TaskID,Instructions,Memory_MB,Input_MB,Output_MB,IO_MB_Total,Inst_per_MB,Predicted_Cost
Task_1,991,161,15,104,119,6.117283950617284,22.26386345001228
Task_2,2979,635,50,179,229,4.683962264150943,56.9917230130026
Task_3,2998,371,153,41,194,8.059139784946236,55.18833100867571
Task_4,1726,522,25,157,182,3.30019120458891,36.2262410618623
Task_5,2550,77,140,142,282,32.69230769230769,47.3155344312737
Task_6,1229,782,35,137,172,1.5696040868454662,29.14741059246717
Task_7,2242,1016,134,133,267,2.2045231071779745,46.425995985666624
Task_8,2661,1021,82,40,122,2.6037181996086107,51.25146943771359
Task_9,920,226,146,168,314,4.052863436123348,23.259855871838756
Task_10,597,403,13,69,82,1.4777227722772277,16.640671700751493
Task_11,1893,834,150,129,279,2.2670658682634732,40.37739606654321
Task_12,2933,857,53,176,229,3.4184149184149186,56.94062925616563
Task_13,1266,1009,88,75,163,1.2534653465346535,29.797283335342627
Task_14,753,668,130,22,152,1.1255605381165918,20.00483269053718
Task_15,678,126,36,191,227,5.338582677165355,18.343047119545446
Task_16,978,479,122,103,225,2.0375,24.49329999513756
Task_17,920,976,108,68,176,0.9416581371545547,24.28481211642222
Task_18,2715,450,183,123,306,6.019955654101995,52.28943627584272
Task_19,846,677,200,59,259,1.247787610619469,22.541527707499455
Task_20,2263,195,116,49,165,11.545918367346939,42.827039461271035
Task_21,2228,660,34,159,193,3.3706505295007565,44.82315724037443
Task_22,1493,632,184,171,355,2.358609794628752,33.81371307975766
Task_23,736,413,152,152,304,1.7777777777777777,20.87008079459761
Task_24,2285,363,91,191,282,6.277472527472527,45.23759855655965
Task_25,1019,489,163,98,261,2.0795918367346937,25.331981953792027
Task_26,1076,545,70,111,181,1.9706959706959708,26.02339604279167
Task_27,2403,683,152,45,197,3.513157894736842,46.7529762667719
Task_28,2161,191,79,184,263,11.255208333333334,42.625713813273975
Task_29,1152,160,86,82,168,7.15527950310559,25.19196066248337
Task_30,1229,623,60,183,243,1.9695512820512822,29.24517465840189
Task_31,2834,662,82,72,154,4.2745098039215685,53.466941736971876
Task_32,1825,189,61,56,117,9.605263157894736,35.698769593447196
Task_33,1736,517,137,115,252,3.3513513513513513,36.752743442227036
Task_34,1824,93,147,24,171,19.404255319148938,34.57726532503997
Task_35,1061,248,119,187,306,4.261044176706827,25.552684125978328
Task_36,2239,198,56,15,71,11.251256281407036,40.85716856872656
Task_37,2503,1015,30,58,88,2.463582677165354,48.614921820829956
Task_38,1697,719,41,153,194,2.3569444444444443,36.57770495916821
Task_39,2189,162,106,183,289,13.429447852760736,42.66482034179621
Task_40,1683,844,183,129,312,1.991715976331361,37.23003668032657
Task_41,1430,261,19,172,191,5.458015267175573,30.8673375508527
Task_42,2723,985,40,93,133,2.761663286004057,53.09532607930848
Task_43,608,422,63,186,249,1.4373522458628842,18.74635304048792
Task_44,2505,537,74,34,108,4.656133828996283,47.183815442806775
Task_45,2585,862,149,77,226,2.995365005793743,50.755354876481995
Task_46,1110,269,82,190,272,4.111111111111111,26.340479900555408
Task_47,980,236,64,25,89,4.135021097046414,21.636977643098177
Task_48,870,424,77,115,192,2.0470588235294116,22.605587143280825
Task_49,781,294,131,147,278,2.647457627118644,21.093149221811437
Task_50,1608,534,114,164,278,3.005607476635514,34.96904730136705
Task_51,1710,560,183,112,295,3.0481283422459895,36.66673528417227
Task_52,940,364,117,197,314,2.5753424657534247,24.067295105123176
Task_53,1032,818,99,184,283,1.26007326007326,26.680614359415298
Task_54,1633,993,190,65,255,1.6428571428571428,36.11526112316283
Task_55,1998,433,59,160,219,4.6036866359447,40.70262323579924
Task_56,984,1024,142,60,202,0.96,25.657420336641337
Task_57,1892,819,58,28,86,2.3073170731707315,37.98086791960268
Task_58,1009,295,119,49,168,3.4087837837837838,23.236921070841703
Task_59,2243,816,186,21,207,2.745410036719706,44.60792486368666
Task_60,2871,440,172,98,270,6.510204081632653,54.529945581388745
Task_61,657,664,39,113,152,0.98796992481203,19.15418167680293
Task_62,1798,68,43,129,172,26.057971014492754,34.96024286486136
Task_63,1297,275,176,140,316,4.699275362318841,29.3486087717001
Task_64,2435,476,183,78,261,5.10482180293501,47.375672635666994
Task_65,2029,1005,17,78,95,2.0168986083499005,41.38333106939411
Task_66,1469,1019,171,79,250,1.4401960784313725,33.673090071868195
Task_67,2910,433,171,101,272,6.7050691244239635,55.1341176622503
Task_68,2163,394,38,61,99,5.4759493670886075,41.34501457004299
Task_69,700,350,94,126,220,1.9943019943019944,19.78236882398897
Task_70,1341,337,27,152,179,3.967455621301775,29.511732567783294
Task_71,2360,698,58,13,71,3.376251788268956,44.393075527235645
Task_72,1224,1008,22,43,65,1.2130822596630326,27.675988018266157
Task_73,1987,175,29,97,126,11.289772727272727,38.161238989294354
Task_74,1050,472,125,58,183,2.219873150105708,24.65576797259828
Task_75,573,281,56,188,244,2.0319148936170213,17.828942189027842
Task_76,1735,931,190,24,214,1.861587982832618,36.9988582600105
Task_77,941,389,61,19,80,2.4128205128205127,21.238645563486354
Task_78,1007,695,146,31,177,1.4468390804597702,24.449017371392088
Task_79,1761,477,150,101,251,3.6841004184100417,36.99602677936234
Task_80,1322,404,110,130,240,3.2641975308641977,29.807307607645658
Task_81,1583,669,56,85,141,2.3626865671641792,33.947239679336015
Task_82,1046,499,85,107,192,2.092,25.537067637891713
Task_83,1865,594,18,173,191,3.134453781512605,38.82346004803881
Task_84,880,65,48,70,118,13.333333333333334,19.585372435251376
Task_85,1689,548,45,183,228,3.0765027322404372,36.09852722741524
Task_86,2282,985,74,28,102,2.314401622718053,44.98681800667608
Task_87,1339,606,79,17,96,2.2059308072487642,28.65196586290264
Task_88,2571,989,15,82,97,2.596969696969697,50.07758792791967
Task_89,2271,274,40,62,102,8.258181818181818,42.73551239010519
Task_90,2858,725,123,139,262,3.9366391184573004,55.261501251724304
Task_91,2051,294,159,47,206,6.952542372881356,40.00259931400411
Task_92,1923,431,75,61,136,4.451388888888889,38.2279966587323
Task_93,2169,704,19,61,80,3.076595744680851,42.1825225360082
Task_94,2071,615,136,52,188,3.362012987012987,41.5323901828478
Task_95,1863,959,187,84,271,1.940625,39.89534790897198
Task_96,1680,154,139,57,196,10.838709677419354,33.63659866223428
Task_97,1912,266,109,46,155,7.1610486891385765,37.17087206477098
Task_98,1096,758,113,52,165,1.4440052700922266,26.392764790709055
Task_99,1633,802,102,100,202,2.0336239103362392,35.768781647857516
Task_100,1162,909,104,87,191,1.2769230769230768,28.225599896348413
Task_101,2268,469,107,131,238,4.825531914893617,44.98126262144795
Task_102,2305,1024,79,69,148,2.2487804878048783,46.20780108012601
Task_103,717,890,190,34,224,0.8047138047138047,20.895012274553455
Task_104,1295,846,48,91,139,1.5289256198347108,29.955945697974723
Task_105,1633,245,121,77,198,6.638211382113822,33.57290033947163
Task_106,2848,655,26,108,134,4.341463414634147,54.0120613605869
Task_107,721,914,134,135,269,0.7879781420765027,21.982403223183308
Task_108,1659,814,103,94,197,2.0355828220858894,36.131207809192
Task_109,2669,764,161,159,320,3.488888888888889,52.68115665783247
Task_110,2022,851,67,112,179,2.3732394366197185,41.93914652601841
Task_111,1071,551,60,181,241,1.940217391304348,26.50594134679369
Task_112,2101,918,173,137,310,2.2861806311207835,44.08633441487336
Task_113,2354,298,26,158,184,7.872909698996655,45.43857177457979
Task_114,638,508,105,173,278,1.2534381139489195,19.41979649542542
Task_115,1152,329,57,58,115,3.4909090909090907,25.440605290591844
Task_116,2826,895,123,132,255,3.154017857142857,55.24722749115193
Task_117,861,208,179,192,371,4.119617224880383,22.559627860185504
Task_118,1837,922,125,150,275,1.990249187432286,39.77683291754405
Task_119,2577,596,44,65,109,4.316582914572864,48.915248406720444
Task_120,516,854,50,31,81,0.6035087719298246,16.921113612082703
Task_121,914,213,127,57,184,4.271028037383178,21.68464807286254
Task_122,1600,101,80,34,114,15.686274509803921,30.83279476216966
Task_123,1360,179,144,91,235,7.555555555555555,29.04185105296119
Task_124,1842,733,30,65,95,2.5095367847411443,37.53450016004422
Task_125,536,732,86,196,282,0.7312414733969986,18.65780029476761
Task_126,912,193,193,119,312,4.701030927835052,22.9458126100068
Task_127,1042,468,199,27,226,2.2217484008528783,24.644540190252325
Task_128,1961,759,37,56,93,2.580263157894737,39.41797166082518
Task_129,850,259,64,32,96,3.269230769230769,19.793078446895482
Task_130,2817,248,49,23,72,11.313253012048193,50.40419018834606
Task_131,1513,769,152,106,258,1.964935064935065,34.026032269232935
Task_132,1870,88,141,195,336,21.01123595505618,37.127289541343124
Task_133,1849,254,11,125,136,7.250980392156863,36.88294595868219
Task_134,1320,754,172,178,350,1.7483443708609272,31.428564461690105
Task_135,2136,469,70,11,81,4.54468085106383,40.76314060840483
Task_136,2163,613,84,118,202,3.522801302931596,43.645051924623836
Task_137,2783,235,73,16,89,11.792372881355933,50.21477253469547
Task_138,2870,1007,74,191,265,2.8472222222222223,56.557845329053634
Task_139,1381,655,89,16,105,2.105182926829268,29.49309727818772
Task_140,2103,915,99,29,128,2.2958515283842793,42.36021426372417
Task_141,2573,611,123,53,176,4.204248366013072,49.295742707890405
Task_142,2384,797,121,19,140,2.987468671679198,46.086839524768685
Task_143,1577,700,150,195,345,2.2496433666191153,35.34714195190989
Task_144,1549,211,45,112,157,7.306603773584905,32.0291452993194
Task_145,1943,833,182,83,265,2.3297362110311752,40.742584922208756
Task_146,2061,69,71,62,133,29.442857142857143,38.081426412648334
Task_147,986,245,13,64,77,4.008130081300813,21.88004222848331
Task_148,2125,158,21,110,131,13.364779874213836,40.26845592602674
Task_149,2623,265,69,166,235,9.860902255639099,50.06515964581055
Task_150,2424,78,153,29,182,30.68354430379747,43.98179219767462
Task_151,1837,418,23,63,86,4.384248210023866,36.36718731202604
Task_152,2705,586,129,65,194,4.608177172061329,51.53948665085065
Task_153,2838,878,135,116,251,3.2286689419795223,55.342640399263836
Task_154,1344,417,192,167,359,3.215311004784689,30.78761810941104
Task_155,1483,911,66,90,156,1.6260964912280702,33.186638089267824
Task_156,580,180,186,37,223,3.2044198895027622,16.29173754798204
Task_157,1962,230,180,161,341,8.493506493506494,39.84267988428299
Task_158,2988,903,128,175,303,3.3053097345132745,58.11859088419686
Task_159,2843,193,182,90,272,14.654639175257731,53.075165615451205
Task_160,891,228,181,126,307,3.890829694323144,22.715420287803727
Task_161,1016,452,155,38,193,2.2428256070640176,24.119624187383437
Task_162,2444,592,167,175,342,4.12141652613828,48.69570931427487
Task_163,1299,520,113,101,214,2.4932821497120923,29.651657054995724
Task_164,676,996,10,161,171,0.6780341023069207,21.019070570964352
Task_165,1890,648,11,195,206,2.9121725731895225,39.517360703143375
Task_166,2979,158,75,89,164,18.735849056603772,54.34022237614826
Task_167,1684,908,121,142,263,1.8525852585258527,37.243128156911375
Task_168,2635,676,51,22,73,3.8921713441654355,48.89771843103043
Task_169,1993,104,148,160,308,18.98095238095238,38.95383328219521
Task_170,1650,317,71,55,126,5.188679245283019,33.51555248667943
Task_171,2546,912,69,132,201,2.7886089813800656,50.741800934973746
Task_172,2473,598,161,128,289,4.128547579298831,48.866298272411484
Task_173,2203,233,16,126,142,9.414529914529915,42.37352445661494
Task_174,2759,783,153,31,184,3.5191326530612246,52.51749652937976
Task_175,1327,958,26,160,186,1.383733055265902,31.222888218762915
Task_176,2376,445,85,91,176,5.327354260089686,46.00862241753169
Task_177,2289,560,86,108,194,4.080213903743315,45.41599775042761
Task_178,2336,795,195,146,341,2.9346733668341707,47.57850951605767
Task_179,2653,427,80,57,137,6.1985981308411215,49.72497254126896
Task_180,2023,619,95,62,157,3.2629032258064514,40.39707403736093
Task_181,1736,395,39,66,105,4.383838383838384,34.84225085126074
Task_182,675,880,132,162,294,0.7661748013620885,21.2852618648972
Task_183,828,286,153,164,317,2.8850174216027873,22.01105165334849
Task_184,2191,731,41,159,200,2.9931693989071038,44.476640387407876
Task_185,2591,867,122,145,267,2.9850230414746544,51.50916609369401
Task_186,1119,445,190,127,317,2.508968609865471,27.067794786420013
Task_187,1286,622,31,104,135,2.0642054574638844,29.162577924158445
Task_188,2311,340,34,162,196,6.777126099706745,45.11991408162921
Task_189,2287,336,176,54,230,6.786350148367952,44.237917029972245
Task_190,2036,295,154,70,224,6.878378378378378,40.13659263739095
Task_191,2055,743,95,79,174,2.7620967741935485,41.81179100342008
Task_192,2086,998,29,62,91,2.088088088088088,42.0599343281055
Task_193,562,821,189,120,309,0.683698296836983,19.432882601800575
Task_194,2775,157,163,158,321,17.563291139240505,52.00258454981003
Task_195,2499,816,145,16,161,3.05875152998776,48.130876204463455
Task_196,1002,462,17,99,116,2.16414686825054,23.92526623873796
Task_197,920,826,102,20,122,1.1124546553808947,22.88854309971521
Task_198,518,749,93,158,251,0.6906666666666667,18.47493925256098
Task_199,2906,793,104,131,235,3.6599496221662466,56.10298216109311
Task_200,837,479,101,50,151,1.74375,20.91010445184165
Task_201,764,124,51,105,156,6.112,18.87591727188894
Task_202,1284,363,150,191,341,3.5274725274725274,29.618917884360613
Task_203,2152,784,105,16,121,2.74140127388535,42.26041281696791
Task_204,2522,618,61,197,258,4.074313408723748,49.79535210547275
Task_205,636,499,152,40,192,1.272,18.215885712094067
Task_206,2032,371,62,175,237,5.462365591397849,41.114209182211475
Task_207,2045,427,105,76,181,4.77803738317757,40.4214612199508
Task_208,2421,594,44,200,244,4.06890756302521,47.94643783044027
Task_209,1708,339,25,40,65,5.023529411764706,33.18521479297714
Task_210,2110,247,64,47,111,8.508064516129032,39.7847651797693
Task_211,571,577,188,110,298,0.9878892733564014,18.617448254534263
Task_212,1943,614,128,100,228,3.159349593495935,40.20751925647443
Task_213,1940,86,27,94,121,22.298850574712645,36.63246581423416
Task_214,1010,356,125,35,160,2.8291316526610646,23.273965901770794
Task_215,2626,629,34,92,126,4.1682539682539685,50.421839013331855
Task_216,2993,269,91,102,193,11.085185185185185,55.57206138197486
Task_217,2555,568,17,179,196,4.490333919156415,49.66247169218662
Task_218,648,787,124,162,286,0.8223350253807107,20.502097078410294
Task_219,2977,372,193,21,214,7.981233243967829,54.83482102743498
Task_220,695,111,23,165,188,6.205357142857143,18.06982298832959
Task_221,2774,119,116,12,128,23.116666666666667,49.740160888905216
Task_222,1655,594,25,81,106,2.7815126050420167,34.39810982484867
Task_223,2530,672,72,42,114,3.7592867756315007,48.073628979664754
Task_224,938,228,96,129,225,4.096069868995633,23.145408528410197
Task_225,1914,425,136,138,274,4.492957746478873,39.408274079313514
Task_226,1878,595,113,157,270,3.151006711409396,39.39099019221414
Task_227,2651,332,59,39,98,7.960960960960961,48.49699691843836
Task_228,1589,702,10,163,173,2.260312944523471,34.65540783891719
Task_229,1831,764,154,174,328,2.3934640522875816,39.463445460482774
Task_230,1607,901,104,41,145,1.7815964523281596,34.41832780626711
Task_231,1104,636,180,22,202,1.7331240188383046,26.006113355480537
Task_232,2502,399,52,107,159,6.255,47.90655668969817
Task_233,1295,92,70,52,122,13.924731182795698,26.159359833465434
Task_234,1195,877,55,110,165,1.3610478359908884,28.891614410183
Task_235,1872,386,129,93,222,4.837209302325581,38.251006630183845
Task_236,645,867,174,155,329,0.7430875576036866,20.839229968170873
Task_237,2762,564,21,81,102,4.888495575221239,51.76011796389819
Task_238,582,505,176,199,375,1.150197628458498,19.04033810746478
Task_239,2408,534,47,80,127,4.500934579439252,46.48820591569776
Task_240,2957,906,31,62,93,3.2601984564498347,55.663909915276584
Task_241,676,565,103,159,262,1.1943462897526502,20.147335906660444
Task_242,1442,251,58,154,212,5.722222222222222,31.265128636713087
Task_243,595,455,36,175,211,1.3048245614035088,18.28649458658929
Task_244,763,921,126,103,229,0.8275488069414316,22.394951070493033
Task_245,1729,943,103,104,207,1.8315677966101696,37.75682411368012
Task_246,1414,104,53,77,130,13.466666666666667,28.425574512204204
Task_247,2454,551,85,163,248,4.445652173913044,48.32920241182284
Task_248,869,331,57,54,111,2.6174698795180724,20.83765820379359
Task_249,1207,884,153,170,323,1.3638418079096044,29.860578057722904
Task_250,1136,72,119,40,159,15.561643835616438,23.31920139972603
Task_251,2884,266,144,48,192,10.801498127340825,53.016442963583046
Task_252,2182,243,106,38,144,8.942622950819672,41.38675891540375
Task_253,878,170,117,189,306,5.1345029239766085,22.05009307315196
Task_254,1079,621,127,33,160,1.734726688102894,25.18638659945474
Task_255,2963,657,165,55,220,4.503039513677812,55.97072597421691
Task_256,2911,772,191,170,361,3.7658473479948253,56.74110505110675
Task_257,2542,405,23,12,35,6.261083743842365,46.171040208749275
Task_258,1373,737,51,189,240,1.8604336043360434,31.944945901245237
Task_259,1110,99,177,188,365,11.1,25.37763563068823
Task_260,2276,597,184,131,315,3.8060200668896322,45.86491617817203
Task_261,2666,455,180,85,265,5.8464912280701755,51.014996272343645
Task_262,1624,744,70,23,93,2.1798657718120804,33.76259098482486
Task_263,1619,273,135,85,220,5.908759124087592,33.64314640573834
Task_264,1739,877,72,69,141,1.9806378132118452,36.78124712980294
Task_265,2287,88,33,175,208,25.696629213483146,43.05711172785946
Task_266,1433,595,148,116,264,2.4043624161073827,32.256667864151375
Task_267,2886,645,52,89,141,4.46749226006192,54.565725586307025
Task_268,2159,891,20,30,50,2.4204035874439462,42.120307561994665
Task_269,2557,386,192,120,312,6.607235142118863,49.59968875991888
Task_270,1071,295,128,118,246,3.6182432432432434,25.494406840150404
Task_271,1323,463,38,85,123,2.851293103448276,29.062961288858812
Task_272,1951,594,71,100,171,3.2789915966386554,39.94100685611978
Task_273,2603,603,124,116,240,4.309602649006623,50.702548157166405
Task_274,579,154,153,131,284,3.735483870967742,17.135596245762912
Task_275,775,635,110,33,143,1.2185534591194969,20.331520560032583
Task_276,2601,580,24,30,54,4.476764199655766,48.16989052097474
Task_277,2632,773,68,72,140,3.400516795865633,50.68123416533793
Task_278,1725,400,41,31,72,4.301745635910224,33.65386449827363
Task_279,963,782,13,141,154,1.2298850574712643,24.492655641979457
Task_280,1608,557,72,89,161,2.881720430107527,34.08064305637097
Task_281,1410,366,88,93,181,3.8419618528610355,30.51774215492109
Task_282,1045,121,100,49,149,8.565573770491802,22.58473311977578
Task_283,2237,321,21,39,60,6.947204968944099,41.411628580247594
Task_284,1767,382,100,143,243,4.613577023498695,36.80991424140564
Task_285,1049,581,30,164,194,1.802405498281787,25.92761270988437
Task_286,964,262,187,96,283,3.665399239543726,23.852968255724544
Task_287,2673,681,166,103,269,3.9193548387096775,52.17061855872945
Task_288,1804,66,174,119,293,26.925373134328357,35.684808385629076
Task_289,742,310,114,44,158,2.3858520900321545,18.830032407109645
Task_290,2202,962,27,117,144,2.2866043613707165,44.78877538606198
Task_291,2326,266,33,149,182,8.711610486891386,44.858941475028
Task_292,2279,811,161,187,348,2.8066502463054186,46.81720540281637
Task_293,2385,504,120,58,178,4.7227722772277225,45.8657543672653
Task_294,1937,979,171,119,290,1.976530612244898,41.56078899240349
Task_295,607,368,37,28,65,1.6449864498644986,15.835268837293718
Task_296,1824,856,88,135,223,2.128354725787631,39.12872790010032
Task_297,2213,965,62,70,132,2.290890269151139,44.625554824186054
Task_298,946,346,94,200,294,2.7262247838616713,24.10278469845942
Task_299,1667,1016,39,13,52,1.6391347099311702,34.48385269764114
Task_300,2571,571,198,14,212,4.494755244755245,48.994560755712115
Task_301,1373,742,21,101,122,1.847913862718708,30.804422993803538
Task_302,1719,895,179,15,194,1.9185267857142858,36.43681946415215
Task_303,1216,464,25,169,194,2.6150537634408604,28.219018177097208
Task_304,2362,224,153,196,349,10.497777777777777,46.22514281626965
Task_305,2121,554,141,152,293,3.8216216216216217,43.20532559595733
Task_306,738,171,178,57,235,4.290697674418604,19.018265288490188
Task_307,2160,650,130,46,176,3.3179723502304146,42.572708409557855
Task_308,2592,616,75,59,134,4.2009724473257695,49.40185635350614
Task_309,2497,700,123,161,284,3.5620542082738944,49.59545752323961
Task_310,1910,936,44,107,151,2.038420490928495,40.0368139257818
Task_311,2517,965,98,56,154,2.6055900621118013,49.29321206078268
Task_312,1795,470,95,37,132,3.81104033970276,36.0956189973824
Task_313,1193,988,93,84,177,1.2062689585439839,28.773537685382905
Task_314,1877,269,14,196,210,6.951851851851852,38.1418550999383
Task_315,2944,1009,65,64,129,2.9148514851485148,56.358810391567836
Task_316,1296,718,105,17,122,1.8025034770514603,28.46694979498031
Task_317,2987,905,193,162,355,3.2969094922737305,58.324322023614535
Task_318,1668,882,19,16,35,1.8890147225368064,33.79866893753603
Task_319,2386,471,48,61,109,5.055084745762712,45.34560595767627
Task_320,544,149,103,73,176,3.6266666666666665,15.37090046561473
Task_321,1428,409,128,121,249,3.4829268292682927,31.52806535589225
Task_322,2927,987,126,191,317,2.9625506072874495,57.501248082523205
Task_323,1629,476,197,61,258,3.4150943396226414,34.3473424764167
Task_324,974,300,140,189,329,3.2358803986710964,24.45528055718462
Task_325,1667,861,29,90,119,1.9338747099767981,35.73805678796426
Task_326,679,403,67,146,213,1.6806930693069306,19.63995586296288
Task_327,831,719,193,176,369,1.1541666666666666,23.58749060697708
Task_328,979,539,93,58,151,1.8129629629629629,23.611026434268172
Task_329,2599,842,26,138,164,3.0830367734282325,51.012429615877515
Task_330,862,732,191,131,322,1.1759890859481583,23.841076805385104
Task_331,760,883,183,182,365,0.8597285067873304,22.967176401377184
Task_332,876,105,17,29,46,8.264150943396226,18.745161019545467
Task_333,1216,566,41,157,198,2.144620811287478,28.504404970301508
Task_334,2090,901,35,31,66,2.317073170731707,41.022337805444536
Task_335,1305,277,32,68,100,4.694244604316546,27.66163039084921
Task_336,2906,902,26,83,109,3.2181616832779625,55.31288397918871
Task_337,864,520,133,11,144,1.6583493282149713,21.267822117409988
Task_338,2388,573,36,161,197,4.160278745644599,47.083211278298755
Task_339,2057,500,78,17,95,4.105788423153693,39.68102094487461
Task_340,2677,503,31,199,230,5.311507936507937,51.664896549727835
Task_341,1271,424,147,155,302,2.9905882352941178,29.380208343524796
Task_342,2852,319,148,64,212,8.9125,53.04885133397528
Task_343,966,307,179,153,332,3.1363636363636362,24.312222114133842
Task_344,2107,842,198,53,251,2.4994068801897984,43.14794056288559
Task_345,2028,683,164,160,324,2.9649122807017543,42.29175345023921
Task_346,1460,395,172,79,251,3.686868686868687,31.644027908343958
Task_347,886,816,18,188,206,1.084455324357405,23.875381196117882
Task_348,2735,416,137,101,238,6.5587529976019185,52.15491355681528
Task_349,2441,436,98,48,146,5.585812356979405,46.16290308571758
Task_350,1530,719,88,22,110,2.125,32.21744611361702
Task_351,2507,1004,92,77,169,2.4945273631840794,49.591098398010615
Task_352,1969,919,117,98,215,2.140217391304348,41.51577242425677
Task_353,1898,630,139,86,225,3.007923930269414,39.24715986519095
Task_354,2997,444,179,173,352,6.734831460674157,57.01365005244313
Task_355,1008,737,102,141,243,1.3658536585365855,25.848689589320447
Task_356,1182,356,200,91,291,3.310924369747899,27.464728481556538
Task_357,1174,190,195,64,259,6.146596858638744,26.409155286597855
Task_358,1048,594,117,111,228,1.761344537815126,25.973539030513063
Task_359,2433,696,92,167,259,3.490674318507891,48.54269678266388
Task_360,656,414,69,132,201,1.580722891566265,19.20949149380837
Task_361,1311,343,163,45,208,3.811046511627907,28.430069155217737
Task_362,2776,464,114,179,293,5.969892473118279,53.3244081267008
Task_363,2067,532,53,120,173,3.8780487804878048,41.790647472172644
Task_364,2827,1011,154,191,345,2.7934782608695654,56.117641091041435
Task_365,522,274,52,143,195,1.8981818181818182,16.724828029697644
Task_366,1369,603,23,19,42,2.2665562913907285,28.327463616963417
Task_367,885,197,105,23,128,4.46969696969697,20.781833190822308
Task_368,1351,300,114,127,241,4.488372093023256,29.928318209344937
Task_369,749,993,170,74,244,0.7535211267605634,22.120792424923636
Task_370,1028,229,153,76,229,4.469565217391304,24.096307955061786
Task_371,2328,340,36,56,92,6.826979472140763,43.86854253665775
Task_372,2372,225,100,10,110,10.495575221238939,43.88146270855619
Task_373,1778,314,175,31,206,5.644444444444445,35.75812829012847
Task_374,2117,866,174,94,268,2.4417531718569783,43.8698868231379
Task_375,2939,1011,188,94,282,2.9041501976284585,57.410842199010006
Task_376,583,1021,15,98,113,0.5704500978473581,19.1114758710736
Task_377,2118,89,129,122,251,23.533333333333335,40.54928148681229
Task_378,2223,1015,175,187,362,2.187992125984252,46.62911800553482
Task_379,1679,94,54,124,178,17.673684210526314,33.15263387298333
Task_380,1441,164,62,61,123,8.733333333333333,29.121520974426463
Task_381,1986,674,77,127,204,2.942222222222222,41.134881018316726
Task_382,2651,312,133,197,330,8.46964856230032,51.02788578796939
Task_383,1418,888,94,46,140,1.5950506186726658,31.407010647507505
Task_384,2098,814,164,45,209,2.5742331288343556,42.386580250136014
Task_385,2630,894,110,162,272,2.9385474860335195,52.25903826118056
Task_386,1036,997,195,52,247,1.0380761523046091,26.586048863644578
Task_387,2394,581,138,89,227,4.11340206185567,47.036988182070736
Task_388,2443,856,95,78,173,2.8506417736289382,48.29394655226881
Task_389,2338,955,98,198,296,2.4456066945606696,47.99732556042404
Task_390,2064,505,130,105,235,4.07905138339921,41.81609112117357
Task_391,1216,747,156,53,209,1.625668449197861,28.551334988489433
Task_392,1306,333,70,63,133,3.910179640718563,28.262233662257017
Task_393,832,529,147,29,176,1.569811320754717,21.18378664905188
Task_394,2024,778,54,16,70,2.5982028241335047,39.32702285597469
Task_395,2624,200,182,23,205,13.054726368159203,48.642838966045616
Task_396,1723,182,138,163,301,9.415300546448087,35.548691054970874
Task_397,2450,173,45,125,170,14.080459770114942,45.8890904868098
Task_398,1646,692,12,199,211,2.375180375180375,35.819016965022975
Task_399,2615,459,170,180,350,5.684782608695652,51.017982247371414
Task_400,2797,766,61,44,105,3.646675358539765,52.185019009832985
Task_401,2251,780,174,108,282,2.882202304737516,45.86324742524804
Task_402,2981,860,41,18,59,3.4622531939605112,54.713234088382556
Task_403,2666,279,103,101,204,9.521428571428572,50.439161597209534
Task_404,2062,588,61,55,116,3.500848896434635,40.64061985252861
Task_405,507,885,19,179,198,0.572234762979684,18.231061016637423
Task_406,2259,950,127,134,261,2.3753943217665614,46.46441771525597
Task_407,1112,652,157,91,248,1.7029096477794794,27.082750126983502
Task_408,918,131,130,126,256,6.954545454545454,22.165606364114947
Task_409,2171,93,129,109,238,23.095744680851062,41.26575824834398
Task_410,1980,542,152,57,209,3.6464088397790055,39.916806609216955
Task_411,1474,703,30,55,85,2.09375,31.37853477809271
Task_412,1970,665,15,91,106,2.957957957957958,39.77022492320268
Task_413,1804,213,72,34,106,8.429906542056075,34.88397718822598
Task_414,1681,190,21,55,76,8.801047120418849,32.76006719226884
Task_415,1244,272,17,166,183,4.556776556776557,27.698650892088086
Task_416,921,212,31,80,111,4.323943661971831,21.74093385243732
Task_417,551,220,183,30,213,2.493212669683258,16.09524862459327
Task_418,624,244,50,76,126,2.546938775510204,17.44918673344009
Task_419,936,512,24,133,157,1.8245614035087718,23.398255192062436
Task_420,1799,992,25,11,36,1.811681772406848,36.213118786187046
Task_421,647,192,85,71,156,3.3523316062176165,17.43195999102043
Task_422,1873,931,137,89,226,2.009656652360515,39.87750098930553
Task_423,1928,753,154,137,291,2.557029177718833,40.74472963339068
Task_424,675,885,107,130,237,0.7618510158013544,20.996019979777472
Task_425,1548,562,16,26,42,2.74955595026643,31.243902089229238
Task_426,969,665,189,56,245,1.454954954954955,24.497836864420606
Task_427,2884,887,80,44,124,3.2477477477477477,54.39770147600881
Task_428,1682,660,27,40,67,2.5446293494704992,33.79735311849334
Task_429,646,951,92,70,162,0.6785714285714286,19.959083452648812
Task_430,1199,694,180,107,287,1.725179856115108,28.936983727750203
Task_431,787,917,58,90,148,0.8572984749455338,22.028271564465115
Task_432,2944,67,178,145,323,43.294117647058826,53.60210978577022
Task_433,2696,650,172,55,227,4.141321044546851,51.751082300090154
Task_434,1154,833,50,54,104,1.3836930455635492,26.75466103643519
Task_435,1375,234,42,90,132,5.851063829787234,29.257710888166184
Task_436,1275,1011,79,173,252,1.2598814229249011,31.09424556716567
Task_437,886,303,168,64,232,2.914473684210526,21.99801167059736
Task_438,1580,1021,185,75,260,1.5459882583170255,35.440965769844304
Task_439,2502,835,188,10,198,2.992822966507177,48.696628740498234
Task_440,725,326,91,50,141,2.217125382262997,18.650833597486898
Task_441,1192,94,20,195,215,12.547368421052632,25.845516445593006
Task_442,2213,771,189,125,314,2.866580310880829,45.402175546713856
Task_443,2725,466,54,182,236,5.835117773019272,52.43027889663989
Task_444,1335,327,33,188,221,4.070121951219512,29.81126275819661
Task_445,2962,93,175,41,216,31.51063829787234,52.82335816976879
Task_446,594,543,30,138,168,1.0919117647058822,18.019262366436845
Task_447,1146,645,138,177,315,1.7739938080495357,28.173602766341258
Task_448,679,938,174,59,233,0.7231096911608094,20.766585947222037
Task_449,2324,207,103,45,148,11.173076923076923,43.407146014927264
Task_450,1076,774,79,28,107,1.3883870967741936,25.24854611563434
Task_451,788,1009,43,187,230,0.7801980198019802,23.13430099350171
Task_452,2086,861,196,76,272,2.4199535962877032,43.048869076922266
Task_453,1419,683,170,112,282,2.074561403508772,32.385683371205396
Task_454,1007,864,53,61,114,1.1641618497109827,24.80996530422462
Task_455,1546,204,48,128,176,7.541463414634146,32.35388881496621
Task_456,2080,922,27,193,220,2.2535211267605635,43.48344592556856
Task_457,2522,489,106,65,171,5.146938775510204,48.00689733957165
Task_458,2281,170,118,143,261,13.339181286549708,43.906134229537294
Task_459,2499,900,126,127,253,2.7735849056603774,50.06512423846929
Task_460,933,564,162,66,228,1.6513274336283186,23.548894641757595
Task_461,2546,969,69,58,127,2.624742268041237,49.67512940342255
Task_462,2770,186,11,135,146,14.81283422459893,51.34324582970462
Task_463,2118,263,171,127,298,8.022727272727273,42.18252946206009
Task_464,1390,503,113,141,254,2.757936507936508,31.277638707492844
Task_465,2035,137,98,120,218,14.746376811594203,39.666723804089926
Task_466,841,697,25,17,42,1.2048710601719197,20.31363791035619
Task_467,1153,899,161,197,358,1.281111111111111,29.21804574930154
Task_468,1964,633,73,31,104,3.0977917981072554,38.837689400989596
Task_469,1567,589,29,143,172,2.6559322033898307,33.95780139637327
Task_470,2423,653,191,132,323,3.7048929663608563,48.40808261222055
Task_471,1737,858,128,17,145,2.0221187427240976,36.1351126693747
Task_472,2344,520,126,17,143,4.499040307101727,44.60174682906645
Task_473,2251,564,45,54,99,3.984070796460177,43.2479838044026
Task_474,1349,300,104,92,196,4.48172757475083,29.541863544001355
Task_475,2475,125,125,52,177,19.642857142857142,45.57397177064666
Task_476,2293,104,180,42,222,21.83809523809524,42.52196061096404
Task_477,697,605,81,139,220,1.1501650165016502,20.462949842558846
Task_478,2470,237,91,190,281,10.378151260504202,47.71417047226822
Task_479,592,1002,23,192,215,0.5902293120638086,20.18693845278339
Task_480,1643,480,176,10,186,3.415800415800416,33.77851753440782
Task_481,2633,612,81,184,265,4.295269168026101,51.52237454750931
Task_482,729,547,10,103,113,1.3302919708029197,19.943658875243678
Task_483,890,877,110,123,233,1.0136674259681093,24.25626850245868
Task_484,2699,699,189,185,374,3.855714285714286,53.23285611183288
Task_485,585,980,119,185,304,0.5963302752293578,20.36953546924172
Task_486,684,1003,29,83,112,0.6812749003984063,20.48952319249631
Task_487,2551,342,143,95,238,7.437317784256559,48.957818098905086
Task_488,2691,1019,65,165,230,2.638235294117647,53.55625176913842
Task_489,2277,615,108,195,303,3.6964285714285716,45.97759492635216
Task_490,2213,427,122,105,227,5.170560747663552,43.88651851898694
Task_491,1098,883,154,176,330,1.242081447963801,28.108903257185016
Task_492,2590,929,71,138,209,2.78494623655914,51.54243959848776
Task_493,2637,704,31,53,84,3.7404255319148936,49.78423995281107
Task_494,1849,539,51,149,200,3.424074074074074,38.623152261114576
Task_495,1524,895,193,164,357,1.7008928571428572,35.109980115116656
Task_496,2403,459,89,28,117,5.223913043478261,45.3382134472572
Task_497,1123,974,85,139,224,1.1517948717948718,28.31723347571571
Task_498,2989,769,110,193,303,3.881818181818182,57.73965487901387
Task_499,2377,503,98,196,294,4.716269841269841,47.178181250039245
Task_500,1790,706,39,86,125,2.531824611032532,37.24877519349851
Task_501,2211,102,17,189,206,21.466019417475728,41.901396720086204
Task_502,1944,399,90,98,188,4.86,39.365521079576176
Task_503,1846,281,31,152,183,6.546099290780142,37.32131572440595
Task_504,1092,966,99,162,261,1.1292657704239917,27.905135217003515
Task_505,773,350,154,133,287,2.202279202279202,21.165521474633675
Task_506,545,540,178,55,233,1.0073937153419594,17.25091703665942
Task_507,636,627,183,26,209,1.0127388535031847,18.60283094193272
Task_508,1636,864,180,79,259,1.891329479768786,35.94258061778958
Task_509,2699,129,113,26,139,20.76153846153846,48.58501965962518
Task_510,2284,168,71,101,172,13.514792899408285,43.572420598765916
Task_511,2644,791,29,61,90,3.3383838383838382,50.162327907946896
Task_512,2897,306,135,162,297,9.436482084690553,54.69641315721767
Task_513,2452,753,71,126,197,3.2519893899204244,48.7330717668294
Task_514,2713,455,48,124,172,5.949561403508772,51.72345506393686
Task_515,741,94,128,97,225,7.8,18.72144658255019
Task_516,2879,174,87,133,220,16.451428571428572,53.148039146581795
Task_517,2977,439,122,97,219,6.765909090909091,56.00328554663627
Task_518,1078,109,31,23,54,9.8,22.137193390933884
Task_519,1212,759,55,157,212,1.5947368421052632,29.239098851944078
Task_520,1801,91,113,188,301,19.57608695652174,35.9113412735716
Task_521,2082,447,64,14,78,4.647321428571429,39.266406809123026
Task_522,1396,922,15,183,198,1.512459371614301,32.494216634791705
Task_523,1577,195,96,150,246,8.045918367346939,33.18432808503225
Task_524,2933,774,170,180,350,3.784516129032258,57.061024228493125
Task_525,750,675,166,119,285,1.1094674556213018,21.628874278591045
Task_526,2457,154,183,116,299,15.851612903225806,46.78073702967325
Task_527,2912,277,155,95,250,10.474820143884893,54.49063638893804
Task_528,705,158,120,75,195,4.433962264150943,18.33017901262424
Task_529,2505,639,164,152,316,3.9140625,49.66024909429742
Task_530,2484,474,68,42,110,5.229473684210526,46.57523177586082
Task_531,1372,427,177,171,348,3.205607476635514,31.21896870648681
Task_532,2403,940,40,157,197,2.5536663124335814,48.47278048694192
Task_533,1761,543,155,165,320,3.2371323529411766,37.61084780637354
Task_534,2903,225,180,96,276,12.845132743362832,54.321012381180374
Task_535,2539,438,33,38,71,5.783599088838269,46.75147123860879
Task_536,1068,253,124,71,195,4.2047244094488185,24.571881119998498
Task_537,2817,732,64,61,125,3.8431105047748977,53.128108184187774
Task_538,1966,371,69,82,151,5.28494623655914,39.00937029472993
Task_539,778,896,153,154,307,0.867335562987737,22.990112141914366
Task_540,955,68,93,148,241,13.840579710144928,22.196542108497482
Task_541,2384,541,102,170,272,4.398523985239852,47.25990877621806
Task_542,2671,951,54,133,187,2.805672268907563,52.782990180082855
Task_543,2237,88,110,15,125,25.134831460674157,40.5979816437866
Task_544,619,881,114,13,127,0.7018140589569161,18.717627191035266
Task_545,2342,853,186,45,231,2.7423887587822016,46.473546526308894
Task_546,741,94,50,144,194,7.8,18.734486965822587
Task_547,1197,671,87,88,175,1.78125,27.994386031322133
Task_548,2505,669,45,108,153,3.7388059701492535,48.60531129434418
Task_549,598,189,48,196,244,3.1473684210526316,17.89832248791742
Task_550,2106,594,138,100,238,3.5394957983193276,42.77072790552851
Task_551,870,527,30,82,112,1.6477272727272727,21.967031707342926
Task_552,1629,932,127,178,305,1.7459807073954985,36.67480746704114
Task_553,1735,950,151,185,336,1.8243953732912723,38.57379108898849
Task_554,604,977,11,57,68,0.6175869120654397,18.257260769091
Task_555,869,609,199,144,343,1.4245901639344263,23.697315425068535
Task_556,2195,775,31,137,168,2.8286082474226806,44.33976235044858
Task_557,2840,872,193,127,320,3.2531500572737686,55.682640383451975
Task_558,2926,589,133,180,313,4.959322033898305,56.19577136956144
Task_559,2441,352,148,149,297,6.915014164305949,47.62510164739074
Task_560,2248,409,66,166,232,5.482926829268293,44.61603935851466
Task_561,1198,380,90,112,202,3.1443569553805775,27.620005641000773
Task_562,1435,466,156,80,236,3.0728051391862956,31.416937925040987
Task_563,1207,783,23,197,220,1.5395408163265305,29.24095957361577
Task_564,2717,670,115,78,193,4.049180327868853,52.1537821390244
Task_565,1729,190,23,39,62,9.052356020942408,33.244454160126956
Task_566,1942,887,194,46,240,2.186936936936937,40.31659563056873
Task_567,980,654,41,10,51,1.4961832061068703,22.442228118435498
Task_568,924,893,41,200,241,1.0335570469798658,24.915998600994982
Task_569,854,102,178,119,297,8.29126213592233,20.95126783121836
Task_570,2073,765,101,160,261,2.706266318537859,42.97789081067079
Task_571,898,137,109,101,210,6.507246376811594,21.696841658552184
Task_572,2443,348,95,42,137,7.0,45.91768219440228
Task_573,2187,172,162,71,233,12.641618497109826,41.84972191978509
Task_574,2226,608,132,133,265,3.6551724137931036,44.88556082360808
Task_575,1963,248,199,74,273,7.883534136546185,39.13257659255512
Task_576,1363,743,24,100,124,1.831989247311828,30.749158973650243
Task_577,720,343,80,146,226,2.0930232558139537,20.1764029862028
Task_578,2389,307,23,186,209,7.7564935064935066,46.402385901464584
Task_579,2734,263,82,192,274,10.356060606060606,51.99679146764469
Task_580,2859,934,159,18,177,3.057754010695187,54.264487178192034
Task_581,913,478,118,127,245,1.9060542797494782,23.586536814821955
Task_582,1698,123,196,178,374,13.693548387096774,35.01512848211497
Task_583,2715,935,125,177,302,2.9006410256410255,53.891263975919024
Task_584,582,858,70,164,234,0.6775320139697323,19.73450839554049
Task_585,2830,817,13,124,137,3.4596577017114916,54.28873457118504
Task_586,1547,1009,84,17,101,1.5316831683168317,33.112560122778646
Task_587,731,877,96,76,172,0.8325740318906606,21.131719561639986
Task_588,2836,951,61,11,72,2.9789915966386555,52.74053525728345
Task_589,1760,816,187,30,217,2.1542227662178703,37.12966417363321
Task_590,1676,876,147,84,231,1.911060433295325,36.49393132796623
Task_591,1827,127,48,200,248,14.2734375,36.57073553179321
Task_592,2508,255,36,148,184,9.796875,47.67219419296521
Task_593,2968,901,166,162,328,3.2904656319290466,57.88903827153403
Task_594,2452,907,97,196,293,2.700440528634361,49.64736849160122
Task_595,2467,265,21,42,63,9.274436090225564,44.96075881231514
Task_596,2207,67,153,133,286,32.455882352941174,41.89753759913459
Task_597,1976,689,159,144,303,2.863768115942029,41.36883158495571
Task_598,2863,869,65,79,144,3.2908045977011495,54.80746248171189
Task_599,2578,927,159,119,278,2.7780172413793105,51.50219964665521
Task_600,2149,875,106,38,144,2.4531963470319633,42.909134521488966
Task_601,2058,863,67,200,267,2.3819444444444446,43.254343674002286
Task_602,2390,181,121,16,137,13.131868131868131,43.98904347469753
Task_603,1705,360,164,160,324,4.7229916897506925,36.14703281315127
Task_604,2149,790,96,79,175,2.7168141592920354,43.43722972624882
Task_605,1833,659,70,112,182,2.7772727272727273,38.37538785589553
Task_606,1273,211,117,154,271,6.004716981132075,28.5682254714161
Task_607,2851,606,155,48,203,4.696869851729819,53.684311263424895
Task_608,2841,714,90,20,110,3.9734265734265732,52.856226698951524
Task_609,2148,972,72,180,252,2.2076053442959918,44.9277994603034
Task_610,2372,291,47,66,113,8.123287671232877,44.82895024705065
Task_611,1238,504,78,122,200,2.4514851485148514,28.733877898152937
Task_612,2414,339,198,104,302,7.1,47.11048354055381
Task_613,2625,894,156,187,343,2.9329608938547485,52.53646155508117
Task_614,1596,252,94,49,143,6.308300395256917,32.304451382950674
Task_615,1566,909,65,130,195,1.720879120879121,35.16429863466567
Task_616,1551,342,62,46,108,4.521865889212828,31.235782935526075
Task_617,2055,808,78,123,201,2.5401730531520395,42.6332712440981
Task_618,2646,705,42,33,75,3.7478753541076486,49.18681635408103
Task_619,1023,690,176,118,294,1.4804630969609263,26.155066966297763
Task_620,2831,758,90,107,197,3.729907773386034,54.64734258114092
Task_621,553,484,175,126,301,1.1402061855670103,18.075357394247497
Task_622,504,774,131,183,314,0.6503225806451612,18.48600865405882
Task_623,1610,442,123,59,182,3.63431151241535,33.40739946137091
Task_624,2249,313,17,143,160,7.162420382165605,43.45035285750564
Task_625,2615,180,193,50,243,14.447513812154696,48.491399170381904
Task_626,1929,331,13,89,102,5.8102409638554215,37.98709028881474
Task_627,1539,381,189,179,368,4.028795811518324,33.81548952705151
Task_628,1670,495,162,78,240,3.3669354838709675,35.2317989138566
Task_629,1493,711,135,38,173,2.0969101123595504,32.31796164058064
Task_630,2409,856,99,151,250,2.8109684947491247,48.52491680132864
Task_631,1763,446,107,51,158,3.9440715883668904,35.680288065121445
Task_632,2343,213,161,116,277,10.948598130841122,45.44104172493493
Task_633,1573,841,153,197,350,1.868171021377672,35.74880021999373
Task_634,2806,585,140,130,270,4.78839590443686,54.01552932349614
Task_635,2409,253,145,10,155,9.484251968503937,44.86182607437626
Task_636,789,281,93,171,264,2.797872340425532,21.261742573831494
Task_637,1622,547,48,119,167,2.95985401459854,34.59856693571398
Task_638,2650,239,15,72,87,11.041666666666666,48.64222777403666
Task_639,2648,837,101,10,111,3.159904534606205,50.282437770654106
Task_640,2194,510,61,31,92,4.293542074363992,41.86999451265456
Task_641,606,840,71,104,175,0.7205707491082045,19.577796440240025
Task_642,828,727,42,64,106,1.1373626373626373,21.51478006554736
Task_643,1290,296,48,140,188,4.343434343434343,28.816867157923042
Task_644,2620,827,84,17,101,3.1642512077294684,49.5781875845667
Task_645,1455,755,54,18,72,1.9246031746031746,30.19359442532465
Task_646,622,483,151,134,285,1.2851239669421488,19.094102697940773
Task_647,1662,279,11,30,41,5.935714285714286,32.114073116335334
Task_648,2674,432,163,109,272,6.175519630484988,51.4074926771087
Task_649,1965,398,111,64,175,4.924812030075188,39.03213606014563
Task_650,2315,929,170,140,310,2.489247311827957,47.515997955520454
Task_651,2997,640,53,104,157,4.675507020280811,56.51658794345297
Task_652,1445,354,14,133,147,4.070422535211268,30.92808584477531
Task_653,725,208,83,102,185,3.4688995215311005,19.361895910342906
Task_654,2862,800,78,53,131,3.5730337078651684,54.33925500274058
Task_655,1935,773,30,84,114,2.5,39.662439327372304
Task_656,816,839,133,139,272,0.9714285714285714,23.230858957931947
Task_657,2248,696,134,99,233,3.225251076040172,45.30308447716276
Task_658,826,324,139,153,292,2.5415384615384617,21.972798953434435
Task_659,1385,500,82,144,226,2.7644710578842315,31.159613261761923
Task_660,1522,174,46,145,191,8.697142857142858,31.653288897062538
Task_661,1678,608,198,120,318,2.755336617405583,36.42674697340362
Task_662,1053,86,33,156,189,12.10344827586207,23.579139250747318
Task_663,2769,860,26,170,196,3.21602787456446,54.06517965936717
Task_664,1014,827,53,115,168,1.2246376811594204,25.688851393502848
Task_665,806,776,116,112,228,1.0373230373230373,22.592642347944533
Task_666,2336,705,146,10,156,3.308781869688385,45.19567673186287
Task_667,1492,418,12,52,64,3.560859188544153,30.31448791829185
Task_668,2006,432,38,62,100,4.6327944572748265,39.094679786706585
Task_669,714,800,18,190,208,0.8913857677902621,21.17048501994737
Task_670,2489,777,94,128,222,3.1992287917737787,49.46705343502671
Task_671,1595,596,15,22,37,2.6716917922948076,32.00233937584617
Task_672,1790,869,11,76,87,2.057471264367816,37.04406455916171
Task_673,2782,438,68,87,155,6.337129840546697,52.21209340370219
Task_674,1609,139,117,89,206,11.492857142857142,32.727220396463956
Task_675,1940,248,120,109,229,7.791164658634538,38.9790965680826
Task_676,1178,813,77,195,272,1.4471744471744472,29.1109305482055
Task_677,930,291,44,197,241,3.184931506849315,23.359186916846184
Task_678,2968,653,153,135,288,4.538226299694189,56.886823412722265
Task_679,2431,217,100,50,150,11.15137614678899,45.23935065735123
Task_680,637,337,154,77,231,1.8846153846153846,18.280095479253625
Task_681,1763,85,94,182,276,20.5,35.178668970562214
Task_682,2247,713,170,15,185,3.1470588235294117,44.05326152318539
Task_683,2566,736,24,82,106,3.4816824966078697,49.31263406042964
Task_684,2520,532,179,173,352,4.727954971857411,49.74934319264249
Task_685,531,639,30,61,91,0.8296875,16.234554392288185
Task_686,2135,720,38,77,115,2.9611650485436893,42.59628200352714
Task_687,843,583,90,62,152,1.4434931506849316,21.485134506827837
Task_688,1921,646,32,89,121,2.9690880989180837,39.122294479990465
Task_689,2075,733,12,200,212,2.826975476839237,42.749098703746256
Task_690,2944,492,125,194,319,5.971602434077079,56.21461129834851
Task_691,2336,366,136,31,167,6.3651226158038146,44.41213119093569
Task_692,2576,303,185,64,249,8.473684210526315,48.79518967213564
Task_693,2129,131,69,145,214,16.12878787878788,41.18858306199467
Task_694,1270,605,119,141,260,2.0957095709570956,29.725269112136843
Task_695,2920,360,130,99,229,8.088642659279778,54.83492160634737
Task_696,2846,172,141,147,288,16.45086705202312,52.94195126723891
Task_697,705,325,161,143,304,2.1625766871165646,20.101871339688405
Task_698,2415,129,95,50,145,18.576923076923077,44.26546461546334
Task_699,2499,458,176,57,233,5.444444444444445,47.97110934773218
Task_700,654,707,109,176,285,0.923728813559322,20.374737736386667
Task_701,2903,808,186,151,337,3.5883807169344872,56.59169093798764
Task_702,999,216,58,72,130,4.6036866359447,23.134313275990397
Task_703,722,117,68,138,206,6.11864406779661,18.904912751314452
Task_704,2498,492,17,69,86,5.0669371196754565,46.987214885607365
Task_705,1348,690,106,66,172,1.950795947901592,30.16373125863268
Task_706,543,694,151,79,230,0.781294964028777,17.96866254681943
Task_707,2487,983,169,153,322,2.527439024390244,50.48300836567307
Task_708,2827,565,114,66,180,4.9946996466431095,53.12942645219897
Task_709,658,125,115,37,152,5.222222222222222,16.46647577692057
Task_710,1462,333,198,129,327,4.377245508982036,32.18286440875987
Task_711,1776,156,160,50,210,11.312101910828025,34.979798822246124
Task_712,1445,667,18,24,42,2.163173652694611,29.88456155202557
Task_713,583,226,13,51,64,2.5682819383259914,15.356618680203248
Task_714,690,291,108,89,197,2.363013698630137,19.007295578266042
Task_715,1090,414,154,192,346,2.6265060240963853,26.736573715339443
Task_716,2749,193,136,142,278,14.170103092783505,51.81711435231665
Task_717,755,512,154,56,210,1.4717348927875245,20.490668029251797
Task_718,2426,551,134,103,237,4.394927536231884,47.70099363788315
Task_719,2543,878,87,61,148,2.8930602957906713,49.33483924370726
Task_720,1905,722,171,156,327,2.6348547717842323,40.473428576678195
Task_721,1179,798,190,172,362,1.4755944931163956,29.336405261700126
Task_722,712,849,43,190,233,0.8376470588235294,21.414310357881288
Task_723,2865,494,101,196,297,5.787878787878788,54.8742721312658
Task_724,1812,880,164,72,236,2.0567536889897844,38.54393041632356
Task_725,1412,364,108,61,169,3.8684931506849316,29.95682425265589
Task_726,823,959,67,57,124,0.8572916666666667,22.288925784065466
Task_727,894,796,196,42,238,1.121706398996236,23.37375526149097
Task_728,979,890,77,97,174,1.0987654320987654,25.45206207304859
Task_729,2537,961,125,180,305,2.637214137214137,51.169718210862605
Task_730,2675,252,40,124,164,10.57312252964427,50.23287651773861
Task_731,2306,421,111,164,275,5.464454976303317,45.641503719918944
Task_732,1092,485,32,77,109,2.246913580246914,25.224107479400647
Task_733,2403,750,172,63,235,3.199733688415446,47.43821243795707
Task_734,746,474,59,26,85,1.5705263157894738,18.765969925780826
Task_735,2612,810,20,155,175,3.220715166461159,51.182040718976886
Task_736,1961,83,152,75,227,23.345238095238095,37.4325524706342
Task_737,745,879,64,43,107,0.8465909090909091,20.23129676030948
Task_738,1230,716,116,114,230,1.715481171548117,29.249900394783964
Task_739,770,425,26,194,220,1.807511737089202,21.18321191662064
Task_740,2618,103,103,86,189,25.173076923076923,47.962847752787496
Task_741,2113,268,164,198,362,7.855018587360595,42.513764328779224
Task_742,870,786,138,77,215,1.105463786531131,23.23230484766951
Task_743,1861,733,188,24,212,2.535422343324251,38.369008393633216
Task_744,1200,271,53,36,89,4.411764705882353,25.33728473367147
Task_745,774,727,154,52,206,1.0631868131868132,21.405763068586094
Task_746,728,598,10,37,47,1.2153589315525877,18.4847409050101
Task_747,1167,96,123,32,155,12.030927835051546,24.12432703207325
Task_748,2468,393,50,130,180,6.2639593908629445,47.64229124109706
Task_749,2985,289,17,152,169,10.293103448275861,55.18822158058728
Task_750,1835,917,157,196,353,1.9989106753812635,40.148576366918896
Task_751,691,592,117,10,127,1.1652613827993255,18.752866980936172
Task_752,536,843,163,92,255,0.6350710900473934,18.71590341567674
Task_753,805,327,132,147,279,2.4542682926829267,21.582893807871418
Task_754,975,629,72,133,205,1.5476190476190477,24.956434136428754
Task_755,2869,305,106,159,265,9.375816993464053,54.10151141518778
Task_756,676,742,58,122,180,0.9098250336473755,20.15611383302823
Task_757,2853,103,142,111,253,27.432692307692307,52.15129385035567
Task_758,1045,226,140,52,192,4.60352422907489,24.10190451388417
Task_759,2533,424,86,167,253,5.96,49.19106378755118
Task_760,2802,860,143,96,239,3.254355400696864,54.65601370789653
Task_761,1173,641,172,63,235,1.8271028037383177,27.61339173067323
Task_762,1724,894,118,85,203,1.9262569832402234,37.20466426483621
Task_763,1914,174,48,123,171,10.937142857142858,37.51990634966461
Task_764,2949,542,40,36,76,5.430939226519337,53.45872362533293
Task_765,2131,1015,20,121,141,2.09744094488189,43.747690826826535
Task_766,2438,839,188,53,241,2.9023809523809523,48.33787657889051
Task_767,2199,468,153,101,254,4.688699360341151,43.91394637909763
Task_768,2891,308,99,78,177,9.35598705501618,53.4569323314148
Task_769,2956,1007,36,55,91,2.9325396825396823,55.862820337201775
Task_770,821,491,106,73,179,1.66869918699187,21.190627674181133
Task_771,1445,428,106,186,292,3.3682983682983685,32.14705776508008
Task_772,1703,415,188,112,300,4.09375,36.11583051186491
Task_773,1909,400,198,80,278,4.760598503740648,38.895636627312435
Task_774,1166,948,108,198,306,1.2286617492096945,29.311766400411273
Task_775,2385,122,59,40,99,19.390243902439025,42.94591842734015
Task_776,1892,169,22,96,118,11.129411764705882,36.4035664534511
Task_777,1173,97,31,146,177,11.96938775510204,25.193682393655475
Task_778,1066,216,127,81,208,4.912442396313364,24.603106920471646
Task_779,2398,674,86,130,216,3.5525925925925925,47.635351741456134
Task_780,1427,959,153,105,258,1.4864583333333334,33.20951309425462
Task_781,2906,90,102,57,159,31.934065934065934,51.6618624491623
Task_782,741,634,133,148,281,1.1669291338582677,21.451299526161026
Task_783,1683,813,180,37,217,2.0675675675675675,35.90631401359971
Task_784,1789,530,99,122,221,3.3691148775894537,37.50540291723075
Task_785,2625,628,181,193,374,4.17329093799682,51.84738227162717
Task_786,758,670,163,87,250,1.1296572280178838,21.360193219383735
Task_787,1950,809,166,25,191,2.4074074074074074,39.92549561564275
Task_788,847,808,157,106,263,1.0469715698393078,23.490229912767887
Task_789,2805,85,12,120,132,32.616279069767444,50.22621839805833
Task_790,2618,201,155,18,173,12.96039603960396,48.118408733254846
Task_791,1594,805,190,146,336,1.977667493796526,35.83161910393457
Task_792,724,502,75,32,107,1.4393638170974155,18.835402962194753
Task_793,868,710,40,70,110,1.2208157524613221,22.12397621427033
Task_794,2935,447,84,185,269,6.551339285714286,55.73309586372138
Task_795,2227,431,61,58,119,5.155092592592593,42.70285555142399
Task_796,1916,795,14,47,61,2.407035175879397,38.0226013418746
Task_797,1982,295,114,69,183,6.695945945945946,38.875883026096595
Task_798,697,516,97,43,140,1.3481624758220503,18.732507729879604
Task_799,2534,434,54,27,81,5.825287356321839,46.96223430112095
Task_800,1340,816,65,29,94,1.6401468788249693,29.38888316234231
Task_801,801,635,173,165,338,1.259433962264151,22.671866937310188
Task_802,791,911,25,118,143,0.8673245614035088,22.134122256204666
Task_803,1757,229,93,166,259,7.639130434782609,36.350895319720216
Task_804,615,769,140,32,172,0.7987012987012987,18.60112175832841
Task_805,2597,626,162,161,323,4.1419457735247205,51.12079814316136
Task_806,806,351,92,150,242,2.289772727272727,21.590308972585728
Task_807,1369,234,107,141,248,5.825531914893617,30.04188855719231
Task_808,2174,655,119,116,235,3.3140243902439024,44.0504809852576
Task_809,2895,796,124,86,210,3.6323713927227104,55.49542814955098
Task_810,1810,375,90,119,209,4.8138297872340425,37.328170764485186
Task_811,2177,790,126,93,219,2.752212389380531,44.350933445330384
Task_812,2078,853,91,191,282,2.433255269320843,43.521492577325944
Task_813,1072,666,109,95,204,1.6071964017991005,26.41834451712973
Task_814,2588,749,190,190,380,3.4506666666666668,51.66660924649909
Task_815,2932,633,67,34,101,4.624605678233438,54.136041069275144
Task_816,2117,254,133,66,199,8.301960784313726,41.136236651872714
Task_817,2041,305,51,148,199,6.669934640522876,40.89207550969942
Task_818,563,730,72,50,122,0.7701778385772914,17.285047976140497
Task_819,2700,401,150,152,302,6.7164179104477615,51.91431575151853
Task_820,2527,696,42,45,87,3.625538020086083,47.67166034354519
Task_821,1449,763,102,155,257,1.8965968586387434,33.06076015646465
Task_822,1352,940,130,31,161,1.436769394261424,30.506869503047962
Task_823,548,362,23,27,50,1.5096418732782368,15.02738689259474
Task_824,2961,676,148,200,348,4.373707533234859,57.214816654786546
Task_825,1040,569,66,158,224,1.8245614035087718,25.955695396576388
Task_826,2718,186,88,156,244,14.53475935828877,51.34617515044388
Task_827,2329,91,57,114,171,25.315217391304348,43.36069217823385
Task_828,524,501,121,69,190,1.043824701195219,16.61736881923154
Task_829,2114,455,43,192,235,4.635964912280702,42.58786263048654
Task_830,2353,163,159,127,286,14.347560975609756,45.15932362905459
Task_831,575,221,121,120,241,2.59009009009009,17.395473987112386
Task_832,2489,655,84,139,223,3.794207317073171,49.06664300008564
Task_833,1204,69,92,138,230,17.2,26.043622081379993
Task_834,2736,479,37,192,229,5.7,52.490882259293784
Task_835,2335,668,77,188,265,3.490284005979073,47.00825783656044
Task_836,2543,837,37,43,80,3.0346062052505967,48.33179711554201
Task_837,926,957,105,178,283,0.9665970772442589,25.445488900227833
Task_838,2528,870,140,157,297,2.902411021814007,50.67314121122632
Task_839,931,379,127,84,211,2.45,23.049048850429845
Task_840,640,215,42,145,187,2.962962962962963,18.171830267156533
Task_841,2610,492,10,63,73,5.294117647058823,48.33649472195577
Task_842,2747,560,86,95,181,4.896613190730838,52.357353809587345
Task_843,1474,538,198,61,259,2.7346938775510203,32.09450931430155
Task_844,2851,715,100,86,186,3.9818435754189943,54.27710599900689
Task_845,1193,738,125,189,314,1.6143437077131257,29.220765708948353
Task_846,2158,899,67,27,94,2.397777777777778,42.65233715635203
Task_847,1137,948,142,142,284,1.1981032665964173,28.71214097987361
Task_848,1242,836,36,54,90,1.4838709677419355,28.0740132987811
Task_849,1452,232,194,46,240,6.23175965665236,30.465744354300536
Task_850,2637,1023,59,100,159,2.5751953125,51.99566325103218
Task_851,1477,691,123,177,300,2.134393063583815,33.50579621230369
Task_852,2715,261,176,138,314,10.36259541984733,51.69785141582495
Task_853,1057,334,118,40,158,3.1552238805970148,23.90517114938713
Task_854,1473,644,35,190,225,2.2837209302325583,33.00591559528105
Task_855,1363,470,125,90,215,2.8938428874734607,30.330379770974826
Task_856,1814,1015,12,162,174,1.7854330708661417,39.2039146982197
Task_857,2054,948,44,76,120,2.164383561643836,42.006118003424774
Task_858,1305,994,40,133,173,1.3115577889447236,30.91357334185281
Task_859,2769,846,92,74,166,3.269185360094451,53.2719374500875
Task_860,1425,1015,81,50,131,1.4025590551181102,31.896565180518582
Task_861,1231,720,170,92,262,1.7073509015256587,29.2894599875158
Task_862,2213,220,172,63,235,10.013574660633484,42.68702505540995
Task_863,2973,405,48,109,157,7.322660098522167,55.33288143327568
Task_864,1422,441,135,87,222,3.2171945701357467,31.109746681935576
Task_865,987,582,92,10,102,1.6929674099485421,23.077041293265538
Task_866,1634,675,41,121,162,2.4171597633136095,34.9795089749664
Task_867,2965,1002,62,31,93,2.9561316051844466,55.65075155258065
Task_868,1617,360,64,118,182,4.479224376731302,33.99903056680281
Task_869,1137,518,129,163,292,2.1907514450867054,27.522937196372407
Task_870,1617,193,179,58,237,8.335051546391753,33.23793498615826
Task_871,575,588,47,161,208,0.9762308998302207,18.344287551777356
Task_872,1618,479,143,89,232,3.370833333333333,34.4480094165685
Task_873,825,135,72,88,160,6.0661764705882355,19.821250701117616
Task_874,1629,473,94,164,258,3.4367088607594938,35.10142522057654
Task_875,616,514,46,68,114,1.196116504854369,17.732963485549913
Task_876,1435,396,52,28,80,3.6146095717884132,29.385751181136698
Task_877,911,857,125,21,146,1.0617715617715617,23.12822734323899
Task_878,1353,680,150,108,258,1.986784140969163,31.21686291892203
Task_879,584,895,193,59,252,0.6517857142857143,19.261398680845677
Task_880,2935,443,162,29,191,6.61036036036036,54.43552271217627
Task_881,1042,524,150,58,208,1.9847619047619047,24.993281364806737
Task_882,1769,922,157,46,203,1.9165763813651138,37.517471432646666
Task_883,1692,322,188,56,244,5.238390092879257,34.876929906340905
Task_884,996,752,52,100,152,1.3227091633466135,25.033930962308474
Task_885,1787,415,87,163,250,4.295673076923077,37.303055351013406
Task_886,1398,288,134,149,283,4.837370242214533,30.853015051861743
Task_887,1272,187,67,171,238,6.76595744680851,28.571565665412802
Task_888,1949,494,21,90,111,3.937373737373737,38.91489719781718
Task_889,1006,496,81,86,167,2.024144869215292,24.387353578019326
Task_890,1036,147,147,117,264,7.0,24.19442318542005
Task_891,1337,888,50,151,201,1.5039370078740157,31.567558245493544
Task_892,670,384,18,15,33,1.7402597402597402,16.404175792907314
Task_893,2363,684,34,159,193,3.44963503649635,47.03719832722987
Task_894,1351,144,194,150,344,9.317241379310344,29.59693740237584
Task_895,1836,393,74,135,209,4.659898477157361,37.904396803994466
Task_896,1410,800,186,77,263,1.7602996254681649,32.10339675990971
Task_897,2636,212,78,92,170,12.375586854460094,49.381938963498015
Task_898,1642,240,60,182,242,6.813278008298755,34.5363733060147
Task_899,874,838,175,142,317,1.0417163289630513,24.307024456108504
Task_900,1194,301,157,186,343,3.9536423841059603,27.995566288566835
Task_901,748,873,156,115,271,0.8558352402745996,22.224250629314124
Task_902,1692,934,46,70,116,1.8096256684491978,36.111907570422936
Task_903,2966,657,159,71,230,4.507598784194529,56.0768432129056
Task_904,937,755,180,76,256,1.2394179894179893,24.38089045539657
Task_905,2668,871,96,43,139,3.0596330275229358,51.08038269149355
Task_906,2447,606,25,195,220,4.031301482701812,48.31580132660778
Task_907,2558,543,190,133,323,4.702205882352941,50.19702284189808
Task_908,569,275,39,49,88,2.0615942028985508,15.489318045987652
Task_909,2586,955,14,67,81,2.705020920502092,49.89948294540179
Task_910,2489,276,80,151,231,8.985559566787003,47.9529380244648
Task_911,1411,691,38,120,158,2.0390173410404624,31.436072285068942
Task_912,790,928,95,41,136,0.8503767491926802,21.611073079828486
Task_913,2053,602,189,154,343,3.4046434494195688,42.50912815257596
Task_914,1053,543,28,34,62,1.9356617647058822,23.466458459707326
Task_915,2085,213,123,179,302,9.742990654205608,41.57245650324902
Task_916,2815,844,59,133,192,3.331360946745562,54.78527349343121
Task_917,2453,984,52,21,73,2.4903553299492387,46.95611419761206
Task_918,2021,721,21,38,59,2.799168975069252,39.37596377462755
Task_919,1063,431,182,66,248,2.4606481481481484,25.274041526125853
Task_920,1182,729,128,153,281,1.6191780821917807,28.81701465097197
Task_921,2497,602,94,180,274,4.140961857379768,49.35152178122908
Task_922,2128,319,157,13,170,6.65,40.78342069767643
Task_923,1358,478,18,162,180,2.835073068893528,30.185175858340923
Task_924,1000,327,131,88,219,3.048780487804878,24.057909295296778
Task_925,1141,211,44,146,190,5.382075471698113,26.109638444562254
Task_926,2883,747,42,173,215,3.8542780748663104,55.57867500207175
Task_927,529,681,149,124,273,0.7756598240469208,18.206783976424507
Task_928,2195,107,158,79,237,20.324074074074073,41.4488451318379
Task_929,2598,285,57,168,225,9.083916083916083,49.73737494267886
Task_930,1876,329,57,114,171,5.684848484848485,37.95251025970618
Task_931,1511,890,67,57,124,1.6958473625140291,32.95154287486606
Task_932,2131,971,195,24,219,2.19238683127572,43.42086048030719
Task_933,1319,854,68,105,173,1.5426900584795322,30.843661523167082
Task_934,2991,960,83,77,160,3.1123829344432883,56.9750774108771
Task_935,2210,917,95,92,187,2.4074074074074074,45.11811997527183
Task_936,1722,476,199,161,360,3.610062893081761,36.954693092974864
Task_937,1158,475,74,18,92,2.4327731092436973,25.363647931759292
Task_938,1220,193,170,105,275,6.288659793814433,27.619265914779913
Task_939,1176,600,124,52,176,1.956738768718802,27.13074654485413
Task_940,1313,605,100,177,277,2.1666666666666665,30.53564361278812
Task_941,1573,896,105,75,180,1.7536231884057971,34.409470094578985
Task_942,1555,67,144,75,219,22.86764705882353,30.947383816373957
Task_943,2901,579,183,77,260,5.001724137931035,55.019294290708075
Task_944,1513,386,181,19,200,3.909560723514212,31.542771334234857
Task_945,2580,481,124,172,296,5.352697095435684,50.28056450365813
Task_946,2691,892,110,182,292,3.013437849944009,53.33879669279698
Task_947,2507,530,120,139,259,4.721280602636535,49.06808362033612
Task_948,2763,475,28,88,116,5.804621848739496,51.85062307718939
Task_949,1315,120,46,85,131,10.867768595041323,27.27855266113175
Task_950,2492,999,64,165,229,2.492,50.33850821322176
Task_951,865,784,162,111,273,1.1019108280254777,23.73713574428699
Task_952,1263,245,191,112,303,5.134146341463414,28.610527633209355
Task_953,1918,385,174,173,347,4.9689119170984455,39.72153645786531
Task_954,973,65,190,173,363,14.742424242424242,23.04143866502073
Task_955,2457,84,71,82,153,28.905882352941177,44.81588959764858
Task_956,2618,829,120,98,218,3.1542168674698794,51.53147886574402
Task_957,1591,726,160,175,335,2.1884456671251717,35.575756927055856
Task_958,2754,548,126,126,252,5.016393442622951,52.98629361176793
Task_959,1947,835,187,172,359,2.3289473684210527,41.65968587762436
Task_960,767,289,145,85,230,2.6448275862068966,20.273731171484282
Task_961,2056,887,32,199,231,2.315315315315315,43.05115671657055
Task_962,2180,395,45,179,224,5.505050505050505,43.354478837277746
Task_963,1830,164,180,71,251,11.090909090909092,36.326729212489106
Task_964,1074,886,162,69,231,1.2108229988726043,26.732372437920716
Task_965,1751,795,130,196,326,2.199748743718593,38.316047708423724
Task_966,642,1004,64,180,244,0.6388059701492538,21.14255354118821
Task_967,2148,956,116,66,182,2.2445141065830723,43.610662530559914
Task_968,2660,409,65,145,210,6.487804878048781,51.00842235555422
Task_969,504,414,50,171,221,1.2144578313253012,16.87417638835835
Task_970,1778,831,40,82,122,2.137019230769231,37.39944208421294
Task_971,2049,663,23,99,122,3.085843373493976,41.37612267230602
Task_972,1330,695,166,193,359,1.910919540229885,31.47916021991341
Task_973,2006,749,122,133,255,2.6746666666666665,41.799753994366185
Task_974,1520,670,42,71,113,2.2652757078986587,32.657220715777186
Task_975,1753,410,55,152,207,4.265206812652068,36.68904840639224
Task_976,703,999,178,31,209,0.703,21.13284226655395
Task_977,832,470,46,117,163,1.7664543524416136,21.74279121390603
Task_978,1249,700,126,106,232,1.781740370898716,29.498329857140778
Task_979,2204,268,116,114,230,8.193308550185874,43.23388210525375
Task_980,2857,874,40,182,222,3.265142857142857,55.609622751467725
Task_981,1853,638,155,88,243,2.899843505477308,38.655828412680926
Task_982,992,341,32,152,184,2.9005847953216373,24.033868506204055
Task_983,918,843,52,163,215,1.0876777251184835,24.658275151913006
Task_984,1145,818,68,119,187,1.398046398046398,28.062384503085898
Task_985,1232,819,46,148,194,1.502439024390244,29.49866480997751
Task_986,906,321,66,71,137,2.813664596273292,21.924727269018533
Task_987,1352,771,30,51,81,1.7512953367875648,29.61193370567319
Task_988,1468,816,157,147,304,1.7968176254589963,33.726826727670094
Task_989,1904,373,140,38,178,5.090909090909091,37.66837651031585
Task_990,516,829,114,46,160,0.6216867469879518,17.295148305186938
Task_991,1790,249,165,76,241,7.16,36.256974206415684
Task_992,2150,465,143,118,261,4.613733905579399,43.18509427545505
Task_993,2704,826,79,29,108,3.2696493349455866,51.26363037217795
Task_994,1420,85,10,85,95,16.511627906976745,28.05837407633297
Task_995,1065,184,175,153,328,5.756756756756757,25.294273613204002
Task_996,1233,437,103,172,275,2.815068493150685,28.72339658591518
Task_997,1555,883,91,145,236,1.759049773755656,35.03995813146995
Task_998,2959,384,92,151,243,7.685714285714286,55.76536328368704
Task_999,2118,967,153,37,190,2.18801652892562,43.1453735483021
Task_1000,1296,771,112,11,123,1.6787564766839378,28.757537360632156
Task_1001,1871,571,52,198,250,3.270979020979021,39.344010591237726
Task_1002,1533,213,173,74,247,7.163551401869159,32.09809640996884
Task_1003,726,564,130,35,165,1.2849557522123893,19.651689566559856
Task_1004,677,661,84,183,267,1.0226586102719033,20.456132639836586
Task_1005,2580,965,170,200,370,2.670807453416149,52.18586754599886
Task_1006,592,469,107,109,216,1.2595744680851064,18.214070914072234
Task_1007,2872,833,181,187,368,3.4436450839328536,56.37160104439744
Task_1008,1126,309,46,198,244,3.632258064516129,26.55225746960606
Task_1009,939,803,87,17,104,1.1679104477611941,22.91775872696475
Task_1010,1960,627,98,55,153,3.121019108280255,39.396223439550916
Task_1011,597,201,182,172,354,2.9554455445544554,18.26271920558972
Task_1012,822,549,117,72,189,1.4945454545454546,21.570175328185268
Task_1013,1059,223,125,45,170,4.727678571428571,23.677397198823027
Task_1014,528,789,146,165,311,0.6683544303797468,18.87117126868607
Task_1015,2359,229,30,139,169,10.256521739130434,45.15829722802203
Task_1016,2780,252,80,133,213,10.988142292490119,52.35615120469638
Task_1017,2260,471,64,77,141,4.788135593220339,43.904508237829795
Task_1018,2989,809,31,36,67,3.6901234567901233,54.985888745987126
Task_1019,2629,739,184,181,365,3.5527027027027027,52.203822977444226
Task_1020,2531,598,11,114,125,4.225375626043406,48.80478202776354
Task_1021,2720,750,131,71,202,3.621837549933422,52.348364588552194
Task_1022,2608,818,23,39,62,3.184371184371184,48.98778230543265
Task_1023,1860,453,35,20,55,4.096916299559472,35.777326174144235
Task_1024,2682,496,13,165,178,5.396378269617706,51.27975952277895
Task_1025,2538,418,72,67,139,6.05727923627685,47.98388497657199
Task_1026,764,199,170,90,260,3.82,20.19951788717979
Task_1027,1515,790,69,56,125,1.9152970922882426,32.82432442665369
Task_1028,664,596,51,16,67,1.1122278056951425,17.320894982172067
Task_1029,1638,321,157,135,292,5.086956521739131,34.7776811025475
Task_1030,2207,350,114,174,288,6.287749287749287,43.91302193370236
Task_1031,2752,428,124,66,190,6.414918414918415,51.7201271376642
Task_1032,2309,469,40,29,69,4.912765957446808,43.12127441155536
Task_1033,1673,538,62,38,100,3.103896103896104,33.7742681575354
Task_1034,2270,393,173,71,244,5.761421319796955,44.26779731456504
Task_1035,1024,959,132,103,235,1.0666666666666667,26.62273806687645
Task_1036,2570,177,113,163,276,14.438202247191011,48.53128685765838
Task_1037,2329,303,116,197,313,7.661184210526316,45.828502987502965
Task_1038,508,612,122,124,246,0.8287112561174551,17.507020905529966
Task_1039,2642,259,83,158,241,10.161538461538461,50.29080611241552
Task_1040,1007,176,79,66,145,5.6892655367231635,22.661907690821483
Task_1041,1211,691,53,180,233,1.75,29.15114751657683
Task_1042,1494,789,171,35,206,1.8911392405063292,32.778955252245346
Task_1043,569,598,124,167,291,0.9499165275459098,18.712277431839276
Task_1044,872,716,167,46,213,1.2161785216178522,22.691514462895316
Task_1045,2702,252,63,25,88,10.679841897233201,48.90287464112486
Task_1046,2207,567,15,182,197,3.88556338028169,44.26221203833609
Task_1047,504,785,22,97,119,0.6412213740458015,17.050905762139653
Task_1048,1889,955,137,173,310,1.9759414225941423,40.894874649242446
Task_1049,2447,374,147,40,187,6.525333333333333,46.41320464702641
Task_1050,1795,236,26,188,214,7.5738396624472575,36.73467052198695
Task_1051,2027,409,137,56,193,4.943902439024391,40.233297513962974
Task_1052,588,414,41,135,176,1.416867469879518,17.677031864457977
Task_1053,2915,88,115,30,145,32.752808988764045,51.50743301867397
Task_1054,640,610,56,43,99,1.0474631751227497,17.59872455163814
Task_1055,827,587,16,110,126,1.4064625850340136,21.653317157945423
Task_1056,786,178,40,101,141,4.391061452513966,19.245220000812157
Task_1057,1635,857,11,38,49,1.9055944055944056,33.707934769770056
Task_1058,1955,98,112,164,276,19.747474747474747,38.14986971128391
Task_1059,1832,946,22,44,66,1.9345300950369588,37.04803470615484
Task_1060,555,976,94,47,141,0.5680655066530195,18.320741322168914
Task_1061,2587,702,11,95,106,3.6799431009957324,49.69803527010774
Task_1062,2898,224,38,178,216,12.88,54.076676998024084
Task_1063,1749,993,89,110,199,1.7595573440643864,38.228099436464994
Task_1064,784,395,94,65,159,1.97979797979798,20.12065519560463
Task_1065,2342,267,170,152,322,8.738805970149254,45.88163491058111
Task_1066,920,881,172,42,214,1.0430839002267573,23.952776148528642
Task_1067,802,87,131,63,194,9.113636363636363,19.054088345047237
Task_1068,1679,922,144,75,219,1.819068255687974,36.54663667603612
Task_1069,1411,647,111,138,249,2.177469135802469,32.03582551334065
Task_1070,2324,841,26,48,74,2.7600950118764844,44.606734643034315
Task_1071,2217,643,60,72,132,3.4425465838509317,43.75166548213531
Task_1072,2299,356,192,26,218,6.439775910364146,44.14886695118289
Task_1073,2431,846,58,158,216,2.8701298701298703,48.8520901328688
Task_1074,1239,635,187,21,208,1.9481132075471699,28.14210817565341
Task_1075,1728,859,166,61,227,2.0093023255813955,36.97806244538772
Task_1076,1985,851,89,31,120,2.32981220657277,39.983398743264374
Task_1077,624,786,92,150,242,0.7928843710292249,19.998008600625226
Task_1078,1007,798,49,136,185,1.260325406758448,25.674239884498416
Task_1079,634,351,103,33,136,1.8011363636363635,17.238871507023546
Task_1080,1250,269,32,115,147,4.62962962962963,27.53446981496255
Task_1081,660,565,169,37,206,1.1660777385159011,18.929525559563945
Task_1082,1190,179,130,173,303,6.611111111111111,26.936048250796677
Task_1083,2217,457,33,131,164,4.8406113537117905,43.7377642921194
Task_1084,1015,627,86,195,281,1.6162420382165605,25.957895795509984
Task_1085,2871,686,67,180,247,4.179039301310044,55.45867206931953
Task_1086,2178,80,33,187,220,26.88888888888889,41.37930130914882
Task_1087,2518,244,14,127,141,10.277551020408163,47.46287345759149
Task_1088,2771,240,88,48,136,11.49792531120332,50.6465294575203
Task_1089,2927,813,190,47,237,3.595823095823096,55.68710693517472
Task_1090,599,159,70,45,115,3.74375,15.457372130442481
Task_1091,2792,465,54,193,247,5.991416309012876,53.55325097292359
Task_1092,1005,86,40,82,122,11.551724137931034,21.92659504698891
Task_1093,2941,622,81,149,230,4.720706260032102,56.22311064984325
Task_1094,2562,908,32,130,162,2.8184818481848186,50.454436788461294
Task_1095,2159,206,69,55,124,10.429951690821255,41.07746553830955
Task_1096,508,740,44,85,129,0.6855600539811066,17.20299609840366
Task_1097,619,458,153,100,253,1.3485838779956427,18.826181638550906
Task_1098,2853,976,162,92,254,2.9201637666325486,55.764462086030285
Task_1099,2738,506,111,40,151,5.400394477317554,51.034620046461555
Task_1100,2404,474,196,33,229,5.0610526315789475,46.29540307245197
Task_1101,1886,506,100,195,295,3.719921104536489,39.4036022993516
Task_1102,2180,1019,90,165,255,2.1372549019607843,45.49487353449873
Task_1103,794,978,31,10,41,0.8110316649642493,20.55300729300676
Task_1104,1476,571,53,46,99,2.5804195804195804,30.70834633532095
Task_1105,1130,606,33,194,227,1.8616144975288302,27.488050130777527
Task_1106,591,805,185,64,249,0.7332506203473945,19.006180504498698
Task_1107,1207,275,178,55,233,4.3731884057971016,27.00151855622585
Task_1108,1198,119,144,185,329,9.983333333333333,26.929559532096942
Task_1109,2015,473,195,95,290,4.251054852320675,41.14278769881309
Task_1110,1580,733,45,160,205,2.1525885558583107,34.815608652575975
Task_1111,1266,397,127,118,245,3.180904522613065,28.90372028776102
Task_1112,1479,215,132,48,180,6.847222222222222,30.404628917091262
Task_1113,2964,475,116,176,292,6.226890756302521,56.327488000332416
Task_1114,2613,101,42,108,150,25.61764705882353,47.48293129571434
Task_1115,1082,546,86,61,147,1.9780621572212065,25.19744313729396
Task_1116,558,378,142,116,258,1.4722955145118735,17.643168313362455
Task_1117,2772,911,25,152,177,3.039473684210526,53.989868553654254
Task_1118,1508,156,120,155,275,9.605095541401274,31.812330257785632
Task_1119,1693,493,131,182,313,3.4271255060728745,36.368787067780936
Task_1120,1095,670,56,149,205,1.631892697466468,27.06557926036343
Task_1121,2991,337,51,34,85,8.849112426035504,53.884687185157
Task_1122,1949,92,190,142,332,20.956989247311828,38.30286647787515
Task_1123,578,656,85,141,226,0.8797564687975646,18.693924171724657
Task_1124,1800,331,192,113,305,5.421686746987952,37.39927646945162
Task_1125,2485,669,152,24,176,3.708955223880597,47.722985473235404
Task_1126,2532,867,190,127,317,2.9170506912442398,50.77329988337575
Task_1127,664,537,157,140,297,1.2342007434944238,19.95897864466654
Task_1128,2246,658,67,37,104,3.4081942336874054,43.308029979083585
Task_1129,834,863,11,189,200,0.9652777777777778,23.287018543864615
Task_1130,2644,985,171,54,225,2.6815415821501016,51.93897610662793
Task_1131,2618,508,37,164,201,5.143418467583497,50.54978280294477
Task_1132,2158,840,58,106,164,2.5659928656361473,44.081985829691824
Task_1133,998,631,138,65,203,1.5791139240506329,24.673675698188006
Task_1134,2093,795,73,192,265,2.629396984924623,43.58053699285034
Task_1135,1399,568,193,31,224,2.4586994727592266,30.65858303051766
Task_1136,2809,966,152,126,278,2.904860392967942,55.294706152281776
Task_1137,2876,886,138,160,298,3.2423900789177003,56.24614484924731
Task_1138,2724,389,85,18,103,6.984615384615385,49.78431894907997
Task_1139,1945,978,180,63,243,1.9867211440245147,40.92941642556677
Task_1140,1872,827,176,15,191,2.260869565217391,38.63578291738987
Task_1141,694,354,105,42,147,1.9549295774647888,18.204269786648887
Task_1142,1516,250,11,178,189,6.039840637450199,32.183011996555386
Task_1143,2440,759,21,15,36,3.210526315789474,45.64501568052958
Task_1144,1805,442,85,159,244,4.074492099322799,37.68099283485044
Task_1145,892,750,50,90,140,1.1877496671105192,23.2159711294552
Task_1146,850,1023,145,154,299,0.830078125,24.47892213850601
Task_1147,2506,461,24,191,215,5.424242424242424,48.749744669108104
Task_1148,617,346,38,44,82,1.7780979827089338,16.350777672031512
Task_1149,871,228,138,111,249,3.8034934497816595,22.116141567438245
Task_1150,2944,823,69,86,155,3.5728155339805827,55.98299661648678
Task_1151,2340,421,107,65,172,5.545023696682464,45.036961662751416
Task_1152,2657,331,69,38,107,8.00301204819277,48.86794398350771
Task_1153,2827,821,121,28,149,3.4391727493917275,53.445524792045354
Task_1154,1672,912,67,112,179,1.8313253012048192,36.58330985812521
Task_1155,2568,70,12,86,98,36.16901408450704,45.839747369597234
Task_1156,705,365,159,38,197,1.9262295081967213,18.941752226193735
Task_1157,519,644,176,54,230,0.8046511627906977,17.247639493053352
Task_1158,1224,759,76,120,196,1.6105263157894736,29.282372986147223
Task_1159,861,577,49,13,62,1.4896193771626298,20.333524180165195
Task_1160,2017,976,94,22,116,2.0644831115660183,40.90480634499325
Task_1161,681,665,150,84,234,1.0225225225225225,19.988574403421527
Task_1162,2367,277,116,160,276,8.514388489208633,46.11689402778686
Task_1163,2611,434,153,48,201,6.002298850574713,49.318703822681975
Task_1164,2144,699,189,134,323,3.0628571428571427,44.1368794455906
Task_1165,1961,341,21,83,104,5.733918128654971,38.403196098691886
Task_1166,730,767,184,77,261,0.9505208333333334,21.25866074537025
Task_1167,1663,797,165,61,226,2.0839598997493733,35.75062285608487
Task_1168,1640,183,62,159,221,8.91304347826087,33.988021575404915
Task_1169,545,129,111,76,187,4.1923076923076925,15.44908437142936
Task_1170,2877,490,78,60,138,5.8594704684317716,53.450578215513076
Task_1171,950,474,192,73,265,2.0,23.76379625673391
Task_1172,1989,348,104,200,304,5.699140401146132,40.568280520820075
Task_1173,2895,670,153,25,178,4.3144560357675115,54.21773058603656
Task_1174,2128,314,162,155,317,6.7555555555555555,42.64463477647835
Task_1175,1500,876,37,39,76,1.710376282782212,31.49671005480867
Task_1176,855,175,40,112,152,4.857954545454546,20.424941249359907
Task_1177,2247,119,22,189,211,18.725,42.82766466489471
Task_1178,2329,171,70,18,88,13.540697674418604,42.50223756007313
Task_1179,2141,166,103,196,299,12.820359281437126,41.95927728635751
Task_1180,520,1023,25,118,143,0.5078125,18.288571487518283
Task_1181,1782,337,75,39,114,5.272189349112426,35.164114940199774
Task_1182,1587,522,54,85,139,3.0344168260038242,33.53878188787878
Task_1183,934,82,119,139,258,11.25301204819277,21.94607285124523
Task_1184,2073,626,170,100,270,3.3062200956937797,42.4935692461515
Task_1185,1137,259,131,128,259,4.373076923076923,26.492000536457194
Task_1186,1648,482,49,119,168,3.412008281573499,34.84809608982979
Task_1187,610,701,114,73,187,0.8689458689458689,18.710799570982086
Task_1188,1733,843,182,24,206,2.0533175355450237,36.6574193433041
Task_1189,1649,442,155,15,170,3.7223476297968396,33.590739064944124
Task_1190,2425,962,190,94,284,2.518172377985462,49.12177218142085
Task_1191,1539,239,127,13,140,6.4125,30.990726146469967
Task_1192,1877,388,130,194,324,4.825192802056555,39.00977322298067
Task_1193,2007,474,168,160,328,4.225263157894737,41.31405424281545
Task_1194,2371,372,50,185,235,6.35656836461126,46.54782180531142
Task_1195,2055,816,119,147,266,2.515299877600979,42.855693349178715
Task_1196,643,883,130,177,307,0.7273755656108597,20.880143094373462
Task_1197,2230,261,109,109,218,8.511450381679388,43.558362855210305
Task_1198,1699,968,113,160,273,1.7533539731682146,37.72518873579201
Task_1199,2109,927,131,157,288,2.2726293103448274,44.17129135689436
Task_1200,2681,571,147,102,249,4.687062937062937,51.855528602080994
Task_1201,2612,888,143,69,212,2.938132733408324,51.078057674767656
Task_1202,1639,844,186,194,380,1.9396449704142011,36.9346584713059
Task_1203,2604,842,98,194,292,3.088967971530249,51.835277715415906
Task_1204,2420,449,164,12,176,5.377777777777778,45.91029870655918
Task_1205,537,72,133,110,243,7.3561643835616435,15.5614088373627
Task_1206,1738,458,71,104,175,3.786492374727669,36.29411234142647
Task_1207,1379,173,25,48,73,7.925287356321839,27.48764450066866
Task_1208,2445,721,140,102,242,3.386426592797784,48.56215783234933
Task_1209,1864,473,134,30,164,3.932489451476793,37.36938109143416
Task_1210,892,243,166,135,301,3.6557377049180326,22.76726666796918
Task_1211,704,949,187,175,362,0.7410526315789474,22.21087029334159
Task_1212,817,617,158,63,221,1.3220064724919094,21.835052696325732
Task_1213,2255,802,182,38,220,2.808219178082192,44.96278969712338
Task_1214,1613,621,124,163,287,2.5932475884244375,35.361513997393
Task_1215,2241,457,164,28,192,4.893013100436681,43.454727559663304
Task_1216,2461,361,26,64,90,6.798342541436464,46.03559529818804
Task_1217,2614,360,191,24,215,7.240997229916897,49.105973264137596
Task_1218,743,342,71,153,224,2.1661807580174925,20.537956402178224
Task_1219,1802,522,39,97,136,3.445506692160612,37.05600152134207
Task_1220,934,78,79,150,229,11.822784810126583,21.924510757024095
Task_1221,1560,743,116,147,263,2.096774193548387,34.77218272166521
Task_1222,1060,277,63,60,123,3.8129496402877696,23.830492688387682
Task_1223,2464,389,67,177,244,6.317948717948718,48.03752493099694
Task_1224,708,991,32,57,89,0.7137096774193549,20.369179203265833
Task_1225,1584,410,185,10,195,3.854014598540146,32.8004642771304
Task_1226,2060,599,115,96,211,3.433333333333333,41.9541327391007
Task_1227,737,91,14,189,203,8.01086956521739,18.74394954474207
Task_1228,1290,365,168,74,242,3.5245901639344264,28.745667131975228
Task_1229,1794,834,72,180,252,2.148502994011976,38.88889879290272
Task_1230,1821,908,52,21,73,2.0033003300330035,36.70477762814463
Task_1231,1934,828,198,146,344,2.332931242460796,41.32615971795991
Task_1232,775,163,18,45,63,4.725609756097561,17.85916961042062
Task_1233,1426,385,34,138,172,3.694300518134715,31.05698856951835
Task_1234,720,447,199,12,211,1.6071428571428572,19.313757604814096
Task_1235,1921,149,69,45,114,12.806666666666667,36.14640051136253
Task_1236,2713,498,150,134,284,5.43687374749499,52.33148132044314
Task_1237,2018,864,151,24,175,2.3329479768786126,41.02968282872671
Task_1238,1454,152,117,23,140,9.50326797385621,29.129995518746778
Task_1239,1373,425,84,85,169,3.223004694835681,29.88047583144431
Task_1240,1339,321,147,142,289,4.158385093167702,30.046072222085215
Task_1241,2404,149,43,164,207,16.026666666666667,45.608619735093846
Task_1242,1076,756,127,27,154,1.4214002642007926,25.4495526787971
Task_1243,2250,295,108,136,244,7.601351351351352,44.15127514024521
Task_1244,1549,271,76,71,147,5.694852941176471,31.9419517945684
Task_1245,1955,240,39,117,156,8.112033195020746,38.56937115116464
Task_1246,2065,970,168,118,286,2.126673532440783,43.54168684704084
Task_1247,2575,259,54,168,222,9.903846153846153,49.26656648005386
Task_1248,1217,158,170,167,337,7.654088050314465,27.53188757676612
Task_1249,1209,256,45,36,81,4.7042801556420235,25.457482795288147
Task_1250,587,78,173,23,196,7.430379746835443,15.30315655929175
Task_1251,1783,392,107,68,175,4.536895674300254,36.15317972068538
Task_1252,2176,167,98,28,126,12.952380952380953,40.64242957595499
Task_1253,2809,101,152,92,244,27.53921568627451,51.31203937977529
Task_1254,1490,883,93,71,164,1.6855203619909502,33.11616227994974
Task_1255,2656,402,180,70,250,6.590570719602978,50.42229798094337
Task_1256,2492,530,108,110,218,4.6930320150659135,48.603286006751794
Task_1257,1904,277,118,130,248,6.848920863309353,38.62847768435633
Task_1258,676,588,72,92,164,1.1477079796264855,19.586329585130464
Task_1259,2174,540,90,10,100,4.018484288354898,41.71529522961103
Task_1260,1354,452,89,56,145,2.988962472406181,29.347307703067216
Task_1261,1447,363,29,43,72,3.9752747252747254,29.170125973776155
Task_1262,1918,356,196,133,329,5.372549019607843,39.48623065930378
Task_1263,2280,355,50,36,86,6.404494382022472,42.746798361935056
Task_1264,1695,565,87,148,235,2.9946996466431095,36.235884089306865
Task_1265,1495,988,114,58,172,1.5116279069767442,33.349188130317174
Task_1266,1245,211,97,86,183,5.872641509433962,27.193166279814363
Task_1267,2852,148,111,179,290,19.140939597315437,53.0376746299032
Task_1268,1877,1021,116,81,197,1.8365949119373777,39.942389297031504
Task_1269,2990,368,129,87,216,8.102981029810298,55.654100054849486
Task_1270,951,393,200,29,229,2.4137055837563453,23.04735380810879
Task_1271,2923,909,30,45,75,3.2120879120879122,54.21051671538647
Task_1272,1551,116,130,64,194,13.256410256410257,31.245980595888213
Task_1273,2629,463,104,62,166,5.665948275862069,49.61620413947099
Task_1274,1399,373,58,161,219,3.7406417112299466,31.031242175574217
Task_1275,2447,719,146,135,281,3.3986111111111112,48.811690921516295
Task_1276,535,1005,189,54,243,0.5318091451292246,18.90491922631409
Task_1277,1754,338,87,199,286,5.174041297935103,36.74397271669923
Task_1278,2609,949,66,60,126,2.7463157894736843,50.64255542932158
Task_1279,610,750,26,135,161,0.8122503328894807,18.840835981253022
Task_1280,802,575,26,162,188,1.3923611111111112,21.81785464226232
Task_1281,929,149,67,141,208,6.193333333333333,22.421657308314064
Task_1282,1363,307,147,62,209,4.425324675324675,29.40901156133783
Task_1283,3000,853,128,93,221,3.51288056206089,57.596785104648575
Task_1284,2924,144,117,143,260,20.16551724137931,53.9894220111178
Task_1285,587,388,29,177,206,1.5089974293059125,18.044811942472165
Task_1286,778,574,39,67,106,1.3530434782608696,20.227205188262193
Task_1287,1177,847,145,129,274,1.3879716981132075,28.98256488052019
Task_1288,2092,391,16,125,141,5.336734693877551,41.14763053908292
Task_1289,1948,216,107,143,250,8.976958525345623,39.13340402334464
Task_1290,583,99,101,144,245,5.83,16.495580924003995
Task_1291,1891,292,115,42,157,6.453924914675768,36.94067691094288
Task_1292,2528,243,93,59,152,10.360655737704919,47.10297002666902
Task_1293,1077,302,142,129,271,3.5544554455445545,25.74091736935594
Task_1294,2590,878,23,18,41,2.9465301478953356,48.511311532244044
Task_1295,2030,634,116,118,234,3.1968503937007875,41.701927254992505
Task_1296,2911,642,26,12,38,4.527216174183515,52.7934924600409
Task_1297,2763,562,60,166,226,4.907637655417407,53.24326664768264
Task_1298,2022,117,169,196,365,17.135593220338983,40.03863260211417
Task_1299,1543,950,62,135,197,1.622502628811777,34.946101619811955
Task_1300,1651,596,74,171,245,2.765494137353434,35.83895022277571
Task_1301,2141,172,36,35,71,12.375722543352602,39.465125845898534
Task_1302,1759,644,87,38,125,2.727131782945736,35.86911763678922
Task_1303,2903,228,69,16,85,12.676855895196507,51.98724838342475
Task_1304,2118,344,124,187,311,6.139130434782609,42.60784175085258
Task_1305,685,958,154,94,248,0.7142857142857143,21.40995607916737
Task_1306,2640,625,163,77,240,4.217252396166134,50.94279048586514
Task_1307,1875,961,96,187,283,1.949064449064449,40.64335451328335
Task_1308,1659,869,162,80,242,1.9068965517241379,36.2549977085309
Task_1309,2002,149,200,76,276,13.346666666666666,39.06922120309407
Task_1310,1849,419,121,106,227,4.402380952380953,38.101426484596125
Task_1311,629,363,123,112,235,1.728021978021978,18.650152328900678
Task_1312,2023,806,20,149,169,2.506815365551425,41.67910279285788
Task_1313,1603,572,104,126,230,2.7975567190226878,34.7378322336601
Task_1314,2583,516,110,137,247,4.996131528046422,50.16925424336578
Task_1315,502,227,101,87,188,2.2017543859649122,15.675164623149824
Task_1316,2524,554,180,159,339,4.5477477477477475,49.80417665472235
Task_1317,1022,412,167,58,225,2.4745762711864407,24.40048559712785
Task_1318,1981,384,72,11,83,5.1454545454545455,37.99162757655311
Task_1319,2907,664,33,134,167,4.371428571428571,55.26997450529058
Task_1320,1035,886,197,109,306,1.1668545659526495,26.945471605148544
Task_1321,2973,343,138,129,267,8.642441860465116,55.84469005210199
Task_1322,545,179,118,123,241,3.0277777777777777,16.40824506329162
Task_1323,706,650,170,131,301,1.0844854070660521,20.958637062175526
Task_1324,1697,499,146,161,307,3.394,36.39338603531261
Task_1325,2943,415,14,185,199,7.074519230769231,55.432949694850436
Task_1326,2495,905,87,34,121,2.753863134657837,48.24832084605196
Task_1327,1075,717,156,150,306,1.4972144846796658,27.163697637691826
Task_1328,1879,180,20,34,54,10.38121546961326,35.42318556693264
Task_1329,1398,214,195,86,281,6.502325581395349,30.23377132557704
Task_1330,2834,1014,135,12,147,2.7921182266009854,54.06259551026693
Task_1331,2137,612,199,116,315,3.4861337683523654,43.689170320752545
Task_1332,2304,319,116,176,292,7.2,45.36296948838168
Task_1333,1979,587,116,115,231,3.3656462585034013,40.727803984384444
Task_1334,531,954,48,139,187,0.556020942408377,18.806424839867294
Task_1335,1897,335,26,110,136,5.645833333333333,37.93021847389808
Task_1336,2881,909,19,160,179,3.165934065934066,55.66339389534977
Task_1337,2382,763,82,127,209,3.1178010471204187,47.676532805493174
Task_1338,1115,882,156,55,211,1.2627406568516422,27.333830743695998
Task_1339,1788,1017,125,126,251,1.756385068762279,39.13862796904015
Task_1340,635,534,149,134,283,1.1869158878504673,19.459741732098596
Task_1341,810,748,173,143,316,1.081441922563418,22.995002557784364
Task_1342,575,505,93,118,211,1.1363636363636365,18.183943311148028
Task_1343,829,158,165,194,359,5.213836477987422,21.554287337805658
Task_1344,2308,962,188,200,388,2.3966770508826585,47.94741044190827
Task_1345,2179,318,31,79,110,6.830721003134796,41.94294383000476
Task_1346,1366,286,114,75,189,4.7595818815331015,29.41211701157377
Task_1347,2714,554,41,106,147,4.89009009009009,51.585948390510644
Task_1348,2976,664,145,90,235,4.475187969924812,56.57890933194725
Task_1349,1947,831,161,183,344,2.340144230769231,41.59572673764915
Task_1350,2430,833,180,17,197,2.9136690647482015,47.46649595388296
Task_1351,1826,223,44,22,66,8.151785714285714,34.60409082984405
Task_1352,796,119,157,93,250,6.633333333333334,20.05755371363889
Task_1353,1785,546,91,66,157,3.263254113345521,36.37289743153284
Task_1354,1503,368,29,38,67,4.073170731707317,30.076150319770665
Task_1355,510,869,183,25,208,0.5862068965517241,17.738141460880446
Task_1356,1733,171,116,170,286,10.075581395348838,35.420050312741516
Task_1357,2457,333,131,184,315,7.3562874251497,47.94595876373205
Task_1358,1639,740,152,111,263,2.211875843454791,35.961530862260574
Task_1359,1108,738,30,32,62,1.4993234100135318,24.97455412655221
Task_1360,1825,682,185,80,265,2.67203513909224,38.4047276240452
Task_1361,562,845,114,78,192,0.6643026004728132,18.731814277796396
Task_1362,2713,763,67,156,223,3.5510471204188483,53.055698715073284
Task_1363,2538,968,91,20,111,2.6191950464396285,48.879872819539656
Task_1364,897,210,22,147,169,4.251184834123222,21.943265144329985
Task_1365,2105,659,12,18,30,3.1893939393939394,40.02953889038775
Task_1366,2339,668,149,73,222,3.4962630792227203,46.17645919945152
Task_1367,2476,608,67,110,177,4.06568144499179,48.354922144745736
Task_1368,2765,888,152,192,344,3.1102362204724407,54.74784251427059
Task_1369,1978,728,185,189,374,2.713305898491084,41.9088351616412
Task_1370,1965,522,36,135,171,3.75717017208413,39.87285153315123
Task_1371,2409,980,12,199,211,2.45565749235474,48.80676998183932
Task_1372,805,823,183,194,377,0.9769417475728155,23.560941144646886
Task_1373,2339,177,94,142,236,13.140449438202246,44.774520683790485
Task_1374,2569,964,90,37,127,2.6621761658031087,49.73835997317548
Task_1375,1592,523,45,198,243,3.0381679389312977,34.573150520646955
Task_1376,1492,994,132,77,209,1.499497487437186,33.741419987376915
Task_1377,1488,885,56,139,195,1.6794582392776525,33.900388411210855
Task_1378,728,653,84,170,254,1.1131498470948011,21.168520935665498
Task_1379,2219,178,122,70,192,12.396648044692737,42.210205887465534
Task_1380,2226,741,133,90,223,3.0,44.88777986324774
Task_1381,1179,644,140,186,326,1.827906976744186,28.769347003781196
Task_1382,2004,363,138,82,220,5.5054945054945055,40.02052532686173
Task_1383,1796,589,199,82,281,3.0440677966101695,37.72980179002966
Task_1384,1074,699,131,179,310,1.5342857142857143,27.152432717032543
Task_1385,1540,336,90,167,257,4.56973293768546,33.215825865513914
Task_1386,2364,775,117,17,134,3.0463917525773194,45.7175551725579
Task_1387,2552,946,87,121,208,2.6948257655755015,50.84547141016635
Task_1388,2265,696,47,110,157,3.249641319942611,44.98963735455043
Task_1389,1467,792,180,162,342,1.849936948297604,33.82957422431341
Task_1390,2146,249,52,16,68,8.584,39.58321792338561
Task_1391,1394,594,46,114,160,2.342857142857143,30.874310197911697
Task_1392,2515,433,22,98,120,5.7949308755760365,47.82373284371457
Task_1393,1207,485,32,145,177,2.483539094650206,27.84403070987854
Task_1394,726,576,89,19,108,1.2582322357019065,18.89576398733855
Task_1395,2704,694,39,31,70,3.8906474820143884,50.078238235555524
Task_1396,2078,328,53,171,224,6.316109422492401,41.675566903597506
Task_1397,2503,905,15,18,33,2.7626931567328916,47.054411873080845
Task_1398,1445,911,146,58,204,1.5844298245614035,32.548637618481145
Task_1399,2487,539,75,65,140,4.605555555555555,47.57994934494376
Task_1400,562,970,63,129,192,0.5787847579814624,19.475850968372693
Task_1401,2959,778,122,196,318,3.798459563543004,57.36476675121228
Task_1402,2434,681,148,124,272,3.56891495601173,48.42923856863871
Task_1403,1203,726,93,118,211,1.65474552957359,28.885502850830434
Task_1404,1410,988,59,14,73,1.4256825075834176,30.191020064637
Task_1405,2568,284,68,120,188,9.010526315789473,48.948681126113875
Task_1406,2872,547,153,84,237,5.240875912408759,54.42860532703489
Task_1407,1267,64,24,26,50,19.49230769230769,24.144110387304654
Task_1408,2600,456,160,157,317,5.689277899343545,50.58829472003985
Task_1409,1537,296,151,157,308,5.175084175084175,33.20163056716134
Task_1410,2860,475,165,179,344,6.008403361344538,54.91996483157334
Task_1411,1545,651,56,101,157,2.3696319018404908,33.5384582261478
Task_1412,2444,172,150,118,268,14.127167630057803,46.469050036627344
Task_1413,2313,515,42,185,227,4.482558139534884,45.88517782355972
Task_1414,1416,607,108,78,186,2.3289473684210527,31.16971261897899
Task_1415,2343,483,71,143,214,4.840909090909091,46.25018612766263
Task_1416,579,379,112,138,250,1.5236842105263158,17.98586280780943
Task_1417,2498,409,77,57,134,6.092682926829268,47.211482548729236
Task_1418,782,397,35,60,95,1.964824120603015,19.515426528560184
Task_1419,709,242,15,50,65,2.9176954732510287,17.25777149933734
Task_1420,2968,816,148,125,273,3.6328029375764994,57.320109568069995
Task_1421,1534,712,61,30,91,2.1514726507713884,31.985232238768575
Task_1422,1544,653,95,52,147,2.36085626911315,33.00065512052144
Task_1423,2061,701,135,130,265,2.9358974358974357,42.56114567448812
Task_1424,1048,1001,89,84,173,1.0459081836327346,26.45638830305246
Task_1425,2845,659,38,143,181,4.3106060606060606,54.31729857837765
Task_1426,1757,886,32,147,179,1.9808342728297632,37.821665076228065
Task_1427,2924,774,89,162,251,3.7729032258064517,56.485658122330484
Task_1428,1356,638,40,45,85,2.1220657276995305,28.954054047373692
Task_1429,1819,816,127,30,157,2.226438188494492,37.51778190309588
Task_1430,2086,794,110,57,167,2.6238993710691823,42.034446123946964
Task_1431,830,597,198,101,299,1.3879598662207357,22.780956230537228
Task_1432,720,667,52,126,178,1.0778443113772456,20.56426876815613
Task_1433,1316,662,122,39,161,1.9849170437405732,29.043727238189465
Task_1434,2654,447,70,170,240,5.924107142857143,51.22595075600336
Task_1435,1163,465,196,36,232,2.495708154506438,26.635705262088212
Task_1436,877,881,32,45,77,0.9943310657596371,21.837443411566834
Task_1437,2587,172,82,162,244,14.953757225433526,48.7848694819583
Task_1438,1071,720,174,58,232,1.4854368932038835,26.156309460343113
Task_1439,1950,637,100,119,219,3.0564263322884013,40.37820258434891
Task_1440,2623,150,52,30,82,17.370860927152318,47.14253803025403
Task_1441,792,687,166,107,273,1.1511627906976745,22.336650513978537
Task_1442,2403,89,153,184,337,26.7,45.49880726072177
Task_1443,1433,440,129,155,284,3.249433106575964,31.913981792600406
Task_1444,802,381,34,66,100,2.099476439790576,19.989993698943987
Task_1445,2996,324,136,21,157,9.218461538461538,54.44121161971959
Task_1446,2998,185,63,47,110,16.118279569892472,53.50715648659939
Task_1447,1936,361,152,35,187,5.348066298342541,38.29349128765506
Task_1448,2807,156,156,100,256,17.878980891719745,52.12154410803179
Task_1449,2829,575,145,28,173,4.911458333333333,52.98211622331217
Task_1450,1434,582,143,13,156,2.4596912521440824,30.508804535328583
Task_1451,2286,590,54,139,193,3.8680203045685277,45.62200918130886
Task_1452,1839,609,101,27,128,3.0147540983606556,37.156565631548254
Task_1453,2221,518,159,104,263,4.279383429672447,44.46810483594644
Task_1454,1051,681,160,51,211,1.5410557184750733,25.670840699178637
Task_1455,2375,514,155,79,234,4.611650485436893,46.43326072745328
Task_1456,2632,176,134,188,322,14.870056497175142,49.7488764817355
Task_1457,1831,849,91,82,173,2.1541176470588237,38.574258032816275
Task_1458,2281,533,154,48,202,4.271535580524344,44.420214044663076
Task_1459,2097,822,54,63,117,2.547995139732685,42.167363128964816
Task_1460,888,469,30,32,62,1.8893617021276596,20.641376159441688
Task_1461,641,1001,72,198,270,0.6397205588822356,21.28254073027334
Task_1462,1755,324,112,156,268,5.4,36.560537298791665
Task_1463,743,1011,82,174,256,0.7341897233201581,22.674867145785072
Task_1464,1609,644,143,128,271,2.4945736434108525,35.246931940108674
Task_1465,1336,611,63,141,204,2.183006535947712,30.66488199688627
Task_1466,1414,101,147,49,196,13.862745098039216,28.6515944035777
Task_1467,1593,801,62,150,212,1.986284289276808,35.37829375455562
Task_1468,2600,566,112,56,168,4.585537918871252,49.50656485191676
Task_1469,1874,1017,23,115,138,1.8408644400785854,39.757132188373724
Task_1470,2082,682,142,44,186,3.048316251830161,41.51053454732873
Task_1471,2770,259,143,53,196,10.653846153846153,51.49570418611359
Task_1472,801,189,48,34,82,4.21578947368421,19.0396684451724
Task_1473,2447,635,46,188,234,3.84748427672956,48.44645268508217
Task_1474,2241,986,75,51,126,2.270516717325228,44.95865204096768
Task_1475,1640,709,200,36,236,2.3098591549295775,34.97360778368853
Task_1476,2758,226,76,85,161,12.14977973568282,51.08027852575264
Task_1477,696,466,108,89,197,1.4903640256959314,19.615764671641255
Task_1478,1476,186,146,171,317,7.893048128342246,32.066187972774145
Task_1479,1273,658,150,180,330,1.9317147192716237,30.311102136681956
Task_1480,1823,1002,67,162,229,1.8175473579262214,39.735990935040135
Task_1481,1880,303,90,194,284,6.184210526315789,38.64352996611821
Task_1482,1801,687,76,195,271,2.6177325581395348,38.65930197277995
Task_1483,1278,595,139,147,286,2.1442953020134228,29.94663112010149
Task_1484,986,204,167,115,282,4.809756097560975,24.00530361168141
Task_1485,1865,440,68,116,184,4.229024943310658,38.191820237610585
Task_1486,1348,653,189,25,214,2.0611620795107033,30.005453088801477
Task_1487,1520,831,175,158,333,1.8269230769230769,34.74417820902883
Task_1488,1364,658,172,188,360,2.069802731411229,31.89937946978016
Task_1489,2149,798,101,170,271,2.6896120150187737,44.34494267528627
Task_1490,1151,861,68,76,144,1.3352668213457077,27.567198371272227
Task_1491,1019,269,123,151,274,3.774074074074074,24.76170044122959
Task_1492,2753,421,121,113,234,6.523696682464455,52.45593508705141
Task_1493,2282,907,20,122,142,2.513215859030837,45.81952420774465
Task_1494,1985,236,187,23,210,8.375527426160337,38.71345033085018
Task_1495,574,129,95,26,121,4.415384615384616,15.070870113627317
Task_1496,1308,948,70,145,215,1.3782929399367756,31.26796382921037
Task_1497,1372,336,85,167,252,4.071216617210682,30.534251776915003
Task_1498,1963,246,11,73,84,7.947368421052632,37.77285136149654
Task_1499,1378,239,190,149,339,5.741666666666666,30.623221352458188
Task_1500,709,520,123,141,264,1.3608445297504799,20.533078884612674
Task_1501,1572,359,182,14,196,4.366666666666666,32.42556296979267
Task_1502,1925,607,57,93,150,3.1661184210526314,39.331755199696794
Task_1503,668,806,182,139,321,0.8277571251548946,21.00173205904846
Task_1504,1914,941,197,150,347,2.031847133757962,41.38055347956915
Task_1505,2717,881,136,51,187,3.080498866213152,52.54207753568296
Task_1506,1772,824,49,25,74,2.147878787878788,35.747617825977045
Task_1507,1694,896,54,42,96,1.8885172798216276,35.200242393919915
Task_1508,2834,255,44,118,162,11.0703125,52.583734364612475
Task_1509,1014,202,116,151,267,4.995073891625616,24.42555896823453
Task_1510,2258,308,50,145,195,7.307443365695793,44.30461107946141
Task_1511,1556,679,116,24,140,2.288235294117647,32.7725407535114
Task_1512,549,432,169,86,255,1.2678983833718245,17.295715685988313
Task_1513,958,546,41,71,112,1.7513711151736746,23.22457932831863
Task_1514,2956,144,125,79,204,20.386206896551723,53.874545694718876
Task_1515,1663,986,130,132,262,1.6849037487335359,37.119941561422344
Task_1516,2395,769,196,25,221,3.1103896103896105,46.98555580877348
Task_1517,863,903,178,21,199,0.9546460176991151,23.11963403677433
Task_1518,864,555,195,70,265,1.5539568345323742,22.596982147366447
Task_1519,1885,978,141,71,212,1.9254341164453523,39.87592832789047
Task_1520,1014,265,49,44,93,3.81203007518797,22.515667734516228
Task_1521,1189,952,155,118,273,1.2476390346274921,29.422608026992695
Task_1522,2885,738,20,105,125,3.903924221921516,54.808918237118725
Task_1523,656,886,28,129,157,0.7395715896279594,19.99511216978851
Task_1524,2240,904,23,170,193,2.4751381215469612,45.86245175713439
Task_1525,1056,215,25,41,66,4.888888888888889,22.469426327322633
Task_1526,1620,643,43,28,71,2.515527950310559,32.78597349204953
Task_1527,2074,567,48,18,66,3.6514084507042255,39.46076576713857
Task_1528,899,133,173,175,348,6.708955223880597,22.359973129327653
Task_1529,2134,850,13,127,140,2.5076380728554644,43.36642583320819
Task_1530,2769,996,110,39,149,2.777331995987964,53.06657678313798
Task_1531,2283,211,197,28,225,10.768867924528301,43.42062782357427
Task_1532,875,175,100,72,172,4.971590909090909,20.779144508406386
Task_1533,2780,560,104,133,237,4.955436720142602,53.37924591889989
Task_1534,1010,406,44,41,85,2.481572481572482,22.795834051649706
Task_1535,1176,763,186,111,297,1.5392670157068062,28.80891183727623
Task_1536,2043,453,101,178,279,4.5,41.621744238913216
Task_1537,1612,388,164,177,341,4.143958868894601,34.86856415011989
Task_1538,2691,729,137,32,169,3.686301369863014,51.18217766711182
Task_1539,1698,703,59,75,134,2.4119318181818183,35.798173132324614
Task_1540,2904,233,109,116,225,12.41025641025641,54.14418502155505
Task_1541,931,771,147,83,230,1.205958549222798,24.31314988774299
Task_1542,2202,818,132,42,174,2.688644688644689,43.857071266190395
Task_1543,2774,588,154,166,320,4.709677419354839,53.79651197826456
Task_1544,1539,441,14,36,50,3.481900452488688,30.94496406402999
Task_1545,1617,820,158,127,285,1.9695493300852618,35.985009712845304
Task_1546,2840,850,143,43,186,3.337250293772033,54.05633954089592
Task_1547,675,834,132,35,167,0.8083832335329342,19.619187578452447
Task_1548,1228,73,182,139,321,16.594594594594593,26.751232118358768
Task_1549,2458,239,138,106,244,10.241666666666667,47.192959948551845
Task_1550,1563,283,137,89,226,5.503521126760563,32.91215135716388
Task_1551,2345,313,23,174,197,7.468152866242038,45.65574073499412
Task_1552,804,204,190,180,370,3.921951219512195,21.624162420750128
Task_1553,529,546,69,56,125,0.9670932358318098,16.49058048855964
Task_1554,929,810,67,115,182,1.1454993834771887,24.393771058400233
Task_1555,2937,121,187,111,298,24.07377049180328,54.05876819802351
Task_1556,1120,954,164,86,250,1.1727748691099475,27.971144274791257
Task_1557,567,722,109,82,191,0.7842323651452282,18.274920919882067
Task_1558,2615,697,196,151,347,3.7464183381088825,51.72442183845025
Task_1559,1168,946,25,118,143,1.2333685322069694,28.174240345158935
Task_1560,2725,268,91,48,139,10.130111524163569,50.00632259108934
Task_1561,2463,214,137,166,303,11.455813953488372,47.53014260376769
Task_1562,811,353,173,53,226,2.290960451977401,20.97650594365376
Task_1563,2215,500,148,195,343,4.421157684630739,44.8093003258352
Task_1564,1069,785,76,190,266,1.3600508905852418,27.290871394559726
Task_1565,2321,747,113,132,245,3.1029411764705883,46.73709684414686
Task_1566,2418,825,65,56,121,2.927360774818402,47.11826960292513
Task_1567,1703,952,22,163,185,1.7869884575026234,37.20325150061735
Task_1568,1869,521,76,120,196,3.5804597701149423,38.76431843554007
Task_1569,1226,791,17,51,68,1.547979797979798,27.24304128965082
Task_1570,2274,957,143,129,272,2.373695198329854,46.76616232666462
Task_1571,596,852,97,177,274,0.6987104337631888,19.9892965242196
Task_1572,2965,515,81,85,166,5.746124031007752,55.46816445597387
Task_1573,2112,541,102,10,112,3.896678966789668,40.86317383759528
Task_1574,2915,832,17,121,138,3.4993997599039615,55.52561182991955
Task_1575,1986,777,87,131,218,2.5526992287917736,41.40936140938744
Task_1576,2754,389,90,15,105,7.061538461538461,50.39210677478868
Task_1577,1433,817,15,47,62,1.7518337408312958,30.463972638153336
Task_1578,2042,422,15,131,146,4.8274231678487,40.58793287718684
Task_1579,2099,233,161,126,287,8.97008547008547,41.72291441521913
Task_1580,1591,263,41,144,185,6.026515151515151,33.25238306742762
Task_1581,1007,308,171,19,190,3.2588996763754046,23.23022249845778
Task_1582,2214,217,38,162,200,10.155963302752294,43.15233402541488
Task_1583,1534,964,49,79,128,1.589637305699482,34.252029659937314
Task_1584,1190,510,38,40,78,2.328767123287671,25.59679008764085
Task_1585,1720,290,125,154,279,5.9106529209622,35.93938146247499
Task_1586,958,230,41,88,129,4.147186147186147,22.618859938870248
Task_1587,1522,80,84,74,158,18.790123456790123,29.90208862245122
Task_1588,944,990,154,178,332,0.9525731584258325,26.067259737291717
Task_1589,1983,480,108,61,169,4.122661122661123,39.36721575232856
Task_1590,793,927,120,125,245,0.8545258620689655,23.001644654770754
Task_1591,1246,976,50,151,201,1.2753326509723644,30.295710961147915
Task_1592,1193,779,143,42,185,1.5294871794871794,27.734248760177692
Task_1593,2614,485,37,150,187,5.378600823045267,50.290966174168766
Task_1594,2364,285,166,184,350,8.265734265734265,46.4665286282197
Task_1595,1018,957,110,115,225,1.0626304801670146,26.49399422948609
Task_1596,2353,820,178,141,319,2.8660170523751525,47.81965848476964
Task_1597,1041,134,155,173,328,7.711111111111111,24.50671059538242
Task_1598,2677,446,70,98,168,5.988814317673378,50.97465767744739
Task_1599,2307,217,168,26,194,10.582568807339449,43.67488783041815
Task_1600,2449,483,28,128,156,5.059917355371901,47.24474500959818
Task_1601,1509,955,56,107,163,1.5784518828451883,34.060451155764916
Task_1602,1662,76,41,129,170,21.584415584415584,32.79929774375838
Task_1603,1962,270,155,103,258,7.239852398523985,39.52632680594147
Task_1604,1928,913,56,89,145,2.1094091903719914,40.28709541677418
Task_1605,1679,95,21,175,196,17.489583333333332,33.38005530011072
Task_1606,1522,271,155,45,200,5.595588235294118,31.491529546543575
Task_1607,1605,812,122,154,276,1.9741697416974169,35.76899589106695
Task_1608,858,672,42,51,93,1.274888558692422,21.58419218605877
Task_1609,2287,571,118,114,232,3.9982517482517483,45.55741199214193
Task_1610,2087,514,26,31,57,4.052427184466019,39.75663307576425
Task_1611,2037,745,67,118,185,2.7305630026809653,41.9331140799812
Task_1612,2323,694,122,94,216,3.3424460431654675,46.360094888529794
Task_1613,2777,579,136,110,246,4.787931034482758,53.39957607483215
Task_1614,1675,888,154,137,291,1.8841394825646793,37.1572261048481
Task_1615,1136,575,56,122,178,1.9722222222222223,27.08883597298845
Task_1616,2151,833,69,155,224,2.579136690647482,44.37372288293218
Task_1617,2060,720,29,49,78,2.857142857142857,40.14459707019518
Task_1618,1647,381,125,27,152,4.31151832460733,33.30806845972606
Task_1619,2591,116,29,99,128,22.145299145299145,47.31909494531675
Task_1620,1307,130,34,30,64,9.977099236641221,25.893552453368752
Task_1621,2326,857,111,74,185,2.710955710955711,46.29816794217828
Task_1622,1650,764,109,129,238,2.156862745098039,36.12440742292985
Task_1623,1435,829,131,151,282,1.7289156626506024,33.137686885831705
Task_1624,1042,839,86,79,165,1.2404761904761905,25.911372853444675
Task_1625,2543,470,71,110,181,5.399150743099788,48.99453056584405
Task_1626,1269,298,127,72,199,4.2441471571906355,27.939341787714326
Task_1627,1252,608,167,36,203,2.0558292282430215,28.363499743122276
Task_1628,2162,863,98,37,135,2.502314814814815,43.04620300837073
Task_1629,2070,920,162,24,186,2.247557003257329,42.012760741467936
Task_1630,2554,690,175,123,298,3.6960926193921853,50.474165624710416
Task_1631,1491,187,161,112,273,7.930851063829787,31.975266375016073
Task_1632,992,780,159,45,204,1.2701664532650447,24.73471469309327
Task_1633,1053,942,14,152,166,1.1166489925768823,26.593327634071304
Task_1634,1637,452,148,145,293,3.6136865342163356,35.207062148659425
Task_1635,2280,477,90,55,145,4.7698744769874475,44.09570408717585
Task_1636,900,891,101,187,288,1.0089686098654709,24.79973244611959
Task_1637,2994,104,98,75,173,28.514285714285716,53.48937024660962
Task_1638,1452,276,169,48,217,5.241877256317689,30.531917812023806
Task_1639,2673,563,68,67,135,4.73936170212766,50.642701524280675
Task_1640,1991,251,79,86,165,7.900793650793651,39.304969295277125
Task_1641,1149,906,39,91,130,1.2668136714443219,27.66707762015074
Task_1642,1213,286,104,74,178,4.2264808362369335,26.783459048791276
Task_1643,2192,597,199,167,366,3.6655518394648827,44.81728766208448
Task_1644,2774,906,195,181,376,3.058434399117971,55.07488211368267
Task_1645,1713,764,116,134,250,2.23921568627451,37.18387975993827
Task_1646,2188,290,137,136,273,7.518900343642612,43.28440917886767
Task_1647,1663,384,170,136,306,4.3194805194805195,35.44465112007878
Task_1648,1450,639,128,82,210,2.265625,32.08730874923814
Task_1649,2881,78,109,108,217,36.46835443037975,52.160401289532096
Task_1650,2955,644,19,175,194,4.5813953488372094,56.26767720630709
Task_1651,626,475,90,91,181,1.315126050420168,18.33989832051436
Task_1652,635,236,77,94,171,2.679324894514768,17.89877063359604
Task_1653,2741,885,115,119,234,3.0936794582392775,53.75538243175438
Task_1654,1120,79,68,56,124,14.0,23.35676926922081
Task_1655,2390,78,171,82,253,30.253164556962027,44.37815127606597
Task_1656,629,472,97,172,269,1.3298097251585623,19.21742107148162
Task_1657,2678,913,129,140,269,2.9299781181619258,53.033248520513744
Task_1658,2227,469,69,22,91,4.738297872340426,42.313751044187065
Task_1659,1468,545,139,10,149,2.688644688644689,30.93979949052904
Task_1660,2584,661,78,172,250,3.903323262839879,50.84380217337011
Task_1661,1618,396,129,82,211,4.075566750629723,33.980934504203645
Task_1662,2824,87,49,148,197,32.09090909090909,51.442278049561715
Task_1663,1971,161,140,99,239,12.166666666666666,38.860255954373734
Task_1664,1646,967,41,150,191,1.7004132231404958,36.51040275630111
Task_1665,2876,261,147,53,200,10.977099236641221,53.19624770622426
Task_1666,902,491,183,100,283,1.8333333333333333,23.584861187419644
Task_1667,1725,257,127,190,317,6.686046511627907,36.12903866993806
Task_1668,1452,994,154,61,215,1.4592964824120602,32.93971323688326
Task_1669,1435,595,88,38,126,2.4077181208053693,30.654207985284177
Task_1670,715,524,199,162,361,1.361904761904762,21.10850989586849
Task_1671,645,806,67,74,141,0.7992565055762082,19.421292398241757
Task_1672,2546,744,174,113,287,3.41744966442953,50.453487243346444
Task_1673,858,558,83,132,215,1.5348837209302326,22.847507144770884
Task_1674,2645,873,100,32,132,3.026315789473684,50.7329050653426
Task_1675,663,840,175,67,242,0.7883472057074911,20.275200128353415
Task_1676,1087,232,116,43,159,4.665236051502146,24.041124124815514
Task_1677,2737,183,115,175,290,14.875,51.536834309488235
Task_1678,2637,1023,12,178,190,2.5751953125,52.417066900816685
Task_1679,730,800,119,111,230,0.9113607990012484,21.52751776110369
Task_1680,2940,797,89,89,178,3.6842105263157894,56.00155279881198
Task_1681,2826,465,91,150,241,6.064377682403434,53.89151609416002
Task_1682,1902,142,58,132,190,13.3006993006993,37.61720435792633
Task_1683,1692,434,129,130,259,3.889655172413793,35.84458307414989
Task_1684,1972,399,29,93,122,4.93,39.25451828709687
Task_1685,1792,264,197,146,343,6.7622641509433965,37.264856634372464
Task_1686,1362,765,94,108,202,1.7780678851174934,31.442293893193824
Task_1687,2063,544,193,98,291,3.785321100917431,42.17022112052657
Task_1688,2710,647,72,12,84,4.182098765432099,50.39333626934074
Task_1689,2210,667,151,121,272,3.308383233532934,44.83262576650785
Task_1690,1570,575,50,197,247,2.7256944444444446,34.59489627044178
Task_1691,1996,471,170,54,224,4.228813559322034,40.05025869075434
Task_1692,1138,761,109,62,171,1.4934383202099737,26.881471841520508
Task_1693,2252,622,192,112,304,3.6147672552166936,45.486676864738705
Task_1694,2561,402,198,167,365,6.354838709677419,50.02409241869689
Task_1695,1460,915,143,100,243,1.5938864628820961,33.55033301868474
Task_1696,1282,818,130,104,234,1.5653235653235653,30.364897800412013
Task_1697,2697,174,176,140,316,15.411428571428571,50.70425023596463
Task_1698,1869,925,134,75,209,2.0183585313174945,39.52158130951944
Task_1699,2440,695,117,71,188,3.5057471264367814,47.628150092346914
Task_1700,1414,108,160,114,274,12.972477064220184,29.67025809267508
Task_1701,2689,798,167,139,306,3.365456821026283,53.01250332023428
Task_1702,2693,225,145,104,249,11.915929203539823,50.8708983807958
Task_1703,1171,404,149,88,237,2.891358024691358,27.09085748053876
Task_1704,2459,437,197,43,240,5.614155251141552,47.08402403380745
Task_1705,899,832,184,68,252,1.0792316926770709,23.8786421989905
Task_1706,2893,568,155,200,355,5.084358523725835,55.82436190781025
Task_1707,2709,820,61,85,146,3.299634591961023,52.26775221161237
Task_1708,2482,723,171,31,202,3.4281767955801103,48.20023815514744
Task_1709,2506,393,14,135,149,6.3604060913705585,47.84027691102181
Task_1710,1849,130,82,31,113,14.114503816793894,34.95718947426358
Task_1711,1346,510,38,91,129,2.6340508806262233,29.732538145311384
Task_1712,2326,675,14,71,85,3.440828402366864,44.95954820552524
Task_1713,1138,210,165,88,253,5.393364928909953,26.003471978563407
Task_1714,856,291,187,56,243,2.9315068493150687,21.5521276199146
Task_1715,1708,773,37,107,144,2.20671834625323,36.3414605120825
Task_1716,1255,392,127,71,198,3.1933842239185752,27.997115540345494
Task_1717,1227,602,55,34,89,2.0348258706467663,26.799569658628787
Task_1718,1541,800,14,54,68,1.923845193508115,32.36017337413204
Task_1719,1495,216,43,100,143,6.889400921658986,31.151189215193444
Task_1720,2720,377,88,191,279,7.195767195767195,52.12334114418442
Task_1721,2368,385,25,72,97,6.134715025906735,44.785787552394346
Task_1722,545,825,197,118,315,0.6598062953995157,19.200819624514097
Task_1723,723,100,69,102,171,7.158415841584159,18.170430402892457
Task_1724,1558,200,64,175,239,7.751243781094527,33.04233274716567
Task_1725,1177,964,117,85,202,1.2196891191709844,28.62613312569279
Task_1726,2413,587,82,172,254,4.10374149659864,47.88026269912711
Task_1727,955,383,144,27,171,2.4869791666666665,22.54612567298351
Task_1728,2767,576,91,132,223,4.795493934142114,53.20945028153927
Task_1729,2223,876,153,88,241,2.5347776510832385,45.25374098771897
Task_1730,1434,685,15,113,128,2.0903790087463556,31.875090299717396
Task_1731,1825,373,40,58,98,4.879679144385027,35.929034267631934
Task_1732,650,732,72,143,215,0.8867667121418826,20.10848799669115
Task_1733,1023,284,187,163,350,3.5894736842105264,25.234317333552497
Task_1734,1903,456,141,157,298,4.164113785557987,39.470321195642626
Task_1735,879,322,123,87,210,2.721362229102167,22.0840066056264
Task_1736,986,511,70,16,86,1.92578125,22.659789872179218
Task_1737,692,598,170,193,363,1.1552587646076795,21.008298492594136
Task_1738,2515,839,179,151,330,2.994047619047619,50.51008176664029
Task_1739,1538,432,95,90,185,3.551963048498845,32.76055372315061
Task_1740,2530,616,66,184,250,4.100486223662885,49.85523515972636
Task_1741,2713,828,73,32,105,3.272617611580217,51.324972741305125
Task_1742,1868,458,186,29,215,4.069716775599129,37.704247081694
Task_1743,2694,118,98,136,234,22.638655462184875,49.946296133069474
Task_1744,2957,910,172,155,327,3.2458836443468715,57.72816024454611
Task_1745,935,619,53,22,75,1.5080645161290323,21.769605779453617
Task_1746,816,778,74,108,182,1.0474967907573813,22.428240069929064
Task_1747,2245,369,106,136,242,6.0675675675675675,44.31467797009762
Task_1748,593,338,55,115,170,1.7492625368731562,17.683794459312242
Task_1749,1774,622,92,193,285,2.8475120385232744,38.026971163224665
Task_1750,1114,421,113,172,285,2.639810426540284,26.834349774983256
Task_1751,591,368,144,62,206,1.6016260162601625,17.38686928015137
Task_1752,2053,978,84,200,284,2.097037793667007,43.5349113353274
Task_1753,2205,827,36,39,75,2.6630434782608696,42.52327397948805
Task_1754,1100,189,56,101,157,5.7894736842105265,24.997793612937798
Task_1755,1376,123,89,75,164,11.096774193548388,28.40742894009973
Task_1756,2078,550,43,185,228,3.7713248638838475,42.28077162381032
Task_1757,1012,935,17,107,124,1.0811965811965811,25.472727966344337
Task_1758,2885,772,22,85,107,3.7322121604139715,54.4871582554564
Task_1759,517,721,176,66,242,0.7160664819944599,17.6752018505719
Task_1760,748,785,40,128,168,0.9516539440203562,21.202595885496567
Task_1761,2424,553,91,129,220,4.375451263537906,47.68647890413007
Task_1762,1760,678,105,87,192,2.5920471281296025,37.072905665981544
Task_1763,814,786,126,177,303,1.0343074968233799,23.18365974298358
Task_1764,1840,316,31,40,71,5.804416403785489,35.23542191737565
Task_1765,2565,573,55,141,196,4.468641114982578,50.00200956448171
Task_1766,2303,518,153,128,281,4.4373795761079,45.882673349450954
Task_1767,649,595,92,37,129,1.0889261744966443,18.315647065680484
Task_1768,2484,223,109,139,248,11.089285714285714,47.60924262185725
Task_1769,2866,947,147,103,250,3.023206751054852,55.97867409449359
Task_1770,1916,972,167,134,301,1.9691675231243577,41.277824879764
Task_1771,1589,771,152,133,285,2.0582901554404147,35.39755405641328
Task_1772,2943,890,97,49,146,3.303030303030303,55.62752444265927
Task_1773,855,562,123,13,136,1.5186500888099468,21.187143681226114
Task_1774,1233,121,177,153,330,10.10655737704918,27.45430569398975
Task_1775,901,665,106,28,134,1.352852852852853,22.428973176535692
Task_1776,1602,343,142,56,198,4.656976744186046,33.31569353115497
Task_1777,2487,801,172,110,282,3.100997506234414,49.67093275365304
Task_1778,2184,508,147,59,206,4.2907662082514735,43.00155802202676
Task_1779,1297,263,89,190,279,4.912878787878788,29.254675715818987
Task_1780,1560,693,43,113,156,2.2478386167146973,33.78443144678812
Task_1781,1415,603,134,13,147,2.3427152317880795,30.2721338658402
Task_1782,597,992,14,169,183,0.6012084592145015,19.914722004763004
Task_1783,1410,389,115,68,183,3.6153846153846154,30.16809768739823
Task_1784,1348,129,57,33,90,10.36923076923077,26.68547219867706
Task_1785,1874,733,179,189,368,2.553133514986376,40.249963452802085
Task_1786,1656,657,104,37,141,2.5167173252279635,34.368639018394695
Task_1787,1801,309,51,122,173,5.809677419354839,36.8839768445744
Task_1788,1205,403,21,69,90,2.982673267326733,26.28565279338505
Task_1789,582,685,47,164,211,0.8483965014577259,18.77828243725628
Task_1790,2625,804,53,19,72,3.260869565217391,48.93377811703215
Task_1791,2544,683,111,63,174,3.719298245614035,49.10027950308572
Task_1792,2439,396,184,132,316,6.143576826196473,47.80155510743813
Task_1793,1820,776,27,140,167,2.3423423423423424,38.40544292296871
Task_1794,1062,460,39,89,128,2.3036876355748372,25.13576365885753
Task_1795,2154,203,131,86,217,10.558823529411764,41.839877375245585
Task_1796,1263,902,75,30,105,1.398671096345515,28.588594364114638
Task_1797,1092,506,148,181,329,2.1538461538461537,26.96593593951341
Task_1798,552,857,137,38,175,0.6433566433566433,18.176707755401658
Task_1799,1404,930,59,82,141,1.5080558539205156,31.898532393067864
Task_1800,2192,790,16,77,93,2.771175726927939,43.315386676480394
Task_1801,1541,396,110,50,160,3.881612090680101,31.842135072390708
Task_1802,2111,731,89,108,197,2.883879781420765,43.14843776503057
Task_1803,1811,676,200,65,265,2.675036927621861,37.98736184360964
Task_1804,2345,334,74,120,194,7.0,45.67065898724895
Task_1805,1027,998,174,111,285,1.028028028028028,27.036644494929092
Task_1806,765,390,135,131,266,1.9565217391304348,21.067925779013983
Task_1807,2333,167,45,122,167,13.886904761904763,44.05687559534113
Task_1808,1738,598,44,91,135,2.9015025041736227,36.16456944829263
Task_1809,1507,564,55,127,182,2.6672566371681414,32.953925474525384
Task_1810,550,205,125,89,214,2.6699029126213594,16.593808479164764
Task_1811,1561,202,117,25,142,7.689655172413793,31.310956499545714
Task_1812,959,788,115,40,155,1.2154626108998732,23.73139854116327
Task_1813,1165,844,43,16,59,1.378698224852071,25.899506868187384
Task_1814,2363,394,109,173,282,5.982278481012658,46.499234688727675
Task_1815,1429,304,103,135,238,4.685245901639345,31.173022479207315
Task_1816,1270,391,10,58,68,3.239795918367347,26.650429859561104
Task_1817,911,522,111,152,263,1.7418738049713194,23.797063749216715
Task_1818,2903,494,188,91,279,5.864646464646465,55.09467739734322
Task_1819,2244,305,188,149,337,7.333333333333333,44.529286548374564
Task_1820,1006,160,61,100,161,6.248447204968944,22.98573408356154
Task_1821,694,377,129,41,170,1.835978835978836,18.44826673128755
Task_1822,1692,985,68,24,92,1.7160243407707911,35.51006891650593
Task_1823,2559,436,22,164,186,5.855835240274599,49.136771708412454
Task_1824,894,978,175,92,267,0.9131767109295199,24.722651069351844
Task_1825,2263,380,121,76,197,5.939632545931759,43.983850499842475
Task_1826,1882,1000,68,197,265,1.8801198801198802,40.87831930555314
Task_1827,1189,626,57,54,111,1.8963317384370015,26.83235220366956
Task_1828,2076,523,184,13,197,3.9618320610687023,40.95590481006497
Task_1829,1308,523,61,192,253,2.49618320610687,30.240762493458572
Task_1830,1803,591,24,177,201,3.045608108108108,37.951851123215
Task_1831,2383,340,126,43,169,6.988269794721408,45.03799891060108
Task_1832,2016,409,117,170,287,4.917073170731707,41.07589302775906
Task_1833,618,131,43,195,238,4.681818181818182,17.45283099440351
Task_1834,520,657,96,38,134,0.790273556231003,16.538243242135643
Task_1835,1445,425,91,95,186,3.392018779342723,31.383547610669122
Task_1836,2064,503,157,194,351,4.095238095238095,42.46297010376809
Task_1837,2191,700,48,111,159,3.1255349500713265,43.90815125717403
Task_1838,1842,553,103,106,209,3.324909747292419,38.33833226728661
Task_1839,1872,945,159,163,322,1.9788583509513742,40.63383307517601
Task_1840,1818,247,162,84,246,7.330645161290323,36.794274393609065
Task_1841,2428,1017,112,126,238,2.3850687622789786,49.235738232423365
Task_1842,2484,637,54,22,76,3.8934169278996866,46.28967427775547
Task_1843,1225,789,131,139,270,1.5506329113924051,29.58532435598725
Task_1844,1619,526,199,19,218,3.0721062618595827,33.74909843019173
Task_1845,860,182,180,136,316,4.699453551912568,21.961394234992927
Task_1846,1414,807,182,74,256,1.75,32.1543007302012
Task_1847,1846,1001,100,14,114,1.842315369261477,38.07332854199779
Task_1848,782,716,165,131,296,1.090655509065551,22.34455388419835
Task_1849,1520,804,169,65,234,1.8881987577639752,33.63761993512027
Task_1850,1061,260,34,33,67,4.065134099616858,22.704342587010675
Task_1851,1137,246,43,61,104,4.603238866396761,24.672336808260408
Task_1852,2892,360,197,178,375,8.011080332409973,55.18062060171648
Task_1853,2411,673,132,196,328,3.577151335311573,48.3976020867564
Task_1854,2359,237,124,156,280,9.911764705882353,45.85713811083721
Task_1855,2495,450,110,179,289,5.532150776053215,48.812776825189566
Task_1856,792,454,65,150,215,1.7406593406593407,21.60633853711181
Task_1857,2212,654,80,160,240,3.3770992366412216,44.86352335909121
Task_1858,1874,870,23,144,167,2.151549942594719,39.615206698254276
Task_1859,1644,700,11,72,83,2.3452211126961484,34.156871485393715
Task_1860,2596,709,97,148,245,3.656338028169014,51.02091937088593
Task_1861,2124,170,44,87,131,12.421052631578947,40.33841392753714
Task_1862,2975,592,43,167,210,5.016863406408095,56.511722754186586
Task_1863,1924,256,194,182,376,7.4863813229571985,39.52424375129799
Task_1864,1304,272,173,125,298,4.7765567765567765,29.346089437803982
Task_1865,2050,925,107,86,193,2.2138228941684663,42.43186430582673
Task_1866,1749,671,49,90,139,2.6026785714285716,36.659500883593864
Task_1867,806,783,144,132,276,1.028061224489796,22.85997337587231
Task_1868,1911,999,140,90,230,1.911,40.73316370334097
Task_1869,1462,846,101,163,264,1.7260920897284533,33.55477214398954
Task_1870,2186,190,43,102,145,11.44502617801047,42.028874733158325
Task_1871,1191,75,75,93,168,15.671052631578947,25.434385965816606
Task_1872,1070,511,171,67,238,2.08984375,25.61513464155495
Task_1873,1682,412,29,19,48,4.072639225181598,32.70199921135924
Task_1874,1296,730,153,116,269,1.7729138166894665,30.517702580555227
Task_1875,2244,821,121,27,148,2.72992700729927,44.17571635155
Task_1876,670,633,134,78,212,1.0567823343848581,19.659898721284993
Task_1877,2433,435,125,130,255,5.580275229357798,47.55732644861579
Task_1878,1165,953,12,188,200,1.221174004192872,28.7995559017748
Task_1879,840,986,65,159,224,0.851063829787234,23.96650052674302
Task_1880,2938,369,38,150,188,7.940540540540541,55.0303461137892
Task_1881,1850,796,66,46,112,2.3212045169385194,37.59472050157648
Task_1882,1182,340,190,80,270,3.466275659824047,27.16319716762604
Task_1883,871,760,24,40,64,1.1445466491458607,21.372862912168184
Task_1884,885,921,184,60,244,0.9598698481561823,23.95953508581229
Task_1885,2847,936,126,40,166,3.038420490928495,54.34131473163453
Task_1886,2372,306,88,54,142,7.726384364820847,44.80895516993641
Task_1887,1465,712,107,182,289,2.0546984572230014,33.33903356211958
Task_1888,1725,985,189,151,340,1.7494929006085194,38.478744355754024
Task_1889,2515,811,43,37,80,3.0972906403940885,47.85617740836846
Task_1890,2089,827,152,141,293,2.5229468599033815,43.54163238610143
Task_1891,1401,153,124,154,278,9.097402597402597,30.09397185848719
Task_1892,2083,708,61,80,141,2.9379407616361073,41.940035148690384
Task_1893,2443,455,165,183,348,5.357456140350878,48.27782085088436
Task_1894,1045,1018,112,97,209,1.0255152109911678,27.054268547320774
Task_1895,754,104,128,143,271,7.180952380952381,19.293962468834653
Task_1896,2633,495,27,39,66,5.308467741935484,48.26911354140426
Task_1897,1625,106,189,76,265,15.186915887850468,32.49361370298339
Task_1898,858,535,112,148,260,1.6007462686567164,22.979154648530084
Task_1899,2065,509,107,25,132,4.049019607843137,40.33175183675525
Task_1900,953,1009,91,123,214,0.9435643564356435,25.663553171454684
Task_1901,2394,387,92,85,177,6.170103092783505,45.97057101000547
Task_1902,1645,234,42,100,142,7.0,33.57634560762614
Task_1903,2043,884,137,58,195,2.3084745762711862,41.91538389268165
Task_1904,2760,912,177,135,312,3.023001095290252,54.515930184855414
Task_1905,985,248,64,190,254,3.9558232931726907,24.249936726232082
Task_1906,2838,702,153,85,238,4.0369843527738265,54.40982425391664
Task_1907,1119,774,196,126,322,1.4438709677419355,28.049116874535116
Task_1908,2820,558,162,165,327,5.0447227191413235,54.45874492887824
Task_1909,697,646,29,106,135,1.0772797527047913,19.703621672942603
Task_1910,1723,990,13,173,186,1.7386478304742685,37.730920381078896
Task_1911,1871,823,24,111,135,2.270631067961165,39.07061910479164
Task_1912,658,635,55,81,136,1.0345911949685536,19.048209959788835
Task_1913,1775,356,100,89,189,4.971988795518207,36.31196791241672
Task_1914,2917,923,127,124,251,3.156926406926407,56.74705065802999
Task_1915,1092,311,155,38,193,3.5,24.871765111788374
Task_1916,2423,374,13,160,173,6.461333333333333,46.85963280227989
Task_1917,936,681,165,177,342,1.3724340175953078,25.033214054541233
Task_1918,740,410,89,177,266,1.8004866180048662,20.84255495460072
Task_1919,1558,1003,77,73,150,1.551792828685259,34.33266071726347
Task_1920,1462,898,130,186,316,1.6262513904338154,33.984349762899264
Task_1921,2201,830,27,78,105,2.648616125150421,43.77118777603662
Task_1922,2746,1016,18,20,38,2.7000983284169124,51.309938975237905
Task_1923,782,773,33,42,75,1.0103359173126616,19.956992219147022
Task_1924,1519,836,53,41,94,1.8148148148148149,32.26547158377833
Task_1925,1932,181,18,166,184,10.615384615384615,37.812886855884194
Task_1926,1322,973,161,155,316,1.3572895277207393,31.92599133286537
Task_1927,2758,629,179,148,327,4.377777777777778,53.67918929928057
Task_1928,2586,958,141,149,290,2.6965589155370178,51.82378454210548
Task_1929,2252,216,152,169,321,10.377880184331797,44.291745003575215
Task_1930,1657,637,102,112,214,2.59717868338558,35.70484432861476
Task_1931,2525,848,100,161,261,2.974087161366313,50.40037404327139
Task_1932,805,87,169,20,189,9.147727272727273,18.625550459150332
Task_1933,750,538,151,196,347,1.391465677179963,21.68602823576165
Task_1934,2967,441,11,136,147,6.712669683257919,55.261176162083125
Task_1935,2039,143,65,194,259,14.159722222222221,40.19454486257381
Task_1936,2492,443,109,112,221,5.612612612612613,48.33769790379073
Task_1937,612,526,59,170,229,1.1612903225806452,18.988746455446176
Task_1938,1273,129,32,111,143,9.792307692307693,26.67965179862897
Task_1939,2190,306,125,114,239,7.133550488599348,43.185918788018476
Task_1940,1141,811,153,32,185,1.4051724137931034,27.014799135149755
Task_1941,1626,352,169,67,236,4.606232294617564,33.89720856371381
Task_1942,668,796,118,38,156,0.8381430363864492,19.23893319935201
Task_1943,1948,480,111,176,287,4.0498960498960495,40.2380289976772
Task_1944,2511,840,120,148,268,2.985731272294887,50.166001218383464
Task_1945,1185,108,129,177,306,10.871559633027523,26.30733899628351
Task_1946,1299,554,143,108,251,2.3405405405405406,29.93564939755655
Task_1947,1959,980,200,143,343,1.996941896024465,42.1865801480629
Task_1948,1614,548,87,29,116,2.939890710382514,33.153253124981525
Task_1949,724,120,196,171,367,5.983471074380165,19.63642551176682
Task_1950,1024,747,35,191,226,1.3689839572192513,26.10007182889696
Task_1951,1104,856,52,145,197,1.2882147024504085,27.627438561644528
Task_1952,1749,699,15,53,68,2.4985714285714287,35.340023473040446
Task_1953,1746,940,173,186,359,1.8554729011689692,38.82216638024902
Task_1954,1520,747,82,74,156,2.0320855614973263,33.025771052138175
Task_1955,830,489,192,190,382,1.6938775510204083,23.003490647801545
Task_1956,1888,750,185,30,215,2.5139813581890813,38.94244204847546
Task_1957,1815,811,68,71,139,2.2352216748768474,37.84362514690742
Task_1958,735,418,14,137,151,1.7541766109785202,19.872103883883103
Task_1959,765,437,85,192,277,1.7465753424657535,21.388666144717657
Task_1960,2537,917,50,105,155,2.763616557734205,50.11439432225621
Task_1961,2239,587,190,52,242,3.807823129251701,44.39016740855006
Task_1962,2482,810,48,179,227,3.060419235511714,49.59651689013006
Task_1963,2906,312,172,85,257,9.284345047923322,54.292090615283776
Task_1964,1400,492,15,77,92,2.839756592292089,29.87096561966911
Task_1965,2800,524,162,88,250,5.333333333333333,53.320509613772124
Task_1966,2586,390,82,21,103,6.6138107416879794,47.73019524985505
Task_1967,2931,950,10,149,159,3.082018927444795,56.36348616567472
Task_1968,1468,269,171,38,209,5.437037037037037,30.748614564614105
Task_1969,2692,564,141,139,280,4.764601769911504,52.20122756051271
Task_1970,2361,492,163,47,210,4.789046653144016,45.58108610174039
Task_1971,903,989,84,38,122,0.9121212121212121,23.348833998237314
Task_1972,2857,862,158,123,281,3.3105446118192354,55.739010331818655
Task_1973,637,450,70,182,252,1.4124168514412416,19.312940214933075
Task_1974,1341,157,120,29,149,8.487341772151899,27.548300445457773
Task_1975,2419,85,113,100,213,28.127906976744185,44.99569211576881
Task_1976,995,109,166,144,310,9.045454545454545,23.294249014514623
Task_1977,751,593,53,195,248,1.2643097643097643,21.508712898277736
Task_1978,2533,705,44,62,106,3.587818696883853,48.32496154009363
Task_1979,2449,250,161,197,358,9.756972111553784,47.73885843393902
Task_1980,2542,790,61,10,71,3.213653603034134,47.569465544255586
Task_1981,2141,226,77,142,219,9.431718061674008,42.203236770709836
Task_1982,2106,395,190,59,249,5.318181818181818,41.594365465676965
Task_1983,2967,207,131,117,248,14.264423076923077,55.139513800717964
Task_1984,1577,606,107,13,120,2.598023064250412,32.585928637644095
Task_1985,1363,287,111,125,236,4.732638888888889,30.049377838759913
Task_1986,1824,877,89,141,230,2.0774487471526197,39.25464014667795
Task_1987,1597,114,171,125,296,13.88695652173913,32.84766905074425
Task_1988,2462,612,76,111,187,4.0163132137031,48.352881630366824
Task_1989,648,344,186,177,363,1.8782608695652174,19.576360464335274
Task_1990,1101,1009,158,49,207,1.0900990099009902,27.263167784241276
Task_1991,2333,1023,66,66,132,2.2783203125,46.68758498145473
Task_1992,1929,587,153,176,329,3.2806122448979593,40.46711653597414
Task_1993,1075,825,86,52,138,1.3014527845036319,25.918829166645093
Task_1994,1970,625,109,17,126,3.146964856230032,38.96062615447179
Task_1995,633,725,98,97,195,0.871900826446281,19.62174992796523
Task_1996,1784,282,71,27,98,6.303886925795053,34.815675667558196
Task_1997,1080,363,140,28,168,2.967032967032967,24.470611460714263
Task_1998,1405,859,57,73,130,1.6337209302325582,31.636226069253695
Task_1999,1390,832,168,140,308,1.6686674669867947,32.53509586385612
Task_2000,2293,883,128,136,264,2.5938914027149322,46.81071079089202
Task_2001,1972,506,39,22,61,3.8895463510848125,37.82527828546505
Task_2002,1737,195,200,52,252,8.862244897959183,35.18304937122604
Task_2003,2105,394,126,172,298,5.329113924050633,42.48757039145525
Task_2004,2604,892,141,58,199,2.916013437849944,50.84746545713548
Task_2005,872,1022,133,117,250,0.852394916911046,24.557811538014622
Task_2006,1116,739,153,51,204,1.508108108108108,26.849265316307022
Task_2007,2243,955,192,167,359,2.346234309623431,46.71651682247998
Task_2008,817,228,126,62,188,3.567685589519651,20.37758156813288
Task_2009,2723,685,45,87,132,3.9693877551020407,52.00086495507517
Task_2010,2267,848,183,115,298,2.67020023557126,46.41189349063493
Task_2011,1122,793,65,37,102,1.4130982367758187,25.865549531637125
Task_2012,2531,884,32,102,134,2.8598870056497177,49.70553794047597
Task_2013,1787,613,37,100,137,2.91042345276873,37.053002844512655
Task_2014,1478,398,100,81,181,3.7042606516290726,31.400603138105883
Task_2015,2824,531,138,197,335,5.30827067669173,54.51797515465203
Task_2016,2975,905,34,42,76,3.2836644591611477,55.06426705738451
Task_2017,1785,1010,74,30,104,1.7655786350148368,37.1785795176528
Task_2018,1090,330,137,126,263,3.293051359516616,25.99690700859594
Task_2019,2909,96,140,136,276,29.989690721649485,53.03801990431953
Task_2020,1578,910,48,77,125,1.7321624588364435,34.51589244091786
Task_2021,2605,211,153,40,193,12.287735849056604,48.39500468315138
Task_2022,2423,689,87,169,256,3.5115942028985505,48.28263006248452
Task_2023,522,643,181,124,305,0.8105590062111802,18.106693878071628
Task_2024,1556,971,42,31,73,1.6008230452674896,32.81597439130578
Task_2025,2712,449,48,12,60,6.026666666666666,49.21618455039592
Task_2026,2352,719,75,23,98,3.2666666666666666,45.2393731969242
Task_2027,602,456,103,111,214,1.3172866520787747,18.379053014854073
Task_2028,884,883,146,180,326,1.0,24.682473072981168
Task_2029,2699,825,99,156,255,3.267554479418886,53.05245841378987
Task_2030,574,763,158,198,356,0.7513089005235603,19.604497411130428
Task_2031,2293,249,160,49,209,9.172,43.75780202221122
Task_2032,2234,385,75,109,184,5.787564766839378,43.85507607894382
Task_2033,1609,1005,30,84,114,1.599403578528827,35.22292549089295
Task_2034,696,317,81,198,279,2.188679245283019,20.005720579723818
Task_2035,806,915,56,66,122,0.8799126637554585,21.976420294098478
Task_2036,738,119,199,131,330,6.15,19.61838696780676
Task_2037,1475,1022,147,136,283,1.4418377321603129,34.29788670043566
Task_2038,2187,723,179,61,240,3.020718232044199,43.883483555627635
Task_2039,1278,800,136,104,240,1.595505617977528,30.301950516901087
Task_2040,2181,343,80,128,208,6.340116279069767,43.17753133647435
Task_2041,1698,534,143,133,276,3.1738317757009344,36.33959120399377
Task_2042,1380,953,154,127,281,1.4465408805031446,32.55643715648585
Task_2043,1914,333,172,90,262,5.730538922155689,38.816602533571114
Task_2044,2934,876,84,81,165,3.345496009122007,56.07095981287542
Task_2045,1209,931,187,166,353,1.2972103004291846,30.136543206030115
Task_2046,1018,331,44,118,162,3.066265060240964,24.136693008956286
Task_2047,2440,314,63,49,112,7.746031746031746,45.34469864469333
Task_2048,1775,122,17,102,119,14.43089430894309,34.16475859341646
Task_2049,2537,351,23,132,155,7.207386363636363,48.25747312510012
Task_2050,1548,188,199,52,251,8.19047619047619,32.29677457413262
Task_2051,2668,960,177,39,216,2.7762747138397503,51.91440549389832
Task_2052,2421,629,175,71,246,3.842857142857143,47.42809930310804
Task_2053,747,538,163,103,266,1.385899814471243,21.137126588577956
Task_2054,1154,666,101,59,160,1.7301349325337332,26.683580819053436
Task_2055,2184,682,72,40,112,3.1976573938506587,42.54703859203264
Task_2056,1849,212,141,105,246,8.68075117370892,37.481619076064014
Task_2057,1341,818,179,187,366,1.6373626373626373,32.04556393114445
Task_2058,2727,110,135,71,206,24.56756756756757,49.546218034466186
Task_2059,974,621,69,187,256,1.5659163987138263,25.219214011957686
Task_2060,796,505,81,122,203,1.5731225296442688,21.681732046891096
Task_2061,2594,994,28,26,54,2.607035175879397,49.36538620874012
Task_2062,2274,453,182,54,236,5.008810572687224,44.446555679773375
Task_2063,1992,680,130,61,191,2.9251101321585904,40.438658359342696
Task_2064,1514,874,162,142,304,1.7302857142857142,34.6151812113797
Task_2065,1447,149,43,85,128,9.646666666666667,29.652091779084845
Task_2066,1974,486,73,57,130,4.053388090349076,39.16696073438357
Task_2067,2984,597,112,92,204,4.989966555183947,56.41895452186173
Task_2068,1599,789,33,158,191,2.0240506329113925,35.27291042535429
Task_2069,878,427,27,50,77,2.0514018691588785,20.402092940093745
Task_2070,2345,990,21,63,84,2.3662966700302723,46.103100244171316
Task_2071,1066,88,157,80,237,11.97752808988764,23.66361287328591
Task_2072,1561,206,159,11,170,7.541062801932367,31.435627602391165
Task_2073,2913,247,141,189,330,11.745967741935484,54.920717565792906
Task_2074,1760,561,23,21,44,3.131672597864769,34.592673241612005
Task_2075,2407,524,79,123,202,4.584761904761905,47.31585991728565
Task_2076,2411,527,163,171,334,4.566287878787879,47.92341022443217
Task_2077,2692,455,150,141,291,5.9035087719298245,51.90058325787536
Task_2078,2776,847,103,36,139,3.2735849056603774,52.6674262948695
Task_2079,2963,190,163,21,184,15.513089005235603,53.70498641327938
Task_2080,913,933,165,42,207,0.9775160599571735,24.092658411618032
Task_2081,2732,913,183,44,227,2.989059080962801,52.85150638865063
Task_2082,1006,424,145,40,185,2.367058823529412,23.671617242162558
Task_2083,2615,594,121,14,135,4.394957983193278,49.18115136469774
Task_2084,1305,443,12,96,108,2.939189189189189,28.65450476164055
Task_2085,2820,367,122,24,146,7.663043478260869,51.865304667769855
Task_2086,998,809,76,67,143,1.2320987654320987,24.81741216262837
Task_2087,1240,483,140,159,299,2.56198347107438,29.069003561597622
Task_2088,1146,358,164,161,325,3.1922005571030643,27.30366682694726
Task_2089,2180,774,198,60,258,2.8129032258064517,44.017215572878946
Task_2090,2342,502,30,197,227,4.656063618290259,46.34739631738651
Task_2091,1454,129,36,46,82,11.184615384615384,28.46191716864926
Task_2092,2572,750,67,41,108,3.4247669773635154,48.83237838536569
Task_2093,1833,779,134,64,198,2.35,38.339610474473425
Task_2094,2994,202,192,82,274,14.748768472906404,55.32737544206399
Task_2095,1615,795,22,10,32,2.028894472361809,32.72784109364092
Task_2096,1594,365,101,86,187,4.355191256830601,33.369188290202835
Task_2097,1302,619,168,69,237,2.1,29.59640706418784
Task_2098,524,200,122,125,247,2.6069651741293534,16.555994699575177
Task_2099,1345,834,17,54,71,1.6107784431137724,29.341112791953137
Task_2100,1793,793,189,108,297,2.2581863979848866,38.71550920074763
Task_2101,2580,994,108,127,235,2.592964824120603,51.560816120323125
Task_2102,767,301,27,16,43,2.5397350993377485,17.83926933572717
Task_2103,603,885,65,30,95,0.6805869074492099,18.41279852290089
Task_2104,2486,1009,87,192,279,2.4613861386138614,50.42003667633648
Task_2105,513,271,148,153,301,1.8860294117647058,16.8956375528256
Task_2106,2087,534,150,120,270,3.9009345794392525,42.452662635616484
Task_2107,2118,979,92,14,106,2.1612244897959183,42.24610198427485
Task_2108,2718,312,63,40,103,8.68370607028754,49.489954001099456
Task_2109,2529,498,122,59,181,5.0681362725450905,48.13042947331589
Task_2110,2254,995,164,55,219,2.2630522088353415,45.79427745594472
Task_2111,684,709,191,90,281,0.9633802816901409,20.53740934786119
Task_2112,1190,269,170,20,190,4.407407407407407,26.028885219678447
Task_2113,1831,1014,173,141,314,1.8039408866995075,40.13011201478226
Task_2114,1135,523,175,169,344,2.1660305343511452,27.75014089715661
Task_2115,1625,618,119,157,276,2.625201938610662,35.48376473305152
Task_2116,953,128,153,151,304,7.387596899224806,22.944467227790046
Task_2117,2023,342,42,187,229,5.8979591836734695,40.74258493640148
Task_2118,1172,1021,20,195,215,1.1467710371819961,29.190649164991196
Task_2119,1962,85,152,49,201,22.813953488372093,36.99274548277424
Task_2120,1489,88,181,164,345,16.730337078651687,31.1460949109692
Task_2121,2256,865,150,83,233,2.605080831408776,45.6574852091616
Task_2122,1375,883,44,155,199,1.5554298642533937,31.974446849637573
Task_2123,1567,662,36,157,193,2.363499245852187,34.337986433751524
Task_2124,1983,80,83,172,255,24.48148148148148,38.45064831756138
Task_2125,886,185,146,200,346,4.763440860215054,22.62357655647017
Task_2126,1815,247,113,98,211,7.318548387096774,36.90665541774769
Task_2127,2828,146,120,61,181,19.238095238095237,51.31932537081911
Task_2128,946,525,118,17,135,1.7984790874524714,22.468513897931643
Task_2129,1742,840,99,90,189,2.071343638525565,37.35019010644288
Task_2130,1805,359,10,63,73,5.013888888888889,35.16234245053567
Task_2131,1120,828,117,36,153,1.3510253317249699,26.44044422714417
Task_2132,981,167,197,93,290,5.839285714285714,23.427365493722434
Task_2133,927,506,181,78,259,1.8284023668639053,23.5894466540237
Task_2134,1288,776,160,57,217,1.6576576576576576,29.731619038835703
Task_2135,2128,992,44,17,61,2.1430010070493455,41.62636187221433
Task_2136,1323,356,155,50,205,3.7058823529411766,28.7568090928953
Task_2137,844,869,195,191,386,0.9701149425287356,24.35733259155948
Task_2138,1109,797,25,50,75,1.3897243107769424,25.18781614451785
Task_2139,778,673,80,155,235,1.1543026706231454,22.07736008776588
Task_2140,1974,69,109,49,158,28.2,36.44568418566299
Task_2141,1808,146,142,165,307,12.299319727891156,36.5808763450246
Task_2142,1684,341,102,20,122,4.923976608187134,33.44454435729153
Task_2143,2841,1016,74,36,110,2.793510324483776,54.006158635904974
Task_2144,2071,415,52,51,103,4.978365384615385,40.02818211649835
Task_2145,2952,353,17,142,159,8.338983050847459,54.697828399436446
Task_2146,748,646,103,87,190,1.1561051004636784,20.85089419654521
Task_2147,1474,518,108,19,127,2.840077071290944,30.743928851242746
Task_2148,1285,267,27,43,70,4.794776119402985,26.2764981918037
Task_2149,2796,421,166,74,240,6.625592417061611,52.749388443011746
Task_2150,2199,314,102,152,254,6.980952380952381,43.47899993977084
Task_2151,2251,979,116,168,284,2.296938775510204,46.581441437062004
Task_2152,1888,303,115,171,286,6.2105263157894735,38.696056210679
Task_2153,1176,101,90,177,267,11.529411764705882,25.95418497776478
Task_2154,1722,442,130,102,232,3.8871331828442437,36.18237345968341
Task_2155,1442,599,16,106,122,2.4033333333333333,31.447224549275656
Task_2156,2819,799,93,44,137,3.52375,53.370930622981184
Task_2157,2906,446,197,40,237,6.501118568232662,54.1818446804323
Task_2158,1192,558,188,115,303,2.1323792486583186,28.498540659650157
Task_2159,1124,731,163,78,241,1.53551912568306,27.30105582029786
Task_2160,841,938,113,25,138,0.8956336528221512,22.291036458172513
Task_2161,2364,601,163,112,275,3.9269102990033224,47.06310377221246
Task_2162,2556,685,164,77,241,3.7259475218658893,49.8070860635952
Task_2163,837,487,144,68,212,1.7151639344262295,21.727039916677683
Task_2164,2658,540,140,66,206,4.913123844731977,50.68247564197935
Task_2165,1901,739,22,18,40,2.5689189189189188,37.04910226870812
Task_2166,687,144,72,136,208,4.7379310344827585,18.621856433360154
Task_2167,1903,1003,182,95,277,1.8954183266932272,40.97463350917577
Task_2168,553,998,67,186,253,0.5535535535535535,19.751127720099642
Task_2169,728,591,47,197,244,1.2297297297297298,20.974221051344866
Task_2170,936,109,33,32,65,8.50909090909091,19.840673030136795
Task_2171,1613,247,58,77,135,6.504032258064516,32.9845594911664
Task_2172,2956,585,63,172,235,5.044368600682594,56.422722893644014
Task_2173,2193,124,132,55,187,17.544,41.36893926826892
Task_2174,813,177,100,120,220,4.567415730337078,20.50037774422793
Task_2175,884,572,163,18,181,1.5427574171029668,21.847189735367238
Task_2176,2456,441,189,14,203,5.5565610859728505,46.71325432949566
Task_2177,1119,557,16,27,43,2.0053763440860215,24.438052373932297
Task_2178,1583,329,86,174,260,4.796969696969697,33.889386080656074
Task_2179,2640,1023,134,78,212,2.578125,52.12873850305311
Task_2180,2686,785,29,62,91,3.4173027989821882,50.901602490434385
Task_2181,1600,318,30,132,162,5.015673981191223,33.34511231705346
Task_2182,1687,265,130,117,247,6.342105263157895,35.13376673484076
Task_2183,1921,196,69,158,227,9.751269035532994,38.62829144288873
Task_2184,1619,692,152,91,243,2.336219336219336,35.22911270995597
Task_2185,1921,399,119,114,233,4.8025,39.21450731167491
Task_2186,2772,159,138,88,226,17.325,51.25878139051099
Task_2187,2599,739,158,39,197,3.5121621621621624,50.04298292733173
Task_2188,2665,547,72,44,116,4.863138686131387,49.762709371854605
Task_2189,2010,455,183,200,383,4.407894736842105,41.606858478500705
Task_2190,2737,184,89,17,106,14.794594594594594,49.339353734645904
Task_2191,1609,275,135,174,309,5.829710144927536,34.29828661436627
Task_2192,1130,1014,70,33,103,1.1133004926108374,26.85345239818066
Task_2193,2580,689,30,200,230,3.739130434782609,50.730197781199756
Task_2194,1581,619,136,123,259,2.55,34.66360152371966
Task_2195,610,272,190,168,358,2.2344322344322345,18.710807728838443
Task_2196,2423,958,14,43,57,2.5265901981230448,46.60196325152825
Task_2197,1388,908,108,128,236,1.526952695269527,32.36794050266883
Task_2198,1973,852,82,53,135,2.313012895662368,40.34668088971488
Task_2199,993,368,40,67,107,2.6910569105691056,23.078891818217652
Task_2200,2059,252,112,149,261,8.138339920948617,41.07646415815436
Task_2201,746,706,184,17,201,1.0551626591230552,20.3741987720552
Task_2202,2807,584,84,171,255,4.798290598290598,54.06797485598374
Task_2203,2124,315,128,92,220,6.7215189873417724,41.95454865014714
Task_2204,1370,540,189,108,297,2.532347504621072,31.223155314192514
Task_2205,1704,931,41,93,134,1.8283261802575108,36.73821477233173
Task_2206,2687,254,19,46,65,10.537254901960784,48.39990712949924
Task_2207,1267,177,100,90,190,7.117977528089888,27.347341437192295
Task_2208,1462,1000,194,79,273,1.4605394605394606,33.60695966675413
Task_2209,1575,816,13,103,116,1.9277845777233782,34.27417467699642
Task_2210,1582,769,158,171,329,2.0545454545454547,35.53443781933719
Task_2211,2561,597,133,57,190,4.282608695652174,49.19529925387894
Task_2212,1797,136,81,149,230,13.116788321167883,36.089626784063235
Task_2213,2700,685,28,13,41,3.935860058309038,49.63827942686547
Task_2214,2609,839,147,90,237,3.105952380952381,51.32604489097819
Task_2215,988,729,139,98,237,1.3534246575342466,25.4411577657952
Task_2216,989,518,194,143,337,1.905587668593449,25.353236704099846
Task_2217,1623,881,37,74,111,1.8401360544217686,34.896000448021894
Task_2218,2184,653,65,146,211,3.3394495412844036,44.263690929790464
Task_2219,1216,951,148,13,161,1.2773109243697478,28.186683664682292
Task_2220,1172,669,118,52,170,1.7492537313432837,27.220895527390635
Task_2221,1564,785,13,49,62,1.9898218829516539,32.496419515817145
Task_2222,2994,653,181,58,239,4.577981651376147,56.45303377615941
Task_2223,2279,521,78,130,208,4.365900383141763,45.31694833016943
Task_2224,1021,829,149,65,214,1.230120481927711,25.67757700414629
Task_2225,2396,983,102,123,225,2.434959349593496,48.55978971461076
Task_2226,531,533,28,197,225,0.9943820224719101,17.583311619650157
Task_2227,2907,625,20,161,181,4.643769968051118,55.1890310350116
Task_2228,1279,589,41,146,187,2.1677966101694914,29.4711208689293
Task_2229,971,560,85,103,188,1.7308377896613192,24.466023213988294
Task_2230,2651,497,122,16,138,5.323293172690763,49.4014723841938
Task_2231,1050,980,11,134,145,1.070336391437309,26.4546615231282
Task_2232,2901,980,82,122,204,2.9571865443425076,56.54934466276183
Task_2233,1019,260,200,108,308,3.9042145593869733,24.822179166967363
Task_2234,2875,740,104,73,177,3.8798920377867745,54.493166143200995
Task_2235,2370,350,169,11,180,6.752136752136752,44.793520201975184
Task_2236,1644,924,27,52,79,1.7772972972972974,34.439741153514845
Task_2237,3000,344,135,22,157,8.695652173913043,54.614627275315634
Task_2238,1918,739,19,97,116,2.591891891891892,39.37587771643909
Task_2239,1220,434,133,50,183,2.8045977011494254,27.09916623495805
Task_2240,1711,521,178,141,319,3.2777777777777777,36.709721080656635
Task_2241,538,939,105,114,219,0.5723404255319149,18.97685173503869
Task_2242,673,479,53,49,102,1.4020833333333333,17.763102715503944
Task_2243,1436,142,27,58,85,10.041958041958042,28.673515511185744
Task_2244,2298,788,39,32,71,2.91254752851711,43.94776155834836
Task_2245,1437,192,28,70,98,7.44559585492228,29.53292245787901
Task_2246,1582,797,56,97,153,1.9824561403508771,34.588898188173495
Task_2247,2935,172,152,118,270,16.965317919075144,54.22199994256446
Task_2248,2133,954,37,21,58,2.2335078534031414,41.810591951531855
Task_2249,2335,341,19,160,179,6.8274853801169595,45.19782451756049
Task_2250,1678,563,92,171,263,2.975177304964539,36.189279182480924
Task_2251,1430,505,25,124,149,2.8260869565217392,31.156574657537693
Task_2252,856,592,74,72,146,1.4435075885328836,21.99004473161264
Task_2253,2466,653,177,184,361,3.770642201834862,49.33664188475186
Task_2254,1723,673,119,136,255,2.556379821958457,37.08311656209866
Task_2255,2295,724,126,151,277,3.1655172413793102,46.425022768310065
Task_2256,2363,151,137,28,165,15.546052631578947,43.83751980855205
Task_2257,695,514,67,140,207,1.3495145631067962,20.169725456506026
Task_2258,2185,644,184,199,383,3.387596899224806,44.97869879096219
Task_2259,843,859,90,143,233,0.9802325581395349,23.563443285351706
Task_2260,1404,844,108,13,121,1.6615384615384616,30.5958902688426
Task_2261,1203,599,58,33,91,2.005,26.422221258194753
Task_2262,519,244,169,48,217,2.1183673469387756,15.682715673254641
Task_2263,2591,942,120,89,209,2.7476139978791094,51.21256232380964
Task_2264,1101,260,50,193,243,4.218390804597701,26.139100823010917
Task_2265,1993,133,178,182,360,14.873134328358208,39.649650708399676
Task_2266,2994,712,46,84,130,4.199158485273492,56.35611280589421
Task_2267,752,408,109,54,163,1.8386308068459658,19.742252556845838
Task_2268,2694,694,119,71,190,3.8762589928057554,51.69237528768767
Task_2269,1654,960,105,22,127,1.7211238293444329,35.136087822344585
Task_2270,2989,705,183,15,198,4.23371104815864,55.97978464855009
Task_2271,2036,802,46,47,93,2.535491905354919,40.40075303184606
Task_2272,2601,797,31,155,186,3.2593984962406015,51.00669335971395
Task_2273,1001,293,192,55,247,3.4047619047619047,23.86749164625626
Task_2274,1555,83,50,149,199,18.511904761904763,31.56601908904864
Task_2275,2997,238,28,57,85,12.539748953974895,53.85489007256942
Task_2276,683,717,174,30,204,0.9512534818941504,19.807049676922304
Task_2277,2526,610,89,60,149,4.134206219312603,48.25982823470349
Task_2278,2154,942,31,15,46,2.2841993637327676,41.882077057997655
Task_2279,504,181,99,96,195,2.769230769230769,15.542813082360455
Task_2280,2280,316,28,120,148,7.192429022082019,43.96236065077696
Task_2281,1833,353,125,103,228,5.177966101694915,37.632541645765876
Task_2282,2815,702,33,194,227,4.004267425320057,54.47832794340783
Task_2283,1099,1019,45,170,215,1.0774509803921568,27.911493691542663
Task_2284,2866,215,48,199,247,13.268518518518519,53.81667583638501
Task_2285,1416,445,27,151,178,3.1748878923766815,31.04009296550257
Task_2286,2686,550,178,42,220,4.874773139745916,50.952431337794145
Task_2287,2775,976,181,50,231,2.8403275332650972,53.82713471411808
Task_2288,2927,980,69,193,262,2.9836901121304793,57.35592606540379
Task_2289,1018,312,106,136,242,3.252396166134185,24.720080284045384
Task_2290,1226,361,66,120,186,3.386740331491713,27.88497415523574
Task_2291,1463,129,96,168,264,11.253846153846155,30.870642674387508
Task_2292,1927,612,134,156,290,3.143556280587276,40.30934114214597
Task_2293,2394,791,183,167,350,3.022727272727273,48.55620967476273
Task_2294,1948,276,146,82,228,7.0324909747292415,38.876662015329046
Task_2295,778,503,131,147,278,1.5436507936507937,21.662984829207485
Task_2296,1426,1004,32,38,70,1.418905472636816,30.84764521660573
Task_2297,2709,128,157,103,260,21.0,50.316500028154245
Task_2298,1496,798,185,136,321,1.872340425531915,34.174932727276165
Task_2299,2290,606,96,55,151,3.772652388797364,44.606244290549995
Task_2300,1217,604,151,18,169,2.0115702479338844,27.16481815740576
Task_2301,1949,168,99,15,114,11.532544378698224,36.80620533740689
Task_2302,1007,628,80,174,254,1.600953895071542,25.76708139991241
Task_2303,2350,995,180,26,206,2.359437751004016,46.93322862595216
Task_2304,1092,300,171,40,211,3.627906976744186,24.885816160827943
Task_2305,996,276,40,132,172,3.595667870036101,23.87445975376836
Task_2306,2973,1015,98,43,141,2.9261811023622046,56.327924985248444
Task_2307,2786,941,51,198,249,2.9575371549893843,55.02291485874877
Task_2308,2042,389,64,130,194,5.235897435897436,41.071991048309776
Task_2309,820,89,54,41,95,9.11111111111111,17.994098048895548
Task_2310,581,952,15,181,196,0.6096537250786989,19.801065391070804
Task_2311,1479,562,66,58,124,2.6269982238010656,31.430268399063873
Task_2312,2051,987,150,42,192,2.075910931174089,42.14140431815225
Task_2313,1879,532,80,180,260,3.525328330206379,39.32314280613884
Task_2314,2766,516,41,92,133,5.350096711798839,52.25911464067023
Task_2315,2598,120,149,36,185,21.47107438016529,47.35035592508289
Task_2316,2764,478,13,64,77,5.77035490605428,50.77288191747372
Task_2317,1714,177,163,35,198,9.629213483146067,33.99321101184433
Task_2318,1923,671,108,23,131,2.861607142857143,38.59495879938266
Task_2319,2570,614,148,180,328,4.178861788617886,50.705404268505696
Task_2320,2187,656,197,81,278,3.328767123287671,44.07889431786356
Task_2321,2346,209,166,24,190,11.17142857142857,44.20452431069456
Task_2322,2533,725,135,92,227,3.4889807162534434,49.78579458656341
Task_2323,1510,540,117,188,305,2.7911275415896486,33.593197472938705
Task_2324,2221,516,136,104,240,4.295938104448743,44.35803078938422
Task_2325,2894,737,171,68,239,3.921409214092141,55.22130615580531
Task_2326,2649,415,114,101,215,6.367788461538462,50.68698382426919
Task_2327,1208,361,198,100,298,3.3370165745856353,28.082994336181756
Task_2328,1159,364,98,196,294,3.175342465753425,27.454100562026408
Task_2329,1599,411,187,162,349,3.8810679611650487,34.75129023647726
Task_2330,1473,267,200,20,220,5.496268656716418,30.6412432218783
Task_2331,1901,327,65,27,92,5.795731707317073,36.69969493637864
Task_2332,2473,149,55,196,251,16.486666666666668,47.0409305726101
Task_2333,2638,252,124,30,154,10.42687747035573,48.6122063914697
Task_2334,2511,342,148,65,213,7.320699708454811,47.756596307809794
Task_2335,1422,405,168,199,367,3.502463054187192,32.06645335097749
Task_2336,2494,516,24,187,211,4.823984526112186,48.71409917567515
Task_2337,1894,695,34,38,72,2.721264367816092,37.343107529175974
Task_2338,500,330,48,108,156,1.5105740181268883,15.914795333433668
Task_2339,1450,457,156,168,324,3.165938864628821,32.436585217890915
Task_2340,849,498,177,108,285,1.7014028056112225,22.775054594929077
Task_2341,2099,282,71,96,167,7.41696113074205,41.29020323810189
Task_2342,1607,112,121,22,143,14.221238938053098,31.13385701169825
Task_2343,1957,988,187,94,281,1.9787664307381194,41.77292752149834
Task_2344,1222,967,141,50,191,1.262396694214876,29.010025231982258
Task_2345,1513,255,160,89,249,5.91015625,32.130160848495855
Task_2346,2611,950,108,119,227,2.7455310199789693,51.867057181994426
Task_2347,1087,157,18,81,99,6.879746835443038,23.38997359922512
Task_2348,1316,521,110,35,145,2.521072796934866,28.666478815521852
Task_2349,1524,519,97,145,242,2.9307692307692306,33.4251999767882
Task_2350,1029,965,136,179,315,1.065217391304348,27.19250096814805
Task_2351,1543,1010,196,148,344,1.5262116716122651,35.656457257555985
Task_2352,2101,326,142,53,195,6.425076452599388,41.15163660737312
Task_2353,2373,776,17,115,132,3.054054054054054,46.81378595123261
Task_2354,1948,712,22,159,181,2.732117812061711,40.26035984193394
Task_2355,720,222,17,184,201,3.2286995515695067,19.53991325440523
Task_2356,2677,813,67,34,101,3.288697788697789,50.665645430155074
Task_2357,2362,896,163,147,310,2.633221850613155,48.16805342462603
Task_2358,969,860,155,155,310,1.1254355400696865,25.83697419908953
Task_2359,681,716,72,44,116,0.9497907949790795,19.006272483104976
Task_2360,898,389,63,11,74,2.3025641025641024,20.316135646675395
Task_2361,2255,143,98,24,122,15.659722222222221,41.524508174936884
Task_2362,1558,283,20,142,162,5.485915492957746,32.51798821871099
Task_2363,2693,804,154,136,290,3.3453416149068325,53.01821295265677
Task_2364,1054,699,127,127,254,1.5057142857142858,26.50700465903047
Task_2365,2746,663,42,81,123,4.135542168674699,52.19469322969957
Task_2366,1236,944,170,70,240,1.307936507936508,29.573965001321273
Task_2367,2418,462,81,159,240,5.222462203023758,47.486641112312576
Task_2368,1238,434,66,70,136,2.845977011494253,27.49190496803433
Task_2369,1667,365,161,68,229,4.554644808743169,34.558582622628
Task_2370,2324,561,44,152,196,4.135231316725979,46.018513046625905
Task_2371,507,337,59,63,122,1.5,15.436572397645058
Task_2372,1731,194,199,200,399,8.876923076923077,36.30824771608232
Task_2373,1356,1005,27,66,93,1.3479125248508945,30.6511501234796
Task_2374,1751,235,139,49,188,7.419491525423729,35.009605686207145
Task_2375,2142,106,45,70,115,20.018691588785046,39.62514799817823
Task_2376,2020,692,188,152,340,2.914862914862915,42.253704056683986
Task_2377,2829,593,109,168,277,4.762626262626263,54.492635895619664
Task_2378,607,807,110,43,153,0.7512376237623762,18.20811970899406
Task_2379,2809,97,113,39,152,28.663265306122447,49.75008126539044
Task_2380,2774,175,79,40,119,15.761363636363637,49.90487220088074
Task_2381,2169,305,33,84,117,7.088235294117647,41.8793082898659
Task_2382,2953,347,110,98,208,8.485632183908047,55.23413722075404
Task_2383,1357,561,21,85,106,2.4145907473309607,29.610270346259977
Task_2384,2896,178,196,130,326,16.178770949720672,53.87584953052603
Task_2385,801,827,119,163,282,0.967391304347826,23.03632796829528
Task_2386,2073,526,71,127,198,3.933586337760911,42.018199197582994
Task_2387,2597,917,158,84,242,2.8289760348583877,51.26476294629137
Task_2388,2985,262,165,161,326,11.34980988593156,56.056132579397875
Task_2389,2564,623,180,10,190,4.108974358974359,48.96322294310266
Task_2390,1167,351,101,11,112,3.315340909090909,25.301742729929142
Task_2391,2993,373,36,59,95,8.002673796791443,54.40607653762323
Task_2392,2818,914,171,106,277,3.0797814207650274,55.240969473544546
Task_2393,1719,800,165,193,358,2.146067415730337,37.96448978894697
Task_2394,1706,473,26,176,202,3.5991561181434597,36.04266557100218
Task_2395,1728,315,179,73,252,5.468354430379747,35.5028396125165
Task_2396,1679,91,13,68,81,18.25,32.009737762872156
Task_2397,2336,751,96,57,153,3.106382978723404,45.698356344349094
Task_2398,1400,405,154,11,165,3.4482758620689653,29.675706687804816
Task_2399,691,378,85,90,175,1.8232189973614776,19.192356295022496
Task_2400,1662,585,24,146,170,2.83617747440273,35.33031893825201
Task_2401,685,1019,65,57,122,0.6715686274509803,20.272187037988356
Task_2402,2527,686,167,68,235,3.678311499272198,49.22862081557142
Task_2403,641,732,17,35,52,0.8744884038199181,17.751830174866456
Task_2404,2765,644,122,143,265,4.286821705426356,53.551024643416646
Task_2405,1071,1009,16,60,76,1.0603960396039604,25.49224615498012
Task_2406,2583,310,25,61,86,8.305466237942122,47.59803738923318
Task_2407,2115,885,196,200,396,2.3871331828442437,44.685293811148625
Task_2408,2397,85,63,30,93,27.872093023255815,42.606075459862495
Task_2409,1762,531,106,160,266,3.31203007518797,37.337915052637584
Task_2410,2981,839,196,37,233,3.5488095238095236,56.62494529685792
Task_2411,850,767,33,121,154,1.1067708333333333,22.537027004458025
Task_2412,639,217,161,161,322,2.9311926605504586,18.818193410767712
Task_2413,1400,379,162,70,232,3.6842105263157894,30.392553161616362
Task_2414,2757,975,131,122,253,2.824795081967213,54.38024122535313
Task_2415,1249,97,171,124,295,12.744897959183673,27.053945515855734
Task_2416,1339,977,11,11,22,1.369120654396728,28.866203479893702
Task_2417,2611,946,90,26,116,2.757127771911299,50.174100354281954
Task_2418,536,515,194,121,315,1.0387596899224807,17.912290970958825
Task_2419,2692,254,168,126,294,10.556862745098039,51.20068884952847
Task_2420,2921,964,125,167,292,3.026943005181347,57.1864644187988
Task_2421,639,957,111,198,309,0.6670146137787056,21.187993421561213
Task_2422,1698,164,88,126,214,10.290909090909091,34.53999568153662
Task_2423,2209,756,112,133,245,2.918097754293263,44.992521423809215
Task_2424,1466,181,37,168,205,8.054945054945055,30.861126520569425
Task_2425,1260,416,179,44,223,3.0215827338129495,27.954474808762114
Task_2426,1476,511,36,180,216,2.8828125,32.55928554776161
Task_2427,820,346,43,118,161,2.363112391930836,21.018316542097626
Task_2428,2468,407,135,29,164,6.049019607843137,46.715774529184024
Task_2429,800,577,76,74,150,1.3840830449826989,21.03407745459662
Task_2430,986,171,168,56,224,5.732558139534884,22.88480617297854
Task_2431,2058,307,178,138,316,6.681818181818182,41.484446302448035
Task_2432,1290,362,73,25,98,3.553719008264463,27.28644300910148
Task_2433,2490,915,21,104,125,2.7183406113537116,49.10467548692795
Task_2434,1859,967,82,145,227,1.9204545454545454,40.13405637618943
Task_2435,2468,996,16,166,182,2.4754262788365096,49.395031920082566
Task_2436,1240,367,186,96,282,3.369565217391304,28.554164630966202
Task_2437,1995,328,177,74,251,6.0638297872340425,39.81571495822701
Task_2438,1507,971,75,180,255,1.550411522633745,34.75051222966663
Task_2439,2625,325,127,54,181,8.052147239263803,49.140484699029834
Task_2440,1813,565,36,174,210,3.2031802120141344,38.03023137914159
Task_2441,1356,987,126,72,198,1.3724696356275303,31.44213653498717
Task_2442,2192,106,10,154,164,20.485981308411215,41.258723106943826
Task_2443,940,281,40,133,173,3.3333333333333335,23.011624979000384
Task_2444,967,1017,147,87,234,0.949901768172888,25.706688463600376
Task_2445,1693,570,124,24,148,2.9649737302977233,34.64559973693299
Task_2446,908,551,165,86,251,1.644927536231884,23.42934609200995
Task_2447,1315,432,200,83,283,3.0369515011547343,29.617507519309655
Task_2448,1537,99,200,16,216,15.37,30.47271891171489
Task_2449,1348,574,17,136,153,2.3443478260869566,29.961527905537363
Task_2450,786,572,109,106,215,1.3717277486910995,21.64211082337555
Task_2451,1887,997,168,80,248,1.8907815631262526,40.29266139539454
Task_2452,618,498,43,82,125,1.2384769539078155,17.842246683971272
Task_2453,2394,950,147,159,306,2.5173501577287065,48.843122407393764
Task_2454,986,727,148,85,233,1.3543956043956045,25.092183518216796
Task_2455,952,745,14,121,135,1.2761394101876675,24.168493105253972
Task_2456,2037,969,57,171,228,2.1,43.0698337251255
Task_2457,2152,113,178,155,333,18.87719298245614,41.77009698707618
Task_2458,810,478,36,24,60,1.6910229645093946,19.36506593068867
Task_2459,2310,1004,140,184,324,2.298507462686567,47.79794318360049
Task_2460,721,809,45,45,90,0.8901234567901235,19.56809647541202
Task_2461,2637,502,80,195,275,5.242544731610338,51.317418870488176
Task_2462,2519,292,48,120,168,8.597269624573379,47.96259166030904
Task_2463,1091,929,80,199,279,1.1731182795698925,28.101495540566134
Task_2464,1618,564,139,117,256,2.863716814159292,35.05411933633946
Task_2465,2073,502,101,196,297,4.121272365805169,42.36179991923246
Task_2466,1032,270,59,42,101,3.8081180811808117,22.77589113249582
Task_2467,2332,816,43,71,114,2.854345165238678,45.96433493279134
Task_2468,1963,726,100,173,273,2.700137551581843,41.186281929255706
Task_2469,1425,890,47,104,151,1.5993265993265993,32.22835836408372
Task_2470,2542,424,87,59,146,5.9811764705882355,47.91344084003231
Task_2471,859,202,54,195,249,4.231527093596059,22.12132773134914
Task_2472,2019,71,77,15,92,28.041666666666668,36.290761208846654
Task_2473,2567,72,170,109,279,35.16438356164384,47.4857969288666
Task_2474,2734,603,160,94,254,4.526490066225166,52.75245614532967
Task_2475,2226,769,12,196,208,2.890909090909091,45.230194457473544
Task_2476,630,871,166,46,212,0.7224770642201835,19.60767753447561
Task_2477,1015,664,22,127,149,1.5263157894736843,24.9679470922958
Task_2478,1563,95,189,96,285,16.28125,31.899961045047377
Task_2479,793,406,60,170,230,1.9484029484029484,21.584321304969666
Task_2480,691,159,89,24,113,4.31875,16.956717703423806
Task_2481,2404,949,173,18,191,2.5305263157894737,47.363764527511584
Task_2482,2863,386,12,111,123,7.397932816537468,53.3260516496404
Task_2483,2181,162,42,199,241,13.38036809815951,42.38227673194985
Task_2484,863,989,188,123,311,0.8717171717171717,24.596979522476058
Task_2485,570,186,55,157,212,3.0481283422459895,17.42867994304217
Task_2486,714,488,115,191,306,1.460122699386503,20.768034592427913
Task_2487,1177,207,100,127,227,5.658653846153846,26.800656014831166
Task_2488,1153,857,186,180,366,1.343822843822844,29.150645360230424
Task_2489,1464,743,128,175,303,1.967741935483871,33.4727159620705
Task_2490,820,368,182,95,277,2.2222222222222223,21.837205497080802
Task_2491,2340,282,182,59,241,8.268551236749117,44.8762214050765
Task_2492,1208,512,167,117,284,2.354775828460039,28.52467107281215
Task_2493,728,338,84,77,161,2.1474926253687316,19.1656577944905
Task_2494,1354,901,166,191,357,1.501108647450111,32.44519178783571
Task_2495,1885,631,81,69,150,2.982594936708861,38.254394860179765
Task_2496,1388,550,97,37,134,2.5190562613430125,29.812010944715553
Task_2497,1670,301,127,60,187,5.529801324503311,34.063491763598016
Task_2498,1486,530,113,10,123,2.7984934086629,31.026603948527978
Task_2499,580,280,40,191,231,2.0640569395017794,17.73595001860004
Task_2500,511,89,152,86,238,5.677777777777778,15.08736752222663
Task_2501,1503,538,64,41,105,2.7884972170686457,30.995524758031593
Task_2502,2107,303,125,86,211,6.930921052631579,41.431947748939514
Task_2503,1236,346,70,187,257,3.561959654178674,28.560652235086888
Task_2504,2830,733,36,75,111,3.8555858310626703,53.55440644261683
Task_2505,2520,196,67,22,89,12.791878172588833,46.001933383922676
Task_2506,1907,196,81,104,185,9.680203045685278,37.986706988916545
Task_2507,549,708,101,29,130,0.7743300423131171,17.042040615450478
Task_2508,612,201,123,120,243,3.0297029702970297,17.92298051572195
Task_2509,1111,839,101,38,139,1.3226190476190476,26.308382317013137
Task_2510,843,465,185,78,263,1.8090128755364807,22.149214555907477
Task_2511,1340,254,182,27,209,5.254901960784314,28.589127781479206
Task_2512,2408,197,104,12,116,12.16161616161616,44.44012766896365
Task_2513,1291,527,62,161,223,2.445075757575758,29.803546908135697
Task_2514,1685,974,42,78,120,1.7282051282051283,36.28443883718804
Task_2515,2466,935,95,42,137,2.6346153846153846,48.15653643803682
Task_2516,859,648,135,78,213,1.3235747303543914,22.721574053696457
Task_2517,642,180,26,67,93,3.546961325966851,16.411322664080732
Task_2518,1601,116,47,116,163,13.683760683760683,32.06538850742985
Task_2519,2457,329,69,195,264,7.445454545454545,47.84001333526632
Task_2520,2652,701,16,171,187,3.7777777777777777,51.55728618199765
Task_2521,2836,343,22,50,72,8.244186046511627,51.15777175234996
Task_2522,2060,818,84,23,107,2.515262515262515,40.88707125404979
Task_2523,1650,427,110,44,154,3.8551401869158877,33.53208574096394
Task_2524,1942,316,173,45,218,6.126182965299685,38.36506163775544
Task_2525,2128,807,152,161,313,2.633663366336634,44.216487958563505
Task_2526,1450,813,84,76,160,1.7813267813267812,32.069990640162835
Task_2527,1355,913,35,88,123,1.4824945295404814,30.914631982877285
Task_2528,2378,902,161,182,343,2.6334440753045403,48.6403465314188
Task_2529,1522,327,72,147,219,4.640243902439025,32.77864076467042
Task_2530,1189,227,52,61,113,5.214912280701754,25.74984675655843
Task_2531,2340,98,44,164,208,23.636363636363637,43.90431226221133
Task_2532,1539,860,196,169,365,1.7874564459930313,35.29573085415018
Task_2533,2474,206,14,144,158,11.951690821256038,46.72032253983815
Task_2534,2293,854,86,161,247,2.68187134502924,46.72220970959814
Task_2535,1179,476,119,192,311,2.4716981132075473,28.183727371286324
Task_2536,2921,100,173,181,354,28.92079207920792,53.767772145769676
Task_2537,2811,402,23,198,221,6.975186104218363,53.47261891283397
Task_2538,594,890,99,84,183,0.6666666666666666,19.104653393747952
Task_2539,1733,538,127,78,205,3.215213358070501,36.20803867054733
Task_2540,1777,475,168,168,336,3.7331932773109244,37.7242231917449
Task_2541,789,881,87,168,255,0.8945578231292517,22.868625781785955
Task_2542,2621,256,51,86,137,10.198443579766536,49.07494122320156
Task_2543,2814,609,160,162,322,4.613114754098361,54.500277848343465
Task_2544,2453,940,56,29,85,2.6068012752391074,47.274252400759735
Task_2545,1938,924,107,89,196,2.095135135135135,40.75049533358942
Task_2546,2828,288,123,41,164,9.785467128027681,51.985740982649666
Task_2547,1800,941,109,170,279,1.910828025477707,39.296940265468905
Task_2548,1023,383,29,40,69,2.6640625,22.502992641753433
Task_2549,1583,922,113,57,170,1.715059588299025,34.436998589733086
Task_2550,1690,81,163,65,228,20.609756097560975,33.12737486646759
Task_2551,2759,858,62,73,135,3.2118742724097786,53.01036720318451
Task_2552,858,990,31,48,79,0.8657921291624622,22.06665778330869
Task_2553,2256,122,111,139,250,18.341463414634145,43.17425430517388
Task_2554,2818,479,112,25,137,5.870833333333334,52.14752152626506
Task_2555,1342,260,85,42,127,5.14176245210728,27.99600320648413
Task_2556,2467,135,174,96,270,18.139705882352942,46.609396318552996
Task_2557,1343,561,87,124,211,2.389679715302491,30.50606111288978
Task_2558,1158,70,145,87,232,16.309859154929576,25.074270680265045
Task_2559,2501,421,140,188,328,5.92654028436019,49.001525087416724
Task_2560,2673,248,142,179,321,10.734939759036145,51.07742325219215
Task_2561,679,366,199,15,214,1.8501362397820162,18.40385010023487
Task_2562,2901,560,52,83,135,5.171122994652406,54.483517713985954
Task_2563,807,605,146,150,296,1.3316831683168318,22.527836431656443
Task_2564,2044,606,60,22,82,3.367380560131796,39.627847354667466
Task_2565,982,293,86,188,274,3.3401360544217686,24.351703040600558
Task_2566,1656,169,82,37,119,9.741176470588234,32.26758957004892
Task_2567,1898,901,73,141,214,2.104212860310421,40.516939904843206
Task_2568,594,364,126,114,240,1.6273972602739726,18.12508215404164
Task_2569,2771,854,187,124,311,3.24093567251462,54.48798230733871
Task_2570,1553,795,101,83,184,1.9510050251256281,33.877875026819204
Task_2571,2361,163,177,35,212,14.396341463414634,44.253807836609646
Task_2572,664,719,46,101,147,0.9222222222222223,19.49577033215334
Task_2573,1696,992,155,180,335,1.7079556898288015,38.06088170134351
Task_2574,1791,112,43,105,148,15.849557522123893,34.57140366423918
Task_2575,1559,266,34,185,219,5.8389513108614235,33.11567658461064
Task_2576,2056,519,17,81,98,3.953846153846154,40.30275015479461
Task_2577,2453,462,78,21,99,5.29805615550756,45.908078766527865
Task_2578,812,782,77,188,265,1.037037037037037,23.058599362813556
Task_2579,2710,958,45,154,199,2.8258602711157454,53.38607571796513
Task_2580,755,688,137,59,196,1.0957910014513788,20.817122257514203
Task_2581,1654,515,124,147,271,3.205426356589147,35.58068579051446
Task_2582,2113,486,168,22,190,4.338809034907597,41.45461376730629
Task_2583,1735,212,111,197,308,8.145539906103286,36.09599049644301
Task_2584,1376,329,113,36,149,4.16969696969697,28.937079862299612
Task_2585,1352,311,200,27,227,4.333333333333333,29.050417647389704
Task_2586,2389,486,166,142,308,4.905544147843942,47.2833002321878
Task_2587,1173,423,165,115,280,2.766509433962264,27.668317839236195
Task_2588,2129,373,198,123,321,5.692513368983957,42.82980476711199
Task_2589,1106,410,111,79,190,2.6909975669099757,25.802244104156703
Task_2590,1496,939,189,148,337,1.5914893617021277,34.658904373026424
Task_2591,2703,936,88,85,173,2.8847385272145143,52.64733789440828
Task_2592,2459,221,14,177,191,11.076576576576576,47.047939460391774
Task_2593,2764,898,150,18,168,3.0745272525027807,52.587461480634914
Task_2594,2461,684,73,111,184,3.5927007299270075,48.40389055219225
Task_2595,521,700,98,60,158,0.7432239657631954,16.733881258603752
Task_2596,2153,153,191,167,358,13.980519480519481,42.32551611730636
Task_2597,855,89,19,198,217,9.5,20.616363867967014
Task_2598,984,1006,131,154,285,0.9771598808341608,26.489892194012953
Task_2599,1675,876,30,82,112,1.9099201824401368,35.80547763605728
Task_2600,2067,497,111,133,244,4.150602409638554,41.91955818959921
Task_2601,2762,663,85,187,272,4.159638554216867,53.70723914802835
Task_2602,2687,472,157,44,201,5.680761099365751,50.62185209707127
Task_2603,557,563,80,176,256,0.9875886524822695,18.33213850371346
Task_2604,2757,494,17,84,101,5.569696969696969,51.471687171942726
Task_2605,1601,471,55,160,215,3.391949152542373,34.527041234407534
Task_2606,2567,947,25,176,201,2.707805907172996,51.175408317505884
Task_2607,1183,577,15,152,167,2.046712802768166,27.71254715350095
Task_2608,1173,166,155,127,282,7.023952095808383,26.51760844859073
Task_2609,919,273,43,151,194,3.354014598540146,22.847413015613384
Task_2610,2372,323,73,20,93,7.320987654320987,44.10252585667856
Task_2611,1950,704,179,113,292,2.765957446808511,40.909050405135694
Task_2612,1732,343,120,68,188,5.034883720930233,35.28143413067729
Task_2613,1680,202,130,61,191,8.275862068965518,33.935170987387416
Task_2614,2892,81,157,149,306,35.26829268292683,52.855193737386685
Task_2615,1490,195,166,163,329,7.6020408163265305,32.151547635664045
Task_2616,1859,667,127,60,187,2.782934131736527,38.23041257809617
Task_2617,660,706,82,98,180,0.9335219236209336,19.716702240518405
Task_2618,1855,380,44,55,99,4.868766404199475,36.46105872204636
Task_2619,2836,78,197,65,262,35.89873417721519,51.20019027546155
Task_2620,870,571,110,52,162,1.520979020979021,22.02637089559811
Task_2621,668,664,134,120,254,1.0045112781954888,20.170060596334263
Task_2622,1936,804,64,100,164,2.404968944099379,40.416915646026446
Task_2623,1992,711,13,46,59,2.797752808988764,38.96043380724907
Task_2624,2289,530,143,190,333,4.3107344632768365,46.02474688475113
Task_2625,1761,491,81,49,130,3.5792682926829267,35.59001176614461
Task_2626,2076,788,159,109,268,2.6311787072243344,43.054184960570836
Task_2627,657,153,183,161,344,4.266233766233766,18.67586158430274
Task_2628,906,797,131,104,235,1.1353383458646618,24.30788715263252
Task_2629,1366,673,35,170,205,2.026706231454006,31.28237380765971
Task_2630,1599,739,36,169,205,2.1608108108108106,35.15727034354811
Task_2631,1640,700,200,32,232,2.339514978601997,34.926867306954264
Task_2632,2255,344,28,140,168,6.536231884057971,43.91777691227168
Task_2633,2452,888,87,93,180,2.7581552305961754,48.65417181942873
Task_2634,2835,674,32,65,97,4.2,53.09595387415183
Task_2635,1773,286,28,49,77,6.177700348432055,34.08625827704478
Task_2636,769,626,199,102,301,1.226475279106858,21.86072906861446
Task_2637,2678,819,84,85,169,3.265853658536585,51.79243981863012
Task_2638,1747,195,124,58,182,8.91326530612245,34.72941315317646
Task_2639,839,119,33,35,68,6.991666666666666,18.482259187276266
Task_2640,1782,92,42,89,131,19.161290322580644,34.29122555438103
Task_2641,1168,354,19,16,35,3.2901408450704226,24.221393823713285
Task_2642,2248,928,187,150,337,2.419806243272336,46.58755988225605
Task_2643,1299,568,195,157,352,2.282952548330404,30.506654924665767
Task_2644,1174,513,73,31,104,2.2840466926070038,25.949859329004756
Task_2645,842,164,194,189,383,5.1030303030303035,21.867372358284836
Task_2646,1209,957,124,37,161,1.2620041753653444,28.289825307000317
Task_2647,2375,403,14,133,147,5.878712871287129,45.80268958889358
Task_2648,2799,809,75,141,216,3.4555555555555557,54.52317411227734
Task_2649,2921,149,12,113,125,19.473333333333333,52.681631953673026
Task_2650,2380,665,170,81,251,3.5735735735735736,47.042543103066556
Task_2651,730,284,67,153,220,2.56140350877193,20.124351234746943
Task_2652,2505,835,104,39,143,2.9964114832535884,48.35210204433
Task_2653,1570,561,177,60,237,2.793594306049822,33.59151275859217
Task_2654,1180,682,124,81,205,1.7276720351390922,27.87188308276671
Task_2655,1341,999,85,152,237,1.341,31.98090804306877
Task_2656,1378,117,70,125,195,11.677966101694915,29.171808518050582
Task_2657,2797,563,50,163,213,4.959219858156028,53.783365994411106
Task_2658,1090,963,24,193,217,1.1307053941908713,27.760165968476212
Task_2659,790,959,128,101,229,0.8229166666666666,22.937253526735223
Task_2660,2030,177,178,114,292,11.404494382022472,40.01343825023801
Task_2661,537,755,146,74,220,0.7103174603174603,18.087558136577634
Task_2662,1112,95,195,162,357,11.583333333333334,25.23281926786839
Task_2663,1557,441,72,86,158,3.52262443438914,32.82277929375454
Task_2664,547,235,23,98,121,2.3177966101694913,16.23801486256082
Task_2665,1590,278,136,94,230,5.698924731182796,33.47929969835106
Task_2666,2549,620,200,188,388,4.1046698872785825,50.674057958389504
Task_2667,2060,156,183,110,293,13.121019108280255,40.528385665948896
Task_2668,2931,365,133,189,322,8.008196721311476,55.59194163942908
Task_2669,2282,197,87,42,129,11.525252525252526,42.78006250867537
Task_2670,2012,976,112,148,260,2.059365404298874,42.647265473899985
Task_2671,1007,315,28,67,95,3.1867088607594938,22.99472702966356
Task_2672,1151,744,39,186,225,1.54496644295302,28.15527349358767
Task_2673,1066,705,166,174,340,1.5099150141643058,27.17224935295141
Task_2674,1460,688,27,174,201,2.1190130624092887,32.81750710798391
Task_2675,834,119,20,118,138,6.95,19.630204486608886
Task_2676,2637,674,130,16,146,3.9066666666666667,49.85437578584827
Task_2677,2444,116,190,80,270,20.88888888888889,45.80047677748709
Task_2678,2187,246,186,28,214,8.854251012145749,41.98600892038393
Task_2679,1262,581,35,179,214,2.1683848797250858,29.401231631854245
Task_2680,803,793,81,89,170,1.0113350125944585,21.92413714901718
Task_2681,1345,167,137,133,270,8.005952380952381,29.219987365307237
Task_2682,972,169,30,34,64,5.7176470588235295,21.04815915307655
Task_2683,2756,644,161,26,187,4.272868217054263,52.13781490730028
Task_2684,2992,648,35,172,207,4.610169491525424,56.96962617574198
Task_2685,927,997,111,131,242,0.9288577154308617,25.341662322349993
Task_2686,2946,572,132,158,290,5.141361256544503,56.32196601911013
Task_2687,932,86,77,133,210,10.71264367816092,21.861806388328873
Task_2688,878,456,109,126,235,1.9212253829321664,22.916904821232034
Task_2689,2918,645,65,52,117,4.5170278637770895,54.430612043510074
Task_2690,1770,275,26,32,58,6.413043478260869,33.951470732758374
Task_2691,1691,451,72,165,237,3.7411504424778763,35.9624722331277
Task_2692,2229,108,145,13,158,20.44954128440367,40.9445071514996
Task_2693,910,484,95,138,233,1.8762886597938144,23.590043187220914
Task_2694,1731,844,121,11,132,2.048520710059172,36.015541868955125
Task_2695,603,486,173,20,193,1.2381930184804928,17.451235454374576
Task_2696,1591,64,134,65,199,24.476923076923075,31.415662015456338
Task_2697,798,300,85,150,235,2.6511627906976742,21.239122586206538
Task_2698,2368,172,14,65,79,13.6878612716763,43.49766290135104
Task_2699,1358,934,123,183,306,1.4524064171122995,32.343697563933574
Task_2700,1260,142,146,148,294,8.811188811188812,27.896744583028568
Task_2701,1236,333,21,168,189,3.7005988023952097,27.99731775683054
Task_2702,2684,122,32,41,73,21.821138211382113,47.544309881118984
Task_2703,1777,424,137,65,202,4.181176470588236,36.36535965702026
Task_2704,2635,505,49,121,170,5.207509881422925,50.55906386973038
Task_2705,792,589,97,152,249,1.3423728813559321,22.04322156230043
Task_2706,598,535,100,44,144,1.1156716417910448,17.141910970500387
Task_2707,2212,254,161,85,246,8.674509803921568,43.06497535204081
Task_2708,1788,412,42,104,146,4.329297820823244,36.46291869859976
Task_2709,2206,867,171,168,339,2.5414746543778803,45.76720669759424
Task_2710,2174,202,16,116,132,10.70935960591133,41.79820300747832
Task_2711,2328,1013,10,14,24,2.2958579881656807,44.68667882995262
Task_2712,1881,633,120,75,195,2.966876971608833,38.73390863146529
Task_2713,2909,822,37,30,67,3.534629404617254,53.73072448935772
Task_2714,1284,623,64,115,179,2.0576923076923075,29.546357445530433
Task_2715,1089,973,43,31,74,1.1180698151950719,25.453913583602485
Task_2716,1230,293,14,180,194,4.183673469387755,27.9004681300963
Task_2717,2221,536,36,51,87,4.1359404096834265,42.61537288150449
Task_2718,1744,131,87,80,167,13.212121212121213,34.26946541762606
Task_2719,958,132,65,106,171,7.203007518796992,22.260653481164496
Task_2720,2157,195,91,189,280,11.005102040816327,42.54625140062122
Task_2721,1881,525,47,143,190,3.576045627376426,38.874549101657685
Task_2722,2595,277,123,48,171,9.33453237410072,48.18950298929314
Task_2723,1100,773,118,151,269,1.421188630490956,27.542778819422736
Task_2724,1955,536,183,22,205,3.640595903165736,39.19194242169726
Task_2725,2825,386,112,168,280,7.299741602067184,53.766145522262796
Task_2726,1016,982,131,190,321,1.0335707019328586,27.090920180486687
Task_2727,649,645,44,76,120,1.0046439628482973,18.574215269297326
Task_2728,1073,236,148,120,268,4.527426160337553,25.432454391438757
Task_2729,2347,933,48,27,75,2.512847965738758,45.18955454097472
Task_2730,1117,566,13,62,75,1.9700176366843034,24.909767294636282
Task_2731,1773,290,131,114,245,6.092783505154639,36.56536462116319
Task_2732,2353,541,126,150,276,4.341328413284133,46.757773650485
Task_2733,2113,810,183,164,347,2.6054254007398274,44.14585523126667
Task_2734,532,392,72,183,255,1.3536895674300256,17.492960910117734
Task_2735,1128,440,118,135,253,2.557823129251701,26.917688297657893
Task_2736,1438,317,116,90,206,4.522012578616352,30.983347963989925
Task_2737,1119,682,44,146,190,1.638360175695461,27.25470354347243
Task_2738,595,597,71,123,194,0.9949832775919732,18.690241997389588
Task_2739,1951,864,52,109,161,2.255491329479769,40.687947149134295
Task_2740,2194,372,146,168,314,5.882037533512064,43.88924152490383
Task_2741,1537,703,25,30,55,2.1832386363636362,31.665007769781464
Task_2742,2027,498,184,96,280,4.062124248496994,41.421130041793795
Task_2743,2833,822,112,72,184,3.44228432563791,54.110237735501805
Task_2744,2219,316,172,84,256,7.0,43.4177275232633
Task_2745,1621,506,70,149,219,3.1972386587771204,34.938658614343666
Task_2746,1873,775,63,118,181,2.413659793814433,39.3642194865454
Task_2747,2964,293,66,98,164,10.081632653061224,55.02832561043345
Task_2748,2332,626,78,68,146,3.719298245614035,45.44757158299522
Task_2749,1056,550,190,199,389,1.9165154264972777,26.830742049053743
Task_2750,1164,367,47,149,196,3.1630434782608696,27.068707671426953
Task_2751,2379,565,39,37,76,4.203180212014134,44.52877144177023
Task_2752,2586,164,107,154,261,15.672727272727272,48.764463441204356
Task_2753,2926,1008,160,149,309,2.8999008919722495,57.453331533529195
Task_2754,1522,347,61,118,179,4.373563218390805,32.44081295546879
Task_2755,2014,767,138,140,278,2.6223958333333335,42.09676077888653
Task_2756,1203,800,142,160,302,1.5018726591760299,29.44595084410304
Task_2757,2705,741,59,41,100,3.6455525606469004,50.7438075398147
Task_2758,2688,800,46,63,109,3.355805243445693,51.283928527650666
Task_2759,2038,317,26,160,186,6.408805031446541,40.56322521822395
Task_2760,1504,419,50,130,180,3.580952380952381,32.472782774829206
Task_2761,937,895,187,19,206,1.0457589285714286,24.02950449481952
Task_2762,1670,444,97,161,258,3.752808988764045,35.59313201491221
Task_2763,858,926,24,138,162,0.9255663430420712,23.32710690261315
Task_2764,657,900,121,164,285,0.7291897891231964,21.03626356308747
Task_2765,2513,633,191,84,275,3.9637223974763405,49.18973409865412
Task_2766,535,945,177,36,213,0.5655391120507399,18.397977802443467
Task_2767,710,991,66,142,208,0.7157258064516129,21.978475617292457
Task_2768,2915,998,116,165,281,2.9179179179179178,57.145059542897776
Task_2769,1697,415,21,44,65,4.079326923076923,33.24623109392046
Task_2770,1009,982,49,94,143,1.0264496439471007,25.809103710408753
Task_2771,2219,363,13,143,156,6.096153846153846,43.253418899493376
Task_2772,1091,587,131,80,211,1.8554421768707483,26.238761874176856
Task_2773,822,204,176,156,332,4.009756097560976,21.701859774981177
Task_2774,2889,183,189,81,270,15.701086956521738,53.51767961015997
Task_2775,1404,116,98,200,298,12.0,29.959362993615215
Task_2776,1467,794,61,65,126,1.8452830188679246,32.241696542661515
Task_2777,1819,388,183,121,304,4.676092544987147,37.894928022655144
Task_2778,2002,803,150,15,165,2.490049751243781,40.43746618612209
Task_2779,1445,906,72,165,237,1.5931642778390298,33.47994534734412
Task_2780,904,72,43,193,236,12.383561643835616,21.44421829541913
Task_2781,967,736,199,152,351,1.3120759837177747,25.707738277709623
Task_2782,2150,420,89,18,107,5.10688836104513,40.901693863530305
Task_2783,2730,656,92,141,233,4.155251141552512,52.96516225529734
Task_2784,1313,526,53,184,237,2.49146110056926,30.287347862544646
Task_2785,1053,512,22,189,211,2.0526315789473686,25.816682471720128
Task_2786,1784,291,18,51,69,6.109589041095891,34.50189802053439
Task_2787,957,475,63,11,74,2.0105042016806722,21.52112484167421
Task_2788,2781,205,13,93,106,13.5,51.12930770704194
Task_2789,1339,308,191,90,281,4.333333333333333,29.726255277857167
Task_2790,2382,146,80,28,108,16.20408163265306,43.439424473528526
Task_2791,1878,112,159,147,306,16.61946902654867,37.19539207070886
Task_2792,2989,69,97,32,129,42.7,52.195550279784634
Task_2793,1979,164,24,184,208,11.993939393939394,39.025263261175716
Task_2794,1742,865,105,153,258,2.0115473441108547,38.02201207544085
Task_2795,2401,926,60,78,138,2.5900755124056096,47.629998841024054
Task_2796,1763,943,154,27,181,1.867584745762712,37.166492066258634
Task_2797,840,910,20,20,40,0.9220636663007684,21.022088402855072
Task_2798,1676,1019,42,156,198,1.6431372549019607,37.188673549774684
Task_2799,1626,207,153,143,296,7.8173076923076925,34.223495700506945
Task_2800,836,238,58,191,249,3.497907949790795,21.868328548344365
Task_2801,1829,441,17,116,133,4.138009049773756,37.1430741916097
Task_2802,808,694,81,145,226,1.162589928057554,22.533073309235295
Task_2803,1600,612,148,67,215,2.6101141924959217,34.221168775348346
Task_2804,2678,674,110,129,239,3.9674074074074075,52.13054918053382
Task_2805,2702,545,67,104,171,4.948717948717949,51.67992529399913
Task_2806,1970,768,17,142,159,2.5617685305591675,40.4878505700158
Task_2807,1316,381,129,128,257,3.445026178010471,29.712237274093784
Task_2808,1011,340,94,110,204,2.964809384164223,24.574089021112865
Task_2809,1438,204,33,37,70,7.014634146341463,28.526103661742464
Task_2810,2410,647,84,14,98,3.7191358024691357,45.700134235992216
Task_2811,1234,766,88,140,228,1.6088657105606259,29.517520980849966
Task_2812,1836,590,26,47,73,3.1065989847715736,36.053211134353795
Task_2813,1683,582,164,66,230,2.8867924528301887,35.485514146464205
Task_2814,1286,485,79,108,187,2.646090534979424,29.317373096108216
Task_2815,1875,492,112,100,212,3.8032454361054766,38.67139693841347
Task_2816,2557,445,155,125,280,5.733183856502242,49.65800424389945
Task_2817,1319,1007,186,175,361,1.308531746031746,32.203718721085856
Task_2818,2656,699,169,92,261,3.7942857142857145,51.80538768514135
Task_2819,1276,189,136,101,237,6.71578947368421,28.32030419462876
Task_2820,590,894,41,33,74,0.659217877094972,17.534903398771903
Task_2821,2163,185,176,132,308,11.629032258064516,42.50129143777742
Task_2822,951,759,113,118,231,1.2513157894736842,24.864354878708365
Task_2823,2310,895,192,171,363,2.578125,47.61503740531274
Task_2824,1521,226,99,85,184,6.700440528634362,31.573250330275368
Task_2825,2383,575,57,35,92,4.137152777777778,45.12179472887643
Task_2826,2169,154,20,46,66,13.993548387096775,39.76710957497797
Task_2827,2194,975,170,193,363,2.247950819672131,46.058438706287426
Task_2828,674,347,190,119,309,1.9367816091954022,19.66869374699905
Task_2829,2096,108,118,83,201,19.229357798165136,39.806713875916635
Task_2830,2713,710,41,119,160,3.8157524613220817,52.12465976452055
Task_2831,2709,507,198,86,284,5.332677165354331,51.96290460932486
Task_2832,676,487,194,90,284,1.3852459016393444,19.755377634400016
Task_2833,1266,829,136,140,276,1.5253012048192771,30.387622492510427
Task_2834,1650,878,155,25,180,1.8771331058020477,35.16169464241191
Task_2835,892,895,21,115,136,0.9955357142857143,23.58428416488823
Task_2836,1387,837,118,34,152,1.6551312649164678,30.683735819362216
Task_2837,2848,625,176,72,248,4.5495207667731625,54.208364279168684
Task_2838,827,120,186,95,281,6.8347107438016526,20.733915315685504
Task_2839,1273,691,109,103,212,1.8395953757225434,29.76933376481252
Task_2840,2271,355,158,171,329,6.379213483146067,45.122568503087535
Task_2841,2800,621,107,87,194,4.501607717041801,53.373838098595
Task_2842,1096,743,72,105,177,1.4731182795698925,26.868213189960755
Task_2843,1917,756,128,96,224,2.532364597093791,40.24137657040129
Task_2844,1069,395,85,159,244,2.6994949494949494,25.883095773836875
Task_2845,2418,972,70,110,180,2.4850976361767727,48.610958556545434
Task_2846,1580,837,192,181,373,1.8854415274463008,35.927474133420695
Task_2847,2817,825,19,67,86,3.4104116222760292,53.13919340843765
Task_2848,1371,739,61,25,86,1.8527027027027028,29.407307131507665
Task_2849,2107,814,35,119,154,2.585276073619632,42.81144100819156
Task_2850,2745,691,52,106,158,3.9667630057803467,52.694614153974015
Task_2851,1412,460,185,191,376,3.062906724511931,32.11273149940054
Task_2852,2918,246,38,80,118,11.813765182186234,53.48234879233706
Task_2853,2040,934,145,22,167,2.1818181818181817,41.44577594618885
Task_2854,2738,383,65,66,131,7.130208333333333,51.066519673843
Task_2855,1289,116,142,131,273,11.017094017094017,27.93707301948409
Task_2856,2259,456,40,120,160,4.9431072210065645,44.12551724256443
Task_2857,1329,66,68,23,91,19.83582089552239,25.523790598221762
Task_2858,2683,996,72,45,117,2.691073219658977,51.45554528455583
Task_2859,1324,636,40,59,99,2.0784929356357926,28.795289442196026
Task_2860,2595,586,182,167,349,4.420783645655877,51.087644206671484
Task_2861,1152,583,47,27,74,1.9726027397260273,25.169981375907323
Task_2862,2964,959,40,195,235,3.0875,57.64879668503221
Task_2863,1312,766,112,157,269,1.7105606258148631,30.94330610302482
Task_2864,2896,872,75,157,232,3.3172966781214206,56.353359599632945
Task_2865,970,601,147,88,235,1.611295681063123,24.510087052648387
Task_2866,1162,1014,64,98,162,1.1448275862068966,28.517496345033038
Task_2867,1376,552,71,48,119,2.488245931283906,29.44873571519464
Task_2868,2673,889,153,192,345,3.0033707865168537,53.2977325116654
Task_2869,754,390,56,118,174,1.9283887468030692,20.553520793614855
Task_2870,1156,940,118,194,312,1.228480340063762,29.149716872248863
Task_2871,1189,558,125,54,179,2.1270125223613596,27.159108044807994
Task_2872,2460,223,190,180,370,10.982142857142858,47.84018697754101
Task_2873,890,149,66,184,250,5.933333333333334,22.061682064289304
Task_2874,1601,189,99,118,217,8.426315789473684,33.38524201438656
Task_2875,1274,696,85,164,249,1.8278335724533716,30.104258307382338
Task_2876,1388,136,160,138,298,10.13138686131387,29.86032426789006
Task_2877,2647,568,114,145,259,4.6520210896309315,51.41562406460306
Task_2878,732,744,174,49,223,0.9825503355704698,20.798499069996737
Task_2879,2450,736,52,96,148,3.324287652645862,48.16936054089039
Task_2880,1938,873,179,192,371,2.217391304347826,41.71894656843353
Task_2881,908,870,174,66,240,1.04247990815155,24.0855494097287
Task_2882,772,408,78,190,268,1.8875305623471883,21.46162524573353
Task_2883,682,192,106,122,228,3.533678756476684,18.938483087844673
Task_2884,706,263,60,188,248,2.6742424242424243,19.8605584850471
Task_2885,2036,727,192,102,294,2.7967032967032965,42.33638896188443
Task_2886,1351,437,158,82,240,3.084474885844749,30.017976308766297
Task_2887,884,152,60,47,107,5.777777777777778,19.58085068128571
Task_2888,2800,600,172,103,275,4.658901830282862,53.95147909196023
Task_2889,1050,432,126,60,186,2.4249422632794455,24.578643122393117
Task_2890,2701,328,48,27,75,8.209726443768997,48.854643868834735
Task_2891,1954,760,118,188,306,2.5676741130091982,41.320888971539524
Task_2892,1207,602,200,45,245,2.001658374792703,27.772127579910435
Task_2893,1031,578,116,181,297,1.7806563039723662,26.067961407807783
Task_2894,593,601,125,153,278,0.9850498338870431,19.013176655325683
Task_2895,1581,328,100,151,251,4.805471124620061,33.73812762125862
Task_2896,1221,128,125,197,322,9.465116279069768,27.311539107463506
Task_2897,1407,727,116,65,181,1.9326923076923077,31.173717834832235
Task_2898,1227,501,127,189,316,2.444223107569721,29.040596497201037
Task_2899,602,374,147,34,181,1.6053333333333333,17.081139928072666
Task_2900,1291,341,87,12,99,3.7748538011695905,27.034626431449635
Task_2901,515,1006,113,78,191,0.5114200595829196,18.557227875685154
Task_2902,560,974,104,39,143,0.5743589743589743,18.289130378383746
Task_2903,2967,421,84,158,242,7.030805687203792,55.99192426066437
Task_2904,2884,719,162,45,207,4.0055555555555555,54.53100343037275
Task_2905,1640,175,27,11,38,9.318181818181818,31.11780426159959
Task_2906,1284,949,123,183,306,1.351578947368421,31.24545998518195
Task_2907,1041,735,172,55,227,1.4144021739130435,25.773244165051025
Task_2908,698,214,173,61,234,3.2465116279069766,18.6678225649902
Task_2909,2891,1004,91,57,148,2.876616915422886,55.2927298464393
Task_2910,1933,753,130,18,148,2.5636604774535807,38.81512724344831
Task_2911,2365,423,150,99,249,5.577830188679245,46.35450825540102
Task_2912,848,713,120,20,140,1.1876750700280112,21.54866319065899
Task_2913,2610,410,112,189,301,6.350364963503649,50.569839665804125
Task_2914,1348,893,164,154,318,1.5078299776286352,32.0952920169262
Task_2915,2566,546,25,37,62,4.691042047531993,47.46376180263635
Task_2916,843,716,161,183,344,1.1757322175732217,23.66586343051428
Task_2917,714,855,56,58,114,0.8341121495327103,20.053133033237277
Task_2918,2959,664,61,101,162,4.449624060150376,56.008876551508045
Task_2919,535,253,152,86,238,2.106299212598425,16.539550366149353
Task_2920,1475,812,64,127,191,1.8142681426814269,33.414660642945826
Task_2921,2623,933,151,69,220,2.808351177730193,51.42904256108821
Task_2922,2100,641,41,116,157,3.2710280373831777,42.18198260401167
Task_2923,596,989,156,178,334,0.602020202020202,20.746837025074004
Task_2924,1960,836,84,145,229,2.3416965352449224,41.2905968354328
Task_2925,1197,701,118,37,155,1.705128205128205,27.286574436196002
Task_2926,883,674,37,79,116,1.308148148148148,22.538020072385294
Task_2927,2737,409,26,15,41,6.675609756097561,49.32151965343561
Task_2928,922,312,51,78,129,2.9456869009584663,22.466009883947553
Task_2929,825,245,20,187,207,3.3536585365853657,21.348387088294373
Task_2930,1257,565,32,26,58,2.2208480565371023,26.81552223898306
Task_2931,675,161,136,30,166,4.166666666666667,17.27963914326259
Task_2932,2078,852,45,163,208,2.4361078546307153,43.094700846127246
Task_2933,1599,116,96,187,283,13.666666666666666,32.981995383857914
Task_2934,834,530,196,56,252,1.5706214689265536,21.984356854189553
Task_2935,1285,1016,173,86,259,1.263520157325467,30.784866420259174
Task_2936,2216,677,93,21,114,3.2684365781710913,43.11230141807306
Task_2937,2712,966,163,80,243,2.8045501551189247,53.24718789209869
Task_2938,2113,419,39,39,78,5.030952380952381,39.84672254841671
Task_2939,2709,573,67,160,227,4.719512195121951,52.41341016744238
Task_2940,2809,820,62,174,236,3.4214372716199755,54.84661342318054
Task_2941,2993,380,126,169,295,7.8556430446194225,56.47295814368573
Task_2942,2135,642,87,134,221,3.3203732503888026,43.363563176291585
Task_2943,2115,413,55,194,249,5.108695652173913,42.678182457673216
Task_2944,2879,341,160,104,264,8.41812865497076,54.30080163874072
Task_2945,2765,823,66,83,149,3.3555825242718447,53.12155699318985
Task_2946,759,603,31,149,180,1.2566225165562914,20.928279531438086
Task_2947,2982,525,88,124,212,5.669201520912548,56.35839807229971
Task_2948,1937,682,146,133,279,2.83601756954612,40.60479786738223
Task_2949,2398,295,17,71,88,8.10135135135135,44.812696178956344
Task_2950,2057,130,79,135,214,15.702290076335878,40.038681867193695
Task_2951,2850,349,158,186,344,8.142857142857142,54.350487750321065
Task_2952,619,956,94,113,207,0.6468129571577848,20.389806060955532
Task_2953,1737,325,83,57,140,5.328220858895706,34.81094883943869
Task_2954,2006,838,157,70,227,2.390941597139452,41.41484373608224
Task_2955,1402,892,87,38,125,1.5699888017917134,30.967707757395363
Task_2956,2842,769,168,146,314,3.690909090909091,55.391513633610906
Task_2957,820,568,158,98,256,1.4411247803163445,22.33743211855092
Task_2958,2023,934,149,136,285,2.1636363636363636,42.786031950009466
Task_2959,2366,261,166,142,308,9.030534351145038,46.16153779161889
Task_2960,2102,224,193,116,309,9.342222222222222,41.82146118362161
Task_2961,1037,752,103,178,281,1.3771580345285526,26.573159332881925
Task_2962,1481,455,29,99,128,3.2478070175438596,31.870999498110624
Task_2963,1519,817,173,148,321,1.8569682151589242,34.61604253608212
Task_2964,737,543,94,32,126,1.3547794117647058,19.595667502104096
Task_2965,2140,662,133,142,275,3.2277526395173455,43.75242910007154
Task_2966,1250,590,71,67,138,2.1150592216582065,28.137607184362967
Task_2967,1876,935,48,85,133,2.0042735042735043,39.47160264214497
Task_2968,2277,185,83,150,233,12.241935483870968,44.051705582009184
Task_2969,1769,885,185,148,333,1.9966139954853273,38.842751223565145
Task_2970,1440,1019,172,93,265,1.411764705882353,33.52440186900338
Task_2971,784,266,34,73,107,2.9363295880149813,19.547004600904476
Task_2972,710,1010,185,182,367,0.7022749752720079,22.684593535574738
Task_2973,2903,965,126,112,238,3.005175983436853,56.58034664426825
Task_2974,2833,367,191,113,304,7.698369565217392,53.855883425991465
Task_2975,2508,611,197,108,305,4.098039215686274,49.50475137503952
Task_2976,1772,474,109,26,135,3.7305263157894735,35.59035065053249
Task_2977,888,809,98,94,192,1.0962962962962963,23.742631831888854
Task_2978,2748,256,39,89,128,10.69260700389105,51.12092949761263
Task_2979,1068,452,68,111,179,2.357615894039735,25.5777438997261
Task_2980,2600,292,42,175,217,8.873720136518772,49.62310525437963
Task_2981,2974,1006,43,56,99,2.9533267130089373,56.17523892530922
Task_2982,2261,678,26,164,190,3.329896907216495,45.39818737287208
Task_2983,1877,793,32,121,153,2.363979848866499,39.110504717918204
Task_2984,2356,322,54,158,212,7.294117647058823,45.96773102737387
Task_2985,1985,87,193,195,388,22.556818181818183,39.100162362342
Task_2986,565,273,184,10,194,2.062043795620438,16.23867164625244
Task_2987,1940,829,111,61,172,2.3373493975903616,39.90933696958512
Task_2988,2669,70,32,39,71,37.59154929577465,46.211479814356416
Task_2989,2075,897,198,111,309,2.3106904231625833,43.56631190931082
Task_2990,886,907,122,71,193,0.9757709251101322,23.770765577698
Task_2991,2185,284,147,172,319,7.666666666666667,43.476139159188676
Task_2992,2969,465,191,127,318,6.371244635193133,56.41912944604653
Task_2993,700,441,42,114,156,1.583710407239819,19.334312684510326
Task_2994,1222,364,86,62,148,3.347945205479452,26.868552725977437
Task_2995,1683,729,190,173,363,2.3054794520547945,37.16578170383637
Task_2996,2109,343,191,106,297,6.130813953488372,42.28029559336062
Task_2997,2214,593,86,49,135,3.727272727272727,43.09021151665049
Task_2998,1837,930,55,197,252,1.9731471535982814,39.92561756465897
Task_2999,2305,905,17,199,216,2.5441501103752757,46.88330079168859
Task_3000,1316,884,18,91,109,1.4870056497175141,30.05346799557873
Task_3001,2278,509,81,89,170,4.466666666666667,44.62295062607902
Task_3002,2780,838,139,75,214,3.3134684147794995,53.707148568548064
Task_3003,1087,826,90,100,190,1.3143893591293834,27.114137194832796
Task_3004,2360,613,122,134,256,3.8436482084690553,46.98448430933315
Task_3005,962,986,20,32,52,0.9746707193515705,23.684064411690827
Task_3006,852,528,35,78,113,1.610586011342155,21.758540710151333
Task_3007,1373,738,140,17,157,1.857916102841678,29.948325006996885
Task_3008,1024,740,200,190,390,1.3819163292847503,26.838824224824375
Task_3009,1227,926,16,62,78,1.3236245954692556,27.865572018076577
Task_3010,1788,782,69,153,222,2.2835249042145596,38.4513977792348
Task_3011,2469,438,22,18,40,5.624145785876993,45.08534827343096
Task_3012,2231,975,62,41,103,2.285860655737705,43.89792317754543
Task_3013,654,735,184,67,251,0.8885869565217391,19.834014720869796
Task_3014,2083,665,119,62,181,3.1276276276276276,41.637331627643036
Task_3015,1394,553,78,162,240,2.5162454873646207,31.597065599743686
Task_3016,1885,871,47,148,195,2.161697247706422,40.065577738501354
Task_3017,637,1008,84,193,277,0.6313181367690783,21.21389763704874
Task_3018,1233,663,41,13,54,1.8569277108433735,26.534015143777378
Task_3019,1475,947,176,151,327,1.5559071729957805,34.31134645463563
Task_3020,1858,194,60,184,244,9.528205128205128,37.70180844424158
Task_3021,914,109,162,189,351,8.309090909090909,22.27171334640634
Task_3022,1318,570,132,94,226,2.308231173380035,30.09800890377261
Task_3023,1338,699,192,197,389,1.9114285714285715,31.759431711995575
Task_3024,625,967,133,81,214,0.6456611570247934,20.176959295603762
Task_3025,1095,249,93,139,232,4.38,25.80129223882848
Task_3026,2180,291,88,66,154,7.465753424657534,41.69695644737211
Task_3027,1605,423,143,49,192,3.785377358490566,33.387529964569374
Task_3028,967,343,95,150,245,2.811046511627907,24.11754332682662
Task_3029,2116,513,17,32,49,4.116731517509727,40.15659790673781
Task_3030,1657,850,110,98,208,1.9471210340775558,36.32587330972675
Task_3031,2752,864,190,122,312,3.1815028901734106,54.219854980474814
Task_3032,2292,940,96,57,153,2.4357066950053134,45.592210782989326
Task_3033,1762,666,68,154,222,2.6416791604197902,37.678763946920995
Task_3034,1596,556,146,130,276,2.865350089766607,34.78970717726957
Task_3035,1527,231,20,198,218,6.581896551724138,32.45587260644741
Task_3036,1458,484,116,73,189,3.0061855670103093,31.462472722386792
Task_3037,2179,191,188,61,249,11.348958333333334,42.14459651525832
Task_3038,1621,755,189,19,208,2.144179894179894,34.45463735440266
Task_3039,1859,184,128,158,286,10.04864864864865,37.639773563394876
Task_3040,2165,513,61,124,185,4.212062256809339,43.24128838929369
Task_3041,1044,825,187,157,344,1.2639225181598064,27.126097499076167
Task_3042,1376,378,145,13,158,3.6306068601583115,28.95195390539881
Task_3043,2614,281,138,25,163,9.26950354609929,48.448374690312
Task_3044,1791,275,164,63,227,6.489130434782608,36.18151827297134
Task_3045,1765,287,40,87,127,6.128472222222222,35.507730388880205
Task_3046,711,503,59,78,137,1.4107142857142858,19.52651647796942
Task_3047,685,756,79,40,119,0.904887714663144,19.171310597634793
Task_3048,748,333,153,176,329,2.2395209580838324,20.968413880187654
Task_3049,1926,530,41,41,82,3.6271186440677967,37.677931398368344
Task_3050,1054,409,123,165,288,2.5707317073170732,25.850025760219577
Task_3051,1750,287,174,161,335,6.076388888888889,36.666085915008104
Task_3052,715,725,192,60,252,0.9848484848484849,20.682443897090295
Task_3053,2846,631,17,124,141,4.503164556962025,53.83245212312545
Task_3054,2407,920,165,47,212,2.6134636264929423,47.67032686414897
Task_3055,2173,977,162,113,275,2.221881390593047,45.217988057955644
Task_3056,1843,811,140,200,340,2.269704433497537,39.892490801131835
Task_3057,1915,880,105,10,115,2.17366628830874,38.805076941167925
Task_3058,1717,827,160,108,268,2.073671497584541,37.48670341425028
Task_3059,1894,657,78,183,261,2.878419452887538,39.968026826805364
Task_3060,2790,257,167,52,219,10.813953488372093,51.901690942320805
Task_3061,652,486,118,101,219,1.3388090349075976,19.28414479239893
Task_3062,2095,442,158,179,337,4.729119638826185,42.672047009038465
Task_3063,1800,832,68,28,96,2.1608643457382954,36.783571574927755
Task_3064,1162,631,112,138,250,1.8386075949367089,28.046630567524968
Task_3065,2607,797,37,17,54,3.2669172932330826,48.6683538787114
Task_3066,1082,976,171,31,202,1.1074718526100307,26.77389319026821
Task_3067,2881,695,121,25,146,4.139367816091954,53.900755073454036
Task_3068,736,781,51,76,127,0.9411764705882353,20.818550576944627
Task_3069,1512,74,195,199,394,20.16,31.668301128455337
Task_3070,2459,1021,66,148,214,2.4060665362035225,49.78618000841567
Task_3071,704,264,167,200,367,2.6566037735849055,20.258130305121
Task_3072,529,986,118,100,218,0.53596757852077,18.940753319984257
Task_3073,1401,492,177,97,274,2.841784989858012,31.476226643024663
Task_3074,2304,786,159,58,217,2.9275730622617533,45.843583022172396
Task_3075,2492,552,23,34,57,4.506329113924051,46.375592406852455
Task_3076,2095,531,103,158,261,3.93796992481203,42.58489595173722
Task_3077,1534,123,198,121,319,12.370967741935484,32.10301239278407
Task_3078,1293,776,111,24,135,1.664092664092664,28.92637863473348
Task_3079,2824,101,40,98,138,27.686274509803923,50.73665093732026
Task_3080,2631,144,141,172,313,18.144827586206898,49.654830187188736
Task_3081,2834,824,32,185,217,3.435151515151515,55.09738842233079
Task_3082,1442,135,82,51,133,10.602941176470589,28.950045537620184
Task_3083,2779,263,69,10,79,10.526515151515152,49.90281480390854
Task_3084,2716,387,16,91,107,7.0,50.62941134284216
Task_3085,1222,744,168,199,367,1.640268456375839,29.952364051652733
Task_3086,1769,172,54,96,150,10.22543352601156,34.97057830770505
Task_3087,1016,860,37,149,186,1.1800232288037167,25.914328433347436
Task_3088,1347,358,13,79,92,3.752089136490251,28.672220563814136
Task_3089,2035,470,174,128,302,4.320594479830149,41.580316697946735
Task_3090,1129,686,80,137,217,1.6433770014556042,27.65904711437807
Task_3091,1623,133,114,26,140,12.111940298507463,31.695881884641455
Task_3092,2042,908,140,30,170,2.2464246424642464,41.472120886011275
Task_3093,915,209,134,165,299,4.357142857142857,23.051465200680244
Task_3094,2634,733,148,88,236,3.5885558583106265,51.29442681735474
Task_3095,2206,487,24,45,69,4.520491803278689,41.53077698386853
Task_3096,2652,145,126,13,139,18.164383561643834,47.94951241755385
Task_3097,2828,240,39,71,110,11.734439834024895,51.78766630517979
Task_3098,2942,553,115,165,280,5.310469314079422,56.16260978559793
Task_3099,2079,887,108,85,193,2.3412162162162162,42.76084993429413
Task_3100,2733,627,144,95,239,4.351910828025478,52.77442662655749
Task_3101,2147,259,50,34,84,8.257692307692308,40.29597843107818
Task_3102,855,941,132,65,197,0.9076433121019108,23.418235661244882
Task_3103,1524,275,192,138,330,5.521739130434782,32.99667589075073
Task_3104,1049,452,75,134,209,2.315673289183223,25.64152903714286
Task_3105,2938,257,154,121,275,11.387596899224807,55.006113833068184
Task_3106,950,291,98,174,272,3.2534246575342465,23.781639906710712
Task_3107,1947,786,197,53,250,2.473951715374841,40.4335664362797
Task_3108,2086,428,71,169,240,4.862470862470863,42.159262421537264
Task_3109,2362,742,167,67,234,3.1790040376850603,46.78508496240255
Task_3110,1719,562,142,94,236,3.053285968028419,36.467717236950854
Task_3111,2949,425,108,104,212,6.922535211267606,55.45871210151241
Task_3112,1620,253,171,130,301,6.377952755905512,34.29592966770169
Task_3113,1356,579,19,42,61,2.3379310344827586,28.38864812118582
Task_3114,1456,1019,76,116,192,1.427450980392157,33.690549437494305
Task_3115,1102,991,165,102,267,1.1108870967741935,28.078337264496493
Task_3116,2784,115,89,183,272,24.0,51.52514576165524
Task_3117,514,469,33,70,103,1.0936170212765957,15.702421973404924
Task_3118,1336,94,133,195,328,14.063157894736841,28.661630799911304
Task_3119,1460,164,170,175,345,8.848484848484848,31.419803993829177
Task_3120,2602,158,144,41,185,16.364779874213838,47.7280426863888
Task_3121,2807,358,198,12,210,7.818941504178273,52.05641051233675
Task_3122,1435,961,109,65,174,1.4916839916839917,32.40585342905732
Task_3123,1594,156,68,92,160,10.152866242038217,32.1716307603145
Task_3124,2962,684,61,51,112,4.324087591240876,55.050444697028176
Task_3125,1057,1000,165,172,337,1.055944055944056,27.842026281665383
Task_3126,1634,844,67,147,214,1.9337278106508875,36.16058480089634
Task_3127,1692,358,198,47,245,4.713091922005571,34.71572655931137
Task_3128,1042,845,103,70,173,1.2316784869976358,25.75438679595436
Task_3129,1857,280,58,184,242,6.608540925266904,38.102600969455736
Task_3130,668,983,193,107,300,0.6788617886178862,21.553012548364347
Task_3131,2986,692,155,60,215,4.308802308802309,56.33306836873512
Task_3132,576,766,180,77,257,0.7509778357235984,18.726415850046585
Task_3133,1290,269,167,174,341,4.777777777777778,29.38039799528771
Task_3134,2752,124,29,39,68,22.016,48.51874791387919
Task_3135,583,765,163,171,334,0.7610966057441253,19.66489210181042
Task_3136,1539,647,170,146,316,2.375,34.376850987279745
Task_3137,1657,593,84,70,154,2.7895622895622894,34.4973620253445
Task_3138,2546,373,85,62,147,6.807486631016043,47.85903888881605
Task_3139,2944,189,103,159,262,15.494736842105263,54.83888651100463
Task_3140,2109,217,106,104,210,9.674311926605505,41.44195356595022
Task_3141,2105,614,16,106,122,3.4227642276422765,41.99432359698572
Task_3142,2895,686,84,26,110,4.213973799126638,53.73233546820714
Task_3143,1552,578,134,82,216,2.680483592400691,33.53822071943064
Task_3144,511,497,60,81,141,1.0261044176706828,16.280822009285803
Task_3145,2304,191,149,20,169,12.0,43.123855871886086
Task_3146,1092,187,167,60,227,5.808510638297872,24.964138344736728
Task_3147,594,233,49,190,239,2.5384615384615383,17.98897836770404
Task_3148,569,804,163,53,216,0.7068322981366459,18.659461578895
Task_3149,2103,132,183,124,307,15.81203007518797,41.05353837962929
Task_3150,631,869,172,115,287,0.725287356321839,20.538655556788445
Task_3151,2644,548,130,165,295,4.816029143897996,51.49551721516921
Task_3152,1076,937,68,104,172,1.1471215351812367,27.165707803951236
Task_3153,1327,568,160,122,282,2.3321616871704745,30.5832366575394
Task_3154,1659,889,176,75,251,1.8640449438202247,36.27140992260479
Task_3155,2635,963,20,135,155,2.733402489626556,51.653309828666245
Task_3156,2832,490,82,34,116,5.767820773930754,52.23831899303059
Task_3157,2588,418,42,188,230,6.176610978520286,49.940369943533064
Task_3158,2127,534,27,162,189,3.9757009345794394,42.79658597549434
Task_3159,1211,340,105,39,144,3.5513196480938416,26.29910542031332
Task_3160,949,184,53,58,111,5.129729729729729,21.62776703212852
Task_3161,1323,627,191,63,254,2.106687898089172,30.03098383090691
Task_3162,2826,514,64,160,224,5.487378640776699,54.06806320719917
Task_3163,2174,905,58,124,182,2.3995584988962473,44.57880376014098
Task_3164,1267,772,57,66,123,1.6390685640362226,28.9586775967911
Task_3165,937,663,163,168,331,1.411144578313253,24.923327773636984
Task_3166,818,990,39,78,117,0.8254288597376388,22.465008316713398
Task_3167,2589,664,45,108,153,3.8932330827067667,49.91997561378346
Task_3168,955,431,103,38,141,2.2106481481481484,22.57354633156631
Task_3169,2203,473,125,164,289,4.647679324894515,44.243519417661595
Task_3170,1970,305,68,71,139,6.437908496732026,38.680016085850404
Task_3171,2859,431,165,94,259,6.618055555555555,54.19593268890198
Task_3172,2211,1001,83,94,177,2.2065868263473054,45.19421433859045
Task_3173,2365,619,166,169,335,3.814516129032258,47.490074158676215
Task_3174,2033,707,139,14,153,2.871468926553672,40.33476944881632
Task_3175,2756,701,107,58,165,3.925925925925926,52.4462262114514
Task_3176,1571,265,10,59,69,5.906015037593985,30.996063382493816
Task_3177,568,227,83,187,270,2.491228070175439,17.586984140015506
Task_3178,2059,945,196,192,388,2.1765327695560255,43.93703665685564
Task_3179,735,458,10,160,170,1.6013071895424837,20.22115197950072
Task_3180,1244,998,98,159,257,1.2452452452452452,30.43846919289734
Task_3181,2549,541,109,82,191,4.702952029520295,49.09312767952061
Task_3182,2546,921,134,144,278,2.761388286334056,51.01304761067727
Task_3183,2532,725,21,188,209,3.487603305785124,49.91071858452785
Task_3184,2548,915,54,175,229,2.7816593886462884,51.009702409024044
Task_3185,1227,349,175,149,324,3.505714285714286,28.533838498164545
Task_3186,2106,241,195,152,347,8.702479338842975,42.17130799164817
Task_3187,1368,237,112,26,138,5.7478991596638656,28.38041248404313
Task_3188,2774,531,107,99,206,5.214285714285714,52.98644891812453
Task_3189,1141,922,116,199,315,1.2361863488624052,28.877146850950442
Task_3190,2578,772,41,106,147,3.335058214747736,50.12353913647221
Task_3191,753,825,141,10,151,0.9116222760290557,20.588737500122438
Task_3192,611,336,200,81,281,1.8130563798219586,18.13241187081809
Task_3193,831,827,34,183,217,1.0036231884057971,23.10538881137828
Task_3194,1334,662,181,179,360,2.0120663650075414,31.423513981478337
Task_3195,2217,143,38,186,224,15.395833333333334,42.74776424231552
Task_3196,1455,209,35,127,162,6.928571428571429,30.665334136895364
Task_3197,1159,378,53,95,148,3.058047493403694,26.558142093383733
Task_3198,2746,748,52,124,176,3.6662216288384513,53.16387816107147
Task_3199,1462,392,36,179,215,3.7201017811704835,31.9520744414032
Task_3200,2705,209,182,112,294,12.880952380952381,51.21139603660081
Task_3201,1137,961,14,164,178,1.181912681912682,28.135333564825554
Task_3202,2025,231,105,180,285,8.72844827586207,40.616867255348986
Task_3203,2761,1004,87,79,166,2.74726368159204,53.654360324962845
Task_3204,2908,294,56,103,159,9.857627118644068,53.950214967587335
Task_3205,1757,219,141,30,171,7.986363636363636,34.74201534744938
Task_3206,933,240,41,61,102,3.871369294605809,21.413895823034817
Task_3207,2601,533,192,176,368,4.870786516853933,51.11156512521924
Task_3208,2319,990,58,81,139,2.340060544904137,46.56483899507939
Task_3209,1914,369,21,102,123,5.172972972972973,38.20812240300898
Task_3210,1056,276,150,126,276,3.812274368231047,25.341916274257937
Task_3211,2382,94,87,188,275,25.073684210526316,44.76848012269352
Task_3212,1263,769,20,134,154,1.6402597402597403,29.254811502052007
Task_3213,1876,537,20,89,109,3.486988847583643,37.8499799961886
Task_3214,1630,790,153,124,277,2.060682680151707,36.05707366664081
Task_3215,1202,527,112,85,197,2.2765151515151514,27.763055995199036
Task_3216,1368,115,49,53,102,11.793103448275861,27.336927601598955
Task_3217,956,910,79,164,243,1.0493962678375413,25.601442891365206
Task_3218,2642,266,53,53,106,9.895131086142323,48.58706487201164
Task_3219,1000,646,148,158,306,1.545595054095827,25.7665993991842
Task_3220,1020,937,181,91,272,1.0874200426439233,26.4823003380136
Task_3221,2264,911,120,102,222,2.482456140350877,46.199419679270115
Task_3222,2681,151,171,165,336,17.638157894736842,50.535233853987386
Task_3223,2601,100,72,65,137,25.752475247524753,47.01583488000128
Task_3224,2660,550,79,102,181,4.827586206896552,51.097514880841096
Task_3225,1246,476,155,125,280,2.6121593291404612,29.006387348444388
Task_3226,2249,318,54,57,111,7.0501567398119125,42.59737165342971
Task_3227,2462,840,168,146,314,2.9274673008323426,49.594035986360495
Task_3228,727,163,120,88,208,4.432926829268292,18.951397683582005
Task_3229,884,1009,62,199,261,0.8752475247524752,24.957724338260885
Task_3230,2011,83,189,132,321,23.94047619047619,39.117131359670665
Task_3231,1126,160,29,19,48,6.9937888198757765,23.099328607388614
Task_3232,2908,469,104,21,125,6.187234042553191,53.38137917582784
Task_3233,2734,146,88,73,161,18.598639455782312,49.594662604284814
Task_3234,1717,673,177,133,310,2.5474777448071215,37.23157105944217
Task_3235,688,628,98,72,170,1.0937996820349762,19.407453961359597
Task_3236,965,330,178,11,189,2.915407854984894,22.69715652051913
Task_3237,1705,562,198,51,249,3.02841918294849,35.83072790648497
Task_3238,1756,757,35,137,172,2.316622691292876,37.457565859267945
Task_3239,2314,328,28,58,86,7.033434650455927,43.408644630272306
Task_3240,1317,586,65,155,220,2.2436115843270867,30.375623476382813
Task_3241,1252,122,200,71,271,10.178861788617887,26.996083293787326
Task_3242,563,993,152,157,309,0.5663983903420523,19.988680474215467
Task_3243,1066,214,117,102,219,4.9581395348837205,24.99974161679494
Task_3244,1657,211,11,26,37,7.816037735849057,31.689371753496292
Task_3245,1864,802,50,179,229,2.3212951432129514,39.855528430520856
Task_3246,2368,245,57,179,236,9.626016260162602,46.0230874638907
Task_3247,1618,334,87,180,267,4.829850746268657,34.46626674000745
Task_3248,1243,929,49,152,201,1.3365591397849463,30.131105712675005
Task_3249,2049,630,37,23,60,3.2472266244057053,39.45275471575722
Task_3250,983,633,172,82,254,1.5504731861198737,24.831864292694096
Task_3251,2099,995,178,149,327,2.107429718875502,44.38844251394988
Task_3252,1198,572,27,64,91,2.0907504363001745,26.745952156221364
Task_3253,2197,457,81,124,205,4.796943231441048,43.76323709355071
Task_3254,1638,1003,14,150,164,1.6314741035856575,36.291925106837546
Task_3255,2126,818,151,152,303,2.595848595848596,44.160923805162646
Task_3256,2408,441,49,144,193,5.447963800904978,47.08317224646702
Task_3257,2971,948,23,100,123,3.130663856691254,56.9101661075081
Task_3258,1538,381,36,136,172,4.026178010471204,32.7942057340456
Task_3259,2317,232,107,196,303,9.944206008583691,45.33731220686019
Task_3260,2387,771,56,167,223,3.0919689119170983,47.96885117215353
Task_3261,1180,842,42,30,72,1.3997627520759193,26.401791458000613
Task_3262,1172,469,108,157,265,2.4936170212765956,27.792183312566422
Task_3263,1283,730,31,96,127,1.7551299589603284,29.493593930824193
Task_3264,1184,224,80,39,119,5.262222222222222,25.29427442541261
Task_3265,2246,955,49,118,167,2.3493723849372383,45.797332550296915
Task_3266,2039,752,109,198,307,2.7078353253652057,42.661580425106514
Task_3267,2435,306,37,90,127,7.931596091205212,46.217884669274774
Task_3268,2692,577,180,154,334,4.657439446366782,52.50826549702136
Task_3269,2212,867,171,59,230,2.5483870967741935,44.68539883857715
Task_3270,2809,394,161,138,299,7.111392405063291,53.58156741976745
Task_3271,1603,761,186,192,378,2.1036745406824147,36.09380919047585
Task_3272,1454,262,60,59,119,5.52851711026616,29.919734193363755
Task_3273,923,263,108,194,302,3.496212121212121,23.414028016692573
Task_3274,2113,997,135,16,151,2.117234468937876,42.52748973506956
Task_3275,2764,176,99,193,292,15.615819209039548,51.70482757676345
Task_3276,1320,809,47,38,85,1.6296296296296295,29.038034354282917
Task_3277,1811,128,113,94,207,14.03875968992248,35.887296598222626
Task_3278,2461,450,176,187,363,5.4567627494456765,48.61987964057369
Task_3279,2913,760,110,127,237,3.8278580814717476,56.11303915874034
Task_3280,1031,639,17,86,103,1.6109375,24.63429135274582
Task_3281,2426,297,73,31,104,8.140939597315436,45.05354243038662
Task_3282,974,432,41,175,216,2.2494226327944573,24.35936930891009
Task_3283,874,670,179,22,201,1.3025335320417288,22.489351024350672
Task_3284,608,972,116,124,240,0.6248715313463515,20.381563192994925
Task_3285,1153,398,147,27,174,2.889724310776942,25.876054124352734
Task_3286,1434,1013,55,173,228,1.4142011834319526,33.557320457101945
Task_3287,1067,878,13,194,207,1.2138794084186575,27.109340916506394
Task_3288,1129,566,22,161,183,1.9911816578483246,26.84334768959766
Task_3289,1733,653,125,189,314,2.649847094801223,37.52237357062538
Task_3290,873,488,82,102,184,1.7852760736196318,22.58764757542728
Task_3291,2024,196,11,143,154,10.274111675126903,39.44799508742218
Task_3292,1726,726,105,34,139,2.37414030261348,35.66060798013873
Task_3293,1029,313,129,129,258,3.2770700636942673,24.959109510466224
Task_3294,2648,367,130,13,143,7.195652173913044,48.997630157254434
Task_3295,694,811,121,162,283,0.854679802955665,21.29998427462102
Task_3296,1434,143,15,30,45,9.958333333333334,28.130910592418775
Task_3297,1697,108,122,117,239,15.568807339449542,33.96519493751431
Task_3298,1753,791,147,167,314,2.2133838383838382,38.23866098387813
Task_3299,2327,128,176,172,348,18.03875968992248,44.801313299920814
Task_3300,2207,124,157,71,228,17.656,41.839653589331256
Task_3301,2647,515,173,157,330,5.12984496124031,51.58269548278772
Task_3302,1825,127,33,125,158,14.2578125,35.46654558942348
Task_3303,1934,218,21,190,211,8.831050228310502,38.79335170893207
Task_3304,713,825,163,63,226,0.8631961259079903,20.883768233284282
Task_3305,1486,292,176,96,272,5.071672354948806,32.15387951564099
Task_3306,2077,252,143,18,161,8.209486166007904,39.52582692044085
Task_3307,2184,347,124,199,323,6.275862068965517,43.73353382597608
Task_3308,2774,624,176,27,203,4.4384,52.46006669629878
Task_3309,1832,555,190,91,281,3.2949640287769784,38.342722352035416
Task_3310,1110,907,57,44,101,1.222466960352423,26.015352232285966
Task_3311,1175,321,87,10,97,3.6490683229813663,25.16268683719989
Task_3312,2998,310,188,90,278,9.639871382636656,55.95167508829716
Task_3313,2160,989,153,99,252,2.1818181818181817,44.91032516619911
Task_3314,860,721,34,35,69,1.1911357340720221,21.08905823590867
Task_3315,2466,443,89,99,188,5.554054054054054,47.746095767455664
Task_3316,1011,188,55,142,197,5.349206349206349,24.187256316855336
Task_3317,1603,435,47,143,190,3.676605504587156,34.1863261220366
Task_3318,2625,721,171,150,321,3.6357340720221605,51.83995300654808
Task_3319,808,914,90,133,223,0.8830601092896175,23.12491342009496
Task_3320,1840,754,114,93,207,2.437086092715232,38.845340300473985
Task_3321,1861,599,184,32,216,3.1016666666666666,38.03780840037847
Task_3322,897,593,132,116,248,1.5101010101010102,23.6473171138271
Task_3323,947,157,146,180,326,5.993670886075949,23.24238046375584
Task_3324,1823,681,91,115,206,2.6730205278592374,38.48979073827314
Task_3325,620,790,13,83,96,0.7838179519595448,18.601052945294878
Task_3326,1992,226,148,65,213,8.775330396475772,39.1441646841425
Task_3327,2971,489,83,20,103,6.063265306122449,54.02824849854869
Task_3328,2627,988,180,79,259,2.6562184024266937,52.03189887574528
Task_3329,654,945,38,139,177,0.6913319238900634,20.441659509164058
Task_3330,670,749,142,103,245,0.8933333333333333,20.470759763968225
Task_3331,1503,996,109,166,275,1.5075225677031092,34.694583121429105
Task_3332,2229,491,135,97,232,4.530487804878049,44.39164199340902
Task_3333,2520,291,13,68,81,8.63013698630137,46.73245981882088
Task_3334,1756,179,88,88,176,9.755555555555556,34.838406285075024
Task_3335,2307,411,107,175,282,5.599514563106796,45.67216005452351
Task_3336,2962,637,35,128,163,4.6426332288401255,56.02712501572679
Task_3337,2486,420,59,72,131,5.904988123515439,47.33605188434796
Task_3338,2447,718,22,89,111,3.403337969401947,47.502673232110254
Task_3339,1041,948,115,35,150,1.0969441517386722,25.527970463850476
Task_3340,2964,732,118,83,201,4.043656207366985,56.312419484736154
Task_3341,1128,341,26,96,122,3.2982456140350878,25.765852147995332
Task_3342,2292,832,124,58,182,2.751500600240096,45.45160989916059
Task_3343,2728,87,185,182,367,31.0,50.63956291691748
Task_3344,1124,346,35,200,235,3.239193083573487,26.598015064172667
Task_3345,1758,451,156,39,195,3.8893805309734515,35.80171332317054
Task_3346,1586,453,98,24,122,3.4933920704845813,32.41157309232897
Task_3347,1714,785,122,42,164,2.1806615776081424,35.95829988581375
Task_3348,1905,86,85,49,134,21.896551724137932,35.343580307699376
Task_3349,1547,691,130,33,163,2.235549132947977,32.96346151807436
Task_3350,2618,471,46,68,114,5.546610169491525,49.34608282618213
Task_3351,662,250,80,124,204,2.637450199203187,18.830369887258218
Task_3352,2581,885,150,86,236,2.9130925507900676,50.91673968344943
Task_3353,2065,990,147,58,205,2.083753784056509,42.63896962299189
Task_3354,2020,215,56,95,151,9.351851851851851,39.59578641490546
Task_3355,855,947,58,121,179,0.9018987341772152,23.62299039755037
Task_3356,1807,454,70,103,173,3.9714285714285715,37.37014516770735
Task_3357,2117,261,190,90,280,8.080152671755725,41.859447669466704
Task_3358,1175,225,199,67,266,5.199115044247788,26.478395532015004
Task_3359,2339,863,161,124,285,2.707175925925926,47.5541636516103
Task_3360,2065,828,184,148,332,2.4909529553679133,43.35054190426257
Task_3361,2020,999,147,129,276,2.02,42.889783407251834
Task_3362,2927,424,57,192,249,6.8870588235294115,55.56165199289513
Task_3363,1204,1001,170,32,202,1.2015968063872255,28.8578883162031
Task_3364,2354,924,50,39,89,2.544864864864865,45.70923942590011
Task_3365,2275,844,84,34,118,2.6923076923076925,44.530886335982295
Task_3366,1534,169,51,43,94,9.023529411764706,30.150733603131595
Task_3367,2545,998,177,190,367,2.5475475475475475,51.70592030618989
Task_3368,1230,619,76,31,107,1.9838709677419355,27.20626470702804
Task_3369,743,460,66,140,206,1.6117136659436009,20.791641396000745
Task_3370,1613,734,75,25,100,2.1945578231292515,33.58879083375485
Task_3371,1348,730,95,21,116,1.844049247606019,29.49512478177903
Task_3372,1531,731,145,99,244,2.091530054644809,34.104544577410756
Task_3373,1279,265,41,26,67,4.80827067669173,26.133297891178845
Task_3374,546,685,92,118,210,0.7959183673469388,18.258910930327346
Task_3375,2403,67,196,95,291,35.338235294117645,44.956636284938156
Task_3376,1871,582,117,190,307,3.20926243567753,39.4541890587546
Task_3377,2959,851,41,36,77,3.473004694835681,54.6073273786834
Task_3378,2559,197,33,87,120,12.924242424242424,47.719871396027465
Task_3379,1448,110,129,56,185,13.045045045045045,29.263948824974204
Task_3380,1308,460,42,19,61,2.8373101952277655,26.96796522080331
Task_3381,2810,225,110,144,254,12.43362831858407,52.79986306910166
Task_3382,1446,74,98,194,292,19.28,30.16788599343219
Task_3383,1154,1018,108,158,266,1.1324828263002944,29.140448015738485
Task_3384,2198,513,192,111,303,4.276264591439689,44.278476967333575
Task_3385,1225,1021,35,68,103,1.1986301369863013,28.753024407633415
Task_3386,2682,978,20,57,77,2.73953013278856,50.87966361021359
Task_3387,1695,813,135,128,263,2.0823095823095823,37.101312989564455
Task_3388,2654,349,138,181,319,7.582857142857143,51.13019517300038
Task_3389,2950,234,42,187,229,12.553191489361701,55.01044434548809
Task_3390,1874,848,12,135,147,2.2073027090694937,39.244336560419455
Task_3391,1937,852,82,54,136,2.2708089097303636,39.73944576551375
Task_3392,1185,194,55,24,79,6.076923076923077,24.670613901954805
Task_3393,2803,496,19,54,73,5.639839034205232,51.339119501480944
Task_3394,2777,287,150,33,183,9.64236111111111,51.17895903731047
Task_3395,1047,831,11,102,113,1.2584134615384615,25.789547842555454
Task_3396,2343,722,199,120,319,3.240663900414938,47.322955767765734
Task_3397,1559,568,48,177,225,2.739894551845343,34.204023755083035
Task_3398,1864,538,103,112,215,3.458256029684601,38.674920069176146
Task_3399,1566,611,89,25,114,2.5588235294117645,32.544289133419845
Task_3400,999,230,199,35,234,4.324675324675325,23.295598589846502
Task_3401,1138,367,187,18,205,3.092391304347826,25.545845155022146
Task_3402,2649,121,62,172,234,21.71311475409836,49.40676857878094
Task_3403,1189,132,147,44,191,8.93984962406015,25.371188587003108
Task_3404,1597,588,196,61,257,2.711375212224109,34.19075498759572
Task_3405,2012,67,135,72,207,29.58823529411765,38.01593666055675
Task_3406,1756,877,54,108,162,2.0,37.6612995802079
Task_3407,1835,765,78,71,149,2.39556135770235,38.03740129715132
Task_3408,2464,432,183,170,353,5.690531177829099,48.538438633301304
Task_3409,1989,248,31,41,72,7.9879518072289155,37.36143967803776
Task_3410,2444,256,73,67,140,9.509727626459144,45.9491364310764
Task_3411,768,232,58,187,245,3.296137339055794,20.750492359950147
Task_3412,1539,566,148,33,181,2.7142857142857144,32.498958217916176
Task_3413,1810,249,51,184,235,7.24,37.26160215404164
Task_3414,2559,713,138,152,290,3.5840336134453783,50.6324332980225
Task_3415,2302,647,148,87,235,3.552469135802469,45.75583871076742
Task_3416,1118,653,198,81,279,1.709480122324159,27.133012988661232
Task_3417,1662,281,64,171,235,5.8936170212765955,34.94652683006026
Task_3418,2660,832,196,140,336,3.19327731092437,52.79643644936899
Task_3419,2383,601,98,56,154,3.9584717607973423,46.02684227875559
Task_3420,2956,449,64,99,163,6.568888888888889,55.362922965822776
Task_3421,1593,781,110,73,183,2.0370843989769822,34.34252753678857
Task_3422,1247,413,193,16,209,3.0120772946859904,27.519086453806523
Task_3423,2087,627,198,45,243,3.323248407643312,41.778431055680755
Task_3424,1329,576,152,95,247,2.3032928942807627,30.414558329202205
Task_3425,2403,229,49,189,238,10.447826086956521,46.54192929892161
Task_3426,2865,937,67,29,96,3.0543710021321964,54.00132648784706
Task_3427,2308,735,119,80,199,3.135869565217391,45.92467534831968
Task_3428,2895,933,46,86,132,3.099571734475375,55.51875396340042
Task_3429,2512,93,31,102,133,26.72340425531915,45.669630724983854
Task_3430,1009,819,124,153,277,1.2304878048780488,26.22788112019373
Task_3431,678,495,145,38,183,1.3669354838709677,18.68151682079254
Task_3432,971,388,69,162,231,2.4961439588688945,24.330201131566312
Task_3433,2386,686,105,192,297,3.473071324599709,47.89706944654191
Task_3434,1593,66,148,10,158,23.776119402985074,30.401674623701172
Task_3435,2998,228,43,153,196,13.091703056768559,55.546352437915154
Task_3436,549,1003,26,191,217,0.546812749003984,19.36798199113449
Task_3437,1987,916,48,100,148,2.1668484187568158,41.29101258605365
Task_3438,1424,843,173,93,266,1.6872037914691944,32.78443789388093
Task_3439,2732,313,171,154,325,8.700636942675159,52.22663999826966
Task_3440,1675,894,61,185,246,1.8715083798882681,37.17141020288634
Task_3441,2868,238,102,190,292,12.0,54.00541164972509
Task_3442,2435,440,85,15,100,5.521541950113379,45.449954117643735
Task_3443,822,400,160,172,332,2.0498753117206983,22.358956563320884
Task_3444,2498,118,26,25,51,20.991596638655462,44.617128620618985
Task_3445,2848,989,32,54,86,2.8767676767676766,54.021620669193794
Task_3446,1098,554,115,168,283,1.9783783783783784,26.98511429270148
Task_3447,1888,733,23,197,220,2.5722070844686646,39.91259854281687
Task_3448,2142,683,71,97,168,3.1315789473684212,43.28960431376131
Task_3449,2433,683,25,47,72,3.557017543859649,45.80334137112333
Task_3450,1321,873,88,168,256,1.511441647597254,31.363593535510617
Task_3451,1571,148,56,135,191,10.543624161073826,32.448757720312386
Task_3452,2211,811,29,168,197,2.7229064039408866,45.07239572638463
Task_3453,843,337,108,34,142,2.4940828402366866,20.485919195233755
Task_3454,2716,339,157,16,173,7.988235294117647,50.27097294978528
Task_3455,1078,127,35,101,136,8.421875,23.52865632336322
Task_3456,2020,242,52,137,189,8.312757201646091,40.225149415160395
Task_3457,893,987,51,117,168,0.9038461538461539,24.305239619457694
Task_3458,2507,948,159,112,271,2.6417281348788197,50.40086197067141
Task_3459,1201,700,181,115,296,1.7132667617689015,29.03964022750887
Task_3460,1430,603,104,61,165,2.3675496688741724,31.122734804591747
Task_3461,538,539,182,153,335,0.9962962962962963,18.18628849586911
Task_3462,561,646,21,90,111,0.8670788253477589,17.263022268343096
Task_3463,1844,893,174,108,282,2.062639821029083,39.76752672515399
Task_3464,1356,788,42,75,117,1.7186311787072244,30.467403563703567
Task_3465,2820,474,41,199,240,5.936842105263158,53.85650955200293
Task_3466,721,863,180,67,247,0.8344907407407407,21.24811552777844
Task_3467,1850,388,27,114,141,4.755784061696658,37.370342051307524
Task_3468,818,134,172,43,215,6.059259259259259,19.655474069991985
Task_3469,2088,666,71,193,264,3.130434782608696,43.09356243183964
Task_3470,2962,580,131,182,313,5.098106712564544,56.73989896497051
Task_3471,2661,458,100,140,240,5.7973856209150325,51.18840817988647
Task_3472,606,489,179,115,294,1.236734693877551,18.841108488092953
Task_3473,671,97,60,197,257,6.846938775510204,17.980529526633088
Task_3474,2042,315,106,57,163,6.462025316455696,39.8031822765062
Task_3475,590,993,99,24,123,0.5935613682092555,18.612733028653935
Task_3476,2447,78,140,149,289,30.974683544303797,45.747064182685364
Task_3477,1389,845,74,68,142,1.6418439716312057,31.172338829507705
Task_3478,2179,385,161,88,249,5.6450777202072535,43.03282742215405
Task_3479,1257,380,93,69,162,3.2992125984251968,27.626732456793235
Task_3480,1214,344,136,18,154,3.5188405797101447,26.128703853298433
Task_3481,2590,714,22,74,96,3.6223776223776225,49.369688351841
Task_3482,928,842,42,152,194,1.1008303677342823,24.531525651952112
Task_3483,947,1004,183,107,290,0.9422885572139303,25.858567336470824
Task_3484,1597,333,109,107,216,4.781437125748503,33.785440681828504
Task_3485,1109,785,50,179,229,1.410941475826972,27.73439708053544
Task_3486,1745,1022,147,122,269,1.7057673509286413,38.54796648699264
Task_3487,952,243,52,103,155,3.901639344262295,22.857975687285332
Task_3488,1756,200,59,109,168,8.7363184079602,35.589375266842715
Task_3489,2306,572,40,50,90,4.024432809773124,43.94448139805346
Task_3490,977,220,24,47,71,4.420814479638009,21.264429698168353
Task_3491,2167,137,98,51,149,15.702898550724637,40.49065209667477
Task_3492,2876,976,80,146,226,2.9437052200614127,56.309895816628305
Task_3493,2603,698,48,182,230,3.7238912732474962,51.178936615652134
Task_3494,1230,320,129,186,315,3.8317757009345796,28.500780196856397
Task_3495,979,306,157,153,310,3.188925081433225,24.415379696857183
Task_3496,2158,527,199,182,381,4.087121212121212,44.14563011755507
Task_3497,1170,944,198,74,272,1.2380952380952381,28.726462533866293
Task_3498,1846,135,59,114,173,13.573529411764707,36.44029394078884
Task_3499,1237,321,150,10,160,3.841614906832298,26.59373587781418
Task_3500,650,418,130,135,265,1.5513126491646778,19.294834851918612
Task_3501,1189,973,47,162,209,1.2207392197125257,29.25286242080701
Task_3502,960,468,158,79,237,2.046908315565032,23.89986991770087
Task_3503,828,64,13,61,74,12.738461538461538,17.716720473596194
Task_3504,970,684,41,185,226,1.416058394160584,25.02182647355403
Task_3505,2325,147,176,39,215,15.70945945945946,43.49501351277072
Task_3506,2373,789,27,23,50,3.0037974683544304,45.15467646455312
Task_3507,2664,434,191,116,307,6.124137931034483,51.423833426540625
Task_3508,1295,929,90,47,137,1.39247311827957,29.51967004367359
Task_3509,2333,510,156,188,344,4.5655577299412915,46.70383405383757
Task_3510,1676,136,158,50,208,12.233576642335766,33.20738588601272
Task_3511,1085,749,113,173,286,1.4466666666666668,27.339495592991256
Task_3512,711,111,185,110,295,6.348214285714286,18.70472345281227
Task_3513,1989,87,109,14,123,22.602272727272727,36.65510679097133
Task_3514,2403,979,69,54,123,2.4520408163265306,47.41901582132322
Task_3515,1003,102,37,155,192,9.737864077669903,22.898979863393237
Task_3516,2259,262,106,27,133,8.5893536121673,42.59301328251181
Task_3517,1181,311,27,164,191,3.78525641025641,27.146391314041026
Task_3518,1629,649,77,78,155,2.506153846153846,34.546681862306514
Task_3519,777,482,25,113,138,1.608695652173913,20.658527954445095
Task_3520,1283,770,66,152,218,1.6640726329442284,30.381774014417616
Task_3521,2902,698,82,179,261,4.1516452074391985,56.01958799918709
Task_3522,785,548,196,88,284,1.429872495446266,21.581270667759227
Task_3523,1145,567,64,76,140,2.015845070422535,26.54762850281963
Task_3524,2943,944,134,106,240,3.1142857142857143,57.14877429213775
Task_3525,2995,83,55,24,79,35.654761904761905,51.91964465208523
Task_3526,1120,848,145,58,203,1.3191990577149588,27.21217750823276
Task_3527,1218,100,83,70,153,12.05940594059406,25.112299799699898
Task_3528,1447,809,90,71,161,1.7864197530864196,31.939792442545194
Task_3529,2352,887,144,78,222,2.6486486486486487,47.18596143700097
Task_3530,2073,242,144,65,209,8.530864197530864,40.4640769216679
Task_3531,1346,510,186,141,327,2.6340508806262233,30.932171152449047
Task_3532,2408,278,107,53,160,8.630824372759857,45.40826965372127
Task_3533,1948,789,130,79,209,2.4658227848101264,40.426709591507255
Task_3534,1981,564,99,197,296,3.506194690265487,41.101434063702854
Task_3535,1363,673,199,26,225,2.022255192878338,30.377325857891808
Task_3536,867,752,80,123,203,1.151394422310757,23.541016966244673
Task_3537,2375,230,99,60,159,10.281385281385282,44.589490306396065
Task_3538,1909,256,115,16,131,7.428015564202335,36.90642367214669
Task_3539,1528,272,49,80,129,5.597069597069597,31.923357925867226
Task_3540,1380,260,34,144,178,5.287356321839081,29.843461434398733
Task_3541,811,473,64,31,95,1.7109704641350212,19.833439785684195
Task_3542,1996,87,77,68,145,22.681818181818183,37.37653746769953
Task_3543,2167,743,90,63,153,2.9126344086021505,43.002241178556595
Task_3544,2721,850,168,21,189,3.197414806110458,52.17663020992489
Task_3545,2053,344,110,184,294,5.95072463768116,41.49871008845373
Task_3546,1116,88,18,93,111,12.539325842696629,23.530091640876975
Task_3547,1821,334,59,87,146,5.435820895522388,36.68243315811814
Task_3548,1089,173,194,198,392,6.258620689655173,25.77070051788039
Task_3549,1524,733,188,71,259,2.076294277929155,33.60544324472206
Task_3550,1768,88,107,20,127,19.865168539325843,33.212919194218465
Task_3551,2437,794,37,96,133,3.0654088050314465,48.00734904285925
Task_3552,1880,70,70,42,112,26.47887323943662,34.508298188666984
Task_3553,1962,70,27,31,58,27.633802816901408,35.148198781391265
Task_3554,956,485,44,15,59,1.9670781893004115,21.50956445190324
Task_3555,1360,451,30,63,93,3.0088495575221237,29.016021004283903
Task_3556,1410,499,182,196,378,2.82,32.2211159437549
Task_3557,1625,551,21,198,219,2.943840579710145,35.056349646148
Task_3558,1516,513,80,47,127,2.9494163424124515,31.6301173883964
Task_3559,1205,352,45,116,161,3.413597733711048,27.102635375686884
Task_3560,1148,130,64,185,249,8.763358778625955,25.93255975796166
Task_3561,740,154,96,146,242,4.774193548387097,19.56738377012879
Task_3562,2104,736,54,104,158,2.8548168249660786,42.66885273188203
Task_3563,2346,519,106,151,257,4.5115384615384615,46.49222645826624
Task_3564,833,518,46,181,227,1.605009633911368,22.46418229299518
Task_3565,1575,222,168,136,304,7.062780269058296,33.498300760834816
Task_3566,2836,210,149,78,227,13.440758293838863,52.6340931162727
Task_3567,1595,807,110,157,267,1.974009900990099,35.55882761294063
Task_3568,570,643,90,89,179,0.8850931677018633,17.871039621863588
Task_3569,1278,461,37,18,55,2.7662337662337664,26.531892438473516
Task_3570,2295,187,58,40,98,12.207446808510639,42.49548274363422
Task_3571,1843,714,144,103,247,2.5776223776223777,39.02797636999874
Task_3572,740,385,146,83,229,1.9170984455958548,20.126118066944294
Task_3573,2956,72,63,36,99,40.49315068493151,50.91383119536989
Task_3574,2870,858,158,56,214,3.341094295692666,55.10636808287574
Task_3575,1187,65,136,25,161,17.984848484848484,24.1573006124618
Task_3576,2323,548,24,47,71,4.231329690346084,43.62744673680811
Task_3577,1549,1020,151,147,298,1.5171400587659158,35.5737400883678
Task_3578,2669,908,48,39,87,2.9361936193619362,50.61038129436048
Task_3579,1348,419,21,76,97,3.2095238095238097,28.75878321960793
Task_3580,1505,838,97,189,286,1.7938021454112039,34.38558207987078
Task_3581,2548,465,69,110,179,5.467811158798283,49.04347138127152
Task_3582,949,528,96,141,237,1.7939508506616257,24.350450484640806
Task_3583,1402,197,111,11,122,7.08080808080808,28.624863574236713
Task_3584,1136,946,91,126,217,1.1995776135163674,28.405896793097032
Task_3585,2565,1004,103,10,113,2.5522388059701493,49.547084387042695
Task_3586,2820,716,27,57,84,3.933054393305439,52.648238106551986
Task_3587,1604,806,148,106,254,1.9876084262701363,35.56495033670178
Task_3588,2902,987,73,47,120,2.937246963562753,54.959424314601314
Task_3589,2296,111,145,64,209,20.5,42.78779237768265
Task_3590,2663,465,36,68,104,5.714592274678112,49.76468042879957
Task_3591,873,982,43,195,238,0.8880976602238047,24.422363310463837
Task_3592,2814,718,58,179,237,3.913769123783032,54.64287707503044
Task_3593,954,679,112,129,241,1.4029411764705881,24.77952495349839
Task_3594,2011,751,72,94,166,2.6742021276595747,41.33489130416131
Task_3595,2666,550,192,140,332,4.838475499092559,51.98040966916958
Task_3596,1340,300,34,81,115,4.451827242524917,28.720710691924456
Task_3597,2628,384,54,49,103,6.825974025974026,48.46786206787446
Task_3598,1361,209,192,91,283,6.480952380952381,29.766108779885716
Task_3599,2838,781,195,82,277,3.629156010230179,54.82205352460331
Task_3600,809,1023,150,75,225,0.7900390625,23.134128475970403
Task_3601,1185,332,96,182,278,3.5585585585585586,27.708388397732595
Task_3602,1606,200,141,40,181,7.990049751243781,32.349149780755546
Task_3603,1727,898,83,132,215,1.9210233592880979,37.716017603929956
Task_3604,1407,797,47,81,128,1.763157894736842,31.591390140043405
Task_3605,1681,67,173,178,351,24.720588235294116,34.034432940065564
Task_3606,2122,186,42,152,194,11.3475935828877,41.69838115653662
Task_3607,1521,991,162,196,358,1.533266129032258,35.382394024423256
Task_3608,869,920,159,129,288,0.9435396308360477,24.391172567102274
Task_3609,2394,620,125,26,151,3.8550724637681157,45.935303429807306
Task_3610,1169,977,102,118,220,1.1952965235173825,28.985347622064747
Task_3611,1192,897,187,116,303,1.3273942093541202,29.514806773241546
Task_3612,1734,848,132,154,286,2.0424028268551235,37.9700054883704
Task_3613,2898,449,168,53,221,6.44,54.289493213752614
Task_3614,633,529,166,77,243,1.1943396226415095,18.8660511107165
Task_3615,2524,96,146,198,344,26.02061855670103,47.3907101055891
Task_3616,1233,1022,55,77,132,1.2052785923753666,29.43167604843183
Task_3617,2369,958,152,122,274,2.470281543274244,48.273433263248315
Task_3618,779,843,199,61,260,0.9229857819905213,22.091514779330026
Task_3619,2016,632,62,138,200,3.184834123222749,41.477951968387664
Task_3620,2672,77,81,190,271,34.256410256410255,49.33463345292571
Task_3621,986,688,176,74,250,1.4310595065312046,24.929709211273103
Task_3622,2038,539,22,25,47,3.774074074074074,38.93263563872111
Task_3623,2222,856,112,70,182,2.592765460910152,44.49553838210321
Task_3624,914,779,181,142,323,1.1717948717948719,24.83118432236145
Task_3625,1136,460,130,175,305,2.4642082429501087,27.4005764774507
Task_3626,2015,160,87,93,180,12.51552795031056,38.994049927849694
Task_3627,2278,868,64,155,219,2.621403912543153,46.47922610223901
Task_3628,788,230,80,17,97,3.411255411255411,18.736668318453198
Task_3629,1283,145,189,63,252,8.787671232876713,27.597262914576945
Task_3630,2207,90,29,124,153,24.252747252747252,41.00044088354503
Task_3631,1171,584,119,110,229,2.0017094017094017,27.906588622671915
Task_3632,1042,422,33,173,206,2.4633569739952716,25.391339978628526
Task_3633,1705,275,107,47,154,6.177536231884058,33.91489308792763
Task_3634,2648,555,86,104,190,4.762589928057554,51.049375805078604
Task_3635,1030,991,89,101,190,1.0383064516129032,26.589994151852935
Task_3636,2678,561,127,135,262,4.765124555160142,51.882923422690624
Task_3637,2480,676,60,48,108,3.6632200886262924,47.05882638130418
Task_3638,1460,281,185,181,366,5.177304964539007,32.23062206468595
Task_3639,1492,691,113,155,268,2.1560693641618496,33.56692061210436
Task_3640,1767,290,131,33,164,6.072164948453608,35.22779333503631
Task_3641,2905,736,38,84,122,3.9416553595658073,54.94025852786107
Task_3642,2521,86,153,137,290,28.977011494252874,47.00468392597412
Task_3643,2386,828,162,194,356,2.8781664656212302,48.61199623910283
Task_3644,594,69,115,129,244,8.485714285714286,16.48451652807633
Task_3645,2729,920,128,167,295,2.963083604777416,54.02001970404765
Task_3646,728,541,193,63,256,1.3431734317343174,20.346947090516093
Task_3647,803,451,189,191,380,1.7765486725663717,22.449479470232337
Task_3648,2233,217,29,98,127,10.243119266055047,42.83884627533226
Task_3649,1889,444,83,104,187,4.244943820224719,38.64840159682445
Task_3650,600,702,20,141,161,0.8534850640113798,18.491907833563513
Task_3651,2357,332,138,150,288,7.078078078078078,46.18945503413337
Task_3652,2388,119,68,112,180,19.9,44.73065524623892
Task_3653,1636,1022,133,168,301,1.5992179863147604,37.032259343872234
Task_3654,2650,576,167,185,352,4.592720970537262,51.966542644766356
Task_3655,2607,845,17,89,106,3.0815602836879434,50.28182154241494
Task_3656,1117,942,37,19,56,1.1845174973488866,25.630487038436545
Task_3657,1236,404,174,163,337,3.051851851851852,28.932012597588784
Task_3658,764,522,94,79,173,1.4608030592734225,20.615545592091667
Task_3659,976,906,109,68,177,1.076074972436604,24.780368212942605
Task_3660,772,470,31,73,104,1.6390658174097665,19.969688665234177
Task_3661,623,744,59,147,206,0.836241610738255,19.6630990124136
Task_3662,2616,700,10,88,98,3.731811697574893,49.88443706189411
Task_3663,715,152,199,40,239,4.673202614379085,18.307956206836813
Task_3664,2748,996,82,12,94,2.756268806419258,52.19825000363687
Task_3665,705,122,85,173,258,5.7317073170731705,18.884195698500708
Task_3666,1225,807,113,176,289,1.516089108910891,29.781098546286433
Task_3667,2130,918,87,25,112,2.317736670293798,42.384833085524235
Task_3668,1905,752,193,163,356,2.5298804780876494,40.70831057672488
Task_3669,1683,91,43,160,203,18.293478260869566,33.57463702102933
Task_3670,2259,281,199,121,320,8.01063829787234,44.565088570063516
Task_3671,2677,107,61,152,213,24.787037037037038,49.32941389021649
Task_3672,1261,895,39,149,188,1.4073660714285714,30.0255994273691
Task_3673,1103,993,42,139,181,1.1096579476861168,27.510175707690053
Task_3674,2693,157,117,69,186,17.044303797468356,49.38917989092378
Task_3675,1176,956,60,162,222,1.2288401253918495,29.1674942162447
Task_3676,771,800,44,145,189,0.9625468164794008,21.917746249475353
Task_3677,1993,502,121,118,239,3.9622266401590456,40.7195322888629
Task_3678,2879,167,68,99,167,17.136904761904763,52.73064135959393
Task_3679,2183,378,191,100,291,5.759894459102902,43.531783086918274
Task_3680,2848,354,60,174,234,8.022535211267606,53.95065317040974
Task_3681,2785,529,85,113,198,5.254716981132075,53.20073388007793
Task_3682,2700,296,35,159,194,9.090909090909092,51.106948275427925
Task_3683,2806,74,186,88,274,37.413333333333334,51.08808035524141
Task_3684,902,987,139,81,220,0.9129554655870445,24.490079365634177
Task_3685,1921,110,60,49,109,17.306306306306308,35.66088096466578
Task_3686,1302,676,118,48,166,1.9231905465288035,29.058960513488273
Task_3687,506,415,161,86,247,1.2163461538461537,16.508833141515037
Task_3688,1065,401,73,29,102,2.6492537313432836,23.899994620949013
Task_3689,1286,817,94,106,200,1.5721271393643033,30.362691215196264
Task_3690,1124,956,194,165,359,1.174503657262278,28.90264563945648
Task_3691,1659,773,45,193,238,2.143410852713178,36.38903735159687
Task_3692,897,993,154,191,345,0.9024144869215291,25.40870943059939
Task_3693,1415,664,160,83,243,2.1278195488721803,31.75131651939456
Task_3694,698,730,182,100,282,0.9548563611491108,21.02567569510497
Task_3695,1926,293,86,123,209,6.551020408163265,38.88736339576915
Task_3696,2700,335,90,200,290,8.035714285714286,51.75610380336738
Task_3697,2585,669,78,20,98,3.8582089552238807,48.57671535983636
Task_3698,1923,483,106,79,185,3.9731404958677685,38.806804262899526
Task_3699,695,907,98,194,292,0.7654185022026432,21.73737283052101
Task_3700,2770,968,197,40,237,2.8586171310629513,53.687233477361985
Task_3701,2260,471,164,143,307,4.788135593220339,45.189678481523714
Task_3702,1330,777,182,149,331,1.7095115681233932,31.530393235191372
Task_3703,663,491,143,50,193,1.3475609756097562,18.70863629148448
Task_3704,1710,696,82,28,110,2.453371592539455,35.00714035489998
Task_3705,2987,283,93,175,268,10.517605633802816,56.03661501864412
Task_3706,1016,640,55,170,225,1.5850234009360376,25.816125010747296
Task_3707,2312,408,25,44,69,5.65281173594132,42.94861865345863
Task_3708,2109,175,85,187,272,11.982954545454545,41.34623119860631
Task_3709,1215,600,45,95,140,2.021630615640599,27.943825149301748
Task_3710,1239,556,196,174,370,2.2244165170556554,29.62495248430838
Task_3711,1821,296,176,41,217,6.1313131313131315,36.42120581685351
Task_3712,1233,818,50,64,114,1.5054945054945055,28.52334691681806
Task_3713,1143,228,156,64,220,4.991266375545852,25.757303657904036
Task_3714,2905,260,191,169,360,11.130268199233717,54.94938397075757
Task_3715,2228,176,46,43,89,12.587570621468927,41.0775398567145
Task_3716,2546,375,123,91,214,6.7712765957446805,48.758457280401615
Task_3717,1540,193,92,183,275,7.938144329896907,32.86252575462579
Task_3718,1889,276,98,102,200,6.819494584837545,38.14445190197591
Task_3719,1322,526,200,168,368,2.50853889943074,30.82701667647156
Task_3720,1156,208,30,38,68,5.5311004784688995,24.075455540339718
Task_3721,2194,718,180,92,272,3.0514603616133518,44.596493307739394
Task_3722,956,958,161,30,191,0.9968717413972888,24.750240321117655
Task_3723,1112,568,71,103,174,1.9543057996485063,26.725188562473182
Task_3724,2058,552,185,60,245,3.721518987341772,41.326313509473614
Task_3725,2888,617,167,145,312,4.673139158576052,55.62779046693159
Task_3726,1226,216,91,96,187,5.649769585253456,27.42399837205905
Task_3727,2361,451,91,47,138,5.2234513274336285,44.861996422849934
Task_3728,1249,473,137,172,309,2.6350210970464136,29.243991580204764
Task_3729,1557,266,101,116,217,5.831460674157303,32.94604374440355
Task_3730,1390,936,121,117,238,1.4834578441835646,32.479352240173114
Task_3731,1479,966,129,50,179,1.5294725956566702,32.84046703993905
Task_3732,1068,120,199,14,213,8.826446280991735,23.473289399260903
Task_3733,2082,266,93,173,266,7.797752808988764,41.65940067197301
Task_3734,1711,700,102,93,195,2.440798858773181,36.576859565339284
Task_3735,850,590,88,30,118,1.4382402707275803,21.185079630507897
Task_3736,2376,308,162,186,348,7.689320388349515,46.73060991137229
Task_3737,811,625,72,198,270,1.2955271565495208,22.67414166520643
Task_3738,947,469,73,128,201,2.0148936170212766,24.0266139500209
Task_3739,2308,232,165,160,325,9.905579399141631,45.241538535779455
Task_3740,2379,83,65,72,137,28.321428571428573,43.370806382504135
Task_3741,2278,662,173,53,226,3.4358974358974357,45.179475311807465
Task_3742,762,161,200,154,354,4.703703703703703,20.413400113960684
Task_3743,2372,976,23,185,208,2.427840327533265,48.26810806847067
Task_3744,760,845,109,121,230,0.8983451536643026,22.163981900694655
Task_3745,744,315,159,63,222,2.3544303797468356,19.738776708873424
Task_3746,757,297,131,23,154,2.540268456375839,18.96481233111344
Task_3747,1454,528,73,155,228,2.7485822306238186,32.40020853551918
Task_3748,2903,459,69,181,250,6.310869565217391,55.24885815699799
Task_3749,2993,161,87,127,214,18.47530864197531,54.93670537868369
Task_3750,1164,1012,200,71,271,1.1490621915103651,28.81685657577688
Task_3751,644,970,38,101,139,0.6632337796086509,20.052646235300866
Task_3752,2828,802,163,43,206,3.5217932752179326,53.9396232655738
Task_3753,1513,895,28,55,83,1.6886160714285714,32.56249375703637
Task_3754,1394,701,162,111,273,1.9857549857549857,32.00384058457718
Task_3755,788,927,195,180,375,0.8491379310344828,23.58895871020265
Task_3756,2228,670,121,141,262,3.3204172876304026,45.11143980071919
Task_3757,1018,511,117,47,164,1.98828125,24.084322390403184
Task_3758,1404,739,178,10,188,1.8972972972972972,30.9157792907065
Task_3759,2472,644,43,105,148,3.832558139534884,48.02122983919338
Task_3760,608,240,105,63,168,2.5228215767634854,16.902257983273277
Task_3761,2427,972,149,127,276,2.4943473792394655,49.25249484469308
Task_3762,1629,630,162,175,337,2.5816164817749603,35.88612449781805
Task_3763,1599,898,87,56,143,1.778642936596218,34.486761149002284
Task_3764,2991,524,117,169,286,5.6971428571428575,56.87751604840889
Task_3765,2221,580,121,120,241,3.8227194492254735,44.59027059092001
Task_3766,947,80,167,137,304,11.691358024691358,22.34362972989261
Task_3767,1718,873,164,84,248,1.965675057208238,37.22670171479235
Task_3768,2695,99,146,134,280,26.95,49.80831926242664
Task_3769,1373,446,21,138,159,3.0715883668903805,30.056270561187674
Task_3770,870,934,133,32,165,0.93048128342246,23.173469961641086
Task_3771,2752,309,84,75,159,8.87741935483871,51.06091395896627
Task_3772,571,157,16,127,143,3.6139240506329116,15.841309057475039
Task_3773,1701,696,27,200,227,2.4404591104734576,36.81527476884053
Task_3774,2975,337,101,97,198,8.801775147928995,55.53116357649447
Task_3775,2276,509,17,144,161,4.462745098039216,44.544122868109774
Task_3776,801,885,63,50,113,0.9040632054176072,21.362362927589732
Task_3777,1367,281,54,46,100,4.847517730496454,28.099578993387837
Task_3778,2783,822,97,64,161,3.3815309842041312,53.086502926514704
Task_3779,1583,286,53,165,218,5.515679442508711,33.67109103635023
Task_3780,2087,302,56,144,200,6.887788778877888,41.57049949130528
Task_3781,2363,467,86,84,170,5.049145299145299,45.659597707122735
Task_3782,2034,414,69,123,192,4.901204819277108,41.00147709151317
Task_3783,2539,760,122,168,290,3.3363994743758214,50.48707648956783
Task_3784,1843,875,184,101,285,2.103881278538813,39.698916733118736
Task_3785,1724,289,193,32,225,5.944827586206896,34.907023515043285
Task_3786,2628,812,89,123,212,3.2324723247232474,51.682707194957004
Task_3787,2589,206,113,134,247,12.507246376811594,49.188389619032556
Task_3788,2231,552,165,98,263,4.0343580470162745,44.729651490723775
Task_3789,1817,633,154,66,220,2.865930599369085,37.72323053366406
Task_3790,1649,874,60,48,108,1.8845714285714286,34.51380245534599
Task_3791,1376,672,42,33,75,2.0445765230312034,28.966423916161364
Task_3792,627,106,23,101,124,5.859813084112149,16.098657875464678
Task_3793,1375,506,190,13,203,2.712031558185404,29.830539016259408
Task_3794,762,894,37,185,222,0.8513966480446927,22.30257869429943
Task_3795,1315,896,176,49,225,1.4659977703455964,30.427774982195114
Task_3796,903,573,98,15,113,1.5731707317073171,21.807135103784827
Task_3797,2718,591,120,25,145,4.591216216216216,51.019123541028215
Task_3798,1871,1000,50,35,85,1.8691308691308692,38.29685371881713
Task_3799,615,73,120,40,160,8.31081081081081,15.15555858509745
Task_3800,569,71,164,44,208,7.902777777777778,15.02229953714658
Task_3801,1787,363,78,168,246,4.90934065934066,37.24496232467724
Task_3802,2354,753,20,105,125,3.1220159151193636,46.44422844748851
Task_3803,1051,330,190,60,250,3.175226586102719,24.70089204656034
Task_3804,2671,106,87,183,270,24.962616822429908,49.439868134511364
Task_3805,1426,111,151,52,203,12.732142857142858,29.11948192864543
Task_3806,1764,199,170,109,279,8.82,36.261852298464206
Task_3807,1532,86,10,140,150,17.60919540229885,30.40771777089448
Task_3808,2507,938,20,11,31,2.66986155484558,47.30976769598171
Task_3809,2044,114,166,190,356,17.77391304347826,40.24283725261733
Task_3810,774,910,67,126,193,0.849615806805708,22.494644980794273
Task_3811,2232,711,191,78,269,3.134831460674157,44.94532987752489
Task_3812,536,267,94,59,153,2.0,15.674702591973238
Task_3813,2596,366,185,76,261,7.073569482288828,49.49369653812838
Task_3814,1827,425,30,29,59,4.288732394366197,35.35571156114738
Task_3815,2833,116,47,103,150,24.213675213675213,51.110054821781354
Task_3816,1563,880,52,192,244,1.7741203178206584,35.38288903618568
Task_3817,1026,272,127,59,186,3.758241758241758,23.68146744566792
Task_3818,2184,110,51,75,126,19.675675675675677,40.539534295023266
Task_3819,2139,259,190,110,300,8.226923076923077,42.484224832300335
Task_3820,1534,649,89,80,169,2.36,33.112503121344886
Task_3821,2099,117,74,93,167,17.78813559322034,40.08916119436568
Task_3822,1387,551,88,63,151,2.51268115942029,30.024230425523058
Task_3823,2649,611,96,75,171,4.328431372549019,50.56164992005021
Task_3824,2084,77,78,73,151,26.71794871794872,38.72303147740052
Task_3825,1743,740,167,87,254,2.3522267206477734,37.27909585710406
Task_3826,1319,407,108,48,156,3.232843137254902,28.283170794812197
Task_3827,2311,649,189,25,214,3.5553846153846154,45.24547520707153
Task_3828,1628,969,116,155,271,1.6783505154639176,36.586844606184634
Task_3829,869,448,127,55,182,1.935412026726058,21.796028900272763
Task_3830,884,522,51,54,105,1.6902485659655833,21.576470475424312
Task_3831,2038,645,21,52,73,3.154798761609907,39.70294028774374
Task_3832,640,1016,197,18,215,0.6293018682399213,20.164775125401786
Task_3833,2777,947,10,132,142,2.929324894514768,53.8297586172666
Task_3834,956,861,90,189,279,1.1090487238979119,25.572974731581194
Task_3835,1249,443,77,188,265,2.813063063063063,29.099977140284352
Task_3836,2440,823,133,199,332,2.9611650485436893,49.35106189243711
Task_3837,2090,664,162,20,182,3.142857142857143,41.31928495136025
Task_3838,1650,289,197,10,207,5.689655172413793,33.50046325132994
Task_3839,2482,540,16,97,113,4.587800369685767,47.741492392265684
Task_3840,2094,752,32,163,195,2.7808764940239046,43.01640174928528
Task_3841,1866,897,58,104,162,2.0779510022271714,39.4588713313207
Task_3842,2574,641,95,53,148,4.009345794392523,49.26495500577076
Task_3843,2346,645,49,63,112,3.6315789473684212,45.505582442368194
Task_3844,2282,885,134,125,259,2.5756207674943568,46.60399860852067
Task_3845,1785,330,62,11,73,5.3927492447129906,34.137303267084924
Task_3846,584,74,147,95,242,7.786666666666667,16.31919178425505
Task_3847,2384,636,94,16,110,3.7425431711145998,45.5244591389331
Task_3848,1226,506,45,45,90,2.418145956607495,26.486066941472327
Task_3849,1609,392,126,200,326,4.094147582697201,34.80017148918689
Task_3850,715,988,22,24,46,0.7229524772497472,19.784943490640984
Task_3851,2083,842,148,140,288,2.4709371293001188,43.46940489204337
Task_3852,1517,131,31,139,170,11.492424242424242,30.964627489109645
Task_3853,2773,635,109,40,149,4.360062893081761,52.01475414476365
Task_3854,2311,240,120,140,260,9.589211618257261,44.996434087357784
Task_3855,2597,556,95,49,144,4.662477558348295,49.13854556297241
Task_3856,2452,491,169,12,181,4.983739837398374,46.5639528697512
Task_3857,2312,994,160,26,186,2.3236180904522614,46.10376878296369
Task_3858,1025,948,87,78,165,1.0800842992623814,25.9124937988051
Task_3859,977,263,188,57,245,3.7007575757575757,23.309798766856165
Task_3860,2229,278,42,181,223,7.989247311827957,43.74472408858094
Task_3861,2011,161,171,172,343,12.41358024691358,40.08142254428634
Task_3862,1233,134,138,58,196,9.133333333333333,26.379963839859396
Task_3863,909,290,79,162,241,3.1237113402061856,23.089724826056823
Task_3864,2576,127,81,84,165,20.125,47.55229514801996
Task_3865,1945,765,179,18,197,2.539164490861619,39.54377868604016
Task_3866,1988,817,194,187,381,2.430317848410758,42.37424965143678
Task_3867,2285,469,156,142,298,4.861702127659575,45.53690915090919
Task_3868,2201,259,163,51,214,8.465384615384615,42.52345667781076
Task_3869,1314,865,134,83,217,1.5173210161662818,30.621119057022984
Task_3870,1076,266,22,35,57,4.0299625468164795,22.971026050952702
Task_3871,589,486,74,28,102,1.2094455852156059,16.750860291688756
Task_3872,1621,767,81,147,228,2.1106770833333335,35.75933688617117
Task_3873,745,173,11,25,36,4.281609195402299,17.060511938663236
Task_3874,2856,165,21,198,219,17.204819277108435,52.84729842873026
Task_3875,957,524,89,174,263,1.822857142857143,24.617104845073623
Task_3876,735,219,25,47,72,3.340909090909091,17.444755423332516
Task_3877,1450,669,49,46,95,2.1641791044776117,30.699143608444675
Task_3878,1836,695,161,69,230,2.6379310344827585,38.26084146027414
Task_3879,2878,181,26,113,139,15.813186813186814,52.286352871784295
Task_3880,1747,316,44,129,173,5.511041009463723,35.88159019776495
Task_3881,2934,572,115,76,191,5.12041884816754,55.202143245445676
Task_3882,2770,264,32,99,131,10.452830188679245,51.485657490200346
Task_3883,2851,107,103,41,144,26.39814814814815,50.61947036425742
Task_3884,1264,238,31,126,157,5.2887029288702925,27.690627019240974
Task_3885,2116,273,134,76,210,7.7226277372262775,41.35347098622683
Task_3886,1680,81,124,103,227,20.48780487804878,33.438736389391416
Task_3887,1038,315,146,162,308,3.2848101265822787,25.381631448927948
Task_3888,1698,875,21,199,220,1.9383561643835616,37.23257632839692
Task_3889,575,337,105,188,293,1.7011834319526626,18.086842070668048
Task_3890,1072,920,123,36,159,1.1639522258414767,26.034228536246996
Task_3891,1688,323,67,26,93,5.209876543209877,33.392874229068475
Task_3892,783,944,165,18,183,0.8285714285714286,21.49959946142863
Task_3893,2793,945,127,176,303,2.9524312896405918,55.16154030309995
Task_3894,1301,385,75,114,189,3.3704663212435233,29.269961866369318
Task_3895,864,826,182,43,225,1.044740024183797,22.94632961833212
Task_3896,1842,429,188,37,225,4.283720930232558,37.248692548820515
Task_3897,2061,285,33,67,100,7.206293706293707,39.646160395609975
Task_3898,1304,928,106,33,139,1.403659849300323,29.596466680372174
Task_3899,1277,710,122,30,152,1.7960618846694796,28.55215896189715
Task_3900,1115,884,113,200,313,1.2598870056497176,28.357183010705768
Task_3901,1984,98,184,106,290,20.04040404040404,38.58335488519688
Task_3902,692,333,200,113,313,2.07185628742515,19.918273764803665
Task_3903,2728,177,168,163,331,15.325842696629213,51.271518040411706
Task_3904,2274,661,42,158,200,3.4350453172205437,45.57076555216864
Task_3905,2711,288,44,58,102,9.380622837370241,49.66623428457976
Task_3906,1400,74,14,132,146,18.666666666666668,28.24672298141439
Task_3907,2983,898,99,191,290,3.318131256952169,57.99024986045017
Task_3908,1969,580,14,170,184,3.3889845094664373,40.288320975785716
Task_3909,2320,638,37,85,122,3.6306729264475743,45.38469851639369
Task_3910,882,999,24,176,200,0.882,24.450100371614692
Task_3911,2596,900,169,151,320,2.881243063263041,51.93927315336782
Task_3912,1475,348,49,27,76,4.226361031518625,29.535827381668813
Task_3913,2521,694,152,150,302,3.627338129496403,50.021685908017936
Task_3914,2577,112,137,35,172,22.805309734513273,46.75569873797883
Task_3915,953,912,59,50,109,1.0438116100766703,23.65958059029911
Task_3916,833,953,145,158,303,0.8731656184486373,24.025607859346398
Task_3917,1563,641,132,160,292,2.4345794392523366,34.65051984876007
Task_3918,597,191,53,38,91,3.109375,15.854247974892997
Task_3919,2094,591,121,32,153,3.5371621621621623,41.11595899639014
Task_3920,543,571,65,167,232,0.9493006993006993,18.019962089456303
Task_3921,1036,535,169,195,364,1.9328358208955223,26.34855788317124
Task_3922,1904,143,46,120,166,13.222222222222221,37.17422571339106
Task_3923,2595,944,195,195,390,2.746031746031746,52.44085249634105
Task_3924,2176,256,149,94,243,8.46692607003891,42.72223563578069
Task_3925,1964,270,99,153,252,7.247232472324724,39.605878044685646
Task_3926,2879,130,84,17,101,21.977099236641223,50.93882324164298
Task_3927,2530,568,119,196,315,4.446397188049209,49.890073720946816
Task_3928,3000,250,37,177,214,11.952191235059761,55.78634741328654
Task_3929,1839,765,12,74,86,2.4007832898172325,37.548084669361195
Task_3930,1081,148,63,42,105,7.25503355704698,22.59050348407652
Task_3931,1814,1003,181,149,330,1.8067729083665338,39.91041078397789
Task_3932,963,539,169,47,216,1.7833333333333334,23.61317754252953
Task_3933,522,880,49,163,212,0.5925085130533485,18.69598786640738
Task_3934,1620,797,16,93,109,2.030075187969925,34.72069441407615
Task_3935,2954,931,59,127,186,3.1695278969957084,57.09453351007278
Task_3936,2644,506,73,182,255,5.214990138067061,51.33168559398316
Task_3937,1678,125,35,47,82,13.317460317460318,31.97530675832017
Task_3938,1385,306,102,131,233,4.511400651465798,30.455549554282694
Task_3939,2496,891,119,85,204,2.798206278026906,49.432276791759165
Task_3940,2995,504,49,94,143,5.930693069306931,55.98880189430764
Task_3941,2612,154,157,54,211,16.851612903225806,48.4005752124987
Task_3942,578,689,163,153,316,0.8376811594202899,19.21208783746266
Task_3943,2201,106,137,81,218,20.570093457943926,41.465986597619185
Task_3944,1992,366,72,110,182,5.427792915531335,39.93835405858165
Task_3945,1730,76,65,89,154,22.467532467532468,33.437913149889056
Task_3946,2328,201,42,196,238,11.524752475247524,45.11225967623968
Task_3947,2246,849,154,175,329,2.642352941176471,46.30996212664244
Task_3948,2049,348,175,176,351,5.871060171919771,41.69399062761866
Task_3949,1481,583,40,135,175,2.535958904109589,32.552920416045176
Task_3950,2289,272,66,139,205,8.384615384615385,44.638122773220914
Task_3951,2456,650,102,32,134,3.772657450076805,47.030472774493575
Task_3952,1266,859,186,133,319,1.472093023255814,30.653149110952796
Task_3953,974,300,158,184,342,3.2358803986710964,24.506542931484592
Task_3954,1501,692,197,178,375,2.165945165945166,34.22857730655483
Task_3955,1391,663,127,169,296,2.0948795180722892,32.02635232694602
Task_3956,1371,580,171,98,269,2.359724612736661,31.227188212296067
Task_3957,1156,893,114,77,191,1.2930648769574944,28.010403478899377
Task_3958,1955,624,30,50,80,3.128,38.43450761159891
Task_3959,1802,798,25,187,212,2.25531914893617,38.65497474707296
Task_3960,2971,517,79,48,127,5.735521235521236,54.72738852866876
Task_3961,1722,750,142,180,322,2.2929427430093208,37.67468286621087
Task_3962,600,924,132,79,211,0.6486486486486487,19.657645113089657
Task_3963,2225,946,129,81,210,2.3495248152059136,45.28249256324599
Task_3964,1932,484,77,139,216,3.9835051546391753,39.749240003905655
Task_3965,2688,111,134,30,164,24.0,48.476274203520745
Task_3966,1257,73,97,93,190,16.986486486486488,26.53851480906567
Task_3967,793,390,59,192,251,2.028132992327366,21.687424818090772
Task_3968,2007,971,87,150,237,2.064814814814815,42.46028157584374
Task_3969,2240,721,78,51,129,3.102493074792244,44.14905710038059
Task_3970,2659,730,120,157,277,3.6374829001367988,52.2188889867954
Task_3971,1008,352,165,150,315,2.855524079320113,25.04025692119747
Task_3972,2546,123,186,109,295,20.532258064516128,47.90188165337267
Task_3973,1310,399,148,100,248,3.275,29.593486670954743
Task_3974,2114,337,128,70,198,6.254437869822485,41.3956970162219
Task_3975,521,437,11,125,136,1.1894977168949772,16.39059925431175
Task_3976,1383,269,199,151,350,5.122222222222222,30.857060627638884
Task_3977,1531,582,18,44,62,2.6260720411663807,31.165332872903946
Task_3978,2964,81,75,51,126,36.146341463414636,52.1840080865762
Task_3979,2728,159,90,176,266,17.05,51.09883178090788
Task_3980,1781,493,180,127,307,3.6052631578947367,37.65423951350345
Task_3981,1954,1001,41,153,194,1.9500998003992016,41.52811525642456
Task_3982,2880,400,87,76,163,7.182044887780549,53.52294771028382
Task_3983,2176,516,179,40,219,4.20889748549323,42.772264051027896
Task_3984,968,565,180,161,341,1.7102473498233215,25.198727639949777
Task_3985,1237,477,57,163,220,2.587866108786611,28.811037679205224
Task_3986,1152,528,62,138,200,2.1776937618147447,27.468528603935635
Task_3987,1105,457,70,157,227,2.412663755458515,26.662908376173917
Task_3988,1696,908,183,13,196,1.8657865786578658,36.1405874499995
Task_3989,658,138,108,111,219,4.733812949640288,17.966748474119758
Task_3990,1988,487,164,39,203,4.073770491803279,39.59401995089358
Task_3991,632,332,77,74,151,1.897897897897898,17.661527349937362
Task_3992,1828,206,199,109,308,8.830917874396135,37.41298567663899
Task_3993,2164,769,178,67,245,2.81038961038961,43.78267415416391
Task_3994,2025,747,89,185,274,2.7072192513368982,42.296146043493145
Task_3995,1369,864,54,198,252,1.5826589595375722,32.26778111426831
Task_3996,890,259,98,56,154,3.423076923076923,21.300354554595742
Task_3997,1837,782,53,58,111,2.34610472541507,37.605960486361106
Task_3998,1533,388,85,33,118,3.9408740359897174,31.348805522168224
Task_3999,2024,753,62,159,221,2.684350132625995,42.11029376026531
Task_4000,1112,99,56,147,203,11.12,24.703005073468606
Task_4001,2940,637,119,46,165,4.608150470219436,54.94220264596404
Task_4002,2531,211,162,130,292,11.93867924528302,48.48963223864096
Task_4003,758,451,115,11,126,1.676991150442478,19.31671012046077
Task_4004,1864,839,49,148,197,2.219047619047619,39.752576341638445
Task_4005,1457,997,10,183,193,1.4599198396793587,33.59557331501903
Task_4006,789,786,187,72,259,1.0025412960609912,22.0429699719587
Task_4007,2828,93,189,157,346,30.085106382978722,52.13468155418337
Task_4008,2530,133,158,33,191,18.880597014925375,46.52980762179464
Task_4009,801,442,146,168,314,1.8081264108352144,22.071821984562366
Task_4010,2444,501,41,130,171,4.868525896414343,47.38159058413445
Task_4011,1811,835,93,182,275,2.166267942583732,39.252932935201905
Task_4012,2716,984,63,78,141,2.7573604060913706,52.819160763358944
Task_4013,1063,639,28,168,196,1.6609375,26.331745535544087
Task_4014,2185,264,173,106,279,8.245283018867925,43.1284884618773
Task_4015,2948,187,72,78,150,15.680851063829786,54.09703506797616
Task_4016,2363,684,199,32,231,3.44963503649635,46.324459329144105
Task_4017,2012,1016,70,41,111,1.9783677482792528,40.874488324346146
Task_4018,1247,689,51,198,249,1.8072463768115943,29.85320988287035
Task_4019,876,543,50,16,66,1.6102941176470589,20.489477973586823
Task_4020,621,160,171,64,235,3.857142857142857,17.177886575433423
Task_4021,2702,694,111,99,210,3.887769784172662,52.38453863696202
Task_4022,2198,816,194,113,307,2.690330477356181,45.25626319343608
Task_4023,2809,604,149,160,309,4.64297520661157,54.3435930161564
Task_4024,1072,755,120,70,190,1.417989417989418,26.135149048184033
Task_4025,1904,476,174,149,323,3.991614255765199,39.6513580445962
Task_4026,1188,458,147,172,319,2.588235294117647,28.276038257019508
Task_4027,1908,336,179,185,364,5.661721068249258,39.495515437241416
Task_4028,2169,766,171,104,275,2.827900912646675,44.482885919150135
Task_4029,2218,455,37,78,115,4.864035087719298,43.11264123371538
Task_4030,2213,554,22,64,86,3.9873873873873875,42.68321932262146
Task_4031,1948,778,96,18,114,2.5006418485237485,38.9263330190875
Task_4032,2958,985,44,173,217,3.0,57.52280044545256
Task_4033,2058,827,12,120,132,2.4855072463768115,42.05985314477706
Task_4034,1538,291,32,141,173,5.267123287671233,32.54042234748002
Task_4035,2985,1020,65,151,216,2.9236043095004898,58.1348677376669
Task_4036,2976,550,168,76,244,5.4010889292196005,56.03714210099878
Task_4037,924,404,119,88,207,2.2814814814814817,23.047142959090497
Task_4038,1810,940,62,89,151,1.9234856535600424,38.417064030101734
Task_4039,1617,539,192,59,251,2.9944444444444445,34.32593257856893
Task_4040,1376,568,116,133,249,2.4182776801405974,31.22654832513878
Task_4041,2094,132,129,123,252,15.74436090225564,40.66248428436587
Task_4042,1542,568,59,52,111,2.710017574692443,32.26442656364632
Task_4043,607,975,93,37,130,0.6219262295081968,19.329033217178953
Task_4044,1649,312,192,131,323,5.268370607028754,35.05549188511214
Task_4045,666,907,25,89,114,0.7334801762114538,19.892606371050583
Task_4046,1986,958,29,15,44,2.070907194994786,39.203939380501375
Task_4047,1383,443,200,39,239,3.114864864864865,30.039075584347078
Task_4048,2050,584,170,187,357,3.5042735042735043,42.51608698693425
Task_4049,1114,819,69,27,96,1.3585365853658538,25.990069661954436
Task_4050,2055,634,24,75,99,3.236220472440945,40.65604157034799
Task_4051,1739,187,117,168,285,9.25,36.02463960290638
Task_4052,545,469,137,59,196,1.1595744680851063,16.895289108074703
Task_4053,2247,804,59,80,139,2.791304347826087,44.871067678761314
Task_4054,836,310,40,141,181,2.688102893890675,21.39827655705673
Task_4055,2233,442,64,75,139,5.040632054176072,43.37138743428424
Task_4056,1920,926,160,30,190,2.071197411003236,39.87434586777852
Task_4057,1257,733,31,91,122,1.7125340599455041,28.92011008568525
Task_4058,867,987,156,98,254,0.8775303643724697,24.36443676155638
Task_4059,1099,278,69,163,232,3.939068100358423,26.005593068912336
Task_4060,848,87,148,98,246,9.636363636363637,20.49933284346304
Task_4061,2245,561,195,11,206,3.994661921708185,43.80157867797748
Task_4062,1669,972,165,145,310,1.7153134635149023,37.40697922099529
Task_4063,1182,975,186,57,243,1.2110655737704918,28.739386544228697
Task_4064,1068,331,31,88,119,3.216867469879518,24.564483836126445
Task_4065,892,429,155,141,296,2.074418604651163,23.35045451626306
Task_4066,1744,997,78,79,157,1.74749498997996,37.46459913570885
Task_4067,1211,198,117,199,316,6.085427135678392,27.859169714921876
Task_4068,1970,364,117,90,207,5.397260273972603,39.557614877112805
Task_4069,698,882,107,148,255,0.7904869762174406,21.47506383727954
Task_4070,1051,210,119,173,292,4.981042654028436,25.18223236071435
Task_4071,2397,217,123,41,164,10.995412844036696,44.91148028307725
Task_4072,2722,673,72,14,86,4.0385756676557865,50.64975719897197
Task_4073,2428,947,116,72,188,2.561181434599156,48.248952729261475
Task_4074,2115,451,12,121,133,4.679203539823009,41.77910238076881
Task_4075,2710,502,89,196,285,5.387673956262425,52.43216391947262
Task_4076,2770,284,87,30,117,9.719298245614034,50.57485343569818
Task_4077,2183,552,99,124,223,3.9475587703435804,43.825833325928784
Task_4078,1810,386,81,132,213,4.677002583979328,37.455660573126075
Task_4079,2302,566,47,142,189,4.059964726631393,45.64975622174015
Task_4080,1305,120,52,70,122,10.785123966942148,26.802467183185357
Task_4081,2269,587,26,140,166,3.858843537414966,44.93397931862478
Task_4082,1993,255,191,118,309,7.78515625,40.21520455488976
Task_4083,2402,805,176,119,295,2.9801488833746896,48.408586503339414
Task_4084,2073,873,91,53,144,2.371853546910755,42.00656256969153
Task_4085,2757,467,99,184,283,5.891025641025641,52.99743166736181
Task_4086,977,543,154,28,182,1.7959558823529411,23.493665797927566
Task_4087,1207,196,79,145,224,6.126903553299492,27.334741792519186
Task_4088,1070,262,20,45,65,4.068441064638783,22.835370501521595
Task_4089,2892,429,45,41,86,6.725581395348837,52.62951234418222
Task_4090,1571,127,118,134,252,12.2734375,32.40872669051759
Task_4091,1564,722,161,166,327,2.1632088520055324,35.086308063701715
Task_4092,1036,997,184,158,342,1.0380761523046091,27.50197583958637
Task_4093,2788,1020,12,24,36,2.730656219392752,52.147997285031515
Task_4094,2656,576,189,31,220,4.6031195840554595,50.570900065548635
Task_4095,1439,361,60,145,205,3.9751381215469612,31.51204352537351
Task_4096,2787,872,83,96,179,3.1924398625429555,54.06766191746783
Task_4097,2037,999,57,72,129,2.037,42.09985123126497
Task_4098,2505,839,97,57,154,2.982142857142857,48.633288331885296
Task_4099,2023,572,174,185,359,3.5305410122164047,42.05655569963361
Task_4100,2286,796,96,90,186,2.8682559598494355,45.745209640426935
Task_4101,662,931,42,11,53,0.7103004291845494,18.715695107736213
Task_4102,848,687,86,173,259,1.2325581395348837,23.243594643939996
Task_4103,1955,478,112,184,296,4.081419624217119,40.394712000326386
Task_4104,998,746,28,200,228,1.3360107095046854,25.748562087755484
Task_4105,1562,314,108,10,118,4.958730158730159,31.43154408669442
Task_4106,2888,462,68,184,252,6.237580993520519,55.035430205296784
Task_4107,2470,492,137,134,271,5.0101419878296145,48.406501887123795
Task_4108,921,504,17,86,103,1.8237623762376238,22.46678216715866
Task_4109,2371,259,13,144,157,9.11923076923077,45.303091161666835
Task_4110,2220,550,51,111,162,4.029038112522686,44.025234073909644
Task_4111,1997,270,46,160,206,7.369003690036901,39.96298414860192
Task_4112,1859,847,137,173,310,2.1922169811320753,40.08343950694681
Task_4113,888,423,13,63,76,2.0943396226415096,20.893728226221565
Task_4114,928,822,48,77,125,1.1275820170109356,23.811723318570163
Task_4115,2526,423,80,179,259,5.9575471698113205,49.20686706226055
Task_4116,2301,983,29,71,100,2.3384146341463414,45.70524785833422
Task_4117,1975,489,166,191,357,4.030612244897959,41.03178951094581
Task_4118,1293,393,147,127,274,3.281725888324873,29.46202403849424
Task_4119,1210,306,89,57,146,3.9413680781758957,26.496909115625133
Task_4120,1508,666,194,105,299,2.260869565217391,33.80861324200186
Task_4121,2602,325,161,23,184,7.9815950920245395,48.484816993669575
Task_4122,2315,422,147,176,323,5.472813238770685,46.021142489648604
Task_4123,2078,395,38,123,161,5.247474747474747,41.08507836993192
Task_4124,1646,594,83,158,241,2.7663865546218487,35.63818850999169
Task_4125,2941,1004,159,158,317,2.9263681592039803,57.727804288929576
Task_4126,605,715,100,158,258,0.8449720670391061,19.466148791609204
Task_4127,1298,527,176,115,291,2.4583333333333335,30.025439283871915
Task_4128,2549,741,88,144,232,3.4353099730458223,50.308742227968644
Task_4129,2666,967,20,191,211,2.7541322314049586,52.8055449699492
Task_4130,1258,93,187,177,364,13.382978723404255,27.603541865628916
Task_4131,859,604,31,33,64,1.4198347107438016,20.555921365970192
Task_4132,2993,254,124,123,247,11.737254901960783,55.74056872794853
Task_4133,2875,424,185,112,297,6.764705882352941,54.679104326852645
Task_4134,782,451,113,107,220,1.7300884955752212,21.272826603426036
Task_4135,1657,851,33,13,46,1.9448356807511737,33.739473307294176
Task_4136,1052,561,146,133,279,1.8718861209964412,26.20929675994017
Task_4137,2781,988,144,53,197,2.8119312436804855,54.040160216098066
Task_4138,2738,504,107,15,122,5.421782178217822,50.69375345015386
Task_4139,779,236,75,70,145,3.2869198312236287,19.664111786546254
Task_4140,2411,285,122,91,213,8.43006993006993,46.3095699727347
Task_4141,1615,797,27,51,78,2.0238095238095237,33.4975930629669
Task_4142,579,498,140,76,216,1.160320641282565,17.783296606422084
Task_4143,1536,730,173,51,224,2.1012311901504788,33.568513702343964
Task_4144,1668,616,150,188,338,2.7034035656401945,36.48336281295853
Task_4145,2352,969,51,101,152,2.424742268041237,47.302507312987416
Task_4146,945,803,26,194,220,1.1753731343283582,24.998969128259635
Task_4147,1014,418,100,172,272,2.420047732696897,25.183714444470226
Task_4148,584,431,29,100,129,1.3518518518518519,17.44925622232505
Task_4149,2720,575,65,147,212,4.722222222222222,52.51045489508645
Task_4150,1836,889,112,41,153,2.0629213483146067,37.93365666087608
Task_4151,1182,350,160,174,334,3.3675213675213675,27.906983094151858
Task_4152,764,258,49,13,62,2.9498069498069497,17.807012544529304
Task_4153,2604,938,50,41,91,2.7731629392971247,49.76406932295087
Task_4154,1407,185,78,72,150,7.564516129032258,29.442243263012358
Task_4155,850,1002,183,67,250,0.847457627118644,23.735932973545705
Task_4156,2188,535,158,108,266,4.082089552238806,44.01940681753098
Task_4157,816,332,15,42,57,2.4504504504504503,19.179118822426513
Task_4158,1893,170,114,191,305,11.070175438596491,38.055777137545945
Task_4159,2000,471,25,46,71,4.237288135593221,38.26233542481337
Task_4160,2664,333,112,127,239,7.976047904191617,50.79370149174125
Task_4161,2815,667,189,32,221,4.2140718562874255,53.385043653976375
Task_4162,1803,690,34,55,89,2.609261939218524,36.577205629282176
Task_4163,2782,559,191,199,390,4.9678571428571425,54.194030979566946
Task_4164,2067,473,135,137,272,4.360759493670886,41.974500417632086
Task_4165,2351,249,20,150,170,9.404,45.06645551739317
Task_4166,951,871,166,110,276,1.0905963302752293,25.381130313481446
Task_4167,714,383,99,31,130,1.859375,18.597629214289054
Task_4168,1426,739,54,100,154,1.927027027027027,31.88436080912444
Task_4169,1174,491,44,58,102,2.386178861788618,26.019590683608147
Task_4170,1475,1017,181,127,308,1.4489194499017681,34.38188161522125
Task_4171,857,412,45,103,148,2.0750605326876514,21.69873950892257
Task_4172,763,818,91,118,209,0.9316239316239316,22.02751987928208
Task_4173,2197,305,70,178,248,7.1797385620915035,43.567966623756575
Task_4174,1853,199,198,75,273,9.265,37.22551449100957
Task_4175,2529,694,68,185,253,3.6388489208633095,50.1010843613586
Task_4176,714,927,118,97,215,0.7693965517241379,21.632944883615963
Task_4177,2794,323,121,62,183,8.623456790123457,51.78644922453936
Task_4178,2129,283,113,70,183,7.496478873239437,41.18537746146451
Task_4179,1790,725,197,118,315,2.465564738292011,38.551312515652974
Task_4180,1845,995,60,35,95,1.8524096385542168,37.84137373901138
Task_4181,1152,728,133,77,210,1.5802469135802468,27.533247816169645
Task_4182,2320,388,139,197,336,5.96401028277635,46.07753366877959
Task_4183,804,395,159,58,217,2.0303030303030303,20.86105722008669
Task_4184,1709,554,26,167,193,3.0792792792792794,36.293792540713504
Task_4185,2312,95,21,126,147,24.083333333333332,42.539768802329604
Task_4186,2230,207,22,185,207,10.721153846153847,43.38878434649454
Task_4187,1304,353,172,171,343,3.6836158192090394,29.882656751928945
Task_4188,1033,662,41,163,204,1.5580693815987934,25.902710455115734
Task_4189,1820,498,94,159,253,3.647294589178357,38.17492016056527
Task_4190,2136,375,53,41,94,5.680851063829787,40.574158246576715
Task_4191,723,456,139,136,275,1.5820568927789935,20.615736210866825
Task_4192,1597,428,189,91,280,3.722610722610723,34.21315064004943
Task_4193,1157,1016,111,192,303,1.1376597836774829,29.39840597332459
Task_4194,2586,798,106,65,171,3.236545682102628,50.00250199395935
Task_4195,763,67,15,194,209,11.220588235294118,19.06363977748745
Task_4196,2177,518,22,104,126,4.194605009633912,42.92121265223553
Task_4197,2852,660,147,149,296,4.314674735249622,55.12836869305519
Task_4198,2757,505,34,200,234,5.448616600790514,52.950046519215874
Task_4199,1969,161,192,70,262,12.154320987654321,38.53511990547837
Task_4200,2638,277,59,200,259,9.489208633093526,50.537028107784636
Task_4201,1922,625,119,196,315,3.070287539936102,40.442474106549234
Task_4202,621,192,144,136,280,3.2176165803108807,18.23072028380025
Task_4203,1527,156,193,147,340,9.726114649681529,32.39304968503676
Task_4204,2527,570,128,62,190,4.425569176882662,48.585203448662014
Task_4205,1587,500,137,112,249,3.1676646706586826,34.32188117120454
Task_4206,1872,156,77,160,237,11.92356687898089,37.52884828675919
Task_4207,2910,982,53,124,177,2.960325534079349,56.475084315296925
Task_4208,1775,233,146,109,255,7.585470085470085,36.436029940874036
Task_4209,2379,662,101,24,125,3.588235294117647,45.668807919126515
Task_4210,846,415,200,23,223,2.0336538461538463,21.354697137647282
Task_4211,2069,486,12,195,207,4.248459958932238,41.8420445404111
Task_4212,2324,707,143,141,284,3.2824858757062145,46.84780965890683
Task_4213,2571,672,191,43,234,3.820208023774146,49.58458389652484
Task_4214,2908,435,29,171,200,6.669724770642202,54.928163031010506
Task_4215,1277,258,26,20,46,4.93050193050193,25.77275898146164
Task_4216,827,646,45,130,175,1.278207109737249,22.215159449319547
Task_4217,1613,95,140,150,290,16.802083333333332,32.778337017748235
Task_4218,1513,541,199,70,269,2.791512915129151,32.864083245012196
Task_4219,2856,220,94,122,216,12.923076923076923,53.3867389487848
Task_4220,1214,276,13,116,129,4.382671480144404,27.017669151854694
Task_4221,1930,362,96,85,181,5.316804407713499,38.54522593223864
Task_4222,1957,434,47,147,194,4.498850574712644,39.82096252200972
Task_4223,1356,900,12,51,63,1.504994450610433,29.64174666904687
Task_4224,2255,519,72,56,128,4.336538461538462,43.874074366521775
Task_4225,794,1017,42,192,234,0.7799607072691552,23.279442590344146
Task_4226,2468,638,171,122,293,3.8622848200312987,48.92342681354748
Task_4227,1467,430,32,68,100,3.4037122969837585,30.72225968162346
Task_4228,1469,721,93,166,259,2.0346260387811634,33.38377059795351
Task_4229,2650,867,166,187,353,3.052995391705069,52.893174936689526
Task_4230,2184,104,159,13,172,20.8,40.50026892806876
Task_4231,2682,283,54,154,208,9.443661971830986,50.96131740377871
Task_4232,2961,432,159,67,226,6.838337182448037,55.23983008650563
Task_4233,1068,121,198,173,371,8.754098360655737,25.07234984058094
Task_4234,1692,622,41,87,128,2.715890850722311,35.58010763452331
Task_4235,2996,651,70,125,195,4.595092024539877,57.030548627540945
Task_4236,534,497,132,84,216,1.072289156626506,17.042346013907803
Task_4237,724,333,111,155,266,2.1676646706586826,20.27410962103578
Task_4238,627,273,138,44,182,2.2883211678832116,17.121612126776533
Task_4239,2727,650,20,61,81,4.188940092165899,50.93969651563748
Task_4240,1197,289,188,156,344,4.127586206896551,27.964040846820676
Task_4241,1086,363,163,122,285,2.9835164835164836,26.133110585797994
Task_4242,532,786,67,181,248,0.6759847522236341,18.78976950055424
Task_4243,656,893,38,40,78,0.7337807606263982,18.51704182397876
Task_4244,2883,940,120,136,256,3.063761955366631,56.30159171669353
Task_4245,2181,77,15,26,41,27.96153846153846,38.73638156913207
Task_4246,2478,888,37,172,209,2.7874015748031495,49.582537552568844
Task_4247,1109,691,195,102,297,1.6026011560693643,27.539779042114017
Task_4248,1507,963,141,66,207,1.5632780082987552,33.76590752429653
Task_4249,1655,733,64,43,107,2.2547683923705724,34.079635408972145
Task_4250,2630,328,185,187,372,7.993920972644377,50.92610244160763
Task_4251,1695,1013,118,178,296,1.6715976331360947,37.93146807498278
Task_4252,1191,573,152,30,182,2.0749128919860627,27.021221477176596
Task_4253,984,316,188,17,205,3.1041009463722395,22.971986389973694
Task_4254,2780,790,117,32,149,3.5145385587863465,52.64129866400791
Task_4255,2796,251,104,50,154,11.095238095238095,51.14077733286417
Task_4256,2757,878,27,54,81,3.136518771331058,52.1829823633353
Task_4257,2528,329,92,48,140,7.66060606060606,47.20753461541412
Task_4258,1525,962,131,145,276,1.5835929387331256,34.91152487923474
Task_4259,1029,465,25,118,143,2.208154506437768,24.659060552761257
Task_4260,1838,158,161,190,351,11.559748427672956,37.4179908709768
Task_4261,2828,431,109,141,250,6.546296296296297,53.78919974821044
Task_4262,585,513,182,129,311,1.1381322957198443,18.721654692026483
Task_4263,2801,240,47,49,96,11.622406639004149,50.717845138494006
Task_4264,1711,702,68,177,245,2.4338549075391183,37.12112846343059
Task_4265,1306,465,22,103,125,2.8025751072961373,28.93488944203372
Task_4266,1981,215,152,177,329,9.171296296296296,40.05663913017584
Task_4267,2637,173,156,62,218,15.155172413793103,48.90450429997147
Task_4268,2197,403,81,49,130,5.438118811881188,42.20627556529842
Task_4269,2289,644,101,15,116,3.5488372093023255,43.962277870272054
Task_4270,543,689,98,44,142,0.7869565217391304,16.841383033881954
Task_4271,2411,637,62,195,257,3.7789968652037618,48.09022838019187
Task_4272,2197,791,36,65,101,2.773989898989899,43.40698175972991
Task_4273,1986,148,44,92,136,13.328859060402685,38.097107521160446
Task_4274,2470,364,66,55,121,6.767123287671233,46.484619004625614
Task_4275,1213,450,184,177,361,2.6895787139689578,28.84303478275186
Task_4276,2273,682,170,28,198,3.32796486090776,44.70599219002735
Task_4277,876,495,160,182,342,1.7661290322580645,23.558483351248896
Task_4278,1923,812,75,60,135,2.3653136531365315,39.41869990547147
Task_4279,1893,517,147,170,317,3.6544401544401546,39.612010446158436
Task_4280,2313,546,197,96,293,4.2285191956124315,46.16147577659987
Task_4281,624,747,70,171,241,0.8342245989304813,19.898649628120108
Task_4282,1360,337,145,93,238,4.023668639053255,30.06349287976568
Task_4283,1579,827,153,143,296,1.9070048309178744,35.47776924449394
Task_4284,644,839,157,64,221,0.7666666666666667,19.820995268161496
Task_4285,956,332,98,104,202,2.870870870870871,23.590824888888836
Task_4286,2599,969,157,180,337,2.679381443298969,52.32137578916305
Task_4287,2211,443,122,55,177,4.97972972972973,42.99473926695888
Task_4288,2229,941,69,55,124,2.3662420382165603,44.5752627288293
Task_4289,647,192,119,194,313,3.3523316062176165,18.874786648750078
Task_4290,1813,220,117,20,137,8.203619909502262,35.230401433422365
Task_4291,835,686,63,193,256,1.215429403202329,23.126816103385213
Task_4292,2214,903,164,161,325,2.4491150442477876,45.93291841760399
Task_4293,545,402,33,145,178,1.3523573200992556,17.02731175218688
Task_4294,2958,787,155,55,210,3.753807106598985,56.25794412566807
Task_4295,755,105,62,170,232,7.122641509433962,19.225153238005387
Task_4296,2525,357,136,119,255,7.053072625698324,48.73750426246321
Task_4297,2764,521,111,192,303,5.295019157088123,53.384107495227546
Task_4298,2835,776,89,185,274,3.6486486486486487,55.219356787122685
Task_4299,774,297,28,191,219,2.597315436241611,20.831667653543413
Task_4300,2777,362,146,179,325,7.650137741046832,53.144348100528
Task_4301,1489,550,77,146,223,2.702359346642468,32.98699231290418
Task_4302,2258,807,177,77,254,2.7945544554455446,45.52843903567472
Task_4303,1073,407,32,25,57,2.6299019607843137,23.400768119032154
Task_4304,624,215,20,112,132,2.888888888888889,17.385356900733676
Task_4305,2030,640,126,116,242,3.1669266770670825,41.75397572771342
Task_4306,1559,795,196,102,298,1.9585427135678393,35.010200782128955
Task_4307,548,373,117,86,203,1.46524064171123,16.90290257103896
Task_4308,2926,418,71,134,205,6.983293556085919,55.210791620199224
Task_4309,1032,780,31,19,50,1.321382842509603,23.725841038199984
Task_4310,2419,918,56,98,154,2.632208922742111,48.17996261617939
Task_4311,1585,689,185,86,271,2.2971014492753623,34.682079360652565
Task_4312,2769,175,32,15,47,15.732954545454545,49.0562682735185
Task_4313,2034,130,160,181,341,15.526717557251908,40.19414482606049
Task_4314,1690,78,80,19,99,21.39240506329114,31.47618381706346
Task_4315,2095,850,91,10,101,2.461809635722679,41.46079599112606
Task_4316,1246,838,90,123,213,1.4851013110846245,29.84311684582602
Task_4317,1740,180,117,123,240,9.613259668508288,35.259140815850564
Task_4318,1769,740,197,36,233,2.387314439946019,37.10050314755913
Task_4319,838,344,161,60,221,2.428985507246377,21.246221917719428
Task_4320,1570,786,146,111,257,1.9949174078780179,34.98484302579708
Task_4321,1208,605,122,185,307,1.9933993399339933,29.019719727206375
Task_4322,654,887,129,197,326,0.7364864864864865,21.124895333464604
Task_4323,806,481,97,32,129,1.6721991701244814,20.38848695722422
Task_4324,1844,804,95,133,228,2.2906832298136646,39.353621928101575
Task_4325,2329,922,39,10,49,2.52329360780065,44.600611501135006
Task_4326,1228,367,19,80,99,3.3369565217391304,26.75046318512962
Task_4327,1732,385,199,79,278,4.487046632124352,36.03703999121026
Task_4328,1639,616,141,34,175,2.6564019448946516,34.323948955920784
Task_4329,1278,226,187,61,248,5.629955947136564,27.930708352863107
Task_4330,2940,193,96,118,214,15.154639175257731,54.56062007372407
Task_4331,1460,304,119,108,227,4.786885245901639,31.57401116064065
Task_4332,1179,651,102,129,231,1.8082822085889572,28.279456471520323
Task_4333,1851,865,142,96,238,2.1374133949191685,39.59897310790298
Task_4334,2910,289,190,166,356,10.03448275862069,55.11271209938957
Task_4335,2268,744,54,17,71,3.0442953020134227,43.030063838047305
Task_4336,759,771,20,158,178,0.9831606217616581,21.425803386333456
Task_4337,2825,82,138,127,265,34.036144578313255,51.59782355569276
Task_4338,2119,888,169,39,208,2.3835770528683913,42.95443861110483
Task_4339,1894,174,104,13,117,10.822857142857142,35.877931559445415
Task_4340,1727,991,162,88,250,1.7409274193548387,37.78318972696425
Task_4341,2272,407,120,137,257,5.568627450980392,44.93676678388348
Task_4342,1207,561,30,81,111,2.1476868327402134,27.35837287266448
Task_4343,2794,465,116,134,250,5.9957081545064375,53.35283770493876
Task_4344,1643,1021,25,133,158,1.6076320939334638,36.182605306986794
Task_4345,2991,299,101,18,119,9.97,53.827487089647036
Task_4346,1581,129,100,105,205,12.161538461538461,32.32056912403951
Task_4347,1955,405,44,136,180,4.815270935960591,39.397359502801756
Task_4348,2450,372,46,23,69,6.568364611260054,44.98510764139933
Task_4349,1929,615,193,44,237,3.1314935064935066,39.240049167983706
Task_4350,1286,524,157,187,344,2.4495238095238094,30.1704176446579
Task_4351,2256,999,190,46,236,2.256,45.622839043065675
Task_4352,1753,640,73,47,120,2.734789391575663,35.66911114509223
Task_4353,2813,177,179,106,285,15.803370786516854,52.32145393415086
Task_4354,1429,277,87,22,109,5.140287769784172,29.215921039618575
Task_4355,2686,476,39,163,202,5.631027253668763,51.51782297036309
Task_4356,1077,147,187,93,280,7.277027027027027,24.784280778428023
Task_4357,2352,763,159,145,304,3.0785340314136125,47.56340761482642
Task_4358,2529,345,182,18,200,7.309248554913295,47.45437399765069
Task_4359,951,639,183,188,371,1.4859375,25.3056710937331
Task_4360,1172,999,44,140,184,1.172,28.730860467909
Task_4361,1679,600,129,134,263,2.793677204658902,36.19003653435056
Task_4362,1601,702,14,160,174,2.2773826458036983,34.89226472257506
Task_4363,758,499,165,50,215,1.516,20.311629423367823
Task_4364,725,138,37,132,169,5.215827338129497,18.543525782895767
Task_4365,982,166,163,141,304,5.880239520958084,23.62550423633215
Task_4366,1920,594,28,195,223,3.226890756302521,39.93778791459129
Task_4367,2290,820,109,31,140,2.7892813641900123,44.90888300138156
Task_4368,1077,967,45,159,204,1.112603305785124,27.351222778155584
Task_4369,1414,485,148,196,344,2.909465020576132,32.08686211051965
Task_4370,1153,443,79,154,233,2.5968468468468466,27.391294110207966
Task_4371,686,395,152,36,188,1.7323232323232323,18.616464721189413
Task_4372,803,922,13,54,67,0.8699891657638137,21.11800802167266
Task_4373,2262,180,77,156,233,12.497237569060774,43.61982549232207
Task_4374,2389,71,185,191,376,33.18055555555556,45.26135276892293
Task_4375,1052,728,181,197,378,1.4430727023319616,27.201328289236255
Task_4376,2732,682,102,120,222,4.0,52.92141597616163
Task_4377,2492,532,97,120,217,4.675422138836773,48.64355127891255
Task_4378,1249,466,145,27,172,2.674518201284797,27.594575012137213
Task_4379,2270,597,80,95,175,3.7959866220735785,45.13822228964782
Task_4380,2261,330,94,74,168,6.830815709969788,43.54229313528581
Task_4381,2097,135,169,111,280,15.419117647058824,40.84288672804486
Task_4382,1062,262,18,184,202,4.038022813688213,25.116086311465
Task_4383,663,622,175,158,333,1.0642054574638844,20.382211905113618
Task_4384,2082,700,54,160,214,2.970042796005706,42.8638718377665
Task_4385,2395,307,10,149,159,7.775974025974026,45.80963226048724
Task_4386,1837,392,158,169,327,4.674300254452926,38.3668135386742
Task_4387,800,569,115,17,132,1.4035087719298245,20.264214249167768
Task_4388,2136,994,35,192,227,2.1467336683417084,44.613438065265264
Task_4389,710,322,10,141,151,2.198142414860681,19.15346750838513
Task_4390,2484,352,186,113,299,7.036827195467422,48.261524750909956
Task_4391,1955,939,44,127,171,2.0797872340425534,41.012462978725175
Task_4392,2411,326,184,22,206,7.373088685015291,45.72526618226538
Task_4393,1075,340,132,21,153,3.1524926686217007,24.075502638075736
Task_4394,2027,111,52,160,212,18.098214285714285,39.17141652719383
Task_4395,2525,518,171,131,302,4.865125240847784,49.49652022932414
Task_4396,2432,475,163,136,299,5.109243697478991,47.87900352258754
Task_4397,1368,357,65,64,129,3.82122905027933,29.33962813261269
Task_4398,1767,633,55,136,191,2.7870662460567823,37.524654102234976
Task_4399,942,616,38,70,108,1.526742301458671,23.040221922367806
Task_4400,2540,71,135,169,304,35.27777777777778,47.26685297665221
Task_4401,1062,382,25,153,178,2.772845953002611,25.24779453481087
Task_4402,1636,76,190,171,361,21.246753246753247,33.39843583923395
Task_4403,2854,696,125,137,262,4.094691535150646,55.103442330426866
Task_4404,797,128,85,138,223,6.178294573643411,20.133639342492895
Task_4405,2478,641,144,118,262,3.8598130841121496,48.94573709213828
Task_4406,2686,525,10,148,158,5.106463878326996,51.13752370036718
Task_4407,604,312,174,182,356,1.9297124600638977,18.754954556550818
Task_4408,625,640,15,173,188,0.9750390015600624,19.202303141647203
Task_4409,2199,272,22,42,64,8.054945054945055,40.724161273419526
Task_4410,1460,665,170,142,312,2.1921921921921923,33.15803614466578
Task_4411,2334,903,199,88,287,2.581858407079646,47.304129217355126
Task_4412,531,539,72,164,236,0.9833333333333333,17.746231494092527
Task_4413,582,381,133,125,258,1.5235602094240839,18.056603796744074
Task_4414,711,411,105,194,299,1.7257281553398058,20.507212522513395
Task_4415,1668,800,28,172,200,2.0823970037453186,36.45454993057329
Task_4416,997,910,153,146,299,1.0944017563117454,26.387134708101087
Task_4417,994,869,149,191,340,1.1425287356321838,26.525904283860402
Task_4418,2197,232,97,71,168,9.429184549356224,42.04653169055987
Task_4419,2867,372,60,51,111,7.686327077747989,52.51769760653415
Task_4420,2406,233,24,112,136,10.282051282051283,45.622533243939614
Task_4421,1713,250,28,168,196,6.824701195219124,35.37832894643102
Task_4422,994,201,161,98,259,4.920792079207921,23.99594023833446
Task_4423,2386,649,194,191,385,3.670769230769231,48.17532171263107
Task_4424,1582,388,177,199,376,4.066838046272494,34.58389231542472
Task_4425,2124,961,50,141,191,2.2079002079002077,44.24365581997338
Task_4426,2101,226,112,149,261,9.255506607929515,41.64515002751826
Task_4427,1686,833,33,51,84,2.0215827338129495,35.105185008219614
Task_4428,801,382,144,79,223,2.0913838120104438,21.049402666379113
Task_4429,1144,325,83,21,104,3.5092024539877302,24.681672341545198
Task_4430,1270,602,88,190,278,2.1061359867330016,29.888454864008697
Task_4431,2330,821,39,154,193,2.834549878345499,46.921973180999544
Task_4432,1879,403,167,115,282,4.650990099009901,38.78527023120868
Task_4433,2038,976,159,57,216,2.0859774820880244,42.227703280563844
Task_4434,796,724,116,137,253,1.0979310344827586,22.406113137690486
Task_4435,588,293,146,135,281,2.0,18.03468308736381
Task_4436,1655,655,82,25,107,2.5228658536585367,33.96893346763884
Task_4437,1502,856,24,193,217,1.7526254375729289,34.09464519934752
Task_4438,2236,213,37,153,190,10.448598130841122,43.42237612008655
Task_4439,2690,875,83,93,176,3.0707762557077625,52.43301631721945
Task_4440,1510,963,55,65,120,1.566390041493776,33.269848253707465
Task_4441,2219,852,136,31,167,2.601406799531067,44.11010552558033
Task_4442,1795,845,200,75,275,2.1217494089834514,38.39754004221239
Task_4443,2905,149,90,90,180,19.366666666666667,52.931373533348754
Task_4444,2232,443,35,156,191,5.027027027027027,44.18132469133449
Task_4445,1766,973,142,191,333,1.8131416837782341,39.131723374526835
Task_4446,2832,221,160,146,306,12.756756756756756,53.36875407525449
Task_4447,564,741,117,161,278,0.7601078167115903,19.022649874791334
Task_4448,1840,674,111,29,140,2.725925925925926,37.332869564720205
Task_4449,2048,382,104,116,220,5.347258485639687,41.11255997340846
Task_4450,1216,626,22,68,90,1.9393939393939394,27.17630487212026
Task_4451,757,232,18,183,201,3.2489270386266096,20.192128756957594
Task_4452,2715,183,15,137,152,14.755434782608695,50.18361239456374
Task_4453,2159,925,180,199,379,2.3315334773218144,45.42906249026735
Task_4454,505,936,146,37,183,0.5389541088580576,17.622307776461067
Task_4455,2267,999,108,68,176,2.267,45.6400502376685
Task_4456,642,754,114,162,276,0.8503311258278146,20.26833941100308
Task_4457,1325,772,194,171,365,1.7141009055627425,31.621119983758433
Task_4458,2678,585,200,108,308,4.5699658703071675,52.12755232009132
Task_4459,2531,359,56,12,68,7.030555555555556,46.007751777197655
Task_4460,2096,265,101,25,126,7.879699248120301,39.95358516632139
Task_4461,2386,813,13,85,98,2.9312039312039313,46.645686869436325
Task_4462,1374,260,131,148,279,5.264367816091954,30.35997932640086
Task_4463,629,126,76,114,190,4.952755905511811,17.420643729890838
Task_4464,2366,265,192,153,345,8.894736842105264,46.358863948147494
Task_4465,2389,603,120,49,169,3.955298013245033,46.070682785020246
Task_4466,890,535,22,32,54,1.6604477611940298,20.927727473458337
Task_4467,633,1017,31,144,175,0.6218074656188605,20.54684951723598
Task_4468,904,209,13,132,145,4.304761904761905,21.934891391904756
Task_4469,791,772,199,193,392,1.0232858990944373,23.192829341452548
Task_4470,2868,540,148,98,246,5.3012939001848425,54.70076476578333
Task_4471,1312,929,17,156,173,1.410752688172043,30.80141857686265
Task_4472,1436,661,178,99,277,2.1691842900302114,32.529811437612075
Task_4473,1885,589,127,138,265,3.194915254237288,39.432498272052165
Task_4474,1443,426,123,26,149,3.379391100702576,30.272488871292257
Task_4475,1989,575,93,180,273,3.453125,41.2446867865606
Task_4476,736,959,13,64,77,0.7666666666666667,20.21272661659682
Task_4477,1857,696,168,67,235,2.6642754662840744,38.64552625313272
Task_4478,1285,284,198,14,212,4.508771929824562,27.712165493800423
Task_4479,611,756,28,182,210,0.8071334214002642,19.457091789683496
Task_4480,1134,389,95,25,120,2.9076923076923076,25.0789541787305
Task_4481,2163,83,102,137,239,25.75,41.13753261767496
Task_4482,1776,598,17,50,67,2.964941569282137,35.206598752628416
Task_4483,1280,982,141,92,233,1.3021363173957274,30.694717577929197
Task_4484,608,573,161,18,179,1.0592334494773519,17.44132942863021
Task_4485,2108,333,30,52,82,6.311377245508982,40.21226791466998
Task_4486,1801,226,35,81,116,7.933920704845815,35.74628708876305
Task_4487,2290,508,103,182,285,4.49901768172888,45.74191929655228
Task_4488,555,568,121,193,314,0.9753954305799648,18.52562579273823
Task_4489,2297,174,76,30,106,13.125714285714286,42.260542378960196
Task_4490,849,366,52,184,236,2.3133514986376023,22.43324935658198
Task_4491,1975,421,106,148,254,4.680094786729858,40.28517271722236
Task_4492,2618,931,109,31,140,2.8090128755364807,50.45293476303518
Task_4493,1877,371,77,157,234,5.045698924731183,38.62005314985342
Task_4494,927,347,141,52,193,2.663793103448276,22.637272106688204
Task_4495,883,89,33,186,219,9.811111111111112,21.119437517495644
Task_4496,2107,707,28,149,177,2.975988700564972,42.80272490093497
Task_4497,1225,719,50,124,174,1.7013888888888888,29.06644898034139
Task_4498,2496,883,45,162,207,2.823529411764706,49.80860535807265
Task_4499,2570,434,45,16,61,5.908045977011494,46.87922197470434
Task_4500,1936,246,59,81,140,7.838056680161944,38.12091210722185
Task_4501,2966,272,138,152,290,10.864468864468865,55.61768823383792
Task_4502,1392,149,139,171,310,9.28,30.114772804308085
Task_4503,1534,121,93,58,151,12.573770491803279,30.57315856959325
Task_4504,2100,450,42,188,230,4.656319290465632,42.32168725294708
Task_4505,541,301,143,89,232,1.7913907284768211,16.8412441253629
Task_4506,2477,572,142,176,318,4.322862129144852,49.0477967575903
Task_4507,612,536,117,26,143,1.1396648044692737,17.47553037913001
Task_4508,1102,721,114,77,191,1.5263157894736843,26.631829574853203
Task_4509,2168,980,20,200,220,2.2099898063200816,45.008188966909074
Task_4510,1973,811,24,136,160,2.4298029556650245,40.773144681024704
Task_4511,1321,934,67,123,190,1.4128342245989305,31.256096423074208
Task_4512,1886,316,192,112,304,5.9495268138801265,38.70305981125666
Task_4513,1901,92,145,17,162,20.440860215053764,35.51705345718936
Task_4514,1715,120,73,170,243,14.173553719008265,34.783992750214885
Task_4515,1972,584,97,114,211,3.370940170940171,40.539532922711324
Task_4516,1140,77,63,34,97,14.615384615384615,22.785404579804634
Task_4517,683,855,90,98,188,0.7978971962616822,20.76995510491116
Task_4518,2281,254,135,129,264,8.945098039215686,44.57565165445535
Task_4519,2083,919,97,191,288,2.264130434782609,43.807915397098405
Task_4520,2077,670,128,145,273,3.0953800298062593,42.77514562299822
Task_4521,1550,441,167,47,214,3.506787330316742,32.597747534614896
Task_4522,736,349,45,54,99,2.1028571428571428,18.584284459839193
Task_4523,2853,652,25,144,169,4.36906584992343,54.40305348148063
Task_4524,1998,92,30,141,171,21.483870967741936,38.139015010869514
Task_4525,1905,229,49,60,109,8.282608695652174,36.9247847521989
Task_4526,2464,445,20,116,136,5.524663677130045,47.2129084698849
Task_4527,2266,507,66,63,129,4.460629921259843,44.027044094241795
Task_4528,2315,710,183,35,218,3.2559774964838257,45.59192809544754
Task_4529,2002,897,196,112,308,2.2293986636971046,42.40656826594878
Task_4530,2784,214,33,137,170,12.948837209302326,51.81991899466194
Task_4531,2079,348,47,196,243,5.957020057306591,41.7614505254885
Task_4532,2286,412,166,87,253,5.535108958837772,44.82921890743963
Task_4533,2589,571,179,134,313,4.526223776223776,50.73404691176008
Task_4534,2867,449,165,176,341,6.371111111111111,54.92741339907519
Task_4535,2757,587,161,17,178,4.688775510204081,51.584175834387764
Task_4536,1630,812,131,57,188,2.004920049200492,35.08014762094425
Task_4537,822,323,91,17,108,2.537037037037037,19.655238913753347
Task_4538,633,809,101,99,200,0.7814814814814814,19.869615066562314
Task_4539,1117,120,117,192,309,9.231404958677686,25.588731737161634
Task_4540,848,123,179,184,363,6.838709677419355,21.598916103561418
Task_4541,2400,894,25,80,105,2.6815642458100557,47.139234204485916
Task_4542,1133,868,148,181,329,1.3037974683544304,28.676117140890245
Task_4543,1733,619,48,95,143,2.7951612903225804,36.35655511312349
Task_4544,1837,769,144,125,269,2.3857142857142857,39.23637531706897
Task_4545,1556,437,176,126,302,3.5525114155251143,33.88972079450732
Task_4546,2109,473,198,43,241,4.449367088607595,41.66561547482712
Task_4547,1869,67,97,73,170,27.485294117647058,35.46598203214096
Task_4548,2653,189,88,150,238,13.963157894736842,50.15957026595026
Task_4549,1835,421,76,72,148,4.348341232227488,36.963540784403
Task_4550,1740,654,108,192,300,2.6564885496183206,37.57768260539408
Task_4551,1005,913,38,63,101,1.099562363238512,24.79057946549639
Task_4552,1525,540,29,54,83,2.8188539741219962,31.614493790341644
Task_4553,1786,212,46,79,125,8.384976525821596,35.545068596785235
Task_4554,1768,819,132,59,191,2.15609756097561,37.32510795702448
Task_4555,2201,447,120,91,211,4.912946428571429,43.52296943343302
Task_4556,1471,903,200,187,387,1.627212389380531,34.46394438303088
Task_4557,1031,410,14,71,85,2.508515815085158,23.616947066599703
Task_4558,2982,770,101,50,151,3.867704280155642,55.80973693327453
Task_4559,1375,811,130,40,170,1.6933497536945812,30.581031114580203
Task_4560,592,695,76,54,130,0.8505747126436781,17.99815297429461
Task_4561,805,440,139,190,329,1.8253968253968254,22.22870605922749
Task_4562,1300,439,165,52,217,2.9545454545454546,28.940617883342085
Task_4563,1743,247,126,30,156,7.028225806451613,34.482180488789126
Task_4564,1914,876,57,125,182,2.1824401368301025,40.37431045566767
Task_4565,1946,758,129,49,178,2.5638998682476943,39.60115610708601
Task_4566,1392,746,50,197,247,1.8634538152610443,32.310797515135356
Task_4567,1989,66,29,102,131,29.686567164179106,37.30727272607437
Task_4568,2867,328,87,194,281,8.714285714285714,54.28287953893834
Task_4569,1931,310,96,186,282,6.209003215434084,39.456518776044874
Task_4570,1099,185,40,118,158,5.908602150537634,24.73001164733228
Task_4571,2928,779,145,117,262,3.753846153846154,56.50859694550885
Task_4572,745,185,98,20,118,4.005376344086022,17.990887326038308
Task_4573,1423,683,83,149,232,2.0804093567251463,32.33154758345745
Task_4574,1100,174,57,166,223,6.285714285714286,25.222420779318018
Task_4575,1199,294,26,70,96,4.064406779661017,25.95131269518008
Task_4576,1771,664,91,29,120,2.663157894736842,36.0388190054018
Task_4577,1947,1016,54,74,128,1.9144542772861357,40.884477132131
Task_4578,545,70,46,26,72,7.676056338028169,12.956337733833125
Task_4579,2293,663,175,162,337,3.4533132530120483,46.48771344765353
Task_4580,2545,1001,28,35,63,2.539920159680639,48.533078673401825
Task_4581,2629,1006,132,178,310,2.6107249255213505,52.787508364218034
Task_4582,651,256,147,54,201,2.5330739299610894,17.9766478972882
Task_4583,1420,553,125,74,199,2.563176895306859,31.20734217693291
Task_4584,1578,1006,193,24,217,1.567030784508441,34.757785988557416
Task_4585,2664,521,29,39,68,5.103448275862069,48.84920495277748
Task_4586,1957,640,48,76,124,3.0530421216848675,39.642359842180234
Task_4587,2036,627,28,21,49,3.2420382165605095,39.203384508020264
Task_4588,2160,243,120,79,199,8.852459016393443,41.96480522459575
Task_4589,2378,219,67,180,247,10.809090909090909,46.09771066691476
Task_4590,2234,824,16,140,156,2.707878787878788,44.85988757519849
Task_4591,515,669,64,110,174,0.7686567164179104,17.489320015590724
Task_4592,1716,845,127,182,309,2.028368794326241,37.82017793816821
Task_4593,2124,469,63,40,103,4.519148936170213,40.615879421180644
Task_4594,750,619,41,28,69,1.2096774193548387,19.000750499284777
Task_4595,1820,248,39,164,203,7.309236947791165,37.059013625874655
Task_4596,1491,443,106,113,219,3.358108108108108,32.48701077484092
Task_4597,1827,319,83,78,161,5.709375,36.57208624434717
Task_4598,885,846,162,86,248,1.0448642266824084,23.865296432519852
Task_4599,2146,355,95,130,225,6.02808988764045,42.68654683692742
Task_4600,1638,839,140,163,303,1.95,36.51076850839076
Task_4601,2927,206,94,103,197,14.140096618357488,54.33729193573467
Task_4602,1791,942,120,19,139,1.8992576882290562,37.12740969642411
Task_4603,841,759,135,120,255,1.106578947368421,23.211535762283106
Task_4604,588,456,119,176,295,1.286652078774617,18.57834608189566
Task_4605,558,815,10,111,121,0.6838235294117647,18.175415815517706
Task_4606,1106,429,64,40,104,2.572093023255814,24.357079176422406
Task_4607,2663,149,150,82,232,17.753333333333334,49.43294649505455
Task_4608,1277,922,94,102,196,1.3835319609967498,30.4962724069124
Task_4609,2678,539,163,106,269,4.95925925925926,51.80124573184984
Task_4610,1918,630,65,138,203,3.0396196513470684,39.930395496476464
Task_4611,2628,230,15,135,150,11.376623376623376,49.16977932860272
Task_4612,574,912,174,71,245,0.628696604600219,19.30415031225272
Task_4613,1527,371,129,124,253,4.104838709677419,32.99424757702714
Task_4614,944,755,109,27,136,1.2486772486772486,23.329872554393972
Task_4615,1983,702,126,11,137,2.8207681365576103,39.55613905082849
Task_4616,2044,1023,179,134,313,1.99609375,43.518767697778635
Task_4617,1580,641,38,116,154,2.4610591900311527,33.89661988491597
Task_4618,1188,928,88,57,145,1.278794402583423,28.064900086947105
Task_4619,2629,892,138,189,327,2.9440089585666294,52.524406560667465
Task_4620,851,458,32,95,127,1.8540305010893245,21.766791114521357
Task_4621,1912,506,10,115,125,3.7712031558185406,38.71140274103329
Task_4622,995,771,159,74,233,1.288860103626943,25.259108628595097
Task_4623,968,742,197,132,329,1.3028263795423958,25.599441362002924
Task_4624,913,88,187,121,308,10.258426966292134,21.881240340757724
Task_4625,2135,901,50,120,170,2.3669623059866964,43.91749028959551
Task_4626,2783,419,93,24,117,6.626190476190477,51.31371229774091
Task_4627,1023,735,82,42,124,1.389945652173913,24.366931929910166
Task_4628,669,227,133,32,165,2.9342105263157894,17.697668576350875
Task_4629,2313,110,60,40,100,20.83783783783784,41.6329521455255
Task_4630,862,768,142,51,193,1.1209362808842653,22.8041292180236
Task_4631,2814,645,49,11,60,4.356037151702786,51.46152777493537
Task_4632,2552,813,25,106,131,3.135135135135135,49.858827823923484
Task_4633,999,899,41,49,90,1.11,24.201318430189925
Task_4634,1629,275,164,154,318,5.9021739130434785,34.62564678023222
Task_4635,803,71,131,187,318,11.152777777777779,20.18254011190088
Task_4636,2482,972,150,130,280,2.55087358684481,50.14648330337919
Task_4637,1857,235,55,78,133,7.86864406779661,36.91288038929623
Task_4638,548,376,122,150,272,1.453580901856764,17.577126738446147
Task_4639,948,200,100,74,174,4.7164179104477615,22.40248810782622
Task_4640,2042,925,50,139,189,2.205183585313175,42.79342453373084
Task_4641,2947,916,119,116,235,3.213740458015267,57.11667102599788
Task_4642,1696,441,17,141,158,3.83710407239819,35.11505458160786
Task_4643,1108,694,130,29,159,1.5942446043165468,25.903338191374544
Task_4644,2118,568,56,12,68,3.7223198594024605,40.151279117635
Task_4645,1667,398,186,73,259,4.177944862155388,34.842337874195195
Task_4646,1795,399,183,52,235,4.4875,36.7266643417997
Task_4647,913,214,13,160,173,4.246511627906977,22.449648669581652
Task_4648,645,754,74,115,189,0.8543046357615894,19.91708851538748
Task_4649,1964,927,44,11,55,2.1163793103448274,38.91257636379739
Task_4650,1996,67,32,113,145,29.352941176470587,37.46332879445563
Task_4651,797,633,96,199,295,1.2570977917981072,22.48185053975062
Task_4652,785,900,54,150,204,0.8712541620421753,22.716844140176022
Task_4653,1715,837,28,112,140,2.0465393794749405,36.6447244630181
Task_4654,1856,136,172,58,230,13.547445255474452,36.398204021501165
Task_4655,1282,82,30,29,59,15.44578313253012,24.9318616746703
Task_4656,2146,237,34,92,126,9.016806722689076,41.525800073927954
Task_4657,1987,80,54,187,241,24.530864197530864,38.53713907998384
Task_4658,1261,732,145,54,199,1.7203274215552524,29.11062334631688
Task_4659,2298,612,146,35,181,3.7487765089722673,44.667651820801076
Task_4660,1380,964,50,46,96,1.4300518134715026,30.48322206506938
Task_4661,1042,123,151,79,230,8.403225806451612,23.666808577342508
Task_4662,2222,360,190,112,302,6.1551246537396125,44.156019195073554
Task_4663,1043,200,100,27,127,5.189054726368159,23.09469527372877
Task_4664,2267,880,142,55,197,2.5732122587968216,45.54277985176778
Task_4665,2257,707,34,108,142,3.187853107344633,44.82864360659456
Task_4666,1330,945,143,199,342,1.4059196617336152,32.11977236542383
Task_4667,701,182,157,88,245,3.830601092896175,18.969658325173025
Task_4668,1617,372,127,28,155,4.335120643431635,32.86074326969276
Task_4669,1385,486,163,168,331,2.8439425051334704,31.53131174525714
Task_4670,2276,225,73,39,112,10.070796460176991,42.50136540238627
Task_4671,1023,618,174,11,185,1.6526655896607432,24.384665108155307
Task_4672,1125,215,195,105,300,5.208333333333333,26.30425152138872
Task_4673,2299,759,156,70,226,3.025,45.805186743368644
Task_4674,1711,799,50,152,202,2.13875,37.260902000666974
Task_4675,595,476,161,93,254,1.2473794549266248,18.344216530945104
Task_4676,1469,124,128,140,268,11.752,30.882744672436118
Task_4677,1647,700,141,34,175,2.3495007132667616,34.71401956678721
Task_4678,2896,537,130,198,328,5.382899628252788,55.64728879279871
Task_4679,1785,531,39,34,73,3.3552631578947367,35.02676400737793
Task_4680,1297,67,38,187,225,19.073529411764707,27.5084009908945
Task_4681,1547,587,148,129,277,2.630952380952381,34.11450142750773
Task_4682,2846,265,75,98,173,10.699248120300751,53.157214008640956
Task_4683,682,328,80,186,266,2.072948328267477,19.76672081574707
Task_4684,2433,533,37,44,81,4.556179775280899,45.70619721595275
Task_4685,777,687,45,194,239,1.129360465116279,21.94005967623052
Task_4686,2498,304,129,108,237,8.190163934426229,48.03105635220131
Task_4687,554,519,76,22,98,1.0653846153846154,16.19581589416803
Task_4688,1397,211,18,74,92,6.589622641509434,28.859605290445955
Task_4689,1081,556,66,127,193,1.940754039497307,26.379097103754095
Task_4690,553,1002,119,97,216,0.551345962113659,19.347178083146357
Task_4691,1116,838,59,107,166,1.33015494636472,27.442856159959515
Task_4692,1099,167,78,49,127,6.541666666666667,23.68860280343543
Task_4693,1514,407,57,21,78,3.7107843137254903,30.247732629324915
Task_4694,524,294,111,59,170,1.776271186440678,15.682963703544795
Task_4695,2128,934,121,151,272,2.2759358288770053,44.41325154701872
Task_4696,2779,617,157,53,210,4.496763754045308,52.899513791498
Task_4697,2502,464,33,166,199,5.380645161290323,48.59241357002285
Task_4698,1682,103,191,143,334,16.173076923076923,34.16524633057551
Task_4699,1125,773,85,52,137,1.4534883720930232,26.574156771497016
Task_4700,2063,104,190,180,370,19.64761904761905,40.36248707417716
Task_4701,2499,114,147,199,346,21.730434782608697,47.366227375099584
Task_4702,870,890,174,36,210,0.9764309764309764,23.308348444506247
Task_4703,1304,304,148,32,180,4.275409836065574,27.938311188405823
Task_4704,1749,824,39,151,190,2.12,37.69691568653004
Task_4705,1432,622,46,178,224,2.298555377207063,32.27041571458751
Task_4706,938,554,59,36,95,1.6900900900900901,22.124230303391005
Task_4707,1862,376,192,163,355,4.938992042440319,38.82741093166437
Task_4708,2613,348,28,93,121,7.487106017191977,49.208507282695756
Task_4709,1299,821,70,12,82,1.5802919708029197,28.581272169252856
Task_4710,2741,481,49,193,242,5.686721991701245,52.777408912110324
Task_4711,1803,143,162,179,341,12.520833333333334,36.71294750424428
Task_4712,2394,272,198,165,363,8.76923076923077,46.925243626909925
Task_4713,649,734,42,61,103,0.8829931972789116,18.455565762969176
Task_4714,1418,114,122,156,278,12.330434782608696,29.997055212418704
Task_4715,2030,384,172,192,364,5.2727272727272725,41.594780288500345
Task_4716,1771,162,166,12,178,10.865030674846626,34.49632342193839
Task_4717,776,199,128,89,217,3.88,20.170956292523176
Task_4718,1470,497,87,108,195,2.9518072289156625,32.21938756289987
Task_4719,1707,750,35,42,77,2.272969374167776,34.48933331922404
Task_4720,2440,667,111,63,174,3.6526946107784433,47.40239289364727
Task_4721,2846,503,132,164,296,5.646825396825397,54.551363362986535
Task_4722,1312,213,86,74,160,6.130841121495327,27.972017200662062
Task_4723,1245,962,105,194,299,1.2928348909657321,30.60067389146479
Task_4724,1135,815,29,171,200,1.3909313725490196,27.94286845357591
Task_4725,1347,760,54,196,250,1.7700394218134035,31.609754267974207
Task_4726,1773,134,171,120,291,13.133333333333333,35.78843532841432
Task_4727,2880,428,153,189,342,6.713286713286713,55.08722168000033
Task_4728,2199,291,109,62,171,7.530821917808219,42.18662319416882
Task_4729,511,646,126,196,322,0.7897990726429676,18.155270555512185
Task_4730,1826,754,180,177,357,2.418543046357616,39.48808503624944
Task_4731,1164,282,30,75,105,4.113074204946996,25.58115727236428
Task_4732,2533,84,52,42,94,29.8,44.85152763293328
Task_4733,1636,285,126,42,168,5.72027972027972,33.0333501423095
Task_4734,927,607,154,54,208,1.524671052631579,23.465868006043138
Task_4735,1917,1010,62,93,155,1.8961424332344214,40.46779637334928
Task_4736,1563,802,57,136,193,1.946450809464508,34.83064605438159
Task_4737,2957,504,134,33,167,5.855445544554455,54.69760943661032
Task_4738,1278,840,104,165,269,1.5196195005945303,30.616992979679367
Task_4739,1866,810,168,37,205,2.3008631319358814,38.74221710873744
Task_4740,2502,367,158,109,267,6.798913043478261,48.44684227967188
Task_4741,2483,615,96,13,109,4.0308441558441555,46.9658798721487
Task_4742,1912,962,50,180,230,1.9854620976116304,41.12027135750133
Task_4743,2587,582,19,35,54,4.437392795883362,47.97147600019715
Task_4744,2589,909,22,24,46,2.845054945054945,48.813346603807695
Task_4745,2959,235,115,104,219,12.538135593220339,54.976141781428964
Task_4746,2885,928,169,77,246,3.1054897739504845,55.805572641136116
Task_4747,968,185,149,154,303,5.204301075268817,23.656147536497645
Task_4748,1079,811,119,199,318,1.3288177339901477,27.647079392180164
Task_4749,1848,406,199,129,328,4.54054054054054,38.53233721618711
Task_4750,1486,538,102,33,135,2.7569573283858997,31.309503512501426
Task_4751,2270,191,54,133,187,11.822916666666666,43.91074874950517
Task_4752,2630,195,14,157,171,13.418367346938776,49.25917018075423
Task_4753,529,402,199,130,329,1.3126550868486353,17.601234893677322
Task_4754,1250,565,164,87,251,2.208480565371025,28.90929028226618
Task_4755,531,319,194,194,388,1.659375,17.771147268722245
Task_4756,2413,394,162,63,225,6.108860759493671,46.41111226896309
Task_4757,579,528,171,70,241,1.0945179584120983,17.848844299361563
Task_4758,695,344,104,102,206,2.0144927536231885,19.502213994631443
Task_4759,2414,107,86,45,131,22.35185185185185,43.578432956044594
Task_4760,538,527,20,102,122,1.018939393939394,16.69061244304316
Task_4761,1330,421,194,173,367,3.1516587677725116,30.623695131821336
Task_4762,2538,694,69,27,96,3.6517985611510793,48.082551378622306
Task_4763,1690,616,115,93,208,2.739059967585089,36.04126726336725
Task_4764,2182,228,130,158,288,9.528384279475983,43.066772998943485
Task_4765,1586,208,183,182,365,7.588516746411483,33.96382009737492
Task_4766,2839,99,153,56,209,28.39,51.2948995904954
Task_4767,2991,622,90,12,102,4.800963081861958,54.92313889854543
Task_4768,942,552,139,175,314,1.7034358047016276,24.645253949090915
Task_4769,2198,450,57,10,67,4.873614190687362,41.01610792652462
Task_4770,829,1008,157,140,297,0.821605550049554,24.070269103284016
Task_4771,2039,218,123,84,207,9.310502283105023,40.00381192294147
Task_4772,1848,745,75,170,245,2.4772117962466487,39.4294694948397
Task_4773,2357,482,87,113,200,4.87991718426501,46.24304267763642
Task_4774,1359,109,129,45,174,12.354545454545455,27.571944787203194
Task_4775,943,664,193,107,300,1.4180451127819549,24.792370350700356
Task_4776,1573,107,20,142,162,14.564814814814815,31.25860824983161
Task_4777,1308,102,165,64,229,12.699029126213592,27.335880964890833
Task_4778,695,222,18,182,200,3.116591928251121,19.173993132832397
Task_4779,797,665,67,100,167,1.1966966966966968,21.766936803010548
Task_4780,2203,617,46,42,88,3.5647249190938513,42.34934577759913
Task_4781,878,203,79,186,265,4.303921568627451,22.45518545014039
Task_4782,2688,620,97,10,107,4.328502415458937,50.18516059035402
Task_4783,2663,967,33,99,132,2.75103305785124,52.084370825271925
Task_4784,1178,741,170,139,309,1.587601078167116,28.86734680642168
Task_4785,2967,439,194,166,360,6.743181818181818,56.54805348738074
Task_4786,934,197,100,14,114,4.717171717171717,21.146023926433465
Task_4787,1690,705,136,95,231,2.3937677053824364,36.46421248944957
Task_4788,1243,755,110,145,255,1.6441798941798942,29.735300466215033
Task_4789,2436,963,191,23,214,2.5269709543568464,48.21351195545918
Task_4790,1527,891,122,47,169,1.7118834080717489,33.231125677968635
Task_4791,2937,615,92,76,168,4.767857142857143,55.171175589591876
Task_4792,2993,955,42,76,118,3.1307531380753137,56.919477088705975
Task_4793,2033,925,154,185,339,2.195464362850972,43.231690282014505
Task_4794,2008,551,35,11,46,3.63768115942029,38.33753302134954
Task_4795,1121,967,106,22,128,1.1580578512396693,26.927129574679626
Task_4796,1374,64,150,157,307,21.138461538461538,29.022782019487845
Task_4797,2276,187,39,89,128,12.106382978723405,43.59704212066756
Task_4798,1071,107,175,44,219,9.916666666666666,23.31834627080397
Task_4799,2933,860,85,192,277,3.4065040650406506,57.067356193603814
Task_4800,1259,737,108,139,247,1.7059620596205962,29.887922363962275
Task_4801,2956,563,122,80,202,5.24113475177305,55.65515197795534
Task_4802,2186,956,23,157,180,2.284221525600836,44.9130225859242
Task_4803,1571,524,139,196,335,2.9923809523809526,34.65539019072103
Task_4804,896,854,71,122,193,1.047953216374269,24.18789007101823
Task_4805,1657,194,116,180,296,8.497435897435897,34.64683158620337
Task_4806,668,266,109,184,293,2.50187265917603,19.338680231945713
Task_4807,2166,935,91,176,267,2.3141025641025643,45.081883609843636
Task_4808,856,438,33,45,78,1.9498861047835991,20.10827308928197
Task_4809,967,671,82,187,269,1.4389880952380953,25.262772818741936
Task_4810,2358,815,187,187,374,2.889705882352941,48.198542207738676
Task_4811,2762,265,89,64,153,10.38345864661654,50.85082385247415
Task_4812,2346,256,88,46,134,9.1284046692607,43.975546069132264
Task_4813,2286,786,115,189,304,2.9047013977128335,46.65443606421345
Task_4814,932,226,108,115,223,4.105726872246696,22.961541139113667
Task_4815,1977,180,55,76,131,10.922651933701658,38.012561184366305
Task_4816,2441,450,42,90,132,5.412416851441241,46.838626087512175
Task_4817,2881,87,83,61,144,32.73863636363637,51.092145093809904
Task_4818,2049,324,37,117,154,6.304615384615385,40.31350618511469
Task_4819,575,889,163,42,205,0.6460674157303371,18.825490274686256
Task_4820,2627,203,26,116,142,12.877450980392156,49.01560253715974
Task_4821,1618,591,154,194,348,2.733108108108108,35.666736735082466
Task_4822,1285,957,20,95,115,1.3413361169102296,29.918927733132957
Task_4823,511,695,81,176,257,0.7341954022988506,18.041568893493203
Task_4824,708,999,193,41,234,0.708,21.331787206937033
Task_4825,2523,723,41,157,198,3.484806629834254,49.69879078256855
Task_4826,1629,410,58,74,132,3.9635036496350367,33.812060785032834
Task_4827,1224,550,22,110,132,2.221415607985481,27.929866169114216
Task_4828,2472,372,65,126,191,6.627345844504021,47.79674677598552
Task_4829,1552,940,92,62,154,1.649309245483528,33.91974619083826
Task_4830,2448,306,31,50,81,7.973941368078176,45.31623986065691
Task_4831,1713,404,194,142,336,4.229629629629629,36.44472045794634
Task_4832,671,980,112,97,209,0.6839959225280327,21.20615482404165
Task_4833,806,104,46,73,119,7.6761904761904765,18.72944541566946
Task_4834,704,797,108,157,265,0.8822055137844611,21.32666585675865
Task_4835,679,578,100,187,287,1.1727115716753023,20.38896731241081
Task_4836,2706,196,197,156,353,13.736040609137056,51.458770389295545
Task_4837,2993,145,76,156,232,20.5,55.10120244354031
Task_4838,1363,988,118,23,141,1.378159757330637,30.681482883194757
Task_4839,796,640,31,164,195,1.2418096723868954,21.913434313198668
Task_4840,2051,628,86,163,249,3.260731319554849,42.191202893134914
Task_4841,2917,66,137,109,246,43.53731343283582,52.85203514284992
Task_4842,2714,1000,15,51,66,2.711288711288711,51.54344282605166
Task_4843,1838,711,77,197,274,2.581460674157303,39.32476934906499
Task_4844,2348,476,192,54,246,4.922431865828092,45.73756646056503
Task_4845,1291,1024,122,42,164,1.2595121951219512,29.980871249120053
Task_4846,1083,833,37,137,174,1.2985611510791366,26.871298440805607
Task_4847,1257,974,199,113,312,1.2892307692307692,30.76784319317734
Task_4848,1695,902,182,168,350,1.8770764119601329,37.829008611653414
Task_4849,2637,308,145,199,344,8.533980582524272,50.85852309317672
Task_4850,693,418,62,76,138,1.6539379474940334,18.917085330405968
Task_4851,1966,419,37,17,54,4.680952380952381,37.315539637281084
Task_4852,1009,524,149,70,219,1.921904761904762,24.60530189963116
Task_4853,2581,83,96,114,210,30.726190476190474,47.549653974783205
Task_4854,565,264,102,179,281,2.1320754716981134,17.64307181923754
Task_4855,859,465,22,121,143,1.8433476394849786,21.893412862492823
Task_4856,1581,716,19,87,106,2.205020920502092,33.64645490462937
Task_4857,1301,799,48,91,139,1.62625,29.936666091025756
Task_4858,1766,919,136,140,276,1.9195652173913043,38.63231075331432
Task_4859,2883,159,23,39,62,18.01875,51.10496202998275
Task_4860,612,235,41,137,178,2.593220338983051,17.597051147911014
Task_4861,967,303,48,112,160,3.1809210526315788,23.278845121203315
Task_4862,1933,784,151,179,330,2.462420382165605,41.15821484275114
Task_4863,1644,672,21,177,198,2.4427934621099556,35.61232626165968
Task_4864,2397,1023,133,183,316,2.3408203125,49.19824897991699
Task_4865,1364,765,99,59,158,1.7806788511749347,30.32028262194831
Task_4866,2792,680,52,134,186,4.0998531571218795,53.76358785500489
Task_4867,1398,655,11,138,149,2.1310975609756095,31.100666540751828
Task_4868,1439,195,82,142,224,7.341836734693878,30.936322124466788
Task_4869,1615,338,15,62,77,4.76401179941003,32.05741899696912
Task_4870,2675,144,16,74,90,18.448275862068964,48.36599063631161
Task_4871,1417,611,40,86,126,2.315359477124183,31.088040236642012
Task_4872,2657,776,183,96,279,3.4195624195624195,52.275256871645475
Task_4873,2126,779,86,141,227,2.7256410256410257,43.72232079000105
Task_4874,2223,934,61,67,128,2.3775401069518716,44.80428706603467
Task_4875,2510,723,118,131,249,3.4668508287292816,49.67218317821994
Task_4876,2472,957,34,29,63,2.580375782881002,47.28414216992517
Task_4877,2216,242,197,27,224,9.119341563786008,42.454773216185664
Task_4878,2777,135,160,97,257,20.419117647058822,51.44295353176216
Task_4879,1779,159,191,90,281,11.11875,35.91541985817194
Task_4880,916,320,136,175,311,2.853582554517134,23.50111776414147
Task_4881,2553,631,55,90,145,4.0395569620253164,49.31592529761891
Task_4882,653,435,155,197,352,1.4977064220183487,19.878550052149986
Task_4883,2847,273,186,65,251,10.39051094890511,52.9972186011017
Task_4884,1081,565,192,82,274,1.9098939929328622,26.300416791614506
Task_4885,2816,558,89,12,101,5.037567084078712,51.95447156928247
Task_4886,1801,69,102,145,247,25.728571428571428,35.396377068708695
Task_4887,2626,307,97,17,114,8.525974025974026,48.14798960756797
Task_4888,1031,936,174,149,323,1.1003201707577375,27.11890434842527
Task_4889,1256,712,177,91,268,1.761570827489481,29.64073308321977
Task_4890,2549,336,164,150,314,7.563798219584569,49.356945333787074
Task_4891,1879,100,109,63,172,18.603960396039604,35.92232539242095
Task_4892,2000,223,16,195,211,8.928571428571429,39.844261861835854
Task_4893,1543,601,158,49,207,2.5631229235880397,33.03831508984263
Task_4894,910,427,62,17,79,2.1261682242990654,20.64264854453341
Task_4895,661,64,92,148,240,10.169230769230769,17.62266202427843
Task_4896,2992,398,24,159,183,7.498746867167919,55.86279929800361
Task_4897,1085,325,167,120,287,3.3282208588957056,26.001036460928177
Task_4898,1684,406,22,106,128,4.137592137592137,34.861796339869635
Task_4899,861,702,80,44,124,1.22475106685633,21.767695257078795
Task_4900,631,936,171,154,325,0.6734258271077909,21.00320408598392
Task_4901,1200,461,128,170,298,2.5974025974025974,28.377893292478817
Task_4902,2321,576,63,100,163,4.022530329289428,45.73512262616986
Task_4903,1932,780,200,98,298,2.473751600512164,40.870199788281006
Task_4904,1830,470,142,100,242,3.8853503184713376,38.02383194455675
Task_4905,843,820,101,140,241,1.0267965895249695,23.41468675312424
Task_4906,2754,377,199,13,212,7.285714285714286,51.2771240883231
Task_4907,2060,831,50,27,77,2.4759615384615383,40.32927554367476
Task_4908,673,140,189,87,276,4.773049645390071,18.268461276489102
Task_4909,1744,476,124,113,237,3.6561844863731654,36.678215589424106
Task_4910,1211,196,121,137,258,6.147208121827411,27.40738522007149
Task_4911,836,237,143,63,206,3.5126050420168067,20.867919936087983
Task_4912,2071,550,189,147,336,3.7586206896551726,42.58735154373944
Task_4913,1658,383,60,180,240,4.317708333333333,35.25731035946204
Task_4914,1686,536,65,20,85,3.1396648044692737,33.634306784119175
Task_4915,695,734,135,117,252,0.9455782312925171,20.879142290248485
Task_4916,1050,975,110,119,229,1.0758196721311475,27.07298345207599
Task_4917,1133,658,176,132,308,1.7192716236722307,27.910714037986804
Task_4918,2567,110,142,86,228,23.126126126126128,47.40407381973899
Task_4919,660,128,98,94,192,5.116279069767442,17.696243578463598
Task_4920,2779,106,172,10,182,25.97196261682243,49.81755908266076
Task_4921,2941,220,199,26,225,13.307692307692308,53.83792496696034
Task_4922,2145,762,109,98,207,2.8112712975098297,43.77815532033949
Task_4923,2181,734,137,71,208,2.9673469387755103,43.786470448877786
Task_4924,2168,405,90,20,110,5.3399014778325125,41.20875746407392
Task_4925,2078,930,11,143,154,2.2320085929108484,42.722455426668546
Task_4926,2963,159,199,16,215,18.51875,53.62381623100969
Task_4927,610,166,169,143,312,3.6526946107784433,17.7986129851154
Task_4928,647,112,185,197,382,5.725663716814159,18.25566953357656
Task_4929,523,776,21,77,98,0.6731016731016731,17.07254129064272
Task_4930,729,636,87,110,197,1.1444270015698588,20.823854783242997
Task_4931,2080,780,153,63,216,2.6632522407170294,42.32961238400114
Task_4932,1483,609,29,120,149,2.4311475409836065,32.309887719051204
Task_4933,2136,848,103,71,174,2.5159010600706715,43.19169361186033
Task_4934,2291,740,160,128,288,3.0917678812415654,46.42780183289682
Task_4935,1844,236,10,55,65,7.780590717299578,35.30520583446033
Task_4936,1178,745,152,36,188,1.579088471849866,27.506944598343853
Task_4937,1874,132,123,77,200,14.090225563909774,36.54607664488045
Task_4938,847,978,139,117,256,0.8651685393258427,24.052764444856084
Task_4939,1336,511,119,108,227,2.609375,30.277926054953628
Task_4940,890,440,78,63,141,2.018140589569161,21.94545732722911
Task_4941,2215,617,177,102,279,3.5841423948220066,44.757523645256065
Task_4942,2926,328,122,44,166,8.893617021276595,53.61575424242719
Task_4943,2514,922,167,28,195,2.723726977248104,49.26301659645306
Task_4944,2888,960,162,107,269,3.0052029136316336,56.45941704313126
Task_4945,982,581,115,137,252,1.6872852233676976,25.034064416831455
Task_4946,2800,1014,82,73,155,2.7586206896551726,54.08482421284423
Task_4947,1751,280,24,106,130,6.2313167259786475,35.4494008097009
Task_4948,922,872,173,34,207,1.0561282932416953,23.97343199669919
Task_4949,941,669,100,173,273,1.4044776119402984,24.751256056939184
Task_4950,1342,936,67,36,103,1.432230522945571,29.816575305469527
Task_4951,1813,124,167,173,340,14.504,36.66909276644744
Task_4952,2132,778,10,68,78,2.736842105263158,41.7662570425101
Task_4953,2855,777,150,18,168,3.6696658097686377,53.64947612128256
Task_4954,2548,440,43,21,64,5.777777777777778,46.73436853214131
Task_4955,1722,88,137,142,279,19.348314606741575,34.471185784330736
Task_4956,1776,655,18,78,96,2.707317073170732,36.32223791856644
Task_4957,2405,523,28,44,72,4.5896946564885495,44.799406064432624
Task_4958,2158,258,63,94,157,8.332046332046332,41.89725674687547
Task_4959,517,373,54,176,230,1.3823529411764706,17.057221337499563
Task_4960,957,74,28,170,198,12.76,22.097747040030583
Task_4961,2631,862,77,151,228,3.048667439165701,52.08622586924121
Task_4962,1668,798,200,43,243,2.0876095118898625,35.71584771906385
Task_4963,2223,273,165,104,269,8.113138686131387,43.71303080085619
Task_4964,1131,727,196,31,227,1.5535714285714286,26.918222350617366
Task_4965,2297,206,103,37,140,11.096618357487923,43.01006175495263
Task_4966,2130,513,191,144,335,4.143968871595331,43.394492173129954
Task_4967,537,121,167,46,213,4.401639344262295,15.175972001699906
Task_4968,530,599,20,105,125,0.8833333333333333,16.938344864383193
Task_4969,1854,177,38,44,82,10.415730337078651,35.207487638472166
Task_4970,1013,383,169,10,179,2.6380208333333335,23.419390498458668
Task_4971,546,909,62,196,258,0.6,19.492410924539527
Task_4972,1323,600,16,19,35,2.201331114808652,27.417406012274743
Task_4973,2408,579,55,39,94,4.151724137931034,45.494633035930065
Task_4974,1587,183,64,116,180,8.625,32.709269900302274
Task_4975,979,330,12,38,50,2.9577039274924473,21.716637452618595
Task_4976,2642,341,180,68,248,7.7251461988304095,49.98669133326428
Task_4977,1845,358,192,147,339,5.139275766016713,38.40366517869378
Task_4978,537,145,144,174,318,3.6780821917808217,16.67810357088408
Task_4979,1806,778,119,139,258,2.318356867779204,38.74431363500503
Task_4980,794,236,59,43,102,3.350210970464135,18.869363360156903
Task_4981,1024,239,100,171,271,4.266666666666667,24.756792416360398
Task_4982,804,318,56,47,103,2.520376175548589,19.309493663122208
Task_4983,703,254,171,163,334,2.756862745098039,20.006963219920014
Task_4984,1768,261,48,68,116,6.748091603053435,35.24650345139716
Task_4985,1721,425,166,154,320,4.039906103286385,36.584671566987105
Task_4986,2848,726,35,159,194,3.9174690508940855,54.85852848735424
Task_4987,676,325,89,22,111,2.0736196319018405,17.495808841333023
Task_4988,2388,1008,70,71,141,2.3666997026759167,47.55983283570982
Task_4989,1685,794,174,143,317,2.119496855345912,37.14903661258035
Task_4990,1327,448,32,148,180,2.955456570155902,29.644261112121683
Task_4991,2378,993,118,168,286,2.3923541247484907,48.6465814482357
Task_4992,2698,576,56,26,82,4.675909878682842,49.97526058470121
Task_4993,1033,96,34,95,129,10.649484536082474,22.481914699460727
Task_4994,2916,243,141,61,202,11.950819672131148,53.659367467072656
Task_4995,896,86,23,142,165,10.298850574712644,20.971552117523782
Task_4996,942,988,199,186,385,0.9524772497472194,26.279986557985406
Task_4997,2827,638,68,49,117,4.424100156494522,52.752795355741476
Task_4998,2218,1014,15,192,207,2.185221674876847,45.89792205791563
Task_4999,560,175,116,34,150,3.1818181818181817,15.259439890764066
Task_5000,1228,929,83,123,206,1.3204301075268816,29.79753031636748
Task_5001,2043,158,42,63,105,12.849056603773585,38.46865001160105
Task_5002,1503,282,61,14,75,5.310954063604241,29.494209987187833
Task_5003,2534,1016,92,13,105,2.4916420845624385,48.969349461113744
Task_5004,2718,904,48,148,196,3.0033149171270717,53.44495905715478
Task_5005,814,461,188,46,234,1.7619047619047619,21.082239094502686
Task_5006,1259,958,98,197,295,1.3128258602711158,30.849884193165646
Task_5007,1255,966,199,158,357,1.297828335056877,30.980162249763435
Task_5008,2940,212,193,183,376,13.80281690140845,55.40751773852719
Task_5009,1621,981,17,47,64,1.65071283095723,33.88285290131858
Task_5010,2259,955,156,74,230,2.3629707112970713,45.89540360125155
Task_5011,1986,817,148,94,242,2.4278728606356967,41.52420221932599
Task_5012,1615,855,130,171,301,1.8866822429906542,36.19884164510008
Task_5013,1336,473,111,27,138,2.818565400843882,28.6329890900435
Task_5014,1104,494,170,15,185,2.2303030303030305,25.26302677702992
Task_5015,502,626,47,42,89,0.8006379585326954,15.653082510618951
Task_5016,2511,797,51,163,214,3.1466165413533833,50.005759308913305
Task_5017,2775,480,24,81,105,5.769230769230769,51.744390005168896
Task_5018,2530,906,95,131,226,2.78941565600882,50.529379684647616
Task_5019,2248,923,52,100,152,2.432900432900433,45.48831113567535
Task_5020,2246,314,98,196,294,7.130158730158731,44.480895541894
Task_5021,1686,278,152,54,206,6.043010752688172,34.4295496883741
Task_5022,2846,420,177,170,347,6.760095011876484,54.517230239939806
Task_5023,1940,379,102,183,285,5.105263157894737,39.78513890859276
Task_5024,1117,245,27,142,169,4.540650406504065,25.600332538168946
Task_5025,805,743,119,155,274,1.081989247311828,22.728596893301926
Task_5026,2843,796,94,168,262,3.5671267252195733,55.374034282022016
Task_5027,938,529,48,78,126,1.769811320754717,23.299250080531667
Task_5028,2280,966,125,101,226,2.357807652533609,46.640897778205066
Task_5029,1425,555,133,57,190,2.5629496402877696,31.073096988475598
Task_5030,2046,162,102,113,215,12.552147239263803,39.9741207849493
Task_5031,904,505,23,53,76,1.7865612648221343,21.339286039595493
Task_5032,1902,247,158,60,218,7.669354838709677,37.729866095732426
Task_5033,1598,288,178,136,314,5.529411764705882,34.13533600960026
Task_5034,2594,740,11,139,150,3.5006747638326585,50.28837454550321
Task_5035,1055,188,79,55,134,5.582010582010582,23.9035446031704
Task_5036,1637,71,17,21,38,22.73611111111111,29.7144395784894
Task_5037,1422,454,40,132,172,3.1252747252747253,31.18683403778594
Task_5038,2200,577,170,29,199,3.8062283737024223,43.268699506106714
Task_5039,2505,504,49,90,139,4.96039603960396,48.101038138948866
Task_5040,996,633,150,28,178,1.5709779179810726,24.052341117975477
Task_5041,2037,152,174,74,248,13.313725490196079,39.51166456146209
Task_5042,1913,313,145,66,211,6.092356687898089,38.17055571913997
Task_5043,2021,689,18,115,133,2.928985507246377,41.005326572881195
Task_5044,987,807,190,24,214,1.2215346534653466,24.753961679304954
Task_5045,1263,524,162,28,190,2.4057142857142857,28.165861630253577
Task_5046,647,783,76,72,148,0.8252551020408163,19.284575620094092
Task_5047,1217,602,145,48,193,2.0182421227197347,27.749342733985582
Task_5048,1615,577,77,51,128,2.7941176470588234,33.84581197478493
Task_5049,2544,627,57,180,237,4.050955414012739,50.08350080434016
Task_5050,2234,149,104,144,248,14.893333333333333,43.06383022457569
Task_5051,947,932,29,12,41,1.015005359056806,22.742593495112104
Task_5052,2065,972,138,171,309,2.1223021582733814,43.72926169381785
Task_5053,2563,514,113,135,248,4.976699029126213,49.84772915625464
Task_5054,1914,293,38,89,127,6.510204081632653,37.91690781310876
Task_5055,1979,546,28,196,224,3.6179159049360146,40.72588712238844
Task_5056,1220,90,166,89,255,13.406593406593407,26.367620032555028
Task_5057,1764,148,48,75,123,11.838926174496644,34.343169701503236
Task_5058,553,972,190,120,310,0.5683453237410072,19.715821053119814
Task_5059,1677,357,59,77,136,4.684357541899441,34.36379166539508
Task_5060,2297,205,100,76,176,11.150485436893204,43.62512893575306
Task_5061,622,244,177,106,283,2.5387755102040814,18.38134140106938
Task_5062,1003,293,120,191,311,3.4115646258503403,24.812811445894493
Task_5063,2790,853,88,60,148,3.2669789227166275,53.16990377392161
Task_5064,1750,746,138,101,239,2.3427041499330654,37.615862768983355
Task_5065,858,465,137,32,169,1.8412017167381973,21.322851893054946
Task_5066,2370,334,199,93,292,7.074626865671642,46.271012211276165
Task_5067,1569,878,126,170,296,1.7849829351535835,35.51748906679892
Task_5068,1259,946,16,74,90,1.3294614572333685,28.947407135795782
Task_5069,1998,206,95,196,291,9.652173913043478,40.21777304840246
Task_5070,1626,885,65,121,186,1.835214446952596,35.870185688101486
Task_5071,1310,496,199,171,370,2.6358148893360163,30.555808330530798
Task_5072,2914,405,47,199,246,7.177339901477833,55.18087060059863
Task_5073,2438,613,85,57,142,3.970684039087948,46.8321335778032
Task_5074,830,821,55,72,127,1.0097323600973236,22.221673282197116
Task_5075,1044,905,20,104,124,1.1523178807947019,26.010187056327258
Task_5076,1435,216,168,193,361,6.612903225806452,31.606602169734288
Task_5077,2926,705,19,145,164,4.144475920679887,55.711268446342736
Task_5078,1877,248,32,116,148,7.538152610441767,37.35239684793751
Task_5079,2970,680,89,157,246,4.361233480176211,56.88712707947195
Task_5080,1042,296,114,75,189,3.508417508417508,24.323032152326203
Task_5081,1624,1019,19,41,60,1.592156862745098,34.033550329833055
Task_5082,2057,803,80,147,227,2.558457711442786,42.79827383532833
Task_5083,872,1005,151,87,238,0.8667992047713717,24.17112771652495
Task_5084,796,961,165,193,358,0.8274428274428275,23.75478402945855
Task_5085,1141,559,64,139,203,2.0375,27.406570932373228
Task_5086,2343,443,132,149,281,5.277027027027027,46.304090723596175
Task_5087,578,454,194,164,358,1.2703296703296703,18.680178899900614
Task_5088,1031,653,115,40,155,1.5764525993883791,24.472854679459378
Task_5089,1739,355,96,158,254,4.884831460674158,36.402866474593715
Task_5090,1671,662,130,103,233,2.520361990950226,36.07745960182712
Task_5091,2235,477,50,85,135,4.675732217573222,43.72863312461704
Task_5092,2212,497,186,60,246,4.4417670682730925,43.59319868335317
Task_5093,1062,806,33,45,78,1.3159851301115242,24.531992793014464
Task_5094,1660,191,66,155,221,8.645833333333334,34.48396301731203
Task_5095,2938,978,160,48,208,3.001021450459653,56.25766940791083
Task_5096,1323,176,106,21,127,7.47457627118644,27.018440681715187
Task_5097,2122,336,167,35,202,6.29673590504451,41.26021246946125
Task_5098,2503,842,91,20,111,2.9691577698695135,47.93166116847892
Task_5099,2013,747,45,180,225,2.6911764705882355,41.8382246020073
Task_5100,2141,828,122,84,206,2.5826296743063932,43.599249415685144
Task_5101,2370,708,160,33,193,3.3427362482369536,46.340519970526486
Task_5102,2010,690,32,99,131,2.9088277858176554,40.85886217860634
Task_5103,2459,409,57,168,225,5.9975609756097565,47.96239664129923
Task_5104,1969,741,125,16,141,2.6536388140161726,39.40195426468379
Task_5105,581,656,80,59,139,0.8843226788432268,17.65877708064898
Task_5106,1000,120,195,51,246,8.264462809917354,22.787686762934374
Task_5107,858,657,153,65,218,1.303951367781155,22.607073658233308
Task_5108,1188,539,81,160,241,2.2,28.265799855622237
Task_5109,1942,950,41,37,78,2.0420609884332284,38.89856024478565
Task_5110,2056,232,131,31,162,8.82403433476395,39.42727815252626
Task_5111,1786,259,18,16,34,6.869230769230769,33.664362454032165
Task_5112,754,91,129,10,139,8.195652173913043,17.44757452663993
Task_5113,2962,950,81,14,95,3.114616193480547,55.40848016682869
Task_5114,2320,322,27,13,40,7.182662538699691,42.41289946967138
Task_5115,1497,273,106,120,226,5.463503649635037,32.06802595587205
Task_5116,1429,283,156,154,310,5.03169014084507,31.45534463769337
Task_5117,1695,844,196,112,308,2.0059171597633134,37.37721781522935
Task_5118,2331,151,10,177,187,15.335526315789474,44.27081565609353
Task_5119,1926,77,109,176,285,24.692307692307693,37.606482746404446
Task_5120,2399,664,101,174,275,3.607518796992481,47.90796749475305
Task_5121,2357,857,141,23,164,2.747086247086247,46.317272871403105
Task_5122,1621,741,12,42,54,2.184636118598383,33.19051154688968
Task_5123,2296,692,176,155,331,3.313131313131313,46.58939274719128
Task_5124,589,157,51,131,182,3.7278481012658227,16.814238525771316
Task_5125,2288,437,117,17,134,5.223744292237443,43.438206522143275
Task_5126,541,783,163,16,179,0.6900510204081632,17.492661527905728
Task_5127,1865,510,115,194,309,3.649706457925636,39.145524348410326
Task_5128,803,206,194,71,265,3.8792270531400965,20.546287016020617
Task_5129,2936,595,133,143,276,4.926174496644295,56.152373874580064
Task_5130,1535,340,151,69,220,4.5014662756598245,32.31995692185587
Task_5131,1083,418,21,163,184,2.58472553699284,25.676127083309556
Task_5132,512,953,165,123,288,0.5366876310272537,18.91879588426777
Task_5133,2705,671,98,141,239,4.025297619047619,52.58020934929554
Task_5134,1845,823,108,192,300,2.2390776699029127,39.7695938964681
Task_5135,2222,516,17,173,190,4.297872340425532,44.17609394461173
Task_5136,1891,712,176,170,346,2.652173913043478,40.32647959396668
Task_5137,914,380,185,44,229,2.3989501312335957,22.3920854650331
Task_5138,850,701,20,61,81,1.210826210826211,21.37410734688558
Task_5139,1724,552,195,147,342,3.11754068716094,37.126256343939815
Task_5140,2469,921,148,139,287,2.677874186550976,49.826163143621464
Task_5141,714,78,162,159,321,9.037974683544304,18.76114873718051
Task_5142,1546,351,111,50,161,4.392045454545454,31.786237522900894
Task_5143,2866,751,179,59,238,3.8111702127659575,54.71907621695899
Task_5144,1979,331,185,44,229,5.960843373493976,39.07916128790695
Task_5145,2643,632,41,44,85,4.1753554502369665,49.33125531688932
Task_5146,1854,749,151,58,209,2.472,38.5626607128238
Task_5147,937,241,168,54,222,3.871900826446281,22.540838434245387
Task_5148,1752,364,39,163,202,4.8,36.37062925376452
Task_5149,1730,888,123,195,318,1.9460067491563555,38.23541742249262
Task_5150,2743,737,107,196,303,3.71680216802168,53.745994822793875
Task_5151,2068,417,166,94,260,4.947368421052632,41.63623502959576
Task_5152,1756,758,33,200,233,2.313570487483531,37.914333416093065
Task_5153,2324,106,90,26,116,21.7196261682243,42.23814385364383
Task_5154,1402,227,73,189,262,6.149122807017544,30.799179715412265
Task_5155,2892,307,146,102,248,9.38961038961039,54.31211252554963
Task_5156,1623,415,116,154,270,3.9014423076923075,34.776192264549856
Task_5157,1016,519,149,21,170,1.9538461538461538,23.87610005593578
Task_5158,1414,857,170,189,359,1.648018648018648,33.294702768860496
Task_5159,2154,297,190,186,376,7.228187919463087,43.30870288726069
Task_5160,792,805,14,74,88,0.9826302729528535,21.20961331395099
Task_5161,1862,212,107,45,152,8.741784037558686,36.11272135485567
Task_5162,660,499,181,45,226,1.32,18.72458218341495
Task_5163,1523,392,88,131,219,3.8753180661577606,32.87563529808832
Task_5164,1550,770,53,38,91,2.0103761348897535,32.53886606396451
Task_5165,1792,973,100,199,299,1.839835728952772,39.40222208937343
Task_5166,1442,863,170,181,351,1.6689814814814814,33.70919922180758
Task_5167,1631,1003,104,140,244,1.6245019920318724,36.5961662027915
Task_5168,2645,488,55,82,137,5.408997955010225,50.218072479258126
Task_5169,2851,476,15,152,167,5.976939203354298,53.79915289423419
Task_5170,1026,707,63,122,185,1.4491525423728813,25.741096585920406
Task_5171,638,118,85,103,188,5.361344537815126,17.321577002710793
Task_5172,2266,318,138,91,229,7.103448275862069,44.20395743325929
Task_5173,1723,451,186,130,316,3.811946902654867,36.64673766706678
Task_5174,2089,817,64,162,226,2.553789731051345,43.3671903441022
Task_5175,1363,732,182,141,323,1.859481582537517,31.878751487697084
Task_5176,503,903,103,182,285,0.5564159292035398,18.67459060513477
Task_5177,663,455,187,102,289,1.4539473684210527,19.65055602908179
Task_5178,1281,643,76,19,95,1.9891304347826086,27.83461900743589
Task_5179,1753,806,93,68,161,2.1722428748451055,36.791557209486164
Task_5180,2649,674,52,171,223,3.9244444444444446,51.83045850046553
Task_5181,2766,645,99,87,186,4.281733746130031,52.7262380918311
Task_5182,2903,743,181,200,381,3.9018817204301075,56.65699179088008
Task_5183,2222,259,188,26,214,8.546153846153846,42.5779241803519
Task_5184,913,956,141,113,254,0.9540229885057471,25.02409162851225
Task_5185,710,595,53,118,171,1.191275167785235,20.218715986694807
Task_5186,882,320,91,163,254,2.7476635514018692,22.738217642095663
Task_5187,2179,1023,142,86,228,2.1279296875,44.94062054007933
Task_5188,923,216,163,85,248,4.253456221198157,22.57961706059434
Task_5189,1918,727,196,184,380,2.6346153846153846,40.97494524505614
Task_5190,1066,622,43,103,146,1.71107544141252,25.68690157662625
Task_5191,1733,332,66,52,118,5.2042042042042045,34.6770994039163
Task_5192,580,495,128,169,297,1.1693548387096775,18.582029224214214
Task_5193,1779,401,133,127,260,4.425373134328358,37.114829689015295
Task_5194,1998,487,122,146,268,4.094262295081967,40.9223858976514
Task_5195,890,683,29,121,150,1.3011695906432748,22.96895653363444
Task_5196,2662,219,157,192,349,12.1,50.93750746176132
Task_5197,2828,288,173,25,198,9.785467128027681,52.166094045418724
Task_5198,1201,940,148,72,220,1.2763018065887355,28.93831288416359
Task_5199,2268,1016,30,75,105,2.230088495575221,45.38067281026755
Task_5200,1213,1002,31,80,111,1.2093718843469592,28.80753190660727
Task_5201,1556,1009,100,45,145,1.5405940594059406,33.899469816318714
Task_5202,2683,270,77,43,120,9.900369003690036,49.1613631692917
Task_5203,2117,373,25,26,51,5.660427807486631,39.792133255717125
Task_5204,620,257,50,79,129,2.4031007751937983,17.536214401744523
Task_5205,785,833,111,11,122,0.9412470023980816,20.994287918883767
Task_5206,2590,935,38,12,50,2.767094017094017,48.829773123517185
Task_5207,686,654,55,18,73,1.047328244274809,17.79258692100421
Task_5208,2447,989,21,134,155,2.4717171717171715,48.753724126232434
Task_5209,1721,577,152,166,318,2.9775086505190314,37.07744107677332
Task_5210,1297,457,104,128,232,2.831877729257642,29.541554626195197
Task_5211,1704,210,23,113,136,8.075829383886257,34.505628509925295
Task_5212,1372,794,186,17,203,1.7257861635220126,30.598821762913627
Task_5213,1117,945,154,58,212,1.1807610993657505,27.51696266329085
Task_5214,1358,615,79,172,251,2.2045454545454546,31.285826967517867
Task_5215,2026,825,194,200,394,2.4527845036319613,43.07893328620776
Task_5216,2844,913,95,103,198,3.111597374179431,55.359502587334525
Task_5217,2723,592,71,42,113,4.591905564924114,50.894754315184684
Task_5218,2069,600,73,62,135,3.442595673876872,41.11250882743999
Task_5219,1227,432,181,107,288,2.8337182448036953,28.575857616653465
Task_5220,1281,273,171,99,270,4.675182481751825,28.80680825596823
Task_5221,914,102,148,70,218,8.87378640776699,21.039724737114977
Task_5222,2592,305,111,198,309,8.470588235294118,49.9772568915536
Task_5223,2174,939,29,100,129,2.3127659574468087,44.28990806889011
Task_5224,1439,607,124,138,262,2.366776315789474,32.41257710948569
Task_5225,646,679,70,112,182,0.95,19.51287983356998
Task_5226,1886,473,54,85,139,3.978902953586498,38.11618405024597
Task_5227,2358,886,100,53,153,2.6583990980834273,46.51727590394422
Task_5228,1767,573,73,175,248,3.078397212543554,37.61791728257828
Task_5229,1685,655,52,128,180,2.5685975609756095,36.063073892446226
Task_5230,2397,756,99,44,143,3.166446499339498,46.39649492356968
Task_5231,2041,973,75,131,206,2.095482546201232,42.96524788666748
Task_5232,2368,147,174,102,276,16.0,45.21403117310788
Task_5233,1226,737,37,82,119,1.6612466124661247,28.31013410834753
Task_5234,750,1014,13,87,100,0.7389162561576355,21.389429986293155
Task_5235,1477,318,29,146,175,4.630094043887147,31.689800503522573
Task_5236,1404,975,127,50,177,1.4385245901639345,31.6694592603706
Task_5237,2858,722,117,157,274,3.9529737206085755,55.3324887436332
Task_5238,2397,849,173,179,352,2.82,48.811969897402264
Task_5239,757,132,24,43,67,5.69172932330827,17.27951103618845
Task_5240,2551,700,166,68,234,3.6390870185449358,49.64849392430819
Task_5241,984,823,46,97,143,1.1941747572815533,24.950972984663284
Task_5242,949,917,141,193,334,1.0337690631808278,25.89119770293395
Task_5243,2059,336,187,88,275,6.109792284866469,41.08846551509121
Task_5244,2330,506,74,155,229,4.595660749506903,46.20860099752323
Task_5245,1167,619,99,67,166,1.882258064516129,27.024658145291962
Task_5246,1675,764,42,94,136,2.189542483660131,35.766991347992644
Task_5247,2853,981,98,118,216,2.905295315682281,55.761539755756644
Task_5248,2451,490,195,187,382,4.991853360488799,48.67722331530852
Task_5249,2998,296,196,74,270,10.094276094276093,55.64983837127061
Task_5250,2389,770,92,186,278,3.098573281452659,48.19197667155121
Task_5251,2297,521,133,86,219,4.400383141762452,45.19221771328995
Task_5252,970,641,63,87,150,1.5109034267912773,24.08196784930782
Task_5253,936,485,100,61,161,1.9259259259259258,22.686867227226866
Task_5254,1164,828,23,56,79,1.4041013268998794,26.58058186773408
Task_5255,1949,279,121,183,304,6.960714285714285,39.67678152160346
Task_5256,2396,673,86,18,104,3.5548961424332344,45.537360674454
Task_5257,2294,585,140,110,250,3.9146757679180886,45.78808693946132
Task_5258,1655,69,182,121,303,23.642857142857142,33.330465136846954
Task_5259,2975,347,112,27,139,8.548850574712644,54.16041759845066
Task_5260,578,202,63,56,119,2.8472906403940885,15.915068808247831
Task_5261,2712,386,80,80,160,7.007751937984496,50.857864111666636
Task_5262,2955,375,148,105,253,7.85904255319149,55.571627800168166
Task_5263,963,489,36,12,48,1.9653061224489796,21.58816397656172
Task_5264,1966,659,85,88,173,2.978787878787879,40.16842291424219
Task_5265,875,168,187,63,250,5.177514792899408,21.326593157279436
Task_5266,2229,64,199,140,339,34.292307692307695,42.4976566727099
Task_5267,614,471,192,197,389,1.3008474576271187,19.491134299725875
Task_5268,605,500,114,14,128,1.2075848303393213,17.146315367604338
Task_5269,2800,471,170,144,314,5.932203389830509,53.77057804650485
Task_5270,2082,777,173,134,307,2.6760925449871467,43.32724774134476
Task_5271,1301,678,67,74,141,1.9160530191458027,29.36669482344867
Task_5272,2450,640,98,11,109,3.8221528861154446,46.51950000584582
Task_5273,2385,275,165,149,314,8.641304347826088,46.549418478262886
Task_5274,920,821,149,14,163,1.119221411192214,23.177140394979684
Task_5275,857,905,196,199,395,0.9459161147902869,24.740620587699762
Task_5276,2861,903,131,163,294,3.1648230088495577,56.048076321083215
Task_5277,1165,945,21,188,209,1.2315010570824525,28.761379923114628
Task_5278,717,1021,116,178,294,0.7015655577299413,22.494594417138217
Task_5279,1056,508,16,90,106,2.074656188605108,24.708230141524094
Task_5280,2358,973,152,71,223,2.4209445585215605,47.40541860006852
Task_5281,1365,350,121,119,240,3.888888888888889,30.297373037505157
Task_5282,2980,698,20,30,50,4.263233190271817,54.521070431285516
Task_5283,2116,740,11,195,206,2.855600539811066,43.386177820519244
Task_5284,2008,117,118,161,279,17.016949152542374,39.37950760628828
Task_5285,2723,224,160,148,308,12.102222222222222,51.67118948328285
Task_5286,2323,114,148,126,274,20.2,44.16695608046177
Task_5287,2235,124,45,139,184,17.88,42.33412257889359
Task_5288,1018,386,25,115,140,2.6304909560723515,24.20416882826483
Task_5289,2194,118,183,125,308,18.436974789915965,42.398738729288844
Task_5290,912,661,79,188,267,1.3776435045317221,24.39703287943031
Task_5291,1964,897,57,51,108,2.1870824053452114,39.9106972195861
Task_5292,2884,381,23,34,57,7.549738219895288,52.01998289631635
Task_5293,1997,857,128,131,259,2.3275058275058274,42.009698217713286
Task_5294,741,470,26,63,89,1.5732484076433122,19.120503145801717
Task_5295,1944,901,32,104,136,2.155210643015521,40.46579678635042
Task_5296,2726,709,68,101,169,3.83943661971831,52.57910169492365
Task_5297,2613,656,50,128,178,3.9771689497716896,50.77529079514718
Task_5298,1959,120,117,87,204,16.1900826446281,38.04613049484667
Task_5299,1287,207,157,11,168,6.1875,27.104600542454065
Task_5300,2104,826,199,43,242,2.5441354292623943,42.706433712950826
Task_5301,1169,819,104,164,268,1.425609756097561,28.793260051068227
Task_5302,1727,518,78,145,223,3.327552986512524,36.65741451913181
Task_5303,2633,323,39,106,145,8.126543209876543,49.565793116543496
Task_5304,1463,70,135,116,251,20.6056338028169,30.094011074455427
Task_5305,1895,215,88,85,173,8.773148148148149,37.52011995410911
Task_5306,1811,228,126,117,243,7.908296943231441,36.94427219764263
Task_5307,1193,658,77,77,154,1.810318664643399,27.562414659870175
Task_5308,1517,848,25,141,166,1.7868080094228505,33.84956535602867
Task_5309,1490,107,141,99,240,13.796296296296296,30.672342995196857
Task_5310,1919,885,75,91,166,2.1659142212189617,40.22972299453732
Task_5311,1289,379,75,47,122,3.392105263157895,27.56558024134725
Task_5312,1190,244,169,126,295,4.857142857142857,27.438297165354992
Task_5313,1154,891,29,114,143,1.2937219730941705,27.804203496814143
Task_5314,1966,986,76,37,113,1.9918946301925025,40.178449757236955
Task_5315,2671,366,11,173,184,7.277929155313352,50.66860383948271
Task_5316,959,712,105,58,163,1.3450210378681626,23.911871007159856
Task_5317,594,704,182,193,375,0.8425531914893617,19.836499862099735
Task_5318,2756,274,149,121,270,10.021818181818182,52.170339894053505
Task_5319,2677,372,33,120,153,7.176943699731903,50.43695299069341
Task_5320,1690,762,17,127,144,2.2149410222804717,35.96455874186566
Task_5321,762,286,179,128,307,2.6550522648083623,20.869886368490544
Task_5322,818,855,177,89,266,0.955607476635514,23.039179412190425
Task_5323,1495,726,133,151,284,2.0563961485557085,33.7899678825995
Task_5324,2824,680,88,129,217,4.146842878120411,54.38260592224582
Task_5325,662,704,75,194,269,0.9390070921985816,20.529070712260545
Task_5326,1833,603,32,25,57,3.0347682119205297,36.052885579793006
Task_5327,1560,845,112,115,227,1.8439716312056738,34.88069404318215
Task_5328,2495,881,144,87,231,2.828798185941043,49.5303708005087
Task_5329,2414,740,175,167,342,3.2577597840755734,48.676860999308495
Task_5330,916,205,101,164,265,4.446601941747573,22.898911579701874
Task_5331,901,227,67,141,208,3.9517543859649122,22.568019548027873
Task_5332,955,798,190,26,216,1.1952440550688361,24.30515102164105
Task_5333,2498,768,87,62,149,3.2483745123537062,48.34171072194433
Task_5334,1693,556,162,97,259,3.0394973070017954,36.234265001139406
Task_5335,1431,782,125,87,212,1.8275862068965518,32.278042535616315
Task_5336,2368,155,46,41,87,15.179487179487179,43.1382398339668
Task_5337,804,832,30,48,78,0.9651860744297719,20.701819109294817
Task_5338,2417,440,73,73,146,5.480725623582766,46.27237646088159
Task_5339,2005,894,185,70,255,2.2402234636871508,41.699776093206985
Task_5340,1353,750,133,16,149,1.8015978695073236,29.728947039800797
Task_5341,2948,893,75,49,124,3.2975391498881432,55.58950556974718
Task_5342,1074,470,84,114,198,2.2802547770700636,25.9263773940948
Task_5343,2251,795,173,181,354,2.827889447236181,46.34175345069565
Task_5344,1854,140,187,121,308,13.148936170212766,37.246352649227305
Task_5345,2446,608,97,13,110,4.016420361247947,46.32760600931855
Task_5346,2734,342,186,40,226,7.970845481049563,51.060884830505564
Task_5347,1977,594,145,38,183,3.3226890756302523,39.55969097609799
Task_5348,2194,745,76,54,130,2.941018766756032,43.497017048680846
Task_5349,732,1015,64,57,121,0.7204724409448819,20.935054324789885
Task_5350,1079,495,126,176,302,2.1754032258064515,26.596530432393607
Task_5351,2182,712,100,23,123,3.0603085553997196,42.70159180925179
Task_5352,1404,547,119,194,313,2.562043795620438,31.981730390016278
Task_5353,1617,500,74,144,218,3.2275449101796405,34.835829509525546
Task_5354,2376,735,75,72,147,3.2282608695652173,46.55665367108488
Task_5355,2464,748,182,99,281,3.289719626168224,49.10469000447792
Task_5356,679,180,164,161,325,3.751381215469613,18.95983691184092
Task_5357,634,157,102,20,122,4.012658227848101,15.973375804759891
Task_5358,1311,599,86,120,206,2.185,30.123663232450923
Task_5359,837,381,89,191,280,2.1910994764397906,22.36952778374865
Task_5360,2557,738,136,143,279,3.4600811907983764,50.61677434531987
Task_5361,924,632,32,139,171,1.4597156398104265,23.660834355612263
Task_5362,1976,508,158,80,238,3.882121807465619,40.124137743515114
Task_5363,783,328,48,57,105,2.3799392097264436,19.398313957618523
Task_5364,1674,422,139,190,329,3.9574468085106385,35.92452920018366
Task_5365,1066,850,59,136,195,1.2526439482961222,26.93650720205908
Task_5366,918,980,47,171,218,0.9357798165137615,25.04035838687865
Task_5367,1522,362,102,50,152,4.192837465564739,31.36640256260543
Task_5368,2185,367,94,127,221,5.9375,43.33475710978593
Task_5369,1511,908,37,13,50,1.6622662266226622,31.653267482237066
Task_5370,512,574,147,40,187,0.8904347826086957,16.48426743143047
Task_5371,1347,621,155,103,258,2.165594855305466,30.930090924563974
Task_5372,694,358,137,118,255,1.9331476323119776,19.77498867686415
Task_5373,2536,936,73,178,251,2.706510138740662,50.956545610778335
Task_5374,2116,171,86,39,125,12.30232558139535,39.491669944083384
Task_5375,2492,288,192,15,207,8.622837370242214,46.7849898117887
Task_5376,2318,511,21,49,70,4.52734375,43.49894947053559
Task_5377,2883,427,155,190,345,6.735981308411215,55.14636434561438
Task_5378,2222,954,24,153,177,2.3267015706806284,45.40458339860866
Task_5379,2366,600,26,20,46,3.9367720465890184,44.114762091326384
Task_5380,1189,438,117,101,218,2.7084282460136673,27.669207446932983
Task_5381,1972,103,83,137,220,18.96153846153846,38.20141102385363
Task_5382,1117,709,92,98,190,1.5732394366197182,27.276695769413973
Task_5383,2193,156,99,15,114,13.968152866242038,40.523074598257566
Task_5384,532,1006,186,195,381,0.5283018867924528,19.94982719628463
Task_5385,2373,454,37,127,164,5.2153846153846155,46.163517445709836
Task_5386,2204,88,115,76,191,24.764044943820224,41.14015585548375
Task_5387,2781,393,69,92,161,7.058375634517766,52.192326886052605
Task_5388,1146,712,86,36,122,1.6072931276297335,26.305336920756062
Task_5389,2932,784,198,69,267,3.735031847133758,56.06964157738701
Task_5390,1531,151,111,102,213,10.072368421052632,31.765444926220322
Task_5391,1039,950,140,20,160,1.092534174553102,25.329648110967714
Task_5392,887,891,60,20,80,0.9943946188340808,22.183742308723946
Task_5393,1718,256,48,13,61,6.684824902723736,32.84857175454919
Task_5394,708,128,103,49,152,5.488372093023256,17.258202882642838
Task_5395,1964,376,32,20,52,5.209549071618037,37.19894440803114
Task_5396,1511,638,199,102,301,2.3646322378716746,33.773072163265546
Task_5397,1698,895,198,130,328,1.8950892857142858,37.69992567956607
Task_5398,2686,344,139,193,332,7.785507246376811,51.69541873175789
Task_5399,2164,492,115,27,142,4.389452332657201,41.83053830498695
Task_5400,2955,610,88,79,167,4.8363338788870704,55.47780941023513
Task_5401,791,930,144,109,253,0.849624060150376,22.991824744455485
Task_5402,1135,266,99,11,110,4.250936329588015,24.487692914037996
Task_5403,2179,842,70,152,222,2.5848161328588373,44.85099240892085
Task_5404,1430,832,39,81,120,1.716686674669868,31.805693369433868
Task_5405,1740,204,111,135,246,8.487804878048781,35.77498823738325
Task_5406,2897,1024,109,61,170,2.826341463414634,55.56374246985201
Task_5407,1181,701,48,186,234,1.6823361823361824,28.67390974364412
Task_5408,1395,216,58,116,174,6.428571428571429,30.10851649773524
Task_5409,927,486,101,86,187,1.9034907597535935,23.199447554003722
Task_5410,1705,844,185,32,217,2.0177514792899407,36.338269944147065
Task_5411,1273,167,154,164,318,7.5773809523809526,28.34639748255978
Task_5412,2794,989,77,20,97,2.8222222222222224,52.88609100671777
Task_5413,1565,783,35,47,82,1.996173469387755,32.76345133490183
Task_5414,2683,294,90,146,236,9.094915254237288,51.02112713005301
Task_5415,2472,469,41,17,58,5.259574468085106,45.44399690263156
Task_5416,1108,194,92,140,232,5.682051282051282,25.714211404464667
Task_5417,2919,615,106,48,154,4.738636363636363,54.2505663807533
Task_5418,823,1000,53,124,177,0.8221778221778222,23.264078405702463
Task_5419,649,128,38,59,97,5.0310077519379846,16.043101373277356
Task_5420,1623,224,50,14,64,7.213333333333333,31.22642860907112
Task_5421,948,380,197,110,307,2.4881889763779528,24.08569377472732
Task_5422,2915,255,173,92,265,11.38671875,54.44684201839439
Task_5423,1943,206,155,171,326,9.38647342995169,39.40047042133778
Task_5424,2956,261,151,118,269,11.282442748091603,55.274160978518296
Task_5425,2098,489,65,69,134,4.281632653061225,41.27723932525246
Task_5426,1153,156,155,190,345,7.343949044585988,26.583447962881852
Task_5427,971,316,124,189,313,3.0630914826498423,24.387506593676175
Task_5428,1240,685,119,79,198,1.8075801749271136,28.83680773129814
Task_5429,530,580,69,144,213,0.9122203098106713,17.7138082456189
Task_5430,2911,675,50,100,150,4.306213017751479,55.22811697621924
Task_5431,1316,391,141,37,178,3.357142857142857,28.40878185714666
Task_5432,2531,80,93,145,238,31.246913580246915,46.93570915343503
Task_5433,588,537,144,71,215,1.0929368029739777,17.91232546290529
Task_5434,2361,299,120,188,308,7.87,46.28479383475707
Task_5435,638,345,114,196,310,1.8439306358381502,19.210326226766927
Task_5436,2283,615,197,94,291,3.706168831168831,45.81492810160804
Task_5437,2304,847,153,128,281,2.7169811320754715,46.93744063486226
Task_5438,972,788,189,128,317,1.231939163498099,25.689232462353928
Task_5439,1399,364,139,16,155,3.8328767123287673,29.239715198365264
Task_5440,2021,370,149,13,162,5.44743935309973,39.18784204233984
Task_5441,1656,468,199,20,219,3.5309168443496803,34.188729205107926
Task_5442,2556,203,53,46,99,12.529411764705882,46.55173841572958
Task_5443,2003,927,112,79,191,2.158405172413793,41.645318388328704
Task_5444,2020,930,144,181,325,2.1697099892588616,42.9722943729077
Task_5445,980,197,175,114,289,4.94949494949495,23.96215191423632
Task_5446,2361,782,68,90,158,3.0153256704980844,46.7112139257712
Task_5447,1883,252,62,82,144,7.442687747035573,37.33210863447712
Task_5448,2617,476,69,18,87,5.486373165618448,48.24608138902431
Task_5449,1194,424,187,88,275,2.8094117647058825,27.689768653659883
Task_5450,935,371,79,24,103,2.513440860215054,21.68488981816348
Task_5451,2840,349,114,68,182,8.114285714285714,52.65350445859763
Task_5452,2984,399,22,110,132,7.46,55.30147576924821
Task_5453,1231,289,52,189,241,4.244827586206896,28.25547458723373
Task_5454,2217,93,143,36,179,23.585106382978722,40.8065439723886
Task_5455,2623,575,146,179,325,4.553819444444445,51.40529865514958
Task_5456,2488,762,106,93,199,3.260812581913499,49.0999944760654
Task_5457,1358,660,48,134,182,2.05446293494705,30.87016844564253
Task_5458,1601,402,56,97,153,3.9727047146401984,33.644159071314384
Task_5459,589,771,181,164,345,0.7629533678756477,19.818684121499686
Task_5460,931,226,34,120,154,4.101321585903084,22.32448619151808
Task_5461,801,667,94,112,206,1.1991017964071857,22.198259229357756
Task_5462,918,780,78,119,197,1.175416133162612,24.41872911352711
Task_5463,1439,341,72,189,261,4.207602339181286,31.762763020472175
Task_5464,2844,777,89,153,242,3.6555269922879177,55.17395398876656
Task_5465,1297,936,128,155,283,1.384204909284952,31.238547399342266
Task_5466,1084,506,48,87,135,2.138067061143984,25.557894299732414
Task_5467,1832,363,161,18,179,5.032967032967033,36.19526281033557
Task_5468,2106,757,48,64,112,2.778364116094987,42.05615313930006
Task_5469,2019,911,176,115,291,2.213815789473684,42.647314370496474
Task_5470,1878,397,159,47,206,4.71859296482412,37.61028189933605
Task_5471,909,192,63,158,221,4.709844559585492,22.655152351193607
Task_5472,2040,212,94,34,128,9.577464788732394,39.17085255339058
Task_5473,2536,676,157,142,299,3.7459379615952733,50.17715400065699
Task_5474,2053,524,32,112,144,3.9104761904761904,41.04845560166101
Task_5475,2021,230,24,172,196,8.74891774891775,40.18004309085401
Task_5476,2321,596,77,109,186,3.8877721943048575,45.956687050793114
Task_5477,1673,767,98,22,120,2.1783854166666665,34.70580637452339
Task_5478,1794,668,56,199,255,2.681614349775785,38.44305329150199
Task_5479,1671,720,125,17,142,2.3176144244105408,34.54929511059086
Task_5480,2760,706,189,127,316,3.9038189533239036,53.874823888589184
Task_5481,1489,921,98,75,173,1.6149674620390455,33.25590332018833
Task_5482,706,94,24,122,146,7.431578947368421,17.40597026304462
Task_5483,2985,806,55,92,147,3.6988847583643123,56.757185115965996
Task_5484,2871,235,85,83,168,12.165254237288135,52.87392735799492
Task_5485,1756,615,63,111,174,2.8506493506493507,37.084519564084296
Task_5486,827,755,131,189,320,1.093915343915344,23.371460930464753
Task_5487,2228,555,170,80,250,4.0071942446043165,44.318217324630744
Task_5488,2262,558,149,65,214,4.046511627906977,44.52711734203843
Task_5489,1585,862,71,121,192,1.8366164542294323,35.30769002082611
Task_5490,2878,820,26,143,169,3.505481120584653,55.3208129674748
Task_5491,661,600,69,65,134,1.0998336106489184,18.810352099806472
Task_5492,740,557,178,155,333,1.3261648745519714,21.49158772583243
Task_5493,1126,826,56,117,173,1.3615477629987909,27.690676251260424
Task_5494,2731,132,152,124,276,20.533834586466167,50.80129758302223
Task_5495,2763,413,134,97,231,6.673913043478261,52.58422424204494
Task_5496,698,973,132,56,188,0.7166324435318275,21.02085000924542
Task_5497,2529,266,41,78,119,9.47191011235955,47.37077292193042
Task_5498,1311,715,177,161,338,1.8310055865921788,31.098977272105078
Task_5499,606,525,93,26,119,1.1520912547528517,17.287393220832126
Task_5500,644,948,120,115,235,0.678609062170706,20.78343767622671
Task_5501,502,64,94,193,287,7.723076923076923,15.428541891987303
Task_5502,2414,790,79,144,223,3.0518331226295827,48.39453217246976
Task_5503,2944,866,39,101,140,3.395617070357555,56.16423876268959
Task_5504,2486,726,182,32,214,3.4195323246217333,48.32860234669411
Task_5505,1708,70,145,175,320,24.056338028169016,34.32353608059361
Task_5506,1639,901,125,123,248,1.8170731707317074,36.41287641962573
Task_5507,1238,926,59,142,201,1.3354908306364617,30.032262578034082
Task_5508,1373,774,67,185,252,1.7716129032258066,32.021219791148745
Task_5509,862,440,120,40,160,1.9546485260770976,21.16841645497318
Task_5510,950,466,63,47,110,2.0342612419700212,22.145440853047276
Task_5511,1243,377,146,197,343,3.2883597883597884,29.033174537177626
Task_5512,758,973,47,28,75,0.7782340862422998,20.287151127882037
Task_5513,2698,433,169,71,240,6.216589861751152,51.1548865023193
Task_5514,2044,157,165,85,250,12.936708860759493,39.8505624086573
Task_5515,2348,238,69,56,125,9.824267782426778,44.2158512400412
Task_5516,1465,245,61,88,149,5.955284552845528,30.72496527957497
Task_5517,2724,230,192,193,385,11.792207792207792,52.123395464280385
Task_5518,528,636,126,150,276,0.8288854003139717,18.07140937352668
Task_5519,766,506,72,132,204,1.5108481262327416,21.258161594065243
Task_5520,2386,672,105,11,116,3.5453194650817235,45.623731692869136
Task_5521,918,90,105,49,154,10.087912087912088,20.129123415603377
Task_5522,1623,161,161,32,193,10.018518518518519,32.5263017193685
Task_5523,1358,911,147,53,200,1.4890350877192982,31.24916796706078
Task_5524,1686,909,17,98,115,1.8527472527472528,36.16627296967204
Task_5525,1286,338,121,104,225,3.793510324483776,28.91921604015782
Task_5526,1844,774,149,13,162,2.3793548387096775,37.67091208904572
Task_5527,1567,214,32,175,207,7.288372093023256,33.002844609251575
Task_5528,1042,594,189,181,370,1.7512605042016807,26.62113752949307
Task_5529,1414,554,97,174,271,2.547747747747748,31.967181688434877
Task_5530,2428,252,181,56,237,9.596837944664031,46.236478670280356
Task_5531,2342,794,94,121,215,2.9459119496855344,47.14968588048928
Task_5532,1836,145,160,142,302,12.575342465753424,37.02473952268105
Task_5533,2471,832,165,69,234,2.966386554621849,48.767893131205774
Task_5534,1426,601,183,43,226,2.3687707641196014,31.190149543429822
Task_5535,1981,177,176,166,342,11.129213483146067,39.54207664050561
Task_5536,852,618,158,41,199,1.3764135702746365,22.02985169931056
Task_5537,1267,930,86,38,124,1.3609022556390977,28.922004090734404
Task_5538,2720,954,36,168,204,2.8481675392670156,53.58386118757889
Task_5539,2783,278,159,47,206,9.974910394265233,51.517355849936195
Task_5540,1857,819,116,33,149,2.2646341463414634,38.10962288452331
Task_5541,2330,171,43,99,142,13.546511627906977,43.620343473109614
Task_5542,1420,236,47,162,209,5.991561181434599,30.759810382512843
Task_5543,1454,951,127,183,310,1.5273109243697478,33.96126882399661
Task_5544,616,981,43,21,64,0.6272912423625254,18.273345171104307
Task_5545,1618,456,140,196,336,3.5404814004376366,35.18768848237322
Task_5546,1385,278,194,65,259,4.96415770609319,29.942714739514795
Task_5547,610,446,193,33,226,1.3646532438478747,17.795095038673924
Task_5548,2269,577,178,58,236,3.92560553633218,44.715541090647015
Task_5549,2322,312,56,102,158,7.4185303514377,44.74774065485055
Task_5550,1797,810,92,44,136,2.215782983970407,37.16669101147635
Task_5551,2387,245,101,64,165,9.703252032520325,45.158055256608385
Task_5552,1074,321,87,39,126,3.3354037267080745,23.993901359522983
Task_5553,1850,849,116,156,272,2.176470588235294,39.75088453460884
Task_5554,1068,764,73,86,159,1.396078431372549,26.02710512183039
Task_5555,1460,697,177,76,253,2.0916905444126073,32.5339366238105
Task_5556,1428,93,144,37,181,15.191489361702128,28.451280494100832
Task_5557,2999,727,119,70,189,4.1195054945054945,56.594732329806874
Task_5558,2507,847,78,122,200,2.956367924528302,49.91066045857784
Task_5559,972,927,137,131,268,1.0474137931034482,25.898228861493326
Task_5560,2757,558,33,138,171,4.932021466905188,52.5717219785362
Task_5561,871,248,34,117,151,3.497991967871486,21.44902755604255
Task_5562,2486,813,75,21,96,3.054054054054054,47.593550398276676
Task_5563,1216,405,45,31,76,2.9950738916256157,25.570371411376517
Task_5564,2077,563,81,31,112,3.6826241134751774,40.44722461014026
Task_5565,1038,123,85,17,102,8.370967741935484,21.875386306537493
Task_5566,586,417,163,146,309,1.4019138755980862,18.46767817228059
Task_5567,2034,513,157,113,270,3.9571984435797667,41.536204462263946
Task_5568,1897,254,120,106,226,7.43921568627451,38.30307234583995
Task_5569,543,1009,123,36,159,0.5376237623762377,18.211019305810193
Task_5570,2430,702,100,81,181,3.456614509246088,47.44079321167794
Task_5571,1287,748,45,13,58,1.7182910547396528,27.587293714333914
Task_5572,2236,991,128,54,182,2.254032258064516,45.11390077017817
Task_5573,2183,147,122,25,147,14.75,40.64518884035145
Task_5574,2189,318,147,145,292,6.862068965517241,43.495552961822035
Task_5575,2881,735,188,132,320,3.9144021739130435,55.90859803774392
Task_5576,1908,994,10,163,173,1.9175879396984925,40.619054817720574
Task_5577,1233,439,71,47,118,2.8022727272727272,26.801926882334428
Task_5578,2969,212,55,48,103,13.938967136150234,53.186559735055965
Task_5579,1653,375,121,100,221,4.3962765957446805,34.82126236168074
Task_5580,2902,461,119,156,275,6.2813852813852815,55.19414395349478
Task_5581,2525,832,97,81,178,3.0312124849939974,49.367110006694695
Task_5582,2071,319,78,113,191,6.471875,41.26155608678604
Task_5583,1161,140,195,193,388,8.23404255319149,26.7969443090587
Task_5584,2930,320,94,146,240,9.12772585669782,55.07123474033319
Task_5585,1998,352,65,135,200,5.660056657223796,40.28527026510781
Task_5586,1829,582,22,157,179,3.137221269296741,37.955143490233716
Task_5587,1646,905,107,105,212,1.8167770419426048,36.34758164823444
Task_5588,2557,694,102,92,194,3.679136690647482,49.91746911603841
Task_5589,708,432,47,196,243,1.6351039260969977,20.326546569686283
Task_5590,509,552,81,160,241,0.9204339963833634,17.409928741708786
Task_5591,1712,466,139,17,156,3.6659528907922914,34.456313116199354
Task_5592,1930,577,168,43,211,3.339100346020761,39.0282929696898
Task_5593,2884,373,65,158,223,7.711229946524064,54.509354006010675
Task_5594,1485,732,138,35,173,2.0259208731241474,32.233137084528394
Task_5595,1003,872,160,145,305,1.1489117983963344,26.45261637117458
Task_5596,1013,449,131,100,231,2.2511111111111113,24.97551551463361
Task_5597,982,613,34,80,114,1.5993485342019544,24.076552274429872
Task_5598,2672,94,60,13,73,28.126315789473683,46.63575753877458
Task_5599,2426,1020,97,134,231,2.376101860920666,49.217243116460715
Task_5600,894,843,35,101,136,1.0592417061611374,23.415366998376317
Task_5601,1883,440,102,195,297,4.26984126984127,39.15339125866565
Task_5602,1930,340,105,109,214,5.659824046920821,39.06935974077245
Task_5603,1169,406,69,80,149,2.8722358722358723,26.550169147621613
Task_5604,2542,941,57,51,108,2.6985138004246285,49.2066464194961
Task_5605,2146,756,173,159,332,2.8348745046235138,44.424705244498284
Task_5606,2918,677,16,52,68,4.303834808259587,53.79944007558348
Task_5607,1609,361,39,179,218,4.44475138121547,34.19418719035442
Task_5608,560,326,18,28,46,1.7125382262996942,14.869008180006885
Task_5609,1483,301,98,67,165,4.910596026490066,31.106506182673936
Task_5610,2126,809,69,195,264,2.6246913580246916,44.14154454251007
Task_5611,1837,131,45,59,104,13.916666666666666,34.73283509563022
Task_5612,853,708,89,113,202,1.2031029619181945,23.082016699388266
Task_5613,2363,244,128,154,282,9.644897959183673,45.95240126997942
Task_5614,1537,534,182,153,335,2.872897196261682,34.085657849969415
Task_5615,1858,414,95,166,261,4.47710843373494,38.53896525323146
Task_5616,2233,666,147,12,159,3.347826086956522,43.465294023274396
Task_5617,2382,145,90,96,186,16.315068493150687,44.91016374349149
Task_5618,2674,643,116,20,136,4.1521739130434785,50.25218774559198
Task_5619,2769,763,170,137,307,3.6243455497382198,54.17138411523348
Task_5620,868,467,122,179,301,1.8547008547008548,23.168313287096037
Task_5621,2364,635,190,192,382,3.7169811320754715,47.770501766425035
Task_5622,1458,1013,99,46,145,1.4378698224852071,32.39518794264395
Task_5623,2918,799,24,119,143,3.6475,55.62414402781318
Task_5624,2651,1009,198,65,263,2.624752475247525,52.3279874819159
Task_5625,1796,161,192,153,345,11.08641975308642,36.67298411920996
Task_5626,2157,201,173,181,354,10.678217821782178,42.900245431787916
Task_5627,850,926,28,182,210,0.9169363538295577,23.749514269957288
Task_5628,2318,1008,126,73,199,2.2973240832507433,46.804202578361014
Task_5629,2030,983,152,173,325,2.063008130081301,43.28387285311703
Task_5630,2353,554,150,69,219,4.239639639639639,45.95346269764814
Task_5631,1072,123,117,99,216,8.64516129032258,24.3359709056006
Task_5632,1944,843,128,44,172,2.3033175355450237,39.82237158913765
Task_5633,1431,464,115,53,168,3.07741935483871,30.69072492713276
Task_5634,2171,486,18,84,102,4.457905544147844,42.19533607578164
Task_5635,2409,629,145,65,210,3.823809523809524,47.06277872374048
Task_5636,2658,662,69,77,146,4.009049773755656,50.854593277653926
Task_5637,2841,842,55,65,120,3.3701067615658364,54.03985446131216
Task_5638,2228,85,52,166,218,25.906976744186046,42.23050096333692
Task_5639,2513,93,171,105,276,26.73404255319149,46.79894791539031
Task_5640,2136,425,54,98,152,5.014084507042254,42.13367731224148
Task_5641,2555,498,29,19,48,5.1202404809619235,46.79819268595867
Task_5642,1053,359,16,147,163,2.925,24.878830071672144
Task_5643,779,460,189,149,338,1.6898047722342733,21.846953042409684
Task_5644,1795,700,121,159,280,2.5606276747503567,38.45459832250749
Task_5645,1207,517,73,41,114,2.33011583011583,26.66557284318706
Task_5646,1418,657,66,148,214,2.155015197568389,32.15752896709354
Task_5647,730,795,91,55,146,0.9170854271356784,20.557340284682383
Task_5648,1211,681,126,112,238,1.7756598240469208,28.873044801229366
Task_5649,714,566,14,162,176,1.2592592592592593,20.19525469693917
Task_5650,1315,872,167,133,300,1.5063001145475372,31.39534944713812
Task_5651,1634,140,183,54,237,11.588652482269504,32.97954306788093
Task_5652,1143,436,101,85,186,2.6155606407322654,26.334793956418533
Task_5653,2705,202,15,193,208,13.32512315270936,50.95642034440154
Task_5654,1560,104,179,161,340,14.857142857142858,32.2958724750884
Task_5655,2899,167,194,137,331,17.25595238095238,54.00589300340318
Task_5656,2772,863,84,62,146,3.2083333333333335,53.031031946979624
Task_5657,2580,319,33,95,128,8.0625,48.830632073415586
Task_5658,737,135,194,63,257,5.419117647058823,18.878241546487732
Task_5659,1045,473,24,145,169,2.2046413502109705,25.20251017677045
Task_5660,1970,464,116,89,205,4.236559139784946,39.85025249368232
Task_5661,2144,313,13,27,40,6.828025477707007,39.85109408415202
Task_5662,1967,674,33,35,68,2.9140740740740743,38.393026529719286
Task_5663,2762,932,192,193,385,2.960342979635584,55.02418890350132
Task_5664,1231,598,148,109,257,2.055091819699499,29.02530251465929
Task_5665,2411,718,147,113,260,3.35326842837274,48.1113714182923
Task_5666,2188,88,121,153,274,24.584269662921347,41.77438941736105
Task_5667,1336,183,83,137,220,7.260869565217392,29.12123236851029
Task_5668,585,575,160,20,180,1.015625,17.15800436350014
Task_5669,2059,113,66,39,105,18.06140350877193,37.76205020678349
Task_5670,980,593,200,83,283,1.6498316498316499,24.811109706222755
Task_5671,2536,905,133,82,215,2.7991169977924946,50.146480498276674
Task_5672,2605,532,185,190,375,4.887429643527205,51.223750788173504
Task_5673,654,861,103,176,279,0.7587006960556845,20.845869091595418
Task_5674,2102,190,46,64,110,11.00523560209424,40.213239448694786
Task_5675,2149,677,159,172,331,3.169616519174041,44.23861356912304
Task_5676,2844,889,82,94,176,3.195505617977528,54.932629213230506
Task_5677,2053,581,151,33,184,3.527491408934708,40.69927231745417
Task_5678,2239,908,29,49,78,2.463146314631463,43.56841809835282
Task_5679,1303,90,159,10,169,14.31868131868132,26.34056968743269
Task_5680,834,279,156,183,339,2.9785714285714286,22.21023482511609
Task_5681,2178,968,193,156,349,2.2476780185758516,45.665773432280425
Task_5682,2681,877,40,97,137,3.0535307517084282,52.098085946143904
Task_5683,1788,948,132,129,261,1.8840885142255006,38.98730699455076
Task_5684,2938,498,172,165,337,5.887775551102204,56.17782322598756
Task_5685,1529,985,185,38,223,1.550709939148073,34.039058758720536
Task_5686,899,912,96,194,290,0.9846659364731654,24.986531018611924
Task_5687,2428,516,20,57,77,4.696324951644101,45.398860329699005
Task_5688,2205,622,173,54,227,3.539325842696629,43.854345430128056
Task_5689,1627,965,111,78,189,1.684265010351967,35.761349110515354
Task_5690,2758,68,50,32,82,39.971014492753625,48.10052738753928
Task_5691,1320,882,143,159,302,1.4949037372593432,31.552724568399167
Task_5692,1541,238,179,147,326,6.447698744769874,33.133137976035705
Task_5693,794,282,11,146,157,2.8056537102473498,20.406614560276036
Task_5694,2302,1014,168,121,289,2.2679802955665025,47.45217703640378
Task_5695,2440,896,188,177,365,2.720178372352285,49.69584619478896
Task_5696,2821,231,88,170,258,12.15948275862069,53.07288407858849
Task_5697,907,633,15,57,72,1.4305993690851735,21.722713020051
Task_5698,2380,676,80,179,259,3.5155096011816838,47.70743576971079
Task_5699,1408,257,33,200,233,5.457364341085271,30.803798857455757
Task_5700,750,345,39,193,232,2.167630057803468,20.638332633219772
Task_5701,560,440,76,181,257,1.2698412698412698,18.037880711929883
Task_5702,559,255,187,77,264,2.18359375,16.934639616419258
Task_5703,1466,377,93,167,260,3.878306878306878,32.25517820466444
Task_5704,1637,496,18,166,184,3.2937625754527162,34.69086882833325
Task_5705,1298,819,50,116,166,1.5829268292682928,30.351148289207188
Task_5706,1052,861,180,40,220,1.2204176334106729,26.045151888705018
Task_5707,1926,546,93,10,103,3.5210237659963437,37.924517159185875
Task_5708,842,322,125,11,136,2.606811145510836,20.290662594435787
Task_5709,2298,980,92,77,169,2.3425076452599387,46.2043620679332
Task_5710,2119,162,30,21,51,13.0,38.982044097325634
Task_5711,2642,905,75,105,180,2.9161147902869757,51.939678716039055
Task_5712,1579,113,21,21,42,13.850877192982455,29.819139323067066
Task_5713,2705,479,124,179,303,5.635416666666667,52.294619635782645
Task_5714,2202,359,80,55,135,6.116666666666666,42.44427526156216
Task_5715,1795,371,61,165,226,4.825268817204301,37.300526236218175
Task_5716,1354,587,180,142,322,2.302721088435374,31.280028911419194
Task_5717,1989,671,40,41,81,2.9598214285714284,39.13610759997534
Task_5718,1729,790,184,127,311,2.185840707964602,37.783155529272925
Task_5719,515,833,65,198,263,0.617505995203837,18.80823392497317
Task_5720,1198,830,185,160,345,1.4416365824308062,29.62803842052602
Task_5721,2524,829,92,124,216,3.040963855421687,50.14548469794642
Task_5722,1319,336,24,137,161,3.913946587537092,28.934878218587347
Task_5723,1610,928,81,44,125,1.7330462863293865,34.30335313433712
Task_5724,1476,179,24,138,162,8.2,30.359951601554396
Task_5725,2251,903,114,198,312,2.4900442477876106,46.51484295850069
Task_5726,878,162,161,177,338,5.386503067484663,22.207409357618115
Task_5727,988,836,176,50,226,1.1804062126642771,25.094812627180136
Task_5728,1928,276,31,140,171,6.96028880866426,38.51258280249832
Task_5729,1645,414,29,134,163,3.963855421686747,34.481033892762404
Task_5730,2783,799,117,177,294,3.47875,54.5065149420981
Task_5731,1493,201,140,157,297,7.391089108910891,32.12703465355619
Task_5732,2259,463,128,199,327,4.868534482758621,45.32017804671991
Task_5733,2837,151,171,38,209,18.664473684210527,51.66339975056314
Task_5734,1152,852,147,85,232,1.35052754982415,28.105386732596557
Task_5735,2736,831,159,70,229,3.2884615384615383,52.96802256062798
Task_5736,879,329,25,72,97,2.6636363636363636,21.048545927569094
Task_5737,2589,372,87,146,233,6.941018766756033,49.74956488855091
Task_5738,2898,810,16,143,159,3.5733662145499383,55.34868157913511
Task_5739,1703,182,121,93,214,9.306010928961749,34.68420141964905
Task_5740,651,688,37,50,87,0.9448476052249637,18.11176395528342
Task_5741,2024,470,166,149,315,4.29723991507431,41.495569645466404
Task_5742,2553,684,166,178,344,3.727007299270073,50.72731299905373
Task_5743,2634,570,117,94,211,4.612959719789842,50.86952431805164
Task_5744,1723,863,79,71,150,1.994212962962963,36.51010669988218
Task_5745,2260,365,64,165,229,6.174863387978142,44.650535183897524
Task_5746,1600,859,183,130,313,1.8604651162790697,35.96759753268936
Task_5747,1018,916,182,71,253,1.1101417666303162,26.055391049707207
Task_5748,2830,709,34,76,110,3.9859154929577465,53.45393540722688
Task_5749,1370,541,24,79,103,2.5276752767527677,29.698321552640916
Task_5750,1741,833,95,171,266,2.0875299760191846,38.039115185829985
Task_5751,2696,635,149,88,237,4.238993710691824,51.97079243346573
Task_5752,1116,1019,109,161,270,1.0941176470588236,28.501314872367008
Task_5753,1831,638,108,152,260,2.865414710485133,38.72977989223785
Task_5754,2878,295,55,36,91,9.722972972972974,51.95239158493769
Task_5755,2856,124,137,130,267,22.848,52.69054216383417
Task_5756,1863,685,79,178,257,2.7157434402332363,39.53959652424096
Task_5757,1355,810,148,183,331,1.6707768187422936,32.078902256597296
Task_5758,2732,545,172,85,257,5.003663003663004,52.31594167888891
Task_5759,1008,952,43,199,242,1.0577124868835257,26.42523550982267
Task_5760,711,702,106,44,150,1.0113798008534851,19.439264954992503
Task_5761,1274,81,95,138,233,15.536585365853659,27.196345638672085
Task_5762,1362,864,25,140,165,1.5745664739884393,31.497117370488734
Task_5763,1643,690,28,122,150,2.377713458755427,35.07533246861038
Task_5764,2195,365,170,94,264,5.997267759562842,43.49238263740981
Task_5765,2904,187,102,89,191,15.446808510638299,53.74254954693817
Task_5766,2527,190,92,71,163,13.230366492146597,47.28910915442153
Task_5767,1681,526,52,115,167,3.189753320683112,35.50687955717871
Task_5768,2237,516,98,96,194,4.326885880077369,44.42783958086492
Task_5769,997,531,166,119,285,1.8740601503759398,25.251066872379756
Task_5770,2624,79,96,190,286,32.8,48.63558106813127
Task_5771,1956,605,149,197,346,3.227722772277228,41.05900591351218
Task_5772,920,1012,29,30,59,0.9081934846989141,22.942504082736093
Task_5773,2278,619,123,187,310,3.674193548387097,46.02593179170406
Task_5774,1688,695,40,114,154,2.425287356321839,35.77350411333988
Task_5775,1285,825,121,65,186,1.555690072639225,29.59632235927873
Task_5776,625,178,20,56,76,3.4916201117318435,15.848858175634717
Task_5777,618,194,83,13,96,3.169230769230769,15.99964415628768
Task_5778,2149,406,63,138,201,5.28009828009828,42.86417078499929
Task_5779,2904,867,138,135,273,3.345622119815668,56.48091976593995
Task_5780,914,767,23,43,66,1.1901041666666667,22.175256243766142
Task_5781,1859,463,62,84,146,4.006465517241379,37.65493808442955
Task_5782,2352,479,159,12,171,4.9,44.87083732291739
Task_5783,1806,184,66,168,234,9.762162162162163,36.701842046442195
Task_5784,2721,1023,19,130,149,2.6572265625,53.17182568978766
Task_5785,2373,716,85,124,209,3.309623430962343,47.33670500067445
Task_5786,523,921,106,154,260,0.5672451193058569,18.907595316985606
Task_5787,2766,1022,45,198,243,2.7038123167155423,54.73595076567633
Task_5788,738,822,95,94,189,0.8967193195625759,21.486725358802047
Task_5789,1804,842,116,79,195,2.139976275207592,38.24553328052743
Task_5790,1194,726,28,71,99,1.642365887207703,27.30913071181469
Task_5791,2596,463,104,67,171,5.594827586206897,49.09573955388893
Task_5792,1547,948,158,97,255,1.63013698630137,35.11460543422893
Task_5793,1647,501,50,164,214,3.2808764940239046,35.38289871610046
Task_5794,2286,669,79,200,279,3.4119402985074627,46.3207861948095
Task_5795,1389,475,49,148,197,2.918067226890756,31.08729597507629
Task_5796,1393,927,102,60,162,1.5010775862068966,31.308247914509124
Task_5797,2573,318,129,139,268,8.065830721003135,49.450939835554685
Task_5798,2319,415,29,150,179,5.574519230769231,45.23717338108752
Task_5799,1332,559,146,159,305,2.3785714285714286,30.792041695723928
Task_5800,1152,770,110,130,240,1.4941634241245136,28.221392743043182
Task_5801,2143,821,37,50,87,2.6070559610705595,42.108570011791116
Task_5802,996,670,40,22,62,1.4843517138599105,22.923427095671016
Task_5803,2830,324,46,77,123,8.707692307692307,52.37040103965098
Task_5804,2377,689,191,82,273,3.444927536231884,47.211247947150504
Task_5805,854,431,200,97,297,1.9768518518518519,22.72896927958057
Task_5806,2606,977,165,20,185,2.6646216768916156,50.5328096272137
Task_5807,1484,880,161,27,188,1.6844494892167992,32.716205166218565
Task_5808,2002,566,100,20,120,3.5308641975308643,39.13472610371134
Task_5809,655,200,84,35,119,3.2587064676616917,16.82701843495619
Task_5810,2981,282,142,184,326,10.53356890459364,56.10075717978432
Task_5811,756,170,127,79,206,4.421052631578948,19.2764020597118
Task_5812,2052,975,191,79,270,2.1024590163934427,42.92912059791851
Task_5813,1346,450,61,174,235,2.984478935698448,30.503839826202945
Task_5814,1986,642,138,100,238,3.088646967340591,41.021914449942464
Task_5815,1270,880,150,117,267,1.441543700340522,30.5093463230248
Task_5816,1959,695,189,49,238,2.814655172413793,40.0620779124556
Task_5817,1512,364,25,51,76,4.142465753424657,30.402913309544285
Task_5818,2261,955,187,59,246,2.3650627615062763,45.80831225057033
Task_5819,1613,416,71,119,190,3.86810551558753,34.32492904232296
Task_5820,2339,815,197,173,370,2.866421568627451,47.85896528940961
Task_5821,1936,903,19,121,140,2.1415929203539825,40.30456952748991
Task_5822,1171,84,13,105,118,13.776470588235295,24.497621318603958
Task_5823,1631,502,169,110,279,3.242544731610338,35.15709526917395
Task_5824,2812,765,71,122,193,3.671018276762402,54.45008571103392
Task_5825,603,464,100,196,296,1.2967741935483872,18.87455680242799
Task_5826,1707,185,198,133,331,9.17741935483871,35.41159526675781
Task_5827,511,191,155,189,344,2.6614583333333335,16.842075380310526
Task_5828,2728,70,66,121,187,38.42253521126761,49.638336764088876
Task_5829,2250,655,122,147,269,3.4298780487804876,45.452910736322075
Task_5830,1813,150,134,138,272,12.006622516556291,36.52390658246327
Task_5831,702,714,142,128,270,0.9818181818181818,21.017089697960014
Task_5832,2387,763,183,103,286,3.1243455497382198,47.975188425676436
Task_5833,1575,252,196,101,297,6.225296442687747,33.52089366368647
Task_5834,2836,447,45,168,213,6.330357142857143,53.84168329949065
Task_5835,2413,748,148,131,279,3.2216288384512684,48.349453013104664
Task_5836,1099,693,11,193,204,1.5835734870317002,27.078690867936714
Task_5837,578,463,124,161,285,1.2456896551724137,18.343716333926732
Task_5838,1609,369,105,96,201,4.348648648648648,34.03319083872534
Task_5839,2298,909,200,160,360,2.525274725274725,47.43892622628428
Task_5840,2205,992,171,49,220,2.2205438066465257,44.805950447674626
Task_5841,1621,652,178,155,333,2.482388973966309,35.78109791127907
Task_5842,1843,414,96,74,170,4.440963855421686,37.18754813755148
Task_5843,1031,762,159,100,259,1.3512450851900393,26.323576088696743
Task_5844,1361,935,194,50,244,1.454059829059829,31.348053688702795
Task_5845,1687,350,104,168,272,4.806267806267806,35.60679715230767
Task_5846,1854,651,23,175,198,2.8435582822085887,38.98540120440283
Task_5847,879,680,21,191,212,1.2907488986784141,23.470004942621102
Task_5848,729,431,135,151,286,1.6875,20.733227475242934
Task_5849,1931,266,179,18,197,7.2322097378277155,37.713168661642634
Task_5850,1800,568,109,160,269,3.1634446397188047,38.070352049220794
Task_5851,504,89,102,154,256,5.6,15.29856352429592
Task_5852,2906,967,54,62,116,3.0020661157024793,55.32667824001564
Task_5853,505,673,175,15,190,0.7492581602373887,16.530974624811716
Task_5854,2425,348,176,125,301,6.948424068767908,47.34131623510058
Task_5855,553,708,122,35,157,0.7799717912552891,17.156725997637466
Task_5856,2162,146,92,188,280,14.70748299319728,42.14576687272531
Task_5857,2747,1014,140,186,326,2.7064039408866996,54.766252794399826
Task_5858,1048,933,162,71,233,1.1220556745182013,26.49322767416329
Task_5859,2329,708,100,122,222,3.2849083215796897,46.622870607689556
Task_5860,1888,112,197,51,248,16.707964601769913,36.499789186766925
Task_5861,1694,162,28,170,198,10.392638036809815,34.446350837180454
Task_5862,1714,297,117,93,210,5.751677852348993,35.40249232602876
Task_5863,554,218,151,82,233,2.529680365296804,16.67901239198705
Task_5864,804,968,43,105,148,0.8297213622291022,22.43922786206703
Task_5865,557,853,161,29,190,0.6522248243559718,18.360830544809584
Task_5866,2799,272,33,85,118,10.252747252747254,51.745817484748976
Task_5867,2530,431,130,156,286,5.856481481481482,49.25719731069745
Task_5868,1807,357,162,158,320,5.0474860335195535,37.729740203370795
Task_5869,2581,706,170,122,292,3.6506364922206505,50.92387479982972
Task_5870,1492,885,11,68,79,1.6839729119638827,32.053567649874864
Task_5871,2235,767,153,167,320,2.91015625,45.82677885713156
Task_5872,1015,124,199,53,252,8.12,23.190228401993114
Task_5873,2423,1013,47,184,231,2.3895463510848125,49.24790014689059
Task_5874,901,160,133,53,186,5.596273291925466,21.212436179826728
Task_5875,1599,555,171,88,259,2.8758992805755397,34.44391333155903
Task_5876,918,581,88,48,136,1.577319587628866,22.429324479702903
Task_5877,1997,182,13,121,134,10.912568306010929,38.77951782525913
Task_5878,1735,962,72,196,268,1.8016614745586708,38.44767901523037
Task_5879,2568,460,194,43,237,5.570498915401301,48.87096733345322
Task_5880,2682,882,98,52,150,3.0373725934314835,51.654088350150964
Task_5881,2419,477,41,16,57,5.060669456066946,44.68770484010613
Task_5882,1816,441,85,61,146,4.108597285067873,36.50323604058227
Task_5883,2168,359,34,109,143,6.022222222222222,42.31132196424777
Task_5884,1455,471,187,112,299,3.082627118644068,32.36549987068722
Task_5885,2471,1003,41,196,237,2.4611553784860556,49.984110562217744
Task_5886,2861,832,63,136,199,3.434573829531813,55.485710344266955
Task_5887,1648,947,53,37,90,1.738396624472574,34.591290675186485
Task_5888,2313,220,96,100,196,10.46606334841629,44.658608241487116
Task_5889,2731,769,67,198,265,3.5467532467532465,53.610613360134955
Task_5890,2782,413,84,159,243,6.719806763285024,53.04357742354792
Task_5891,1968,851,185,180,365,2.3098591549295775,42.08108115443984
Task_5892,655,282,124,133,257,2.314487632508834,18.947606197228897
Task_5893,814,728,52,129,181,1.1165980795610426,22.267397823693486
Task_5894,2944,979,22,116,138,3.0040816326530613,56.46986352843097
Task_5895,1690,265,70,111,181,6.353383458646617,34.833013391364055
Task_5896,2157,933,162,120,282,2.309421841541756,44.869297100919816
Task_5897,1847,907,22,192,214,2.0341409691629955,39.64472990503206
Task_5898,1164,573,195,115,310,2.0278745644599305,28.133709383537223
Task_5899,2013,100,17,130,147,19.93069306930693,37.95042798702807
Task_5900,1134,410,111,164,275,2.759124087591241,27.059099057413352
Task_5901,2087,594,175,86,261,3.507563025210084,42.288896030054154
Task_5902,2338,218,48,84,132,10.67579908675799,44.43368206304322
Task_5903,2543,923,133,119,252,2.752164502164502,50.817924188653215
Task_5904,2412,267,97,158,255,9.0,46.71842373732741
Task_5905,2401,857,84,104,188,2.7983682983682985,48.06127563917075
Task_5906,2504,858,24,15,39,2.9150174621653084,47.05163619233337
Task_5907,2542,597,200,158,358,4.250836120401337,50.310793304819434
Task_5908,544,647,61,146,207,0.8395061728395061,18.1145199032329
Task_5909,1925,413,116,155,271,4.64975845410628,39.554789689973994
Task_5910,757,683,189,35,224,1.1067251461988303,20.842650333895545
Task_5911,1203,987,181,163,344,1.2176113360323886,30.13876694907842
Task_5912,1485,970,189,79,268,1.529351184346035,33.881535505855396
Task_5913,1145,434,61,92,153,2.632183908045977,26.364948085420107
Task_5914,2255,842,14,167,181,2.67497034400949,45.6156246519428
Task_5915,1736,630,95,83,178,2.751188589540412,36.309568131142406
Task_5916,562,968,103,12,115,0.5799793601651186,17.890176290287055
Task_5917,2267,512,126,53,179,4.419103313840156,44.132256714501644
Task_5918,1801,556,34,32,66,3.2333931777378817,35.3633563393591
Task_5919,2820,952,100,121,221,2.9590766002098636,55.16105467606815
Task_5920,1833,299,57,22,79,6.11,35.06562226011622
Task_5921,1037,465,26,198,224,2.225321888412017,25.55890308229949
Task_5922,1206,1008,76,161,237,1.195242814667988,29.937428717637925
Task_5923,2162,79,128,139,267,27.025,41.218886576381436
Task_5924,2701,759,13,24,37,3.5539473684210527,50.05490995652102
Task_5925,2951,240,39,25,64,12.244813278008298,52.44085835845686
Task_5926,2412,194,55,198,253,12.36923076923077,46.53682950100208
Task_5927,735,611,131,155,286,1.2009803921568627,21.326910965279637
Task_5928,1354,67,64,128,192,19.91176470588235,28.174465812632533
Task_5929,2970,194,109,145,254,15.23076923076923,55.12803499960386
Task_5930,2107,958,80,151,231,2.197080291970803,44.097686220311225
Task_5931,2485,745,55,175,230,3.331099195710456,49.48295324261779
Task_5932,918,386,138,66,204,2.372093023255814,22.63862836561978
Task_5933,1694,777,192,11,203,2.177377892030848,35.740575895681836
Task_5934,2280,376,109,156,265,6.047745358090186,45.02469563047774
Task_5935,2990,964,154,130,284,3.098445595854922,58.189575152692804
Task_5936,2863,781,177,129,306,3.661125319693095,55.70102917737207
Task_5937,2122,684,108,27,135,3.0978102189781023,41.786385772163236
Task_5938,2475,633,124,20,144,3.9037854889589907,47.08362494303406
Task_5939,1934,869,181,127,308,2.2229885057471264,41.263877016186875
Task_5940,1069,302,58,118,176,3.5280528052805282,25.16849359098998
Task_5941,2439,1007,29,83,112,2.419642857142857,48.29576576779662
Task_5942,679,873,96,193,289,0.7768878718535469,21.395792688956387
Task_5943,2858,419,148,81,229,6.804761904761905,53.71836253573386
Task_5944,1614,109,85,69,154,14.672727272727272,31.370576689004398
Task_5945,1443,87,54,38,92,16.397727272727273,27.768701050157006
Task_5946,1099,649,122,126,248,1.6907692307692308,27.064930244643204
Task_5947,2523,626,91,86,177,4.023923444976076,48.76959464622977
Task_5948,2144,715,22,143,165,2.994413407821229,43.385612321942915
Task_5949,2094,352,130,67,197,5.932011331444759,41.124336593390126
Task_5950,767,416,40,190,230,1.839328537170264,21.118112669600418
Task_5951,886,761,63,90,153,1.162729658792651,23.108057897257194
Task_5952,909,107,56,13,69,8.416666666666666,19.191900108664388
Task_5953,2259,194,10,67,77,11.584615384615384,41.91009052272894
Task_5954,735,943,109,139,248,0.7786016949152542,22.18954411978648
Task_5955,1511,631,49,121,170,2.3908227848101267,33.16115991117146
Task_5956,1844,1005,171,65,236,1.8330019880715707,39.405203461734494
Task_5957,644,328,69,135,204,1.9574468085106382,18.805760072532987
Task_5958,1298,1002,104,21,125,1.2941176470588236,29.53421591626314
Task_5959,912,327,196,15,211,2.7804878048780486,21.951764967172142
Task_5960,753,563,90,34,124,1.3351063829787233,19.6921331609493
Task_5961,2016,427,124,50,174,4.710280373831775,39.74344420257777
Task_5962,1987,840,109,44,153,2.3626634958382877,40.160748238430955
Task_5963,1641,963,68,160,228,1.7022821576763485,36.70997420451643
Task_5964,1472,492,54,11,65,2.9858012170385395,29.66104411868419
Task_5965,2150,252,66,71,137,8.49802371541502,41.35631337359669
Task_5966,798,622,116,29,145,1.2808988764044944,20.763592613421824
Task_5967,2630,419,142,27,169,6.261904761904762,49.16291226254018
Task_5968,2099,254,32,166,198,8.231372549019607,41.49625299761234
Task_5969,1655,811,50,26,76,2.0381773399014778,33.851071138323626
Task_5970,884,412,131,18,149,2.1404358353510897,21.14915660886814
Task_5971,1609,723,157,193,350,2.222375690607735,35.94551848830677
Task_5972,2631,548,60,175,235,4.7923497267759565,51.161896480068435
Task_5973,1604,637,133,26,159,2.5141065830721003,33.50810315959712
Task_5974,1676,893,164,113,277,1.8747203579418346,37.09033384652465
Task_5975,603,295,119,176,295,2.0371621621621623,18.401391209213926
Task_5976,1628,491,50,48,98,3.3089430894308944,32.98411508751506
Task_5977,2596,767,144,180,324,3.3802083333333335,51.58292384285354
Task_5978,2655,484,77,57,134,5.474226804123711,49.94233262695491
Task_5979,1802,729,45,23,68,2.4684931506849317,35.84679356685387
Task_5980,733,656,32,148,180,1.1156773211567732,20.65288569037875
Task_5981,2695,265,56,124,180,10.131578947368421,50.74899407967566
Task_5982,1768,291,33,115,148,6.054794520547945,35.78571902534173
Task_5983,2340,140,17,134,151,16.595744680851062,43.57897944515136
Task_5984,2135,672,196,156,352,3.1723625557206536,44.07230837876693
Task_5985,878,270,165,82,247,3.2398523985239853,22.030390743513706
Task_5986,1676,841,79,96,175,1.990498812351544,36.54673164000565
Task_5987,2782,283,113,94,207,9.795774647887324,52.23493581730251
Task_5988,2856,547,99,21,120,5.211678832116788,52.69317743295348
Task_5989,1429,409,102,16,118,3.4853658536585366,29.60609568708325
Task_5990,834,143,47,137,184,5.791666666666667,20.494718782722924
Task_5991,2828,330,113,49,162,8.54380664652568,52.03206432679028
Task_5992,939,283,65,38,103,3.306338028169014,21.387222298577353
Task_5993,908,994,155,80,235,0.9125628140703518,24.70846737216937
Task_5994,2629,220,76,91,167,11.895927601809955,49.277834474329275
Task_5995,1535,653,10,39,49,2.3470948012232418,31.38157554551047
Task_5996,2377,938,92,94,186,2.531416400425985,47.7373928240589
Task_5997,638,645,147,177,324,0.9876160990712074,20.104786706337
Task_5998,2000,604,175,128,303,3.3057851239669422,41.45771253976439
Task_5999,597,842,42,113,155,0.708185053380783,18.983209605058992
Task_6000,1396,974,200,180,380,1.4317948717948719,33.39895000688914
Task_6001,1343,951,27,186,213,1.4107142857142858,31.74085290942546
Task_6002,2844,66,64,176,240,42.44776119402985,51.78526665620075
Task_6003,2955,762,84,153,237,3.872870249017038,56.87014926936026
Task_6004,2946,104,135,193,328,28.057142857142857,54.06667064283244
Task_6005,2868,808,49,162,211,3.5451174289245984,55.646204425388085
Task_6006,609,957,25,108,133,0.6356993736951984,19.57095541816159
Task_6007,2777,749,122,82,204,3.7026666666666666,53.425837283926796
Task_6008,2457,393,134,50,184,6.2360406091370555,46.54580331139669
Task_6009,614,337,129,145,274,1.816568047337278,18.56843181162596
Task_6010,832,406,163,116,279,2.0442260442260443,22.215160981634934
Task_6011,1596,704,100,186,286,2.2638297872340427,35.381502979727216
Task_6012,1772,938,185,155,340,1.8871139510117145,39.0968722982234
Task_6013,1641,465,83,193,276,3.5214592274678114,35.359309231285366
Task_6014,572,413,58,180,238,1.3816425120772946,18.09006452384968
Task_6015,1654,730,114,54,168,2.26265389876881,35.00837854004243
Task_6016,1292,410,69,73,142,3.1435523114355233,28.335935387580236
Task_6017,2055,67,177,31,208,30.220588235294116,38.2681644757091
Task_6018,1003,126,93,169,262,7.897637795275591,23.674160738380692
Task_6019,1183,572,185,122,307,2.0645724258289704,28.42818892171589
Task_6020,2225,301,104,200,304,7.367549668874172,44.14108104321315
Task_6021,1109,783,110,18,128,1.4145408163265305,25.891396009313876
Task_6022,590,620,68,54,122,0.9500805152979066,17.526865460264844
Task_6023,2751,183,197,44,241,14.951086956521738,50.82492858542031
Task_6024,1501,908,97,20,117,1.6512651265126512,32.28903865055272
Task_6025,1184,360,93,110,203,3.2797783933518008,27.398558598885042
Task_6026,2097,103,147,134,281,20.16346153846154,40.43340236439789
Task_6027,1856,812,54,111,165,2.2829028290282904,39.26576465733873
Task_6028,748,548,44,34,78,1.3624772313296905,18.6997828407476
Task_6029,1560,615,54,35,89,2.5324675324675323,32.110076331870175
Task_6030,2888,880,157,189,346,3.2780930760499434,56.67633364574584
Task_6031,1889,122,42,46,88,15.357723577235772,35.26939902622637
Task_6032,1864,423,43,141,184,4.39622641509434,38.04911215518408
Task_6033,2601,126,101,31,132,20.480314960629922,47.03171669583679
Task_6034,1772,959,163,25,188,1.8458333333333334,37.518095941145134
Task_6035,2692,608,166,172,338,4.420361247947455,52.65175106499299
Task_6036,595,291,149,129,278,2.037671232876712,18.116661918557863
Task_6037,836,638,137,94,231,1.3082942097026604,22.646962504820994
Task_6038,1824,992,182,78,260,1.836858006042296,39.31738799033398
Task_6039,1268,725,189,76,265,1.7465564738292012,29.625184445992563
Task_6040,674,146,34,25,59,4.585034013605442,16.010815410915217
Task_6041,1515,361,21,120,141,4.185082872928176,31.930554726439947
Task_6042,2422,158,79,126,205,15.232704402515724,46.00901417009161
Task_6043,1956,676,158,173,331,2.8892171344165436,41.17990374455097
Task_6044,2380,521,49,89,138,4.559386973180077,46.15845880242102
Task_6045,1609,957,69,120,189,1.6795407098121085,35.92227260038275
Task_6046,2495,70,64,67,131,35.140845070422536,44.97789513409214
Task_6047,2040,882,155,90,245,2.3103057757644394,42.48095472650723
Task_6048,635,832,167,138,305,0.7623049219687875,20.516711692001675
Task_6049,2399,911,48,27,75,2.630482456140351,45.944907062169825
Task_6050,655,483,47,195,242,1.353305785123967,19.56929247871993
Task_6051,2639,945,30,144,174,2.7896405919661733,52.07217694354042
Task_6052,1443,580,105,105,210,2.4836488812392425,32.108409271012185
Task_6053,2038,200,47,138,185,10.139303482587065,40.1136945968485
Task_6054,1750,738,77,179,256,2.3680649526387008,37.90772853713263
Task_6055,891,352,191,65,256,2.5240793201133145,22.358984056056926
Task_6056,1823,771,45,164,209,2.36139896373057,38.80773302520552
Task_6057,2289,132,183,54,237,17.210526315789473,43.20481192395323
Task_6058,2984,984,152,41,193,3.0294416243654823,56.92617620411721
Task_6059,708,294,52,70,122,2.4,18.613728986426466
Task_6060,2034,308,119,118,237,6.58252427184466,40.72300230165276
Task_6061,2311,888,49,48,97,2.5995500562429696,45.0662133022744
Task_6062,1655,708,66,103,169,2.3342736248236955,35.614054258358266
Task_6063,639,919,107,185,292,0.6945652173913044,20.961719067348767
Task_6064,2718,606,87,96,183,4.477759472817134,52.10482256689047
Task_6065,1183,90,68,180,248,13.0,25.99398728921524
Task_6066,2686,968,180,41,221,2.7719298245614037,52.28011539983629
Task_6067,1149,838,191,88,279,1.369487485101311,28.232583799924956
Task_6068,806,272,145,13,158,2.9523809523809526,19.594856118057816
Task_6069,2060,603,65,39,104,3.410596026490066,40.06790207259818
Task_6070,2909,841,198,137,335,3.454869358669834,56.76092223991367
Task_6071,2313,344,89,167,256,6.7043478260869565,45.454778392219
Task_6072,1787,460,49,128,177,3.876355748373102,37.03825245158501
Task_6073,2104,933,28,94,122,2.252676659528908,43.0343048562435
Task_6074,2887,118,20,186,206,24.26050420168067,52.8664504564191
Task_6075,1740,177,152,18,170,9.775280898876405,33.83571734717394
Task_6076,2147,951,60,137,197,2.255252100840336,44.536687163624094
Task_6077,1161,532,85,54,139,2.178236397748593,26.35880373815456
Task_6078,677,903,62,34,96,0.7488938053097345,19.196078317216955
Task_6079,1248,100,200,79,279,12.356435643564357,26.750812277344792
Task_6080,2161,271,186,44,230,7.944852941176471,41.75492955006133
Task_6081,757,382,176,81,257,1.9765013054830287,20.479103595812457
Task_6082,800,500,186,39,225,1.596806387225549,20.944337975902695
Task_6083,2082,630,168,50,218,3.299524564183835,41.704311821039596
Task_6084,2793,808,141,45,186,3.452410383189122,53.14124334145142
Task_6085,1408,613,184,174,358,2.2931596091205213,32.42589357884646
Task_6086,2887,69,48,91,139,41.24285714285714,51.466817283698866
Task_6087,2193,777,188,64,252,2.8187660668380463,44.28005872220825
Task_6088,1855,928,122,147,269,1.9967707212055974,40.049272645264914
Task_6089,2340,430,46,19,65,5.4292343387471,43.203770742816175
Task_6090,686,168,89,120,209,4.059171597633136,18.60233723905719
Task_6091,2894,889,89,154,243,3.251685393258427,56.32387242088797
Task_6092,783,642,161,51,212,1.2177293934681181,21.287166638619826
Task_6093,1567,99,18,129,147,15.67,30.954720056940662
Task_6094,965,545,149,58,207,1.7673992673992673,23.825343043182865
Task_6095,901,543,115,77,192,1.65625,22.928810490602263
Task_6096,2061,723,104,10,114,2.846685082872928,40.64703634191459
Task_6097,2974,376,46,148,194,7.888594164456234,55.707052326696406
Task_6098,2982,285,180,50,230,10.426573426573427,54.86165491278917
Task_6099,553,700,163,89,252,0.7888730385164051,18.326067432508555
Task_6100,1232,455,63,30,93,2.7017543859649122,26.498067359513673
Task_6101,811,149,127,49,176,5.406666666666666,19.370730587000363
Task_6102,502,297,76,62,138,1.6845637583892616,15.309362120141003
Task_6103,2250,863,114,55,169,2.6041666666666665,44.9022352593578
Task_6104,1012,118,96,186,282,8.504201680672269,23.826885695519987
Task_6105,766,906,139,151,290,0.844542447629548,22.74143452454386
Task_6106,2134,959,97,114,211,2.222916666666667,44.280664694670726
Task_6107,1887,723,58,195,253,2.606353591160221,40.06961644198854
Task_6108,1404,317,97,14,111,4.415094339622642,28.90230490596026
Task_6109,529,891,36,174,210,0.5930493273542601,18.691301965437937
Task_6110,1868,913,43,59,102,2.0437636761487963,38.333893352423694
Task_6111,2334,225,181,198,379,10.327433628318584,45.924886416349004
Task_6112,904,815,121,130,251,1.107843137254902,24.365212083154905
Task_6113,1493,759,84,153,237,1.9644736842105264,33.699596725344755
Task_6114,629,515,153,78,231,1.2189922480620154,18.716683937314613
Task_6115,1724,416,78,65,143,4.134292565947242,35.109270458410386
Task_6116,2613,581,81,125,206,4.489690721649485,50.75431463734285
Task_6117,2021,953,151,44,195,2.1184486373165616,41.56557386219329
Task_6118,762,79,158,41,199,9.525,18.13353370633717
Task_6119,2097,615,62,151,213,3.404220779220779,42.784748557838014
Task_6120,2900,874,117,167,284,3.3142857142857145,56.53597657434589
Task_6121,1422,164,132,99,231,8.618181818181819,30.18063306039277
Task_6122,1694,828,58,79,137,2.0434258142340167,36.19685311521292
Task_6123,696,130,150,169,319,5.312977099236641,19.01382008805316
Task_6124,1432,316,187,91,278,4.517350157728707,31.229817710150602
Task_6125,2565,309,37,84,121,8.274193548387096,48.148810630515875
Task_6126,1225,694,140,64,204,1.7625899280575539,28.46119317048012
Task_6127,2432,938,52,146,198,2.589989350372737,49.07183761301487
Task_6128,2676,462,170,166,336,5.779697624190065,51.90972175036418
Task_6129,2263,72,194,112,306,31.0,42.85516903301879
Task_6130,708,815,28,47,75,0.8676470588235294,18.943231052855317
Task_6131,803,632,150,18,168,1.268562401263823,20.658976724691737
Task_6132,2729,123,185,42,227,22.008064516129032,49.74027632378368
Task_6133,2369,906,174,98,272,2.6119073869900773,48.07037696058768
Task_6134,1055,106,35,101,136,9.85981308411215,22.86856942589007
Task_6135,821,144,138,113,251,5.662068965517242,20.773821718131995
Task_6136,1559,228,48,150,198,6.807860262008734,32.933057999500754
Task_6137,730,944,40,35,75,0.7724867724867724,19.68352611400694
Task_6138,2799,220,147,34,181,12.665158371040723,51.26674513967023
Task_6139,1217,165,64,108,172,7.331325301204819,26.69773863642996
Task_6140,2014,68,92,79,171,29.18840579710145,37.90119319888431
Task_6141,2397,91,11,79,90,26.054347826086957,43.2883987513473
Task_6142,2205,527,11,107,118,4.176136363636363,43.29568752711496
Task_6143,1950,429,49,12,61,4.534883720930233,37.10063282357291
Task_6144,709,69,174,124,298,10.128571428571428,18.518921387635384
Task_6145,2767,596,165,85,250,4.634840871021775,53.00224328965916
Task_6146,1626,889,164,197,361,1.8269662921348315,36.78737444020016
Task_6147,1846,581,192,88,280,3.1718213058419242,38.531968597744736
Task_6148,2103,659,16,72,88,3.1863636363636365,41.38102988278758
Task_6149,574,708,14,26,40,0.8095909732016925,16.444209957771676
Task_6150,1093,483,50,143,193,2.2582644628099175,26.43023336594284
Task_6151,2338,442,155,50,205,5.27765237020316,45.09726342794491
Task_6152,893,927,35,115,150,0.9622844827586207,23.761613134268675
Task_6153,2364,88,170,10,180,26.56179775280899,42.99067997181169
Task_6154,1860,724,128,72,200,2.56551724137931,38.655311214128275
Task_6155,2158,860,64,131,195,2.506387921022067,44.40954967006953
Task_6156,1587,493,156,49,205,3.2125506072874495,33.38489117488
Task_6157,1380,764,91,41,132,1.803921568627451,30.348674972745254
Task_6158,1370,598,178,198,376,2.287145242070117,31.893380187956183
Task_6159,1472,857,192,120,312,1.7156177156177157,33.90070011388324
Task_6160,2794,624,84,198,282,4.4704,54.151208706330046
Task_6161,2525,286,66,184,250,8.797909407665506,48.68706940566582
Task_6162,2862,133,43,38,81,21.35820895522388,50.77383939503829
Task_6163,2756,939,196,165,361,2.931914893617021,54.80177313280109
Task_6164,2646,416,185,48,233,6.345323741007194,49.95736840937221
Task_6165,1298,669,117,148,265,1.9373134328358208,30.401544976184947
Task_6166,1616,614,26,130,156,2.627642276422764,34.47516435745427
Task_6167,1953,145,187,97,284,13.376712328767123,38.7229056475016
Task_6168,2910,795,87,116,203,3.6557788944723617,56.01495883781849
Task_6169,863,172,124,20,144,4.988439306358382,19.834421902802347
Task_6170,1028,567,163,175,338,1.8098591549295775,26.175504083946702
Task_6171,2196,496,99,37,136,4.41851106639839,42.42127102381108
Task_6172,647,992,111,169,280,0.6515609264853978,21.25104723608862
Task_6173,2679,82,139,169,308,32.27710843373494,49.564925654779245
Task_6174,2997,240,110,104,214,12.435684647302905,55.573382007812675
Task_6175,1121,377,22,154,176,2.9656084656084656,26.10418093473937
Task_6176,2517,213,81,26,107,11.761682242990654,46.157602712856566
Task_6177,2323,128,100,166,266,18.007751937984494,44.35997555531828
Task_6178,859,874,163,34,197,0.9817142857142858,23.02767176392037
Task_6179,1575,901,110,66,176,1.746119733924612,34.33608098849066
Task_6180,578,818,69,98,167,0.7057387057387058,18.903558422085112
Task_6181,946,798,76,188,264,1.183979974968711,25.328714288477425
Task_6182,1835,455,42,40,82,4.024122807017544,36.00426901080035
Task_6183,1720,718,24,119,143,2.39221140472879,36.39119666730781
Task_6184,2185,130,189,92,281,16.6793893129771,42.03958762426725
Task_6185,1514,516,162,187,349,2.9284332688588006,33.77752137711989
Task_6186,2194,1001,139,188,327,2.189620758483034,45.96973446340932
Task_6187,1866,943,16,80,96,1.9766949152542372,38.677847685230816
Task_6188,2802,328,129,18,147,8.516717325227964,51.218208172751254
Task_6189,2708,742,89,52,141,3.6446837146702555,51.598096111988944
Task_6190,2150,796,176,199,375,2.697616060225847,44.86577455202994
Task_6191,1526,80,36,140,176,18.839506172839506,30.79938318273538
Task_6192,1878,442,70,42,112,4.239277652370204,36.96172269546954
Task_6193,2212,957,39,65,104,2.3089770354906056,44.17072521562361
Task_6194,1153,270,98,35,133,4.254612546125461,25.207536847536563
Task_6195,1502,99,142,98,240,15.02,30.83554608423516
Task_6196,596,252,76,29,105,2.355731225296443,15.985520039430115
Task_6197,2231,187,163,133,296,11.867021276595745,43.7861910125911
Task_6198,619,261,78,167,245,2.3625954198473282,18.437674483469888
Task_6199,2021,789,179,57,236,2.5582278481012657,41.46563606066539
Task_6200,1602,168,65,99,164,9.479289940828401,32.699239415490965
Task_6201,1447,137,194,88,282,10.485507246376812,30.467234659400926
Task_6202,2258,806,175,99,274,2.798017348203222,45.99152621774883
Task_6203,1721,337,81,196,277,5.091715976331361,36.26891789233376
Task_6204,2059,532,156,113,269,3.8630393996247654,41.98818243096635
Task_6205,1301,579,21,142,163,2.2431034482758623,29.510003675279233
Task_6206,1500,115,143,160,303,12.931034482758621,31.428631448019576
Task_6207,1028,561,130,190,320,1.8291814946619218,26.097608539050054
Task_6208,2637,891,68,188,256,2.9562780269058297,52.44878982859746
Task_6209,755,161,133,147,280,4.660493827160494,19.95925680446607
Task_6210,1757,408,64,122,186,4.295843520782396,36.44661295034381
Task_6211,2166,79,97,52,149,27.075,39.94043329998271
Task_6212,1277,691,65,190,255,1.8453757225433527,30.27935692369306
Task_6213,2469,484,32,29,61,5.090721649484536,45.7249572725055
Task_6214,1464,697,17,112,129,2.097421203438395,32.18456807389371
Task_6215,1897,670,139,188,327,2.827123695976155,40.230485422864454
Task_6216,1821,88,60,44,104,20.46067415730337,33.59034084116997
Task_6217,2029,427,141,182,323,4.740654205607477,41.520089690948474
Task_6218,2132,726,44,123,167,2.9325997248968365,43.13569364956425
Task_6219,1728,905,109,39,148,1.9072847682119205,36.27112806069512
Task_6220,1360,275,38,100,138,4.927536231884058,29.168238151345196
Task_6221,651,788,138,114,252,0.8250950570342205,20.32911397775138
Task_6222,1901,403,123,200,323,4.705445544554456,39.442784951915094
Task_6223,1647,612,21,83,104,2.686786296900489,34.30370380382758
Task_6224,1414,872,191,181,372,1.6197021764032073,33.388144779363394
Task_6225,519,276,171,37,208,1.8736462093862816,15.753028910320126
Task_6226,2798,283,71,133,204,9.852112676056338,52.71403199203021
Task_6227,2155,324,93,28,121,6.630769230769231,41.127010619630035
Task_6228,1752,479,100,45,145,3.65,35.36020784233845
Task_6229,644,878,140,194,334,0.732650739476678,21.00557835148296
Task_6230,1158,634,49,71,120,1.8236220472440945,26.847212542566776
Task_6231,647,775,68,153,221,0.8337628865979382,20.21487264712914
Task_6232,2010,635,47,54,101,3.160377358490566,39.76107765349644
Task_6233,2459,871,140,138,278,2.819954128440367,49.46949726462257
Task_6234,1998,513,173,142,315,3.88715953307393,41.21157644850641
Task_6235,1911,921,145,130,275,2.0726681127982647,40.916987014723446
Task_6236,2383,888,165,26,191,2.6805399325084363,47.05496712294402
Task_6237,2986,999,136,57,193,2.986,57.21851340112752
Task_6238,1707,943,48,161,209,1.8082627118644068,37.624102280131495
Task_6239,1288,279,92,185,277,4.6,29.187414285482816
Task_6240,1041,419,183,33,216,2.4785714285714286,24.487363748124377
Task_6241,2312,907,101,18,119,2.5462555066079293,45.04341180954962
Task_6242,2392,853,181,11,192,2.800936768149883,46.987128510219044
Task_6243,2784,236,62,65,127,11.746835443037975,51.21643795508078
Task_6244,2121,924,170,106,276,2.292972972972973,44.22325239818186
Task_6245,715,264,120,157,277,2.69811320754717,19.963297615625876
Task_6246,2261,488,103,47,150,4.623721881390593,43.408059752779444
Task_6247,654,397,84,91,175,1.64321608040201,18.68036347759422
Task_6248,1823,404,130,181,311,4.501234567901235,38.12984248585857
Task_6249,2153,521,43,126,169,4.124521072796935,42.83513272359028
Task_6250,2822,289,127,21,148,9.73103448275862,51.54231704722637
Task_6251,1758,211,118,80,198,8.29245283018868,35.502928264255495
Task_6252,1562,353,55,131,186,4.4124293785310735,33.22627072722985
Task_6253,2000,377,51,28,79,5.291005291005291,38.072904517303236
Task_6254,2341,993,175,59,234,2.3551307847082494,47.14027207939139
Task_6255,2210,756,182,164,346,2.919418758256275,45.50901998591957
Task_6256,677,951,140,135,275,0.7111344537815126,21.495984624607683
Task_6257,680,894,79,77,156,0.7597765363128491,20.22797771827305
Task_6258,1290,297,59,80,139,4.328859060402684,28.106941715560357
Task_6259,625,739,91,92,183,0.8445945945945946,19.141625006998915
Task_6260,2612,284,169,21,190,9.164912280701754,48.63618894046619
Task_6261,1155,1004,36,46,82,1.1492537313432836,27.034656610152272
Task_6262,1772,99,55,66,121,17.72,33.745999582020396
Task_6263,1479,106,197,191,388,13.822429906542055,31.29374604177921
Task_6264,2124,395,191,12,203,5.363636363636363,41.343036298600545
Task_6265,1853,99,94,167,261,18.53,36.5937451866618
Task_6266,1610,449,65,172,237,3.577777777777778,34.68261593064186
Task_6267,869,349,87,48,135,2.4828571428571427,20.93330239554005
Task_6268,2401,406,108,91,199,5.899262899262899,46.49981720452555
Task_6269,530,895,46,131,177,0.5915178571428571,18.345208182341036
Task_6270,2623,974,115,14,129,2.6902564102564104,50.51797261001459
Task_6271,734,691,198,96,294,1.060693641618497,21.477665734304036
Task_6272,2140,1006,171,16,187,2.125124131082423,43.38262160689239
Task_6273,657,878,190,137,327,0.7474402730375427,21.043891880902606
Task_6274,1258,437,150,129,279,2.872146118721461,29.07406186226827
Task_6275,1282,735,149,133,282,1.7418478260869565,30.39500219724953
Task_6276,1504,709,32,105,137,2.1183098591549294,32.89849785630083
Task_6277,776,766,151,112,263,1.0117340286831813,22.225656907248492
Task_6278,1093,871,127,60,187,1.253440366972477,26.688824503879488
Task_6279,2691,553,51,181,232,4.85740072202166,52.191230397169335
Task_6280,1972,646,164,29,193,3.047913446676971,39.84908926197664
Task_6281,999,185,189,37,226,5.370967741935484,23.145452208307177
Task_6282,2914,323,55,43,98,8.993827160493828,52.6667014415282
Task_6283,854,588,108,118,226,1.4499151103565364,22.828950845722556
Task_6284,1494,191,103,132,235,7.78125,31.779745202887725
Task_6285,2001,655,146,79,225,3.0503048780487805,40.918239098331064
Task_6286,1834,703,115,146,261,2.6051136363636362,38.977081383202
Task_6287,704,690,64,39,103,1.0188133140376265,18.878748281624326
Task_6288,2527,557,76,146,222,4.528673835125448,49.45310609615288
Task_6289,740,268,56,97,153,2.7509293680297398,19.59344035462105
Task_6290,2200,419,92,70,162,5.238095238095238,42.68178201229503
Task_6291,1907,599,178,75,253,3.1783333333333332,39.301823002076574
Task_6292,1786,114,60,156,216,15.530434782608696,35.59799595678597
Task_6293,779,691,198,108,306,1.1257225433526012,22.216369197644763
Task_6294,2220,199,143,178,321,11.1,43.74982266898115
Task_6295,2964,91,176,115,291,32.21739130434783,54.00863242494986
Task_6296,1833,436,128,32,160,4.194508009153318,36.54910154940614
Task_6297,1344,995,37,16,53,1.3493975903614457,29.33792593833707
Task_6298,1593,833,173,49,222,1.910071942446043,34.622842259782466
Task_6299,983,161,106,26,132,6.067901234567901,21.769492423459088
Task_6300,829,876,156,165,321,0.9452679589509693,23.822820939334846
Task_6301,585,719,140,159,299,0.8125,19.364014960909838
Task_6302,1548,599,99,91,190,2.58,33.564233618703035
Task_6303,700,615,29,196,225,1.1363636363636365,20.549099697090487
Task_6304,556,461,99,31,130,1.2034632034632036,16.363413634527713
Task_6305,2159,952,80,80,160,2.265477439664218,43.90111137172994
Task_6306,554,436,101,121,222,1.2677345537757436,17.554300968803265
Task_6307,2486,163,50,109,159,15.158536585365853,46.379468364980916
Task_6308,1577,488,119,142,261,3.224948875255624,34.22350808787937
Task_6309,554,673,155,147,302,0.8219584569732937,18.710527589880968
Task_6310,2689,528,70,20,90,5.083175803402646,49.656285903574656
Task_6311,2900,812,84,33,117,3.5670356703567037,54.33698004136151
Task_6312,583,119,114,129,243,4.858333333333333,16.784947386393977
Task_6313,1829,975,26,48,74,1.8739754098360655,37.18072199459679
Task_6314,1825,190,200,150,350,9.55497382198953,37.561800045528315
Task_6315,2584,323,141,102,243,7.9753086419753085,49.47531781655787
Task_6316,1318,613,131,122,253,2.1465798045602607,30.4510831822346
Task_6317,2654,223,159,18,177,11.848214285714286,48.68758375960572
Task_6318,1185,156,176,182,358,7.547770700636943,27.134712273007526
Task_6319,2504,384,70,178,248,6.503896103896104,48.69143780393929
Task_6320,1678,767,165,50,215,2.1848958333333335,35.72111432831065
Task_6321,1840,764,151,72,223,2.4052287581699345,38.56725931027247
Task_6322,1428,298,177,149,326,4.775919732441472,31.55442393371599
Task_6323,855,686,69,74,143,1.244541484716157,22.276400767278222
Task_6324,785,911,181,158,339,0.8607456140350878,23.297476533014883
Task_6325,2236,613,121,126,247,3.6416938110749184,44.96838943863852
Task_6326,1773,876,116,128,244,2.0216647662485747,38.447682093926964
Task_6327,1633,855,80,51,131,1.9077102803738317,34.95959239141785
Task_6328,1207,242,63,130,193,4.967078189300412,27.374212835430757
Task_6329,2188,819,162,157,319,2.6682926829268294,45.225793080561196
Task_6330,2360,1009,181,168,349,2.3366336633663365,48.69508097652315
Task_6331,2195,544,53,175,228,4.027522935779817,44.25572953137843
Task_6332,2600,308,123,10,133,8.414239482200648,48.05207215202838
Task_6333,1943,126,177,79,256,15.299212598425196,37.98331576813689
Task_6334,2357,624,54,130,184,3.7712,46.62680157529573
Task_6335,803,222,110,129,239,3.600896860986547,21.00352575080296
Task_6336,1919,349,165,189,354,5.482857142857143,39.67359562819202
Task_6337,1673,328,88,13,101,5.085106382978723,33.09258420023481
Task_6338,1971,564,55,51,106,3.488495575221239,38.906666315571755
Task_6339,1476,939,66,31,97,1.5702127659574467,31.96843901173973
Task_6340,1528,659,92,84,176,2.315151515151515,33.12032563096484
Task_6341,1521,157,18,46,64,9.626582278481013,29.61976060444749
Task_6342,2926,571,89,59,148,5.115384615384615,54.46413634013598
Task_6343,2152,631,117,154,271,3.4050632911392404,43.844214768747456
Task_6344,2799,623,76,31,107,4.485576923076923,52.067867925451715
Task_6345,2832,490,184,171,355,5.767820773930754,54.56357712089042
Task_6346,534,854,200,47,247,0.624561403508772,18.34140807658096
Task_6347,961,947,184,62,246,1.0137130801687764,25.09400053634617
Task_6348,1560,151,123,94,217,10.263157894736842,32.15204941900202
Task_6349,988,387,91,111,202,2.5463917525773194,24.31830029183708
Task_6350,1912,996,102,169,271,1.917753259779338,41.20508813503084
Task_6351,1661,424,63,138,201,3.908235294117647,35.20009508183353
Task_6352,2988,638,156,95,251,4.676056338028169,56.90224460336754
Task_6353,1492,169,81,150,231,8.776470588235295,31.502460922281596
Task_6354,1014,178,159,163,322,5.664804469273743,24.217996218859977
Task_6355,2968,277,170,166,336,10.676258992805755,55.89560187365354
Task_6356,2293,310,32,40,72,7.372990353697749,42.38606619834655
Task_6357,2210,668,141,21,162,3.303437967115097,43.186266895692604
Task_6358,2484,682,58,40,98,3.636896046852123,47.01737942579431
Task_6359,2890,654,86,97,183,4.412213740458015,55.027681899918385
Task_6360,1274,987,74,165,239,1.2894736842105263,30.948751563686333
Task_6361,956,969,11,190,201,0.9855670103092784,25.553059537568476
Task_6362,2524,820,94,182,276,3.074299634591961,50.479001177641685
Task_6363,2787,560,19,96,115,4.967914438502674,52.57444967631785
Task_6364,2141,182,142,133,275,11.699453551912569,41.98220620413893
Task_6365,1312,114,31,162,193,11.408695652173913,27.93633019414875
Task_6366,1282,925,126,171,297,1.3844492440604752,31.053325509843678
Task_6367,2218,298,61,94,155,7.418060200668896,42.9774165985512
Task_6368,1134,795,118,21,139,1.4246231155778895,26.38222566412917
Task_6369,821,436,165,159,324,1.8787185354691076,22.40139096837
Task_6370,2460,724,174,71,245,3.393103448275862,48.34148770560713
Task_6371,1867,138,101,190,291,13.431654676258994,37.448211278146196
Task_6372,856,228,192,51,243,3.7379912663755457,21.29782515661036
Task_6373,2021,565,74,185,259,3.570671378091873,41.68378189016453
Task_6374,2107,521,83,92,175,4.03639846743295,42.14396133038258
Task_6375,569,697,146,153,299,0.8151862464183381,19.03371338394316
Task_6376,1358,351,88,65,153,3.8579545454545454,28.920601852465026
Task_6377,2914,872,135,131,266,3.3379152348224514,56.6176329368162
Task_6378,2356,324,156,75,231,7.24923076923077,45.41521361791812
Task_6379,1231,576,39,136,175,2.1334488734835357,28.57350254804517
Task_6380,1370,853,13,139,152,1.604215456674473,31.29509512140942
Task_6381,2342,312,54,99,153,7.482428115015974,44.995087021026656
Task_6382,2034,696,80,169,249,2.9182209469153517,42.23009961631781
Task_6383,1668,251,74,39,113,6.619047619047619,33.08326146573024
Task_6384,2237,879,134,151,285,2.5420454545454545,46.027546977732534
Task_6385,1870,662,100,145,245,2.8205128205128207,39.34507808499348
Task_6386,2403,136,22,129,151,17.54014598540146,44.561283393022244
Task_6387,2668,203,84,84,168,13.07843137254902,49.55994412324543
Task_6388,946,897,78,115,193,1.0534521158129175,25.10558831539791
Task_6389,2142,575,28,197,225,3.71875,43.4050919539005
Task_6390,2478,224,168,77,245,11.013333333333334,47.05530659660227
Task_6391,1779,850,88,181,269,2.09048178613396,38.671803237317626
Task_6392,2308,234,95,150,245,9.821276595744681,44.94392575247457
Task_6393,2830,475,55,141,196,5.945378151260504,53.88100117422089
Task_6394,2170,374,114,118,232,5.786666666666667,43.07331303565845
Task_6395,2660,76,36,92,128,34.54545454545455,47.983285218460416
Task_6396,1657,146,41,77,118,11.272108843537415,32.4533355106744
Task_6397,1601,750,85,123,208,2.131824234354194,35.207780483591826
Task_6398,2700,322,35,75,110,8.359133126934985,50.13908149233555
Task_6399,961,121,119,172,291,7.877049180327869,23.026810724959933
Task_6400,673,308,169,24,193,2.177993527508091,18.136968984550638
Task_6401,1273,892,106,141,247,1.425531914893617,30.539132170117096
Task_6402,2526,668,121,85,206,3.7757847533632285,49.21596089776488
Task_6403,1585,452,20,75,95,3.498896247240618,32.61382182448185
Task_6404,2663,97,17,192,209,27.1734693877551,48.885893722491666
Task_6405,542,965,184,75,259,0.5610766045548654,19.008057188560937
Task_6406,748,481,80,176,256,1.5518672199170125,21.19355806492852
Task_6407,818,168,152,129,281,4.840236686390533,20.981414937693355
Task_6408,2388,178,48,196,244,13.340782122905027,45.67602638599095
Task_6409,2474,702,59,29,88,3.519203413940256,46.86136229447124
Task_6410,1225,792,126,178,304,1.544766708701135,29.805053325971443
Task_6411,648,273,170,147,317,2.3649635036496353,19.09903974981193
Task_6412,1826,842,151,24,175,2.166073546856465,37.91899837557836
Task_6413,1141,392,115,91,206,2.9033078880407124,26.54838749480666
Task_6414,1848,287,139,64,203,6.416666666666667,37.022946269681455
Task_6415,1264,907,160,34,194,1.3920704845814977,29.44051705141925
Task_6416,1907,415,57,124,181,4.584134615384615,38.80170965295132
Task_6417,586,296,141,73,214,1.973063973063973,17.21288368411238
Task_6418,2223,866,44,84,128,2.56401384083045,44.73128076328057
Task_6419,1584,987,94,163,257,1.6032388663967612,35.97784125579428
Task_6420,1628,475,140,51,191,3.4201680672268906,34.0741539499196
Task_6421,1515,473,151,158,309,3.1962025316455698,33.43413087900206
Task_6422,1729,339,166,135,301,5.0852941176470585,36.317140957771606
Task_6423,1278,374,10,64,74,3.408,26.869929032145777
Task_6424,2103,776,99,57,156,2.7065637065637067,42.08230345438589
Task_6425,2372,394,13,172,185,6.0050632911392405,46.13264383687859
Task_6426,1151,944,163,29,192,1.217989417989418,27.755969378406263
Task_6427,1619,580,180,109,289,2.7865748709122204,35.25740962175912
Task_6428,1910,348,151,184,335,5.472779369627507,39.43495015468078
Task_6429,2706,427,22,38,60,6.322429906542056,49.27581850309727
Task_6430,2400,996,47,29,76,2.407221664994985,46.234789667587506
Task_6431,1178,197,66,140,206,5.94949494949495,26.876429352248707
Task_6432,1350,631,132,188,320,2.1360759493670884,31.41293784524231
Task_6433,527,520,156,75,231,1.0115163147792707,16.99687662163165
Task_6434,1999,413,12,134,146,4.828502415458937,39.84212695750425
Task_6435,1156,428,24,92,116,2.6946386946386944,26.38165703691099
Task_6436,1924,229,198,81,279,8.365217391304348,38.51898550163913
Task_6437,1501,76,155,18,173,19.493506493506494,29.250517209399238
Task_6438,2852,376,65,181,246,7.56498673740053,54.15065232691372
Task_6439,1382,1008,61,141,202,1.3696729435084243,32.54450078685143
Task_6440,1172,120,129,98,227,9.685950413223141,25.93720071058536
Task_6441,1680,82,71,26,97,20.240963855421686,31.520162361514725
Task_6442,2475,351,154,112,266,7.03125,47.96557307829196
Task_6443,1757,964,17,177,194,1.8207253886010362,38.25193691096865
Task_6444,1697,659,56,131,187,2.5712121212121213,36.434955863554585
Task_6445,1684,79,39,41,80,21.05,31.533540808224767
Task_6446,2210,122,186,80,266,17.96747967479675,42.21498419628602
Task_6447,2695,443,26,140,166,6.06981981981982,51.21384705774373
Task_6448,1962,646,189,165,354,3.0324574961360122,41.272497464761635
Task_6449,1472,743,66,67,133,1.978494623655914,32.20223118464303
Task_6450,582,995,166,117,283,0.5843373493975904,20.17150964355567
Task_6451,1837,937,120,65,185,1.9584221748400852,38.70284775776475
Task_6452,2736,119,19,16,35,22.8,47.95851387141425
Task_6453,1127,561,93,66,159,2.005338078291815,26.066163929993532
Task_6454,2843,905,94,133,227,3.1379690949227372,55.506959641677604
Task_6455,572,914,93,170,263,0.6251366120218579,19.978020887841456
Task_6456,1760,488,10,166,176,3.5991820040899793,36.62203289708817
Task_6457,1804,239,126,151,277,7.516666666666667,37.076309422115884
Task_6458,2360,90,97,199,296,25.934065934065934,44.684403390849404
Task_6459,2648,545,33,103,136,4.8498168498168495,50.50267470033929
Task_6460,507,461,190,155,345,1.0974025974025974,17.453977579525944
Task_6461,2276,256,108,94,202,8.85603112840467,44.11759684421005
Task_6462,877,254,52,31,83,3.43921568627451,20.173864926596554
Task_6463,913,937,84,70,154,0.9733475479744137,23.788970107898976
Task_6464,605,1003,41,113,154,0.602589641434263,19.665325574694823
Task_6465,2695,786,140,99,239,3.4243964421855146,52.694439648961804
Task_6466,827,597,109,120,229,1.382943143812709,22.44580430376523
Task_6467,1987,245,14,39,53,8.077235772357724,37.34908631849884
Task_6468,1280,427,78,141,219,2.9906542056074765,29.26830332020597
Task_6469,1020,554,80,50,130,1.837837837837838,24.093280856017202
Task_6470,1690,152,148,127,275,11.045751633986928,34.59146126203786
Task_6471,2345,839,115,192,307,2.7916666666666665,47.77303617924505
Task_6472,2947,814,97,160,257,3.6159509202453988,56.983984418499766
Task_6473,1263,437,132,27,159,2.8835616438356166,27.466256171634228
Task_6474,1124,176,43,94,137,6.350282485875706,24.540290152582713
Task_6475,681,834,182,63,245,0.8155688622754491,20.488797236382343
Task_6476,742,949,80,170,250,0.7810526315789473,22.459471374879964
Task_6477,1427,665,70,195,265,2.1426426426426426,32.64163525077888
Task_6478,2822,718,176,99,275,3.924895688456189,54.65425651875622
Task_6479,2504,296,112,97,209,8.43097643097643,47.98912084718404
Task_6480,637,841,189,41,230,0.7565320665083135,19.482597034553564
Task_6481,2861,793,154,66,220,3.6032745591939546,54.76442501026556
Task_6482,1835,432,61,152,213,4.237875288683603,38.05423827260055
Task_6483,1811,376,113,58,171,4.803713527851459,36.31114896096769
Task_6484,1968,360,74,198,272,5.4515235457063715,40.260626463333885
Task_6485,1368,201,109,166,275,6.772277227722772,30.067968656211093
Task_6486,1831,502,38,111,149,3.640159045725646,37.44117775083887
Task_6487,838,465,199,102,301,1.798283261802575,22.574293336205006
Task_6488,1466,415,78,101,179,3.5240384615384617,31.752808995611257
Task_6489,1806,291,125,69,194,6.184931506849315,36.32241637777357
Task_6490,2503,773,180,160,340,3.2338501291989665,50.171238061400096
Task_6491,2697,141,35,39,74,18.992957746478872,47.96251791081099
Task_6492,2673,898,137,198,335,2.9733036707452727,53.28960953023236
Task_6493,1513,928,71,82,153,1.6286329386437028,33.566373688564546
Task_6494,1606,177,143,25,168,9.02247191011236,31.815624612157418
Task_6495,2908,371,109,112,221,7.817204301075269,54.68046964886562
Task_6496,781,448,55,90,145,1.7394209354120267,20.6718096900662
Task_6497,1772,680,135,86,221,2.6020558002936856,37.39058417453637
Task_6498,2347,651,141,176,317,3.5996932515337425,47.23547450779764
Task_6499,2138,985,109,26,135,2.1683569979716024,42.99226746173608
Task_6500,1812,747,129,53,182,2.4224598930481283,37.68566576429229
Task_6501,2712,351,140,157,297,7.704545454545454,51.92013387335692
Task_6502,596,773,135,85,220,0.7700258397932817,19.0004826504425
Task_6503,1171,864,89,189,278,1.353757225433526,29.099294419592738
Task_6504,1172,138,90,195,285,8.431654676258994,26.501094825920546
Task_6505,787,518,137,47,184,1.5163776493256262,20.448452290774426
Task_6506,2651,886,16,12,28,2.988726042841037,49.450560803126685
Task_6507,2893,92,192,188,380,31.107526881720432,53.401278311631664
Task_6508,2975,1007,33,167,200,2.951388888888889,57.809685755451746
Task_6509,1758,67,35,179,214,25.852941176470587,34.65140307174991
Task_6510,505,229,104,99,203,2.1956521739130435,16.099043524574284
Task_6511,2313,484,101,176,277,4.7690721649484535,45.98384884379885
Task_6512,2712,309,121,26,147,8.748387096774193,49.96097149203069
Task_6513,862,961,95,178,273,0.896049896049896,24.479282321586364
Task_6514,2870,141,100,172,272,20.211267605633804,53.16397925558234
Task_6515,1940,743,55,123,178,2.60752688172043,40.3506410263807
Task_6516,2105,108,36,99,135,19.31192660550459,39.40892911111527
Task_6517,516,546,149,52,201,0.943327239488117,16.873464623601514
Task_6518,1409,298,29,181,210,4.712374581939799,30.81908023838096
Task_6519,1028,392,98,155,253,2.6157760814249365,25.226108080036113
Task_6520,1275,177,115,107,222,7.162921348314606,27.778070906429758
Task_6521,2275,647,43,14,57,3.5108024691358026,42.94940723674307
Task_6522,2902,399,113,131,244,7.255,54.811771415755096
Task_6523,962,230,61,111,172,4.1645021645021645,23.269481831907715
Task_6524,2030,124,93,146,239,16.24,39.67481235255132
Task_6525,936,696,83,98,181,1.3428981348637017,24.117470229005523
Task_6526,1827,502,91,74,165,3.63220675944334,37.32041285977268
Task_6527,2858,726,97,147,244,3.931224209078404,55.21894715549373
Task_6528,2416,373,98,50,148,6.459893048128342,45.579048495869955
Task_6529,2438,146,41,128,169,16.58503401360544,45.51552511952843
Task_6530,1569,116,104,132,236,13.41025641025641,32.175674406037096
Task_6531,2112,578,76,71,147,3.6476683937823835,41.84908268326223
Task_6532,1321,152,79,185,264,8.633986928104575,28.948357427610773
Task_6533,960,419,87,148,235,2.2857142857142856,24.138895828956674
Task_6534,1231,1002,47,48,95,1.2273180458624127,28.314116947655247
Task_6535,992,158,152,71,223,6.238993710691824,22.945296634984995
Task_6536,814,939,171,123,294,0.8659574468085106,23.589402559250733
Task_6537,1932,1009,23,108,131,1.9128712871287128,40.6964720427628
Task_6538,1280,820,26,133,159,1.5590742996345919,29.76318459860664
Task_6539,1504,72,46,37,83,20.602739726027398,28.52181896487838
Task_6540,2456,308,105,19,124,7.948220064724919,45.53561741882101
Task_6541,1282,576,165,155,320,2.221837088388215,30.115395568145086
Task_6542,2487,93,190,166,356,26.45744680851064,46.840855857298884
Task_6543,2098,430,77,76,153,4.867749419953596,41.15675167433635
Task_6544,2792,681,199,64,263,4.093841642228739,53.51611995296196
Task_6545,2661,664,130,107,237,4.001503759398497,51.788326984529625
Task_6546,1392,842,119,19,138,1.6512455516014235,30.487267466694874
Task_6547,2991,548,164,136,300,5.448087431693989,56.96997200149125
Task_6548,1795,1016,146,57,203,1.7649950835791544,38.43252463887982
Task_6549,507,225,62,171,233,2.243362831858407,16.501258061422245
Task_6550,1759,561,159,57,216,3.1298932384341636,36.50924894286211
Task_6551,1141,528,16,106,122,2.156899810964083,26.458054300230476
Task_6552,1887,135,142,158,300,13.875,37.69505456127943
Task_6553,621,483,116,94,210,1.2830578512396693,18.62605696140949
Task_6554,2756,837,191,134,325,3.288782816229117,54.274762940957146
Task_6555,2165,673,75,190,265,3.212166172106825,44.34442487907652
Task_6556,1394,250,112,148,260,5.553784860557769,30.556289427192468
Task_6557,1181,299,131,63,194,3.9366666666666665,26.468525342094836
Task_6558,826,799,199,128,327,1.0325,23.450362676787027
Task_6559,2718,326,70,143,213,8.311926605504587,51.670175511456186
Task_6560,2507,68,124,46,170,36.333333333333336,44.991231503312214
Task_6561,814,361,195,80,275,2.248618784530387,21.43198786720564
Task_6562,960,981,129,80,209,0.9775967413441955,25.36331052240828
Task_6563,635,226,43,85,128,2.797356828193833,17.589646266049588
Task_6564,2619,229,162,191,353,11.38695652173913,50.31395151126244
Task_6565,1699,713,93,47,140,2.3795518207282913,35.35031534771888
Task_6566,1870,1021,149,133,282,1.8297455968688845,40.613928562957035
Task_6567,1378,1021,140,94,234,1.3483365949119375,32.44751951640512
Task_6568,1630,983,148,118,266,1.6565040650406504,36.585196603259845
Task_6569,1783,747,55,69,124,2.3836898395721926,37.071827892858565
Task_6570,759,503,138,107,245,1.505952380952381,21.15481655960055
Task_6571,542,735,189,92,281,0.7364130434782609,18.441393900546938
Task_6572,1564,258,38,137,175,6.038610038610039,32.817798749655715
Task_6573,1598,219,74,117,191,7.263636363636364,33.44542349821317
Task_6574,2181,796,136,170,306,2.736511919698871,45.003409437595394
Task_6575,983,671,147,165,312,1.462797619047619,25.58681158191207
Task_6576,1093,398,115,158,273,2.7393483709273183,26.354322027434126
Task_6577,2277,907,76,137,213,2.5077092511013217,46.541877230121145
Task_6578,1700,914,150,179,329,1.8579234972677596,37.86700571176861
Task_6579,1844,991,127,117,244,1.8588709677419355,39.91405200425762
Task_6580,1324,466,116,114,230,2.835117773019272,29.96794065366927
Task_6581,2720,910,184,31,215,2.9857299670691546,52.61624201113289
Task_6582,1320,379,34,98,132,3.473684210526316,28.970611000780746
Task_6583,520,92,59,54,113,5.591397849462366,14.012252991267887
Task_6584,2938,791,29,88,117,3.70959595959596,55.63593752019974
Task_6585,2548,582,23,119,142,4.370497427101201,49.121584524776246
Task_6586,2432,985,49,162,211,2.4665314401622718,49.29136927870459
Task_6587,2334,603,120,22,142,3.8642384105960264,44.86135375367579
Task_6588,1039,344,84,10,94,3.0115942028985505,23.06589949119595
Task_6589,1260,252,44,42,86,4.980237154150197,26.266263170086944
Task_6590,711,454,13,89,102,1.5626373626373626,19.02965782619216
Task_6591,1467,809,65,56,121,1.8111111111111111,32.00114106713115
Task_6592,2808,483,184,179,363,5.801652892561983,54.208593601302404
Task_6593,2771,64,85,66,151,42.63076923076923,49.090608276580475
Task_6594,1223,455,158,129,287,2.682017543859649,28.613272657494402
Task_6595,2936,944,93,62,155,3.106878306878307,55.9114936359286
Task_6596,1791,587,107,36,143,3.045918367346939,36.3031768322302
Task_6597,695,955,41,153,194,0.7269874476987448,21.322333156427067
Task_6598,688,221,17,22,39,3.099099099099099,16.41506306560589
Task_6599,1633,770,191,151,342,2.118028534370947,36.37478902376733
Task_6600,1447,730,21,133,154,1.9794801641586868,32.06023913151644
Task_6601,1103,363,113,59,172,3.03021978021978,25.188253219975312
Task_6602,2646,714,140,35,175,3.7006993006993008,50.58491232969911
Task_6603,735,527,84,157,241,1.3920454545454546,20.925173839985458
Task_6604,1793,384,92,145,237,4.6571428571428575,37.281216511741896
Task_6605,586,840,47,151,198,0.6967895362663495,19.407849913056666
Task_6606,2468,739,200,53,253,3.3351351351351353,48.55348768159903
Task_6607,505,425,85,179,264,1.1854460093896713,17.07647565734064
Task_6608,1726,885,110,101,211,1.9480812641083523,37.54265677616233
Task_6609,1358,873,17,30,47,1.5537757437070938,29.256463534405793
Task_6610,2971,866,93,133,226,3.4267589388696655,57.43656607331821
Task_6611,2272,957,111,111,222,2.37160751565762,46.482730144555525
Task_6612,909,369,67,50,117,2.4567567567567568,21.547476162107255
Task_6613,1256,227,195,124,319,5.508771929824562,28.527935959237468
Task_6614,2573,847,90,40,130,3.0341981132075473,49.504171728494974
Task_6615,1118,640,100,90,190,1.7441497659906395,26.84965312418588
Task_6616,1266,372,16,67,83,3.3941018766756033,27.13851528727345
Task_6617,2822,504,124,96,220,5.588118811881188,53.7560365097549
Task_6618,1748,174,179,19,198,9.98857142857143,34.34236469285296
Task_6619,2087,846,65,138,203,2.4639905548996457,43.28456066213022
Task_6620,1986,685,14,138,152,2.8950437317784257,40.52365559109477
Task_6621,1864,856,91,97,188,2.175029171528588,39.58465392590093
Task_6622,2206,255,70,37,107,8.6171875,41.4707046305103
Task_6623,904,519,88,195,283,1.7384615384615385,23.84964672124022
Task_6624,604,153,69,151,220,3.9220779220779223,17.38383491584681
Task_6625,2183,209,54,169,223,10.395238095238096,42.892824280743504
Task_6626,2080,889,51,22,73,2.337078651685393,40.77343137193155
Task_6627,1526,686,22,174,196,2.2212518195050945,33.762649857649556
Task_6628,1499,387,126,123,249,3.86340206185567,32.583604035927905
Task_6629,1835,907,139,154,293,2.0209251101321586,39.785483686960866
Task_6630,1538,609,37,102,139,2.5213114754098362,33.077100955413705
Task_6631,1556,396,40,158,198,3.9193954659949624,33.348446723693094
Task_6632,1945,493,59,101,160,3.937246963562753,39.37939239471253
Task_6633,2615,798,28,138,166,3.272841051314143,51.07770954247
Task_6634,2082,276,175,61,236,7.516245487364621,40.754365356718914
Task_6635,2786,225,118,63,181,12.327433628318584,51.31693306873844
Task_6636,2014,85,30,108,138,23.41860465116279,37.875677435113666
Task_6637,684,840,19,103,122,0.8133174791914387,20.01051972954008
Task_6638,1471,334,196,167,363,4.391044776119403,32.546446073312104
Task_6639,2909,313,19,191,210,9.264331210191083,54.54185789388645
Task_6640,969,774,148,110,258,1.2503225806451612,25.30599553144562
Task_6641,2462,395,23,131,154,6.217171717171717,47.176749277701084
Task_6642,2537,440,114,156,270,5.752834467120182,49.32543442742775
Task_6643,719,756,105,22,127,0.9498018494055482,19.89792271203061
Task_6644,1472,738,139,95,234,1.9918809201623815,33.12746616086738
Task_6645,1225,415,188,53,241,2.9447115384615383,27.791683526470724
Task_6646,2814,782,124,188,312,3.5938697318007664,55.04141808961083
Task_6647,788,894,176,101,277,0.8804469273743016,22.92947794411549
Task_6648,1708,365,145,127,272,4.666666666666667,35.928142991776994
Task_6649,1067,1015,193,39,232,1.0501968503937007,26.779975487098383
Task_6650,741,604,70,61,131,1.2247933884297522,20.022842445815282
Task_6651,2413,989,190,83,273,2.437373737373737,48.712217346924696
Task_6652,1785,292,30,131,161,6.092150170648464,36.14659949977926
Task_6653,1127,340,119,147,266,3.304985337243402,26.65870109154829
Task_6654,2913,510,98,131,229,5.700587084148728,55.2984148595134
Task_6655,1410,762,85,160,245,1.8479685452162515,32.44036506955721
Task_6656,1989,1006,26,80,106,1.9751737835153922,40.999799362914764
Task_6657,1731,724,33,200,233,2.3875862068965517,37.41203402717399
Task_6658,546,91,124,79,203,5.934782608695652,15.345704483392899
Task_6659,1985,340,40,87,127,5.821114369501466,39.16537748147345
Task_6660,1749,731,63,114,177,2.389344262295082,37.23899163045809
Task_6661,2890,709,87,109,196,4.070422535211268,55.38487697926601
Task_6662,2231,171,171,186,357,12.970930232558139,43.61758103585924
Task_6663,2248,575,93,163,256,3.9027777777777777,45.24452481982371
Task_6664,1935,956,74,18,92,2.0219435736677114,39.17477381855158
Task_6665,1790,221,23,194,217,8.063063063063064,36.67905493551206
Task_6666,1081,586,58,154,212,1.8415672913117547,26.630037237376186
Task_6667,660,286,71,31,102,2.299651567944251,17.067599178665798
Task_6668,1773,375,187,142,329,4.715425531914893,37.26810111725393
Task_6669,2177,962,14,107,121,2.260643821391485,44.29416670272186
Task_6670,851,435,39,194,233,1.951834862385321,22.52663220960736
Task_6671,1916,196,141,140,281,9.725888324873097,38.64235517692365
Task_6672,553,799,116,176,292,0.69125,19.22027173216798
Task_6673,2334,447,128,58,186,5.209821428571429,44.957801206570046
Task_6674,1675,782,153,125,278,2.1392081736909323,36.75103156876567
Task_6675,2095,332,167,165,332,6.291291291291292,42.26609571409005
Task_6676,2925,370,43,78,121,7.884097035040432,54.035346269019385
Task_6677,2019,115,34,73,107,17.405172413793103,37.75929553831711
Task_6678,2434,710,118,185,303,3.423347398030942,48.749856911163285
Task_6679,1561,389,86,110,196,4.0025641025641026,33.35516889014602
Task_6680,2875,219,132,114,246,13.068181818181818,53.72246641372618
Task_6681,2545,773,17,119,136,3.2881136950904395,49.50347127890907
Task_6682,2971,925,78,187,265,3.2084233261339095,57.895144850381264
Task_6683,2952,252,143,193,336,11.66798418972332,55.58887666363396
Task_6684,2796,756,133,47,180,3.6935270805812417,52.99939756083407
Task_6685,2919,1016,195,136,331,2.870206489675516,57.447461906442015
Task_6686,609,72,169,186,355,8.342465753424657,17.304199316496835
Task_6687,2750,802,69,40,109,3.4246575342465753,51.87056799948735
Task_6688,2653,335,112,93,205,7.895833333333333,50.35820787076445
Task_6689,1170,520,141,120,261,2.2456813819577737,27.848941998617054
Task_6690,1725,925,154,46,200,1.8628509719222461,36.81606043444136
Task_6691,1235,692,40,33,73,1.7821067821067822,26.818708022770053
Task_6692,678,966,103,72,175,0.7011375387797312,20.612936535362262
Task_6693,1322,565,194,194,388,2.335689045936396,31.077934719703066
Task_6694,2816,544,184,200,384,5.1669724770642205,54.65852225159438
Task_6695,1870,502,196,117,313,3.7176938369781314,39.1043183927554
Task_6696,641,968,97,126,223,0.6615067079463365,20.79837231130762
Task_6697,2618,233,32,52,84,11.188034188034187,47.92288021132617
Task_6698,1809,736,143,97,240,2.4545454545454546,38.5515001472552
Task_6699,2368,271,170,38,208,8.705882352941176,44.97528690591164
Task_6700,2062,294,10,124,134,6.989830508474577,40.381982384292634
Task_6701,1462,84,182,187,369,17.2,30.814634251544163
Task_6702,1575,678,83,191,274,2.3195876288659796,34.974410587731256
Task_6703,1020,453,197,154,351,2.246696035242291,25.718932688918887
Task_6704,949,845,166,22,188,1.1217494089834514,24.080932659403473
Task_6705,2688,214,194,86,280,12.502325581395349,50.59777316864705
Task_6706,1379,210,49,184,233,6.535545023696683,30.27174954412882
Task_6707,534,333,164,167,331,1.598802395209581,17.56626328209992
Task_6708,2445,621,155,161,316,3.9308681672025725,48.66605344317702
Task_6709,598,150,179,129,308,3.9602649006622515,17.526385910648813
Task_6710,716,399,14,106,120,1.79,19.353865467167974
Task_6711,2927,121,104,188,292,23.991803278688526,53.98726279776482
Task_6712,2929,584,189,146,335,5.006837606837607,56.27654932524018
Task_6713,1426,305,38,162,200,4.660130718954249,31.009637059166195
Task_6714,1276,174,76,169,245,7.291428571428572,28.170458233340725
Task_6715,2775,275,81,183,264,10.054347826086957,52.64182002423647
Task_6716,2962,725,183,164,347,4.079889807162535,57.32872228274338
Task_6717,2620,1012,82,187,269,2.586377097729516,52.58440048373826
Task_6718,1527,219,27,146,173,6.9409090909090905,32.12681982264498
Task_6719,2336,756,135,196,331,3.085865257595773,47.4844114213436
Task_6720,1160,772,48,39,87,1.500646830530401,26.294710434030907
Task_6721,618,599,138,53,191,1.03,18.485378497015006
Task_6722,2076,353,135,148,283,5.864406779661017,41.79024170921219
Task_6723,830,681,64,45,109,1.217008797653959,20.871893380818324
Task_6724,2830,102,40,107,147,27.475728155339805,50.884776057163215
Task_6725,2537,385,124,93,217,6.572538860103627,48.746817444562254
Task_6726,1367,701,134,98,232,1.9472934472934473,31.375596647382082
Task_6727,1434,254,72,197,269,5.623529411764705,31.44137702335284
Task_6728,988,1001,181,95,276,0.9860279441117764,26.38257348763808
Task_6729,896,485,53,76,129,1.8436213991769548,22.50351042835545
Task_6730,2357,969,81,121,202,2.4298969072164947,47.89525178262213
Task_6731,740,829,109,121,230,0.891566265060241,21.785472468205796
Task_6732,1104,895,185,33,218,1.2321428571428572,26.964526544608827
Task_6733,1846,246,140,11,151,7.473684210526316,35.933274618961036
Task_6734,2202,468,199,68,267,4.6950959488272925,43.53099264023884
Task_6735,1759,192,56,196,252,9.1139896373057,36.29528041269544
Task_6736,2137,251,46,127,173,8.48015873015873,41.83915421454121
Task_6737,987,584,164,104,268,1.6871794871794872,25.14634465950222
Task_6738,648,981,165,64,229,0.659877800407332,20.52856551315112
Task_6739,2700,524,65,75,140,5.142857142857143,51.02664789916704
Task_6740,2766,961,14,43,57,2.8752598752598755,52.046630801347
Task_6741,2274,280,178,60,238,8.092526690391459,43.81578537463961
Task_6742,1594,67,129,172,301,23.441176470588236,32.440366800427135
Task_6743,2620,798,146,42,188,3.27909887359199,50.50863115599197
Task_6744,2867,896,154,183,337,3.1962095875139354,56.34435259047302
Task_6745,1581,886,157,159,316,1.782412626832018,35.79307651629953
Task_6746,1078,640,30,182,212,1.6817472698907956,26.665070558843244
Task_6747,1170,318,53,84,137,3.6677115987460813,26.29976950799887
Task_6748,1607,745,200,79,279,2.1541554959785523,35.202586897263096
Task_6749,2906,318,28,139,167,9.109717868338558,54.115849886566224
Task_6750,1124,99,155,21,176,11.24,23.648550446671283
Task_6751,1021,856,179,61,240,1.191365227537923,25.833130607004637
Task_6752,2233,926,34,100,134,2.4088457389428264,45.10001698447684
Task_6753,1336,811,130,91,221,1.645320197044335,31.004220957443266
Task_6754,2704,250,43,171,214,10.772908366533864,51.0943786923209
Task_6755,2733,342,150,89,239,7.967930029154519,51.67283635692993
Task_6756,2440,865,167,44,211,2.8175519630484986,48.00254330886107
Task_6757,692,541,189,162,351,1.2767527675276753,20.721515257670294
Task_6758,2259,461,119,189,308,4.8896103896103895,45.213402096985305
Task_6759,588,802,192,41,233,0.7322540473225405,18.673212470186254
Task_6760,2874,92,96,58,154,30.903225806451612,51.11903987771722
Task_6761,2516,77,101,81,182,32.256410256410255,45.81701312426952
Task_6762,2535,745,81,108,189,3.3981233243967828,49.910170123720214
Task_6763,1714,613,44,143,187,2.791530944625407,36.4322375486038
Task_6764,2636,746,79,152,231,3.5287817938420347,51.82102292777126
Task_6765,1819,687,133,92,225,2.6438953488372094,38.34720005558365
Task_6766,2165,311,160,44,204,6.939102564102564,41.840049340091625
Task_6767,1992,985,192,189,381,2.020283975659229,42.963761155641386
Task_6768,1896,469,143,161,304,4.034042553191489,39.434216332491374
Task_6769,1234,574,161,11,172,2.146086956521739,27.597819121207788
Task_6770,2260,93,36,196,232,24.04255319148936,42.77960216285158
Task_6771,1052,440,132,17,149,2.385487528344671,23.922396057038103
Task_6772,2950,931,109,164,273,3.165236051502146,57.45278618702785
Task_6773,1484,173,135,17,152,8.528735632183908,29.673220260999944
Task_6774,1955,746,69,25,94,2.6171352074966534,38.98136443427389
Task_6775,2395,397,171,73,244,6.017587939698492,46.29079030642378
Task_6776,2310,855,91,59,150,2.6985981308411215,45.5747480759347
Task_6777,2353,766,168,186,354,3.0677966101694913,47.87412091620647
Task_6778,1143,431,98,135,233,2.6458333333333335,27.050336256497786
Task_6779,917,167,160,26,186,5.458333333333333,21.214344999141876
Task_6780,2699,737,181,18,199,3.6571815718157183,51.40960831348331
Task_6781,2028,746,139,34,173,2.714859437751004,40.876630287879024
Task_6782,2377,941,163,125,288,2.523354564755839,48.41471409116008
Task_6783,1378,926,126,75,201,1.4865156418554477,31.679539025389392
Task_6784,2529,225,177,107,284,11.190265486725664,48.4429740084834
Task_6785,1504,453,157,129,286,3.3127753303964758,33.050122737365385
Task_6786,2634,139,166,86,252,18.814285714285713,49.02260483222312
Task_6787,2594,822,171,130,301,3.1518833535844473,51.54698455385087
Task_6788,1722,866,13,95,108,1.986159169550173,36.625426694427226
Task_6789,1957,974,127,82,209,2.0071794871794872,41.15956654814697
Task_6790,1953,476,166,71,237,4.09433962264151,39.48925746993719
Task_6791,890,390,192,91,283,2.2762148337595907,22.917598218459858
Task_6792,1450,684,55,33,88,2.116788321167883,30.580309347708834
Task_6793,1724,990,58,111,169,1.739656912209889,37.61542236993327
Task_6794,2146,914,121,181,302,2.3453551912568305,44.81536875835343
Task_6795,2612,725,32,200,232,3.597796143250689,51.35841877165975
Task_6796,1682,291,183,142,325,5.760273972602739,35.53177348396321
Task_6797,838,627,136,170,306,1.3343949044585988,23.161587850237698
Task_6798,2552,136,178,31,209,18.62773722627737,47.031619589156286
Task_6799,1695,113,86,110,196,14.868421052631579,33.922238280460824
Task_6800,1585,506,131,124,255,3.126232741617357,34.3538937368159
Task_6801,2237,174,62,47,109,12.782857142857143,41.053425049991425
Task_6802,1061,640,30,71,101,1.655226209048362,25.03297583376955
Task_6803,2129,146,80,83,163,14.482993197278912,40.59121844972954
Task_6804,1673,933,39,193,232,1.791220556745182,37.09395272425948
Task_6805,2582,591,121,55,176,4.361486486486487,49.35536700256228
Task_6806,2402,524,187,119,306,4.575238095238095,47.568853466743654
Task_6807,1310,103,90,108,198,12.596153846153847,27.64322843673121
Task_6808,2769,732,194,51,245,3.77762619372442,53.20171711814741
Task_6809,1852,147,63,172,235,12.513513513513514,37.09345452490323
Task_6810,1878,183,198,109,307,10.206521739130435,37.96408687038148
Task_6811,1575,347,85,105,190,4.525862068965517,33.3993978237077
Task_6812,644,250,63,42,105,2.5657370517928286,16.499008198379403
Task_6813,2093,226,147,24,171,9.220264317180616,39.99501031412976
Task_6814,1552,317,160,102,262,4.880503144654088,33.220844817203215
Task_6815,973,931,160,92,252,1.043991416309013,25.692070178621723
Task_6816,1427,618,190,14,204,2.3053311793214863,30.990509596582356
Task_6817,2009,1000,21,62,83,2.006993006993007,40.729763037512534
Task_6818,2097,635,109,198,307,3.297169811320755,43.21251669595224
Task_6819,538,757,14,156,170,0.7097625329815304,18.071929336053117
Task_6820,1635,328,194,69,263,4.9696048632218845,34.05576218216636
Task_6821,2807,989,17,67,84,2.8353535353535353,53.42940509642967
Task_6822,2272,179,15,87,102,12.622222222222222,42.37209918039277
Task_6823,1598,313,170,178,348,5.089171974522293,34.43396123160003
Task_6824,2915,176,42,146,188,16.468926553672315,53.53872410831312
Task_6825,1927,888,111,137,248,2.1676040494938134,40.956377833271354
Task_6826,1769,494,73,17,90,3.573737373737374,35.0180577433159
Task_6827,2922,723,93,75,168,4.035911602209945,55.289576468792006
Task_6828,2848,396,20,64,84,7.173803526448363,52.18905581816774
Task_6829,2606,566,148,185,333,4.596119929453263,51.1521385471252
Task_6830,1882,82,126,133,259,22.674698795180724,36.799863233780805
Task_6831,1226,441,74,181,255,2.773755656108597,28.68017939097224
Task_6832,1923,596,62,47,109,3.221105527638191,37.971494640386815
Task_6833,901,201,128,83,211,4.46039603960396,21.992974355333654
Task_6834,2240,692,78,83,161,3.2323232323232323,44.38675877858114
Task_6835,2336,299,32,174,206,7.786666666666667,45.44890995786485
Task_6836,509,717,70,19,89,0.7089136490250696,16.281052234774133
Task_6837,609,734,108,181,289,0.8285714285714286,19.761726069451882
Task_6838,550,88,183,188,371,6.179775280898877,16.569430973246366
Task_6839,1508,739,185,147,332,2.037837837837838,34.246932356093204
Task_6840,941,177,23,170,193,5.286516853932584,22.513637188933235
Task_6841,2722,444,101,74,175,6.116853932584269,51.27590974759659
Task_6842,1103,431,48,136,184,2.553240740740741,26.133515850528863
Task_6843,2759,223,175,14,189,12.316964285714286,50.649670606405344
Task_6844,1063,208,47,22,69,5.086124401913875,22.494198844598206
Task_6845,2345,880,164,173,337,2.6617480136208855,48.008534390376155
Task_6846,1500,249,119,141,260,6.0,32.21738110722577
Task_6847,658,454,63,191,254,1.4461538461538461,19.667631773813373
Task_6848,1804,889,101,173,274,2.0269662921348313,39.18050263291267
Task_6849,2223,142,84,188,272,15.545454545454545,43.07294057254319
Task_6850,816,825,96,29,125,0.9878934624697336,21.746282319897205
Task_6851,1943,667,51,144,195,2.908682634730539,40.48615812145019
Task_6852,2682,740,129,146,275,3.619433198380567,52.58963225168393
Task_6853,800,71,143,63,206,11.11111111111111,19.06922085565502
Task_6854,1188,663,64,90,154,1.7891566265060241,27.70785378205905
Task_6855,2935,714,190,111,301,4.104895104895105,56.581186277256656
Task_6856,2784,573,26,178,204,4.850174216027875,53.442526657490504
Task_6857,1458,925,194,64,258,1.57451403887689,33.106043376471526
Task_6858,1035,666,77,25,102,1.5517241379310345,24.178573169736328
Task_6859,2581,765,60,174,234,3.3694516971279374,51.052556856265106
Task_6860,1091,996,162,26,188,1.0942828485456368,26.859350831177725
Task_6861,854,210,187,24,211,4.04739336492891,20.758432617758274
Task_6862,1898,913,177,107,284,2.076586433260394,40.69295374959423
Task_6863,2123,406,102,192,294,5.216216216216216,42.82307272222255
Task_6864,1266,264,177,127,304,4.777358490566038,28.748662197328414
Task_6865,511,811,42,45,87,0.6293103448275862,16.586969728276987
Task_6866,2116,223,44,27,71,9.446428571428571,39.25163663540955
Task_6867,1215,186,70,32,102,6.497326203208556,25.693736133307254
Task_6868,2202,167,99,35,134,13.107142857142858,41.10451506462941
Task_6869,2083,974,134,169,303,2.1364102564102563,43.99074613923806
Task_6870,1799,837,192,123,315,2.1467780429594274,39.05087465857776
Task_6871,1501,647,193,153,346,2.316358024691358,33.92046222180042
Task_6872,1983,770,194,175,369,2.5719844357976656,42.0764843586809
Task_6873,2928,670,195,111,306,4.363636363636363,56.353289366573584
Task_6874,2336,634,14,112,126,3.678740157480315,45.89564152721507
Task_6875,2423,140,200,159,359,17.18439716312057,46.49429807475855
Task_6876,1571,1024,157,50,207,1.5326829268292683,34.78634665442332
Task_6877,2446,227,68,166,234,10.728070175438596,47.123143840866284
Task_6878,2421,145,158,171,329,16.58219178082192,46.40557709647899
Task_6879,2842,93,36,152,188,30.23404255319149,51.59844098997033
Task_6880,817,494,175,199,374,1.6505050505050505,22.79047120904438
Task_6881,781,281,15,91,106,2.769503546099291,19.731389351312888
Task_6882,1277,164,63,74,137,7.739393939393939,26.93996337292138
Task_6883,719,773,163,141,304,0.9289405684754521,21.64740441132407
Task_6884,676,299,164,131,295,2.2533333333333334,19.50230636817572
Task_6885,2856,776,36,174,210,3.675675675675676,55.21658011111393
Task_6886,1100,281,164,109,273,3.900709219858156,26.01542158020965
Task_6887,1891,805,65,91,156,2.3461538461538463,39.34980907470216
Task_6888,1671,836,57,93,150,1.996415770609319,36.02530174211599
Task_6889,1862,469,137,32,169,3.9617021276595743,37.22799067330636
Task_6890,1917,1016,137,137,274,1.8849557522123894,41.31303949511185
Task_6891,2757,238,53,189,242,11.535564853556485,52.194935632013596
Task_6892,2506,176,76,25,101,14.158192090395481,45.56560223249593
Task_6893,2624,82,33,19,52,31.6144578313253,45.85604543674418
Task_6894,836,743,158,141,299,1.1236559139784945,23.29732747910192
Task_6895,2866,422,156,125,281,6.775413711583925,54.47696353293029
Task_6896,1393,923,65,47,112,1.5075757575757576,30.69049787270562
Task_6897,1508,128,183,27,210,11.689922480620154,30.473237119551573
Task_6898,1416,401,30,141,171,3.5223880597014925,30.836603932520337
Task_6899,2245,513,12,22,34,4.367704280155642,41.91957529604507
Task_6900,1455,302,44,138,182,4.801980198019802,31.160774891817677
Task_6901,774,677,86,132,218,1.1415929203539823,21.824235794599733
Task_6902,2616,114,116,188,304,22.747826086956522,49.00073167164652
Task_6903,1945,875,26,140,166,2.220319634703196,40.705963756185554
Task_6904,2792,76,21,52,73,36.25974025974026,48.90027394701445
Task_6905,1543,914,74,72,146,1.6863387978142077,33.90615712718844
Task_6906,574,972,164,105,269,0.5899280575539568,19.882442177361234
Task_6907,2642,688,115,24,139,3.834542815674891,49.98696734278311
Task_6908,2562,664,101,140,241,3.8526315789473684,50.286659370939084
Task_6909,762,801,147,104,251,0.9501246882793017,22.12546792059095
Task_6910,2658,1001,81,99,180,2.6526946107784433,52.434064837738866
Task_6911,2281,834,119,135,254,2.731736526946108,46.420954409369074
Task_6912,692,346,70,64,134,1.994236311239193,18.591647233617753
Task_6913,1373,481,36,80,116,2.8485477178423237,29.8221862469308
Task_6914,2013,447,25,77,102,4.493303571428571,39.509094994740785
Task_6915,2593,904,161,142,303,2.8651933701657457,51.81442604537265
Task_6916,2533,466,180,103,283,5.423982869379015,49.328021476954426
Task_6917,1045,311,168,96,264,3.3493589743589745,25.20789069818396
Task_6918,2116,664,89,90,179,3.181954887218045,42.54626937986579
Task_6919,2990,1018,34,12,46,2.9342492639842983,55.371312071179936
Task_6920,1078,497,142,109,251,2.1646586345381524,26.258912095077733
Task_6921,1179,535,19,117,136,2.199626865671642,27.15985220847986
Task_6922,2008,860,74,171,245,2.332171893147503,42.32069682704259
Task_6923,1627,167,167,148,315,9.68452380952381,33.891667263990335
Task_6924,2604,132,104,31,135,19.57894736842105,47.0916329614077
Task_6925,1546,315,27,72,99,4.8924050632911396,31.540199338186287
Task_6926,1714,683,145,151,296,2.5058479532163744,37.17867975914345
Task_6927,2174,182,185,43,228,11.879781420765028,41.66849793284229
Task_6928,788,629,28,44,72,1.2507936507936508,19.519463031093455
Task_6929,2265,657,175,34,209,3.4422492401215807,44.590093951134584
Task_6930,1052,315,76,54,130,3.329113924050633,24.05318431813681
Task_6931,1097,691,180,102,282,1.5852601156069364,27.2527983909502
Task_6932,713,218,101,40,141,3.2557077625570776,18.015008920422122
Task_6933,993,84,57,125,182,11.68235294117647,22.481944878006402
Task_6934,1320,648,154,171,325,2.0338983050847457,30.988560845146605
Task_6935,1429,653,55,114,169,2.185015290519878,31.914426136715857
Task_6936,2788,710,161,182,343,3.921237693389592,54.5333242146948
Task_6937,2019,1022,107,120,227,1.9736070381231672,42.711346686549426
Task_6938,575,410,15,176,191,1.3990267639902676,17.806848424821293
Task_6939,2892,795,75,166,241,3.6331658291457285,56.10188360268034
Task_6940,2988,666,101,113,214,4.47976011994003,56.87920731609429
Task_6941,2641,556,44,137,181,4.741472172351885,50.750162640915846
Task_6942,1972,847,104,129,233,2.3254716981132075,41.46229107166433
Task_6943,1850,112,150,71,221,16.371681415929203,35.84723957494391
Task_6944,1989,393,182,10,192,5.048223350253807,39.14028120025574
Task_6945,1013,539,88,13,101,1.875925925925926,23.322598067159564
Task_6946,891,69,17,165,182,12.728571428571428,20.73425220153038
Task_6947,889,620,15,121,136,1.431561996779388,22.818370785373904
Task_6948,2039,556,172,88,260,3.6606822262118492,41.418759583005134
Task_6949,861,365,160,68,228,2.3524590163934427,21.803353526056597
Task_6950,2836,730,102,64,166,3.8796169630642954,53.782547314500256
Task_6951,1575,130,116,33,149,12.022900763358779,30.95142388856846
Task_6952,1669,922,58,14,72,1.808234019501625,34.122739717237685
Task_6953,2224,375,100,47,147,5.914893617021277,42.48269946305487
Task_6954,2801,79,23,69,92,35.0125,49.52081416806797
Task_6955,2659,453,57,158,215,5.856828193832599,51.21275629662571
Task_6956,2098,112,172,123,295,18.56637168141593,40.56978955341498
Task_6957,1128,545,175,175,350,2.065934065934066,27.744174792334874
Task_6958,607,605,67,41,108,1.0016501650165017,17.259913556537466
Task_6959,2284,1006,39,104,143,2.2681231380337636,46.17391410437218
Task_6960,2923,688,152,60,212,4.242380261248186,55.30893656578206
Task_6961,2384,64,176,33,209,36.676923076923075,43.39200177411044
Task_6962,2912,644,134,200,334,4.514728682170543,56.27380769285198
Task_6963,1438,399,177,13,190,3.595,30.417052530127226
Task_6964,940,967,97,64,161,0.9710743801652892,24.338595550273237
Task_6965,864,803,85,41,126,1.0746268656716418,22.18675868035379
Task_6966,1362,384,49,92,141,3.5376623376623377,29.690320893517196
Task_6967,2245,233,181,138,319,9.594017094017094,44.190872558324564
Task_6968,2198,548,153,96,249,4.0036429872495445,44.14863747158972
Task_6969,2977,818,131,58,189,3.634920634920635,56.4502871738957
Task_6970,2637,209,199,99,298,12.557142857142857,50.121999626928265
Task_6971,833,244,114,61,175,3.4,20.55471862870816
Task_6972,1140,947,159,78,237,1.2025316455696202,28.22915250137699
Task_6973,1186,993,18,177,195,1.193158953722334,29.21439589101506
Task_6974,2329,927,102,200,302,2.509698275862069,47.78350128654099
Task_6975,836,846,136,106,242,0.987012987012987,23.390128974274187
Task_6976,1901,143,161,137,298,13.20138888888889,38.001412537391836
Task_6977,827,784,107,185,292,1.0535031847133758,23.34557214301115
Task_6978,889,215,123,145,268,4.1157407407407405,22.492249454274955
Task_6979,2308,336,97,193,290,6.8486646884272995,45.52382593425767
Task_6980,651,927,172,10,182,0.7015086206896551,19.66168716907193
Task_6981,2005,772,99,98,197,2.59379042690815,41.54816437070604
Task_6982,1129,244,15,107,122,4.608163265306122,25.441799587881146
Task_6983,2089,831,47,144,191,2.5108173076923075,43.14917734905419
Task_6984,1552,660,19,138,157,2.3479576399394855,33.5615515849421
Task_6985,860,963,94,149,243,0.8921161825726142,24.285570502752424
Task_6986,2969,439,58,179,237,6.747727272727273,56.19894143207812
Task_6987,2902,578,81,26,107,5.0120898100172715,53.49357261512075
Task_6988,2682,829,154,187,341,3.2313253012048193,53.2270246541936
Task_6989,524,678,18,134,152,0.7717231222385862,17.162413445417187
Task_6990,2438,893,139,87,226,2.727069351230425,48.64216432261588
Task_6991,2222,847,53,171,224,2.6202830188679247,45.61414522361639
Task_6992,2024,85,59,46,105,23.53488372093023,36.868915898287895
Task_6993,963,207,92,19,111,4.6298076923076925,21.559226362052176
Task_6994,635,653,174,117,291,0.9709480122324159,19.84105862033042
Task_6995,702,983,184,27,211,0.7134146341463414,21.04866029128208
Task_6996,2394,529,89,15,104,4.516981132075472,45.127498385857756
Task_6997,613,694,193,147,340,0.8820143884892087,19.889757959724104
Task_6998,2100,382,152,162,314,5.483028720626632,42.42638208985094
Task_6999,1183,366,16,126,142,3.223433242506812,26.700005447231224
Task_7000,2837,457,167,43,210,6.1943231441048034,52.99731414439092
Task_7001,1476,868,123,133,256,1.6985040276179517,33.7649113647596
Task_7002,876,651,197,178,375,1.343558282208589,24.160754115555864
Task_7003,587,276,13,160,173,2.11913357400722,17.502556402935074
Task_7004,2934,265,101,104,205,11.030075187969924,54.63248029118557
Task_7005,555,64,95,66,161,8.538461538461538,14.656953022111209
Task_7006,1171,506,52,58,110,2.309664694280079,26.17826895416515
Task_7007,708,78,168,121,289,8.962025316455696,18.467237615689353
Task_7008,2525,672,153,11,164,3.7518573551263,48.314069068158915
Task_7009,1831,803,35,144,179,2.277363184079602,38.72100634039307
Task_7010,875,616,17,48,65,1.4181523500810373,20.93489504505851
Task_7011,2714,967,148,55,203,2.803719008264463,52.924414952105444
Task_7012,763,992,37,91,128,0.7683786505538771,21.98243712723504
Task_7013,1669,319,171,91,262,5.215625,34.91541394917634
Task_7014,2417,924,77,192,269,2.612972972972973,49.134020858858854
Task_7015,1360,604,15,55,70,2.2479338842975207,28.928810781531443
Task_7016,2066,276,26,26,52,7.458483754512636,38.682711403057596
Task_7017,1800,950,141,174,315,1.8927444794952681,39.49302187826185
Task_7018,1647,296,155,61,216,5.545454545454546,33.8564559763363
Task_7019,1247,313,150,94,244,3.9713375796178343,28.23630800162893
Task_7020,2807,285,98,35,133,9.814685314685315,51.4031528382632
Task_7021,2830,153,153,40,193,18.376623376623378,51.437715659810245
Task_7022,1748,181,121,33,154,9.604395604395604,34.07176709833747
Task_7023,1094,697,30,164,194,1.5673352435530086,26.962767240771417
Task_7024,1376,543,57,24,81,2.5294117647058822,28.950878325463393
Task_7025,2382,689,141,99,240,3.4521739130434783,47.4351445984155
Task_7026,2890,849,192,177,369,3.4,56.69687313488604
Task_7027,870,74,186,186,372,11.6,21.500962599086908
Task_7028,2922,464,153,193,346,6.283870967741936,55.89482654288717
Task_7029,843,236,169,84,253,3.5569620253164556,21.385206078355306
Task_7030,2093,252,199,124,323,8.272727272727273,41.85647321817425
Task_7031,2804,233,109,34,143,11.982905982905983,51.14981149214324
Task_7032,1382,433,159,67,226,3.184331797235023,30.25311876019055
Task_7033,1313,244,138,108,246,5.359183673469388,29.13428130632778
Task_7034,1522,919,192,100,292,1.6543478260869566,34.76602096496983
Task_7035,1021,767,143,177,320,1.3294270833333333,26.568474300215765
Task_7036,2684,958,99,47,146,2.7987486965589157,51.64313772928225
Task_7037,1719,417,36,53,89,4.1124401913875595,34.361202266549434
Task_7038,2210,162,88,48,136,13.558282208588958,41.11556175156444
Task_7039,903,621,98,95,193,1.4517684887459807,23.509048515120366
Task_7040,1643,183,102,15,117,8.929347826086957,32.235945793082266
Task_7041,717,953,52,142,194,0.7515723270440252,21.748460471670935
Task_7042,1394,934,45,136,181,1.490909090909091,32.12962684990376
Task_7043,2902,895,28,43,71,3.2388392857142856,53.88278692290223
Task_7044,1491,481,140,156,296,3.0933609958506225,33.018123341996
Task_7045,2815,980,122,41,163,2.8695208970438326,53.94843749811762
Task_7046,2959,339,60,77,137,8.702941176470588,54.5372428184412
Task_7047,1879,332,81,32,113,5.642642642642643,36.65751300172233
Task_7048,1051,313,15,108,123,3.3471337579617835,24.45799046271622
Task_7049,1866,196,43,119,162,9.472081218274111,37.07651730322108
Task_7050,1716,125,178,10,188,13.619047619047619,33.57405694902844
Task_7051,1731,367,106,74,180,4.703804347826087,35.257020805904894
Task_7052,973,319,98,36,134,3.040625,22.497693690626818
Task_7053,850,460,174,162,336,1.8438177874186552,22.994253759940666
Task_7054,983,360,177,146,323,2.7229916897506925,24.700570684593913
Task_7055,1365,336,185,184,369,4.050445103857567,30.92846834275296
Task_7056,1587,530,89,97,186,2.9887005649717513,34.06198032673659
Task_7057,2087,154,192,12,204,13.464516129032258,39.74998892204522
Task_7058,1667,347,108,174,282,4.790229885057471,35.33443397382551
Task_7059,1760,249,96,31,127,7.04,34.69423795482061
Task_7060,1231,84,182,127,309,14.48235294117647,26.834744096398683
Task_7061,819,617,12,196,208,1.325242718446602,22.416189157791624
Task_7062,2365,69,186,76,262,33.785714285714285,43.80267932244567
Task_7063,2721,875,14,98,112,3.106164383561644,52.538608800468715
Task_7064,2664,656,91,194,285,4.054794520547945,52.20360523630962
Task_7065,1291,171,85,183,268,7.505813953488372,28.438712536529497
Task_7066,1177,793,199,108,307,1.4823677581863979,28.958606437312273
Task_7067,1532,940,121,43,164,1.6280552603613176,33.556947295609234
Task_7068,1389,974,76,133,209,1.4246153846153846,32.590934242531524
Task_7069,768,269,192,133,325,2.8444444444444446,20.998255430302546
Task_7070,1200,706,59,156,215,1.6973125884016973,28.89216577840247
Task_7071,2109,398,103,150,253,5.285714285714286,42.32893875481074
Task_7072,1011,980,118,72,190,1.0305810397553516,25.896906503991314
Task_7073,629,500,169,176,345,1.255489021956088,19.55876694975299
Task_7074,2943,1001,68,184,252,2.937125748502994,57.61750551356146
Task_7075,1899,783,33,184,217,2.4221938775510203,40.16231802060847
Task_7076,1953,923,121,187,308,2.1136363636363638,41.82101870664529
Task_7077,2457,75,151,100,251,32.328947368421055,45.64435606336264
Task_7078,624,972,32,140,172,0.6413155190133607,20.18398161357537
Task_7079,2576,466,138,115,253,5.516059957173447,49.891049754458436
Task_7080,1140,264,188,82,270,4.30188679245283,26.254925755616526
Task_7081,780,904,77,46,123,0.861878453038674,21.218720464204655
Task_7082,586,856,92,156,248,0.6837806301050176,19.783168319428402
Task_7083,1805,638,120,26,146,2.8247261345852896,36.70004303522915
Task_7084,1500,457,112,172,284,3.2751091703056767,33.0535859214576
Task_7085,2890,938,61,174,235,3.0777422790202342,56.49530338351599
Task_7086,1276,264,178,187,365,4.815094339622641,29.269580763980056
Task_7087,2140,317,106,35,141,6.729559748427673,40.930922540419765
Task_7088,1372,900,137,107,244,1.5227524972253053,32.094871473468395
Task_7089,2366,988,39,87,126,2.3923154701718907,47.31478882890051
Task_7090,542,752,199,50,249,0.7197875166002656,18.068410262020695
Task_7091,1797,75,181,148,329,23.644736842105264,35.73356974965369
Task_7092,2678,758,128,58,186,3.5283267457180503,51.397529068133586
Task_7093,1748,700,175,185,360,2.49358059914408,38.10878234655419
Task_7094,2206,410,120,199,319,5.367396593673966,44.272542245128456
Task_7095,882,662,43,53,96,1.330316742081448,21.951079547594617
Task_7096,2938,885,24,38,62,3.3160270880361176,54.44516635871844
Task_7097,998,191,194,56,250,5.197916666666667,23.585633513150935
Task_7098,2620,733,122,45,167,3.569482288828338,50.04264682120331
Task_7099,2818,438,127,192,319,6.419134396355353,54.039850592176016
Task_7100,2513,797,37,42,79,3.1491228070175437,47.54058389704119
Task_7101,2171,468,128,93,221,4.628997867803838,43.244932220592545
Task_7102,1722,69,172,162,334,24.6,34.57802199356155
Task_7103,2043,85,90,150,240,23.75581395348837,39.301924055648456
Task_7104,2129,274,80,188,268,7.741818181818182,42.47677100147516
Task_7105,1947,514,132,82,214,3.7805825242718445,39.58085333311467
Task_7106,1756,230,86,82,168,7.6017316017316015,35.243755098258276
Task_7107,2732,334,149,48,197,8.155223880597015,50.87863080429202
Task_7108,2056,134,166,10,176,15.22962962962963,38.74692787270049
Task_7109,2442,695,157,135,292,3.5086206896551726,48.706412338890175
Task_7110,684,862,148,19,167,0.7925840092699884,19.65219663357301
Task_7111,2113,931,194,180,374,2.267167381974249,44.6684535756282
Task_7112,538,634,37,197,234,0.8472440944881889,18.013026248412718
Task_7113,1950,746,110,62,172,2.610441767068273,39.8460703474714
Task_7114,965,67,169,114,283,14.191176470588236,22.442170891588727
Task_7115,617,866,112,170,282,0.7116493656286044,20.365654252975933
Task_7116,2818,668,135,56,191,4.212257100149476,53.57979296381564
Task_7117,1037,705,182,146,328,1.4688385269121813,26.60662902764881
Task_7118,725,880,47,132,179,0.8229284903518729,21.25277875361674
Task_7119,2445,427,146,68,214,5.712616822429907,47.004658586925785
Task_7120,844,874,148,152,300,0.9645714285714285,23.92801926256236
Task_7121,636,640,92,97,189,0.9921996879875195,19.38505700937399
Task_7122,2979,755,64,171,235,3.9404761904761907,57.32630474064312
Task_7123,1304,792,134,101,235,1.644388398486759,30.66207646261982
Task_7124,2537,719,105,147,252,3.5236111111111112,50.12425820721942
Task_7125,2565,453,187,58,245,5.649779735682819,49.042985183596635
Task_7126,2436,467,49,39,88,5.205128205128205,45.558121937383184
Task_7127,2355,862,179,91,270,2.7288528389339515,47.54244576605395
Task_7128,672,286,115,31,146,2.341463414634146,17.694065604274638
Task_7129,1599,153,138,182,320,10.383116883116884,33.4448997272142
Task_7130,572,701,74,127,201,0.8148148148148148,18.69528022150085
Task_7131,2675,249,89,91,180,10.7,50.0493334198332
Task_7132,2769,174,194,150,344,15.822857142857142,51.98074893197577
Task_7133,2068,555,73,117,190,3.7194244604316546,41.96938480725048
Task_7134,963,280,193,13,206,3.4270462633451957,22.602292481345255
Task_7135,1233,134,29,88,117,9.133333333333333,25.811226989914417
Task_7136,2035,150,195,104,299,13.47682119205298,40.094144653163056
Task_7137,566,1000,46,67,113,0.5654345654345654,18.443552148716
Task_7138,590,950,194,166,360,0.6203995793901157,20.630859904097374
Task_7139,709,434,151,114,265,1.6298850574712644,20.27721880628988
Task_7140,773,152,60,165,225,5.052287581699346,20.074134753120628
Task_7141,2732,131,118,10,128,20.696969696969695,49.16228447824043
Task_7142,1583,632,172,171,343,2.500789889415482,35.18503922388327
Task_7143,2155,121,82,55,137,17.66393442622951,40.22055262878545
Task_7144,1300,152,52,165,217,8.49673202614379,28.38398803007578
Task_7145,738,402,96,194,290,1.8312655086848635,20.931880569365855
Task_7146,1659,403,136,45,181,4.106435643564357,33.829802368774885
Task_7147,2295,432,27,105,132,5.300230946882217,44.57169439430218
Task_7148,736,606,146,89,235,1.2125205930807248,20.77163461223535
Task_7149,1931,1022,118,153,271,1.8875855327468232,41.563462679253234
Task_7150,2680,378,171,55,226,7.071240105540897,50.61012269799851
Task_7151,2007,877,83,174,257,2.285876993166287,42.33812982506981
Task_7152,2280,912,16,53,69,2.497261774370208,44.43277014515781
Task_7153,2722,328,82,199,281,8.27355623100304,52.08094024477239
Task_7154,591,815,71,77,148,0.7242647058823529,18.743517499559022
Task_7155,771,614,117,170,287,1.2536585365853659,21.891703588748452
Task_7156,1796,283,109,63,172,6.323943661971831,35.94692040179964
Task_7157,700,106,111,38,149,6.542056074766355,16.918218471037555
Task_7158,1195,172,168,108,276,6.907514450867052,26.791515242932338
Task_7159,599,844,119,163,282,0.7088757396449704,20.002247196183777
Task_7160,2332,567,168,200,368,4.105633802816901,46.99627266907407
Task_7161,1607,969,51,60,111,1.6567010309278352,34.62022071230377
Task_7162,2483,405,84,178,262,6.115763546798029,48.39900177071204
Task_7163,1757,257,18,98,116,6.810077519379845,35.242418451474876
Task_7164,2892,75,26,162,188,38.05263157894737,52.27853885972262
Task_7165,1552,429,36,184,220,3.609302325581395,33.52512430006424
Task_7166,501,353,127,106,233,1.4152542372881356,16.52113174128286
Task_7167,1299,889,122,133,255,1.4595505617977529,30.966131686495302
Task_7168,1571,342,65,199,264,4.580174927113703,33.8803841921928
Task_7169,1183,749,34,52,86,1.5773333333333333,26.88857088348108
Task_7170,1993,877,170,89,259,2.2699316628701594,41.75959554583986
Task_7171,1707,285,172,29,201,5.968531468531468,34.525295822469616
Task_7172,1924,661,123,153,276,2.906344410876133,40.34868723048386
Task_7173,2182,341,154,72,226,6.380116959064328,42.64235743332869
Task_7174,728,384,94,108,202,1.8909090909090909,20.225205687284433
Task_7175,658,894,37,199,236,0.735195530726257,20.75497844410393
Task_7176,2615,507,111,89,200,5.147637795275591,50.17710440070226
Task_7177,2759,261,10,95,105,10.530534351145038,50.94724862451909
Task_7178,836,647,35,152,187,1.2901234567901234,22.51220325958053
Task_7179,1727,502,36,46,82,3.433399602385686,34.4351681694567
Task_7180,1742,766,68,70,138,2.2711864406779663,36.49134130786417
Task_7181,2559,497,189,59,248,5.13855421686747,49.09221661949059
Task_7182,1516,282,174,10,184,5.3568904593639575,31.0707602390935
Task_7183,2036,975,72,77,149,2.0860655737704916,41.98065211884562
Task_7184,914,877,54,150,204,1.041002277904328,24.64043648861229
Task_7185,1130,86,134,89,223,12.988505747126437,24.74669283607435
Task_7186,1439,473,94,192,286,3.0358649789029535,32.261052618764495
Task_7187,1653,507,55,164,219,3.2539370078740157,35.48868579872475
Task_7188,2929,178,60,16,76,16.363128491620113,51.67318894298248
Task_7189,2884,859,49,20,69,3.353488372093023,53.23789642911421
Task_7190,2228,979,176,70,246,2.273469387755102,45.457499115335416
Task_7191,759,68,154,133,287,11.0,19.25887966268984
Task_7192,648,404,35,55,90,1.6,17.44199745968645
Task_7193,2676,999,179,164,343,2.676,53.63871352253707
Task_7194,1812,460,193,105,298,3.93058568329718,37.96656072454669
Task_7195,1885,432,174,124,298,4.353348729792148,39.05962682025421
Task_7196,928,650,167,172,339,1.4254992319508448,24.782314339946108
Task_7197,2445,840,22,144,166,2.9072532699167657,48.453253546557534
Task_7198,2085,969,18,123,141,2.149484536082474,42.872293619521315
Task_7199,743,839,177,14,191,0.8845238095238095,20.875926940533194
Task_7200,1181,735,186,110,296,1.6046195652173914,28.824406061002804
Task_7201,571,230,124,148,272,2.4718614718614718,17.542327481626618
Task_7202,1598,506,96,43,139,3.1518737672583828,32.9832308370422
Task_7203,2947,509,86,160,246,5.7784313725490195,55.9807113242934
Task_7204,2457,786,119,195,314,3.121982210927573,49.41741519519227
Task_7205,1827,72,175,140,315,25.027397260273972,36.1146450716431
Task_7206,2767,374,13,105,118,7.378666666666667,51.74062595857214
Task_7207,2645,1022,192,134,326,2.5855327468230693,53.0985298281419
Task_7208,1579,355,64,91,155,4.435393258426966,32.985598456878385
Task_7209,2142,324,34,196,230,6.590769230769231,42.595913550843
Task_7210,1814,295,186,44,230,6.128378378378378,36.3529575561817
Task_7211,2846,412,159,141,300,6.891041162227603,54.23622189228845
Task_7212,1260,604,71,69,140,2.0826446280991737,28.337272752746433
Task_7213,1021,649,169,181,350,1.5707692307692307,26.340574161099614
Task_7214,921,117,49,11,60,7.805084745762712,19.60893044339267
Task_7215,1011,690,189,149,338,1.463096960926194,26.1831270859921
Task_7216,715,772,175,174,349,0.92496765847348,21.827770984804527
Task_7217,843,436,175,19,194,1.929061784897025,21.07262524666515
Task_7218,794,473,131,50,181,1.6751054852320675,20.46733850286536
Task_7219,2140,194,52,132,184,10.974358974358974,41.67842621157144
Task_7220,680,727,144,132,276,0.9340659340659341,20.747814703810466
Task_7221,901,887,35,18,53,1.0146396396396395,22.081233477013864
Task_7222,649,566,78,161,239,1.144620811287478,19.73239037900029
Task_7223,2937,551,169,160,329,5.320652173913044,56.290501507361476
Task_7224,2912,82,91,94,185,35.08433734939759,52.42623760033852
Task_7225,2865,329,200,142,342,8.681818181818182,54.44492129406924
Task_7226,1311,507,51,125,176,2.5807086614173227,29.704306578114473
Task_7227,1797,999,108,125,233,1.797,39.15622875910825
Task_7228,515,576,143,119,262,0.8925476603119584,17.58006695459161
Task_7229,581,92,147,80,227,6.247311827956989,16.030989208204236
Task_7230,908,989,144,99,243,0.9171717171717172,24.954288661829565
Task_7231,709,474,115,88,203,1.4926315789473685,19.807671206655286
Task_7232,1681,806,38,142,180,2.0830235439900866,36.334803675241666
Task_7233,861,271,143,38,181,3.1654411764705883,20.856933754967056
Task_7234,1397,387,169,159,328,3.600515463917526,31.37857090884017
Task_7235,1282,868,28,54,82,1.475258918296893,28.752505957832255
Task_7236,728,469,124,96,220,1.548936170212766,20.45262567587075
Task_7237,660,1000,74,164,238,0.6593406593406593,21.41668270144034
Task_7238,2863,729,181,197,378,3.921917808219178,55.961190475843374
Task_7239,988,94,146,170,316,10.4,23.108328586111593
Task_7240,1495,747,72,13,85,1.9986631016042782,31.443164705633915
Task_7241,2332,540,175,31,206,4.310536044362292,45.26215390148763
Task_7242,1349,180,130,186,316,7.45303867403315,29.52569724862555
Task_7243,1904,934,99,59,158,2.036363636363636,39.411906438548826
Task_7244,1958,493,47,49,96,3.9635627530364372,38.244197872339164
Task_7245,2336,426,118,105,223,5.470725995316159,45.81180984238079
Task_7246,2174,120,55,105,160,17.96694214876033,41.080315796865726
Task_7247,2951,286,159,160,319,10.282229965156795,55.57440193451763
Task_7248,2666,617,192,168,360,4.313915857605178,52.36196569469081
Task_7249,2598,204,70,148,218,12.673170731707318,49.35263891159092
Task_7250,1942,506,138,164,302,3.8303747534516766,40.27628511724741
Task_7251,2937,837,116,146,262,3.5047732696897373,56.8761696345324
Task_7252,2843,981,129,131,260,2.895112016293279,55.80652768816066
Task_7253,2392,422,68,106,174,5.6548463356974,46.52243390379658
Task_7254,1252,240,93,75,168,5.195020746887967,27.29506271389373
Task_7255,2969,1004,25,24,49,2.954228855721393,55.2076818536056
Task_7256,1749,934,95,88,183,1.8705882352941177,37.53416403304859
Task_7257,2438,148,48,141,189,16.36241610738255,46.06387141094811
Task_7258,1307,743,52,39,91,1.756720430107527,28.528919225362774
Task_7259,2958,209,73,20,93,14.085714285714285,52.941003369445944
Task_7260,1659,454,59,15,74,3.646153846153846,32.51821682544192
Task_7261,1592,245,46,51,97,6.471544715447155,31.836424488318283
Task_7262,1407,592,108,58,166,2.372681281618887,30.655410793443156
Task_7263,789,799,75,45,120,0.98625,20.91980516907173
Task_7264,2540,417,69,155,224,6.076555023923445,49.209895691400796
Task_7265,2834,946,106,86,192,2.992608236536431,54.916093194646926
Task_7266,525,990,73,118,191,0.5297679112008072,18.951207230890958
Task_7267,1468,111,181,25,206,13.107142857142858,29.512395890334947
Task_7268,2292,82,155,130,285,27.6144578313253,43.338611581885196
Task_7269,1412,118,124,103,227,11.865546218487395,29.700192873541283
Task_7270,2488,474,143,65,208,5.237894736842105,47.80796727189838
Task_7271,2198,702,15,133,148,3.126600284495021,43.93874470465556
Task_7272,2638,736,108,63,171,3.5793758480325644,50.607272008626985
Task_7273,1851,496,167,168,335,3.7243460764587524,38.95828467272866
Task_7274,2907,382,186,95,281,7.590078328981723,54.91938109570901
Task_7275,765,657,165,48,213,1.162613981762918,20.89089834864931
Task_7276,2008,752,108,159,267,2.6666666666666665,41.93302995709416
Task_7277,1691,212,162,26,188,7.938967136150235,33.86216111560478
Task_7278,2428,313,27,86,113,7.732484076433121,46.0207641646071
Task_7279,704,177,21,86,107,3.955056179775281,17.547146523180277
Task_7280,550,433,20,123,143,1.2672811059907834,16.774449108131915
Task_7281,1153,915,154,163,317,1.2587336244541485,29.01911497574694
Task_7282,1941,209,172,186,358,9.242857142857142,39.54644696369195
Task_7283,551,85,170,33,203,6.406976744186046,14.884890374634054
Task_7284,1044,250,148,61,209,4.159362549800797,24.14000828192358
Task_7285,1626,915,178,123,301,1.775109170305677,36.47582548244737
Task_7286,1753,491,150,40,190,3.563008130081301,35.85361389275422
Task_7287,728,1012,56,172,228,0.7186574531095755,22.421974215570987
Task_7288,900,211,86,101,187,4.245283018867925,22.227564843178467
Task_7289,2133,938,134,81,215,2.2715654952076676,43.82227681250536
Task_7290,2974,92,128,179,307,31.978494623655912,54.330240909791335
Task_7291,2817,492,137,58,195,5.713995943204869,52.933981317762424
Task_7292,1521,660,192,109,301,2.301059001512859,34.01062164380902
Task_7293,1680,400,156,62,218,4.1895261845386536,34.76780183373935
Task_7294,521,884,54,192,246,0.5887005649717514,18.892528735037146
Task_7295,2288,463,150,86,236,4.931034482758621,44.9393428855229
Task_7296,2673,813,168,52,220,3.2837837837837838,51.87875384414059
Task_7297,1684,786,142,153,295,2.1397712833545106,37.02375467906384
Task_7298,1047,994,132,135,267,1.0522613065326634,27.295271028961835
Task_7299,1959,369,30,187,217,5.294594594594595,39.79313883830061
Task_7300,672,458,70,58,128,1.4640522875816993,18.547102359756877
Task_7301,1334,894,101,161,262,1.4905027932960895,31.63442700246463
Task_7302,2695,827,35,108,143,3.254830917874396,52.15398743430595
Task_7303,2192,602,119,25,144,3.6351575456053067,42.645120775753945
Task_7304,533,835,46,48,94,0.6375598086124402,17.05242403070956
Task_7305,2599,975,26,78,104,2.6629098360655736,50.52577688442992
Task_7306,2445,256,78,172,250,9.513618677042802,47.30499465187723
Task_7307,2670,271,85,152,237,9.816176470588236,50.7441807098657
Task_7308,875,558,164,115,279,1.5652951699463327,23.32808011415429
Task_7309,2750,885,102,47,149,3.1038374717832955,52.43626482463845
Task_7310,2990,493,184,47,231,6.052631578947368,55.63659912556931
Task_7311,1729,135,155,49,204,12.713235294117647,34.00749707991072
Task_7312,1723,280,16,76,92,6.131672597864768,34.24558715447755
Task_7313,1089,822,79,190,269,1.3232077764277035,27.728535037788447
Task_7314,2418,110,172,132,304,21.783783783783782,45.63278199125104
Task_7315,573,362,159,34,193,1.578512396694215,16.796658889558373
Task_7316,1524,437,197,16,213,3.4794520547945207,31.997554440766464
Task_7317,2785,134,138,165,303,20.62962962962963,51.843585243096534
Task_7318,1112,122,36,130,166,9.040650406504065,24.529948801412917
Task_7319,880,137,136,124,260,6.3768115942028984,21.67243439508314
Task_7320,1008,84,178,77,255,11.858823529411765,22.622878919026164
Task_7321,1445,516,101,150,251,2.7949709864603483,32.18916061365825
Task_7322,1623,357,76,105,181,4.533519553072626,34.07077311477131
Task_7323,607,187,44,200,244,3.228723404255319,18.04635657452756
Task_7324,2695,212,117,199,316,12.652582159624414,51.29227883974352
Task_7325,906,184,191,166,357,4.897297297297297,22.935386242572964
Task_7326,990,679,41,12,53,1.4558823529411764,22.672150674988206
Task_7327,1511,791,172,131,303,1.9078282828282829,34.30233084439166
Task_7328,1203,226,13,40,53,5.299559471365638,24.98500361228839
Task_7329,2816,907,65,67,132,3.101321585903084,54.00227220854135
Task_7330,1221,196,39,50,89,6.197969543147208,25.62484572325621
Task_7331,674,115,92,52,144,5.810344827586207,16.923091671564695
Task_7332,643,804,39,116,155,0.7987577639751553,19.476353839043394
Task_7333,2980,589,89,173,262,5.0508474576271185,56.8506001351735
Task_7334,2407,804,37,85,122,2.990062111801242,47.28536779059551
Task_7335,2085,414,13,35,48,5.024096385542169,39.40299623544016
Task_7336,1756,759,113,123,236,2.3105263157894735,37.77025523028572
Task_7337,617,872,18,81,99,0.7067583046964491,18.839774881608278
Task_7338,1697,934,125,45,170,1.8149732620320855,36.03033835673234
Task_7339,532,605,200,179,379,0.8778877887788779,18.553909152811173
Task_7340,2601,445,57,12,69,5.831838565022421,47.40065748064965
Task_7341,917,249,31,104,135,3.668,22.136827237390303
Task_7342,2600,905,79,27,106,2.869757174392936,49.76425608166707
Task_7343,1375,319,36,133,169,4.296875,29.879105009695063
Task_7344,2905,885,94,187,281,3.278781038374718,56.749265954105574
Task_7345,2578,418,61,59,120,6.152744630071599,48.22116332178654
Task_7346,2849,118,80,21,101,23.941176470588236,50.49016294984767
Task_7347,951,223,61,176,237,4.245535714285714,23.53201252493675
Task_7348,918,847,186,165,351,1.0825471698113207,25.202629574755502
Task_7349,735,610,37,99,136,1.2029459901800328,20.237862562809795
Task_7350,2783,187,131,70,201,14.803191489361701,51.62217610006417
Task_7351,1179,436,119,114,233,2.6979405034324944,27.591256662749036
Task_7352,2893,795,141,42,183,3.6344221105527637,54.66357772650932
Task_7353,1914,982,17,192,209,1.9471007121057986,40.88535471823267
Task_7354,2485,968,133,59,192,2.564499484004128,49.15503223695473
Task_7355,618,344,20,44,64,1.791304347826087,15.947159545932372
Task_7356,1490,861,168,135,303,1.728538283062645,34.17975319789309
Task_7357,1471,345,168,111,279,4.2514450867052025,32.12178985912848
Task_7358,2133,170,150,180,330,12.473684210526315,41.93729664526705
Task_7359,539,778,153,42,195,0.6919127086007703,17.832724324122587
Task_7360,761,218,37,159,196,3.4748858447488584,20.197144428393017
Task_7361,2616,368,10,48,58,7.0894308943089435,47.756072069458405
Task_7362,1303,96,53,33,86,13.43298969072165,25.62458653965045
Task_7363,790,528,178,168,346,1.4933837429111532,22.268279767935855
Task_7364,1517,867,148,77,225,1.7476958525345623,33.83569734275493
Task_7365,2483,80,153,161,314,30.65432098765432,46.4905367033727
Task_7366,1689,140,86,77,163,11.97872340425532,33.41454786676268
Task_7367,1465,380,16,168,184,3.8451443569553807,31.589120335341388
Task_7368,2196,421,131,95,226,5.203791469194313,43.55057426116141
Task_7369,1880,518,64,60,124,3.622350674373796,37.56963303432177
Task_7370,1456,770,44,85,129,1.888456549935149,32.21288379465937
Task_7371,2712,232,142,123,265,11.639484978540773,51.29813671987811
Task_7372,1581,204,159,136,295,7.712195121951219,33.4873312415317
Task_7373,1629,92,175,112,287,17.516129032258064,33.034159216355896
Task_7374,717,632,105,155,260,1.132701421800948,20.98985568064214
Task_7375,1158,535,105,148,253,2.16044776119403,27.71105082297473
Task_7376,953,528,76,73,149,1.8015122873345937,23.371235005670144
Task_7377,2171,418,175,178,353,5.181384248210024,43.8673337629246
Task_7378,1330,737,57,48,105,1.8021680216802167,29.006257005966244
Task_7379,2783,194,185,180,365,14.271794871794873,52.728386057745006
Task_7380,2036,573,27,33,60,3.5470383275261326,39.08927564204787
Task_7381,1829,465,188,121,309,3.924892703862661,38.324726763896926
Task_7382,511,342,94,179,273,1.489795918367347,17.045534531623296
Task_7383,747,924,108,181,289,0.8075675675675675,22.55150468503957
Task_7384,837,272,85,122,207,3.065934065934066,21.597885153574428
Task_7385,2900,512,19,136,155,5.653021442495127,54.42542179742707
Task_7386,1485,625,157,158,315,2.3722044728434506,33.46572947733146
Task_7387,2976,293,127,100,227,10.122448979591837,55.492410912418336
Task_7388,1208,566,198,64,262,2.130511463844797,28.06221848349807
Task_7389,991,97,138,104,242,10.112244897959183,22.734607722443993
Task_7390,618,167,89,44,133,3.6785714285714284,16.07850566497621
Task_7391,524,621,68,47,115,0.842443729903537,16.215654377526906
Task_7392,756,162,150,85,235,4.638036809815951,19.50115674268518
Task_7393,1742,621,40,141,181,2.8006430868167205,36.72463616305195
Task_7394,1807,666,136,92,228,2.709145427286357,38.10475655230839
Task_7395,1514,868,106,84,190,1.7422324510932106,33.69483127597312
Task_7396,2925,708,127,173,300,4.125528913963328,56.49015972424886
Task_7397,2851,678,86,43,129,4.198821796759941,53.35638960460792
Task_7398,2531,451,71,79,150,5.599557522123894,48.183674275307965
Task_7399,1680,372,39,155,194,4.50402144772118,35.209989445938206
Task_7400,2848,883,13,168,181,3.2217194570135748,55.1547463986644
Task_7401,579,727,73,121,194,0.7953296703296703,18.88396126640508
Task_7402,2355,715,118,87,205,3.2891061452513966,46.67462964970675
Task_7403,1298,607,77,84,161,2.1348684210526314,29.217267712264192
Task_7404,850,468,134,79,213,1.812366737739872,22.05048811796276
Task_7405,1133,327,195,184,379,3.4542682926829267,27.275083476013844
Task_7406,803,777,129,172,301,1.032133676092545,22.965180946791435
Task_7407,2048,200,82,41,123,10.189054726368159,38.90130250772801
Task_7408,1150,527,160,140,300,2.178030303030303,27.759373293669395
Task_7409,1071,330,35,45,80,3.2356495468277946,23.399588246633016
Task_7410,2872,169,168,179,347,16.894117647058824,53.742257920978325
Task_7411,1083,803,15,69,84,1.3470149253731343,25.63698324941581
Task_7412,2145,401,45,36,81,5.335820895522388,40.74103218689374
Task_7413,2163,688,22,35,57,3.13933236574746,41.52571503045216
Task_7414,1610,809,101,95,196,1.9876543209876543,35.36368252391375
Task_7415,850,253,136,22,158,3.3464566929133857,20.318530178085314
Task_7416,863,142,63,171,234,6.034965034965035,21.498123568048072
Task_7417,2360,468,93,188,281,5.031982942430703,46.82362923247964
Task_7418,1024,326,15,129,144,3.1314984709480123,24.157685283937735
Task_7419,1929,763,52,89,141,2.524869109947644,39.77853938253502
Task_7420,2933,1007,26,87,113,2.9097222222222223,56.243213137137154
Task_7421,786,602,169,116,285,1.3034825870646767,22.060080481816765
Task_7422,1263,797,130,197,327,1.5827067669172932,30.55413309639658
Task_7423,2453,557,20,67,87,4.396057347670251,46.503314086023586
Task_7424,663,702,159,99,258,0.9431009957325747,20.253995277623
Task_7425,894,182,106,95,201,4.885245901639344,21.907830412912404
Task_7426,1807,773,43,24,67,2.334625322997416,36.10195205974836
Task_7427,1374,77,162,200,362,17.615384615384617,29.343881176259135
Task_7428,590,582,144,179,323,1.012006861063465,19.077936414249553
Task_7429,2224,985,97,185,282,2.255578093306288,46.21184175957193
Task_7430,2142,255,110,121,231,8.3671875,42.22244029650319
Task_7431,1615,334,169,44,213,4.82089552238806,33.26017338040014
Task_7432,586,547,191,115,306,1.0693430656934306,18.738129204514763
Task_7433,2392,141,111,152,263,16.845070422535212,45.56469181892887
Task_7434,638,515,79,66,145,1.2364341085271318,18.23884347450133
Task_7435,2890,959,47,36,83,3.0104166666666665,54.2924546654229
Task_7436,2858,622,78,134,212,4.587479935794542,54.83251545803926
Task_7437,2266,496,133,61,194,4.559356136820925,44.20696893610542
Task_7438,1090,983,21,153,174,1.1077235772357723,27.357244610630264
Task_7439,2748,163,29,174,203,16.75609756097561,51.0969973335233
Task_7440,2980,580,13,26,39,5.129087779690189,53.9573214919206
Task_7441,925,764,164,104,268,1.2091503267973855,24.655362360452703
Task_7442,2672,916,74,61,135,2.913849509269357,51.61910337783693
Task_7443,581,349,75,83,158,1.66,17.031645687863605
Task_7444,1251,930,115,119,234,1.3437164339419978,30.245352750465297
Task_7445,877,981,142,127,269,0.8930753564154786,24.61120941106978
Task_7446,2744,650,65,78,143,4.21505376344086,52.22079969982018
Task_7447,685,993,53,79,132,0.6891348088531187,20.889094270230363
Task_7448,1522,116,144,193,337,13.008547008547009,31.981082389373984
Task_7449,2642,604,24,92,116,4.36694214876033,50.46868328046478
Task_7450,771,788,160,63,223,0.9771863117870723,21.690556172734123
Task_7451,1624,256,180,147,327,6.319066147859922,34.51163820926292
Task_7452,1304,307,107,17,124,4.233766233766234,27.31948692757555
Task_7453,1654,175,77,34,111,9.397727272727273,32.15434085508275
Task_7454,2795,746,101,93,194,3.7416331994645247,53.888586548970245
Task_7455,2938,877,45,121,166,3.34624145785877,56.37383638650558
Task_7456,795,904,106,78,184,0.8784530386740331,22.197734662097393
Task_7457,1606,194,58,35,93,8.235897435897435,31.640453558192025
Task_7458,2194,454,24,86,110,4.821978021978022,42.66319187808817
Task_7459,1488,1021,101,158,259,1.455968688845401,34.424884988124425
Task_7460,2123,172,152,63,215,12.271676300578035,40.788664322841946
Task_7461,2176,642,25,89,114,3.384136858475894,43.11517155084855
Task_7462,1210,982,57,154,211,1.2309257375381486,29.729566935291732
Task_7463,970,664,100,35,135,1.4586466165413534,23.518741008523648
Task_7464,1449,585,91,34,125,2.4726962457337884,30.79553749402586
Task_7465,2774,1008,135,57,192,2.7492566897918733,53.882504926099465
Task_7466,1456,828,156,84,240,1.7563329312424607,32.89014686897004
Task_7467,1885,589,69,89,158,3.194915254237288,38.54720047061871
Task_7468,2757,913,67,143,210,3.016411378555799,54.14574476705575
Task_7469,2733,960,170,90,260,2.8439125910509886,53.77294433570777
Task_7470,2879,802,29,172,201,3.585305105853051,55.65136249709141
Task_7471,2979,212,82,53,135,13.985915492957746,54.15256771713792
Task_7472,911,188,181,33,214,4.8201058201058204,21.776697144480718
Task_7473,2098,715,124,154,278,2.930167597765363,43.284987962469096
Task_7474,1897,317,31,113,144,5.965408805031447,37.90196576033755
Task_7475,1487,308,41,147,188,4.8122977346278315,31.870717174024467
Task_7476,2880,633,46,189,235,4.542586750788644,55.303911108247746
Task_7477,926,355,42,128,170,2.601123595505618,22.8924132456027
Task_7478,704,261,132,95,227,2.687022900763359,19.435381117260466
Task_7479,660,789,48,99,147,0.8354430379746836,19.716442857391716
Task_7480,2161,797,161,117,278,2.708020050125313,44.48578752892636
Task_7481,1256,98,53,193,246,12.686868686868687,27.168932884450328
Task_7482,928,619,155,113,268,1.4967741935483871,24.30497778717296
Task_7483,1896,400,108,155,263,4.728179551122195,39.01749741952247
Task_7484,2803,971,128,47,175,2.883744855967078,53.86872587715262
Task_7485,2158,488,195,46,241,4.413087934560327,42.48531381067705
Task_7486,1148,551,154,144,298,2.079710144927536,27.799855619531233
Task_7487,2499,68,149,72,221,36.21739130434783,45.68814841518125
Task_7488,593,381,191,192,383,1.5523560209424083,18.89223944973969
Task_7489,2020,1020,46,181,227,1.9784524975514202,42.844707106103364
Task_7490,1481,259,74,116,190,5.696153846153846,31.719858369416386
Task_7491,1356,294,32,75,107,4.596610169491526,28.726650078043296
Task_7492,2785,553,62,40,102,5.027075812274369,51.36862620241636
Task_7493,993,505,186,29,215,1.9624505928853755,24.00204466610204
Task_7494,2204,243,156,123,279,9.032786885245901,43.377818406199914
Task_7495,1057,520,33,16,49,2.0287907869481767,23.270154910843832
Task_7496,1426,122,17,22,39,11.59349593495935,27.478709575728313
Task_7497,2738,382,184,101,285,7.148825065274152,52.30047884600094
Task_7498,2142,596,183,194,377,3.5879396984924625,44.111452575693214
Task_7499,1244,224,176,66,242,5.528888888888889,27.43323809294644
Task_7500,1674,578,13,106,119,2.8911917098445596,35.092606496988815
Task_7501,897,451,121,125,246,1.9845132743362832,23.250035722843553
Task_7502,1303,910,118,69,187,1.4302963776070252,30.20027432188188
Task_7503,1755,204,135,178,313,8.560975609756097,36.37678488434689
Task_7504,2677,937,14,65,79,2.8539445628997866,51.016530258035175
Task_7505,1952,946,22,180,202,2.061246040126716,41.35816056074716
Task_7506,968,837,31,82,113,1.1551312649164678,24.501105361934492
Task_7507,2784,114,105,177,282,24.208695652173912,51.527396319020795
Task_7508,2358,377,99,51,150,6.238095238095238,44.83178000603785
Task_7509,2362,190,64,198,262,12.366492146596858,45.822698879676494
Task_7510,697,721,28,190,218,0.9653739612188366,20.754225958598568
Task_7511,672,316,100,70,170,2.1198738170347005,18.196208952747302
Task_7512,1225,148,53,28,81,8.221476510067115,25.091154876668256
Task_7513,1659,597,43,110,153,2.774247491638796,34.99744480016911
Task_7514,522,892,33,106,139,0.5845464725643897,17.94024345733
Task_7515,1537,302,78,120,198,5.072607260726072,32.802394919970745
Task_7516,1533,799,23,69,92,1.91625,32.89433473307311
Task_7517,1905,980,171,134,305,1.9418960244648318,41.1463954962714
Task_7518,2740,342,25,132,157,7.988338192419825,51.39905309941
Task_7519,1342,376,93,146,239,3.559681697612732,30.16470334998432
Task_7520,1908,715,18,90,108,2.664804469273743,38.89052368579317
Task_7521,2670,340,112,36,148,7.829912023460411,49.42357169096977
Task_7522,1571,227,36,62,98,6.890350877192983,31.50579657232372
Task_7523,2139,995,54,146,200,2.147590361445783,44.604630358004535
Task_7524,1286,330,50,186,236,3.8851963746223563,29.252429282362083
Task_7525,1941,196,176,106,282,9.852791878172589,38.9915929612685
Task_7526,2638,884,182,12,194,2.9807909604519773,50.997341459679895
Task_7527,556,716,18,76,94,0.7754532775453278,17.178639607977672
Task_7528,2225,331,146,79,225,6.701807228915663,43.41756836627409
Task_7529,2127,867,161,42,203,2.4504608294930876,43.02160361261559
Task_7530,2987,872,18,142,160,3.4215349369988544,56.97000176390915
Task_7531,791,584,24,98,122,1.3521367521367522,21.036314804876728
Task_7532,2506,166,48,170,218,15.005988023952096,47.43986088988953
Task_7533,1555,675,82,187,269,2.3002958579881656,34.65863113989946
Task_7534,1131,211,154,118,272,5.334905660377358,26.277992409435416
Task_7535,666,559,111,96,207,1.1892857142857143,19.653693091716914
Task_7536,2561,399,110,166,276,6.4025,49.61152087933385
Task_7537,637,471,53,164,217,1.3495762711864407,19.20821982768102
Task_7538,2839,230,118,68,186,12.29004329004329,52.26862187832072
Task_7539,502,156,152,127,279,3.1974522292993632,15.932249955716765
Task_7540,2594,694,17,182,199,3.7323741007194244,50.69847706295872
Task_7541,617,452,135,51,186,1.3620309050772628,17.828232880263247
Task_7542,2124,832,125,141,266,2.5498199279711886,43.99009267885458
Task_7543,891,737,118,13,131,1.2073170731707317,22.352216857733524
Task_7544,2014,305,114,178,292,6.5816993464052285,40.73237612127597
Task_7545,1533,314,49,89,138,4.866666666666666,32.08123795866641
Task_7546,686,1020,136,108,244,0.6718903036238981,21.70151341384336
Task_7547,1590,135,127,17,144,11.691176470588236,31.05076374685819
Task_7548,2493,877,200,195,395,2.8394077448747153,50.63786085138198
Task_7549,2324,626,119,37,156,3.7065390749601277,44.9169213325414
Task_7550,2748,204,169,89,258,13.404878048780487,51.48640003938448
Task_7551,2640,556,62,17,79,4.73967684021544,48.440826997927324
Task_7552,2273,959,36,38,74,2.3677083333333333,44.14105542307266
Task_7553,2261,254,121,175,296,8.866666666666667,44.47128854098912
Task_7554,1037,933,166,70,236,1.1102783725910064,26.322247656206724
Task_7555,2435,568,120,48,168,4.279437609841827,46.616855645817225
Task_7556,554,910,76,89,165,0.6081229418221734,18.847862361764992
Task_7557,1565,1002,117,51,168,1.5603190428713858,34.42459578976314
Task_7558,864,80,124,145,269,10.666666666666666,20.897132797941207
Task_7559,1320,683,14,64,78,1.9298245614035088,28.645068343026395
Task_7560,2068,573,142,22,164,3.602787456445993,40.834491783397226
Task_7561,2911,325,149,71,220,8.929447852760736,54.06865610330925
Task_7562,528,1014,27,119,146,0.5201970443349754,18.562780573718467
Task_7563,2981,366,20,80,100,8.122615803814714,54.560910319957834
Task_7564,687,1001,109,74,183,0.6856287425149701,20.886480376626494
Task_7565,1718,404,68,66,134,4.241975308641975,34.99152259541539
Task_7566,2528,86,95,172,267,29.057471264367816,47.10931925666262
Task_7567,2163,668,121,141,262,3.233183856502242,44.075582186128315
Task_7568,2170,815,117,179,296,2.659313725490196,44.8566900486721
Task_7569,1867,90,52,73,125,20.516483516483518,35.3892188063609
Task_7570,1278,811,109,96,205,1.5738916256157636,30.160949760617203
Task_7571,1004,938,90,71,161,1.0692225772097976,25.197157085724683
Task_7572,2358,474,112,154,266,4.96421052631579,46.58201939488606
Task_7573,2292,666,125,196,321,3.4362818590704647,46.45907260982049
Task_7574,1859,852,111,195,306,2.17936694021102,40.11324049275975
Task_7575,2543,722,85,198,283,3.5172890733056708,50.49055871258978
Task_7576,985,305,79,45,124,3.218954248366013,22.472903299956545
Task_7577,1072,594,182,161,343,1.8016806722689076,26.958644288626534
Task_7578,2934,238,186,54,240,12.276150627615063,54.15837440673503
Task_7579,1122,619,190,50,240,1.8096774193548386,26.564833096706312
Task_7580,2378,543,73,133,206,4.3713235294117645,46.94658706336663
Task_7581,2456,887,115,14,129,2.765765765765766,47.60013806588682
Task_7582,894,1015,195,58,253,0.8799212598425197,24.42310854933676
Task_7583,814,478,138,130,268,1.6993736951983298,22.114010476911222
Task_7584,693,669,48,20,68,1.0343283582089553,18.025169133885267
Task_7585,955,252,162,84,246,3.774703557312253,23.17606579970807
Task_7586,911,221,35,192,227,4.103603603603603,22.773421900431202
Task_7587,1564,99,147,181,328,15.64,32.330831195620824
Task_7588,1023,136,54,133,187,7.467153284671533,23.63708712944562
Task_7589,2956,117,44,190,234,25.050847457627118,54.12041801491475
Task_7590,1853,320,23,147,170,5.7725856697819315,37.55364653343241
Task_7591,1643,1000,132,161,293,1.6413586413586414,37.028657905633516
Task_7592,1462,570,195,24,219,2.5604203152364273,31.569622481146606
Task_7593,2457,111,19,195,214,21.9375,45.84294820200828
Task_7594,835,647,100,15,115,1.2885802469135803,20.86921848600642
Task_7595,1187,791,187,75,262,1.4987373737373737,28.50930464500837
Task_7596,2480,938,113,181,294,2.6411075612353567,50.146632085594355
Task_7597,1397,870,109,150,259,1.6039035591274398,32.55783413703878
Task_7598,1841,597,65,162,227,3.0785953177257523,38.75021023590493
Task_7599,2835,296,86,60,146,9.545454545454545,52.12865260929641
Task_7600,1224,648,96,137,233,1.8859784283513097,29.056424084424663
Task_7601,1193,856,172,21,193,1.3920653442240374,28.03293553697104
Task_7602,1649,471,160,71,231,3.4936440677966103,34.63401280973036
Task_7603,1766,102,38,147,185,17.145631067961165,34.686317585393404
Task_7604,2068,854,104,154,258,2.4187134502923975,43.15450132612532
Task_7605,914,517,200,70,270,1.7644787644787645,23.300418684977178
Task_7606,2530,761,122,17,139,3.320209973753281,48.26232056198071
Task_7607,1184,623,33,42,75,1.8974358974358974,25.8313481708806
Task_7608,1020,660,128,46,174,1.5431164901664145,24.63309475867239
Task_7609,1261,333,143,126,269,3.7754491017964074,28.738114632553053
Task_7610,2448,948,33,122,155,2.5795574288724974,48.69611006480044
Task_7611,508,198,135,173,308,2.5527638190954773,16.68909112154187
Task_7612,2835,521,96,137,233,5.431034482758621,54.16495487264916
Task_7613,2225,278,77,197,274,7.974910394265233,44.04708206394898
Task_7614,2234,585,56,82,138,3.8122866894197953,43.993031441231075
Task_7615,2319,765,183,66,249,3.0274151436031334,46.220461872644044
Task_7616,921,576,100,134,234,1.5961871750433276,23.966967542126536
Task_7617,1150,1017,92,157,249,1.1296660117878192,29.04567533605238
Task_7618,2960,500,15,11,26,5.908183632734531,53.12087213917152
Task_7619,2849,701,22,52,74,4.0584045584045585,52.70383005199122
Task_7620,1414,593,117,123,240,2.3804713804713806,31.851592166617397
Task_7621,1539,107,188,127,315,14.25,31.819022538111458
Task_7622,2964,744,43,75,118,3.978523489932886,55.813255855181694
Task_7623,2043,303,109,41,150,6.720394736842105,39.34639465392981
Task_7624,1487,819,75,80,155,1.8134146341463415,32.86443064051493
Task_7625,1806,917,88,114,202,1.9673202614379084,38.907902585266434
Task_7626,2772,236,37,149,186,11.69620253164557,51.83705796845852
Task_7627,2983,387,183,60,243,7.688144329896907,55.420464470431135
Task_7628,744,392,27,192,219,1.8931297709923665,20.660503651780996
Task_7629,1878,979,39,136,175,1.916326530612245,40.07953439377044
Task_7630,2396,518,185,179,364,4.616570327552987,47.80393725248209
Task_7631,1693,977,42,99,141,1.731083844580777,36.66889848072731
Task_7632,832,548,104,68,172,1.5154826958105647,21.557017124159724
Task_7633,1801,613,69,51,120,2.933224755700326,36.61553356679749
Task_7634,1693,140,39,142,181,12.00709219858156,33.94786353343026
Task_7635,2154,72,154,71,225,29.506849315068493,40.33749138642087
Task_7636,2066,985,22,195,217,2.0953346855983774,43.37551627396831
Task_7637,2752,75,39,80,119,36.21052631578947,49.197608155279276
Task_7638,803,306,45,110,155,2.6156351791530943,20.549594643684046
Task_7639,2495,85,121,48,169,29.011627906976745,45.024444163517764
Task_7640,2217,942,173,23,196,2.3510074231177094,44.596623987180514
Task_7641,2151,249,20,125,145,8.604,41.67984169870999
Task_7642,1355,269,195,51,246,5.018518518518518,29.332801168036028
Task_7643,2212,183,12,126,138,12.021739130434783,42.14875023964708
Task_7644,1265,613,185,106,291,2.060260586319218,29.75952946597046
Task_7645,727,409,25,77,102,1.773170731707317,19.01978887096119
Task_7646,2922,264,19,97,116,11.026415094339622,53.7084723740347
Task_7647,1418,185,50,119,169,7.623655913978495,30.054469268157707
Task_7648,2241,600,173,138,311,3.7287853577371046,45.31239449717233
Task_7649,758,482,28,153,181,1.5693581780538302,20.71820560143554
Task_7650,2969,776,122,140,262,3.821106821106821,57.18240098576183
Task_7651,1901,213,28,62,90,8.883177570093459,36.57122606420535
Task_7652,2013,1007,132,67,199,1.9970238095238095,41.924829710366275
Task_7653,855,643,69,47,116,1.3276397515527951,21.446291064940695
Task_7654,2238,1023,130,140,270,2.185546875,46.40815419243392
Task_7655,1048,155,168,79,247,6.717948717948718,24.023795701269837
Task_7656,2076,69,112,191,303,29.65714285714286,40.01661288745672
Task_7657,1467,810,117,39,156,1.8088779284833538,31.865120454825117
Task_7658,1299,960,16,38,54,1.3517169614984392,28.859897356470725
Task_7659,915,393,186,63,249,2.3223350253807107,22.8133907074165
Task_7660,738,390,193,102,295,1.8874680306905371,20.728912024072816
Task_7661,1508,418,106,91,197,3.5990453460620526,32.39846851885036
Task_7662,2755,205,184,84,268,13.37378640776699,51.532532703230146
Task_7663,952,586,122,136,258,1.6218057921635434,24.600165861248115
Task_7664,1775,718,88,200,288,2.4687065368567453,38.30992629253466
Task_7665,2777,417,171,130,301,6.643540669856459,53.14934673996021
Task_7666,2311,781,82,69,151,2.955242966751918,45.482201545282216
Task_7667,1712,859,198,32,230,1.9906976744186047,36.55445866871157
Task_7668,901,202,10,101,111,4.438423645320197,21.53790752817982
Task_7669,2570,179,116,118,234,14.277777777777779,48.314353714965016
Task_7670,670,747,161,22,183,0.8957219251336899,19.321324930418566
Task_7671,543,299,187,167,354,1.81,17.7182270205903
Task_7672,2661,565,181,40,221,4.701413427561837,50.617664542603414
Task_7673,1151,231,182,117,299,4.961206896551724,26.782865148591526
Task_7674,2017,810,185,66,251,2.4870530209617754,41.58582103820743
Task_7675,1567,220,53,191,244,7.090497737556561,33.34481034666984
Task_7676,1593,911,99,153,252,1.7467105263157894,35.76531943963747
Task_7677,2008,392,86,122,208,5.10941475826972,40.50930311560939
Task_7678,1004,494,30,63,93,2.0282828282828285,23.516556293256286
Task_7679,966,577,105,175,280,1.671280276816609,24.95011232747179
Task_7680,2754,744,102,147,249,3.6966442953020135,53.62712010132268
Task_7681,1490,142,57,106,163,10.41958041958042,30.73568532083574
Task_7682,1522,426,191,116,307,3.5644028103044496,33.32424589205702
Task_7683,2391,956,98,179,277,2.498432601880878,48.726809866706816
Task_7684,2950,442,200,187,387,6.659142212189616,56.44141049416148
Task_7685,842,491,95,122,217,1.7113821138211383,22.426505438645147
Task_7686,1678,1023,26,148,174,1.638671875,37.07849545271121
Task_7687,975,256,79,103,182,3.7937743190661477,23.486816001077756
Task_7688,2788,962,61,11,72,2.8951194184839046,52.01427248489861
Task_7689,2197,903,127,192,319,2.4303097345132745,45.681947823437525
Task_7690,744,645,56,16,72,1.151702786377709,18.759181282755023
Task_7691,799,976,149,34,183,0.8178096212896623,22.0798425486897
Task_7692,878,538,98,16,114,1.6289424860853432,21.306785169281977
Task_7693,1479,838,52,120,172,1.762812872467223,33.41979017339646
Task_7694,2518,302,200,93,293,8.310231023102311,48.50534166512764
Task_7695,1806,552,185,84,269,3.2658227848101267,37.709589694929996
Task_7696,2791,152,155,58,213,18.241830065359476,51.198692846311445
Task_7697,2402,113,84,179,263,21.07017543859649,45.44796864557133
Task_7698,836,916,160,184,344,0.9116684841875682,24.18653325053559
Task_7699,940,395,175,37,212,2.3737373737373737,22.807387178766607
Task_7700,1111,310,25,81,106,3.572347266881029,24.882887255371017
Task_7701,1915,953,110,163,273,2.007337526205451,41.11924109221663
Task_7702,1709,87,71,14,85,19.420454545454547,31.842236847959146
Task_7703,1083,221,147,167,314,4.878378378378378,25.815647321898677
Task_7704,1712,697,138,41,179,2.4527220630372493,35.63007960125616
Task_7705,1304,98,100,73,173,13.171717171717171,26.788467497127005
Task_7706,2800,933,168,104,272,2.9978586723768736,54.98969551433161
Task_7707,2559,976,89,126,215,2.6192425793244625,51.12012091551262
Task_7708,2557,607,88,20,108,4.2055921052631575,48.01100533218301
Task_7709,842,752,56,90,146,1.1181938911022575,22.35943349024097
Task_7710,2200,686,83,80,163,3.2023289665211063,43.80698695959359
Task_7711,699,242,164,117,281,2.876543209876543,19.598416747914392
Task_7712,2649,807,179,49,228,3.2784653465346536,51.299466191522356
Task_7713,2137,855,28,60,88,2.496495327102804,42.30223706912704
Task_7714,2283,840,138,26,164,2.714625445897741,45.110576449714436
Task_7715,1840,718,17,166,183,2.5591098748261474,38.55595887543395
Task_7716,2488,100,165,172,337,24.633663366336634,46.87687747510739
Task_7717,1113,938,12,65,77,1.1853035143769968,26.058647907941875
Task_7718,525,633,59,106,165,0.8280757097791798,17.446346231656687
Task_7719,1202,373,198,183,381,3.213903743315508,28.522417371445844
Task_7720,1104,621,161,186,347,1.77491961414791,27.590960571360753
Task_7721,764,136,129,20,149,5.576642335766423,18.114887650864844
Task_7722,586,364,164,25,189,1.6054794520547946,16.908552618907766
Task_7723,2491,821,90,191,281,3.0304136253041363,49.960494606971174
Task_7724,1036,543,106,20,126,1.9044117647058822,23.94359778785648
Task_7725,1598,852,127,112,239,1.873388042203986,35.55423138087209
Task_7726,590,601,119,174,293,0.9800664451827242,19.06405666854752
Task_7727,2719,269,26,177,203,10.07037037037037,51.388352038315105
Task_7728,1343,681,41,119,160,1.969208211143695,30.33254716602272
Task_7729,1423,646,28,90,118,2.1993817619783615,31.211658838541513
Task_7730,1834,460,175,94,269,3.9783080260303687,38.112410977634894
Task_7731,2074,735,24,171,195,2.817934782608696,42.66127165572948
Task_7732,2502,653,113,60,173,3.8256880733944953,48.26753771345002
Task_7733,2410,272,128,67,195,8.827838827838828,45.83436385625902
Task_7734,2392,750,81,144,225,3.18508655126498,47.902416964202736
Task_7735,2331,1022,10,84,94,2.278592375366569,46.34503244478473
Task_7736,786,289,181,110,291,2.7103448275862068,21.160449406935275
Task_7737,2064,995,114,102,216,2.072289156626506,43.26461712464501
Task_7738,1360,669,85,41,126,2.029850746268657,29.62731608000422
Task_7739,1104,729,123,193,316,1.5123287671232877,27.768489570491564
Task_7740,978,592,25,94,119,1.6492411467116357,24.09108283299919
Task_7741,1019,926,191,124,315,1.099244875943905,26.825109680457675
Task_7742,675,543,11,39,50,1.2408088235294117,17.47745895374974
Task_7743,2998,630,44,166,210,4.751188589540412,56.99615002192409
Task_7744,2493,374,51,199,250,6.648,48.579220073205356
Task_7745,1847,600,70,149,219,3.0732113144758735,38.81468865278444
Task_7746,2777,972,67,76,143,2.854059609455293,53.68905666790898
Task_7747,2398,458,57,54,111,5.224400871459695,45.44137211898333
Task_7748,2802,266,50,122,172,10.49438202247191,52.54565353885039
Task_7749,1735,681,133,14,147,2.5439882697947214,35.56468318751937
Task_7750,1039,708,61,108,169,1.465444287729196,25.799240758752273
Task_7751,1472,194,38,42,80,7.5487179487179485,29.446982977081415
Task_7752,697,892,66,69,135,0.780515117581187,20.398084611603814
Task_7753,755,891,198,134,332,0.8464125560538116,22.6851596097578
Task_7754,1232,583,196,88,284,2.1095890410958904,28.833129916600257
Task_7755,662,662,111,127,238,0.9984917043740573,20.056217177579065
Task_7756,812,637,103,126,229,1.2727272727272727,22.317718441073282
Task_7757,1078,152,70,60,130,7.045751633986928,23.569277420696
Task_7758,970,458,16,130,146,2.113289760348584,23.650374012847447
Task_7759,2694,948,92,161,253,2.838777660695469,53.432315611599876
Task_7760,1921,706,114,184,298,2.717114568599717,40.587071078957784
Task_7761,1338,656,69,81,150,2.036529680365297,29.928642269360154
Task_7762,2863,382,83,51,134,7.4751958224543085,52.839100492671
Task_7763,2369,968,190,172,362,2.4447884416924666,48.7745057683919
Task_7764,2934,235,54,161,215,12.432203389830509,54.80587270547945
Task_7765,1525,714,128,157,285,2.132867132867133,34.24104430635796
Task_7766,842,218,79,86,165,3.8447488584474887,21.04101525720942
Task_7767,731,911,22,112,134,0.8015350877192983,21.112188088234728
Task_7768,1635,496,33,92,125,3.289738430583501,34.27856344599545
Task_7769,2583,978,122,35,157,2.638406537282942,50.125934710267266
Task_7770,2931,848,76,90,166,3.452296819787986,56.12062657601158
Task_7771,838,350,109,33,142,2.3874643874643873,20.44679873036425
Task_7772,2553,935,53,41,94,2.7275641025641026,48.95767521881359
Task_7773,1126,239,64,86,150,4.691666666666666,25.289007945169207
Task_7774,2331,898,87,191,278,2.592880978865406,47.611890565698026
Task_7775,1190,1010,186,167,353,1.1770524233432245,30.091511284052796
Task_7776,1512,185,175,159,334,8.129032258064516,32.38649562270553
Task_7777,915,797,63,16,79,1.1466165413533835,22.123891728819185
Task_7778,2672,265,71,11,82,10.045112781954888,48.51661477560871
Task_7779,1619,96,170,151,321,16.690721649484537,33.00923653264632
Task_7780,753,877,193,37,230,0.857630979498861,21.470535738934146
Task_7781,1523,427,119,77,196,3.558411214953271,32.427200235356075
Task_7782,1785,440,102,162,264,4.0476190476190474,37.40523051285308
Task_7783,2645,676,132,10,142,3.9069423929098965,49.939634921229555
Task_7784,2219,1006,185,27,212,2.2035749751737836,44.90679357241652
Task_7785,838,942,22,34,56,0.8886532343584306,21.48708438659655
Task_7786,2307,287,180,33,213,8.010416666666666,44.06305860180098
Task_7787,601,572,71,115,186,1.0488656195462478,18.46002893987705
Task_7788,2820,804,138,121,259,3.5031055900621118,54.86859356615222
Task_7789,1822,221,13,155,168,8.207207207207206,36.68160142524799
Task_7790,1032,749,192,160,352,1.376,26.7782529649762
Task_7791,2067,293,120,65,185,7.030612244897959,40.29084686085091
Task_7792,1806,527,110,57,167,3.4204545454545454,36.75918774401315
Task_7793,2679,914,137,197,334,2.9278688524590164,53.42873548486305
Task_7794,2766,821,74,96,170,3.3649635036496353,53.612626088529474
Task_7795,2380,915,74,73,147,2.5982532751091703,47.199000966059835
Task_7796,1593,1017,177,58,235,1.5648330058939097,35.362351472606925
Task_7797,853,547,169,88,257,1.5565693430656935,22.558791986994276
Task_7798,636,470,79,125,204,1.3503184713375795,19.07147703625964
Task_7799,1765,333,68,40,108,5.2844311377245505,34.73075724464518
Task_7800,2128,867,24,44,68,2.4516129032258065,41.486704538133665
Task_7801,2490,253,200,84,284,9.803149606299213,47.604850020729636
Task_7802,1096,782,128,51,179,1.3997445721583652,26.355694720045083
Task_7803,1384,854,185,135,320,1.6187134502923977,32.555120576967255
Task_7804,2634,121,119,150,269,21.59016393442623,49.217916591525146
Task_7805,2819,852,83,191,274,3.3048065650644785,55.22731291054112
Task_7806,582,654,80,77,157,0.8885496183206106,17.914285629803295
Task_7807,2813,991,193,14,207,2.8356854838709675,54.128619681281755
Task_7808,862,629,77,71,148,1.3682539682539683,22.147456147891834
Task_7809,1557,604,34,120,154,2.5735537190082645,33.44114952100235
Task_7810,2059,394,148,187,335,5.2126582278481015,41.94846635399056
Task_7811,755,877,165,80,245,0.8599088838268792,21.95820803643681
Task_7812,1179,229,183,117,300,5.126086956521739,27.222783008874586
Task_7813,1305,239,166,195,361,5.4375,29.636614743051506
Task_7814,913,279,196,50,246,3.2607142857142857,22.20806278409141
Task_7815,2503,1006,75,98,173,2.4856007944389273,50.124499540789024
Task_7816,1573,346,75,120,195,4.53314121037464,33.509091211478164
Task_7817,548,997,111,36,147,0.5490981963927856,18.22662065550465
Task_7818,926,757,111,179,290,1.2216358839050132,24.817438744439457
Task_7819,1472,403,97,193,290,3.6435643564356437,32.51906522310808
Task_7820,960,664,111,190,301,1.443609022556391,25.187811630199956
Task_7821,1690,976,53,124,177,1.7297850562947799,37.109997618592395
Task_7822,2302,390,109,46,155,5.887468030690537,43.75875897542496
Task_7823,782,410,66,200,266,1.9026763990267639,21.623740879629946
Task_7824,1856,137,158,128,286,13.44927536231884,37.16619465836592
Task_7825,790,287,63,26,89,2.7430555555555554,18.83012479777942
Task_7826,2457,700,90,50,140,3.5049928673323825,47.251276323325555
Task_7827,1745,924,183,17,200,1.8864864864864865,36.91005510509189
Task_7828,2288,428,111,182,293,5.333333333333333,45.48707967841616
Task_7829,1906,94,196,62,258,20.063157894736843,36.665669793694654
Task_7830,1568,702,134,102,236,2.2304409672830725,34.58323137197894
Task_7831,710,484,198,165,363,1.4639175257731958,20.911011461201543
Task_7832,2030,135,85,106,191,14.926470588235293,39.398768947309094
Task_7833,2676,766,45,81,126,3.4889178617992176,51.459285288470056
Task_7834,1075,609,17,43,60,1.7622950819672132,24.031556301228605
Task_7835,1649,371,49,182,231,4.432795698924731,35.0710037807011
Task_7836,1997,905,89,86,175,2.204194260485651,41.40635498029629
Task_7837,1612,614,113,59,172,2.621138211382114,34.04077892122865
Task_7838,2138,400,124,155,279,5.331670822942644,42.91889967922045
Task_7839,2911,536,96,163,259,5.420856610800745,55.57211441011261
Task_7840,1926,604,189,56,245,3.183471074380165,39.49295171391067
Task_7841,1189,557,66,74,140,2.130824372759857,27.207254641021525
Task_7842,2236,342,59,82,141,6.518950437317784,43.24279744188805
Task_7843,522,736,137,108,245,0.7082767978290366,18.201290464165513
Task_7844,2672,190,83,11,94,13.989528795811518,48.50011811751946
Task_7845,2216,131,150,144,294,16.78787878787879,42.798318010854295
Task_7846,1937,956,52,130,182,2.0240334378265414,41.00613382263766
Task_7847,1521,171,137,41,178,8.843023255813954,30.599194883531837
Task_7848,708,354,142,116,258,1.9943661971830986,19.994391299064592
Task_7849,1071,649,90,67,157,1.6476923076923078,25.419811420447843
Task_7850,2483,862,105,105,210,2.877172653534183,49.46676883359252
Task_7851,2110,385,191,149,340,5.466321243523316,42.692626218118356
Task_7852,1214,419,14,48,62,2.8904761904761904,25.793190322609647
Task_7853,2793,566,98,110,208,4.925925925925926,53.45387088511618
Task_7854,1239,641,102,41,143,1.9299065420560748,27.70597002418333
Task_7855,1672,83,36,86,122,19.904761904761905,32.36301979810474
Task_7856,2290,915,58,135,193,2.5,46.69609347686626
Task_7857,1613,600,40,60,100,2.6838602329450914,33.31019289283048
Task_7858,687,647,186,86,272,1.0601851851851851,20.21169730664897
Task_7859,2460,176,14,21,35,13.898305084745763,44.08731325652499
Task_7860,1714,636,26,163,189,2.6907378335949765,36.58065230059933
Task_7861,1886,625,136,166,302,3.012779552715655,39.76975091949466
Task_7862,2939,200,156,159,315,14.621890547263682,55.03174117894677
Task_7863,934,1024,69,43,112,0.911219512195122,23.91168640103354
Task_7864,1290,469,86,174,260,2.74468085106383,29.70446686037974
Task_7865,1071,923,85,184,269,1.1590909090909092,27.60419077194318
Task_7866,504,524,36,33,69,0.96,14.850283452062953
Task_7867,592,834,144,79,223,0.7089820359281437,19.26571502686382
Task_7868,2643,849,137,124,261,3.1094117647058823,52.21888773739971
Task_7869,2659,76,120,74,194,34.532467532467535,48.14554682567525
Task_7870,2782,425,46,54,100,6.530516431924883,51.28006952208346
Task_7871,2299,187,76,151,227,12.22872340425532,44.727665957375194
Task_7872,2083,816,174,15,189,2.5495716034271725,41.90541775100878
Task_7873,718,503,170,192,362,1.4246031746031746,21.132038054867774
Task_7874,1487,174,142,154,296,8.497142857142856,31.54953938277545
Task_7875,1897,875,181,102,283,2.165525114155251,40.546987647600616
Task_7876,856,262,139,33,172,3.2547528517110265,20.78247802140889
Task_7877,1467,884,174,131,305,1.6576271186440679,33.88991140804067
Task_7878,2019,264,36,79,115,7.618867924528302,39.32049191654934
Task_7879,1149,220,62,46,108,5.199095022624435,24.47308291670606
Task_7880,893,188,126,49,175,4.724867724867725,21.3328382770552
Task_7881,1026,526,14,54,68,1.9468690702087286,23.347814379025493
Task_7882,1424,718,128,122,250,1.9805285118219749,32.444550760359874
Task_7883,1797,923,124,160,284,1.9448051948051948,39.201335539685424
Task_7884,2419,301,45,90,135,8.009933774834437,45.932529530485375
Task_7885,2274,944,75,14,89,2.4063492063492062,44.46027378677959
Task_7886,2525,130,42,176,218,19.27480916030534,47.355122621632994
Task_7887,1237,652,47,105,152,1.894333843797856,28.509818581671993
Task_7888,970,698,80,48,128,1.3876967095851216,23.760375840088727
Task_7889,2460,509,109,80,189,4.823529411764706,47.537139473979884
Task_7890,2342,522,119,160,279,4.478011472275335,46.550878090557426
Task_7891,2169,754,81,70,151,2.8728476821192053,43.168539018583864
Task_7892,2747,102,20,76,96,26.66990291262136,48.86863192457732
Task_7893,1965,686,70,85,155,2.8602620087336246,40.049998697282525
Task_7894,1841,561,69,66,135,3.275800711743772,37.43501335126347
Task_7895,2164,841,86,171,257,2.5700712589073635,44.69742134295928
Task_7896,814,575,100,163,263,1.4131944444444444,22.387726338065132
Task_7897,921,733,174,197,371,1.2547683923705721,25.055251398238315
Task_7898,2715,818,191,124,315,3.3150183150183152,53.50581332318891
Task_7899,514,187,86,180,266,2.734042553191489,16.683714456356906
Task_7900,1064,850,47,62,109,1.2502937720329024,25.493486791511497
Task_7901,1531,522,137,200,337,2.9273422562141493,34.03063016478281
Task_7902,656,268,99,91,190,2.4386617100371746,18.39889756991054
Task_7903,862,701,178,169,347,1.227920227920228,23.872141916788767
Task_7904,2993,931,124,67,191,3.21137339055794,57.17947124758057
Task_7905,2817,944,105,133,238,2.980952380952381,55.182729382885306
Task_7906,862,596,46,115,161,1.4438860971524288,22.360554429709868
Task_7907,1883,229,70,175,245,8.18695652173913,38.31954608052754
Task_7908,1673,664,164,41,205,2.5157894736842104,35.208115045725386
Task_7909,643,958,161,33,194,0.670490093847758,20.069602856879595
Task_7910,2744,360,135,131,266,7.6011080332409975,52.27921763633319
Task_7911,2095,350,26,157,183,5.968660968660969,41.50550917676427
Task_7912,995,713,141,74,215,1.3935574229691876,24.99216508580773
Task_7913,2240,220,128,26,154,10.135746606334841,42.15182783586253
Task_7914,2039,720,172,167,339,2.828016643550624,42.66005763358749
Task_7915,1046,952,42,116,158,1.0975865687303252,26.201417537962914
Task_7916,2041,614,184,53,237,3.31869918699187,41.32380043984196
Task_7917,581,446,99,135,234,1.2997762863534676,18.103002165185305
Task_7918,2338,762,27,24,51,3.0642201834862384,44.523337038395404
Task_7919,2937,585,112,85,197,5.011945392491468,55.420272934765656
Task_7920,1676,123,182,65,247,13.516129032258064,33.57057371828868
Task_7921,2803,482,74,32,106,5.803312629399586,51.656921993599866
Task_7922,1708,951,112,98,210,1.7941176470588236,37.45691657728926
Task_7923,2439,178,105,32,137,13.625698324022347,44.85571431684118
Task_7924,2715,342,40,154,194,7.915451895043732,51.48051840676292
Task_7925,576,966,97,12,109,0.5956566701137539,18.12822488748824
Task_7926,1431,987,136,194,330,1.4483805668016194,33.78903578265666
Task_7927,1280,621,109,77,186,2.057877813504823,28.997383164668012
Task_7928,753,914,158,182,340,0.8229508196721311,22.830958090406472
Task_7929,1584,320,107,193,300,4.934579439252336,34.04149372179128
Task_7930,2519,584,192,62,254,4.305982905982906,48.802968387234024
Task_7931,2839,256,183,134,317,11.04669260700389,53.646344810929406
Task_7932,1531,908,51,46,97,1.6842684268426842,32.72022529480435
Task_7933,2504,403,159,113,272,6.198019801980198,48.62714315487045
Task_7934,2044,524,114,164,278,3.8933333333333335,41.8404848383885
Task_7935,826,766,123,44,167,1.0769230769230769,21.70328971986595
Task_7936,1379,360,54,159,213,3.8199445983379503,30.647341248932985
Task_7937,2701,431,102,53,155,6.252314814814815,50.538943208970295
Task_7938,2463,376,87,72,159,6.5331564986737405,46.59670795250239
Task_7939,1805,273,81,68,149,6.587591240875913,35.90237891032122
Task_7940,2164,67,104,57,161,31.823529411764707,39.83563407027538
Task_7941,1467,191,189,166,355,7.640625,31.944352980364652
Task_7942,913,915,181,103,284,0.9967248908296943,24.988029002470103
Task_7943,2603,230,36,23,59,11.268398268398268,46.88567198313407
Task_7944,765,536,88,114,202,1.4245810055865922,21.160684711138934
Task_7945,536,593,184,62,246,0.9023569023569024,17.446583799694277
Task_7946,1734,457,116,195,311,3.7860262008733625,36.91283694262582
Task_7947,2384,195,191,196,387,12.16326530612245,46.57083611913918
Task_7948,1976,220,138,175,313,8.941176470588236,39.92128070737615
Task_7949,2255,698,185,49,234,3.2260371959942775,44.74217951892323
Task_7950,1630,176,169,156,325,9.209039548022599,33.910121304258716
Task_7951,2958,130,38,155,193,22.580152671755727,54.01357834099923
Task_7952,2397,152,78,174,252,15.666666666666666,45.83576429191743
Task_7953,2557,563,64,15,79,4.533687943262412,47.21095283494088
Task_7954,768,909,164,94,258,0.843956043956044,22.499107663504816
Task_7955,2043,814,98,151,249,2.506748466257669,42.602479604020765
Task_7956,1688,946,18,128,146,1.7824709609292502,36.54509103288239
Task_7957,1687,91,118,148,266,18.33695652173913,33.906111520809354
Task_7958,1716,719,130,85,215,2.3833333333333333,36.5864495715093
Task_7959,587,511,97,151,248,1.146484375,18.507004728046102
Task_7960,1284,263,33,24,57,4.863636363636363,26.273868711625354
Task_7961,1791,900,40,175,215,1.9877913429522753,38.75816932590867
Task_7962,1985,582,133,12,145,3.404802744425386,39.30935102787398
Task_7963,1382,240,32,133,165,5.734439834024896,29.84971106565513
Task_7964,1872,962,109,154,263,1.9439252336448598,40.407555429230804
Task_7965,1829,105,131,156,287,17.254716981132077,36.28208088102468
Task_7966,2148,533,16,20,36,4.022471910112359,40.29206284630521
Task_7967,2538,111,124,74,198,22.660714285714285,46.57015093346726
Task_7968,2310,387,184,104,288,5.953608247422681,45.563326525897594
Task_7969,1422,705,67,101,168,2.0141643059490084,31.9059759200852
Task_7970,2716,282,57,89,146,9.597173144876326,50.70160913923263
Task_7971,581,75,73,134,207,7.644736842105263,16.238807384645554
Task_7972,1247,234,185,138,323,5.306382978723405,28.4484364133622
Task_7973,1592,981,124,142,266,1.6211812627291242,36.01199809504413
Task_7974,1814,646,125,163,288,2.80370942812983,38.628010503618306
Task_7975,1733,705,173,182,355,2.454674220963173,37.85989746399858
Task_7976,1622,262,45,191,236,6.167300380228137,34.1552679954449
Task_7977,1512,371,115,11,126,4.064516129032258,31.00427951659323
Task_7978,1811,243,86,175,261,7.422131147540983,37.206251843762566
Task_7979,1122,614,17,131,148,1.824390243902439,26.507213626040357
Task_7980,1810,586,155,83,238,3.0834752981260647,37.73964605955439
Task_7981,1706,700,79,121,200,2.433666191155492,36.7592549403789
Task_7982,1921,116,117,77,194,16.418803418803417,37.083389041192646
Task_7983,1004,796,40,61,101,1.2597239648682559,24.247778719739667
Task_7984,1097,565,94,90,184,1.9381625441696113,26.16398794108809
Task_7985,2852,762,169,17,186,3.7378768020969857,53.72832752310635
Task_7986,2471,376,116,170,286,6.554376657824934,48.16167943285763
Task_7987,2742,917,117,29,146,2.9869281045751634,52.47069008179528
Task_7988,758,745,150,131,281,1.0160857908847185,21.995264406577235
Task_7989,576,191,170,84,254,3.0,17.095973483245874
Task_7990,2835,362,157,100,257,7.809917355371901,53.63958671799829
Task_7991,1104,564,68,142,210,1.9539823008849557,26.866517464206783
Task_7992,878,943,128,61,189,0.9300847457627118,23.630029554353218
Task_7993,2948,997,111,38,149,2.9539078156312626,55.97441068072725
Task_7994,1231,397,141,168,309,3.092964824120603,28.71165502193651
Task_7995,650,781,189,198,387,0.8312020460358056,21.023216496118135
Task_7996,1757,450,174,10,184,3.895787139689579,35.433365608849655
Task_7997,1022,513,19,70,89,1.9883268482490273,23.731585682028577
Task_7998,867,338,85,52,137,2.5575221238938055,21.16595543089235
Task_7999,2751,479,57,98,155,5.73125,52.081476158617214
Task_8000,2475,727,142,124,266,3.3997252747252746,49.19670358760518
Task_8001,1639,408,48,159,207,4.007334963325183,34.85350752635447
Task_8002,663,981,176,145,321,0.675152749490835,21.617958760777345
Task_8003,510,312,100,66,166,1.6293929712460065,15.637381881805785
Task_8004,504,72,76,26,102,6.904109589041096,12.872263944259977
Task_8005,2878,988,41,38,79,2.910010111223458,53.951788439720325
Task_8006,2504,985,195,87,282,2.5395537525354968,50.22739525427059
Task_8007,2659,658,154,125,279,4.034901365705615,51.953305982464634
Task_8008,2422,182,165,105,270,13.234972677595628,46.35188865630116
Task_8009,1316,537,94,182,276,2.446096654275093,30.456315355501136
Task_8010,764,572,22,122,144,1.3333333333333333,20.665868057636857
Task_8011,1154,388,73,74,147,2.966580976863753,26.171587428849815
Task_8012,2111,213,95,77,172,9.86448598130841,40.872749772083466
Task_8013,1502,679,186,145,331,2.208823529411765,33.95709875870148
Task_8014,1069,161,122,99,221,6.598765432098766,24.558572293303882
Task_8015,1075,343,164,136,300,3.125,25.983012405547953
Task_8016,1514,746,175,66,241,2.0267737617135206,33.37219505798532
Task_8017,1817,476,124,101,225,3.809224318658281,37.762112840486594
Task_8018,1519,586,85,194,279,2.5877342419080067,33.81956449913439
Task_8019,2564,358,55,13,68,7.142061281337047,46.52788037208436
Task_8020,2812,935,117,154,271,3.0042735042735043,55.254886508841516
Task_8021,2132,985,84,166,250,2.162271805273834,44.605490484082765
Task_8022,838,371,142,75,217,2.252688172043011,21.495640064352628
Task_8023,839,206,133,113,246,4.053140096618358,21.52635333867201
Task_8024,2107,944,114,170,284,2.22962962962963,44.19355360541491
Task_8025,2404,464,172,189,361,5.16989247311828,47.757191997202064
Task_8026,1686,187,79,152,231,8.96808510638298,35.06169677980279
Task_8027,1615,722,46,14,60,2.2337482710926695,32.66396663832839
Task_8028,977,910,67,153,220,1.0724478594950604,25.797821350453642
Task_8029,2644,252,173,128,301,10.450592885375494,50.469279348087504
Task_8030,1091,136,51,166,217,7.963503649635037,24.999620960551468
Task_8031,2907,458,29,26,55,6.333333333333333,52.587241507474744
Task_8032,977,158,88,76,164,6.144654088050315,22.39997540975479
Task_8033,899,110,143,112,255,8.0990990990991,21.50252596897621
Task_8034,1243,520,186,60,246,2.385796545105566,28.325277641422062
Task_8035,547,74,176,197,373,7.293333333333333,16.465725668791332
Task_8036,2454,850,80,55,135,2.883666274970623,48.00263386250325
Task_8037,2176,669,114,83,197,3.2477611940298505,43.61330535383001
Task_8038,2599,354,183,32,215,7.32112676056338,48.92011256133991
Task_8039,920,228,104,107,211,4.0174672489082965,22.71291635905706
Task_8040,2757,685,85,186,271,4.018950437317784,53.6918269291622
Task_8041,2443,764,125,65,190,3.193464052287582,47.92383727744271
Task_8042,2541,230,104,93,197,11.0,48.17372659018909
Task_8043,717,921,83,182,265,0.7776572668112798,21.98222013320193
Task_8044,2714,496,93,71,164,5.4607645875251505,51.29129410077265
Task_8045,642,983,101,11,112,0.6524390243902439,19.2304038165363
Task_8046,1557,656,46,116,162,2.3698630136986303,33.706594229324544
Task_8047,2251,325,27,79,106,6.904907975460123,42.96952368028911
Task_8048,1431,893,87,88,175,1.6006711409395973,32.391864104937326
Task_8049,2871,105,79,18,97,27.08490566037736,50.512375530769695
Task_8050,2651,382,149,125,274,6.921671018276762,50.909597926869424
Task_8051,1590,894,182,92,274,1.776536312849162,35.572316166420656
Task_8052,820,478,136,48,184,1.7118997912317329,20.84355653929821
Task_8053,1612,216,73,15,88,7.428571428571429,31.642622046891177
Task_8054,972,506,182,180,362,1.9171597633136095,25.213397088119333
Task_8055,573,873,173,128,301,0.6556064073226545,19.745708375504055
Task_8056,2397,862,88,89,177,2.777520278099652,47.58396668251432
Task_8057,1731,491,109,20,129,3.518292682926829,34.84601528681072
Task_8058,1891,340,110,71,181,5.545454545454546,37.61723771420475
Task_8059,2487,372,158,175,333,6.6675603217158175,48.62056165550092
Task_8060,2722,201,58,166,224,13.475247524752476,51.36531312172088
Task_8061,1079,608,61,151,212,1.7717569786535303,26.622687472550655
Task_8062,1967,479,75,37,112,4.097916666666666,38.521465648481566
Task_8063,2416,511,121,33,154,4.71875,45.97067387779585
Task_8064,2598,189,135,171,306,13.673684210526316,49.59494068300356
Task_8065,2431,990,159,53,212,2.453077699293643,48.567596767972674
Task_8066,1059,765,187,80,267,1.3825065274151436,26.474122478451463
Task_8067,2089,137,97,141,238,15.13768115942029,40.65850958215682
Task_8068,1338,261,36,125,161,5.106870229007634,28.939781820569674
Task_8069,2106,785,121,171,292,2.6793893129770994,43.719138082457455
Task_8070,2540,339,84,131,215,7.470588235294118,48.79814070315164
Task_8071,2730,280,43,88,131,9.715302491103202,50.783499158610404
Task_8072,1221,963,63,143,206,1.266597510373444,29.83180933406415
Task_8073,1996,173,21,42,63,11.471264367816092,37.13760656413885
Task_8074,2339,342,165,197,362,6.819241982507289,46.3411748916323
Task_8075,694,498,19,127,146,1.3907815631262526,19.322952519069982
Task_8076,989,101,34,170,204,9.696078431372548,22.76090543544973
Task_8077,2845,541,25,69,94,5.249077490774908,52.796003550556485
Task_8078,1270,182,111,118,229,6.939890710382514,28.011355207138166
Task_8079,1965,706,84,79,163,2.7793493635077793,40.11724399513352
Task_8080,957,830,139,32,171,1.151624548736462,24.061418649649365
Task_8081,2989,260,48,170,218,11.452107279693486,55.76157393990948
Task_8082,1414,100,12,134,146,14.0,28.62595248396803
Task_8083,2728,585,101,197,298,4.6552901023890785,53.00474184319237
Task_8084,1123,144,108,170,278,7.744827586206896,25.736833850315517
Task_8085,2945,929,135,198,333,3.1666666666666665,57.687563484331825
Task_8086,953,989,62,136,198,0.9626262626262626,25.594162629217617
Task_8087,2142,734,135,195,330,2.914285714285714,44.336102538339254
Task_8088,2330,512,66,45,111,4.541910331384016,44.238042253216896
Task_8089,2516,629,110,181,291,3.9936507936507937,49.73256656245803
Task_8090,767,722,150,103,253,1.0608575380359613,21.89834652611695
Task_8091,2006,239,135,104,239,8.358333333333333,40.02717199213786
Task_8092,1870,809,43,175,218,2.308641975308642,39.741151888073574
Task_8093,823,94,145,135,280,8.663157894736843,20.304756123179445
Task_8094,2187,603,75,126,201,3.620860927152318,44.08942103892201
Task_8095,1933,320,188,101,289,6.021806853582555,39.37604294200053
Task_8096,1096,238,26,50,76,4.585774058577406,23.24272408295002
Task_8097,906,627,28,165,193,1.4426751592356688,23.693416744538467
Task_8098,1675,238,10,127,137,7.00836820083682,34.08112547801523
Task_8099,2256,88,198,29,227,25.348314606741575,41.84009941340178
Task_8100,1405,944,30,139,169,1.4867724867724867,32.323820819427496
Task_8101,1840,539,80,165,245,3.4074074074074074,38.63828485550223
Task_8102,1893,874,104,79,183,2.1634285714285713,39.50821994125575
Task_8103,741,505,117,99,216,1.4644268774703557,20.69324766375531
Task_8104,1201,758,174,121,295,1.5823451910408433,29.195070582558397
Task_8105,2485,815,180,86,266,3.045343137254902,49.311762975755904
Task_8106,2375,937,80,106,186,2.5319829424307034,47.876253569340804
Task_8107,2881,863,97,144,241,3.334490740740741,55.996601707892296
Task_8108,2637,986,29,30,59,2.6717325227963524,49.92798315628057
Task_8109,2322,349,104,148,252,6.634285714285714,45.52834148986176
Task_8110,1782,987,55,184,239,1.8036437246963564,39.15348500250881
Task_8111,1789,676,119,123,242,2.642540620384047,38.060280723100824
Task_8112,812,848,129,42,171,0.9564193168433451,21.866541541223473
Task_8113,992,869,183,165,348,1.1402298850574712,26.492158105874054
Task_8114,2455,807,36,108,144,3.0383663366336635,48.27279791852674
Task_8115,2503,365,129,79,208,6.83879781420765,47.85320681309181
Task_8116,1697,250,183,164,347,6.760956175298805,35.75927223092764
Task_8117,1992,374,127,163,290,5.312,40.58458828383447
Task_8118,1759,832,192,128,320,2.1116446578631454,38.43140458494391
Task_8119,1712,466,25,156,181,3.6659528907922914,35.8202062558082
Task_8120,1415,411,181,110,291,3.4344660194174756,31.501935093903356
Task_8121,2134,81,67,190,257,26.024390243902438,40.91012551541615
Task_8122,907,869,83,107,190,1.042528735632184,24.281790242577063
Task_8123,2723,773,128,138,266,3.5180878552971575,53.290800068776946
Task_8124,761,607,125,92,217,1.2516447368421053,21.176650822926725
Task_8125,2254,867,79,106,185,2.596774193548387,45.74355076248179
Task_8126,775,120,156,185,341,6.404958677685951,20.342129607663548
Task_8127,1647,720,131,125,256,2.2843273231622745,36.01475676790786
Task_8128,2473,396,41,54,95,6.2292191435768265,46.293347193978825
Task_8129,744,113,56,22,78,6.526315789473684,16.864139338791457
Task_8130,2894,556,59,51,110,5.195691202872531,53.57370501504527
Task_8131,2166,102,166,71,237,21.02912621359223,40.82958298200392
Task_8132,2691,225,76,189,265,11.9070796460177,51.17422460469687
Task_8133,2883,1010,69,67,136,2.851632047477745,55.37213955980136
Task_8134,2615,544,175,57,232,4.798165137614679,50.081346526247636
Task_8135,2335,225,168,95,263,10.331858407079647,45.238736967985346
Task_8136,1648,345,61,199,260,4.763005780346821,35.09279855906552
Task_8137,2596,797,98,113,211,3.2531328320802007,51.08358614919009
Task_8138,2681,986,89,79,168,2.7163120567375887,52.3243761134668
Task_8139,772,667,134,57,191,1.155688622754491,21.105623163530698
Task_8140,2461,534,37,171,208,4.6,48.18965546137688
Task_8141,2065,648,189,120,309,3.1818181818181817,42.6413788271349
Task_8142,1629,378,73,35,108,4.298153034300792,32.80222910169347
Task_8143,723,581,174,55,229,1.2422680412371134,20.254111972046058
Task_8144,607,565,159,180,339,1.0724381625441697,19.37009800250141
Task_8145,834,764,84,17,101,1.0901960784313725,21.105246115917083
Task_8146,2799,332,133,24,157,8.405405405405405,51.39850620664959
Task_8147,1828,1011,97,140,237,1.8063241106719368,39.74843506907526
Task_8148,2946,702,191,189,380,4.190611664295875,57.18782035334116
Task_8149,2344,802,25,15,40,2.9190535491905356,44.33486152601227
Task_8150,896,552,129,154,283,1.620253164556962,23.74637316145106
Task_8151,573,335,177,142,319,1.7053571428571428,18.09865234828148
Task_8152,1376,910,162,153,315,1.5104281009879255,32.57670400475886
Task_8153,2030,440,79,89,168,4.603174603174603,40.491847937542
Task_8154,1843,613,43,190,233,3.001628664495114,38.7887557921707
Task_8155,1770,403,58,168,226,4.381188118811881,37.04031933778983
Task_8156,2486,626,151,43,194,3.9649122807017543,47.91221734113338
Task_8157,2420,842,12,32,44,2.870699881376038,45.93200318596329
Task_8158,2857,73,153,39,192,38.608108108108105,50.67723725448288
Task_8159,2059,239,171,105,276,8.579166666666667,41.032649366165025
Task_8160,767,287,126,23,149,2.6631944444444446,19.114125733570333
Task_8161,1870,275,78,36,114,6.77536231884058,36.377085916783024
Task_8162,1026,816,61,147,208,1.255813953488372,26.27200558933581
Task_8163,2729,202,72,86,158,13.443349753694582,50.52272238693984
Task_8164,1790,452,21,163,184,3.9514348785871967,36.97415360091296
Task_8165,2353,995,142,168,310,2.362449799196787,48.36480343825488
Task_8166,2344,522,28,158,186,4.4818355640535374,46.07510488507936
Task_8167,2901,702,69,64,133,4.126600284495021,54.689800149952525
Task_8168,2874,626,67,154,221,4.583732057416268,55.16006557646435
Task_8169,2980,221,188,84,272,13.423423423423424,55.168110160167174
Task_8170,1871,151,126,91,217,12.30921052631579,36.97498374313694
Task_8171,2842,924,144,43,187,3.0724324324324326,54.417883922799824
Task_8172,2654,244,102,49,151,10.83265306122449,48.88781113612841
Task_8173,2127,509,27,72,99,4.170588235294118,41.364468819497624
Task_8174,2099,152,56,187,243,13.718954248366012,41.1144336146996
Task_8175,967,69,32,118,150,13.814285714285715,21.438608635409548
Task_8176,2126,463,172,187,359,4.581896551724138,43.34157767015099
Task_8177,2369,247,31,139,170,9.55241935483871,45.38213836452625
Task_8178,2623,888,11,156,167,2.9505061867266593,51.46262431725733
Task_8179,1798,435,26,158,184,4.123853211009174,37.09923199874199
Task_8180,986,178,136,103,239,5.5083798882681565,23.314260985686982
Task_8181,1097,243,38,83,121,4.495901639344262,24.718219394515828
Task_8182,700,224,94,113,207,3.111111111111111,19.299631996728184
Task_8183,905,309,23,44,67,2.9193548387096775,20.442333810197244
Task_8184,1923,254,76,85,161,7.541176470588235,37.99353622024156
Task_8185,1003,570,177,85,262,1.7565674255691768,25.03040016195894
Task_8186,842,497,87,45,132,1.6907630522088353,20.90570214321207
Task_8187,1656,994,98,142,240,1.664321608040201,36.96324548819822
Task_8188,1654,985,80,37,117,1.6774847870182557,35.20203396452753
Task_8189,821,853,64,109,173,0.9613583138173302,22.848364672766753
Task_8190,2947,410,120,33,153,7.170316301703163,54.0338442001022
Task_8191,2259,554,144,46,190,4.07027027027027,44.054693583705536
Task_8192,1327,819,136,188,324,1.6182926829268294,31.639029898304056
Task_8193,512,887,36,38,74,0.5765765765765766,16.131793645593127
Task_8194,2194,351,77,93,170,6.232954545454546,42.920843097506975
Task_8195,2916,810,110,166,276,3.595561035758323,56.55100220396256
Task_8196,2651,70,38,188,226,37.33802816901409,48.713222212335324
Task_8197,1268,656,150,17,167,1.9299847792998477,28.182329192190014
Task_8198,2671,280,28,163,191,9.505338078291816,50.59505754116171
Task_8199,1609,774,58,180,238,2.0761290322580646,35.73536652071884
Task_8200,2313,391,200,88,288,5.900510204081633,45.34864543979284
Task_8201,2029,711,76,12,88,2.8497191011235956,39.87102439095805
Task_8202,2930,319,117,100,217,9.15625,54.81282636684053
Task_8203,823,964,89,66,155,0.8528497409326425,22.420953833113504
Task_8204,1073,321,173,13,186,3.3322981366459627,24.24517410134121
Task_8205,2899,787,163,90,253,3.6789340101522843,55.829418044257864
Task_8206,508,820,50,104,154,0.6187576126674786,17.747562637913042
Task_8207,1198,342,88,124,212,3.492711370262391,27.53067584604644
Task_8208,2602,217,62,198,260,11.935779816513762,49.71782978635613
Task_8209,2140,312,103,82,185,6.8370607028754,41.69195125866685
Task_8210,1051,941,73,112,185,1.115711252653928,26.721694049669722
Task_8211,1956,262,104,20,124,7.437262357414449,37.50460585830476
Task_8212,917,275,178,70,248,3.322463768115942,22.488797673366275
Task_8213,2131,793,142,169,311,2.6838790931989926,44.22294263772727
Task_8214,1599,705,99,99,198,2.264872521246459,34.89488692173655
Task_8215,1571,766,162,23,185,2.048239895697523,33.62916431132006
Task_8216,1545,229,64,193,257,6.717391304347826,33.04909520265675
Task_8217,984,201,100,193,293,4.871287128712871,24.127300804877063
Task_8218,1177,1009,86,21,107,1.1653465346534653,27.570001309054064
Task_8219,1041,866,163,91,254,1.2006920415224913,26.57660617345176
Task_8220,2692,770,93,18,111,3.4915693904020753,50.76145733529688
Task_8221,2690,611,160,187,347,4.395424836601308,52.69219651122743
Task_8222,732,609,192,156,348,1.2,21.55409125003639
Task_8223,716,901,109,154,263,0.7937915742793792,21.86382686881629
Task_8224,1597,322,181,51,232,4.944272445820434,33.272660075288336
Task_8225,2480,731,89,151,240,3.387978142076503,49.25070144127816
Task_8226,591,855,110,18,128,0.6904205607476636,18.256263551721016
Task_8227,543,724,24,149,173,0.7489655172413793,17.99988712544242
Task_8228,2351,813,119,90,209,2.888206388206388,47.03071881541473
Task_8229,2820,193,79,77,156,14.536082474226804,51.89074679038119
Task_8230,2432,247,69,84,153,9.806451612903226,45.91574335368941
Task_8231,2208,868,183,108,291,2.5408515535097815,45.497724374948355
Task_8232,2825,626,12,19,31,4.505582137161085,51.353610618077816
Task_8233,1661,355,65,71,136,4.665730337078652,33.977351016877066
Task_8234,1492,297,164,146,310,5.006711409395973,32.48642145185142
Task_8235,2995,953,96,112,208,3.139412997903564,57.91834212289066
Task_8236,2026,731,125,38,163,2.76775956284153,40.7036586326494
Task_8237,895,66,177,81,258,13.35820895522388,21.006864756038905
Task_8238,982,732,146,71,217,1.339699863574352,24.81101513979547
Task_8239,2368,967,41,99,140,2.446280991735537,47.33699293912452
Task_8240,503,814,133,55,188,0.6171779141104294,17.56921109910876
Task_8241,1660,993,12,146,158,1.6700201207243461,36.33990730599621
Task_8242,1927,536,184,182,366,3.5884543761638734,40.449253906012615
Task_8243,1087,287,147,37,184,3.7743055555555554,24.48012240135208
Task_8244,2611,479,199,67,266,5.439583333333333,50.034710582584694
Task_8245,1896,988,135,33,168,1.9170879676440848,39.391955654707054
Task_8246,2904,565,197,14,211,5.130742049469965,54.243890933125016
Task_8247,1394,477,23,30,53,2.916317991631799,28.800294605012322
Task_8248,781,165,172,71,243,4.704819277108434,19.75424614246693
Task_8249,2826,789,122,73,195,3.5772151898734177,54.148824952841636
Task_8250,2917,114,118,35,153,25.36521739130435,51.89000356243977
Task_8251,512,729,91,32,123,0.7013698630136986,16.596245821149925
Task_8252,614,529,94,36,130,1.1584905660377358,17.6303062150678
Task_8253,2268,477,123,137,260,4.7447698744769875,45.115088509660005
Task_8254,1853,92,119,133,252,19.9247311827957,36.42253436519764
Task_8255,1050,805,194,156,350,1.3027295285359801,27.223772485880744
Task_8256,1891,995,75,59,134,1.8985943775100402,39.48389216581537
Task_8257,1439,496,32,118,150,2.8953722334004026,31.2318486992322
Task_8258,1776,64,89,12,101,27.323076923076922,32.592948668237504
Task_8259,556,178,76,111,187,3.106145251396648,16.36919789691191
Task_8260,1872,421,193,168,361,4.436018957345971,39.16672414145911
Task_8261,657,499,170,29,199,1.314,18.60367020826256
Task_8262,986,138,139,59,198,7.093525179856115,22.53475103360284
Task_8263,1292,185,171,107,278,6.946236559139785,28.586685857658228
Task_8264,954,283,111,192,303,3.359154929577465,23.971015801466155
Task_8265,597,499,151,133,284,1.194,18.752245846711336
Task_8266,1625,394,52,170,222,4.113924050632911,34.71690206446806
Task_8267,2457,629,129,170,299,3.9,48.81806913694013
Task_8268,2054,970,49,99,148,2.1153450051493308,42.54378689532072
Task_8269,2035,496,163,66,229,4.094567404426559,40.781199770861114
Task_8270,2743,872,92,50,142,3.1420389461626574,52.41818098186861
Task_8271,963,684,69,173,242,1.4058394160583942,25.126760962417475
Task_8272,1319,747,14,125,139,1.7633689839572193,30.087909628094383
Task_8273,699,364,106,198,304,1.915068493150685,20.21115793498326
Task_8274,2091,959,134,85,219,2.178125,43.294352388587185
Task_8275,3000,996,66,186,252,3.009027081243731,58.508533317872114
Task_8276,1486,925,185,172,357,1.6047516198704104,34.61269865979738
Task_8277,2687,195,81,16,97,13.709183673469388,48.67069352629654
Task_8278,1087,937,138,85,223,1.1588486140724947,27.261755562801834
Task_8279,2440,997,32,103,135,2.444889779559118,48.61843962189996
Task_8280,509,448,130,139,269,1.133630289532294,17.141613891109646
Task_8281,2066,888,27,175,202,2.3239595050618673,43.04817998227414
Task_8282,1197,393,177,161,338,3.0380710659898478,28.281326952161862
Task_8283,878,655,194,195,389,1.3384146341463414,24.292881586487308
Task_8284,1802,760,114,22,136,2.3679369250985545,36.944531960526994
Task_8285,1091,350,103,64,167,3.1082621082621085,24.92587843411407
Task_8286,1178,133,146,148,294,8.791044776119403,26.469944156941413
Task_8287,2820,308,172,50,222,9.12621359223301,52.34703782879129
Task_8288,1187,988,93,48,141,1.2002022244691608,28.13053614675429
Task_8289,2198,652,13,187,200,3.3660030627871365,44.42343729581719
Task_8290,947,821,196,118,314,1.1520681265206814,25.40838866302418
Task_8291,815,103,128,197,325,7.836538461538462,20.582072795924024
Task_8292,1895,537,149,29,178,3.5223048327137545,38.03537604737837
Task_8293,2169,981,155,134,289,2.208757637474542,45.26092813234029
Task_8294,1493,273,177,78,255,5.4489051094890515,31.776168299902608
Task_8295,1589,552,75,100,175,2.8734177215189876,34.23724077429636
Task_8296,2727,536,196,116,312,5.078212290502793,52.77588526362314
Task_8297,2652,950,167,25,192,2.7886435331230284,51.49330255717235
Task_8298,1608,959,116,142,258,1.675,36.16123903082869
Task_8299,2915,374,53,112,165,7.773333333333333,54.64311635816529
Task_8300,705,158,144,106,250,4.433962264150943,18.979313011953845
Task_8301,2419,864,178,186,364,2.7965317919075146,49.27179797576207
Task_8302,880,996,159,197,356,0.8826479438314945,25.199297075597727
Task_8303,2306,253,25,189,214,9.078740157480315,44.8782149392784
Task_8304,832,809,176,172,348,1.0271604938271606,23.735525647644664
Task_8305,551,159,167,93,260,3.44375,16.494742146827996
Task_8306,2171,557,182,15,197,3.890681003584229,42.5497665478174
Task_8307,2290,324,47,135,182,7.046153846153846,44.470853684874875
Task_8308,1799,619,108,49,157,2.9016129032258067,36.62828869453299
Task_8309,932,974,156,63,219,0.9558974358974359,24.81209824955721
Task_8310,566,110,19,37,56,5.099099099099099,14.091271749375316
Task_8311,790,960,23,95,118,0.8220603537981269,22.143729894402327
Task_8312,2724,632,11,70,81,4.303317535545023,50.99495578637188
Task_8313,2229,1016,148,26,174,2.191740412979351,44.867742468427686
Task_8314,2009,430,28,196,224,4.661252900232019,40.82859313217893
Task_8315,1437,247,107,60,167,5.794354838709677,29.987711891007596
Task_8316,2294,988,25,100,125,2.319514661274014,46.29808617288851
Task_8317,1275,801,53,163,216,1.5897755610972568,30.37994950195579
Task_8318,1090,101,172,127,299,10.686274509803921,24.694291343046057
Task_8319,2302,355,196,189,385,6.466292134831461,45.89172533665049
Task_8320,2894,205,141,65,206,14.048543689320388,53.2732273084682
Task_8321,1488,553,148,66,214,2.6859205776173285,32.23413555040097
Task_8322,1229,913,104,175,279,1.3446389496717723,30.12898318404834
Task_8323,2863,803,130,54,184,3.560945273631841,54.47011488401921
Task_8324,1070,172,74,119,193,6.184971098265896,24.612555745920094
Task_8325,1765,1014,180,114,294,1.7389162561576355,38.94104602969679
Task_8326,1695,493,93,92,185,3.431174089068826,35.55327139558051
Task_8327,2737,84,130,62,192,32.2,49.38976456330331
Task_8328,1930,760,57,170,227,2.536136662286465,40.71691175816492
Task_8329,2499,417,140,38,178,5.978468899521531,47.22807086285078
Task_8330,2217,236,70,130,200,9.354430379746836,43.352075267899956
Task_8331,1957,589,129,181,310,3.316949152542373,40.838548144318
Task_8332,1323,439,89,21,110,3.006818181818182,28.02955360487635
Task_8333,1618,660,167,29,196,2.447806354009077,34.29969355661324
Task_8334,2140,526,99,93,192,4.060721062618596,42.81118550475431
Task_8335,1327,218,169,144,313,6.059360730593608,29.620120683462982
Task_8336,901,122,28,175,203,7.32520325203252,21.686919071778206
Task_8337,2331,440,161,95,256,5.285714285714286,45.884403918916405
Task_8338,2360,866,79,152,231,2.7220299884659744,47.82465173499037
Task_8339,2645,764,107,96,203,3.457516339869281,51.704863767457034
Task_8340,2416,1002,41,150,191,2.4087736789631107,48.83465098024354
Task_8341,2970,280,198,155,353,10.569395017793594,55.99873149481491
Task_8342,1983,343,11,95,106,5.7645348837209305,38.98001921852412
Task_8343,2339,100,31,188,219,23.15841584158416,44.05080361182592
Task_8344,1318,816,88,72,160,1.613219094247246,29.89278989845126
Task_8345,597,731,127,121,248,0.8155737704918032,19.305660490469915
Task_8346,2983,190,85,142,227,15.61780104712042,55.318233859167286
Task_8347,765,254,140,178,318,3.0,20.936502424315638
Task_8348,1060,340,91,156,247,3.1085043988269794,25.575807743837725
Task_8349,1288,1005,136,107,243,1.2803180914512922,31.035284904911137
Task_8350,2270,868,46,57,103,2.6121979286536248,44.58474559312659
Task_8351,770,134,136,184,320,5.703703703703703,20.219573398367476
Task_8352,643,936,87,35,122,0.6862326574172892,19.23756428754402
Task_8353,1245,586,25,43,68,2.1209540034071552,26.660328467755207
Task_8354,1952,749,193,126,319,2.6026666666666665,41.222488876253756
Task_8355,2713,852,109,43,152,3.1805392731535758,51.70634188263998
Task_8356,1800,975,183,154,337,1.8442622950819672,39.640508541291005
Task_8357,1659,489,170,66,236,3.3857142857142857,34.837979398046805
Task_8358,2200,362,17,169,186,6.0606060606060606,43.18688632892656
Task_8359,2070,349,107,63,170,5.914285714285715,40.38447035629976
Task_8360,883,117,178,45,223,7.483050847457627,20.637487403093626
Task_8361,1468,528,75,136,211,2.775047258979206,32.52647686182872
Task_8362,2497,591,99,68,167,4.217905405405405,47.98140528554068
Task_8363,1842,266,195,125,320,6.898876404494382,37.92754881423404
Task_8364,1826,348,92,82,174,5.232091690544412,36.94626244409621
Task_8365,945,306,88,71,159,3.0781758957654723,22.348847692764384
Task_8366,704,989,70,95,165,0.7111111111111111,21.54266167937888
Task_8367,840,549,150,92,242,1.5272727272727273,22.444616409137964
Task_8368,2751,183,44,66,110,14.951086956521738,50.162351217970574
Task_8369,2741,735,89,55,144,3.724184782608696,52.12221428165216
Task_8370,692,348,60,100,160,1.9828080229226361,19.060039139939423
Task_8371,2612,785,105,101,206,3.323155216284987,51.24534442718527
Task_8372,2599,541,111,113,224,4.795202952029521,50.3642638700594
Task_8373,828,953,38,140,178,0.8679245283018868,23.065625093797042
Task_8374,2983,541,69,54,123,5.503690036900369,55.22433704337349
Task_8375,1057,859,27,195,222,1.2290697674418605,26.90020927968554
Task_8376,2867,78,143,13,156,36.29113924050633,50.45036799843092
Task_8377,1487,676,142,102,244,2.1964549483013296,33.25497717473557
Task_8378,1656,473,58,132,190,3.4936708860759493,35.23484599244138
Task_8379,2499,288,130,77,207,8.647058823529411,47.451239972234795
Task_8380,785,305,197,127,324,2.565359477124183,21.369729775074916
Task_8381,1738,136,164,196,360,12.686131386861314,35.7365314923722
Task_8382,1971,304,151,121,272,6.462295081967213,39.875383897870414
Task_8383,2783,184,189,75,264,15.043243243243243,51.79009914257845
Task_8384,1565,519,143,164,307,3.0096153846153846,34.37145842192678
Task_8385,1893,209,82,160,242,9.014285714285714,38.32011732485985
Task_8386,1933,563,95,145,240,3.4273049645390072,40.07800918114993
Task_8387,1643,726,128,180,308,2.2599724896836313,36.2851336206754
Task_8388,1024,656,27,41,68,1.5585996955859969,23.380213685962588
Task_8389,2646,244,31,191,222,10.8,50.242415735401494
Task_8390,2267,536,108,89,197,4.221601489757914,44.74710604260963
Task_8391,2902,612,174,62,236,4.734094616639478,54.87665468462969
Task_8392,1233,640,129,98,227,1.923556942277691,29.040222107314793
Task_8393,819,874,95,132,227,0.936,23.24710319767485
Task_8394,559,810,124,141,265,0.689272503082614,19.176312020310537
Task_8395,2778,946,159,133,292,2.9334741288278776,54.8143612547949
Task_8396,2987,559,86,79,165,5.333928571428571,55.93199238430966
Task_8397,1746,577,98,92,190,3.0207612456747404,36.69105606003563
Task_8398,1473,292,167,55,222,5.027303754266212,31.21342186520161
Task_8399,2337,1024,120,78,198,2.28,47.26698884184717
Task_8400,2736,471,53,149,202,5.796610169491525,52.42983211239357
Task_8401,2363,472,171,45,216,4.995771670190275,45.53184008728391
Task_8402,1334,141,176,172,348,9.394366197183098,29.311605422119825
Task_8403,1381,984,62,161,223,1.402030456852792,32.58335651266026
Task_8404,2784,745,72,181,253,3.7319034852546915,54.30037282000882
Task_8405,514,89,76,55,131,5.711111111111111,14.00013964846874
Task_8406,1500,507,21,46,67,2.952755905511811,30.462311655783953
Task_8407,2288,876,63,91,154,2.6088939566704674,45.82938081285767
Task_8408,2400,1000,44,51,95,2.3976023976023977,47.043532080651566
Task_8409,2045,180,183,54,237,11.298342541436464,39.73731893148508
Task_8410,1272,652,147,174,321,1.9479326186830015,30.227172428980094
Task_8411,1106,325,110,112,222,3.392638036809816,26.028453936899293
Task_8412,1152,661,187,82,269,1.7401812688821752,27.692698488121724
Task_8413,1149,213,64,130,194,5.369158878504673,26.363160955508175
Task_8414,2306,312,51,40,91,7.36741214057508,43.00854207753417
Task_8415,1955,861,30,141,171,2.2679814385150814,40.82108765946415
Task_8416,2071,460,28,81,109,4.492407809110629,40.67044596293568
Task_8417,619,360,200,160,360,1.7146814404432134,19.116254809883582
Task_8418,2751,778,97,30,127,3.5314505776636715,52.06766189941288
Task_8419,1956,744,110,143,253,2.625503355704698,40.99765711848584
Task_8420,998,547,164,43,207,1.8211678832116789,24.1577970921673
Task_8421,2382,539,73,70,143,4.411111111111111,45.943623355158756
Task_8422,577,669,158,31,189,0.8611940298507462,17.80185293207678
Task_8423,2798,569,10,141,151,4.908771929824561,52.991890464620155
Task_8424,2220,705,98,25,123,3.144475920679887,43.291922608713094
Task_8425,2523,782,17,114,131,3.2222222222222223,49.20303369832531
Task_8426,1843,944,37,68,105,1.9502645502645504,38.30520470812456
Task_8427,1197,326,44,76,120,3.6605504587155964,26.4752460601017
Task_8428,1716,83,32,41,73,20.428571428571427,31.854506614723373
Task_8429,1172,160,193,152,345,7.279503105590062,26.838692461673322
Task_8430,840,75,120,54,174,11.052631578947368,19.45498324729297
Task_8431,1758,284,165,107,272,6.168421052631579,36.41920906693287
Task_8432,641,940,66,27,93,0.6811902231668437,19.259263381309605
Task_8433,1439,169,188,15,203,8.464705882352941,29.63173407566133
Task_8434,2858,1001,67,10,77,2.852295409181637,53.39782506341793
Task_8435,2066,252,151,35,186,8.16600790513834,39.87799518686884
Task_8436,2866,766,132,26,158,3.7366362451108213,53.899897460149674
Task_8437,2787,373,102,23,125,7.451871657754011,51.19810010710945
Task_8438,1540,823,193,95,288,1.8689320388349515,34.71286389523231
Task_8439,1019,736,117,67,184,1.3826322930800543,25.02687562466282
Task_8440,1697,575,154,116,270,2.9461805555555554,36.40144279566748
Task_8441,510,856,67,106,173,0.5950991831971996,18.086353944160933
Task_8442,1550,423,74,33,107,3.6556603773584904,31.679881428399
Task_8443,2687,619,120,128,248,4.333870967741936,52.137493187000416
Task_8444,2119,526,195,185,380,4.020872865275142,43.52484024421309
Task_8445,1751,238,15,30,45,7.326359832635983,33.48738448332058
Task_8446,1027,245,133,53,186,4.17479674796748,23.724634073064944
Task_8447,1749,106,160,183,343,16.345794392523363,35.3224201105542
Task_8448,1136,652,158,167,325,1.7396630934150077,28.06745528098324
Task_8449,2157,164,104,37,141,13.072727272727272,40.37072387572048
Task_8450,2039,866,24,110,134,2.351787773933103,41.86417467685862
Task_8451,2769,695,42,161,203,3.978448275862069,53.536765833954256
Task_8452,2575,839,17,91,108,3.0654761904761907,49.854866891916004
Task_8453,1173,895,177,182,359,1.3091517857142858,29.54454281535885
Task_8454,1022,999,128,40,168,1.022,25.546082416232753
Task_8455,1863,897,43,63,106,2.074610244988864,38.42293424886497
Task_8456,1474,672,199,46,245,2.1901931649331354,32.254084071992565
Task_8457,2538,77,87,91,178,32.53846153846154,46.336538023858346
Task_8458,2416,799,10,126,136,3.02,47.62132989521269
Task_8459,546,600,43,149,192,0.908485856905158,17.769649705345817
Task_8460,1843,520,179,169,348,3.5374280230326294,38.968193604360614
Task_8461,2971,94,45,46,91,31.273684210526316,51.84275677966172
Task_8462,2483,137,118,36,154,17.992753623188406,45.319101941853944
Task_8463,2778,324,180,181,361,8.547692307692307,53.19439899815802
Task_8464,2956,348,99,45,144,8.469914040114613,53.90114946599206
Task_8465,647,1016,22,51,73,0.6361848574237955,18.999934782112295
Task_8466,1525,672,67,120,187,2.265973254086181,33.69876073721347
Task_8467,2488,430,161,181,342,5.77262180974478,48.87824897095123
Task_8468,2977,736,194,120,314,4.039348710990502,57.38789920189163
Task_8469,1440,855,123,68,191,1.6822429906542056,32.34206521420193
Task_8470,1451,110,94,105,199,13.072072072072071,29.971281630537845
Task_8471,2669,86,115,119,234,30.67816091954023,49.046808469801285
Task_8472,2557,285,192,31,223,8.94055944055944,48.05076459764325
Task_8473,2017,570,49,162,211,3.532399299474606,41.41523228140936
Task_8474,1967,379,145,73,218,5.176315789473684,39.3422276851538
Task_8475,730,689,31,61,92,1.0579710144927537,19.563224257857385
Task_8476,2206,429,28,190,218,5.130232558139535,43.90726217299166
Task_8477,2747,580,91,187,278,4.728055077452668,53.23407144964313
Task_8478,2305,845,59,200,259,2.724586288416076,47.108077119570375
Task_8479,1247,878,58,183,241,1.4186575654152447,30.244886511985076
Task_8480,1076,158,126,105,231,6.767295597484277,24.74056406366977
Task_8481,2073,412,116,146,262,5.019370460048426,41.83982849231722
Task_8482,1763,403,73,28,101,4.3638613861386135,34.95934602163892
Task_8483,802,70,122,193,315,11.295774647887324,20.15662467431604
Task_8484,990,725,152,184,336,1.3636363636363635,26.008480234204445
Task_8485,2752,331,45,122,167,8.289156626506024,51.656530768843545
Task_8486,985,784,199,82,281,1.2547770700636942,25.41995102075018
Task_8487,1023,644,95,150,245,1.586046511627907,25.912173881539434
Task_8488,788,735,160,89,249,1.0706521739130435,22.034453984231845
Task_8489,1610,481,23,118,141,3.340248962655602,33.932658371192396
Task_8490,2238,345,113,22,135,6.468208092485549,42.515331781142926
Task_8491,2068,570,177,19,196,3.6217162872154116,40.89899343013728
Task_8492,2396,122,17,44,61,19.479674796747968,42.899581972645365
Task_8493,755,472,45,111,156,1.5961945031712474,20.311086885444762
Task_8494,639,780,15,58,73,0.8181818181818182,18.03850077880531
Task_8495,2583,904,15,12,27,2.85414364640884,48.4371395652897
Task_8496,1147,516,151,43,194,2.218568665377176,26.361162961944427
Task_8497,1883,350,188,61,249,5.364672364672365,37.91772318134098
Task_8498,2069,225,10,193,203,9.154867256637168,40.94114712723002
Task_8499,955,771,72,28,100,1.2370466321243523,23.315254294784683
Task_8500,1771,799,98,30,128,2.21375,36.75044568427534
Task_8501,1590,482,124,195,319,3.2919254658385095,34.74931949869327
Task_8502,2219,301,84,90,174,7.347682119205298,43.09914877087308
Task_8503,1362,636,68,146,214,2.1381475667189953,31.201536184672253
Task_8504,2583,530,107,161,268,4.864406779661017,50.34421422401105
Task_8505,1855,457,76,196,272,4.050218340611353,38.79196109636228
Task_8506,2541,332,95,125,220,7.63063063063063,48.82651080285398
Task_8507,1917,729,109,195,304,2.626027397260274,40.63895636958854
Task_8508,1767,104,136,124,260,16.82857142857143,35.133623486536095
Task_8509,1111,914,38,26,64,1.214207650273224,25.54089239113155
Task_8510,2513,912,48,156,204,2.7524644030668126,50.2694274547436
Task_8511,938,699,172,101,273,1.34,24.71932783977482
Task_8512,838,936,193,187,380,0.8943436499466382,24.44238513046285
Task_8513,2545,155,35,19,54,16.314102564102566,45.57549976827761
Task_8514,1494,334,161,176,337,4.459701492537313,32.80621821937971
Task_8515,1149,743,182,41,223,1.5443548387096775,27.23192091821529
Task_8516,1633,628,185,120,305,2.5961844197138313,35.71834480270699
Task_8517,2558,195,84,108,192,13.051020408163266,48.354581950193655
Task_8518,2123,475,181,161,342,4.4600840336134455,43.21807894408628
Task_8519,2804,502,69,67,136,5.57455268389662,52.51378918087454
Task_8520,1899,1019,198,103,301,1.861764705882353,41.108951277817816
Task_8521,1027,392,44,75,119,2.61323155216285,24.009599270254522
Task_8522,957,293,175,71,246,3.2551020408163267,23.18090896565053
Task_8523,568,886,35,66,101,0.6403607666290868,18.00782495992318
Task_8524,877,928,93,103,196,0.9440258342303552,24.20405688491013
Task_8525,1297,564,20,25,45,2.295575221238938,27.28172597703454
Task_8526,887,705,95,40,135,1.2563739376770537,22.406640137730033
Task_8527,2662,944,119,141,260,2.816931216931217,52.837464771881876
Task_8528,2453,170,152,102,254,14.345029239766081,46.52704312636778
Task_8529,1546,690,152,57,209,2.2373371924746746,33.50971278934049
Task_8530,974,837,135,49,184,1.162291169451074,24.500170139736024
Task_8531,2047,618,129,183,312,3.3069466882067853,42.367488635716924
Task_8532,2203,561,179,109,288,3.919928825622776,44.440484185896345
Task_8533,2945,780,145,92,237,3.770806658130602,56.53103905534471
Task_8534,740,483,163,57,220,1.5289256198347108,20.132626450964988
Task_8535,723,140,28,33,61,5.127659574468085,16.8289539997704
Task_8536,965,457,152,50,202,2.106986899563319,23.400208089667988
Task_8537,1263,278,180,86,266,4.526881720430108,28.252621298603234
Task_8538,2115,857,25,98,123,2.465034965034965,43.01074331940228
Task_8539,1887,704,38,103,141,2.676595744680851,38.91805769779265
Task_8540,1281,344,165,52,217,3.7130434782608694,28.335116816491595
Task_8541,2356,439,144,126,270,5.3545454545454545,46.41349113712952
Task_8542,1003,499,163,79,242,2.006,24.700486979709865
Task_8543,1001,265,66,148,214,3.763157894736842,24.311863514921622
Task_8544,1772,133,106,162,268,13.223880597014926,35.72597669951909
Task_8545,637,188,184,172,356,3.3703703703703702,18.900126246025184
Task_8546,1698,610,76,78,154,2.779050736497545,35.49396100646947
Task_8547,565,892,169,151,320,0.6326987681970885,19.798630607149278
Task_8548,840,800,141,153,294,1.048689138576779,23.563176293858522
Task_8549,1018,74,157,95,252,13.573333333333334,23.157597107912732
Task_8550,1138,795,73,19,92,1.42964824120603,26.082883674476438
Task_8551,2109,893,19,172,191,2.359060402684564,43.63062555029182
Task_8552,2267,969,197,109,306,2.337113402061856,46.81652638285946
Task_8553,923,766,130,15,145,1.2033898305084745,23.014688775158145
Task_8554,1181,420,85,134,219,2.8052256532066506,27.585623294302163
Task_8555,2716,966,85,46,131,2.8086866597724924,52.11809113119199
Task_8556,1563,531,16,41,57,2.93796992481203,31.625431188421434
Task_8557,2802,850,85,177,262,3.2925969447708576,54.87077762724605
Task_8558,928,895,65,171,236,1.0357142857142858,25.082553004697203
Task_8559,2074,249,60,155,215,8.296,41.23215497613439
Task_8560,657,161,92,17,109,4.055555555555555,16.399310766376434
Task_8561,1318,885,63,45,108,1.487584650112867,29.21718382923197
Task_8562,2258,894,105,14,119,2.522905027932961,44.250624845892084
Task_8563,2386,806,119,77,196,2.956629491945477,47.291836789547
Task_8564,2304,673,40,71,111,3.4183976261127595,44.9485927207632
Task_8565,595,689,31,148,179,0.8623188405797102,18.617875094589763
Task_8566,600,409,173,42,215,1.4634146341463414,17.458592151795116
Task_8567,2139,145,87,143,230,14.650684931506849,41.483540637832476
Task_8568,1764,877,98,26,124,2.009111617312073,36.61377985145827
Task_8569,711,787,166,89,255,0.9022842639593909,21.079764835045896
Task_8570,1635,653,87,96,183,2.5,35.10112448578578
Task_8571,1026,472,39,116,155,2.1691331923890065,24.633951617577676
Task_8572,2132,421,96,109,205,5.052132701421801,42.54460521729828
Task_8573,1321,400,39,11,50,3.29426433915212,27.037024110673485
Task_8574,897,464,76,70,146,1.929032258064516,22.226140293428813
Task_8575,2077,627,29,47,76,3.3073248407643314,39.950126050068164
Task_8576,909,111,163,102,265,8.116071428571429,21.670779046922025
Task_8577,1589,553,99,47,146,2.868231046931408,33.026757551187345
Task_8578,2018,492,167,77,244,4.093306288032454,40.687093211214666
Task_8579,743,942,16,117,133,0.7879109225874867,21.472102964319372
Task_8580,1666,75,190,70,260,21.92105263157895,32.790877483057564
Task_8581,1835,412,36,184,220,4.443099273607748,37.948878727542144
Task_8582,576,803,192,61,253,0.7164179104477612,18.803368243778152
Task_8583,2015,649,176,94,270,3.1,41.58316532193684
Task_8584,868,356,98,11,109,2.4313725490196076,20.573068353784873
Task_8585,1045,435,59,129,188,2.396788990825688,25.403830593835043
Task_8586,1764,146,13,25,38,12.0,33.0609518060869
Task_8587,2813,979,121,27,148,2.870408163265306,53.68534045928012
Task_8588,1261,709,172,78,250,1.776056338028169,29.463455337771364
Task_8589,689,1008,54,181,235,0.6828543111992071,21.87892253671336
Task_8590,1368,599,158,27,185,2.28,29.898957166787095
Task_8591,743,317,42,193,235,2.3364779874213837,20.45326229853727
Task_8592,1869,620,199,145,344,3.0096618357487923,39.64326864218763
Task_8593,1441,822,158,79,237,1.7509113001215066,32.6144963546863
Task_8594,753,88,178,42,220,8.460674157303371,18.142127421920073
Task_8595,1434,791,44,71,115,1.8106060606060606,31.65294087225367
Task_8596,974,525,194,34,228,1.8517110266159695,23.815974286621508
Task_8597,796,258,136,41,177,3.0733590733590734,19.730879108056513
Task_8598,2867,480,120,127,247,5.960498960498961,54.53372344816567
Task_8599,554,454,88,112,200,1.2175824175824175,17.48583826225364
Task_8600,2182,624,182,149,331,3.4912,44.56030822756336
Task_8601,674,485,145,183,328,1.3868312757201646,20.21284158836734
Task_8602,2432,161,198,114,312,15.012345679012345,46.49399208436836
Task_8603,2750,864,18,95,113,3.179190751445087,53.00031967983262
Task_8604,2381,744,98,113,211,3.195973154362416,47.51099208641503
Task_8605,2956,1007,123,180,303,2.9325396825396823,57.944025839494145
Task_8606,2356,482,81,98,179,4.877846790890269,46.024440134897226
Task_8607,1061,479,93,81,174,2.2104166666666667,25.244578183535225
Task_8608,1762,793,141,113,254,2.2191435768261965,38.0379035966727
Task_8609,2097,174,128,185,313,11.982857142857142,41.29301243637374
Task_8610,2044,193,139,159,298,10.536082474226804,40.806137543384935
Task_8611,1603,529,165,189,354,3.0245283018867926,35.25324290304307
Task_8612,2174,821,75,98,173,2.6447688564476888,44.334186238465115
Task_8613,2757,663,82,155,237,4.15210843373494,53.46848738749396
Task_8614,2089,439,188,73,261,4.747727272727273,41.6625637166418
Task_8615,2030,920,18,133,151,2.204125950054289,41.886225351825374
Task_8616,1462,1023,175,194,369,1.427734375,34.56759799301187
Task_8617,1544,815,117,144,261,1.892156862745098,34.72961935222195
Task_8618,1082,704,116,109,225,1.5347517730496454,26.808991161318346
Task_8619,1078,96,148,12,160,11.11340206185567,22.664079810212115
Task_8620,2611,1005,58,37,95,2.595427435387674,50.08213094341226
Task_8621,875,673,145,55,200,1.2982195845697329,22.833863471900752
Task_8622,1498,410,193,92,285,3.6447688564476888,32.658020775407074
Task_8623,2729,724,160,86,246,3.7641379310344827,52.80095653492024
Task_8624,2811,407,179,60,239,6.889705882352941,52.74811909822434
Task_8625,1507,428,118,131,249,3.5128205128205128,32.85384592511763
Task_8626,2891,790,84,49,133,3.6548672566371683,54.42339487257925
Task_8627,2261,582,117,145,262,3.8782161234991426,45.361354442173514
Task_8628,1260,203,53,15,68,6.176470588235294,25.390779941466416
Task_8629,1744,68,162,30,192,25.27536231884058,33.357152488945935
Task_8630,1857,78,119,131,250,23.50632911392405,36.303452707366205
Task_8631,2752,469,55,39,94,5.85531914893617,50.58630667754557
Task_8632,856,1020,108,107,215,0.8383937316356513,24.11725071549309
Task_8633,2421,595,119,112,231,4.0620805369127515,47.74839006312055
Task_8634,1999,322,63,74,137,6.188854489164087,39.29913865383039
Task_8635,1774,970,49,113,162,1.826982492276004,38.245141195550495
Task_8636,2559,227,176,24,200,11.223684210526315,47.69417648613529
Task_8637,590,160,21,168,189,3.6645962732919255,16.887192351719122
Task_8638,874,259,33,153,186,3.3615384615384616,21.96518911135277
Task_8639,1874,653,33,31,64,2.8654434250764527,36.837346224423904
Task_8640,2582,79,61,32,93,32.275,45.45453249025781
Task_8641,1090,556,115,85,200,1.9569120287253141,26.094166277084323
Task_8642,2112,860,96,102,198,2.4529616724738674,43.57657709250091
Task_8643,2062,651,120,171,291,3.1625766871165646,42.596953383035526
Task_8644,1206,171,33,151,184,7.011627906976744,26.43742220654609
Task_8645,1369,1005,51,150,201,1.3608349900596421,32.368770292271726
Task_8646,2234,349,146,173,319,6.382857142857143,44.4749970896936
Task_8647,1399,327,195,83,278,4.265243902439025,30.585185626199078
Task_8648,877,194,115,123,238,4.4974358974358974,21.991881348310212
Task_8649,1250,685,125,167,292,1.8221574344023324,29.840694792923248
Task_8650,2820,694,142,12,154,4.057553956834532,52.809135748149636
Task_8651,1930,774,188,30,218,2.490322580645161,39.69638258447289
Task_8652,2356,579,27,165,192,4.062068965517241,46.61097960179337
Task_8653,557,620,79,100,179,0.8969404186795491,17.87920531556851
Task_8654,2579,224,181,136,317,11.462222222222222,49.41999960818553
Task_8655,2010,93,117,76,193,21.382978723404257,38.08495277974489
Task_8656,1592,193,52,177,229,8.206185567010309,33.54134985825002
Task_8657,1230,104,126,99,225,11.714285714285714,26.503970237107453
Task_8658,2474,720,76,177,253,3.4313453536754506,49.31611368724027
Task_8659,2329,805,142,151,293,2.889578163771712,47.289924740196476
Task_8660,1127,314,55,194,249,3.577777777777778,26.725399141321606
Task_8661,1856,708,125,95,220,2.617771509167842,39.05355441731209
Task_8662,928,644,35,51,86,1.4387596899224806,22.439140516494508
Task_8663,623,755,95,173,268,0.8240740740740741,20.01273247506545
Task_8664,1134,472,53,197,250,2.397463002114165,27.360966721489387
Task_8665,1285,164,29,197,226,7.787878787878788,28.171415747814596
Task_8666,2283,424,31,113,144,5.371764705882353,44.363413911335904
Task_8667,2413,451,132,99,231,5.338495575221239,47.12467447986932
Task_8668,1444,330,171,42,213,4.362537764350453,30.55078823715766
Task_8669,1732,565,55,40,95,3.060070671378092,34.759547227954634
Task_8670,544,318,11,96,107,1.7053291536050157,16.166599980034267
Task_8671,1253,450,56,51,107,2.778270509977827,27.214810565793226
Task_8672,2156,556,132,146,278,3.8707360861759423,43.689498816545104
Task_8673,516,241,142,88,230,2.1322314049586777,16.179848621679522
Task_8674,1571,185,148,52,200,8.446236559139784,32.37925267546965
Task_8675,826,954,37,148,185,0.8649214659685864,23.146388101775177
Task_8676,1680,576,167,122,289,2.9116117850953205,36.229825027982166
Task_8677,869,696,127,63,190,1.2467718794835008,22.711709241429997
Task_8678,738,378,28,183,211,1.9472295514511873,20.472169552772254
Task_8679,2370,631,103,54,157,3.75,45.90122621573919
Task_8680,2301,496,146,32,178,4.629778672032193,44.323348165980455
Task_8681,950,682,68,104,172,1.390922401171303,24.427126855332073
Task_8682,1750,772,179,86,265,2.263906856403622,37.52817799906552
Task_8683,2263,119,41,27,68,18.858333333333334,40.897458175418244
Task_8684,2123,385,104,67,171,5.5,41.35425746572783
Task_8685,1492,858,13,164,177,1.7369033760186263,33.55512288682424
Task_8686,1113,931,56,169,225,1.194206008583691,28.176945684654783
Task_8687,775,915,73,37,110,0.8460698689956332,21.071313657384056
Task_8688,998,579,178,28,206,1.7206896551724138,24.214885950887307
Task_8689,1234,741,57,38,95,1.6630727762803235,27.48487559537531
Task_8690,1466,725,63,68,131,2.0192837465564737,32.054699441178606
Task_8691,1780,369,17,142,159,4.8108108108108105,36.211415714726
Task_8692,1752,691,18,11,29,2.531791907514451,34.56404754169119
Task_8693,555,659,138,39,177,0.8409090909090909,17.170691356233693
Task_8694,752,702,130,182,312,1.069701280227596,21.973293547601628
Task_8695,1968,592,163,44,207,3.318718381112985,39.64980254538886
Task_8696,1854,542,106,156,262,3.414364640883978,38.805616798761875
Task_8697,2460,76,75,152,227,31.948051948051948,45.82839527425403
Task_8698,2955,439,168,156,324,6.715909090909091,56.181216231271286
Task_8699,1843,399,129,135,264,4.6075,38.15078419698171
Task_8700,1836,453,179,155,334,4.044052863436123,38.55950206090285
Task_8701,1330,510,81,99,180,2.6027397260273974,29.859051925238763
Task_8702,2354,325,94,172,266,7.220858895705521,46.134974937228975
Task_8703,2026,961,15,54,69,2.106029106029106,40.548924963660006
Task_8704,588,725,189,182,371,0.8099173553719008,19.788321007605784
Task_8705,1116,373,71,119,190,2.983957219251337,26.322808096267313
Task_8706,2068,714,97,144,241,2.8923076923076922,42.648890222403246
Task_8707,2160,974,78,191,269,2.2153846153846155,45.22065956806
Task_8708,1353,289,168,154,322,4.665517241379311,30.328076574614624
Task_8709,854,920,52,135,187,0.9272529858849077,23.727985859105274
Task_8710,1293,352,136,157,293,3.6628895184135977,29.459541236541778
Task_8711,975,343,22,16,38,2.8343023255813953,21.201694557193445
Task_8712,1045,550,127,194,321,1.896551724137931,26.342755846643428
Task_8713,1683,968,66,12,78,1.736842105263158,34.72758459592773
Task_8714,2015,743,46,141,187,2.7083333333333335,41.625781710849225
Task_8715,2237,680,24,170,194,3.2848751835535976,45.06442996656197
Task_8716,1711,909,144,54,198,1.8802197802197802,36.79620226587868
Task_8717,775,477,171,170,341,1.6213389121338913,21.881167354947475
Task_8718,2139,452,102,108,210,4.7218543046357615,42.724401451702
Task_8719,2687,373,105,179,284,7.184491978609626,51.57307001476253
Task_8720,1764,369,32,79,111,4.767567567567568,35.582731396476944
Task_8721,1330,471,191,84,275,2.8177966101694913,29.943896346200773
Task_8722,770,710,147,112,259,1.0829817158931083,21.941255297702202
Task_8723,1704,375,157,199,356,4.531914893617022,36.3817061379197
Task_8724,800,540,139,55,194,1.478743068391867,21.21434774914543
Task_8725,1555,940,92,90,182,1.6524973432518597,34.565322307537656
Task_8726,2611,538,175,69,244,4.8441558441558445,50.10000984247028
Task_8727,1256,657,79,82,161,1.9088145896656534,28.72802828183414
Task_8728,628,856,111,107,218,0.7327887981330222,20.03375938057572
Task_8729,1767,559,198,82,280,3.155357142857143,37.1712591220296
Task_8730,2195,527,158,200,358,4.15719696969697,44.65417302031591
Task_8731,899,792,36,147,183,1.1336696090794451,23.758656817643857
Task_8732,1350,698,81,24,105,1.9313304721030042,29.208562910403227
Task_8733,2573,67,197,100,297,37.838235294117645,47.61977256391128
Task_8734,2462,414,132,24,156,5.932530120481927,46.33936474845575
Task_8735,1393,646,190,143,333,2.153013910355487,32.13352830888005
Task_8736,2570,973,90,85,175,2.6386036960985626,50.695309143264666
Task_8737,717,707,95,65,160,1.0127118644067796,19.88848297955103
Task_8738,831,227,139,42,181,3.6447368421052633,20.19851851721259
Task_8739,1686,893,111,85,196,1.8859060402684564,36.56788932495306
Task_8740,1115,983,31,180,211,1.133130081300813,28.171670066487142
Task_8741,593,1003,111,46,157,0.5906374501992032,18.987982203954594
Task_8742,2330,867,149,52,201,2.684331797235023,46.5277001896798
Task_8743,2822,976,54,180,234,2.8884339815762536,55.57188716603421
Task_8744,2841,188,195,149,344,15.031746031746032,53.59027270464554
Task_8745,506,916,141,179,320,0.5517993456924755,18.900129403095566
Task_8746,2907,406,123,21,144,7.142506142506143,53.28376750367524
Task_8747,1052,264,115,44,159,3.969811320754717,23.585590208834287
Task_8748,2368,985,91,11,102,2.4016227180527383,46.18667058186883
Task_8749,1623,921,183,19,202,1.7603036876355749,34.9652221252668
Task_8750,2504,287,28,48,76,8.694444444444445,45.632762714181275
Task_8751,1180,929,79,181,260,1.2688172043010753,29.382739689222575
Task_8752,863,668,184,176,360,1.289985052316891,23.88550720900143
Task_8753,1297,501,151,178,329,2.5836653386454183,30.191262085113777
Task_8754,1011,102,57,11,68,9.815533980582524,20.800624670095242
Task_8755,2440,277,66,119,185,8.776978417266188,46.793203430562336
Task_8756,706,501,112,80,192,1.406374501992032,19.7222771928301
Task_8757,1127,909,71,55,126,1.2384615384615385,27.052837446972188
Task_8758,1651,798,26,156,182,2.0663329161451816,35.89569992142733
Task_8759,2919,368,13,67,80,7.9105691056910565,53.23264664745787
Task_8760,2126,592,137,19,156,3.585160202360877,41.418661753463596
Task_8761,1449,497,18,85,103,2.9096385542168677,30.838558332693804
Task_8762,2479,215,91,12,103,11.476851851851851,45.455329660210886
Task_8763,2340,180,17,175,192,12.92817679558011,44.431198331549076
Task_8764,684,520,168,124,292,1.3128598848368522,20.247305661954382
Task_8765,2655,730,153,21,174,3.632010943912449,50.64711843905639
Task_8766,2970,635,198,41,239,4.669811320754717,55.81226929505035
Task_8767,1712,577,157,188,345,2.961937716262976,37.08886185108897
Task_8768,667,505,121,185,306,1.3181818181818181,20.08394198246542
Task_8769,2501,795,120,161,281,3.141959798994975,49.94416778931844
Task_8770,1452,1008,92,102,194,1.4390485629335976,33.520620524942
Task_8771,2143,594,153,11,164,3.6016806722689076,42.01697070688527
Task_8772,766,743,117,52,169,1.0295698924731183,20.96736227059684
Task_8773,2318,138,54,169,223,16.676258992805757,44.31580913027784
Task_8774,2798,283,105,43,148,9.852112676056338,51.219195581101864
Task_8775,1365,656,31,152,183,2.077625570776256,30.914963933894956
Task_8776,2114,863,90,58,148,2.446759259259259,42.54648894869848
Task_8777,1282,247,63,95,158,5.169354838709677,28.05817193256678
Task_8778,2151,874,132,158,290,2.458285714285714,44.68208677570711
Task_8779,2730,277,16,58,74,9.820143884892087,49.438822404334665
Task_8780,2568,977,151,115,266,2.625766871165644,51.43979231567139
Task_8781,1660,657,57,100,157,2.522796352583587,35.37725223620711
Task_8782,1647,326,11,110,121,5.036697247706422,33.85120316662511
Task_8783,2730,509,43,145,188,5.352941176470588,52.1960797193096
Task_8784,2280,811,183,84,267,2.8078817733990147,46.023276969996196
Task_8785,1668,264,170,29,199,6.29433962264151,33.8279197612032
Task_8786,814,291,193,53,246,2.787671232876712,20.915738229091144
Task_8787,1834,413,48,74,122,4.429951690821256,36.9642497840618
Task_8788,1953,238,154,163,317,8.171548117154812,39.62434969073703
Task_8789,1402,196,54,128,182,7.116751269035533,30.057120824997643
Task_8790,2699,289,193,165,358,9.306896551724138,51.78467090306456
Task_8791,2131,618,137,157,294,3.4426494345718903,43.57858436773072
Task_8792,1350,324,169,151,320,4.153846153846154,30.3827726349558
Task_8793,938,864,72,108,180,1.084393063583815,24.604974256732152
Task_8794,1350,954,173,34,207,1.4136125654450262,31.007513536659484
Task_8795,1648,293,41,49,90,5.605442176870748,32.618427501365396
Task_8796,1915,846,24,186,210,2.260920897284534,40.578828385791816
Task_8797,1069,625,37,84,121,1.707667731629393,25.484633888444524
Task_8798,2724,831,105,39,144,3.2740384615384617,51.81388339721334
Task_8799,1277,769,57,84,141,1.6584415584415584,29.38278775096603
Task_8800,1111,272,93,19,112,4.069597069597069,24.18047107014478
Task_8801,793,743,159,41,200,1.0658602150537635,21.472720750860105
Task_8802,2162,64,35,49,84,33.261538461538464,38.810241722642736
Task_8803,1686,96,26,127,153,17.38144329896907,32.803657119819256
Task_8804,2296,406,81,182,263,5.641277641277641,45.50994275390457
Task_8805,1993,328,169,177,346,6.057750759878419,40.720157914000815
Task_8806,2951,1009,60,131,191,2.9217821782178217,57.42239922049631
Task_8807,1190,322,19,45,64,3.6842105263157894,24.93192253530779
Task_8808,2767,295,114,140,254,9.347972972972974,52.375762892663886
Task_8809,2968,1016,149,126,275,2.9183874139626353,57.95692444271375
Task_8810,1684,978,114,69,183,1.7201225740551582,36.318909242855504
Task_8811,1897,879,16,189,205,2.1556818181818183,40.298679018063524
Task_8812,1302,208,100,16,116,6.229665071770335,26.924090076171336
Task_8813,1192,365,194,20,214,3.2568306010928962,26.49341324750282
Task_8814,2377,1018,197,194,391,2.3326790971540725,49.219899431170255
Task_8815,2645,98,187,162,349,26.717171717171716,49.31153185652848
Task_8816,2800,373,173,100,273,7.4866310160427805,53.195422523185094
Task_8817,2008,743,110,113,223,2.6989247311827955,41.63910090195793
Task_8818,2591,928,149,182,331,2.7890204520990314,52.04254401936608
Task_8819,1036,675,149,26,175,1.532544378698225,24.911128176826296
Task_8820,1359,287,91,189,280,4.71875,30.32753393344078
Task_8821,1135,474,143,132,275,2.389473684210526,27.23070079958302
Task_8822,1010,759,196,150,346,1.3289473684210527,26.44699236435712
Task_8823,591,688,115,57,172,0.8577648766328012,18.130724858341363
Task_8824,1918,575,108,63,171,3.329861111111111,38.6948596684937
Task_8825,2652,940,142,139,281,2.818278427205101,52.75823070718254
Task_8826,2209,971,12,148,160,2.272633744855967,44.993506543550104
Task_8827,2793,122,26,61,87,22.70731707317073,49.70514377190471
Task_8828,1765,108,121,61,182,16.192660550458715,34.13491868189991
Task_8829,2885,871,199,145,344,3.30848623853211,56.52707423333684
Task_8830,574,626,27,182,209,0.9154704944178629,18.444275100054643
Task_8831,2599,244,104,114,218,10.608163265306123,49.33376113709168
Task_8832,2059,286,146,64,210,7.174216027874564,40.38653797750214
Task_8833,1842,692,13,96,109,2.658008658008658,38.02572773635744
Task_8834,1617,104,36,10,46,15.4,30.291214067762862
Task_8835,2159,900,173,119,292,2.3962264150943398,44.84177141104292
Task_8836,668,283,151,18,169,2.352112676056338,17.463580343096794
Task_8837,2610,423,45,102,147,6.15566037735849,49.49341555900796
Task_8838,2630,570,146,91,237,4.605954465849387,50.82839425005235
Task_8839,1301,697,167,10,177,1.8638968481375358,28.956729125079246
Task_8840,1455,947,123,94,217,1.5348101265822784,33.35954006952422
Task_8841,2878,682,197,15,212,4.2137628111273795,54.211694963817585
Task_8842,935,353,98,188,286,2.6412429378531073,23.827635239033
Task_8843,2069,458,180,165,345,4.507625272331155,42.3278431496491
Task_8844,1350,890,37,170,207,1.5151515151515151,31.66516397353385
Task_8845,1492,661,71,113,184,2.2537764350453173,32.98614179217803
Task_8846,1660,103,128,40,168,15.961538461538462,32.13906526335257
Task_8847,835,600,68,10,78,1.3893510815307821,20.13502790642109
Task_8848,2783,116,55,174,229,23.786324786324787,51.38797441681114
Task_8849,1694,105,160,86,246,15.981132075471699,33.721844012992484
Task_8850,811,396,95,45,140,2.042821158690176,20.19265122651986
Task_8851,2783,735,37,147,184,3.78125,53.61500229977221
Task_8852,2857,120,136,183,319,23.611570247933884,52.995423744998014
Task_8853,1493,292,69,136,205,5.09556313993174,32.11910285855048
Task_8854,573,594,133,22,155,0.9630252100840336,17.116550540595085
Task_8855,2296,237,92,25,117,9.647058823529411,42.9414374048093
Task_8856,1853,300,128,96,224,6.156146179401993,37.76670665434594
Task_8857,2757,623,94,188,282,4.418269230769231,53.58384432099724
Task_8858,2587,274,150,173,323,9.407272727272728,49.814308379157204
Task_8859,1525,366,45,58,103,4.155313351498638,31.175623799144585
Task_8860,2397,585,63,28,91,4.090443686006826,45.25942589077437
Task_8861,2020,1003,167,186,353,2.0119521912350598,43.33281219947302
Task_8862,1168,798,189,177,366,1.4618272841051314,29.172992163093113
Task_8863,689,885,155,190,345,0.7776523702031602,21.793442693897063
Task_8864,1894,616,135,137,272,3.0696920583468397,39.69035507761145
Task_8865,2099,666,134,122,256,3.1469265367316344,43.000677503663894
Task_8866,2178,345,185,14,199,6.294797687861272,41.97851054287754
Task_8867,2378,81,199,170,369,29.0,45.115149355630855
Task_8868,2100,633,27,103,130,3.312302839116719,42.110775943927486
Task_8869,2459,398,141,44,185,6.162907268170426,46.56383168098781
Task_8870,2040,831,61,149,210,2.451923076923077,42.54340466730821
Task_8871,892,378,65,92,157,2.3535620052770447,22.22823916688905
Task_8872,883,453,38,156,194,1.9449339207048457,22.85822763340319
Task_8873,2486,234,103,27,130,10.578723404255319,46.05771441401945
Task_8874,2612,807,194,121,315,3.232673267326733,51.835016799266214
Task_8875,1426,877,110,75,185,1.6241457858769932,32.09598779702004
Task_8876,2573,852,85,50,135,3.0164126611957798,49.55421344875169
Task_8877,578,764,78,131,209,0.7555555555555555,19.029983061798344
Task_8878,1399,926,28,197,225,1.5091693635382957,32.69491576455081
Task_8879,2606,823,98,13,111,3.162621359223301,49.57158168347588
Task_8880,1952,482,42,199,241,4.041407867494824,40.14779494855974
Task_8881,701,968,107,102,209,0.7234262125902993,21.582938948093886
Task_8882,2796,544,87,142,229,5.130275229357798,53.566750804444105
Task_8883,2165,807,23,190,213,2.6794554455445545,44.49066920969553
Task_8884,768,268,129,177,306,2.8550185873605947,20.973878779082913
Task_8885,1836,642,162,138,300,2.855365474339036,38.98131379634073
Task_8886,2377,611,22,118,140,3.883986928104575,46.359193044254575
Task_8887,1832,432,33,86,119,4.23094688221709,36.985345542184454
Task_8888,1851,130,174,177,351,14.129770992366412,37.35245887679719
Task_8889,1969,811,128,167,295,2.4248768472906406,41.63756433865192
Task_8890,2437,641,161,92,253,3.79595015576324,48.11698267269855
Task_8891,1152,183,130,87,217,6.260869565217392,25.963019417916566
Task_8892,2179,323,188,91,279,6.7253086419753085,43.070580386226275
Task_8893,2041,745,84,82,166,2.7359249329758715,41.479814374349736
Task_8894,734,806,129,63,192,0.909541511771995,21.031434744468523
Task_8895,1339,721,44,91,135,1.8545706371191135,30.230085091854196
Task_8896,2498,843,101,136,237,2.9597156398104265,49.81211123421438
Task_8897,1505,532,72,149,221,2.823639774859287,33.179985050872666
Task_8898,693,177,170,141,311,3.893258426966292,19.048386314689747
Task_8899,1409,274,135,42,177,5.123636363636364,29.46714726925448
Task_8900,2345,94,184,22,206,24.68421052631579,43.04754274831961
Task_8901,912,943,19,66,85,0.9661016949152542,23.361433860757284
Task_8902,2527,295,161,188,349,8.537162162162161,49.079997862461006
Task_8903,2631,812,33,170,203,3.236162361623616,51.76661782792619
Task_8904,567,837,88,171,259,0.6766109785202864,19.453182190904702
Task_8905,689,148,167,192,359,4.624161073825503,19.285102714439855
Task_8906,980,971,17,59,76,1.008230452674897,23.831658935992525
Task_8907,1096,330,132,100,232,3.311178247734139,25.913965814243397
Task_8908,2678,623,145,85,230,4.291666666666667,51.58875505037725
Task_8909,1500,489,52,154,206,3.061224489795918,32.94722855038243
Task_8910,1712,136,39,37,76,12.496350364963504,32.400341475582614
Task_8911,1929,531,86,188,274,3.6259398496240602,40.10120171201419
Task_8912,2668,79,29,109,138,33.35,48.0807959352989
Task_8913,2875,865,159,10,169,3.31986143187067,54.36390677088567
Task_8914,1992,531,151,62,213,3.744360902255639,40.1043421692366
Task_8915,2423,589,120,171,291,4.106779661016949,48.11787125191383
Task_8916,595,276,27,200,227,2.148014440433213,17.983970975925942
Task_8917,2996,218,142,116,258,13.680365296803654,55.68616446650583
Task_8918,2704,207,191,190,381,13.0,51.69396292980897
Task_8919,2652,172,144,123,267,15.329479768786127,49.752399225616045
Task_8920,1074,704,79,109,188,1.523404255319149,26.61323207991642
Task_8921,1320,426,76,18,94,3.091334894613583,27.75059488864787
Task_8922,2406,153,77,134,211,15.623376623376624,45.74492925761272
Task_8923,818,88,103,159,262,9.191011235955056,20.239462039379926
Task_8924,1486,329,187,158,345,4.503030303030303,32.67292704105469
Task_8925,1925,555,197,140,337,3.462230215827338,40.285676269283435
Task_8926,2852,162,125,148,273,17.496932515337424,52.994378106674816
Task_8927,1902,881,48,184,232,2.1564625850340136,40.65856195268075
Task_8928,2533,629,132,111,243,4.020634920634921,49.682856742205594
Task_8929,1763,279,168,44,212,6.296428571428572,35.41097615724885
Task_8930,1780,701,133,18,151,2.5356125356125356,36.2329520583635
Task_8931,1858,296,175,77,252,6.255892255892256,37.548272259766755
Task_8932,2473,153,120,21,141,16.058441558441558,45.14999345938711
Task_8933,1711,479,185,182,367,3.564583333333333,36.852478289001276
Task_8934,2369,918,20,75,95,2.5778019586507073,46.49788951033087
Task_8935,948,1020,118,132,250,0.9285014691478942,25.783043550331726
Task_8936,2627,119,69,187,256,21.891666666666666,49.18509872394491
Task_8937,2100,238,72,179,251,8.786610878661088,41.7994617424667
Task_8938,2638,552,171,10,181,4.770343580470163,49.69487151114493
Task_8939,939,881,14,114,128,1.064625850340136,24.46264616205441
Task_8940,515,1017,12,111,123,0.5058939096267191,18.133651018012166
Task_8941,613,793,184,155,339,0.7720403022670025,20.226671635642237
Task_8942,1717,975,126,193,319,1.7592213114754098,38.287854010606736
Task_8943,2234,512,72,171,243,4.354775828460039,44.78973556221976
Task_8944,714,901,126,22,148,0.7915742793791575,20.231117951578263
Task_8945,1721,311,30,187,217,5.516025641025641,35.835937556917976
Task_8946,1254,282,66,130,196,4.431095406360424,28.259397520152884
Task_8947,717,343,187,96,283,2.0843023255813953,20.20886727969462
Task_8948,2295,234,21,167,188,9.76595744680851,44.37961532756329
Task_8949,563,231,85,196,281,2.4267241379310347,17.577456275185302
Task_8950,1402,705,74,149,223,1.9858356940509916,32.105212307354414
Task_8951,2855,315,167,198,365,9.034810126582279,54.42343265019688
Task_8952,2923,194,115,199,314,14.98974358974359,54.735862064318106
Task_8953,2947,375,12,162,174,7.837765957446808,55.11286700791707
Task_8954,2117,445,183,105,288,4.746636771300448,42.70065574352808
Task_8955,1292,257,30,65,95,5.007751937984496,27.306735784369774
Task_8956,962,926,118,59,177,1.0377562028047465,24.56142432208692
Task_8957,1855,728,83,34,117,2.544581618655693,37.496644437462486
Task_8958,1742,185,97,42,139,9.365591397849462,34.19082284130662
Task_8959,2070,427,94,200,294,4.836448598130841,42.14842632920345
Task_8960,723,933,47,153,200,0.7740899357601713,21.736429643528652
Task_8961,2126,191,192,83,275,11.072916666666666,41.64970305571614
Task_8962,1099,597,126,93,219,1.8377926421404682,26.67170338790352
Task_8963,642,175,106,105,211,3.647727272727273,17.7567711110752
Task_8964,2151,169,10,66,76,12.652941176470588,39.85605136404995
Task_8965,1238,514,132,35,167,2.403883495145631,27.518268596552616
Task_8966,2557,407,200,193,393,6.267156862745098,50.141710236979954
Task_8967,2810,817,95,110,205,3.43520782396088,54.561642372516026
Task_8968,2568,573,13,127,140,4.473867595818815,49.36801653580656
Task_8969,2828,840,73,148,221,3.3626634958382877,55.10371371328324
Task_8970,2308,906,162,169,331,2.5446527012127893,47.4705107041996
Task_8971,2824,842,197,91,288,3.3499406880189797,54.99192575337023
Task_8972,1850,394,99,105,204,4.6835443037974684,37.932537560650175
Task_8973,870,740,60,63,123,1.174089068825911,22.504391219006465
Task_8974,2806,442,55,48,103,6.334085778781039,51.4280130508099
Task_8975,2178,986,81,171,252,2.2066869300911853,45.410260510713876
Task_8976,1078,91,76,81,157,11.717391304347826,23.244830133673375
Task_8977,1185,733,16,179,195,1.6144414168937329,28.49073759425967
Task_8978,1126,741,122,128,250,1.517520215633423,27.761544221266444
Task_8979,1420,637,73,48,121,2.225705329153605,30.458674770100327
Task_8980,1065,980,73,101,174,1.0856269113149848,27.054855372212618
Task_8981,661,577,104,86,190,1.143598615916955,19.247485584477392
Task_8982,2665,532,41,29,70,5.0,48.97550093183825
Task_8983,963,220,31,195,226,4.357466063348416,23.596886271021557
Task_8984,821,487,200,125,325,1.6823770491803278,22.502569696779762
Task_8985,871,413,158,187,345,2.103864734299517,23.255943345447722
Task_8986,957,978,66,17,83,0.9775280898876404,23.736135685693892
Task_8987,739,371,96,183,279,1.9865591397849462,20.784257258559695
Task_8988,2316,989,17,151,168,2.3393939393939394,46.848084999383055
Task_8989,1489,663,11,174,185,2.2424698795180724,32.961323720159434
Task_8990,546,772,61,159,220,0.7063389391979301,18.765429058129175
Task_8991,2165,421,51,63,114,5.130331753554502,42.048549529353764
Task_8992,1642,949,43,28,71,1.7284210526315789,34.08842976196933
Task_8993,2676,908,37,193,230,2.943894389438944,52.90784349562029
Task_8994,1148,493,74,95,169,2.3238866396761133,26.905759360310753
Task_8995,2276,411,39,32,71,5.524271844660194,42.398221716215176
Task_8996,2924,664,122,54,176,4.396992481203007,54.97290106153355
Task_8997,1803,311,118,90,208,5.778846153846154,36.74403309566469
Task_8998,2568,323,48,196,244,7.925925925925926,49.48791437579624
Task_8999,998,872,173,163,336,1.143184421534937,26.53949792491059
Task_9000,2558,490,60,78,138,5.209775967413442,48.738319088665854
Task_9001,1245,689,114,161,275,1.8043478260869565,29.688547544935314
Task_9002,1109,112,132,25,157,9.814159292035399,23.379418015106893
Task_9003,1409,873,87,106,193,1.6121281464530892,32.403841942978474
Task_9004,2650,728,190,130,320,3.635116598079561,52.224235033122206
Task_9005,2588,239,101,38,139,10.783333333333333,47.726620165871275
Task_9006,1940,651,172,122,294,2.9754601226993866,40.60633340312038
Task_9007,1437,390,39,125,164,3.6751918158567776,31.129245002946714
Task_9008,1232,122,170,112,282,10.016260162601625,27.166499005587394
Task_9009,1432,428,14,89,103,3.337995337995338,30.444524923194496
Task_9010,623,600,117,70,187,1.0366056572379367,18.498920192439225
Task_9011,1884,921,120,131,251,2.0433839479392626,40.382449526999686
Task_9012,621,504,48,198,246,1.2297029702970297,19.092768680143976
Task_9013,732,277,88,52,140,2.633093525179856,18.809620376086297
Task_9014,821,440,131,45,176,1.8616780045351473,20.675259645207674
Task_9015,1723,322,40,11,51,5.3343653250774,33.14427803428087
Task_9016,1503,814,192,59,251,1.8441717791411043,33.38143126441572
Task_9017,1774,221,123,125,248,7.990990990990991,36.368782128461625
Task_9018,1354,836,193,124,317,1.6176821983273597,31.994249759225784
Task_9019,510,387,64,126,190,1.3144329896907216,16.730215202722118
Task_9020,1591,66,23,168,191,23.746268656716417,32.028128442542645
Task_9021,756,580,183,48,231,1.3012048192771084,20.5523967843523
Task_9022,2109,765,155,52,207,2.7532637075718016,42.73429039885688
Task_9023,1412,680,46,190,236,2.0734214390602057,32.20675562412744
Task_9024,1478,979,166,58,224,1.5081632653061225,33.37258069426186
Task_9025,2603,346,98,191,289,7.501440922190202,50.206608623157855
Task_9026,2033,329,98,109,207,6.16060606060606,40.643873751672366
Task_9027,2151,231,177,144,321,9.27155172413793,42.71650769480012
Task_9028,1497,856,166,96,262,1.7467911318553093,34.05676638364035
Task_9029,2424,535,37,199,236,4.522388059701493,47.774273310693864
Task_9030,1148,723,186,22,208,1.5856353591160222,27.012233472625564
Task_9031,2403,1015,28,114,142,2.3651574803149606,48.122173123118365
Task_9032,2209,945,67,51,118,2.3350951374207187,44.12738983665141
Task_9033,1293,829,63,79,142,1.5578313253012048,29.760196686503576
Task_9034,2346,272,33,24,57,8.593406593406593,43.089088206674035
Task_9035,2431,1000,50,125,175,2.4285714285714284,49.06909917047299
Task_9036,2361,73,127,37,164,31.905405405405407,42.772676880419915
Task_9037,1741,800,26,124,150,2.1735330836454434,36.97432835810965
Task_9038,2412,758,191,115,306,3.177865612648221,48.463270032005056
Task_9039,1480,887,166,20,186,1.6666666666666667,32.413570988323976
Task_9040,1914,986,191,141,332,1.939209726443769,41.43960743203978
Task_9041,2129,976,73,173,246,2.1791197543500513,44.60185332366612
Task_9042,512,979,80,176,256,0.5224489795918368,19.141821106221617
Task_9043,734,226,102,170,272,3.2334801762114536,20.135916048974924
Task_9044,1481,499,85,193,278,2.962,32.93735082882633
Task_9045,2817,320,14,183,197,8.77570093457944,53.10334392087037
Task_9046,1115,870,36,82,118,1.2801377726750862,26.819939171452976
Task_9047,1858,222,106,33,139,8.331838565022421,36.11617614205573
Task_9048,783,140,117,186,303,5.553191489361702,20.44966324234442
Task_9049,787,648,185,135,320,1.2126348228043142,22.348145334960034
Task_9050,2056,634,115,130,245,3.237795275590551,42.1808831913123
Task_9051,920,377,83,122,205,2.433862433862434,23.244655463900155
Task_9052,2457,392,55,142,197,6.251908396946565,47.710072911915454
Task_9053,620,413,105,161,266,1.497584541062802,18.847040869017498
Task_9054,2252,923,156,150,306,2.4372294372294374,46.495640416752416
Task_9055,1222,538,33,138,171,2.267161410018553,28.20281487332438
Task_9056,1336,598,150,119,269,2.2303839732888147,30.75687749393857
Task_9057,993,646,56,140,196,1.534775888717156,25.295843084311326
Task_9058,2249,360,56,127,183,6.229916897506925,44.04512865304966
Task_9059,2321,158,22,117,139,14.59748427672956,43.36534956223212
Task_9060,520,189,103,153,256,2.736842105263158,16.552556099349264
Task_9061,2112,643,117,45,162,3.279503105590062,41.59732499402514
Task_9062,2099,949,160,78,238,2.2094736842105265,43.442384599835414
Task_9063,1288,406,82,127,209,3.1646191646191646,29.22399304233618
Task_9064,1861,443,185,62,247,4.191441441441442,37.90188203679498
Task_9065,744,781,170,113,283,0.9514066496163683,21.935828387092712
Task_9066,2283,980,80,125,205,2.327217125382263,46.79984763901166
Task_9067,979,574,130,98,228,1.702608695652174,24.80265893198295
Task_9068,2192,491,176,196,372,4.455284552845528,44.54841118172916
Task_9069,739,210,145,10,155,3.5023696682464456,18.332934796643947
Task_9070,2148,304,76,45,121,7.0426229508196725,40.807623383484575
Task_9071,1357,746,106,172,278,1.8165997322623828,31.66993093081074
Task_9072,2906,183,101,118,219,15.793478260869565,53.799623843158635
Task_9073,718,690,106,79,185,1.0390738060781477,20.30459597186151
Task_9074,1597,394,22,184,206,4.0430379746835445,34.021926561687295
Task_9075,1147,758,23,37,60,1.5111989459815547,25.71935308511293
Task_9076,1741,801,195,189,384,2.1708229426433916,38.427476587821005
Task_9077,1836,894,160,177,337,2.0513966480446926,39.99291266341688
Task_9078,2975,555,89,123,212,5.350719424460432,56.36335192559212
Task_9079,870,405,14,95,109,2.142857142857143,21.70530363945898
Task_9080,1844,829,81,20,101,2.221686746987952,37.300376645976584
Task_9081,2275,462,149,171,320,4.913606911447085,45.497602699601636
Task_9082,1414,424,188,55,243,3.327058823529412,30.804893520323784
Task_9083,2026,551,106,22,128,3.670289855072464,39.91870957641088
Task_9084,1982,896,165,148,313,2.20958751393534,42.161856983977415
Task_9085,1381,997,164,147,311,1.3837675350701404,32.873099276875045
Task_9086,564,597,123,197,320,0.9431438127090301,18.798553541746188
Task_9087,974,84,65,157,222,11.458823529411765,22.536957212819186
Task_9088,502,135,144,95,239,3.6911764705882355,15.480456069603306
Task_9089,2602,337,21,46,67,7.6982248520710055,47.345547730636184
Task_9090,1971,764,15,163,178,2.5764705882352943,40.85346355551291
Task_9091,2278,853,151,200,351,2.667447306791569,46.965280403972294
Task_9092,1864,722,72,90,162,2.5781466113416323,38.700747542778
Task_9093,643,557,102,83,185,1.1523297491039426,18.707667780149688
Task_9094,2561,627,105,130,235,4.078025477707007,50.11175544899902
Task_9095,2588,272,101,152,253,9.47985347985348,49.476598996299195
Task_9096,862,669,163,73,236,1.2865671641791045,22.806115667736055
Task_9097,1987,262,112,25,137,7.555133079847908,38.27167012968035
Task_9098,930,751,163,104,267,1.2367021276595744,24.64859509999373
Task_9099,2279,690,156,43,199,3.298118668596237,44.85848491888788
Task_9100,892,575,186,48,234,1.5486111111111112,22.69779500270977
Task_9101,1707,604,164,33,197,2.821487603305785,35.52989195444616
Task_9102,1972,327,63,177,240,6.012195121951219,40.03491994616321
Task_9103,974,703,172,42,214,1.3835227272727273,24.28947834962372
Task_9104,1322,443,173,52,225,2.9774774774774775,29.337596086542174
Task_9105,715,977,147,64,211,0.7310838445807771,21.33090439987806
Task_9106,2987,776,135,44,179,3.844272844272844,56.06339267976605
Task_9107,1630,487,109,142,251,3.3401639344262297,35.014274909318665
Task_9108,2866,752,162,115,277,3.806108897742364,55.505919709507076
Task_9109,1372,759,119,134,253,1.805263157894737,31.779650828932052
Task_9110,811,289,178,83,261,2.796551724137931,21.087512820494723
Task_9111,1817,173,41,97,138,10.442528735632184,35.552895590254295
Task_9112,1019,946,71,77,148,1.0760295670538542,25.69600079250785
Task_9113,600,745,12,88,100,0.8042895442359249,18.11549176118928
Task_9114,668,316,159,71,230,2.107255520504732,18.613262010476067
Task_9115,1916,727,140,151,291,2.631868131868132,40.49375936944589
Task_9116,1421,120,31,18,49,11.743801652892563,27.460313173569574
Task_9117,934,390,103,193,296,2.3887468030690537,23.96802681268569
Task_9118,1180,703,65,73,138,1.6761363636363635,27.462768024005285
Task_9119,1296,707,79,45,124,1.8305084745762712,28.66441019060099
Task_9120,2235,983,103,200,303,2.2713414634146343,46.472884851487755
Task_9121,1141,864,103,148,251,1.3190751445086706,28.416988347718924
Task_9122,1327,136,42,164,206,9.686131386861314,28.552537550841453
Task_9123,2239,453,93,39,132,4.931718061674009,43.07571093759674
Task_9124,2402,550,89,32,121,4.35934664246824,45.67824175387949
Task_9125,1847,189,20,30,50,9.721052631578948,35.127080975317504
Task_9126,1280,451,44,78,122,2.831858407079646,28.279788312772993
Task_9127,2674,128,190,129,319,20.728682170542637,50.06960507280595
Task_9128,850,225,12,16,28,3.7610619469026547,18.84556314537457
Task_9129,2813,797,173,152,325,3.525062656641604,55.07858967633899
Task_9130,2825,260,104,64,168,10.82375478927203,52.008211769888426
Task_9131,2472,454,91,31,122,5.432967032967033,46.5209852114727
Task_9132,539,280,186,112,298,1.9181494661921707,17.2616197785234
Task_9133,2264,253,140,16,156,8.913385826771654,42.54415681549425
Task_9134,1396,565,183,166,349,2.4664310954063606,32.03290063536963
Task_9135,1875,507,28,190,218,3.690944881889764,38.91922929902027
Task_9136,2382,157,21,198,219,15.075949367088608,45.35232268945822
Task_9137,2474,853,23,167,190,2.8969555035128804,49.38158868283211
Task_9138,2895,569,116,186,302,5.078947368421052,55.599850968948125
Task_9139,1798,1006,198,117,315,1.785501489572989,39.551652884055656
Task_9140,2960,206,20,20,40,14.29951690821256,52.052129808328935
Task_9141,1947,944,151,195,346,2.06031746031746,41.97426137928108
Task_9142,2291,782,121,198,319,2.925925925925926,46.80191310795275
Task_9143,2087,750,119,15,134,2.7789613848202395,41.318703884615196
Task_9144,1069,857,129,79,208,1.245920745920746,26.634761068491358
Task_9145,922,361,136,113,249,2.546961325966851,23.35689094307227
Task_9146,2220,306,105,141,246,7.231270358306189,43.73139212722801
Task_9147,2483,879,94,59,153,2.8215909090909093,48.428749934823635
Task_9148,1989,101,67,112,179,19.5,38.13031404114677
Task_9149,569,513,113,135,248,1.1070038910505837,18.130737394054837
Task_9150,1057,79,136,153,289,13.2125,24.027672967591553
Task_9151,2348,142,14,84,98,16.41958041958042,43.34492722587421
Task_9152,2038,931,23,130,153,2.186695278969957,42.156851249578864
Task_9153,2557,299,191,55,246,8.523333333333333,48.48332122822824
Task_9154,1181,701,174,86,260,1.6823361823361824,28.261172561784054
Task_9155,1417,192,169,138,307,7.341968911917099,30.917173520733645
Task_9156,2290,401,128,14,142,5.696517412935323,43.40043536148632
Task_9157,1891,953,172,170,342,1.9821802935010482,41.06017953696371
Task_9158,1906,86,49,77,126,21.908045977011493,36.06514142400102
Task_9159,2647,239,106,131,237,11.029166666666667,50.18372306863853
Task_9160,1532,171,185,79,264,8.906976744186046,31.779769765279543
Task_9161,2191,716,73,127,200,3.0557880055788007,44.49717336191202
Task_9162,2807,249,32,144,176,11.228,52.38057446536407
Task_9163,1897,737,160,186,346,2.5704607046070462,40.52328297801839
Task_9164,2314,547,95,177,272,4.2226277372262775,46.25113137286734
Task_9165,1313,845,68,97,165,1.5520094562647755,30.721602408476354
Task_9166,1896,194,159,176,335,9.723076923076922,38.58864899418245
Task_9167,525,689,60,114,174,0.7608695652173914,17.715442606375657
Task_9168,2701,90,135,178,313,29.681318681318682,50.06508429721839
Task_9169,1478,904,163,62,225,1.6331491712707182,33.19071857685427
Task_9170,1908,531,196,175,371,3.5864661654135337,40.14478941247016
Task_9171,663,281,193,34,227,2.351063829787234,18.119877187980318
Task_9172,2557,314,178,183,361,8.117460317460317,49.66767759529355
Task_9173,1810,380,40,167,207,4.7506561679790025,37.36905280654098
Task_9174,1611,185,49,63,112,8.661290322580646,32.32118317539679
Task_9175,1686,488,148,129,277,3.4478527607361964,36.00209713161879
Task_9176,1968,923,33,96,129,2.1298701298701297,41.04144445121141
Task_9177,2470,403,113,18,131,6.1138613861386135,46.1829008305289
Task_9178,2921,102,40,72,112,28.359223300970875,51.81794256298645
Task_9179,2710,82,95,33,128,32.65060240963855,48.15268897452824
Task_9180,652,432,49,137,186,1.5057736720554273,19.052381859151655
Task_9181,743,376,28,156,184,1.9708222811671088,20.213523374476647
Task_9182,764,489,27,17,44,1.5591836734693878,18.323625243739723
Task_9183,2099,972,107,156,263,2.157245632065776,44.03873223762503
Task_9184,953,188,125,83,208,5.042328042328043,22.885081467906627
Task_9185,811,77,85,45,130,10.397435897435898,18.001477448464616
Task_9186,1412,881,14,14,28,1.600907029478458,29.837890103519214
Task_9187,1318,726,151,147,298,1.81292984869326,31.04332579410952
Task_9188,759,427,34,190,224,1.7733644859813085,21.00105302170998
Task_9189,2549,807,196,189,385,3.1547029702970297,51.252065518303446
Task_9190,1263,504,54,151,205,2.500990099009901,29.223104711738248
Task_9191,1618,307,63,74,137,5.253246753246753,33.22402163713997
Task_9192,1463,271,175,38,213,5.3786764705882355,30.694398698123496
Task_9193,1057,180,89,106,195,5.8397790055248615,24.269236181745224
Task_9194,1804,66,104,30,134,26.925373134328357,33.73890945347982
Task_9195,873,129,146,141,287,6.7153846153846155,21.597825445174
Task_9196,2283,285,132,55,187,7.9825174825174825,43.793882424277946
Task_9197,2312,64,131,96,227,35.56923076923077,43.26425942475871
Task_9198,2702,584,90,152,242,4.618803418803418,52.320707700719794
Task_9199,1599,869,141,123,264,1.8379310344827586,35.75173632693909
Task_9200,1061,747,63,123,186,1.4184491978609626,26.425767329296118
Task_9201,1614,522,159,64,223,3.0860420650095604,34.17636495862862
Task_9202,1273,841,60,42,102,1.51187648456057,28.32266190262989
Task_9203,2414,354,18,173,191,6.8,46.73630560778317
Task_9204,2897,89,141,145,286,32.18888888888889,52.961566193565375
Task_9205,2717,876,185,95,280,3.0980615735461803,53.490936231006465
Task_9206,2793,272,115,199,314,10.23076923076923,53.0604727775952
Task_9207,1521,491,59,56,115,3.091463414634146,31.829336379189858
Task_9208,1680,360,119,115,234,4.653739612188366,35.279952415001055
Task_9209,1825,680,187,21,208,2.679882525697504,37.56456586366795
Task_9210,2350,490,188,168,356,4.786150712830957,46.933286205015825
Task_9211,1947,686,96,186,282,2.834061135371179,40.91982307915899
Task_9212,902,970,100,102,202,0.9289392378990731,24.639261304882623
Task_9213,1866,361,123,69,192,5.154696132596685,37.49666952533776
Task_9214,2759,305,94,151,245,9.016339869281046,52.344187724328556
Task_9215,2113,604,41,84,125,3.492561983471074,42.006527962138215
Task_9216,1328,620,25,177,202,2.138486312399356,30.530703355535717
Task_9217,1167,581,74,197,271,2.0051546391752577,28.282505232269887
Task_9218,1704,830,97,180,277,2.050541516245487,37.45987136580671
Task_9219,1507,866,103,95,198,1.7381776239907727,33.90463251200658
Task_9220,1882,131,18,35,53,14.257575757575758,35.01915524965981
Task_9221,1995,622,19,87,106,3.202247191011236,39.90885100763561
Task_9222,2639,178,198,156,354,14.743016759776536,49.98603359522824
Task_9223,2481,328,45,105,150,7.541033434650456,47.1070260783934
Task_9224,1338,98,120,59,179,13.515151515151516,27.24599341126798
Task_9225,584,235,115,77,192,2.4745762711864407,16.938643615655934
Task_9226,2620,694,28,111,139,3.7697841726618706,50.51201608625497
Task_9227,2986,928,162,11,173,3.2142088266953714,56.46578958694522
Task_9228,2182,800,144,128,272,2.724094881398252,44.816961439937415
Task_9229,1563,632,63,157,220,2.4691943127962084,34.42137695406905
Task_9230,1566,109,120,148,268,14.236363636363636,32.08673021169982
Task_9231,1245,725,79,21,100,1.7148760330578512,27.63684453789229
Task_9232,1701,863,110,44,154,1.96875,35.71167648475875
Task_9233,963,749,91,108,199,1.284,24.936890453590177
Task_9234,1175,973,148,151,299,1.2063655030800822,29.47248116447345
Task_9235,2193,624,124,90,214,3.5088,43.955908234367655
Task_9236,1707,240,102,46,148,7.08298755186722,33.819985810219045
Task_9237,701,243,32,122,154,2.872950819672131,18.762355547040794
Task_9238,2957,921,167,153,320,3.207158351409978,57.728118461126144
Task_9239,1673,560,39,89,128,2.982174688057041,35.124778398534
Task_9240,1944,377,95,73,168,5.142857142857143,38.619842164737584
Task_9241,1205,793,163,62,225,1.5176322418136021,28.499987989322815
Task_9242,1097,286,87,96,183,3.822299651567944,25.417449893456766
Task_9243,698,696,196,162,358,1.0014347202295553,21.27470874607633
Task_9244,1039,324,183,127,310,3.1969230769230768,25.384264550573448
Task_9245,2572,315,177,108,285,8.139240506329115,49.45587223799163
Task_9246,2163,902,137,40,177,2.395348837209302,43.41043993545026
Task_9247,826,406,82,81,163,2.0294840294840295,21.1714570760484
Task_9248,2611,980,20,102,122,2.6615698267074412,51.16314350388305
Task_9249,960,455,91,119,210,2.1052631578947367,24.13800123733788
Task_9250,2315,767,13,121,134,3.0143229166666665,45.962094648922154
Task_9251,2897,631,87,74,161,4.583860759493671,54.38220708399583
Task_9252,2861,219,139,148,287,13.004545454545454,53.73601981119663
Task_9253,582,559,144,56,200,1.0392857142857144,17.80722202050884
Task_9254,1555,84,90,60,150,18.294117647058822,30.34206162834612
Task_9255,2701,127,15,175,190,21.1015625,49.96490283894142
Task_9256,2264,463,189,184,373,4.879310344827586,45.58465883668953
Task_9257,2977,954,127,127,254,3.1172774869109947,57.81269858274643
Task_9258,702,630,128,94,222,1.1125198098256734,20.348491752882705
Task_9259,850,129,23,170,193,6.538461538461538,20.91667548265917
Task_9260,2698,216,12,88,100,12.433179723502304,49.620226880707634
Task_9261,1487,871,97,198,295,1.7052752293577982,34.24326578147804
Task_9262,556,165,189,69,258,3.3493975903614457,16.256517565194248
Task_9263,2882,970,25,69,94,2.968074150360453,54.7382004587922
Task_9264,2591,862,159,150,309,3.0023174971031286,51.690142926083944
Task_9265,2570,277,175,31,206,9.244604316546763,48.15096998373091
Task_9266,1521,856,135,42,177,1.7747957992998833,33.07574175775293
Task_9267,1881,797,39,192,231,2.357142857142857,39.96026725511387
Task_9268,1487,589,160,30,190,2.5203389830508476,31.962272860228108
Task_9269,1875,422,142,40,182,4.432624113475177,37.35949891997287
Task_9270,601,478,168,191,359,1.254697286012526,19.132049666628493
Task_9271,2185,599,185,117,302,3.6416666666666666,44.35102799142023
Task_9272,1554,901,126,191,317,1.7228381374722839,35.463266958499894
Task_9273,1739,315,21,171,192,5.503164556962025,35.93733791010214
Task_9274,1542,798,199,24,223,1.9299123904881101,33.56779842253258
Task_9275,1404,346,35,97,132,4.046109510086455,30.244197452524915
Task_9276,2455,111,109,93,202,21.919642857142858,45.63455916446253
Task_9277,517,358,168,167,335,1.4401114206128134,17.33910054196104
Task_9278,2555,501,190,143,333,5.089641434262949,50.07389597067697
Task_9279,1833,275,36,158,194,6.641304347826087,37.3059119365542
Task_9280,2119,207,156,67,223,10.1875,41.12515098987894
Task_9281,2897,407,65,181,246,7.1004901960784315,54.967128810561825
Task_9282,2366,797,18,55,73,2.9649122807017543,45.41808418659619
Task_9283,1030,350,191,32,223,2.9344729344729346,24.12424355207206
Task_9284,2306,454,173,95,268,5.068131868131868,45.58840121890455
Task_9285,1616,85,102,59,161,18.790697674418606,31.375787092847897
Task_9286,1560,269,197,119,316,5.777777777777778,33.45430087203644
Task_9287,2595,438,41,90,131,5.911161731207289,49.231009792058565
Task_9288,1539,515,143,147,290,2.9825581395348837,33.84561020456167
Task_9289,2239,1021,154,106,260,2.190802348336595,46.32287213670208
Task_9290,2432,614,37,13,50,3.9544715447154473,45.32481567713237
Task_9291,1920,222,160,189,349,8.609865470852018,39.22710965084102
Task_9292,1744,91,103,53,156,18.956521739130434,33.399679386516894
Task_9293,1412,582,89,17,106,2.4219554030874786,29.70501211190734
Task_9294,1831,344,143,150,293,5.3072463768115945,37.93295830333384
Task_9295,2970,690,184,51,235,4.298118668596238,56.207700555548456
Task_9296,1221,382,37,180,217,3.1879895561357703,28.128340094454114
Task_9297,2735,701,184,84,268,3.8960113960113962,52.889915636084794
Task_9298,2718,862,58,80,138,3.149478563151796,52.50740530630198
Task_9299,875,846,106,127,233,1.0330578512396693,23.94704494097034
Task_9300,2782,966,187,195,382,2.8769389865563597,55.436732842117465
Task_9301,689,343,174,149,323,2.002906976744186,20.00036837179093
Task_9302,1390,597,104,184,288,2.3244147157190636,31.789828962183297
Task_9303,1342,626,107,95,202,2.1403508771929824,30.574293490088717
Task_9304,2138,993,143,113,256,2.1509054325955734,44.627481180397155
Task_9305,1755,340,162,170,332,5.146627565982405,36.92270831778233
Task_9306,1137,1008,158,108,266,1.1268582755203171,28.68985352849653
Task_9307,1711,354,87,72,159,4.819718309859155,34.62722097556733
Task_9308,2909,939,73,63,136,3.09468085106383,55.53581175340988
Task_9309,644,898,122,160,282,0.7163515016685206,20.877629956544652
Task_9310,1745,934,163,121,284,1.8663101604278074,38.35436697550339
Task_9311,2161,412,96,85,181,5.232445520581114,42.364626199217035
Task_9312,827,504,84,30,114,1.6376237623762375,20.550904828916906
Task_9313,813,184,109,119,228,4.394594594594595,20.817754419769123
Task_9314,625,740,149,50,199,0.8434547908232118,18.931598409671057
Task_9315,1861,255,44,199,243,7.26953125,37.9643480317015
Task_9316,1026,651,72,21,93,1.5736196319018405,23.939125262655136
Task_9317,2143,490,186,90,276,4.364562118126273,43.016626076379055
Task_9318,2501,266,104,22,126,9.367041198501873,46.34993369273345
Task_9319,1110,190,113,105,218,5.81151832460733,25.617958674755616
Task_9320,942,288,190,74,264,3.2595155709342563,23.09194294652229
Task_9321,2463,678,107,178,285,3.6273932253313697,49.016862336826364
Task_9322,902,95,100,100,200,9.395833333333334,21.137583133713484
Task_9323,1741,181,82,115,197,9.565934065934066,35.17279282239348
Task_9324,2749,587,27,157,184,4.675170068027211,52.64204820013066
Task_9325,846,583,150,172,322,1.4486301369863013,23.198528652238412
Task_9326,920,192,146,104,250,4.766839378238342,22.76717661811027
Task_9327,1804,456,76,23,99,3.947483588621444,35.681212951944694
Task_9328,2874,825,33,49,82,3.4794188861985473,53.7197972635445
Task_9329,1787,706,23,46,69,2.5275813295615275,35.705877091885974
Task_9330,1455,561,158,113,271,2.588967971530249,32.52532935640972
Task_9331,1876,538,54,61,115,3.4805194805194803,37.59057908550087
Task_9332,2476,501,185,181,366,4.932270916334661,49.027652032021216
Task_9333,731,578,178,88,266,1.2625215889464594,20.696476868485743
Task_9334,1432,885,178,74,252,1.6162528216704288,32.6740731511176
Task_9335,1451,782,160,29,189,1.8531289910600255,31.973606191314115
Task_9336,1444,804,188,36,224,1.7937888198757763,32.11071108755868
Task_9337,2557,250,177,105,282,10.187250996015937,48.96786356046467
Task_9338,690,709,179,183,362,0.971830985915493,21.302472502471172
Task_9339,2768,434,149,109,258,6.363218390804597,52.8386899725535
Task_9340,2313,523,67,36,103,4.41412213740458,43.9218543729722
Task_9341,977,134,103,72,175,7.237037037037037,22.155925537331115
Task_9342,2559,370,191,82,273,6.8975741239892185,49.0628488420085
Task_9343,556,425,27,99,126,1.3051643192488263,16.928195883192984
Task_9344,1652,440,114,138,252,3.746031746031746,35.21096379153467
Task_9345,2980,335,135,55,190,8.869047619047619,55.034874714261186
Task_9346,1278,752,69,29,98,1.697211155378486,28.304641730478824
Task_9347,2526,961,17,139,156,2.625779625779626,49.88750681412768
Task_9348,2798,932,136,168,304,2.9989281886387995,55.1929213355152
Task_9349,1233,311,192,175,367,3.951923076923077,28.737040529119707
Task_9350,1312,250,12,72,84,5.227091633466135,27.46561932256896
Task_9351,1610,579,21,122,143,2.7758620689655173,34.15473972869982
Task_9352,2510,528,188,174,362,4.744801512287334,49.62468505984634
Task_9353,1113,191,87,64,151,5.796875,24.655228340764342
Task_9354,1703,473,67,90,157,3.5928270042194095,35.309601250862876
Task_9355,2250,65,54,195,249,34.09090909090909,42.55410566321618
Task_9356,2932,515,191,101,292,5.682170542635659,55.84153061570237
Task_9357,2768,899,156,48,204,3.0755555555555554,53.29883710241407
Task_9358,2511,996,173,165,338,2.518555667001003,50.99353924899449
Task_9359,1781,623,157,18,175,2.8541666666666665,36.31504240970174
Task_9360,1413,751,92,20,112,1.8789893617021276,30.443781812575924
Task_9361,2375,402,16,157,173,5.893300248138958,46.09616729585951
Task_9362,1494,788,51,78,129,1.8935361216730038,33.01998760235073
Task_9363,1660,516,141,67,208,3.2108317214700195,34.83668600489227
Task_9364,2060,171,63,56,119,11.976744186046512,38.72617995969356
Task_9365,2998,313,138,157,295,9.547770700636942,56.30198537765947
Task_9366,552,495,179,134,313,1.1129032258064515,18.082599596382163
Task_9367,2122,225,92,16,108,9.389380530973451,39.96613290904107
Task_9368,1614,816,187,134,321,1.9755201958384332,36.097541343625664
Task_9369,1708,1024,31,76,107,1.666341463414634,36.60172823111731
Task_9370,2641,113,63,142,205,23.166666666666668,48.956756814482844
Task_9371,2494,434,164,141,305,5.733333333333333,48.760948510772685
Task_9372,1017,983,137,199,336,1.0335365853658536,27.1906580101362
Task_9373,890,471,25,193,218,1.8855932203389831,23.22411863999587
Task_9374,1110,615,45,63,108,1.801948051948052,25.651547919037412
Task_9375,766,248,163,31,194,3.076305220883534,19.488373535477752
Task_9376,2724,376,106,122,228,7.225464190981432,51.83262185176974
Task_9377,2863,308,34,121,155,9.26537216828479,53.18416760686049
Task_9378,2222,941,59,173,232,2.358811040339703,45.931197537243065
Task_9379,2142,124,29,60,89,17.136,39.48299333703114
Task_9380,2647,321,44,70,114,8.220496894409937,49.290316182648155
Task_9381,755,145,55,118,173,5.171232876712328,19.354638322334015
Task_9382,2792,544,143,186,329,5.122935779816514,54.010097808219655
Task_9383,2646,650,193,185,378,4.064516129032258,52.256173715509455
Task_9384,1814,596,153,12,165,3.0385259631490786,36.84320365578158
Task_9385,2297,662,113,165,278,3.464555052790347,46.28639286765517
Task_9386,1201,116,136,157,293,10.264957264957266,26.68124581408691
Task_9387,2551,125,66,117,183,20.246031746031747,47.388843162781654
Task_9388,1592,629,148,200,348,2.526984126984127,35.383211847733286
Task_9389,1901,352,167,155,322,5.385269121813031,39.20476182444291
Task_9390,1224,602,62,76,138,2.029850746268657,27.89762997049966
Task_9391,687,172,125,112,237,3.9710982658959537,18.609547488033943
Task_9392,2563,132,186,199,385,19.270676691729324,48.75745235797723
Task_9393,2733,700,140,23,163,3.898716119828816,51.71252408045654
Task_9394,1931,637,120,122,242,3.0266457680250785,40.18533902162713
Task_9395,1874,121,174,62,236,15.360655737704919,36.61927497043323
Task_9396,924,861,26,51,77,1.0719257540603249,22.639762840255514
Task_9397,1676,827,141,89,230,2.024154589371981,36.45048977256551
Task_9398,590,984,41,141,182,0.5989847715736041,19.63997966783109
Task_9399,1048,822,57,190,247,1.2733900364520048,26.925468330532173
Task_9400,2476,707,60,138,198,3.4971751412429377,48.99155292958949
Task_9401,1316,405,49,52,101,3.2413793103448274,28.11541125109476
Task_9402,1845,105,139,200,339,17.40566037735849,36.8323757021816
Task_9403,1369,448,131,113,244,3.048997772828508,30.684673194192257
Task_9404,586,72,118,195,313,8.027397260273972,16.768212454449667
Task_9405,1902,418,171,38,209,4.5393794749403344,38.105430548283444
Task_9406,2596,633,157,47,204,4.094637223974764,49.72636447688716
Task_9407,2317,792,144,117,261,2.921815889029004,46.865016586211446
Task_9408,676,585,81,141,222,1.1535836177474403,20.08021506173428
Task_9409,2417,383,40,103,143,6.294270833333333,46.302811974708106
Task_9410,831,227,55,20,75,3.6447368421052633,18.656787875112723
Task_9411,2573,244,57,89,146,10.50204081632653,48.302119485929545
Task_9412,2647,307,177,194,371,8.594155844155845,51.12748925757296
Task_9413,1165,582,198,167,365,1.9982847341337908,28.501832325331915
Task_9414,2885,592,53,178,231,4.865092748735244,55.353394952580004
Task_9415,1249,237,58,136,194,5.2478991596638656,28.060512148832927
Task_9416,1253,800,79,157,236,1.564294631710362,30.07055547100217
Task_9417,2559,195,24,151,175,13.056122448979592,48.28619564282528
Task_9418,2312,381,50,28,78,6.052356020942408,42.96902977724765
Task_9419,2196,439,27,100,127,4.990909090909091,43.00051571169869
Task_9420,875,352,151,108,259,2.4787535410764874,22.622476819827753
Task_9421,2995,627,102,53,155,4.769108280254777,55.828735652067884
Task_9422,2398,173,28,154,182,13.781609195402298,45.19573073729136
Task_9423,2485,988,137,26,163,2.512639029322548,48.70502456499636
Task_9424,2183,177,64,69,133,12.264044943820224,41.11321975640661
Task_9425,2478,489,187,78,265,5.057142857142857,48.11653142999961
Task_9426,2998,706,159,167,326,4.2404526166902405,57.74857015506342
Task_9427,2301,396,177,153,330,5.795969773299748,45.71184825189912
Task_9428,2132,523,68,150,218,4.068702290076335,43.06184300748163
Task_9429,2429,860,182,49,231,2.821138211382114,47.99337587071011
Task_9430,1170,597,145,62,207,1.9565217391304348,27.26922828268357
Task_9431,2295,755,11,86,97,3.0357142857142856,44.965156874515515
Task_9432,2315,182,155,69,224,12.650273224043715,44.112955293103774
Task_9433,1300,319,184,65,249,4.0625,28.689597401415345
Task_9434,1359,308,56,190,246,4.398058252427185,30.354809965781893
Task_9435,716,728,98,99,197,0.9821673525377229,20.90980672914013
Task_9436,2073,187,190,181,371,11.02659574468085,41.70149824850502
Task_9437,945,1008,175,95,270,0.9365708622398414,25.702313159083854
Task_9438,2068,806,182,187,369,2.5625774473358116,43.55327449872619
Task_9439,1297,115,43,114,157,11.181034482758621,26.99481970374424
Task_9440,1423,1022,133,115,248,1.391006842619746,33.28525361638544
Task_9441,2863,186,190,135,325,15.310160427807487,53.9343581729103
Task_9442,2260,67,78,91,169,33.23529411764706,42.13482392526344
Task_9443,1723,773,85,133,218,2.2260981912144704,37.27201902328306
Task_9444,2676,239,156,48,204,11.15,49.68254741326002
Task_9445,2276,291,74,106,180,7.794520547945205,44.16600490773985
Task_9446,1963,808,96,199,295,2.426452410383189,41.632896481153246
Task_9447,1209,946,121,198,319,1.276663146779303,30.076666698398245
Task_9448,823,885,117,157,274,0.9288939051918735,23.529824384637077
Task_9449,1652,1009,52,18,70,1.6356435643564355,34.15482397559341
Task_9450,2794,1005,118,44,162,2.7773359840954273,53.56581364574068
Task_9451,1967,924,92,167,259,2.1264864864864865,41.873322246855395
Task_9452,1570,753,145,19,164,2.0822281167108754,33.34528352058842
Task_9453,1615,730,180,45,225,2.2093023255813953,34.5443835617128
Task_9454,2869,706,54,56,110,4.057991513437058,53.71632481629144
Task_9455,586,936,159,147,306,0.6254002134471718,20.253040341814334
Task_9456,2060,864,170,108,278,2.3815028901734103,43.081649348052416
Task_9457,884,122,39,191,230,7.186991869918699,21.562897058180038
Task_9458,1831,891,123,166,289,2.052690582959641,39.67188804496343
Task_9459,1650,143,60,170,230,11.458333333333334,33.8810919509597
Task_9460,705,351,23,89,112,2.002840909090909,18.879448133615515
Task_9461,675,736,50,45,95,0.9158751696065129,18.73546477126105
Task_9462,2986,1021,177,137,314,2.9217221135029354,58.44967949203116
Task_9463,2070,997,71,21,92,2.0741482965931866,41.534134212450276
Task_9464,1159,92,146,80,226,12.46236559139785,25.097311243651337
Task_9465,2694,437,84,20,104,6.1506849315068495,49.49291018267507
Task_9466,716,662,133,194,327,1.0799396681749622,21.363776896630494
Task_9467,971,835,76,173,249,1.1614832535885167,25.73737472675271
Task_9468,1819,345,30,27,57,5.257225433526012,35.002836475208426
Task_9469,1151,575,158,101,259,1.9982638888888888,27.683727437702846
Task_9470,2716,782,148,140,288,3.4687100893997447,53.310304258640976
Task_9471,1136,161,17,23,40,7.012345679012346,23.286407944075037
Task_9472,939,239,124,18,142,3.9125,21.40731173914394
Task_9473,2971,409,152,80,232,7.246341463414634,55.523117717648226
Task_9474,2700,593,89,144,233,4.545454545454546,52.25606682247161
Task_9475,1804,427,183,168,351,4.214953271028038,38.06491814056334
Task_9476,1212,562,62,145,207,2.152753108348135,28.56706311447806
Task_9477,1555,467,103,78,181,3.322649572649573,32.861221946469996
Task_9478,611,588,54,184,238,1.0373514431239388,19.148233013111277
Task_9479,1351,181,196,85,281,7.423076923076923,29.12105891426815
Task_9480,1401,447,63,106,169,3.127232142857143,30.77947752809733
Task_9481,825,855,138,161,299,0.9637850467289719,23.576891754895083
Task_9482,1031,303,165,127,292,3.3914473684210527,25.108588370571436
Task_9483,2153,763,119,93,212,2.818062827225131,43.85460395467769
Task_9484,1381,846,153,188,341,1.630460448642267,32.65508486256224
Task_9485,2412,477,70,88,158,5.046025104602511,46.49914814560802
Task_9486,1751,455,148,22,170,3.8399122807017543,35.345440459528476
Task_9487,1134,648,113,131,244,1.7473035439137135,27.60546295977976
Task_9488,682,974,100,74,174,0.6994871794871795,20.756142258702912
Task_9489,2662,837,193,90,283,3.1766109785202863,52.36683353498071
Task_9490,756,905,70,85,155,0.8344370860927153,21.457333427503205
Task_9491,841,527,109,54,163,1.5928030303030303,21.5296780477203
Task_9492,1906,974,61,103,164,1.9548717948717949,40.475340435916266
Task_9493,2368,614,177,38,215,3.850406504065041,46.13815736943307
Task_9494,1072,651,52,108,160,1.6441717791411044,26.065517039452754
Task_9495,2012,992,89,124,213,2.026183282980866,42.48978292739667
Task_9496,1558,590,17,48,65,2.6362098138747885,31.704787089601833
Task_9497,902,1012,26,190,216,0.8904244817374136,24.89791816543543
Task_9498,1708,672,129,41,170,2.537890044576523,35.4293194238048
Task_9499,2474,189,76,53,129,13.021052631578947,46.267715935104015
Task_9500,2213,437,186,126,312,5.052511415525114,44.33301602452432
Task_9501,2643,800,114,161,275,3.299625468164794,52.18253384689351
Task_9502,1651,739,44,187,231,2.231081081081081,36.129328225033966
Task_9503,889,630,156,90,246,1.4088748019017432,23.402294554045113
Task_9504,1045,609,194,15,209,1.7131147540983607,24.925912810939394
Task_9505,2339,159,44,180,224,14.61875,44.7656315274693
Task_9506,2679,441,15,122,137,6.0610859728506785,50.679655418959264
Task_9507,2632,503,59,175,234,5.222222222222222,51.05475712312424
Task_9508,1123,247,121,45,166,4.528225806451613,24.80593219568239
Task_9509,2388,621,166,151,317,3.8392282958199355,47.753166332928345
Task_9510,2899,911,11,70,81,3.178728070175439,54.64669303114673
Task_9511,1323,819,42,44,86,1.6134146341463416,29.083346788173785
Task_9512,536,93,155,166,321,5.702127659574468,16.061623135075124
Task_9513,1097,929,11,161,172,1.1795698924731184,27.454756903661643
Task_9514,1795,818,39,77,116,2.191697191697192,37.514846789726306
Task_9515,839,978,67,125,192,0.856996935648621,23.72876547544048
Task_9516,711,515,109,63,172,1.377906976744186,19.49843913577389
Task_9517,2411,122,30,171,201,19.601626016260163,45.43154064339012
Task_9518,1220,627,79,191,270,1.9426751592356688,29.251278961861573
Task_9519,1291,282,45,115,160,4.561837455830389,28.2132902355166
Task_9520,1520,589,75,131,206,2.5762711864406778,33.512207276335495
Task_9521,1238,767,119,136,255,1.6119791666666667,29.68020570548443
Task_9522,571,529,102,93,195,1.0773584905660378,17.84000711290514
Task_9523,1278,286,141,113,254,4.452961672473868,28.7659065724617
Task_9524,2008,527,73,161,234,3.803030303030303,41.20434492836477
Task_9525,2276,711,121,132,253,3.196629213483146,45.947137943744984
Task_9526,609,232,65,159,224,2.6137339055793993,18.074141701109976
Task_9527,2469,700,24,19,43,3.522111269614836,45.9943765014832
Task_9528,1872,168,52,10,62,11.076923076923077,34.996379843329265
Task_9529,1508,114,45,68,113,13.11304347826087,29.8303442318071
Task_9530,1668,400,184,26,210,4.159600997506234,34.27462051608361
Task_9531,1247,430,188,18,206,2.8932714617169375,27.476281762845698
Task_9532,2495,466,56,64,120,5.342612419700214,47.343345713264455
Task_9533,792,905,25,102,127,0.8741721854304636,22.097871619578104
Task_9534,687,360,92,141,233,1.9030470914127424,19.682650107636395
Task_9535,1018,377,13,67,80,2.693121693121693,23.18734181406766
Task_9536,2687,827,27,13,40,3.245169082125604,49.8496248871636
Task_9537,2177,643,181,149,330,3.380434782608696,44.53666448403927
Task_9538,2837,842,35,79,114,3.365361803084223,54.16270590730574
Task_9539,2396,677,10,81,91,3.533923303834808,46.20211744836531
Task_9540,2923,562,157,150,307,5.191829484902309,55.99046626731651
Task_9541,2375,356,173,127,300,6.652661064425771,46.575862476101655
Task_9542,2171,481,22,89,111,4.504149377593361,42.37833856338049
Task_9543,2368,654,94,32,126,3.615267175572519,45.73268142290996
Task_9544,711,729,80,94,174,0.9739726027397261,20.64933176643778
Task_9545,1544,438,11,70,81,3.5170842824601367,31.692629280479917
Task_9546,2049,809,29,111,140,2.5296296296296297,41.847706334673944
Task_9547,2186,170,146,74,220,12.783625730994151,41.821341396867986
Task_9548,948,761,37,52,89,1.2440944881889764,23.191760434073803
Task_9549,1789,376,200,106,306,4.745358090185676,37.36807475263952
Task_9550,2295,671,16,40,56,3.4151785714285716,43.657435564083045
Task_9551,2510,439,93,84,177,5.704545454545454,47.98114871242816
Task_9552,1314,382,179,88,267,3.430809399477807,29.41829296038409
Task_9553,2052,932,45,192,237,2.1993569131832795,43.10524696993078
Task_9554,1325,239,57,24,81,5.520833333333333,27.159846559953106
Task_9555,631,596,135,51,186,1.0569514237855946,18.458802666760896
Task_9556,1599,445,20,19,39,3.585201793721973,31.360834379291642
Task_9557,2272,192,200,74,274,11.7720207253886,43.906909027229155
Task_9558,2680,172,25,199,224,15.491329479768787,50.12983842251669
Task_9559,778,182,67,103,170,4.251366120218579,19.87936636800566
Task_9560,2038,488,171,115,286,4.1676891615541924,41.594500495995824
Task_9561,1030,638,70,118,188,1.6118935837245696,25.758783615436272
Task_9562,1754,291,188,74,262,6.006849315068493,35.929470662258126
Task_9563,2281,244,67,165,232,9.310204081632653,44.56991242540318
Task_9564,2018,800,49,163,212,2.519350811485643,42.16036770909595
Task_9565,2027,811,143,122,265,2.4963054187192117,42.35530308757426
Task_9566,2117,471,63,107,170,4.485169491525424,42.19562573858175
Task_9567,1667,844,123,25,148,1.9727810650887574,35.09505846026561
Task_9568,1715,547,152,74,226,3.1295620437956204,35.98118072130877
Task_9569,1083,382,109,31,140,2.827676240208877,24.41487248090652
Task_9570,2203,1020,117,50,167,2.1576885406464252,44.443826674177195
Task_9571,945,347,88,16,104,2.7155172413793105,21.602829975450742
Task_9572,570,732,68,150,218,0.7776261937244202,18.88728113492191
Task_9573,1602,715,144,199,343,2.2374301675977653,35.78688451296713
Task_9574,1822,142,180,167,347,12.741258741258742,37.0164720000974
Task_9575,615,680,86,185,271,0.9030837004405287,19.616263170805343
Task_9576,2647,824,21,20,41,3.2084848484848485,49.190339053857436
Task_9577,2584,934,151,131,282,2.7636363636363637,51.654749783849866
Task_9578,1715,701,18,117,135,2.443019943019943,36.15812879044403
Task_9579,2201,349,167,40,207,6.288571428571428,42.56840762489069
Task_9580,2739,435,187,53,240,6.282110091743119,51.81237652359443
Task_9581,2163,548,176,195,371,3.939890710382514,44.26583217427622
Task_9582,619,182,132,95,227,3.3825136612021858,17.686411621533278
Task_9583,1323,361,43,25,68,3.654696132596685,27.150718580473054
Task_9584,847,266,47,89,136,3.1722846441947565,20.996473111131916
Task_9585,811,813,52,144,196,0.9963144963144963,22.810022750199767
Task_9586,600,979,104,152,256,0.6122448979591837,20.389708234477286
Task_9587,1127,442,119,161,280,2.544018058690745,27.067997908536
Task_9588,1333,168,153,152,305,7.887573964497041,29.244648954382026
Task_9589,2106,67,170,17,187,30.970588235294116,38.71931482323665
Task_9590,2562,371,115,11,126,6.887096774193548,47.6157501444578
Task_9591,2055,783,23,84,107,2.621173469387755,41.46613640103144
Task_9592,1870,452,77,127,204,4.1280353200883,38.59338310535606
Task_9593,2723,863,97,138,235,3.1516203703703702,53.45732510629131
Task_9594,2724,840,193,33,226,3.2390011890606423,52.512265041275356
Task_9595,2805,351,162,78,240,7.96875,52.72072951958327
Task_9596,1039,397,93,73,166,2.6105527638190953,24.44012555069352
Task_9597,2090,137,40,109,149,15.144927536231885,39.734922616101564
Task_9598,1997,141,126,67,193,14.06338028169014,38.46976145632314
Task_9599,953,197,196,100,296,4.813131313131313,23.547030935185443
Task_9600,2171,793,77,10,87,2.734256926952141,42.317304488485654
Task_9601,833,988,49,111,160,0.8422649140546006,23.167832602057896
Task_9602,1482,309,150,124,274,4.780645161290322,32.17375407592373
Task_9603,573,997,52,40,92,0.5741482965931863,18.05491259114127
Task_9604,2256,1024,43,179,222,2.2009756097560977,46.55098720357532
Task_9605,927,342,30,199,229,2.7026239067055395,23.452206139365103
Task_9606,1085,85,28,26,54,12.616279069767442,22.009815129963204
Task_9607,2858,301,83,60,143,9.463576158940397,52.47309596839938
Task_9608,1062,772,26,38,64,1.3738680465717983,24.330404753208487
Task_9609,1745,350,51,21,72,4.971509971509971,33.741417172572504
Task_9610,1959,935,16,193,209,2.092948717948718,41.479274738394
Task_9611,2035,808,141,33,174,2.515451174289246,41.19233624814992
Task_9612,1771,116,162,47,209,15.136752136752136,34.50052876670906
Task_9613,2356,424,151,186,337,5.543529411764706,46.754311544507345
Task_9614,2236,491,141,38,179,4.544715447154472,43.31082470464005
Task_9615,2628,770,104,161,265,3.4085603112840466,51.805543461649904
Task_9616,737,180,61,48,109,4.071823204419889,17.566511171354264
Task_9617,1798,509,162,70,232,3.5254901960784313,37.108241865393325
Task_9618,1793,779,178,63,241,2.2987179487179485,37.89233739845389
Task_9619,2816,526,189,92,281,5.343453510436433,53.877131639415545
Task_9620,2744,705,80,106,186,3.8866855524079322,52.994786798599385
Task_9621,2686,694,134,123,257,3.864748201438849,52.392908160672256
Task_9622,505,1003,129,85,214,0.5029880478087649,18.369660126089688
Task_9623,2464,182,109,152,261,13.46448087431694,47.04284521716036
Task_9624,1824,825,78,185,263,2.208232445520581,39.39680331061073
Task_9625,2342,660,156,71,227,3.5431164901664145,46.18936374505609
Task_9626,723,439,72,149,221,1.643181818181818,20.49444138845694
Task_9627,577,892,115,142,257,0.6461366181410975,19.68995344259651
Task_9628,1502,576,99,104,203,2.603119584055459,32.99880408913523
Task_9629,1841,615,161,30,191,2.9886363636363638,37.66606540347302
Task_9630,933,355,196,150,346,2.6207865168539324,24.00319020546793
Task_9631,738,385,177,31,208,1.9119170984455958,19.54698200246512
Task_9632,2057,363,170,48,218,5.6510989010989015,40.394521815562015
Task_9633,2151,659,167,180,347,3.2590909090909093,44.29741283214156
Task_9634,1335,330,102,121,223,4.033232628398792,29.684020234661872
Task_9635,1790,226,133,84,217,7.88546255506608,36.14609237750907
Task_9636,1162,859,122,69,191,1.3511627906976744,27.90019092387674
Task_9637,2763,362,55,42,97,7.6115702479338845,50.42737043702346
Task_9638,804,424,160,187,347,1.891764705882353,22.239320923782913
Task_9639,2328,653,29,101,130,3.5596330275229358,45.78217079561754
Task_9640,2975,104,75,194,269,28.333333333333332,54.36511605144985
Task_9641,1963,696,74,84,158,2.8163558106169297,40.034498466632876
Task_9642,974,881,197,180,377,1.1043083900226758,26.334339150592175
Task_9643,1252,431,33,106,139,2.8981481481481484,28.020700184857777
Task_9644,2060,553,185,124,309,3.7184115523465704,42.26731395780505
Task_9645,1696,174,19,109,128,9.691428571428572,33.5792756212698
Task_9646,1876,429,92,32,124,4.362790697674418,37.106992628539025
Task_9647,2950,840,38,106,144,3.507728894173603,56.21592032691217
Task_9648,2201,343,171,77,248,6.398255813953488,43.113478812592
Task_9649,1131,955,10,52,62,1.1830543933054394,26.34684778579667
Task_9650,2397,133,157,150,307,17.888059701492537,45.72495875820558
Task_9651,1864,181,79,130,209,10.241758241758241,37.23194999245741
Task_9652,1495,929,199,84,283,1.60752688172043,34.01556051752838
Task_9653,1867,880,87,180,267,2.119182746878547,40.13796196830651
Task_9654,2525,262,158,141,299,9.600760456273765,48.63578656340356
Task_9655,2504,250,40,132,172,9.97609561752988,47.61510208921053
Task_9656,1288,430,147,28,175,2.988399071925754,28.13874703078328
Task_9657,1438,752,80,32,112,1.9096945551128819,30.98809763126174
Task_9658,565,649,171,191,362,0.8692307692307693,19.15380665891775
Task_9659,2165,855,15,22,37,2.5292056074766354,41.84290022789283
Task_9660,2813,733,19,113,132,3.832425068119891,53.68865032339354
Task_9661,520,815,73,166,239,0.6372549019607843,18.60452566633731
Task_9662,2353,418,48,36,84,5.615751789976134,44.09481771064634
Task_9663,2417,690,195,199,394,3.4978292329956586,48.848174076795196
Task_9664,1637,998,65,25,90,1.6386386386386387,34.52947303054976
Task_9665,503,174,37,173,210,2.874285714285714,15.698049982586
Task_9666,654,755,22,138,160,0.8650793650793651,19.480618089403205
Task_9667,1612,252,21,15,36,6.371541501976284,30.901626672998145
Task_9668,1265,350,138,146,284,3.6039886039886038,28.95347163047774
Task_9669,1846,163,154,109,263,11.25609756097561,37.035523096644916
Task_9670,1722,591,81,19,100,2.9087837837837838,34.59930469590225
Task_9671,1988,339,130,173,303,5.847058823529411,40.478323610776755
Task_9672,966,884,154,187,341,1.0915254237288134,26.064871423684792
Task_9673,2348,225,118,126,244,10.389380530973451,45.431991207469956
Task_9674,2262,163,149,179,328,13.792682926829269,43.990071183333725
Task_9675,1114,585,82,35,117,1.901023890784983,25.33643086124779
Task_9676,1722,668,125,38,163,2.5739910313901344,35.690674346932575
Task_9677,788,682,174,88,262,1.1537335285505124,21.9376307577956
Task_9678,1237,425,119,18,137,2.903755868544601,26.73885968512342
Task_9679,1243,714,170,164,334,1.7384615384615385,29.991633612245845
Task_9680,2854,488,125,129,254,5.83640081799591,54.38854601006892
Task_9681,2563,839,138,181,319,3.051190476190476,51.264994369838085
Task_9682,2284,491,56,186,242,4.642276422764228,45.562941694932256
Task_9683,1332,692,47,182,229,1.922077922077922,30.949815589082238
Task_9684,687,398,45,52,97,1.7218045112781954,18.02503678720043
Task_9685,2728,937,88,57,145,2.908315565031983,52.536429914506805
Task_9686,1163,910,28,114,142,1.2766190998902305,28.00555859533473
Task_9687,2794,599,84,192,276,4.656666666666666,54.0355523928601
Task_9688,1862,994,29,176,205,1.871356783919598,40.16028350437443
Task_9689,633,969,45,76,121,0.6525773195876289,19.601030486788527
Task_9690,1502,259,79,187,266,5.776923076923077,32.5085608435129
Task_9691,1225,760,24,65,89,1.609724047306176,27.77660267270421
Task_9692,2623,304,53,175,228,8.6,50.234900414771836
Task_9693,1538,908,187,53,240,1.691969196919692,34.27813257697898
Task_9694,796,237,190,105,295,3.3445378151260505,21.15986827638564
Task_9695,2695,411,157,45,202,6.54126213592233,50.52324705197061
Task_9696,1698,315,139,156,295,5.3734177215189876,35.75078970330287
Task_9697,1869,980,110,110,220,1.9051987767584098,40.15763124335689
Task_9698,2358,96,176,111,287,24.309278350515463,44.39999823146049
Task_9699,1838,658,190,47,237,2.78907435508346,37.94855761975954
Task_9700,600,549,84,80,164,1.0909090909090908,17.94452259776643
Task_9701,1036,251,139,67,206,4.111111111111111,24.100137593593995
Task_9702,2761,603,77,145,222,4.571192052980132,53.29203974057404
Task_9703,2806,147,98,170,268,18.95945945945946,52.17867753685556
Task_9704,1468,920,193,125,318,1.5939196525515744,34.06728930537517
Task_9705,1474,172,179,97,276,8.520231213872833,31.18150431243895
Task_9706,2908,454,145,187,332,6.391208791208792,55.56840908498879
Task_9707,2864,596,26,154,180,4.797319932998325,54.46164505831708
Task_9708,1268,164,13,85,98,7.684848484848485,26.504174093137113
Task_9709,2296,196,129,173,302,11.654822335025381,44.782861485447455
Task_9710,2266,784,170,89,259,2.886624203821656,45.7944075236777
Task_9711,2161,772,114,58,172,2.795601552393273,43.24509377027808
Task_9712,2483,651,163,82,245,3.808282208588957,48.64391661472487
Task_9713,747,726,159,200,359,1.0275103163686383,22.222546411671953
Task_9714,1980,453,38,168,206,4.361233480176211,40.29332085894328
Task_9715,1956,80,85,184,269,24.14814814814815,38.09800314383369
Task_9716,1621,564,38,43,81,2.8690265486725663,32.97971866358759
Task_9717,1846,665,80,41,121,2.7717717717717716,37.26253102603353
Task_9718,1286,283,190,178,368,4.528169014084507,29.49148734864092
Task_9719,2348,684,122,182,304,3.4277372262773724,47.30573747926726
Task_9720,636,777,54,188,242,0.8174807197943444,20.202841600106883
Task_9721,2900,95,170,74,244,30.208333333333332,52.280716398451574
Task_9722,526,75,99,122,221,6.921052631578948,15.312106010272304
Task_9723,1781,1010,188,95,283,1.76162215628091,39.07662608007004
Task_9724,2615,560,31,196,227,4.661319073083779,50.84902241421497
Task_9725,757,66,110,164,274,11.298507462686567,19.302855080370446
Task_9726,2684,200,30,126,156,13.35323383084577,49.96864242303763
Task_9727,1871,424,101,64,165,4.402352941176471,37.6068276563527
Task_9728,1841,659,50,78,128,2.7893939393939395,38.215932160088215
Task_9729,1024,238,191,183,374,4.2845188284518825,25.235254558637507
Task_9730,1659,388,33,155,188,4.26478149100257,34.900923528005215
Task_9731,2331,652,99,80,179,3.5696784073506893,45.74514704755702
Task_9732,2061,927,99,19,118,2.220905172413793,41.172696361075616
Task_9733,2088,806,144,35,179,2.587360594795539,41.93908944946003
Task_9734,1797,835,39,61,100,2.1495215311004783,36.990085836599974
Task_9735,2037,707,175,11,186,2.8771186440677967,40.739122674601596
Task_9736,552,791,116,111,227,0.696969696969697,18.777240895609577
Task_9737,661,172,94,113,207,3.820809248554913,18.163903757476213
Task_9738,1866,874,60,107,167,2.1325714285714286,39.474849825658815
Task_9739,1006,963,186,21,207,1.0435684647302905,25.450721679373846
Task_9740,1870,411,24,59,83,4.538834951456311,36.61531440359513
Task_9741,1723,798,39,86,125,2.1564455569461827,36.47481950213517
Task_9742,2941,705,58,98,156,4.165722379603399,55.8146367625514
Task_9743,1844,678,143,163,306,2.715758468335788,39.28481949169022
Task_9744,1326,409,128,175,303,3.234146341463415,30.23651964044531
Task_9745,2028,718,163,99,262,2.820584144645341,42.01801034219187
Task_9746,951,558,180,49,229,1.701252236135957,23.615560001093815
Task_9747,2927,902,107,119,226,3.241417497231451,56.719757844593175
Task_9748,2090,219,69,71,140,9.5,40.27409678867112
Task_9749,2595,808,144,101,245,3.207663782447466,51.22400622909894
Task_9750,854,148,159,73,232,5.731543624161074,20.739642901872845
Task_9751,1860,979,113,89,202,1.8979591836734695,39.712494780827235
Task_9752,973,432,189,69,258,2.2471131639722866,23.89478109437174
Task_9753,1847,367,36,98,134,5.019021739130435,37.21304076636127
Task_9754,632,501,62,75,137,1.2589641434262948,18.20766461677264
Task_9755,1509,520,114,51,165,2.896353166986564,32.16191301142236
Task_9756,1775,165,149,119,268,10.69277108433735,35.96148077613643
Task_9757,2272,254,198,65,263,8.909803921568628,43.89508917260588
Task_9758,2114,788,38,68,106,2.679340937896071,42.124749762845404
Task_9759,2116,148,176,197,373,14.201342281879194,41.84091871012833
Task_9760,1263,914,60,115,175,1.380327868852459,30.147512370943772
Task_9761,2324,234,56,123,179,9.88936170212766,44.76640775758718
Task_9762,1846,815,138,65,203,2.2622549019607843,38.69710505729489
Task_9763,1806,889,125,47,172,2.0292134831460675,37.7934804516715
Task_9764,1658,425,153,78,231,3.892018779342723,34.77733450086324
Task_9765,1427,319,104,190,294,4.459375,31.52400482601904
Task_9766,1451,882,18,99,117,1.6432616081540203,32.3950987792477
Task_9767,1510,1008,186,173,359,1.4965312190287414,35.231555673253666
Task_9768,2199,898,190,132,322,2.446051167964405,45.623615648541865
Task_9769,2251,407,131,103,234,5.517156862745098,44.4509558643671
Task_9770,746,108,74,23,97,6.844036697247707,17.24340374379386
Task_9771,1586,378,162,12,174,4.1846965699208445,32.569906179406765
Task_9772,1150,753,42,157,199,1.5251989389920424,28.008924505982193
Task_9773,696,623,187,145,332,1.1153846153846154,20.86221436831548
Task_9774,542,142,145,98,243,3.7902097902097904,16.263289998955603
Task_9775,1193,944,194,51,245,1.2624338624338625,28.880710893954127
Task_9776,856,890,171,152,323,0.9607182940516273,24.27130266451326
Task_9777,2720,309,86,78,164,8.774193548387096,50.83485225253358
Task_9778,888,278,124,119,243,3.182795698924731,22.53403776895382
Task_9779,2669,178,71,30,101,14.910614525139664,48.216915003109534
Task_9780,2154,75,53,57,110,28.342105263157894,39.38398786401117
Task_9781,908,872,172,127,299,1.0400916380297824,24.84783335297981
Task_9782,1719,179,199,56,255,9.55,34.700389748020655
Task_9783,1981,326,153,37,190,6.058103975535168,38.93988809342008
Task_9784,795,1013,23,12,35,0.7840236686390533,20.649060863866904
Task_9785,2494,865,71,23,94,2.879907621247113,47.90317692072659
Task_9786,1606,354,148,20,168,4.523943661971831,32.581669784677565
Task_9787,2520,408,106,141,247,6.161369193154035,48.82527021780001
Task_9788,2182,393,116,122,238,5.538071065989848,43.35891956090237
Task_9789,1686,382,165,114,279,4.402088772845953,35.64810281805544
Task_9790,1635,689,163,55,218,2.369565217391304,35.02795470533027
Task_9791,761,440,165,172,337,1.72562358276644,21.52855912007333
Task_9792,2035,285,190,146,336,7.115384615384615,41.146985212907275
Task_9793,2991,168,171,34,205,17.698224852071007,54.23187194117955
Task_9794,2576,268,62,28,90,9.576208178438662,47.01319089585152
Task_9795,1103,760,112,130,242,1.4494086727989488,27.397467520658964
Task_9796,1819,482,138,115,253,3.7660455486542443,37.95969126253492
Task_9797,942,236,139,63,202,3.9746835443037973,22.520994877282273
Task_9798,2365,397,39,133,172,5.942211055276382,45.927243089817146
Task_9799,897,709,91,66,157,1.263380281690141,22.758585677947767
Task_9800,1584,808,27,157,184,1.9579728059332508,34.884370328457685
Task_9801,2891,820,93,83,176,3.5213154689403168,55.238295421568516
Task_9802,2086,501,157,78,235,4.155378486055777,41.81421577104766
Task_9803,2973,119,20,72,92,24.775,52.682702714067126
Task_9804,1466,677,193,38,231,2.162241887905605,32.12238153330217
Task_9805,2748,969,86,154,240,2.8329896907216496,54.24925590330807
Task_9806,2452,853,93,57,150,2.871194379391101,47.91679336551413
Task_9807,1656,107,129,33,162,15.333333333333334,32.0207069558708
Task_9808,2061,863,38,146,184,2.3854166666666665,42.56503936928351
Task_9809,2387,689,159,84,243,3.4594202898550726,47.226962941202316
Task_9810,1481,141,182,188,370,10.429577464788732,31.749743847545645
Task_9811,2130,452,162,16,178,4.701986754966887,41.29210404216371
Task_9812,2424,293,43,76,119,8.244897959183673,45.76758578961958
Task_9813,1067,420,186,95,281,2.534441805225653,25.92834530079107
Task_9814,2883,874,178,66,244,3.294857142857143,55.475541605108695
Task_9815,1607,751,193,98,291,2.136968085106383,35.59936426181882
Task_9816,855,277,193,161,354,3.0755395683453237,22.57103168894552
Task_9817,2063,302,158,121,279,6.808580858085809,41.35470543244135
Task_9818,809,955,163,165,328,0.8462343096234309,23.765994446628856
Task_9819,2136,593,192,165,357,3.595959595959596,43.87427098150686
Task_9820,2289,198,22,25,47,11.50251256281407,41.784940354323076
Task_9821,1898,258,188,178,366,7.328185328185328,39.06951900380232
Task_9822,523,92,140,166,306,5.623655913978495,15.841967596219888
Task_9823,1067,939,78,104,182,1.1351063829787233,26.971030270575948
Task_9824,2381,307,147,21,168,7.73051948051948,44.77682705002429
Task_9825,1377,381,110,154,264,3.6047120418848166,30.747015028886054
Task_9826,645,628,147,89,236,1.0254372019077902,19.395475024304663
Task_9827,1468,385,197,18,215,3.8031088082901556,30.86979854911473
Task_9828,2164,320,136,148,284,6.741433021806854,43.07537504305237
Task_9829,1261,976,165,158,323,1.2906857727737973,30.95296540719041
Task_9830,1482,1001,86,113,199,1.4790419161676647,33.996562635305025
Task_9831,1010,360,106,89,195,2.7977839335180055,24.277761775057964
Task_9832,862,736,61,110,171,1.169606512890095,23.04415300571478
Task_9833,1813,1018,183,166,349,1.7791952894995093,40.03824204813473
Task_9834,2638,732,150,29,179,3.5989085948158253,50.42442636083022
Task_9835,1637,431,200,38,238,3.7893518518518516,34.0842903111146
Task_9836,680,390,90,46,136,1.7391304347826086,18.086842906087774
Task_9837,1589,117,132,136,268,13.466101694915254,32.70268734709783
Task_9838,1919,564,84,49,133,3.3964601769911504,38.31380074537655
Task_9839,1008,246,18,27,45,4.080971659919029,21.68623258999304
Task_9840,1224,301,95,14,109,4.052980132450331,26.075678755535417
Task_9841,2130,220,154,86,240,9.638009049773755,41.62961356100249
Task_9842,1205,595,73,45,118,2.021812080536913,26.799241698928483
Task_9843,559,353,160,67,227,1.57909604519774,16.96512882816445
Task_9844,2346,570,134,180,314,4.108581436077058,46.95483180152652
Task_9845,1492,686,74,15,89,2.1717612809315865,31.275770901064163
Task_9846,1297,288,193,183,376,4.4878892733564015,29.725375223890964
Task_9847,1156,372,161,67,228,3.099195710455764,26.490885344317665
Task_9848,528,89,121,42,163,5.866666666666666,14.211535494761614
Task_9849,746,502,57,156,213,1.4831013916500995,21.03648321765264
Task_9850,1452,992,143,195,338,1.4622356495468278,34.17483545791596
Task_9851,1176,712,26,198,224,1.6493688639551192,28.51910241109461
Task_9852,2696,418,73,149,222,6.43436754176611,51.66960520021871
Task_9853,1386,762,89,133,222,1.81651376146789,31.909395619047093
Task_9854,571,893,148,174,322,0.6387024608501118,19.913095249726815
Task_9855,520,78,101,72,173,6.582278481012659,14.419185851534744
Task_9856,2468,825,22,170,192,2.9878934624697338,49.09690431746042
Task_9857,2769,288,21,192,213,9.581314878892734,52.2541802657533
Task_9858,776,624,46,143,189,1.2416,21.46695378418215
Task_9859,2842,563,123,100,223,5.039007092198582,54.25917473896809
Task_9860,2783,938,200,185,385,2.9637912673056444,55.36397824258387
Task_9861,2529,549,141,91,232,4.598181818181819,49.139257188982924
Task_9862,2829,394,109,63,172,7.162025316455696,52.661342074659224
Task_9863,2071,670,126,152,278,3.0864381520119224,42.71290639806477
Task_9864,2446,672,190,93,283,3.6344725111441307,48.52967952109412
Task_9865,1627,978,63,47,110,1.661899897854954,34.485192877308315
Task_9866,1646,122,118,190,308,13.382113821138212,33.91221667043926
Task_9867,2941,375,176,105,281,7.821808510638298,55.476333088583225
Task_9868,2955,692,86,141,227,4.264069264069264,56.58077444612831
Task_9869,1903,389,27,183,210,4.87948717948718,38.93545488070057
Task_9870,1349,646,188,107,295,2.0850077279752703,31.212596174810628
Task_9871,1636,367,187,64,251,4.445652173913044,34.15344517241429
Task_9872,715,363,15,30,45,1.9642857142857142,17.522405053974435
Task_9873,2858,158,89,190,279,17.9748427672956,53.21413301435024
Task_9874,594,496,92,27,119,1.1951710261569417,16.9394379683477
Task_9875,1281,586,165,91,256,2.1822827938671208,29.602515258433957
Task_9876,974,290,184,32,216,3.3470790378006874,23.013356529221372
Task_9877,501,156,139,120,259,3.1910828025477707,15.816084844080057
Task_9878,2638,1007,86,153,239,2.617063492063492,52.61864411777006
Task_9879,848,942,172,182,354,0.8992576882290562,24.50200669913106
Task_9880,1083,163,57,116,173,6.603658536585366,24.612977558057427
Task_9881,2505,224,170,85,255,11.133333333333333,47.62235513893737
Task_9882,888,133,78,55,133,6.626865671641791,20.395842607166085
Task_9883,2238,401,34,126,160,5.567164179104478,43.64129209308765
Task_9884,1938,345,85,97,182,5.601156069364162,38.95806107609801
Task_9885,2482,391,168,131,299,6.331632653061225,48.387230261008106
Task_9886,1871,744,143,27,170,2.5114093959731543,38.186140913423934
Task_9887,1597,860,195,83,278,1.8548199767711964,35.40317162152459
Task_9888,2677,574,48,194,242,4.655652173913044,52.028433438280814
Task_9889,2649,896,108,191,299,2.9531772575250836,52.73055331957848
Task_9890,1391,290,130,200,330,4.780068728522337,31.035621657595225
Task_9891,2138,760,172,196,368,2.80946123521682,44.52699756578778
Task_9892,2518,393,93,183,276,6.3908629441624365,49.04802995562981
Task_9893,2698,387,29,180,209,6.953608247422681,51.49864710899337
Task_9894,799,562,179,36,215,1.419182948490231,21.09598657973667
Task_9895,1990,593,60,187,247,3.3501683501683504,41.226636031148814
Task_9896,2284,367,103,194,297,6.206521739130435,45.25789823163478
Task_9897,1579,202,66,142,208,7.778325123152709,33.187738766900026
Task_9898,1632,539,181,25,206,3.022222222222222,34.10869301016074
Task_9899,1909,348,149,52,201,5.469914040114613,38.20946533559985
Task_9900,2020,457,75,64,139,4.4104803493449785,39.90270062976986
Task_9901,2618,742,72,99,171,3.5235531628532972,50.95776674635368
Task_9902,585,170,48,78,126,3.4210526315789473,16.03159203443222
Task_9903,1313,211,120,60,180,6.193396226415095,27.942583339462217
Task_9904,2254,926,38,29,67,2.431499460625674,43.68627925901843
Task_9905,1074,289,65,194,259,3.703448275862069,25.8175272354384
Task_9906,535,777,184,75,259,0.6876606683804627,18.33488959717688
Task_9907,2489,528,31,87,118,4.705103969754253,47.69596310689399
Task_9908,2765,481,85,66,151,5.736514522821577,51.65709185947964
Task_9909,2119,930,12,132,144,2.276047261009667,43.36244062968751
Task_9910,2088,528,109,104,213,3.947069943289225,42.168989249473505
Task_9911,1490,757,139,25,164,1.9656992084432718,32.26569634205835
Task_9912,1472,979,87,107,194,1.5020408163265306,33.70506184641156
Task_9913,827,827,102,169,271,0.998792270531401,23.391317327887425
Task_9914,1377,615,99,126,225,2.2353896103896105,31.273094435494944
Task_9915,2971,1012,116,93,209,2.932872655478776,57.58080579129139
Task_9916,2267,272,64,174,238,8.304029304029305,44.49579318699284
Task_9917,2152,924,40,51,91,2.3264864864864867,42.818486801113465
Task_9918,1084,999,112,93,205,1.084,27.46999555949426
Task_9919,2564,938,19,90,109,2.730564430244941,50.016389068649666
Task_9920,1895,677,49,91,140,2.7949852507374633,39.01434312752412
Task_9921,2491,972,99,25,124,2.5601233299075026,48.39603268315798
Task_9922,2907,428,33,130,163,6.776223776223776,54.49965460371981
Task_9923,1516,829,32,152,184,1.8265060240963855,33.863683601659226
Task_9924,2249,517,165,140,305,4.341698841698841,45.15027504512366
Task_9925,795,393,99,94,193,2.017766497461929,21.11464906351111
Task_9926,934,766,194,96,290,1.2177314211212515,24.87400982705455
Task_9927,2164,439,121,63,184,4.918181818181818,42.2386080608874
Task_9928,648,334,72,110,182,1.9343283582089552,18.5753772760785
Task_9929,856,723,121,74,195,1.1823204419889504,22.76845192561719
Task_9930,1674,300,184,178,362,5.561461794019934,35.65521423014319
Task_9931,1517,554,45,171,216,2.7333333333333334,33.32231046070348
Task_9932,1967,350,157,174,331,5.603988603988604,40.31052595934385
Task_9933,2690,351,78,148,226,7.642045454545454,51.3696559747431
Task_9934,2684,167,99,100,199,15.976190476190476,49.968064564937094
Task_9935,1481,688,57,116,173,2.1494920174165455,32.98506089427714
Task_9936,2704,997,22,78,100,2.7094188376753507,52.170473461826425
Task_9937,2166,490,53,183,236,4.411405295315682,43.67137539225996
Task_9938,538,270,165,85,250,1.985239852398524,16.683249331344978
Task_9939,514,698,12,185,197,0.7353361945636624,17.74331430795654
Task_9940,843,595,18,74,92,1.4144295302013423,21.25011845722862
Task_9941,1834,89,132,127,259,20.377777777777776,36.13732301360968
Task_9942,2614,743,100,71,171,3.513440860215054,50.28616335924639
Task_9943,2752,808,194,140,334,3.4017305315203954,54.16970496154278
Task_9944,1606,303,74,85,159,5.282894736842105,33.14093073739689
Task_9945,2036,842,178,124,302,2.4151838671411627,42.76437696174067
Task_9946,883,181,112,168,280,4.851648351648351,22.012069933774907
Task_9947,1868,76,190,152,342,24.25974025974026,36.91767451905928
Task_9948,2931,355,104,163,267,8.23314606741573,55.27164354801901
Task_9949,2786,658,85,50,135,4.227617602427921,52.317279976295545
Task_9950,2233,772,189,54,243,2.888745148771022,44.84217424187566
Task_9951,741,852,57,129,186,0.8686987104337632,21.619717357435814
Task_9952,784,633,153,55,208,1.2365930599369086,21.287104570348625
Task_9953,531,153,109,22,131,3.448051948051948,14.551662508782933
Task_9954,999,873,158,92,250,1.143020594965675,25.961658217472277
Task_9955,1678,432,193,38,231,3.8752886836027716,34.70483690460818
Task_9956,675,972,98,53,151,0.6937307297019527,20.35447669351212
Task_9957,2723,445,103,83,186,6.105381165919282,51.349196838116335
Task_9958,700,627,121,170,291,1.1146496815286624,20.78983649125125
Task_9959,738,925,168,150,318,0.796976241900648,22.528593193811954
Task_9960,2915,125,45,145,190,23.134920634920636,53.281526721705376
Task_9961,1856,494,76,42,118,3.7494949494949497,36.85967480757685
Task_9962,685,506,167,177,344,1.3510848126232742,20.543723291769243
Task_9963,967,97,165,173,338,9.86734693877551,22.89158239620588
Task_9964,519,308,23,24,47,1.6796116504854368,14.241971137042094
Task_9965,1882,121,101,124,225,15.426229508196721,37.149735961828114
Task_9966,2198,779,173,147,320,2.817948717948718,45.24889527983752
Task_9967,540,262,87,99,186,2.053231939163498,16.55710128363563
Task_9968,2352,671,108,68,176,3.5,45.96023067811681
Task_9969,1169,521,125,29,154,2.239463601532567,26.267574108466572
Task_9970,2024,497,82,186,268,4.06425702811245,41.51709844303306
Task_9971,616,892,39,42,81,0.6898096304591266,18.492498160932062
Task_9972,2796,262,53,138,191,10.631178707224334,52.59701209177206
Task_9973,2393,914,23,124,147,2.6153005464480876,47.74622695270548
Task_9974,753,610,89,72,161,1.23240589198036,20.24010105346365
Task_9975,1454,577,27,167,194,2.5155709342560555,32.332902978626755
Task_9976,639,161,74,198,272,3.9444444444444446,18.317974613150827
Task_9977,1048,676,87,125,212,1.5480059084194977,26.154179735793132
Task_9978,1345,926,22,194,216,1.4509169363538295,31.664166015822293
Task_9979,1539,547,190,41,231,2.8083941605839415,32.835254648093034
Task_9980,951,438,166,195,361,2.1662870159453305,24.684708408893385
Task_9981,2974,399,160,166,326,7.435,56.37194291632454
Task_9982,2476,552,196,165,361,4.477396021699819,49.145671232286794
Task_9983,797,997,83,153,236,0.7985971943887775,23.3269178017666
Task_9984,2574,437,198,152,350,5.876712328767123,50.255882040307675
Task_9985,2557,293,42,89,131,8.697278911564625,48.12738010766322
Task_9986,2398,543,163,154,317,4.408088235294118,47.66735149488037
Task_9987,2636,656,165,125,290,4.012176560121766,51.63224687817842
Task_9988,2590,92,155,135,290,27.849462365591396,48.16282647506463
Task_9989,2019,464,183,116,299,4.341935483870968,41.276611753681905
Task_9990,2773,482,110,61,171,5.74120082815735,51.86977272966235
Task_9991,899,728,60,147,207,1.233196159122085,23.982644406121086
Task_9992,2833,501,73,52,125,5.643426294820717,52.79620140227933
Task_9993,960,73,131,162,293,12.972972972972974,22.464547780044565
Task_9994,705,866,35,97,132,0.8131487889273357,20.652258217008214
Task_9995,1478,205,190,183,373,7.174757281553398,32.28545128110667
Task_9996,2322,748,46,28,74,3.1001335113484645,44.208715393232126
Task_9997,1553,399,62,156,218,3.8825,33.51344133502572
Task_9998,967,127,138,23,161,7.5546875,21.390624751873485
Task_9999,2120,512,49,170,219,4.132553606237817,42.909057246018506
Task_10000,685,743,193,84,277,0.9206989247311828,20.553717445790465
Task_10001,1060,525,149,111,260,2.0152091254752853,26.105342743380245
Task_10002,1599,366,184,149,333,4.356948228882834,34.51423345936165
Task_10003,2760,579,55,28,83,4.758620689655173,50.96828845577026
Task_10004,1443,814,163,154,317,1.7705521472392638,33.37994704411429
Task_10005,2079,940,54,164,218,2.2093517534537725,43.59025614896152
Task_10006,2391,842,20,64,84,2.8362989323843415,46.37970428458897
Task_10007,2345,984,66,120,186,2.3807106598984773,47.56725088051974
Task_10008,2749,902,32,178,210,3.044296788482835,53.95327966293056
Task_10009,2165,280,164,111,275,7.704626334519573,42.858253578216726
Task_10010,1964,634,15,151,166,3.0929133858267717,40.27001935386336
Task_10011,2000,85,37,137,174,23.25581395348837,38.34027780395208
Task_10012,1912,841,71,142,213,2.2707838479809976,40.54882895663366
Task_10013,785,641,50,23,73,1.222741433021807,19.589453930079102
Task_10014,2898,796,196,23,219,3.6361355081555833,55.03358740360641
Task_10015,518,511,26,92,118,1.01171875,16.284659842659
Task_10016,1333,454,117,57,174,2.9296703296703295,29.157984527296758
Task_10017,2681,719,138,64,202,3.723611111111111,51.60311674671791
Task_10018,664,509,67,154,221,1.3019607843137255,19.720535419756803
Task_10019,2001,338,120,172,292,5.902654867256637,40.62954525005028
Task_10020,2163,418,49,31,80,5.162291169451074,41.033062038578585
Task_10021,653,796,159,200,359,0.8193224592220828,20.99385728320698
Task_10022,820,729,48,11,59,1.1232876712328768,20.201232100289637
Task_10023,1655,876,178,19,197,1.887115165336374,35.320568694477174
Task_10024,827,539,68,130,198,1.5314814814814814,22.291498630237385
Task_10025,1837,339,182,92,274,5.402941176470589,37.739885429731565
Task_10026,2668,267,153,196,349,9.955223880597014,51.219937051153885
Task_10027,2052,714,59,69,128,2.86993006993007,41.439587523260066
Task_10028,2217,474,141,135,276,4.667368421052632,44.36726074360397
Task_10029,2933,455,56,16,72,6.432017543859649,52.70738808306918
Task_10030,1385,859,185,59,244,1.6104651162790697,31.62497967521269
Task_10031,865,808,87,181,268,1.069221260815822,23.84954776074994
Task_10032,2180,827,22,85,107,2.632850241545894,43.49036158934532
Task_10033,1039,181,189,25,214,5.708791208791209,23.391436621959855
Task_10034,1842,749,180,106,286,2.456,39.301841954382304
Task_10035,2394,667,158,150,308,3.5838323353293413,47.951804502672104
Task_10036,630,738,96,59,155,0.8525033829499323,18.63999473527313
Task_10037,2991,245,25,171,196,12.158536585365853,55.5636070858804
Task_10038,1046,999,104,31,135,1.046,25.75896562088201
Task_10039,1385,713,181,49,230,1.9397759103641457,30.989922467392955
Task_10040,2919,1019,141,38,179,2.861764705882353,55.79542435489362
Task_10041,2359,545,61,58,119,4.32051282051282,45.16048099735952
Task_10042,2480,772,200,118,318,3.2082794307891334,49.642998260087495
Task_10043,1447,627,82,44,126,2.304140127388535,30.86001526376055
Task_10044,740,102,99,185,284,7.184466019417476,19.200184606427555
Task_10045,2050,404,112,153,265,5.061728395061729,41.47349684447192
Task_10046,1774,109,12,61,73,16.12727272727273,33.289300505609624
Task_10047,1605,331,176,54,230,4.8343373493975905,33.434862734881634
Task_10048,2758,822,191,89,280,3.3511543134872417,53.80309254529353
Task_10049,1630,169,184,178,362,9.588235294117647,34.221862727185616
Task_10050,1966,788,83,199,282,2.491761723700887,41.560125151164534
Task_10051,764,725,131,42,173,1.0523415977961432,20.7319196818778
Task_10052,1230,303,126,78,204,4.046052631578948,27.488749081508445
Task_10053,2304,145,170,43,213,15.780821917808218,43.24647546165221
Task_10054,2781,800,121,186,307,3.4719101123595504,54.54975747534888
Task_10055,1111,597,91,135,226,1.8578595317725752,27.069454105545134
Task_10056,2261,176,142,117,259,12.774011299435028,43.508765272278914
Task_10057,1204,850,86,178,264,1.4148061104582843,29.485923735494925
Task_10058,2187,494,127,102,229,4.418181818181818,43.69660279172003
Task_10059,2772,348,142,187,329,7.9426934097421205,53.04712746547161
Task_10060,1030,716,136,148,284,1.4365411436541144,26.320051639182566
Task_10061,2903,786,137,161,298,3.6886912325285897,56.361335442289054
Task_10062,2191,956,109,38,147,2.2894461859979103,43.85364369144236
Task_10063,719,989,88,115,203,0.7262626262626263,21.89428142265405
Task_10064,2073,138,128,61,189,14.913669064748202,39.57634624296107
Task_10065,2306,904,35,29,64,2.5480662983425413,44.46916487657537
Task_10066,2089,304,11,100,111,6.849180327868853,40.65715303183318
Task_10067,1245,259,128,94,222,4.788461538461538,27.926488327706256
Task_10068,1002,679,19,12,31,1.473529411764706,22.656296460461178
Task_10069,1830,766,22,16,38,2.3859191655801824,36.07233281056188
Task_10070,1149,712,12,96,108,1.6115007012622722,27.032715483162963
Task_10071,1522,498,19,21,40,3.0501002004008018,30.501232035118534
Task_10072,2714,74,97,164,261,36.18666666666667,49.84763648438601
Task_10073,2041,1017,122,136,258,2.004911591355599,43.20763107691308
Task_10074,1457,67,150,116,266,21.426470588235293,30.05905000306326
Task_10075,2036,434,85,135,220,4.680459770114942,41.1677979106185
Task_10076,2475,353,98,109,207,6.991525423728813,47.71594705213504
Task_10077,1150,506,110,20,130,2.2682445759368837,25.680151200635645
Task_10078,2876,555,107,60,167,5.172661870503597,53.77126301331205
Task_10079,2937,376,187,176,363,7.790450928381963,55.890109405972964
Task_10080,2452,525,168,10,178,4.661596958174905,46.64626400688647
Task_10081,2522,1019,18,195,213,2.4725490196078432,50.69418728991386
Task_10082,868,530,34,28,62,1.6346516007532956,20.520639697380286
Task_10083,1568,303,165,194,359,5.157894736842105,33.99927382817643
Task_10084,2565,677,51,30,81,3.7831858407079646,48.31101681738013
Task_10085,634,386,197,56,253,1.6382428940568476,18.393021779571516
Task_10086,1645,584,79,53,132,2.8119658119658117,34.38105947483429
Task_10087,2253,210,180,33,213,10.677725118483412,42.92766492470178
Task_10088,726,995,148,174,322,0.7289156626506024,22.60438579540069
Task_10089,2116,760,23,57,80,2.780551905387648,41.59113229825409
Task_10090,2846,831,163,161,324,3.420673076923077,55.716955486664894
Task_10091,571,892,83,22,105,0.6394176931690929,17.768628659924765
Task_10092,1340,206,24,110,134,6.473429951690822,28.68141733328649
Task_10093,2278,88,120,57,177,25.59550561797753,42.025330306542166
Task_10094,1744,280,120,83,203,6.2064056939501775,35.54470396015453
Task_10095,696,96,127,159,286,7.175257731958763,18.37169434702355
Task_10096,2152,255,76,73,149,8.40625,41.44711698208621
Task_10097,1335,94,171,54,225,14.052631578947368,27.632633701441794
Task_10098,1700,318,174,177,351,5.329153605015674,36.075618069986454
Task_10099,578,885,63,21,84,0.6523702031602708,17.769767839517346
Task_10100,781,966,18,70,88,0.8076525336091003,21.35023852250829
Task_10101,672,117,65,32,97,5.694915254237288,16.07091466609722
Task_10102,1323,993,53,58,111,1.3309859154929577,30.056279378623287
Task_10103,979,622,77,22,99,1.5714285714285714,23.105094794234887
Task_10104,1072,228,147,190,337,4.681222707423581,25.803167189212328
Task_10105,856,290,174,179,353,2.941580756013746,22.650863324819074
Task_10106,2062,578,32,159,191,3.5613126079447324,41.937488135812956
Task_10107,677,576,139,86,225,1.173310225303293,19.668737214589935
Task_10108,563,1005,115,30,145,0.5596421471172962,18.540840949043414
Task_10109,1784,953,160,86,246,1.870020964360587,38.544733000087156
Task_10110,1224,123,185,70,255,9.870967741935484,26.430438202446158
Task_10111,1363,146,172,186,358,9.272108843537415,29.83024904376885
Task_10112,1705,905,153,86,239,1.8818984547461368,37.112216711175066
Task_10113,1644,272,116,109,225,6.021978021978022,34.36735316738859
Task_10114,1106,364,101,40,141,3.03013698630137,24.70164322831648
Task_10115,2006,205,162,29,191,9.737864077669903,38.91781291573921
Task_10116,665,600,83,100,183,1.1064891846921796,19.379355061884787
Task_10117,2585,815,82,168,250,3.167892156862745,51.30070103140299
Task_10118,1239,252,44,135,179,4.897233201581027,27.56180979436454
Task_10119,1238,180,148,124,272,6.8397790055248615,27.48538838535836
Task_10120,1324,286,156,184,340,4.613240418118467,29.98475710861229
Task_10121,2247,808,63,192,255,2.7775030902348576,46.0169890878341
Task_10122,1969,224,186,73,259,8.751111111111111,39.0257672021817
Task_10123,2523,801,75,46,121,3.1458852867830425,48.40383148326965
Task_10124,783,500,18,112,130,1.562874251497006,20.744039517857335
Task_10125,1593,231,46,77,123,6.866379310344827,32.49112705484645
Task_10126,1311,828,178,35,213,1.5814234016887816,30.02895293854409
Task_10127,678,759,162,152,314,0.8921052631578947,21.011252239863374
Task_10128,1530,837,167,72,239,1.8257756563245824,33.9555428370194
Task_10129,678,915,181,20,201,0.740174672489083,20.066183671810812
Task_10130,858,847,72,88,160,1.0117924528301887,22.8375487600123
Task_10131,1999,213,92,32,124,9.341121495327103,38.315438372609606
Task_10132,1560,480,98,182,280,3.2432432432432434,34.0871319524447
Task_10133,2762,250,150,35,185,11.00398406374502,50.863144089904864
Task_10134,2664,488,54,46,100,5.447852760736196,49.30075737917283
Task_10135,1530,772,176,85,261,1.9793014230271668,34.0126582663936
Task_10136,2578,355,141,25,166,7.241573033707865,48.156175684721404
Task_10137,952,651,89,51,140,1.460122699386503,23.390270969139866
Task_10138,2848,743,23,185,208,3.827956989247312,55.08016747658126
Task_10139,2297,927,75,173,248,2.4752155172413794,47.129533468334934
Task_10140,2639,923,117,81,198,2.856060606060606,51.71688534496759
Task_10141,2761,154,116,161,277,17.81290322580645,51.53895012201077
Task_10142,1397,452,155,68,223,3.0838852097130243,30.53931087152478
Task_10143,2484,441,18,58,76,5.619909502262443,46.021810976581484
Task_10144,776,252,94,55,149,3.067193675889328,19.566077361824895
Task_10145,1743,195,108,92,200,8.892857142857142,35.35461118525545
Task_10146,1372,289,64,97,161,4.731034482758621,29.695713983178155
Task_10147,2888,588,72,42,114,4.903225806451613,53.47615423992523
Task_10148,2534,609,30,62,92,4.154098360655738,48.01854851834341
Task_10149,1642,131,179,86,265,12.43939393939394,33.37026264182675
Task_10150,2006,458,136,178,314,4.37037037037037,41.209987126106434
Task_10151,654,165,37,82,119,3.9397590361445785,16.96287652977959
Task_10152,1441,107,31,97,128,13.342592592592593,29.060086846405014
Task_10153,2172,608,163,130,293,3.5665024630541873,44.15216736009429
Task_10154,1405,370,53,181,234,3.7870619946091644,31.22863773855597
Task_10155,1611,230,85,36,121,6.974025974025974,32.055572598907396
Task_10156,2808,732,65,30,95,3.830832196452933,52.360484360729565
Task_10157,1879,396,28,55,83,4.732997481108312,36.78750590148038
Task_10158,841,153,177,14,191,5.461038961038961,20.003613222054163
Task_10159,2177,242,53,121,174,8.958847736625515,42.5759092388897
Task_10160,2431,459,171,108,279,5.284782608695652,47.6799835407063
Task_10161,2219,509,81,34,115,4.350980392156862,42.59445922560362
Task_10162,1335,219,60,64,124,6.068181818181818,28.1907307172339
Task_10163,718,121,169,24,193,5.885245901639344,17.936498045436426
Task_10164,1567,907,109,159,268,1.725770925110132,35.420134403954684
Task_10165,777,1007,29,125,154,0.7708333333333334,22.2370874850627
Task_10166,2025,1015,44,110,154,1.9931102362204725,42.105556363292656
Task_10167,1790,422,196,121,317,4.231678486997636,37.605061333019954
Task_10168,744,995,24,40,64,0.7469879518072289,20.06034540014663
Task_10169,2772,1003,126,115,241,2.760956175298805,54.64095397153801
Task_10170,1030,802,33,129,162,1.2826899128268991,25.690318240286718
Task_10171,638,988,177,154,331,0.6450960566228514,21.30395426125742
Task_10172,1292,334,87,162,249,3.8567164179104476,29.202811167697593
Task_10173,1277,912,67,57,124,1.3986856516977,29.244638537029676
Task_10174,790,727,25,160,185,1.085164835164835,21.869089946123307
Task_10175,1429,329,150,125,275,4.33030303030303,31.40759921633155
Task_10176,2173,625,28,162,190,3.4712460063897765,43.83410816228386
Task_10177,2797,1017,104,126,230,2.7475442043222005,55.04733766274719
Task_10178,1094,685,70,180,250,1.5947521865889214,27.326446354570596
Task_10179,1523,1023,130,37,167,1.4873046875,33.62743139905862
Task_10180,955,198,32,129,161,4.798994974874372,22.761431671188017
Task_10181,1128,457,57,141,198,2.462882096069869,26.89104941380909
Task_10182,1776,829,120,14,134,2.139759036144578,36.63693899982967
Task_10183,2832,257,114,165,279,10.976744186046512,53.41365646527347
Task_10184,1536,593,183,145,328,2.585858585858586,34.212488291485556
Task_10185,1145,472,142,59,201,2.4207188160676534,26.41632973553044
Task_10186,810,362,74,100,174,2.231404958677686,21.297169373171638
Task_10187,2525,347,130,186,316,7.255747126436781,49.07670517483647
Task_10188,2471,214,26,134,160,11.493023255813954,46.689222025730125
Task_10189,2942,668,14,97,111,4.3976083707025415,55.40246823549094
Task_10190,2253,896,49,98,147,2.511705685618729,45.51543608677779
Task_10191,1634,596,44,155,199,2.7370184254606365,35.22077346940971
Task_10192,969,120,56,105,161,8.008264462809917,22.140393999321617
Task_10193,2977,258,19,199,218,11.494208494208495,55.46405285616266
Task_10194,2284,788,131,190,321,2.8948035487959443,46.707103255797826
Task_10195,1344,943,12,144,156,1.423728813559322,31.09917799325748
Task_10196,1467,636,176,178,354,2.30298273155416,33.42021278006826
Task_10197,2626,667,14,185,199,3.931137724550898,51.22895125687702
Task_10198,2801,124,89,62,151,22.408,50.462868099428086
Task_10199,2984,232,154,161,315,12.806866952789699,55.87548834787452
Task_10200,1295,432,57,168,225,2.9907621247113165,29.616205374128267
Task_10201,828,922,112,112,224,0.8970747562296858,23.439243306064185
Task_10202,777,336,76,137,213,2.3056379821958455,20.994827813145342
Task_10203,1527,692,161,76,237,2.2034632034632033,33.50749232281888
Task_10204,2370,276,156,43,199,8.555956678700362,44.9459854134896
Task_10205,1198,450,171,171,342,2.656319290465632,28.51118719522307
Task_10206,2915,761,150,65,215,3.825459317585302,55.51780807950919
Task_10207,1138,843,57,129,186,1.3483412322274881,27.9779432544268
Task_10208,1437,895,128,154,282,1.6037946428571428,33.37875870726767
Task_10209,2804,351,16,38,54,7.965909090909091,50.7186850667403
Task_10210,1219,578,52,142,194,2.105354058721934,28.706877284963653
Task_10211,2512,343,147,128,275,7.3023255813953485,48.58764219654403
Task_10212,2780,361,187,60,247,7.679558011049724,52.13852387823194
Task_10213,2477,86,128,130,258,28.471264367816094,46.16019728747859
Task_10214,1569,214,192,167,359,7.297674418604651,33.66815387564672
Task_10215,592,142,170,198,368,4.13986013986014,17.780778560195568
Task_10216,922,155,172,125,297,5.910256410256411,22.59515821760999
Task_10217,2879,783,119,43,162,3.6721938775510203,54.2270138392957
Task_10218,929,729,62,13,75,1.2726027397260273,21.904299682973804
Task_10219,2426,201,141,25,166,12.009900990099009,45.19634231970284
Task_10220,2218,452,126,100,226,4.896247240618101,44.03520060243096
Task_10221,1648,604,96,80,176,2.7239669421487602,34.8336305535331
Task_10222,2712,907,35,168,203,2.986784140969163,53.326254814854956
Task_10223,1187,78,57,74,131,15.025316455696203,24.72878900245415
Task_10224,2935,723,73,157,230,4.053867403314917,56.484078624465006
Task_10225,868,938,158,88,246,0.9243876464323749,23.938040149168256
Task_10226,1017,484,30,110,140,2.0969072164948455,24.483156580250753
Task_10227,1160,414,43,193,236,2.7951807228915664,27.36364038506672
Task_10228,2627,300,194,47,241,8.727574750830565,49.28780899100363
Task_10229,2219,226,165,152,317,9.775330396475772,43.76556619196065
Task_10230,694,910,177,67,244,0.7618002195389681,20.975294631310607
Task_10231,2234,888,120,121,241,2.5129358830146233,45.76580798986202
Task_10232,2950,192,119,24,143,15.284974093264248,53.31509977648971
Task_10233,1985,94,166,14,180,20.894736842105264,37.052540422262815
Task_10234,1480,968,19,147,166,1.5273477812177503,33.537337461187924
Task_10235,1164,152,165,69,234,7.607843137254902,25.629895773383478
Task_10236,734,127,185,35,220,5.734375,18.33536617294569
Task_10237,1342,833,197,128,325,1.6091127098321343,31.83672524161118
Task_10238,659,822,24,150,174,0.8007290400972054,20.169092703113066
Task_10239,645,349,11,114,125,1.8428571428571427,18.159322246170394
Task_10240,2921,626,72,124,196,4.6586921850079746,55.75254515205506
Task_10241,1054,950,98,114,212,1.1083070452155626,26.97448645072095
Task_10242,2492,412,108,151,259,6.033898305084746,48.46416508531295
Task_10243,1014,124,145,198,343,8.112,24.145545588537647
Task_10244,2214,377,177,81,258,5.857142857142857,43.519193747173766
Task_10245,1024,598,138,166,304,1.7095158597662772,26.02911173427898
Task_10246,1358,88,102,23,125,15.258426966292134,26.8788163873824
Task_10247,555,549,82,61,143,1.009090909090909,16.741123969711037
Task_10248,1040,699,31,99,130,1.4857142857142858,25.469257479149633
Task_10249,1338,513,43,51,94,2.603112840466926,28.708453444013642
Task_10250,1876,1021,160,123,283,1.8356164383561644,40.69886084456322
Task_10251,1745,253,69,80,149,6.8700787401574805,35.153640402594654
Task_10252,2662,375,84,27,111,7.079787234042553,49.057854805988256
Task_10253,2711,364,86,136,222,7.427397260273972,51.62184580668593
Task_10254,2915,268,106,45,151,10.8364312267658,52.97925645478523
Task_10255,1958,847,118,38,156,2.3089622641509435,39.827761415144174
Task_10256,2061,226,152,198,350,9.079295154185022,41.48637146865247
Task_10257,511,753,172,130,302,0.6777188328912467,18.397955403948913
Task_10258,1281,963,197,133,330,1.3288381742738589,31.27616045456897
Task_10259,905,888,65,183,248,1.0179977502812148,24.766798319648757
Task_10260,2898,570,67,162,229,5.075306479859895,55.40859193843309
Task_10261,2756,900,118,79,197,3.0588235294117645,53.521781386948476
Task_10262,2021,889,65,80,145,2.2707865168539327,41.57809973239558
Task_10263,849,283,38,39,77,2.98943661971831,19.32745281907347
Task_10264,696,742,185,194,379,0.9367429340511441,21.602821989361626
Task_10265,1244,825,115,130,245,1.5060532687651331,29.872264766260432
Task_10266,1044,423,188,121,309,2.4622641509433962,25.766310745007445
Task_10267,1895,367,43,110,153,5.149456521739131,37.99631275477136
Task_10268,1066,154,110,111,221,6.877419354838709,24.498034793752495
Task_10269,1254,495,101,184,285,2.528225806451613,29.30206760369275
Task_10270,2095,497,23,60,83,4.206827309236948,40.51085483986339
Task_10271,860,587,125,106,231,1.4625850340136055,22.925797115050557
Task_10272,571,333,87,53,140,1.7095808383233533,16.433172110800303
Task_10273,1423,306,35,15,50,4.635179153094462,28.388053793013025
Task_10274,1236,636,87,132,219,1.9403453689167975,29.094260276259803
Task_10275,1045,486,34,105,139,2.1457905544147846,24.896650335860368
Task_10276,1584,836,98,36,134,1.89247311827957,33.797923794354084
Task_10277,1774,354,27,130,157,4.997183098591549,36.1490693797902
Task_10278,858,266,62,94,156,3.2134831460674156,21.376338679567187
Task_10279,1407,379,155,18,173,3.7026315789473685,29.60177805414816
Task_10280,1248,350,13,151,164,3.5555555555555554,28.09533159532123
Task_10281,1502,918,136,125,261,1.6343852013057671,34.34293278383634
Task_10282,1414,326,92,61,153,4.324159021406728,29.74793753713162
Task_10283,2448,92,48,136,184,26.322580645161292,45.335186650560246
Task_10284,867,330,169,110,279,2.619335347432024,22.51877483797972
Task_10285,1957,140,148,173,321,13.879432624113475,39.00353544024301
Task_10286,2865,532,131,77,208,5.375234521575985,54.06344089274803
Task_10287,2338,544,45,157,202,4.289908256880734,46.20676308766474
Task_10288,826,997,16,38,54,0.8276553106212425,21.599878503251023
Task_10289,1483,742,18,166,184,1.9959623149394348,33.02499180991777
Task_10290,1550,279,196,130,326,5.535714285714286,33.391434216887305
Task_10291,554,808,38,193,231,0.6847960444993819,18.96321507949656
Task_10292,2405,377,97,70,167,6.362433862433862,45.855462139511445
Task_10293,2496,508,29,73,102,4.903732809430255,47.33833002999384
Task_10294,1966,102,124,158,282,19.0873786407767,38.410254566136935
Task_10295,2591,788,145,129,274,3.2839036755386566,51.269596199785326
Task_10296,1581,475,91,144,235,3.3214285714285716,34.18046764654763
Task_10297,2517,798,27,53,80,3.1501877346683353,48.04013697325027
Task_10298,1665,631,135,74,209,2.634493670886076,35.37755301389948
Task_10299,505,295,48,140,188,1.7060810810810811,16.389613229629393
Task_10300,1135,751,53,137,190,1.509308510638298,27.84073427087607
Task_10301,1991,652,75,43,118,3.0490045941807042,39.49783617132805
Task_10302,1235,114,101,179,280,10.73913043478261,27.161952067297594
Task_10303,2844,652,74,170,244,4.355283307810107,54.90445835649532
Task_10304,1208,284,45,103,148,4.23859649122807,26.83885318701803
Task_10305,644,911,169,149,318,0.706140350877193,21.063900878001867
Task_10306,2642,471,168,90,258,5.5974576271186445,50.77317762307295
Task_10307,1236,95,176,199,375,12.875,27.31483175470946
Task_10308,2130,262,174,73,247,8.098859315589353,41.65272463086959
Task_10309,2696,117,78,141,219,22.847457627118644,50.02455475812152
Task_10310,2804,168,62,100,162,16.59171597633136,51.445569009676426
Task_10311,2183,512,31,37,68,4.255360623781677,41.30804960193596
Task_10312,2103,963,200,186,386,2.1815352697095434,44.672468153262365
Task_10313,2664,530,122,93,215,5.016949152542373,51.22280531621544
Task_10314,738,834,117,101,218,0.8838323353293414,21.685843087708992
Task_10315,1328,745,153,128,281,1.7801608579088473,31.143004276398262
Task_10316,1123,833,117,139,256,1.3465227817745804,28.045030106007673
Task_10317,2124,803,69,194,263,2.6417910447761193,44.0851242051304
Task_10318,2660,655,187,75,262,4.054878048780488,51.445477607669375
Task_10319,1258,736,26,64,90,1.7069199457259159,28.173067164150936
Task_10320,1217,777,50,79,129,1.56426735218509,28.57936788325082
Task_10321,1616,787,18,154,172,2.050761421319797,35.30281121994774
Task_10322,792,612,148,120,268,1.2920065252854813,22.090253825556584
Task_10323,2601,645,186,179,365,4.026315789473684,51.46018598437494
Task_10324,1827,1011,183,14,197,1.8053359683794465,38.52058659114748
Task_10325,558,1011,195,176,371,0.5513833992094862,20.22489473850533
Task_10326,2886,562,106,73,179,5.126110124333925,54.109622466808126
Task_10327,1963,510,121,113,234,3.8414872798434443,40.24028874932747
Task_10328,2984,380,99,192,291,7.832020997375328,56.3479418754942
Task_10329,1914,772,156,103,259,2.476067270375162,40.38829208275591
Task_10330,605,73,71,31,102,8.175675675675675,14.264198720314093
Task_10331,1490,926,51,41,92,1.6073354908306365,32.17082862460528
Task_10332,2575,501,182,154,336,5.129482071713148,50.42017022706617
Task_10333,1913,299,87,193,280,6.376666666666667,39.09143901066872
Task_10334,1331,680,46,49,95,1.9544787077826726,28.89280226007168
Task_10335,1098,956,45,83,128,1.1473354231974922,27.065500991880086
Task_10336,2811,223,191,185,376,12.549107142857142,53.417720785025686
Task_10337,1594,448,130,161,291,3.5501113585746102,34.52810241185405
Task_10338,1533,554,20,31,51,2.7621621621621624,31.146322356750265
Task_10339,639,826,92,53,145,0.7726723095525998,19.34623165045029
Task_10340,2283,918,185,111,296,2.484221980413493,46.86902860552319
Task_10341,2995,338,65,49,114,8.834808259587021,54.358980144442704
Task_10342,1233,834,102,126,228,1.4766467065868263,29.632315736184122
Task_10343,550,449,191,66,257,1.2222222222222223,17.206355407879865
Task_10344,1130,99,103,32,135,11.3,23.510423967256532
Task_10345,1698,987,114,53,167,1.7186234817813766,36.571374078089804
Task_10346,2762,880,193,142,335,3.135073779795687,54.56140114800468
Task_10347,779,310,66,65,131,2.504823151125402,19.862476473247675
Task_10348,736,798,51,159,210,0.9211514392991239,21.67180302652373
Task_10349,1130,75,38,26,64,14.868421052631579,22.402016467838905
Task_10350,771,765,88,25,113,1.0065274151436032,20.420568198595166
Task_10351,1480,470,34,46,80,3.142250530785563,30.352515471906013
Task_10352,522,778,122,31,153,0.6700898587933247,17.094594795310783
Task_10353,2773,792,31,110,141,3.4968474148802016,53.26688903788866
Task_10354,1769,244,99,68,167,7.220408163265306,35.31885856444427
Task_10355,2843,399,141,168,309,7.1075,54.22538775147126
Task_10356,669,977,19,102,121,0.6840490797546013,20.328982790498124
Task_10357,2684,621,48,63,111,4.315112540192926,50.757494053973744
Task_10358,2571,317,191,87,278,8.084905660377359,49.130474077753256
Task_10359,2494,136,125,83,208,18.204379562043794,46.575492892702435
Task_10360,905,247,160,116,276,3.649193548387097,22.845358737826285
Task_10361,1023,747,181,123,304,1.3676470588235294,26.365902166140092
Task_10362,991,336,22,122,144,2.940652818991098,23.57926427268394
Task_10363,2840,324,33,172,205,8.738461538461538,53.506440377971444
Task_10364,1677,323,14,167,181,5.175925925925926,34.81141586776418
Task_10365,2445,279,143,47,190,8.732142857142858,46.09499205795353
Task_10366,643,337,64,107,171,1.9023668639053255,18.436917975992543
Task_10367,1838,892,77,131,208,2.0582306830907053,39.495445122234635
Task_10368,2797,638,63,39,102,4.377151799687011,51.81459696857877
Task_10369,1569,452,177,17,194,3.4635761589403975,32.61472962064652
Task_10370,667,157,70,72,142,4.2215189873417724,17.285212889671925
Task_10371,1988,673,23,57,80,2.949554896142433,39.29047385780017
Task_10372,949,884,109,19,128,1.072316384180791,23.715450994972656
Task_10373,1395,850,154,15,169,1.6392479435957696,30.83399787421367
Task_10374,2271,318,116,111,227,7.1191222570532915,44.449453216206166
Task_10375,1096,411,170,193,363,2.6601941747572817,26.90007967584316
Task_10376,1120,623,44,155,199,1.794871794871795,27.16517889199127
Task_10377,1347,268,143,64,207,5.007434944237918,29.05748011100208
Task_10378,2882,961,101,12,113,2.995841995841996,54.446873509317356
Task_10379,2083,854,181,180,361,2.4362573099415203,43.894507919583
Task_10380,803,880,147,158,305,0.9114642451759364,23.338460415230514
Task_10381,2859,973,53,168,221,2.935318275154004,56.08335680538742
Task_10382,2326,552,128,122,250,4.206148282097649,46.20720802575179
Task_10383,2876,821,170,154,324,3.4987834549878345,56.15059321844802
Task_10384,2105,542,37,99,136,3.876611418047882,41.84865051109934
Task_10385,1632,492,144,130,274,3.310344827586207,35.147918861310714
Task_10386,1796,1018,109,72,181,1.762512266928361,38.267523063740725
Task_10387,1152,250,64,117,181,4.589641434262949,26.27683233568605
Task_10388,552,360,142,143,285,1.5290858725761773,17.664126500125423
Task_10389,2027,966,19,33,52,2.09617373319545,40.28035633372926
Task_10390,2545,585,126,139,265,4.343003412969283,49.87301601426393
Task_10391,2514,757,21,99,120,3.316622691292876,48.83680869027185
Task_10392,742,568,80,188,268,1.3040421792618628,21.40599549484097
Task_10393,2693,567,67,180,247,4.741197183098592,52.26027109320058
Task_10394,2574,920,24,87,111,2.794788273615635,50.1866934313361
Task_10395,1826,957,99,97,196,1.9060542797494782,39.312852246029735
Task_10396,2668,900,185,197,382,2.9611542730299667,53.427004057934745
Task_10397,1374,249,55,88,143,5.496,29.310207980214305
Task_10398,732,862,164,146,310,0.8482039397450754,22.15795511054922
Task_10399,1282,392,113,152,265,3.262086513994911,29.28085118562349
Task_10400,1295,391,50,69,119,3.3035714285714284,28.21301087486682
Task_10401,573,605,188,98,286,0.9455445544554455,18.67634068973631
Task_10402,1499,579,40,162,202,2.5844827586206898,33.05198249313126
Task_10403,2493,272,37,125,162,9.131868131868131,47.27758186608266
Task_10404,782,671,74,82,156,1.1636904761904763,21.23538483735752
Task_10405,1928,76,77,125,202,25.038961038961038,37.337913392205785
Task_10406,2403,399,126,197,323,6.0075,47.36869694435203
Task_10407,1090,599,186,131,317,1.8166666666666667,27.098154720395012
Task_10408,895,171,150,119,269,5.203488372093023,22.05237512746169
Task_10409,1010,871,48,145,193,1.158256880733945,26.122488073761332
Task_10410,2279,93,77,125,202,24.24468085106383,42.9152195447706
Task_10411,1192,1002,154,166,320,1.1884346959122631,29.94825505345896
Task_10412,1996,208,67,147,214,9.55023923444976,39.8270140941369
Task_10413,2941,345,83,19,102,8.5,53.05812064338141
Task_10414,2383,528,30,20,50,4.504725897920605,44.292125211282816
Task_10415,699,581,160,122,282,1.2010309278350515,20.59718444652175
Task_10416,1192,813,115,118,233,1.4643734643734643,28.913862230814544
Task_10417,2969,471,119,77,196,6.290254237288136,55.457076390262735
Task_10418,1040,953,134,80,214,1.090146750524109,26.499807996204268
Task_10419,2269,199,194,59,253,11.345,43.516496183902596
Task_10420,992,169,19,153,172,5.8352941176470585,23.080990098760452
Task_10421,2437,751,150,24,174,3.2406914893617023,47.309861358253016
Task_10422,1333,191,15,31,46,6.942708333333333,26.945808720467483
Task_10423,940,942,80,20,100,0.9968186638388123,23.532643875159195
Task_10424,571,280,93,152,245,2.0320284697508897,17.6991543146293
Task_10425,1809,728,58,188,246,2.4814814814814814,38.80785266952848
Task_10426,2528,74,26,200,226,33.70666666666666,46.85854109255084
Task_10427,770,469,28,98,126,1.6382978723404256,20.581958899023064
Task_10428,985,469,12,185,197,2.095744680851064,24.56868089837654
Task_10429,1124,188,195,65,260,5.947089947089947,25.652552743760975
Task_10430,2229,606,125,30,155,3.672158154859967,43.34390117047972
Task_10431,1428,152,25,75,100,9.333333333333334,28.73739796084244
Task_10432,1945,126,40,196,236,15.31496062992126,38.3336912073224
Task_10433,2094,835,171,31,202,2.5047846889952154,42.40446944718767
Task_10434,2475,442,149,180,329,5.586907449209932,48.65180435768729
Task_10435,2115,86,128,61,189,24.310344827586206,39.59698391332673
Task_10436,1480,317,95,12,107,4.654088050314465,30.17952654421549
Task_10437,2202,863,121,189,310,2.548611111111111,45.591420449264
Task_10438,1763,905,58,192,250,1.945916114790287,38.65484096124836
Task_10439,1289,835,112,98,210,1.541866028708134,30.414915681436387
Task_10440,1107,421,163,175,338,2.623222748815166,26.96684376411378
Task_10441,2510,909,127,69,196,2.758241758241758,49.45535823904509
Task_10442,1187,280,67,110,177,4.224199288256227,26.89657068840353
Task_10443,2002,704,45,13,58,2.8397163120567375,38.77620049356193
Task_10444,2842,850,72,92,164,3.339600470035253,54.83295491795889
Task_10445,2039,198,147,81,228,10.246231155778894,40.04433973701125
Task_10446,1717,843,27,142,169,2.0343601895734595,36.996565544851364
Task_10447,1387,859,38,72,110,1.6127906976744186,31.02448779176126
Task_10448,645,314,108,107,215,2.0476190476190474,18.66418391048421
Task_10449,2927,1001,84,49,133,2.9211576846307383,55.654923062260515
Task_10450,797,907,71,175,246,0.8777533039647577,23.165286105732378
Task_10451,1573,985,98,131,229,1.5953346855983772,35.55434003784919
Task_10452,2680,775,59,158,217,3.4536082474226806,52.57899372593247
Task_10453,1731,414,119,156,275,4.171084337349398,36.50751797516716
Task_10454,2748,619,195,119,314,4.432258064516129,53.38784655027646
Task_10455,555,807,15,106,121,0.6868811881188119,18.11097588917461
Task_10456,1927,224,23,102,125,8.564444444444444,38.079028018136505
Task_10457,1078,98,130,125,255,10.88888888888889,24.225874498984634
Task_10458,1219,761,129,19,148,1.599737532808399,27.584521648814235
Task_10459,2839,184,74,72,146,15.345945945945946,52.085942977555895
Task_10460,1567,202,93,185,278,7.719211822660099,33.36615737183909
Task_10461,2036,890,117,41,158,2.285072951739618,41.15456937110388
Task_10462,623,672,10,28,38,0.9257057949479941,16.982048584630146
Task_10463,832,737,136,68,204,1.127371273712737,22.30167133656634
Task_10464,2662,968,104,124,228,2.7471620227038183,52.74322725090504
Task_10465,1383,1003,106,55,161,1.3774900398406376,31.433768646781147
Task_10466,2309,101,126,55,181,22.637254901960784,42.72903792650629
Task_10467,1853,1000,173,95,268,1.8511488511488512,40.13240199701058
Task_10468,551,439,26,68,94,1.2522727272727272,16.138416271359375
Task_10469,1695,667,84,16,100,2.537425149700599,34.45811442544814
Task_10470,2416,75,44,115,159,31.789473684210527,44.236523973252844
Task_10471,1698,787,30,57,87,2.1548223350253806,35.11422525723578
Task_10472,2506,356,61,108,169,7.019607843137255,47.96962453539911
Task_10473,883,953,72,24,96,0.9255765199161425,22.869312431194412
Task_10474,2183,518,33,122,155,4.20616570327553,43.14442880045042
Task_10475,2139,925,182,133,315,2.3099352051835855,44.726945530429
Task_10476,502,276,194,50,244,1.812274368231047,15.693027983263633
Task_10477,1623,822,35,100,135,1.9720534629404618,35.113224205493815
Task_10478,2609,945,178,59,237,2.7579281183932345,51.25105358575424
Task_10479,818,666,138,46,184,1.2263868065967016,21.355097650155887
Task_10480,1754,593,88,129,217,2.952861952861953,37.16067555383905
Task_10481,2315,722,110,132,242,3.2019363762102353,46.54995453882728
Task_10482,1765,236,170,67,237,7.447257383966245,35.70516001246448
Task_10483,871,147,118,70,188,5.885135135135135,20.72148878511425
Task_10484,764,611,192,61,253,1.2483660130718954,21.009908237671308
Task_10485,2487,961,52,179,231,2.585239085239085,50.212207700496286
Task_10486,1671,449,186,137,323,3.7133333333333334,35.85908602402197
Task_10487,1289,320,60,188,248,4.015576323987539,29.262735730801666
Task_10488,595,722,26,11,37,0.8229598893499308,16.53194933682004
Task_10489,1815,517,16,117,133,3.503861003861004,37.19164965170234
Task_10490,2998,289,37,21,58,10.337931034482759,53.35912618842611
Task_10491,2815,309,197,67,264,9.080645161290322,52.681551399491546
Task_10492,2123,561,163,180,343,3.7775800711743774,43.52567108159993
Task_10493,652,237,53,183,236,2.7394957983193278,18.90337694802217
Task_10494,2051,893,151,126,277,2.2941834451901566,43.05132587929382
Task_10495,2899,780,24,93,117,3.7119078104993597,55.12604935882789
Task_10496,1421,347,55,118,173,4.083333333333333,30.957056074666458
Task_10497,1246,489,199,190,389,2.5428571428571427,29.634012786537937
Task_10498,756,509,68,77,145,1.4823529411764707,20.257717537766975
Task_10499,2015,280,153,199,352,7.170818505338079,40.96328550528888
Task_10500,1601,461,11,177,188,3.465367965367965,34.204384050229834
Task_10501,2527,218,39,120,159,11.538812785388128,47.533860216405536
Task_10502,1632,577,194,41,235,2.823529411764706,34.42054544388875
Task_10503,2366,727,117,197,314,3.25,47.7933685568103
Task_10504,1717,943,152,52,204,1.81885593220339,37.064701444345324
Task_10505,2660,312,114,123,237,8.498402555910543,50.64256432887722
Task_10506,954,572,151,29,180,1.6649214659685865,23.25695380960912
Task_10507,1241,932,45,70,115,1.330117899249732,28.865741011332556
Task_10508,1564,146,34,187,221,10.639455782312925,32.352571211792565
Task_10509,2253,643,23,42,65,3.498447204968944,42.87320971441223
Task_10510,2112,583,24,138,162,3.6164383561643834,42.3145886275568
Task_10511,2607,819,48,104,152,3.1792682926829268,50.80666359533112
Task_10512,2507,617,18,71,89,4.05663430420712,47.623184036407366
Task_10513,2376,546,200,165,365,4.343692870201097,47.56107476540103
Task_10514,2338,461,60,96,156,5.0606060606060606,45.49566637845865
Task_10515,1676,98,61,81,142,16.92929292929293,32.610296237476746
Task_10516,632,967,190,95,285,0.6528925619834711,20.831311987570405
Task_10517,2817,403,42,90,132,6.9727722772277225,52.63391599275085
Task_10518,2333,731,51,148,199,3.1871584699453552,46.888974440243196
Task_10519,1002,861,15,163,178,1.1624129930394431,25.673767025956195
Task_10520,2375,767,14,23,37,3.0924479166666665,44.90109892329042
Task_10521,2212,725,62,84,146,3.046831955922865,44.07536927298886
Task_10522,1971,329,148,139,287,5.972727272727273,40.05396993673439
Task_10523,2889,163,63,156,219,17.615853658536587,53.45496976922637
Task_10524,1426,799,41,53,94,1.7825,31.014223250329973
Task_10525,500,1006,86,20,106,0.49652432969215493,16.79557639831356
Task_10526,1559,409,157,148,305,3.8024390243902437,33.89303294247748
Task_10527,1651,192,30,109,139,8.55440414507772,33.48025854958917
Task_10528,2046,255,95,126,221,7.9921875,40.73791054995487
Task_10529,2814,554,151,38,189,5.07027027027027,52.862017124439994
Task_10530,1914,962,19,192,211,1.9875389408099688,40.874898602947134
Task_10531,513,656,53,145,198,0.7808219178082192,17.642352969906092
Task_10532,2618,570,125,99,224,4.584938704028021,50.72283433440416
Task_10533,2745,536,67,85,152,5.111731843575419,51.86924510075283
Task_10534,2673,625,52,179,231,4.2699680511182105,52.102812402286396
Task_10535,1657,847,194,145,339,1.9540094339622642,36.97256975010696
Task_10536,2039,101,20,191,211,19.99019607843137,39.25415747497591
Task_10537,1644,776,15,142,157,2.115830115830116,35.45464101760667
Task_10538,2096,319,179,62,241,6.55,41.184102916084946
Task_10539,1738,497,126,77,203,3.4899598393574296,36.08560382388617
Task_10540,2805,638,105,69,174,4.389671361502347,53.09117295927074
Task_10541,1862,614,131,99,230,3.0276422764227644,38.91745889077463
Task_10542,2841,537,175,50,225,5.280669144981412,53.458497907877636
Task_10543,1387,487,54,59,113,2.8422131147540983,29.683571875814252
Task_10544,877,491,124,21,145,1.782520325203252,21.4965449282012
Task_10545,575,951,57,129,186,0.6039915966386554,19.526168574061256
Task_10546,1875,662,163,188,351,2.828054298642534,39.965055913186326
Task_10547,989,234,29,17,46,4.208510638297873,21.137875340815445
Task_10548,1188,471,19,14,33,2.516949152542373,24.870506480351803
Task_10549,2146,227,50,139,189,9.412280701754385,42.18302774862974
Task_10550,1599,648,17,24,41,2.463790446841294,32.24100315978807
Task_10551,1258,265,169,168,337,4.7293233082706765,28.834426784419765
Task_10552,1374,405,152,185,337,3.3842364532019706,31.15116712672584
Task_10553,628,375,111,147,258,1.6702127659574468,18.827073919716256
Task_10554,2785,817,32,135,167,3.404645476772616,53.813713272298685
Task_10555,922,907,93,17,110,1.0154185022026432,23.16801647777523
Task_10556,2587,442,160,74,234,5.839729119638826,49.483983805397266
Task_10557,2865,633,162,125,287,4.518927444794953,55.172586997172154
Task_10558,1398,263,196,192,388,5.295454545454546,31.305192517557
Task_10559,2523,496,127,68,195,5.076458752515091,48.376575047966874
Task_10560,2484,935,73,179,252,2.6538461538461537,50.13540815401666
Task_10561,1327,721,51,156,207,1.8379501385041552,30.969297581578974
Task_10562,2482,629,121,200,321,3.93968253968254,49.35714608260444
Task_10563,1132,728,61,48,109,1.5528120713305897,25.886613661036904
Task_10564,1747,262,44,32,76,6.642585551330798,33.537394947387604
Task_10565,2105,173,88,120,208,12.097701149425287,40.87674171745854
Task_10566,570,1019,151,181,332,0.5588235294117647,20.308102578618698
Task_10567,2039,261,126,20,146,7.782442748091603,39.01043435474206
Task_10568,1715,481,179,178,357,3.5580912863070537,36.87124819865644
Task_10569,2197,652,192,63,255,3.364471669218989,43.95663647443707
Task_10570,2384,216,163,105,268,10.986175115207374,46.04336157286437
Task_10571,2131,815,44,98,142,2.611519607843137,43.15684624606158
Task_10572,1988,171,117,116,233,11.55813953488372,39.12368197058998
Task_10573,1534,432,48,75,123,3.5427251732101617,32.305928296817434
Task_10574,1251,415,51,185,236,3.0072115384615383,28.977450743016988
Task_10575,1082,669,130,87,217,1.6149253731343283,26.410941145072268
Task_10576,606,909,93,153,246,0.6659340659340659,20.34181045515188
Task_10577,1379,493,10,169,179,2.791497975708502,30.598768327040272
Task_10578,1492,401,35,169,204,3.711442786069652,32.41206682552252
Task_10579,2077,468,51,186,237,4.428571428571429,42.22669291616683
Task_10580,643,897,96,189,285,0.7160356347438753,20.976381052205944
Task_10581,2008,120,180,197,377,16.59504132231405,39.92033466911583
Task_10582,2240,169,111,59,170,13.176470588235293,42.17818277074925
Task_10583,622,687,44,157,201,0.9040697674418605,19.297968065408607
Task_10584,789,351,101,127,228,2.241477272727273,21.14707178336383
Task_10585,1371,849,11,140,151,1.6129411764705883,31.25687555704151
Task_10586,1412,736,198,60,258,1.9158751696065128,31.73186328563254
Task_10587,1255,702,148,127,275,1.7852062588904694,29.837616728749683
Task_10588,1339,716,156,58,214,1.8675034867503486,30.32389653850326
Task_10589,2575,506,27,145,172,5.0788954635108485,49.656998210540614
Task_10590,1803,452,86,119,205,3.980132450331126,37.44182195655437
Task_10591,626,249,80,70,150,2.504,17.14717752097903
Task_10592,589,703,132,101,233,0.8366477272727273,18.979337414788606
Task_10593,1922,493,175,196,371,3.8906882591093117,40.275995780221585
Task_10594,2554,516,11,117,128,4.940038684719536,49.04223547413546
Task_10595,1819,953,99,167,266,1.9067085953878407,39.574002801394194
Task_10596,578,781,110,35,145,0.7391304347826086,17.7947560137185
Task_10597,2856,130,88,70,158,21.801526717557252,51.26564897588208
Task_10598,2912,267,19,10,29,10.865671641791044,51.53777040792175
Task_10599,862,909,135,33,168,0.9472527472527472,22.84711144653636
Task_10600,2210,377,178,142,320,5.8465608465608465,44.14791065259436
Task_10601,2518,755,96,111,207,3.3306878306878307,49.73387941286851
Task_10602,1553,748,62,95,157,2.0734312416555407,33.9420122609466
Task_10603,2782,885,18,48,66,3.139954853273138,52.02150610858598
Task_10604,1135,398,88,31,119,2.844611528822055,25.08464697440868
Task_10605,1296,689,43,92,135,1.8782608695652174,29.48809253873588
Task_10606,926,562,118,175,293,1.644760213143872,24.32847934755935
Task_10607,699,579,67,42,109,1.2051724137931035,18.7483945045114
Task_10608,1983,421,142,106,248,4.699052132701421,40.32316628315754
Task_10609,2031,787,116,46,162,2.5774111675126905,40.80064132380735
Task_10610,2335,882,96,114,210,2.6443941109852775,47.25029641428944
Task_10611,2758,70,80,189,269,38.84507042253521,50.642886472777896
Task_10612,2281,795,84,72,156,2.8655778894472363,45.11200127419986
Task_10613,1809,653,41,115,156,2.7660550458715596,37.60479867713809
Task_10614,1227,138,66,65,131,8.827338129496402,25.898487115428864
Task_10615,2927,975,10,136,146,2.9989754098360657,56.32291013451988
Task_10616,1183,475,186,49,235,2.485294117647059,27.06763569653255
Task_10617,2975,674,162,188,350,4.407407407407407,57.42163736175943
Task_10618,923,240,82,136,218,3.8298755186721993,22.966841721054156
Task_10619,2960,379,53,39,92,7.7894736842105265,53.616461993797174
Task_10620,1818,528,81,147,228,3.436672967863894,38.12839721991628
Task_10621,1290,595,106,182,288,2.164429530201342,30.196987964322314
Task_10622,1772,767,63,195,258,2.3072916666666665,38.38140164076041
Task_10623,1553,285,85,109,194,5.43006993006993,32.88073993042327
Task_10624,2402,416,159,15,174,5.7601918465227815,45.57280047102089
Task_10625,2902,169,111,121,232,17.070588235294117,53.612027856589414
Task_10626,1402,991,118,35,153,1.4133064516129032,31.396809190329176
Task_10627,2959,191,31,31,62,15.411458333333334,52.694248803870046
Task_10628,2422,194,149,38,187,12.42051282051282,45.38888821857571
Task_10629,508,725,116,174,290,0.699724517906336,18.238422195764247
Task_10630,617,442,147,145,292,1.3927765237020315,18.958367780780204
Task_10631,1136,472,179,74,253,2.40169133192389,26.699128855287018
Task_10632,1501,380,108,28,136,3.9396325459317585,31.008767481207887
Task_10633,2920,787,19,84,103,3.7055837563451774,55.03799321999772
Task_10634,584,866,72,54,126,0.6735870818915801,18.51155284405928
Task_10635,1682,672,19,132,151,2.49925705794948,35.60351263069065
Task_10636,2316,64,178,19,197,35.63076923076923,42.08157918683593
Task_10637,878,158,196,101,297,5.522012578616352,21.910944388053935
Task_10638,851,330,148,41,189,2.5709969788519635,21.03871842904476
Task_10639,2599,163,145,147,292,15.847560975609756,49.09430914545681
Task_10640,2621,750,87,37,124,3.490013315579228,49.80673491897074
Task_10641,843,645,160,31,191,1.304953560371517,21.9528256523528
Task_10642,1365,768,112,108,220,1.7750325097529258,31.49649352630352
Task_10643,1181,402,115,175,290,2.930521091811414,27.861078201632882
Task_10644,2762,921,49,184,233,2.995661605206074,54.45233071237936
Task_10645,2117,197,92,135,227,10.691919191919192,41.73786084088446
Task_10646,2999,880,59,173,232,3.4040862656072646,58.05251277994817
Task_10647,554,312,167,45,212,1.7699680511182108,16.366111950916867
Task_10648,1262,218,96,122,218,5.762557077625571,28.186143555846773
Task_10649,1481,717,109,181,290,2.062674094707521,33.611130681362575
Task_10650,2285,479,53,140,193,4.760416666666667,45.26288299510227
Task_10651,643,561,60,159,219,1.1441281138790036,19.52711440338679
Task_10652,2341,720,153,166,319,3.246879334257975,47.35241282841087
Task_10653,773,418,22,14,36,1.8448687350835322,18.150431730221943
Task_10654,2349,457,89,95,184,5.12882096069869,45.7335826480238
Task_10655,2133,629,59,122,181,3.3857142857142857,43.05675362428951
Task_10656,2933,421,133,168,301,6.950236966824645,55.68711629803033
Task_10657,1528,318,184,10,194,4.789968652037618,31.609965901417407
Task_10658,751,65,118,71,189,11.378787878787879,18.232418009223338
Task_10659,657,571,127,57,184,1.1486013986013985,18.750115782936955
Task_10660,589,157,74,117,191,3.7278481012658227,17.036393103278005
Task_10661,2134,157,149,54,203,13.50632911392405,40.8779597978368
Task_10662,1220,656,98,167,265,1.856925418569254,29.16729813822414
Task_10663,2317,816,14,130,144,2.835985312117503,46.181330873373774
Task_10664,2351,429,99,141,240,5.467441860465116,46.190111279151516
Task_10665,1618,471,188,117,305,3.4279661016949152,34.980066438406254
Task_10666,2485,214,185,41,226,11.55813953488372,46.65702169000045
Task_10667,2741,106,185,152,337,25.61682242990654,50.839836721098656
Task_10668,919,263,171,78,249,3.481060606060606,22.64412310971208
Task_10669,519,79,119,145,264,6.4875,15.474979781923118
Task_10670,1195,848,79,54,133,1.4075382803297998,28.015576469124493
Task_10671,782,115,153,52,205,6.741379310344827,19.195211501690977
Task_10672,742,376,30,103,133,1.9681697612732096,19.818621842601015
Task_10673,2976,247,135,107,242,12.0,55.39924704921193
Task_10674,2141,815,41,153,194,2.6237745098039214,43.911816348666385
Task_10675,1611,492,109,102,211,3.2677484787018254,34.49048094464373
Task_10676,2874,433,58,197,255,6.622119815668203,54.783016470228795
Task_10677,2945,964,161,169,330,3.051813471502591,57.74097971039779
Task_10678,2757,358,141,86,227,7.67966573816156,51.972222995828396
Task_10679,2729,209,197,29,226,12.995238095238095,50.50536043705531
Task_10680,1167,548,45,117,162,2.1256830601092895,27.15912840940119
Task_10681,1224,188,89,10,99,6.476190476190476,25.65306881495741
Task_10682,2615,591,33,72,105,4.41722972972973,49.483351416678765
Task_10683,2718,673,163,99,262,4.032640949554896,52.80584542651053
Task_10684,1190,585,88,38,126,2.030716723549488,26.743010157811554
Task_10685,1171,654,26,89,115,1.7877862595419847,27.232477791711105
Task_10686,2397,882,32,163,195,2.714609286523216,48.22367145037566
Task_10687,1233,561,169,139,308,2.193950177935943,29.214888114766143
Task_10688,1937,744,70,49,119,2.6,39.00391426812686
Task_10689,2300,404,145,196,341,5.679012345679013,45.83504175958751
Task_10690,558,953,49,112,161,0.5849056603773585,18.92707037650489
Task_10691,2531,349,35,10,45,7.231428571428571,45.94736818735662
Task_10692,1684,876,139,137,276,1.9201824401368301,37.19491237379928
Task_10693,2131,984,133,57,190,2.163451776649746,43.59786509153429
Task_10694,2155,890,172,77,249,2.4186307519640855,44.133217882426095
Task_10695,1090,371,143,42,185,2.9301075268817205,24.823792718072884
Task_10696,597,864,179,29,208,0.6901734104046243,19.08643631236146
Task_10697,507,1004,174,13,187,0.5044776119402985,17.915379905075905
Task_10698,572,185,50,37,87,3.075268817204301,15.271152262003882
Task_10699,1569,640,164,105,269,2.4477379095163805,34.55812692324865
Task_10700,1443,753,64,61,125,1.9137931034482758,31.427619394448172
Task_10701,1729,162,159,145,304,10.607361963190185,35.4242794406369
Task_10702,1597,570,103,88,191,2.7968476357267953,34.151116940364766
Task_10703,1673,389,61,105,166,4.28974358974359,34.896139229326664
Task_10704,969,392,152,74,226,2.4656488549618323,23.68131342327628
Task_10705,1204,93,177,28,205,12.808510638297872,25.283983246628825
Task_10706,595,811,173,164,337,0.7327586206896551,19.991791015565177
Task_10707,2701,365,32,164,196,7.379781420765028,51.38847703224013
Task_10708,848,347,58,199,257,2.4367816091954024,22.458394748307768
Task_10709,2027,905,136,188,324,2.2373068432671084,43.01113788361294
Task_10710,2235,524,135,191,326,4.257142857142857,45.12046478782014
Task_10711,1289,237,106,195,301,5.415966386554622,29.106574555816703
Task_10712,750,480,89,35,124,1.5592515592515592,19.330362136320996
Task_10713,605,874,197,99,296,0.6914285714285714,20.166146950976522
Task_10714,989,358,15,64,79,2.754874651810585,22.454266545079935
Task_10715,2184,381,10,13,23,5.717277486910994,40.419277893669175
Task_10716,2400,842,77,161,238,2.8469750889679717,48.42332200780023
Task_10717,1807,223,45,161,206,8.066964285714286,36.76084063942603
Task_10718,1898,963,109,176,285,1.9688796680497926,40.95407528010066
Task_10719,526,500,22,34,56,1.0499001996007984,15.15477441368179
Task_10720,2213,548,170,61,231,4.030965391621129,43.70124528911066
Task_10721,2727,935,197,13,210,2.9134615384615383,52.6247461498677
Task_10722,2304,693,14,119,133,3.319884726224784,45.58029982764098
Task_10723,969,919,55,142,197,1.0532608695652175,25.598160300162018
Task_10724,1371,246,188,181,369,5.550607287449393,30.718838878887922
Task_10725,516,412,122,90,212,1.2493946731234866,16.60511384307205
Task_10726,1530,747,179,109,288,2.0454545454545454,34.36638181522056
Task_10727,2141,871,24,158,182,2.455275229357798,43.891694354546495
Task_10728,927,864,175,35,210,1.0716763005780348,24.03493264799589
Task_10729,947,960,197,142,339,0.9854318418314256,25.991478818828565
Task_10730,1742,429,141,132,273,4.051162790697674,36.6858323863299
Task_10731,1252,134,80,73,153,9.274074074074074,26.188883390642772
Task_10732,769,995,41,150,191,0.7720883534136547,22.5437832714784
Task_10733,579,686,98,163,261,0.8427947598253275,18.999326406442197
Task_10734,1940,332,79,151,230,5.8258258258258255,39.46516505352123
Task_10735,2397,963,83,43,126,2.486514522821577,46.95295468387627
Task_10736,2581,644,86,130,216,4.001550387596899,50.43890742733493
Task_10737,1723,743,22,156,178,2.3158602150537635,36.775793410489065
Task_10738,821,736,72,127,199,1.1139755766621438,22.674339662459232
Task_10739,779,835,161,155,316,0.9318181818181818,22.864409694251293
Task_10740,608,902,162,54,216,0.6733111849390919,19.55568222598838
Task_10741,601,129,128,177,305,4.623076923076923,17.449993389905966
Task_10742,2988,245,48,71,119,12.146341463414634,54.50748771858167
Task_10743,1468,820,126,120,246,1.7880633373934227,33.438277166615784
Task_10744,2854,1006,38,62,100,2.83416087388282,54.33992818007231
Task_10745,2885,472,170,51,221,6.099365750528541,54.09746164661584
Task_10746,1709,299,135,137,272,5.696666666666666,35.73946924604568
Task_10747,2411,363,191,79,270,6.623626373626373,46.67050680817218
Task_10748,1524,952,52,103,155,1.5991605456453306,34.138575011867154
Task_10749,1950,190,157,150,307,10.209424083769633,39.34053868460644
Task_10750,2716,100,155,19,174,26.89108910891089,48.75321960101718
Task_10751,2788,359,32,138,170,7.7444444444444445,52.404482906293254
Task_10752,2860,92,69,176,245,30.752688172043012,52.293265244306504
Task_10753,1618,270,110,70,180,5.970479704797048,33.0527757564813
Task_10754,2264,590,43,122,165,3.8307952622673436,44.90131886169852
Task_10755,1437,996,155,78,233,1.4413239719157473,33.02090611367472
Task_10756,2667,557,19,24,43,4.779569892473118,48.901164978001326
Task_10757,1201,668,28,47,75,1.7952167414050821,26.196115472146207
Task_10758,1413,934,63,112,175,1.5112299465240642,32.61331108599982
Task_10759,1444,1006,196,178,374,1.4339622641509433,34.22876862525719
Task_10760,2659,617,185,92,277,4.302588996763754,51.664900516579614
Task_10761,2040,783,171,113,284,2.6020408163265305,42.54618341470539
Task_10762,2270,287,112,87,199,7.881944444444445,43.910653878924904
Task_10763,642,936,45,24,69,0.6851654215581644,18.51246532875386
Task_10764,1450,899,197,69,266,1.6111111111111112,32.949000802488804
Task_10765,984,799,22,126,148,1.23,24.749330501314578
Task_10766,641,297,25,10,35,2.151006711409396,15.687736184992024
Task_10767,1561,725,181,138,319,2.150137741046832,34.971050154284995
Task_10768,2823,569,38,70,108,4.9526315789473685,52.72907871579792
Task_10769,2406,425,96,168,264,5.647887323943662,47.246331613780406
Task_10770,852,641,112,179,291,1.3271028037383177,23.372424627696375
Task_10771,637,100,144,158,302,6.306930693069307,17.62516237759866
Task_10772,2579,589,98,134,232,4.371186440677966,50.28205787458395
Task_10773,1700,115,92,83,175,14.655172413793103,33.66960549594742
Task_10774,2169,262,160,65,225,8.247148288973383,42.12499178047137
Task_10775,2680,98,98,132,230,27.07070707070707,49.28056765602097
Task_10776,1593,654,21,44,65,2.43206106870229,32.35746683893701
Task_10777,1949,828,81,98,179,2.3510253317249696,40.67217546425508
Task_10778,2584,265,125,48,173,9.714285714285714,48.10912133749245
Task_10779,2925,766,71,40,111,3.8135593220338984,54.54427003085862
Task_10780,1429,1024,178,129,307,1.3941463414634145,33.67297120025996
Task_10781,1599,310,109,174,283,5.141479099678457,34.14095122271025
Task_10782,1884,667,114,114,228,2.820359281437126,39.46047349445714
Task_10783,2656,142,173,17,190,18.573426573426573,48.4984313624756
Task_10784,2576,927,22,76,98,2.7758620689655173,49.81039620454922
Task_10785,2369,929,29,156,185,2.5473118279569893,47.746394957608466
Task_10786,2297,492,200,109,309,4.659229208924949,45.80238831708755
Task_10787,739,749,178,199,377,0.9853333333333333,22.297932027303247
Task_10788,1712,845,46,128,174,2.023640661938534,37.038165928828796
Task_10789,2770,577,199,172,371,4.7923875432525955,53.936584678590485
Task_10790,1115,845,182,161,343,1.3179669030732861,28.367694624920293
Task_10791,2053,340,83,127,210,6.020527859237537,41.076779803332485
Task_10792,522,562,89,39,128,0.9271758436944938,16.272461179435343
Task_10793,1409,290,37,170,207,4.841924398625429,30.741831283841083
Task_10794,1076,1012,53,35,88,1.0621915103652517,25.791460205320934
Task_10795,2629,1022,192,84,276,2.5698924731182795,52.25261159324548
Task_10796,2485,528,18,70,88,4.697542533081285,46.93343655983026
Task_10797,2981,504,123,172,295,5.902970297029703,56.69910029000189
Task_10798,2924,150,23,183,206,19.364238410596027,53.883465573719
Task_10799,2541,959,62,79,141,2.646875,49.97444331346849
Task_10800,2668,680,191,153,344,3.9177679882525696,52.499579174454766
Task_10801,1099,977,164,139,303,1.1237218813905931,28.20398344691497
Task_10802,937,1008,15,154,169,0.9286422200198216,24.9984538974599
Task_10803,1294,857,158,96,254,1.508158508158508,30.778105261254066
Task_10804,1944,243,193,187,380,7.967213114754099,39.819305836942654
Task_10805,911,678,88,189,277,1.3416789396170838,24.378444309986964
Task_10806,813,235,139,96,235,3.444915254237288,21.161785158185303
Task_10807,1800,180,110,81,191,9.94475138121547,35.69832609183315
Task_10808,640,327,21,37,58,1.951219512195122,16.30935156290582
Task_10809,607,522,189,81,270,1.1606118546845123,18.579364912649705
Task_10810,714,119,79,90,169,5.95,18.26442255129693
Task_10811,2676,310,13,77,90,8.604501607717042,49.406718567917615
Task_10812,569,144,141,82,223,3.924137931034483,16.398998468066488
Task_10813,2271,427,42,66,108,5.30607476635514,43.47850526926345
Task_10814,2389,525,50,131,181,4.5418250950570345,46.82759264987285
Task_10815,2431,865,119,25,144,2.80715935334873,47.25819881402109
Task_10816,2937,972,91,188,279,3.0184994861253855,57.48645725537677
Task_10817,1224,799,150,69,219,1.53,28.82386158971724
Task_10818,619,107,193,16,209,5.731481481481482,16.120053306206255
Task_10819,2814,628,95,26,121,4.473767885532592,52.4827506960946
Task_10820,1061,938,36,146,182,1.1299254526091587,26.76430328679948
Task_10821,1771,372,192,87,279,4.7479892761394105,36.66645042097951
Task_10822,2965,470,147,57,204,6.295116772823779,55.255968046958664
Task_10823,2358,225,111,84,195,10.43362831858407,45.01182994895345
Task_10824,2954,250,59,123,182,11.768924302788845,54.78848342743857
Task_10825,986,72,35,53,88,13.506849315068493,20.822775167620794
Task_10826,511,793,94,21,115,0.6435768261964736,16.69047632445359
Task_10827,2428,420,40,11,51,5.767220902612826,44.622109863323544
Task_10828,2605,792,141,102,243,3.2849936948297604,51.32466125705918
Task_10829,1002,247,14,117,131,4.040322580645161,23.53203807359904
Task_10830,1610,101,197,67,264,15.784313725490197,32.194267632372096
Task_10831,1753,922,63,118,181,1.8992416034669555,37.920874811344646
Task_10832,2609,195,85,94,179,13.311224489795919,48.7959933375062
Task_10833,1405,754,132,40,172,1.8609271523178808,31.02225746970576
Task_10834,1836,703,71,67,138,2.6079545454545454,37.77295531110991
Task_10835,1794,543,101,142,243,3.297794117647059,37.75260439954484
Task_10836,1941,894,173,74,247,2.1687150837988827,40.74311917279221
Task_10837,2182,568,137,48,185,3.834797891036907,42.753673854595455
Task_10838,2117,809,171,63,234,2.61358024691358,43.08763179244301
Task_10839,1445,968,186,172,358,1.4912280701754386,34.07156866716152
Task_10840,1503,462,70,173,243,3.24622030237581,33.07411238194328
Task_10841,1360,224,61,48,109,6.044444444444444,27.900970773009757
Task_10842,777,97,82,83,165,7.928571428571429,18.743980825799618
Task_10843,839,521,119,176,295,1.60727969348659,22.833395532967657
Task_10844,1272,633,103,124,227,2.006309148264984,29.670860887839407
Task_10845,2773,271,97,50,147,10.194852941176471,50.888726599643945
Task_10846,1450,426,105,93,198,3.395784543325527,31.594459053601227
Task_10847,2849,243,65,93,158,11.676229508196721,52.74626015028752
Task_10848,1666,210,126,102,228,7.895734597156398,34.49941572272558
Task_10849,580,831,12,108,120,0.6971153846153846,18.543439487849422
Task_10850,2597,219,94,79,173,11.804545454545455,48.65688889654558
Task_10851,2001,1009,104,56,160,1.9811881188118812,41.27948265963346
Task_10852,2958,529,42,130,172,5.581132075471698,55.7423300558952
Task_10853,986,969,102,73,175,1.0164948453608247,25.307194396887226
Task_10854,597,1013,122,21,143,0.5887573964497042,18.96361801304158
Task_10855,1893,74,95,38,133,25.24,35.17929117488838
Task_10856,2855,517,164,54,218,5.511583011583012,53.77061099625191
Task_10857,2788,119,63,62,125,23.233333333333334,50.06742927323279
Task_10858,2142,291,111,64,175,7.335616438356165,41.47281832609965
Task_10859,856,1008,180,177,357,0.848364717542121,24.831224612205073
Task_10860,1054,108,141,35,176,9.669724770642201,22.7224042996731
Task_10861,2175,394,169,122,291,5.506329113924051,43.49032988531911
Task_10862,2883,919,23,178,201,3.133695652173913,56.14576087275679
Task_10863,1944,795,68,143,211,2.442211055276382,40.89995733828974
Task_10864,932,979,69,96,165,0.9510204081632653,25.008417688103496
Task_10865,953,462,27,101,128,2.058315334773218,23.551566410321954
Task_10866,582,806,59,37,96,0.7211895910780669,17.75790252730847
Task_10867,1980,368,35,193,228,5.365853658536586,40.16891359959315
Task_10868,2146,441,181,80,261,4.855203619909502,42.70309678418918
Task_10869,1081,367,149,172,321,2.9375,26.302372293155468
Task_10870,2221,399,185,116,301,5.5525,44.27094291386942
Task_10871,748,379,55,157,212,1.9684210526315788,20.71765051272422
Task_10872,1807,264,28,98,126,6.818867924528302,36.32831752758933
Task_10873,2187,993,96,69,165,2.200201207243461,44.46078901780794
Task_10874,802,465,172,27,199,1.7210300429184548,20.703777043225873
Task_10875,2574,560,124,194,318,4.588235294117647,50.571788459347374
Task_10876,519,558,100,48,148,0.9284436493738819,16.16386312907365
Task_10877,2487,857,185,197,382,2.8986013986013988,50.424583501235155
Task_10878,1301,475,187,81,268,2.7331932773109244,29.432130988549048
Task_10879,1359,338,88,11,99,4.008849557522124,28.10224631624448
Task_10880,933,621,23,157,180,1.5,23.980643541306634
Task_10881,2248,886,132,161,293,2.5343855693348365,46.27440162707925
Task_10882,1510,587,30,153,183,2.568027210884354,33.0023429895139
Task_10883,1340,870,200,189,389,1.5384615384615385,32.268480771392284
Task_10884,2622,179,36,50,86,14.566666666666666,47.447734956741265
Task_10885,2726,923,111,153,264,2.95021645021645,53.8216186288995
Task_10886,2228,509,49,51,100,4.368627450980392,42.8399772975964
Task_10887,2096,581,14,188,202,3.6013745704467355,42.58030553281488
Task_10888,887,963,72,43,115,0.9201244813278008,23.04256746597854
Task_10889,2202,682,177,43,220,3.224011713030747,43.70826316580704
Task_10890,2531,806,181,123,304,3.1363073110285007,50.501928112359394
Task_10891,2621,384,90,43,133,6.8077922077922075,48.79561514900757
Task_10892,867,538,100,119,219,1.608534322820037,22.903722489429295
Task_10893,2088,118,74,185,259,17.54621848739496,40.733975920190346
Task_10894,2093,665,11,106,117,3.1426426426426426,41.96252170086323
Task_10895,2972,517,92,38,130,5.737451737451737,54.89375486098373
Task_10896,2002,585,36,162,198,3.416382252559727,41.01477165841136
Task_10897,2188,605,159,91,250,3.6105610561056105,43.99895295989043
Task_10898,1280,807,80,180,260,1.5841584158415842,30.65852767639106
Task_10899,775,361,157,40,197,2.1408839779005526,20.005232369097218
Task_10900,1741,848,130,182,312,2.050647820965842,38.23914397259873
Task_10901,595,1005,63,92,155,0.5914512922465208,19.584626628523985
Task_10902,989,190,170,174,344,5.178010471204188,24.37757492737884
Task_10903,1153,548,140,150,290,2.1001821493624773,27.8423597156837
Task_10904,1071,417,72,92,164,2.562200956937799,25.42056230906587
Task_10905,2325,127,167,88,255,18.1640625,44.048765676460356
Task_10906,2948,393,175,52,227,7.482233502538071,54.91478091196168
Task_10907,2323,709,21,159,180,3.271830985915493,46.198254132908
Task_10908,719,282,189,140,329,2.5406360424028267,20.29403310790815
Task_10909,2154,69,123,108,231,30.771428571428572,40.790186811259524
Task_10910,2467,432,108,159,267,5.697459584295612,48.182185247428585
Task_10911,2920,520,121,109,230,5.604606525911708,55.400064780414176
Task_10912,624,185,55,142,197,3.3548387096774195,17.87097908621963
Task_10913,748,445,84,13,97,1.6771300448430493,18.7881654808857
Task_10914,1853,735,128,38,166,2.5176630434782608,37.994988267052214
Task_10915,837,148,197,161,358,5.617449664429531,21.56720420277267
Task_10916,1521,925,13,86,99,1.642548596112311,33.27053502121023
Task_10917,2092,457,169,36,205,4.567685589519651,41.193304091024146
Task_10918,1441,156,135,65,200,9.178343949044587,29.932768863970328
Task_10919,2105,685,140,53,193,3.068513119533528,42.36300177601117
Task_10920,1257,203,111,155,266,6.161764705882353,28.266275564883383
Task_10921,1265,98,42,173,215,12.777777777777779,27.070352160429348
Task_10922,1511,1013,102,159,261,1.490138067061144,34.800681156279325
Task_10923,2094,953,144,70,214,2.1949685534591197,43.10893618496565
Task_10924,2156,876,109,150,259,2.458380843785633,44.61610375115464
Task_10925,575,833,108,60,168,0.6894484412470024,18.30697929128997
Task_10926,2019,866,75,182,257,2.328719723183391,42.588144527593776
Task_10927,2578,975,153,159,312,2.6413934426229506,51.86384774000768
Task_10928,2046,622,191,91,282,3.284109149277689,41.94808763640044
Task_10929,646,644,10,45,55,1.0015503875968992,17.4532965748718
Task_10930,879,566,142,24,166,1.5502645502645502,21.940815334058502
Task_10931,1964,346,157,135,292,5.659942363112392,40.0168092990643
Task_10932,2804,595,133,48,181,4.704697986577181,52.62695649874767
Task_10933,1897,300,63,54,117,6.3023255813953485,37.053773811664946
Task_10934,2792,548,124,52,176,5.0856102003642984,52.55580134519457
Task_10935,2189,694,67,120,187,3.149640287769784,44.28538813349271
Task_10936,1501,827,172,102,274,1.8128019323671498,34.08269888220091
Task_10937,556,143,114,142,256,3.861111111111111,16.631075048312486
Task_10938,1794,443,73,116,189,4.04054054054054,37.25198712429815
Task_10939,2085,296,41,86,127,7.02020202020202,40.588751837443574
Task_10940,504,793,37,198,235,0.6347607052896725,18.137725023335847
Task_10941,2151,569,16,45,61,3.7736842105263158,40.98935206074664
Task_10942,2054,453,95,25,120,4.524229074889868,39.84408077679249
Task_10943,757,897,74,55,129,0.8429844097995546,21.309620748810968
Task_10944,1623,612,20,177,197,2.6476345840130504,35.08694983785028
Task_10945,1586,808,156,168,324,1.9604449938195303,35.69237935347539
Task_10946,2599,360,113,92,205,7.199445983379501,49.5526292479749
Task_10947,751,877,35,50,85,0.8553530751708428,20.328082628061882
Task_10948,665,477,126,10,136,1.391213389121339,17.926726073674132
Task_10949,2777,927,197,55,252,2.992456896551724,54.01862694262855
Task_10950,2964,723,77,99,176,4.093922651933702,56.44370943392951
Task_10951,2034,681,28,176,204,2.9824046920821115,41.90406965202543
Task_10952,2488,495,88,196,284,5.016129032258065,48.87026138415907
Task_10953,1941,675,49,34,83,2.871301775147929,38.38792692461066
Task_10954,2977,621,66,101,167,4.786173633440514,56.26438736264376
Task_10955,1591,331,15,25,40,4.792168674698795,31.149078380377507
Task_10956,2886,911,140,57,197,3.164473684210526,55.37681630658577
Task_10957,2504,862,160,42,202,2.9015063731170336,48.974883023705196
Task_10958,1158,1004,157,99,256,1.1522388059701492,29.014175591334375
Task_10959,2178,968,33,34,67,2.2476780185758516,42.65042664882393
Task_10960,2429,492,17,61,78,4.926977687626775,45.394437393057245
Task_10961,746,288,100,161,261,2.5813148788927336,20.464443424681804
Task_10962,2455,297,14,11,25,8.238255033557047,44.46227272853556
Task_10963,2478,376,45,90,135,6.572944297082228,47.12171537078964
Task_10964,1090,382,60,85,145,2.845953002610966,25.27135066928601
Task_10965,2639,658,57,196,253,4.004552352048559,51.78210064814767
Task_10966,2289,628,121,130,251,3.639109697933227,45.87918041857073
Task_10967,2246,857,151,121,272,2.617715617715618,45.998892177648685
Task_10968,1261,440,120,61,181,2.8594104308390023,27.87271688730583
Task_10969,977,404,159,63,222,2.4123456790123456,23.7076043793829
Task_10970,2617,151,137,164,301,17.217105263157894,49.36743248281983
Task_10971,2196,220,161,123,284,9.936651583710407,43.188485640070375
Task_10972,2997,809,45,115,160,3.7,56.90950245185198
Task_10973,774,202,168,145,313,3.812807881773399,20.83563755011411
Task_10974,2020,957,13,50,63,2.1085594989561587,40.275868837237766
Task_10975,2169,298,87,83,170,7.254180602006689,41.99090885642865
Task_10976,1597,650,20,48,68,2.453149001536098,32.50819365042777
Task_10977,2032,511,24,180,204,3.96875,41.34177573937931
Task_10978,2995,335,164,161,325,8.913690476190476,56.47311550489093
Task_10979,2378,521,140,33,173,4.555555555555555,45.70618122463401
Task_10980,1378,732,168,188,356,1.8799454297407914,32.33400130830187
Task_10981,2838,254,145,171,316,11.129411764705882,53.6727599731204
Task_10982,954,242,193,139,332,3.925925925925926,23.889011783744014
Task_10983,1247,524,69,110,179,2.375238095238095,28.636146388879027
Task_10984,701,251,12,87,99,2.7817460317460316,18.11897162085116
Task_10985,1912,747,34,140,174,2.556149732620321,39.915722909084295
Task_10986,655,792,196,99,295,0.8259773013871374,20.56187058200395
Task_10987,2169,167,52,132,184,12.910714285714286,41.755805084111536
Task_10988,2156,716,81,190,271,3.00697350069735,44.33179867439734
Task_10989,1044,684,48,106,154,1.524087591240876,25.590494616796054
Task_10990,2006,207,147,127,274,9.64423076923077,40.09997523219993
Task_10991,2643,854,186,117,303,3.0912280701754384,52.41358670979147
Task_10992,2937,101,64,118,182,28.794117647058822,53.02199109691248
Task_10993,1560,309,95,120,215,5.032258064516129,33.205441611684904
Task_10994,991,658,38,68,106,1.5037936267071321,23.878938679116192
Task_10995,669,322,184,40,224,2.071207430340557,18.326624428368515
Task_10996,1812,333,184,160,344,5.425149700598802,37.8403989116645
Task_10997,2727,490,163,84,247,5.553971486761711,51.9933447524698
Task_10998,2705,338,101,89,190,7.979351032448378,50.98210851734498
Task_10999,1864,317,155,118,273,5.861635220125786,38.227614392463956
Task_11000,2756,709,22,148,170,3.8816901408450706,52.97859063220315
Task_11001,1294,769,57,15,72,1.6805194805194805,27.718617784667416
Task_11002,2173,312,105,142,247,6.942492012779553,43.01481408276717
Task_11003,2115,237,51,51,102,8.88655462184874,40.10481888147536
Task_11004,1595,873,107,110,217,1.8249427917620138,35.469902651016035
Task_11005,2523,709,161,128,289,3.5535211267605633,50.00986353619893
Task_11006,2469,484,111,32,143,5.090721649484536,46.71396878099549
Task_11007,1792,238,163,173,336,7.497907949790795,37.181342770093885
Task_11008,775,127,101,92,193,6.0546875,19.41962176157534
Task_11009,1904,682,130,60,190,2.787701317715959,39.03879085250699
Task_11010,832,395,54,15,69,2.101010101010101,19.220209353877983
Task_11011,1324,426,61,63,124,3.100702576112412,28.689264232891798
Task_11012,1077,117,36,78,114,9.127118644067796,23.251301008368916
Task_11013,2971,773,146,84,230,3.838501291989664,56.68459804373533
Task_11014,2281,186,195,172,367,12.197860962566844,44.99476152428435
Task_11015,1658,582,15,33,48,2.843910806174957,33.1524852829927
Task_11016,2909,1017,68,197,265,2.857563850687623,57.20627940452159
Task_11017,2848,933,127,78,205,3.0492505353319057,55.11243900313958
Task_11018,1400,334,171,108,279,4.17910447761194,30.95844453345413
Task_11019,1882,864,87,142,229,2.175722543352601,40.09883374672926
Task_11020,992,418,56,129,185,2.367541766109785,24.409150679166846
Task_11021,966,968,175,182,357,0.9969040247678018,26.436572935349165
Task_11022,1835,599,162,197,359,3.058333333333333,39.18241669326719
Task_11023,2570,101,140,84,224,25.19607843137255,47.35771265789876
Task_11024,2564,854,192,120,312,2.9988304093567253,51.206843753955525
Task_11025,2595,685,177,156,333,3.782798833819242,51.31391895540829
Task_11026,1657,391,184,106,290,4.2270408163265305,35.256367920578775
Task_11027,2099,311,60,88,148,6.727564102564102,40.95869200623384
Task_11028,2919,355,167,145,312,8.19943820224719,55.258252823344755
Task_11029,2599,151,110,56,166,17.098684210526315,47.78954809947178
Task_11030,1616,321,13,81,94,5.0186335403726705,32.80816083605577
Task_11031,2015,166,73,61,134,12.065868263473053,38.45408692809374
Task_11032,915,654,137,130,267,1.3969465648854962,24.202735012798744
Task_11033,1089,259,187,71,258,4.188461538461539,25.209619638590016
Task_11034,1975,718,16,13,29,2.7468706536856744,38.23782360320074
Task_11035,1200,576,198,172,370,2.079722703639515,29.06715937635619
Task_11036,762,241,183,143,326,3.1487603305785123,20.83134139255754
Task_11037,1373,958,86,174,260,1.4316996871741396,32.47475925355585
Task_11038,2416,802,139,88,227,3.008717310087173,48.017113064090516
Task_11039,2385,814,56,115,171,2.9263803680981595,47.563143338729084
Task_11040,2730,744,26,172,198,3.664429530201342,53.09466730596427
Task_11041,1851,297,84,81,165,6.2114093959731544,37.065778909502704
Task_11042,736,727,83,89,172,1.010989010989011,20.737527029435377
Task_11043,798,488,53,194,247,1.6319018404907975,22.060990486522332
Task_11044,1563,525,58,120,178,2.9714828897338403,33.685672626624324
Task_11045,2306,872,51,81,132,2.6414662084765177,46.096226306534476
Task_11046,2295,326,196,95,291,7.018348623853211,45.09321247357999
Task_11047,988,749,37,98,135,1.3173333333333332,24.740134706008025
Task_11048,2778,145,38,126,164,19.027397260273972,51.04155272956097
Task_11049,1194,1001,44,116,160,1.1916167664670658,28.79706726432572
Task_11050,957,702,13,97,110,1.3613086770981508,23.95653872439892
Task_11051,1587,369,41,53,94,4.289189189189189,32.22427039708548
Task_11052,610,666,133,113,246,0.9145427286356822,19.282700409042675
Task_11053,1904,345,141,97,238,5.502890173410405,38.79896006712709
Task_11054,984,560,91,172,263,1.7540106951871657,25.150299548627988
Task_11055,1577,347,44,140,184,4.531609195402299,33.259166122919176
Task_11056,2784,252,155,115,270,11.003952569169961,52.52257931800216
Task_11057,2084,553,195,126,321,3.7617328519855597,42.70435501546266
Task_11058,601,630,117,36,153,0.9524564183835182,17.69430811311376
Task_11059,2813,788,159,61,220,3.565272496831432,53.91476708937636
Task_11060,881,396,169,144,313,2.2191435768261965,23.15321391600509
Task_11061,1515,828,20,156,176,1.827503015681544,33.77298604987467
Task_11062,1732,127,22,141,163,13.53125,34.226786707269284
Task_11063,2376,434,149,108,257,5.462068965517242,46.62869846570069
Task_11064,1472,330,157,93,250,4.447129909365559,31.86601293247855
Task_11065,2616,390,32,196,228,6.690537084398977,50.319013957068215
Task_11066,1579,573,194,175,369,2.750871080139373,35.05924747206257
Task_11067,1995,612,35,111,146,3.2544861337683524,40.40821271509882
Task_11068,1800,655,123,101,224,2.7439024390243905,38.05521425188894
Task_11069,1565,104,194,196,390,14.904761904761905,32.651096377419286
Task_11070,586,860,13,172,185,0.6806039488966318,19.37979322612402
Task_11071,614,452,138,26,164,1.3554083885209713,17.487229534595333
Task_11072,2661,924,46,132,178,2.8767567567567567,52.22893526287819
Task_11073,1632,622,42,108,150,2.619582664526485,34.64094532813147
Task_11074,2440,617,27,26,53,3.9482200647249193,45.733493402734375
Task_11075,2384,878,103,143,246,2.712172923777019,48.16611770222792
Task_11076,2300,619,70,168,238,3.7096774193548385,46.16242320113984
Task_11077,1675,924,178,174,352,1.8108108108108107,37.59826554802091
Task_11078,627,265,137,88,225,2.357142857142857,17.988350284220978
Task_11079,1065,611,23,150,173,1.7401960784313726,26.133325042714038
Task_11080,1426,865,142,184,326,1.6466512702078522,33.35361833966798
Task_11081,1455,730,101,49,150,1.990424076607387,31.487618953269475
Task_11082,2261,487,145,81,226,4.633196721311475,44.478086082053174
Task_11083,708,426,97,58,155,1.6580796252927401,18.89565422942014
Task_11084,711,317,34,191,225,2.2358490566037736,19.91345982751717
Task_11085,1646,222,122,85,207,7.381165919282512,33.83281988878983
Task_11086,1127,736,190,131,321,1.5291723202170964,28.086245799002402
Task_11087,1075,494,194,162,356,2.1717171717171717,26.752920966664522
Task_11088,837,418,110,79,189,1.9976133651551313,21.54742699790846
Task_11089,2760,792,106,186,292,3.480453972257251,54.124295270065225
Task_11090,718,293,72,62,134,2.442176870748299,18.746377792845806
Task_11091,2632,128,61,189,250,20.4031007751938,49.280593022256454
Task_11092,1470,421,29,189,218,3.4834123222748814,32.232120851934845
Task_11093,830,172,59,104,163,4.797687861271676,20.414219304965375
Task_11094,1668,865,182,180,362,1.926096997690531,37.35782649751089
Task_11095,2118,105,81,120,201,19.9811320754717,40.4293287306658
Task_11096,1749,266,111,95,206,6.550561797752809,35.87187722029983
Task_11097,1573,155,24,103,127,10.083333333333334,31.524571566570074
Task_11098,1862,988,194,70,264,1.8827098078867543,39.76668289083939
Task_11099,999,965,182,42,224,1.0341614906832297,25.509482714218493
Task_11100,1126,300,130,48,178,3.740863787375415,25.10033953751149
Task_11101,886,274,173,129,302,3.2218181818181817,22.76997201801889
Task_11102,1182,774,30,181,211,1.5251612903225806,28.697703995584146
Task_11103,2838,991,35,72,107,2.8608870967741935,54.32431738870338
Task_11104,671,449,100,92,192,1.491111111111111,19.22951411520788
Task_11105,897,214,189,196,385,4.1720930232558135,23.21727658284286
Task_11106,1571,840,185,138,323,1.868014268727705,35.50582289762796
Task_11107,1827,180,48,69,117,10.0939226519337,35.433041991844604
Task_11108,1184,463,115,50,165,2.5517241379310347,26.661220688024343
Task_11109,1908,1004,180,125,305,1.8985074626865672,41.25528426257021
Task_11110,1960,814,117,187,304,2.4049079754601226,41.57422165957055
Task_11111,1100,98,78,84,162,11.11111111111111,23.718539117598613
Task_11112,701,526,152,68,220,1.3301707779886147,19.724463046508927
Task_11113,1967,83,151,65,216,23.416666666666668,37.43861213204294
Task_11114,1203,738,172,183,355,1.6278755074424898,29.555174722584734
Task_11115,525,183,72,200,272,2.8532608695652173,16.726703016114254
Task_11116,2759,483,140,167,307,5.700413223140496,53.16292521631092
Task_11117,1920,575,33,29,62,3.3333333333333335,37.358600237494585
Task_11118,1068,778,157,133,290,1.3709884467265725,27.12657279878626
Task_11119,2555,142,141,120,261,17.867132867132867,48.106674499680985
Task_11120,513,819,180,37,217,0.625609756097561,17.771901114783372
Task_11121,2634,184,179,100,279,14.237837837837837,49.750893576509064
Task_11122,2437,338,97,53,150,7.188790560471976,46.04111599561356
Task_11123,919,947,61,66,127,0.9694092827004219,24.0418852111831
Task_11124,537,883,53,78,131,0.6074660633484162,18.297328474185722
Task_11125,2284,327,144,15,159,6.963414634146342,43.13175107566686
Task_11126,1737,866,167,24,191,2.0034602076124566,36.72478438273741
Task_11127,683,222,189,168,357,3.062780269058296,19.697469393564408
Task_11128,1431,127,86,121,207,11.1796875,30.006864463732565
Task_11129,2884,318,56,165,221,9.04075235109718,54.35387075637871
Task_11130,807,425,82,27,109,1.8943661971830985,19.868408014409955
Task_11131,1972,677,49,166,215,2.9085545722713864,41.06419292563289
Task_11132,1062,460,180,19,199,2.3036876355748372,24.63701979746946
Task_11133,1446,435,33,13,46,3.31651376146789,29.09145157912846
Task_11134,2171,215,196,68,264,10.050925925925926,42.16331565414834
Task_11135,867,755,89,199,288,1.1468253968253967,23.950742325069204
Task_11136,2554,658,94,80,174,3.87556904400607,49.47109005381552
Task_11137,2467,954,158,14,172,2.5832460732984295,48.29019451633838
Task_11138,2934,333,88,20,108,8.784431137724551,53.076509925321936
Task_11139,2308,747,102,54,156,3.085561497326203,45.28043883530654
Task_11140,2843,389,10,182,192,7.28974358974359,53.68696690719104
Task_11141,2094,369,34,145,179,5.65945945945946,41.504817467471675
Task_11142,1804,182,16,38,54,9.857923497267759,34.48361875614909
Task_11143,965,995,33,69,102,0.9688755020080321,24.537907191829234
Task_11144,1449,298,180,20,200,4.846153846153846,30.275969560993676
Task_11145,686,395,150,157,307,1.7323232323232323,20.043150732210183
Task_11146,2425,677,75,86,161,3.5766961651917404,47.34105002084355
Task_11147,2456,102,141,125,266,23.844660194174757,45.98762397053963
Task_11148,756,560,180,186,366,1.3475935828877006,21.94845705156347
Task_11149,1667,716,37,77,114,2.324965132496513,35.16975719594837
Task_11150,2510,121,197,123,320,20.57377049180328,47.45721663476752
Task_11151,863,932,62,106,168,0.92497320471597,23.610547213902816
Task_11152,2927,548,101,51,152,5.331511839708561,54.38173309778711
Task_11153,787,606,99,26,125,1.2965403624382208,20.27584804670167
Task_11154,2001,707,61,68,129,2.8262711864406778,40.50430598894864
Task_11155,2371,396,22,58,80,5.972292191435768,44.38425337464136
Task_11156,2300,573,129,184,313,4.006968641114983,46.23732695194161
Task_11157,1273,135,76,193,269,9.360294117647058,28.074284743321943
Task_11158,2230,1006,36,41,77,2.2144985104270107,43.54509444436845
Task_11159,1068,267,176,55,231,3.985074626865672,24.76908628605494
Task_11160,856,345,50,28,78,2.4739884393063583,19.81845752377811
Task_11161,1483,693,66,22,88,2.136887608069164,31.153620779783477
Task_11162,1781,75,13,22,35,23.43421052631579,32.230175915825804
Task_11163,1684,110,114,181,295,15.17117117117117,34.12488522576998
Task_11164,621,645,169,22,191,0.9613003095975232,18.472714306664937
Task_11165,2964,679,147,59,206,4.358823529411764,55.89934800188835
Task_11166,1063,421,85,139,224,2.518957345971564,25.751263590431446
Task_11167,2782,542,78,50,128,5.123388581952118,52.05108383154023
Task_11168,567,264,188,147,335,2.139622641509434,17.87115138543778
Task_11169,622,326,183,107,290,1.9021406727828747,18.676565842618373
Task_11170,1280,133,75,88,163,9.552238805970148,27.198109194312067
Task_11171,2735,539,107,39,146,5.064814814814815,51.11025978772701
Task_11172,1903,70,110,65,175,26.802816901408452,36.100385899472826
Task_11173,2883,136,170,198,368,21.043795620437955,53.8068063613884
Task_11174,2293,905,175,101,276,2.5309050772626933,46.882140370559796
Task_11175,1975,862,102,89,191,2.2885283893395134,41.11919436443562
Task_11176,1816,514,72,99,171,3.5262135922330096,37.534582650853544
Task_11177,973,593,88,41,129,1.638047138047138,23.34100778325192
Task_11178,2589,513,128,57,185,5.036964980544747,49.21454308747975
Task_11179,1334,636,40,20,60,2.0941915227629515,27.927784326614347
Task_11180,2035,140,129,13,142,14.432624113475176,38.15611385635655
Task_11181,2824,734,156,97,253,3.8421768707482995,54.68280738935968
Task_11182,841,532,97,160,257,1.577861163227017,22.699081933857958
Task_11183,2487,900,54,187,241,2.760266370699223,50.06795420305732
Task_11184,2306,713,30,90,120,3.2296918767507004,45.40330913891278
Task_11185,639,744,50,115,165,0.8577181208053691,19.65083410842467
Task_11186,2249,738,124,116,240,3.0433017591339646,45.52224762432535
Task_11187,2799,1012,139,14,153,2.763079960513327,53.425366764183025
Task_11188,2618,338,138,103,241,7.722713864306785,50.05721233512791
Task_11189,2641,334,160,28,188,7.883582089552239,49.31598295496781
Task_11190,1686,203,94,94,188,8.264705882352942,34.5684905748631
Task_11191,607,102,83,161,244,5.893203883495145,16.90435824118082
Task_11192,1790,719,70,132,202,2.486111111111111,38.18419043509169
Task_11193,594,802,144,174,318,0.7397260273972602,19.83431217087369
Task_11194,1813,429,90,74,164,4.216279069767442,36.8322893295188
Task_11195,721,585,147,52,199,1.2303754266211604,20.117861825593764
Task_11196,1272,68,97,67,164,18.434782608695652,26.151611965702113
Task_11197,1037,475,116,83,199,2.1785714285714284,24.97482167168997
Task_11198,700,336,158,64,222,2.077151335311573,19.117137930470474
Task_11199,1174,753,39,180,219,1.557029177718833,28.51176844379718
Task_11200,1726,736,32,87,119,2.3419267299864317,36.26444273830816
Task_11201,1874,503,82,29,111,3.7182539682539684,37.04616545861244
Task_11202,2105,102,176,113,289,20.436893203883496,40.559516436696896
Task_11203,1015,344,190,147,337,2.9420289855072466,25.22008864966335
Task_11204,1280,271,45,157,202,4.705882352941177,28.57780733627334
Task_11205,2253,841,102,11,113,2.675771971496437,44.098726962780404
Task_11206,2950,487,95,54,149,6.045081967213115,54.68690088544556
Task_11207,2673,898,63,118,181,2.9733036707452727,52.423904293994774
Task_11208,508,170,46,132,178,2.9707602339181287,15.388704563364314
Task_11209,2364,785,30,52,82,3.0076335877862594,45.71524952300506
Task_11210,1168,732,60,142,202,1.5934515688949522,28.360371538871963
Task_11211,1190,904,194,43,237,1.3149171270718232,28.45456697577541
Task_11212,528,593,124,36,160,0.8888888888888888,16.417423241805533
Task_11213,1108,75,34,18,52,14.578947368421053,21.83858256046248
Task_11214,921,759,56,42,98,1.2118421052631578,22.5650357587996
Task_11215,1335,734,200,110,310,1.816326530612245,31.33738946675477
Task_11216,1766,575,89,89,178,3.0659722222222223,36.705645784302384
Task_11217,739,693,153,156,309,1.0648414985590777,21.695026961665565
Task_11218,899,536,128,64,192,1.6741154562383613,22.763463283442416
Task_11219,2405,372,77,107,184,6.447721179624665,46.504153311853344
Task_11220,2277,401,64,157,221,5.664179104477612,44.99117469432974
Task_11221,1448,99,177,104,281,14.48,30.18430697937636
Task_11222,2685,963,48,21,69,2.7852697095435683,50.58231313955275
Task_11223,1746,932,66,116,182,1.8713826366559485,37.837260990351375
Task_11224,707,295,74,104,178,2.3885135135135136,19.362786170249525
Task_11225,2517,634,14,158,172,3.9637795275590553,49.168682685814474
Task_11226,2385,938,184,176,360,2.5399361022364215,48.931398525182864
Task_11227,1759,543,26,118,144,3.233455882352941,36.45951878900238
Task_11228,2732,626,171,181,352,4.35725677830941,53.418905330987776
Task_11229,2948,1022,44,100,144,2.881720430107527,56.746202945798935
Task_11230,2527,709,97,19,116,3.5591549295774647,47.874796405886656
Task_11231,1461,871,72,147,219,1.6754587155963303,33.5173004713111
Task_11232,1068,780,177,26,203,1.3674775928297056,25.941143261661384
Task_11233,753,295,136,150,286,2.543918918918919,20.69415143112931
Task_11234,2420,678,31,76,107,3.5640648011782035,46.791115077145015
Task_11235,2342,431,76,198,274,5.421296296296297,46.42752885018209
Task_11236,2950,374,168,160,328,7.866666666666666,55.90777288585531
Task_11237,1299,151,124,44,168,8.546052631578947,26.940470734368713
Task_11238,1484,407,175,98,273,3.6372549019607843,32.48554561454011
Task_11239,2108,240,195,119,314,8.746887966804978,42.00215105729973
Task_11240,2594,759,27,194,221,3.413157894736842,51.12333023618566
Task_11241,1359,454,194,20,214,2.986813186813187,29.42046110236562
Task_11242,1219,428,76,22,98,2.8414918414918415,26.33698777353767
Task_11243,1035,625,112,89,201,1.6533546325878594,25.526994858491708
Task_11244,2560,465,139,200,339,5.493562231759657,50.146733288634586
Task_11245,1795,166,76,88,164,10.748502994011975,35.66187961798371
Task_11246,2854,357,186,160,346,7.972067039106145,54.412132094177686
Task_11247,2016,798,66,51,117,2.523153942428035,40.60244467764563
Task_11248,1593,98,156,37,193,16.09090909090909,31.22526808420841
Task_11249,543,103,168,27,195,5.221153846153846,15.01076431091765
Task_11250,1326,211,199,118,317,6.254716981132075,29.559568984418075
Task_11251,1570,287,95,46,141,5.451388888888889,31.882398173163864
Task_11252,2772,931,24,196,220,2.9742489270386265,54.48313470699944
Task_11253,1266,574,186,75,261,2.2017391304347824,29.108332699404368
Task_11254,2631,971,10,182,192,2.70679012345679,52.186118018139545
Task_11255,2832,197,77,113,190,14.303030303030303,52.860924444211626
Task_11256,2079,444,63,142,205,4.671910112359551,41.90411070986115
Task_11257,1895,493,199,60,259,3.8360323886639676,38.62052702233765
Task_11258,2706,590,17,177,194,4.5786802030456855,52.112072941628234
Task_11259,2842,798,51,162,213,3.5569461827284106,55.24697895001406
Task_11260,1245,98,56,21,77,12.575757575757576,24.29679610370323
Task_11261,913,679,145,162,307,1.3426470588235293,24.50386826306656
Task_11262,2376,607,183,124,307,3.9078947368421053,47.43402594792067
Task_11263,2644,595,127,43,170,4.436241610738255,50.00710563330756
Task_11264,2452,547,62,135,197,4.474452554744525,48.09448548126309
Task_11265,583,391,182,90,272,1.4872448979591837,17.9548593263559
Task_11266,1532,239,87,170,257,6.383333333333334,32.72571359436704
Task_11267,2477,178,17,134,151,13.837988826815643,45.8755548468651
Task_11268,1245,128,178,184,362,9.651162790697674,27.850542408811407
Task_11269,2512,142,120,75,195,17.566433566433567,46.69106247886331
Task_11270,2054,391,108,185,293,5.239795918367347,41.66727032361727
Task_11271,618,934,187,139,326,0.6609625668449198,20.77436764287194
Task_11272,2762,166,89,177,266,16.538922155688624,51.61655251188339
Task_11273,2196,342,136,58,194,6.402332361516035,42.606540082496146
Task_11274,2671,707,145,140,285,3.772598870056497,52.3475162029895
Task_11275,640,932,109,94,203,0.6859592711682744,20.438695293072517
Task_11276,2616,691,70,152,222,3.7803468208092488,51.2998103539899
Task_11277,502,902,47,69,116,0.5559246954595792,17.119023822884753
Task_11278,2775,530,174,36,210,5.2259887005649714,52.26425485490467
Task_11279,626,179,87,63,150,3.477777777777778,16.56414702319825
Task_11280,2531,522,190,46,236,4.839388145315487,48.477445373671145
Task_11281,1194,857,82,114,196,1.3916083916083917,29.000334230382236
Task_11282,842,131,50,176,226,6.378787878787879,21.04356018697077
Task_11283,1625,726,90,108,198,2.235213204951857,35.44793158687922
Task_11284,2085,959,165,40,205,2.171875,42.660141867380794
Task_11285,2452,775,182,119,301,3.1597938144329896,49.133676085499225
Task_11286,2016,777,165,132,297,2.5912596401028276,42.23363796224633
Task_11287,1387,928,30,154,184,1.4930032292787945,32.09297686695814
Task_11288,1648,847,64,100,164,1.9433962264150944,35.98794811909592
Task_11289,1512,801,41,158,199,1.885286783042394,33.932568491976575
Task_11290,2992,827,83,55,138,3.6135265700483092,56.33234631816084
Task_11291,662,111,70,138,208,5.910714285714286,17.667271757806933
Task_11292,2871,196,146,30,176,14.573604060913706,52.269808503526285
Task_11293,2892,897,86,79,165,3.220489977728285,55.49780067370722
Task_11294,1256,175,141,118,259,7.136363636363637,27.676982140993573
Task_11295,602,115,142,139,281,5.189655172413793,17.17580719775042
Task_11296,1824,758,167,179,346,2.4031620553359683,39.42225745580724
Task_11297,1777,817,61,144,205,2.1723716381418092,38.30297607196771
Task_11298,1833,272,118,43,161,6.714285714285714,35.983808220572236
Task_11299,1021,709,197,48,245,1.4380281690140846,25.209367160120568
Task_11300,1118,1022,66,185,251,1.0928641251221896,28.565654370754757
Task_11301,557,684,83,164,247,0.8131386861313868,18.581228759296852
Task_11302,1064,213,100,56,156,4.97196261682243,23.907107175313836
Task_11303,608,321,90,132,222,1.8881987577639752,18.218756372042645
Task_11304,1126,768,66,186,252,1.4642392717815345,28.03512396987224
Task_11305,2647,966,199,21,220,2.737331954498449,51.53651894058487
Task_11306,601,556,88,29,117,1.0789946140035906,17.16965013200009
Task_11307,1322,327,132,187,319,4.030487804878049,29.998048813295892
Task_11308,1638,206,126,97,223,7.913043478260869,34.04642458392596
Task_11309,1468,127,145,73,218,11.46875,30.15036615390495
Task_11310,1128,856,98,189,287,1.3162193698949824,28.410329661454824
Task_11311,522,708,108,83,191,0.7362482369534555,17.466578449649123
Task_11312,1553,768,88,184,272,2.0195058517555267,34.85366753641449
Task_11313,1308,786,19,179,198,1.662007623888183,30.634832900455706
Task_11314,1486,534,179,79,258,2.777570093457944,32.52981120733302
Task_11315,643,204,94,62,156,3.1365853658536587,17.23805547334466
Task_11316,2966,127,54,169,223,23.171875,54.387703679975004
Task_11317,2923,804,195,19,214,3.631055900621118,55.26229532313628
Task_11318,2724,405,33,20,53,6.70935960591133,49.34713352581797
Task_11319,2397,328,110,197,307,7.285714285714286,46.962926548591874
Task_11320,2207,703,76,93,169,3.1349431818181817,44.2661711455198
Task_11321,567,449,34,181,215,1.26,17.827235200054577
Task_11322,2754,194,153,144,297,14.123076923076923,51.91145427912385
Task_11323,1351,221,135,169,304,6.085585585585585,30.00572448279767
Task_11324,1750,250,29,140,169,6.972111553784861,35.61563048982648
Task_11325,853,144,41,171,212,5.882758620689655,21.217162410629278
Task_11326,1120,837,165,122,287,1.3365155131264916,28.12469987527211
Task_11327,1369,72,190,80,270,18.753424657534246,28.421137510519888
Task_11328,509,933,148,82,230,0.5449678800856531,18.28028224521137
Task_11329,2593,829,36,10,46,3.1240963855421686,48.449569248389146
Task_11330,2072,228,35,88,123,9.048034934497817,40.1430394019737
Task_11331,2210,1004,150,36,186,2.199004975124378,44.565011179690174
Task_11332,1439,555,53,129,182,2.588129496402878,31.862877069939604
Task_11333,560,527,137,96,233,1.0606060606060606,17.938242583619882
Task_11334,2942,803,106,63,169,3.6592039800995027,55.64405278317301
Task_11335,2337,65,181,16,197,35.40909090909091,42.430171554444115
Task_11336,1490,773,60,44,104,1.925064599483204,31.493365622550158
Task_11337,2283,332,118,27,145,6.8558558558558556,43.297118747168916
Task_11338,1021,677,115,12,127,1.5058997050147493,24.143645686895876
Task_11339,1715,134,69,142,211,12.703703703703704,34.66155006842887
Task_11340,2794,784,172,184,356,3.559235668789809,54.92330614835699
Task_11341,835,369,110,91,201,2.2567567567567566,21.611288530973663
Task_11342,952,290,111,87,198,3.2714776632302405,23.080828988465978
Task_11343,611,506,197,144,341,1.205128205128205,19.268705168575934
Task_11344,2656,307,198,141,339,8.623376623376624,51.04787538529763
Task_11345,2748,191,86,14,100,14.3125,49.71657416096934
Task_11346,790,977,65,176,241,0.8077709611451943,23.247914573913107
Task_11347,1713,226,87,151,238,7.546255506607929,35.42509870991473
Task_11348,1219,222,70,82,152,5.466367713004484,26.700091706493165
Task_11349,1457,422,117,132,249,3.4444444444444446,32.04479715902354
Task_11350,1293,468,86,173,259,2.7569296375266523,29.74281392692359
Task_11351,1586,894,136,53,189,1.7720670391061453,34.73534733879118
Task_11352,1896,428,33,67,100,4.419580419580419,37.51246552055793
Task_11353,2953,979,138,98,236,3.013265306122449,57.39016902157321
Task_11354,1572,678,99,125,224,2.3151693667157587,34.5528582780197
Task_11355,1249,94,91,91,182,13.147368421052631,26.16855259503032
Task_11356,897,340,118,164,282,2.63049853372434,23.11791630134088
Task_11357,1555,808,27,186,213,1.9221260815822003,34.76829796874266
Task_11358,657,529,134,26,160,1.239622641509434,18.142083546506157
Task_11359,1918,663,137,142,279,2.88855421686747,40.25733787873839
Task_11360,987,813,30,90,120,1.2125307125307125,24.604521279591
Task_11361,2447,641,150,110,260,3.811526479750779,48.43401008064299
Task_11362,644,73,169,54,223,8.702702702702704,16.60989563006051
Task_11363,686,900,200,116,316,0.7613762486126526,21.55218514006199
Task_11364,764,284,172,135,307,2.680701754385965,20.90531849587246
Task_11365,1384,670,191,67,258,2.0625931445603576,31.175609441576437
Task_11366,913,652,95,93,188,1.3981623277182236,23.72033223336237
Task_11367,2194,987,180,73,253,2.220647773279352,45.01722354629194
Task_11368,2139,450,92,151,243,4.74279379157428,43.00720358967542
Task_11369,762,87,105,156,261,8.659090909090908,19.289237931344562
Task_11370,1655,425,24,59,83,3.884976525821596,33.25816913959729
Task_11371,1063,245,113,120,233,4.321138211382114,25.14700614847634
Task_11372,2269,301,102,150,252,7.513245033112582,44.52908672236516
Task_11373,2432,259,62,176,238,9.353846153846154,47.059572874865744
Task_11374,1156,990,155,78,233,1.1664984863773966,28.59773878120261
Task_11375,1122,514,163,191,354,2.1786407766990292,27.59336784765917
Task_11376,2623,588,59,54,113,4.453310696095077,49.55976210244412
Task_11377,1414,736,74,83,157,1.9185888738127543,31.436302781179695
Task_11378,2579,161,30,42,72,15.919753086419753,46.34493366386315
Task_11379,1227,913,89,96,185,1.3424507658643325,29.484141039647103
Task_11380,1478,780,106,30,136,1.8924455825864277,31.951380922742715
Task_11381,952,498,166,66,232,1.907815631262525,23.655918877721746
Task_11382,2211,335,169,93,262,6.580357142857143,43.624476907452426
Task_11383,1205,816,171,178,349,1.474908200734394,29.754409472784545
Task_11384,2460,406,149,45,194,6.044226044226044,46.75188747471372
Task_11385,538,504,32,13,45,1.0653465346534654,15.01712673825937
Task_11386,2382,856,162,186,348,2.779463243873979,48.58842760303522
Task_11387,2694,949,80,66,146,2.8357894736842106,52.15364021449842
Task_11388,2985,108,138,129,267,27.38532110091743,54.3541884992078
Task_11389,2341,234,179,111,290,9.961702127659574,45.54070090027536
Task_11390,1072,196,108,105,213,5.441624365482234,24.963842223029687
Task_11391,933,479,35,170,205,1.94375,23.818465425472095
Task_11392,2673,345,137,65,202,7.72543352601156,50.279641631826415
Task_11393,2667,688,10,132,142,3.8708272859216257,51.27349286621202
Task_11394,1365,644,154,84,238,2.116279069767442,30.8754269769985
Task_11395,2282,198,142,168,310,11.467336683417086,44.69097779870136
Task_11396,623,151,107,81,188,4.098684210526316,16.980478138232506
Task_11397,1412,481,83,72,155,2.929460580912863,30.37286268587357
Task_11398,2794,868,160,122,282,3.2151898734177213,54.76265076379648
Task_11399,982,410,111,105,216,2.389294403892944,24.301375526881113
Task_11400,1606,939,189,39,228,1.7085106382978723,35.063789197271966
Task_11401,1116,781,12,38,50,1.4271099744245523,25.274902158194962
Task_11402,2718,359,17,69,86,7.55,50.02889741379511
Task_11403,2494,142,111,147,258,17.44055944055944,47.17181965990366
Task_11404,2533,670,34,39,73,3.774962742175857,47.2881373871953
Task_11405,1050,841,77,53,130,1.2470308788598574,25.692364469990608
Task_11406,2306,935,130,58,188,2.463675213675214,46.16389525573576
Task_11407,1897,657,90,80,170,2.882978723404255,38.90102422374329
Task_11408,1824,750,34,135,169,2.428761651131824,38.37830053731989
Task_11409,514,282,68,190,258,1.8162544169611308,16.929080373747933
Task_11410,2736,989,87,127,214,2.7636363636363637,53.93121954979927
Task_11411,2157,598,17,96,113,3.6010016694490816,42.74638965450856
Task_11412,2991,889,175,12,187,3.3606741573033707,56.53428493493968
Task_11413,1721,460,196,178,374,3.7331887201735356,36.975704032049684
Task_11414,1184,410,132,171,303,2.880778588807786,27.98678143257455
Task_11415,803,981,49,145,194,0.8177189409368636,23.178366450593135
Task_11416,2551,179,162,162,324,14.172222222222222,48.4847585025677
Task_11417,1456,664,173,175,348,2.1894736842105265,33.30218147498743
Task_11418,2254,686,191,127,318,3.2809315866084425,45.8055736553554
Task_11419,2297,347,53,35,88,6.600574712643678,42.93204407484374
Task_11420,1106,559,59,166,225,1.975,27.017760258340644
Task_11421,1898,297,20,47,67,6.369127516778524,36.083240904208644
Task_11422,1858,468,166,143,309,3.961620469083156,38.825644965643896
Task_11423,2106,624,37,119,156,3.3696,42.23442321488678
Task_11424,2705,688,108,172,280,3.925979680696662,52.8503757317312
Task_11425,2289,675,32,106,138,3.386094674556213,45.19881638269405
Task_11426,1761,1021,161,42,203,1.7230919765166341,37.69023351526472
Task_11427,2301,967,61,22,83,2.3770661157024793,44.82347228845614
Task_11428,1305,974,148,48,196,1.3384615384615384,30.33657945034837
Task_11429,1835,640,84,165,249,2.862714508580343,38.816221451495686
Task_11430,1755,308,121,94,215,5.679611650485437,36.12161820697794
Task_11431,2195,68,82,179,261,31.81159420289855,41.71521267880141
Task_11432,1976,284,13,123,136,6.933333333333334,39.04580639928425
Task_11433,518,114,178,200,378,4.504347826086956,16.358984640185536
Task_11434,2703,729,149,145,294,3.702739726027397,52.97177744618443
Task_11435,1303,831,39,70,109,1.5661057692307692,29.463335439334475
Task_11436,638,943,165,196,361,0.6758474576271186,21.359555536378632
Task_11437,729,617,33,109,142,1.1796116504854368,20.23974819775545
Task_11438,2399,374,78,190,268,6.397333333333333,47.09478618605053
Task_11439,664,286,179,33,212,2.313588850174216,18.082635255767656
Task_11440,2484,598,21,142,163,4.146911519198665,48.30412192497164
Task_11441,1355,580,144,180,324,2.332185886402754,31.33861801614425
Task_11442,2490,355,105,157,262,6.99438202247191,48.264334032787836
Task_11443,2332,101,138,89,227,22.862745098039216,43.74495654832439
Task_11444,2901,881,160,64,224,3.2891156462585034,55.69714327507453
Task_11445,2273,709,104,170,274,3.2014084507042253,46.04367605658637
Task_11446,930,839,80,169,249,1.1071428571428572,24.99153210445894
Task_11447,518,130,136,179,315,3.954198473282443,16.208270708481724
Task_11448,996,616,186,194,380,1.614262560777958,26.02539385858562
Task_11449,875,816,85,61,146,1.0709914320685434,22.67723431855224
Task_11450,673,961,159,138,297,0.6995841995841996,21.560361243246117
Task_11451,1732,422,142,62,204,4.094562647754137,35.59872175446833
Task_11452,2085,1003,170,135,305,2.0766932270916336,44.07177305554452
Task_11453,1063,365,29,128,157,2.9043715846994536,24.934486639488977
Task_11454,1589,204,178,120,298,7.751219512195122,33.60368582200519
Task_11455,2402,831,96,72,168,2.887019230769231,47.290725523505756
Task_11456,1719,771,191,96,287,2.226683937823834,37.43543716394611
Task_11457,1335,762,189,101,290,1.7496723460026213,31.30779041932099
Task_11458,1336,1018,185,23,208,1.3110893032384692,30.939886268451563
Task_11459,1304,885,78,141,219,1.471783295711061,31.03195324199177
Task_11460,2629,593,38,73,111,4.425925925925926,49.89875233920946
Task_11461,2418,859,175,56,231,2.811627906976744,48.02442678389559
Task_11462,2126,308,66,45,111,6.880258899676376,40.3378320146768
Task_11463,2809,356,185,60,245,7.868347338935574,52.57118056959939
Task_11464,2144,948,155,102,257,2.2592202318229715,44.570940124425526
Task_11465,1080,691,129,55,184,1.560693641618497,25.889509582489328
Task_11466,1661,874,20,134,154,1.8982857142857144,35.90047908681057
Task_11467,730,425,196,74,270,1.7136150234741785,20.193020705914453
Task_11468,1486,976,99,47,146,1.5209825997952917,32.70343033748015
Task_11469,538,584,93,30,123,0.9196581196581196,16.636111804789465
Task_11470,2655,200,95,69,164,13.208955223880597,49.25550490922401
Task_11471,1326,695,65,145,210,1.9051724137931034,30.79920959420471
Task_11472,1969,428,187,55,242,4.589743589743589,39.59664639955858
Task_11473,1618,992,24,71,95,1.6294058408862033,34.84994915905798
Task_11474,1700,925,106,166,272,1.83585313174946,37.625223486246846
Task_11475,2735,872,157,118,275,3.1328751431844215,53.80293187998624
Task_11476,2025,660,181,41,222,3.0635400907715584,40.84750520399454
Task_11477,2582,444,73,50,123,5.802247191011236,48.36667248646475
Task_11478,1953,583,139,131,270,3.344178082191781,40.50263815443602
Task_11479,1856,101,115,29,144,18.19607843137255,35.13115319957933
Task_11480,2588,272,168,76,244,9.47985347985348,48.963197600595414
Task_11481,1789,824,148,39,187,2.1684848484848485,37.39117238909531
Task_11482,2825,86,189,194,383,32.47126436781609,52.274664647044155
Task_11483,1009,100,146,39,185,9.990099009900991,21.960235294127088
Task_11484,2231,800,146,156,302,2.7852684144818975,45.769531291083375
Task_11485,1084,192,66,35,101,5.616580310880829,23.611789246929106
Task_11486,1198,691,62,17,79,1.73121387283237,26.029259774198504
Task_11487,2849,651,169,57,226,4.369631901840491,54.10201128894531
Task_11488,2134,221,68,23,91,9.612612612612613,39.99174544427344
Task_11489,1590,87,44,199,243,18.068181818181817,32.29510881724499
Task_11490,2369,103,71,84,155,22.778846153846153,43.63279451725774
Task_11491,880,135,131,176,307,6.470588235294118,21.895757699484623
Task_11492,2228,309,32,108,140,7.187096774193549,43.07486816607946
Task_11493,2297,264,120,69,189,8.667924528301887,43.936351174745994
Task_11494,2657,615,113,178,291,4.313311688311688,51.916730773647565
Task_11495,1550,338,12,187,199,4.572271386430678,33.10121957795675
Task_11496,1111,776,108,16,124,1.4298584298584298,25.753787620975785
Task_11497,621,585,37,40,77,1.0597269624573378,16.78924713376067
Task_11498,1978,654,156,137,293,3.019847328244275,41.23512760484799
Task_11499,2750,561,85,173,258,4.893238434163701,53.10801995105137
Task_11500,1116,297,65,152,217,3.7449664429530203,26.25684891640059
Task_11501,2858,979,103,190,293,2.916326530612245,56.27320560509482
Task_11502,786,612,111,135,246,1.2822185970636215,21.918064309019133
Task_11503,2236,119,153,119,272,18.633333333333333,42.90527463365621
Task_11504,1069,424,182,49,231,2.5152941176470587,25.083931945797115
Task_11505,1141,205,93,186,279,5.538834951456311,26.658144711147454
Task_11506,2132,391,60,66,126,5.438775510204081,41.473363320140884
Task_11507,762,896,84,139,223,0.8494983277591973,22.33480170102999
Task_11508,637,869,132,160,292,0.732183908045977,20.627730044776534
Task_11509,2383,446,147,33,180,5.331096196868009,45.47512902541842
Task_11510,820,78,166,111,277,10.379746835443038,20.1528029263553
Task_11511,963,872,125,82,207,1.1030927835051547,24.998722544510446
Task_11512,1352,440,145,48,193,3.0657596371882088,29.376104077882673
Task_11513,787,854,14,95,109,0.92046783625731,21.655309024961245
Task_11514,2867,633,200,69,269,4.522082018927445,54.57079330525465
Task_11515,1757,447,106,178,284,3.921875,37.09817641677634
Task_11516,631,520,165,131,296,1.2111324376199617,19.365887837537944
Task_11517,1913,891,88,149,237,2.1446188340807173,40.73152024634242
Task_11518,2255,936,30,105,135,2.4066168623265742,45.496589925711895
Task_11519,1823,100,41,109,150,18.04950495049505,35.0659712779455
Task_11520,1429,309,122,22,144,4.609677419354838,29.620376083191772
Task_11521,2395,560,128,139,267,4.269162210338681,47.42689106371606
Task_11522,685,637,199,92,291,1.073667711598746,20.378373856560568
Task_11523,1939,886,137,107,244,2.186020293122886,41.07828505645539
Task_11524,1338,603,143,23,166,2.2152317880794703,29.331495244506197
Task_11525,748,881,193,170,363,0.8480725623582767,22.744250869147077
Task_11526,2306,760,130,76,206,3.0302233902759528,45.920985377705
Task_11527,2188,484,37,130,167,4.511340206185567,43.2751479700594
Task_11528,1264,718,97,170,267,1.7579972183588317,30.067253134271763
Task_11529,952,126,166,124,290,7.496062992125984,22.845962300309633
Task_11530,1661,639,48,27,75,2.5953125,33.40221694637375
Task_11531,1346,592,142,66,208,2.269814502529511,30.081072793823413
Task_11532,2493,1023,135,12,147,2.4345703125,48.68669849005761
Task_11533,1652,550,101,163,264,2.9981851179673322,35.65176824725105
Task_11534,1791,128,103,96,199,13.883720930232558,35.59007899324619
Task_11535,1979,308,80,51,131,6.4045307443365695,38.69504906526944
Task_11536,2277,161,20,144,164,14.055555555555555,43.18828501654846
Task_11537,2705,888,183,29,212,3.0427446569178853,52.30647189634001
Task_11538,742,695,128,124,252,1.0660919540229885,21.444934904530644
Task_11539,1028,736,180,115,295,1.3948439620081412,26.351656317751168
Task_11540,1754,996,97,101,198,1.7592778335005015,38.28282729393886
Task_11541,1946,368,183,67,250,5.273712737127371,39.07509238316791
Task_11542,955,947,12,116,128,1.0073839662447257,24.89980521039657
Task_11543,1923,525,146,176,322,3.655893536121673,40.14380492425423
Task_11544,1350,123,171,51,222,10.887096774193548,28.19942155035898
Task_11545,1352,429,51,35,86,3.144186046511628,28.274194675095227
Task_11546,2225,305,43,160,203,7.271241830065359,43.65468918020224
Task_11547,506,93,166,143,309,5.382978723404255,15.502964359822345
Task_11548,2441,274,78,31,109,8.876363636363637,45.30426739200774
Task_11549,2984,944,80,170,250,3.157671957671958,58.06464370826808
Task_11550,2749,265,164,155,319,10.334586466165414,52.29738400455968
Task_11551,818,583,113,151,264,1.4006849315068493,22.46289413602297
Task_11552,2929,141,191,164,355,20.62676056338028,54.45570041391793
Task_11553,1408,207,151,109,260,6.769230769230769,30.569817898902528
Task_11554,1439,441,173,17,190,3.255656108597285,30.492708848227924
Task_11555,2985,574,98,82,180,5.191304347826087,55.88309347220174
Task_11556,574,266,65,160,225,2.149812734082397,17.636786606924925
Task_11557,2982,382,103,102,205,7.785900783289817,55.801865375189415
Task_11558,1029,307,33,87,120,3.340909090909091,23.88573983156321
Task_11559,1810,386,62,36,98,4.677002583979328,35.369347700294114
Task_11560,1646,866,128,112,240,1.8985005767012688,36.36281220024542
Task_11561,1164,365,164,13,177,3.180327868852459,25.737874783302242
Task_11562,2619,393,165,128,293,6.647208121827411,50.53017224088503
Task_11563,794,747,102,12,114,1.0614973262032086,20.65108691304727
Task_11564,1271,214,20,34,54,5.911627906976745,25.930544082997855
Task_11565,765,946,185,154,339,0.8078141499472017,23.090464313749376
Task_11566,1221,704,22,132,154,1.7319148936170212,28.37329543881846
Task_11567,2657,829,93,158,251,3.2012048192771085,52.4947399133435
Task_11568,565,142,83,32,115,3.9510489510489513,14.861634596241075
Task_11569,2804,97,98,29,127,28.612244897959183,49.7065039536293
Task_11570,2957,431,45,89,134,6.844907407407407,54.87170132216167
Task_11571,1123,286,68,100,168,3.912891986062718,25.84303986608657
Task_11572,1909,380,46,20,66,5.010498687664042,36.22798673807728
Task_11573,2862,136,119,126,245,20.89051094890511,52.81618764855288
Task_11574,909,972,77,150,227,0.934224049331963,25.00645049541815
Task_11575,2522,537,161,151,312,4.687732342007435,49.584546757609225
Task_11576,2440,551,38,17,55,4.420289855072464,45.20965415590408
Task_11577,2124,998,168,47,215,2.126126126126126,43.44224022372337
Task_11578,2861,829,76,98,174,3.446987951807229,55.256784401211036
Task_11579,1977,845,20,181,201,2.3368794326241136,41.44773178487603
Task_11580,2139,874,188,192,380,2.4445714285714284,44.947425983933236
Task_11581,1486,215,95,140,235,6.87962962962963,31.83287896997706
Task_11582,2868,228,126,190,316,12.524017467248909,54.074576491131836
Task_11583,2735,153,161,15,176,17.75974025974026,49.57808370920929
Task_11584,1580,383,120,29,149,4.114583333333333,32.35360703277067
Task_11585,2907,708,101,150,251,4.100141043723554,55.95046761062298
Task_11586,2402,840,40,150,190,2.8561236623067776,48.09145709395426
Task_11587,896,567,116,133,249,1.5774647887323943,23.579859800786448
Task_11588,709,596,151,131,282,1.187604690117253,20.815348147676403
Task_11589,909,750,184,187,371,1.2103861517976031,24.903220292547857
Task_11590,543,174,129,115,244,3.1028571428571428,16.368475475934527
Task_11591,1601,316,58,121,179,5.0504731861198735,33.61893256578998
Task_11592,1254,385,126,46,172,3.2487046632124352,27.459045191019708
Task_11593,899,1005,99,200,299,0.8936381709741551,25.27790389894074
Task_11594,1438,646,58,13,71,2.2225656877897992,29.62584120532108
Task_11595,1443,758,94,106,200,1.901185770750988,32.70519225242864
Task_11596,1590,213,176,164,340,7.429906542056075,33.90608276150742
Task_11597,2193,103,166,168,334,21.08653846153846,42.23041014849901
Task_11598,975,721,109,143,252,1.350415512465374,25.34066529970639
Task_11599,669,144,68,79,147,4.613793103448276,17.427385345099378
Task_11600,1680,871,65,189,254,1.926605504587156,37.2183802858456
Task_11601,2437,654,143,164,307,3.7206106870229005,48.60778507467685
Task_11602,951,543,46,117,163,1.7481617647058822,23.855255766663234
Task_11603,2415,492,84,181,265,4.898580121703854,47.62497887531455
Task_11604,1934,866,69,51,120,2.2306805074971163,39.514428189386074
Task_11605,1314,709,146,135,281,1.8507042253521127,30.832786680106494
Task_11606,2646,107,150,126,276,24.5,49.040488235194225
Task_11607,2542,939,43,113,156,2.704255319148936,50.11104439099288
Task_11608,1069,314,98,34,132,3.3936507936507936,24.017230251333746
Task_11609,2696,882,88,126,214,3.0532276330690826,52.972708214294634
Task_11610,560,851,44,185,229,0.6572769953051644,19.188116633602395
Task_11611,2342,976,51,166,217,2.3971340839303994,47.90517253943177
Task_11612,1844,773,185,135,320,2.3824289405684755,39.604287568963606
Task_11613,666,817,163,71,234,0.8141809290953546,20.171580231697465
Task_11614,787,423,141,165,306,1.8561320754716981,21.750099880233638
Task_11615,2664,835,32,190,222,3.186602870813397,52.46832501334338
Task_11616,2242,895,195,180,375,2.502232142857143,46.60484167503296
Task_11617,1059,840,72,185,257,1.2592152199762188,27.178390801559363
Task_11618,2228,243,165,103,268,9.131147540983607,43.678080592569565
Task_11619,1720,834,196,200,396,2.059880239520958,38.267804100198425
Task_11620,957,480,146,195,341,1.9896049896049897,24.82169369368223
Task_11621,1435,599,50,124,174,2.3916666666666666,32.031137237321836
Task_11622,2629,590,109,160,269,4.44839255499154,51.26801888460329
Task_11623,2631,651,184,189,373,4.035276073619632,52.00509619681967
Task_11624,2305,112,64,188,252,20.398230088495577,43.77806589318451
Task_11625,1137,574,116,98,214,1.9773913043478262,27.254977895053614
Task_11626,2670,181,62,50,112,14.67032967032967,48.13301094536677
Task_11627,2994,137,172,78,250,21.695652173913043,54.5825932388046
Task_11628,1850,678,179,182,361,2.72459499263623,39.65559773737955
Task_11629,1860,644,31,126,157,2.883720930232558,38.43133066634277
Task_11630,2573,307,124,123,247,8.353896103896103,49.294471828667135
Task_11631,2487,748,36,72,108,3.3204272363150866,48.0244892707052
Task_11632,2910,546,166,27,193,5.319926873857404,54.31857000281237
Task_11633,2886,379,182,52,234,7.594736842105263,53.91801111231922
Task_11634,1938,784,168,40,208,2.4687898089171973,39.798959896708205
Task_11635,814,323,18,180,198,2.5123456790123457,21.369849473875718
Task_11636,2745,539,72,48,120,5.083333333333333,51.08020684984398
Task_11637,1367,671,19,73,92,2.0342261904761907,29.860712572099043
Task_11638,2320,681,159,118,277,3.401759530791789,46.63725425700195
Task_11639,2036,964,88,199,287,2.1098445595854924,43.206343644635275
Task_11640,1048,466,78,99,177,2.2441113490364026,25.273666266094576
Task_11641,1880,191,64,195,259,9.791666666666666,38.18475867625443
Task_11642,710,398,194,152,346,1.7794486215538847,20.60078770721898
Task_11643,2530,625,77,54,131,4.041533546325879,48.45442007938135
Task_11644,2063,908,93,156,249,2.2695269526952697,43.31793533305549
Task_11645,583,932,74,85,159,0.62486602357985,19.135247829307666
Task_11646,946,240,178,102,280,3.925311203319502,23.467362704843357
Task_11647,1161,950,107,150,257,1.220820189274448,28.94751747193938
Task_11648,2954,238,173,120,293,12.359832635983263,55.26583883231471
Task_11649,706,176,168,18,186,3.9887005649717513,17.69355515170382
Task_11650,1255,587,114,119,233,2.1343537414965987,29.277420722961637
Task_11651,1433,704,95,109,204,2.0326241134751775,32.38719103170549
Task_11652,2259,378,196,100,296,5.96042216358839,44.756731894875905
Task_11653,2234,582,98,118,216,3.8319039451114922,44.70079671850396
Task_11654,2393,707,69,75,144,3.3799435028248586,46.775415651383405
Task_11655,1634,605,166,32,198,2.6963696369636962,34.38066571118774
Task_11656,1027,622,140,100,240,1.6484751203852328,25.766269943873542
Task_11657,2478,918,114,104,218,2.6964091403699673,49.59711592068902
Task_11658,2113,146,22,141,163,14.374149659863946,40.349799214925135
Task_11659,2790,1016,98,97,195,2.743362831858407,54.778581676183684
Task_11660,2995,860,110,10,120,3.478513356562137,55.86038001893362
Task_11661,2918,329,151,184,335,8.842424242424242,55.313137824943034
Task_11662,2939,526,110,154,264,5.576850094876661,55.93955276751719
Task_11663,2945,263,69,36,105,11.155303030303031,53.072980398355305
Task_11664,1369,115,40,27,67,11.801724137931034,26.76972376347895
Task_11665,1492,212,101,97,198,7.004694835680751,31.65053731115474
Task_11666,1445,452,45,148,193,3.1898454746136866,31.721930863431478
Task_11667,2569,462,132,108,240,5.5485961123110155,49.698343190782566
Task_11668,1123,493,171,148,319,2.2732793522267207,27.322375505682288
Task_11669,752,835,27,89,116,0.8995215311004785,20.952182731343974
Task_11670,1068,492,47,92,139,2.1663286004056794,25.26105911556553
Task_11671,2112,342,153,72,225,6.1574344023323615,41.53403777774935
Task_11672,1842,457,32,55,87,4.021834061135372,36.428899486579915
Task_11673,1004,788,89,87,176,1.2724968314321927,25.118390643902657
Task_11674,1583,491,133,27,160,3.217479674796748,32.7102396854208
Task_11675,1484,103,152,176,328,14.26923076923077,31.075724885892072
Task_11676,2493,96,128,80,208,25.701030927835053,45.87014827402954
Task_11677,1411,587,139,152,291,2.3996598639455784,32.05762059235068
Task_11678,2323,395,99,152,251,5.866161616161616,45.70081386805773
Task_11679,2529,895,150,52,202,2.822544642857143,49.77283498021766
Task_11680,728,887,179,152,331,0.8198198198198198,22.266860821263737
Task_11681,638,268,106,171,277,2.3717472118959106,18.779826950148006
Task_11682,2268,169,83,171,254,13.341176470588236,43.82365873144531
Task_11683,1743,272,163,130,293,6.384615384615385,36.269322462541666
Task_11684,551,331,19,34,53,1.6596385542168675,14.948281790134105
Task_11685,2532,942,190,53,243,2.6850477200424177,50.15818276751951
Task_11686,1560,558,136,96,232,2.7906976744186047,34.00142023293468
Task_11687,1788,320,57,163,220,5.570093457943925,37.021628312823644
Task_11688,938,557,168,151,319,1.6810035842293907,24.584886981640967
Task_11689,919,112,184,70,254,8.132743362831858,21.322036682905217
Task_11690,2588,619,138,34,172,4.174193548387096,49.341719092879906
Task_11691,1582,901,161,161,322,1.753880266075388,35.885494216506885
Task_11692,1790,606,94,127,221,2.9489291598023066,37.85104437170411
Task_11693,1503,933,69,14,83,1.6092077087794432,32.14974181772251
Task_11694,2680,903,85,60,145,2.9646017699115044,51.665250243154986
Task_11695,1013,529,196,194,390,1.911320754716981,26.081318100074714
Task_11696,2288,590,136,97,233,3.8714043993231813,45.64689751333157
Task_11697,2449,597,61,49,110,4.095317725752508,46.38054053867646
Task_11698,1593,350,143,200,343,4.538461538461538,34.48682353422131
Task_11699,2535,599,135,61,196,4.225,48.805102752177
Task_11700,2994,544,82,190,272,5.493577981651376,57.04992077958687
Task_11701,1635,91,19,32,51,17.77173913043478,30.624733251477295
Task_11702,773,163,33,93,126,4.713414634146342,19.00642924944698
Task_11703,711,966,37,33,70,0.7352637021716649,19.520080634034024
Task_11704,1840,681,149,130,279,2.697947214076246,39.060809681981176
Task_11705,2187,957,84,42,126,2.2828810020876826,43.62243306910866
Task_11706,2623,142,19,61,80,18.342657342657343,47.36057632792885
Task_11707,1966,280,94,165,259,6.99644128113879,39.803547379572045
Task_11708,2795,838,100,196,296,3.33134684147795,54.8559971161564
Task_11709,1706,596,99,151,250,2.8576214405360134,36.57304065161789
Task_11710,1727,887,155,54,209,1.9448198198198199,37.03090772171737
Task_11711,604,111,28,144,172,5.392857142857143,16.455063880692688
Task_11712,2330,572,74,188,262,4.06631762652705,46.61702172937666
Task_11713,1888,228,175,76,251,8.244541484716157,37.77493682819797
Task_11714,1296,890,180,39,219,1.4545454545454546,29.968097745533644
Task_11715,854,400,134,131,265,2.1296758104738154,22.503233546887532
Task_11716,2565,859,103,150,253,2.9825581395348837,51.01639991422572
Task_11717,1386,728,25,29,54,1.9012345679012346,29.406166372793578
Task_11718,1752,295,130,195,325,5.918918918918919,36.72966410492853
Task_11719,992,882,106,159,265,1.1234428086070216,26.072554465480653
Task_11720,1124,241,137,148,285,4.644628099173554,26.372652944840315
Task_11721,1141,110,187,96,283,10.27927927927928,25.416919492238332
Task_11722,2221,967,90,163,253,2.294421487603306,45.97090421185144
Task_11723,1829,795,35,16,51,2.2977386934673367,36.39616010100634
Task_11724,1614,928,90,59,149,1.73735199138859,34.81926670221923
Task_11725,2539,354,19,122,141,7.152112676056338,48.108722748955564
Task_11726,1877,640,86,36,122,2.9282371294851792,37.659122796759895
Task_11727,589,137,54,166,220,4.268115942028985,17.08584183011945
Task_11728,2281,363,91,118,209,6.266483516483516,44.73829402575931
Task_11729,2568,108,149,157,306,23.559633027522935,48.016466984246904
Task_11730,1882,900,110,81,191,2.088790233074362,39.616596162873684
Task_11731,2466,82,69,72,141,29.710843373493976,44.76397764826739
Task_11732,1703,281,17,69,86,6.039007092198582,33.71208963724581
Task_11733,1413,758,73,140,213,1.8616600790513833,32.3815542796874
Task_11734,2366,80,111,174,285,29.209876543209877,44.545686233544075
Task_11735,893,499,76,81,157,1.786,22.434257701755254
Task_11736,1647,372,177,125,302,4.415549597855228,35.118275846426464
Task_11737,1612,224,188,27,215,7.164444444444444,32.80851633858051
Task_11738,2714,928,40,64,104,2.921420882669537,52.00891945110673
Task_11739,1324,720,73,145,218,1.8363384188626908,30.883164578927047
Task_11740,871,119,155,163,318,7.258333333333334,21.703509415196198
Task_11741,1699,975,18,46,64,1.7407786885245902,35.08307364053608
Task_11742,2075,984,103,42,145,2.1065989847715736,42.098375999179744
Task_11743,2036,189,84,116,200,10.715789473684211,40.22995721778593
Task_11744,2549,588,14,180,194,4.3276740237691005,49.72845043344349
Task_11745,997,1012,161,79,240,0.9842053307008884,26.17901571141854
Task_11746,877,822,91,47,138,1.065613608748481,22.467468991699395
Task_11747,1759,232,199,48,247,7.549356223175966,35.36535159717028
Task_11748,1592,538,163,70,233,2.953617810760668,33.943209285973076
Task_11749,970,364,93,20,113,2.6575342465753424,22.334132076639232
Task_11750,2768,230,107,92,199,11.982683982683982,51.73127904260007
Task_11751,2658,750,90,127,217,3.5392809587217045,52.00094014429772
Task_11752,2023,809,127,48,175,2.4975308641975307,41.013589541061
Task_11753,2284,134,16,44,60,16.918518518518518,41.22159723302287
Task_11754,2731,478,155,94,249,5.701461377870563,52.27940391042995
Task_11755,965,353,164,177,341,2.725988700564972,24.520035616536774
Task_11756,724,840,34,131,165,0.8608799048751486,21.13293756987812
Task_11757,504,738,118,179,297,0.6820027063599459,18.290010742281805
Task_11758,854,359,52,192,244,2.3722222222222222,22.537892011988347
Task_11759,1267,798,75,137,212,1.5857321652065082,30.154003283580153
Task_11760,2638,478,71,65,136,5.507306889352819,49.80284261261414
Task_11761,2071,524,124,85,209,3.9447619047619047,41.56639781563762
Task_11762,2465,1007,21,151,172,2.445436507936508,49.442640715246455
Task_11763,1783,758,71,33,104,2.3491436100131753,36.313551099843494
Task_11764,1312,67,96,51,147,19.294117647058822,26.258290542675706
Task_11765,981,370,130,144,274,2.6442048517520216,24.47706187400081
Task_11766,1585,595,54,157,211,2.6593959731543624,34.64412559536842
Task_11767,1611,658,24,158,182,2.4446130500758727,34.82952558575389
Task_11768,2356,536,45,108,153,4.387337057728119,45.82251473898251
Task_11769,2821,752,13,38,51,3.746347941567065,52.290673771684276
Task_11770,969,518,165,161,326,1.8670520231213872,25.013396424479414
Task_11771,2273,826,77,99,176,2.7484885126964933,45.820486683278325
Task_11772,1162,765,194,82,276,1.516971279373368,28.1769406866002
Task_11773,1565,1002,81,121,202,1.5603190428713858,35.40292297962057
Task_11774,672,1019,187,92,279,0.6588235294117647,21.54450537416963
Task_11775,2061,451,28,161,189,4.5597345132743365,41.48372077889997
Task_11776,2492,440,31,31,62,5.650793650793651,45.93946581555756
Task_11777,814,414,181,107,288,1.96144578313253,21.982908399906126
Task_11778,857,382,152,37,189,2.2375979112271542,21.31925663049921
Task_11779,512,717,196,163,359,0.713091922005571,18.578583713560807
Task_11780,772,421,38,173,211,1.8293838862559242,21.1024057308309
Task_11781,2354,278,103,33,136,8.437275985663083,44.19385012907552
Task_11782,864,869,128,55,183,0.993103448275862,23.082047819493823
Task_11783,1484,524,147,34,181,2.8266666666666667,31.497034047272138
Task_11784,1208,138,109,41,150,8.690647482014388,25.17910417913721
Task_11785,1231,637,191,155,346,1.9294670846394983,29.615782590241594
Task_11786,2700,685,65,41,106,3.935860058309038,50.500571954956115
Task_11787,2181,831,113,146,259,2.621394230769231,44.865848386618644
Task_11788,549,545,171,100,271,1.0054945054945055,17.963700797842815
Task_11789,2721,810,126,166,292,3.3551171393341552,53.53366035497436
Task_11790,965,757,125,41,166,1.2730870712401055,23.943964448661536
Task_11791,1626,785,35,158,193,2.068702290076336,35.67880635827675
Task_11792,2602,930,124,61,185,2.79484425349087,50.71537540908116
Task_11793,2872,498,108,63,171,5.755511022044089,53.552945281609134
Task_11794,2442,395,137,113,250,6.166666666666667,47.520385979004715
Task_11795,871,149,49,122,171,5.806666666666667,21.050584435919657
Task_11796,2363,599,79,102,181,3.9383333333333335,46.55096863977513
Task_11797,526,180,122,23,145,2.9060773480662982,14.755708601380613
Task_11798,2274,513,142,172,314,4.424124513618677,45.62071721544658
Task_11799,1004,555,118,107,225,1.8057553956834533,25.148977326075666
Task_11800,1337,668,105,148,253,1.9985052316890881,30.962069424492697
Task_11801,2487,952,58,37,95,2.6096537250786986,47.95192521964614
Task_11802,2519,986,148,147,295,2.552178318135765,50.86896767896011
Task_11803,1179,640,103,125,228,1.8393135725429017,28.225753334621654
Task_11804,2908,112,102,50,152,25.734513274336283,51.583502088441
Task_11805,2215,567,106,134,240,3.8996478873239435,44.46991763059852
Task_11806,2491,619,126,23,149,4.017741935483871,47.46126232732226
Task_11807,2796,99,41,87,128,27.96,50.28526069870603
Task_11808,2857,932,19,118,137,3.062165058949625,54.98717403299463
Task_11809,1258,815,110,149,259,1.5416666666666667,30.15397953217901
Task_11810,1657,613,181,125,306,2.698697068403909,36.06314237930689
Task_11811,2017,732,73,178,251,2.751705320600273,42.095666788529755
Task_11812,1378,602,184,122,306,2.285240464344942,31.60571113575053
Task_11813,1283,962,31,23,54,1.332294911734164,28.547491586479214
Task_11814,2043,392,180,108,288,5.198473282442748,41.361096349910135
Task_11815,1735,926,145,88,233,1.871628910463862,37.64086422632709
Task_11816,1665,412,118,31,149,4.031476997578692,33.78218884427201
Task_11817,892,162,135,78,213,5.47239263803681,21.46760864493453
Task_11818,865,232,70,39,109,3.7124463519313307,20.202045328557052
Task_11819,2718,719,188,55,243,3.775,52.390148827606055
Task_11820,1465,194,118,148,266,7.512820512820513,31.434560887577135
Task_11821,2633,681,188,145,333,3.8607038123167157,51.88705110605034
Task_11822,2877,131,188,15,203,21.795454545454547,51.950731035113044
Task_11823,2509,819,116,197,313,3.0597560975609754,50.34317311107577
Task_11824,2650,919,11,138,149,2.880434782608696,51.76097390387897
Task_11825,1848,154,55,111,166,11.92258064516129,36.43131692079846
Task_11826,629,180,159,153,312,3.4751381215469612,18.100728567816372
Task_11827,1854,651,108,123,231,2.8435582822085887,38.961732419121795
Task_11828,2672,325,29,137,166,8.196319018404909,50.448223660241865
Task_11829,2801,686,174,85,259,4.0771470160116445,53.867710800709865
Task_11830,2161,973,149,146,295,2.2186858316221767,45.153899353655284
Task_11831,2163,762,137,120,257,2.834862385321101,44.317625122198365
Task_11832,512,350,118,189,307,1.4586894586894588,17.14094261015799
Task_11833,1199,775,97,23,120,1.5451030927835052,27.218073681228365
Task_11834,1777,681,107,162,269,2.6055718475073313,38.06474752181402
Task_11835,1346,331,16,185,201,4.054216867469879,29.819170502612668
Task_11836,939,241,107,64,171,3.8801652892561984,22.13671998675456
Task_11837,1072,611,194,132,326,1.7516339869281046,26.879157225654684
Task_11838,956,714,154,150,304,1.337062937062937,25.26258357932083
Task_11839,1508,736,49,40,89,2.046132971506106,31.74025365448149
Task_11840,2223,351,182,57,239,6.315340909090909,43.27724333365265
Task_11841,2617,711,153,63,216,3.675561797752809,50.619777836262564
Task_11842,2559,335,146,37,183,7.616071428571429,47.91275005574841
Task_11843,807,828,75,60,135,0.9734620024125452,21.827922410346634
Task_11844,1088,257,25,174,199,4.217054263565892,25.55661063603586
Task_11845,1462,479,17,129,146,3.0458333333333334,31.477822331808266
Task_11846,2822,883,180,111,291,3.1923076923076925,55.27773887605927
Task_11847,530,410,131,106,237,1.289537712895377,17.15276715479523
Task_11848,2572,257,151,50,201,9.968992248062015,48.14830561303532
Task_11849,980,645,187,126,313,1.5170278637770898,25.431359012033923
Task_11850,1897,999,166,182,348,1.897,41.342800416652594
Task_11851,2131,664,59,30,89,3.2045112781954885,41.3044773699177
Task_11852,1082,81,94,154,248,13.195121951219512,24.296108796058565
Task_11853,585,371,186,182,368,1.5725806451612903,18.651999523987083
Task_11854,2343,398,85,20,105,5.87218045112782,43.82318887965325
Task_11855,2809,716,65,94,159,3.917712691771269,53.696680924588215
Task_11856,2775,810,65,100,165,3.4217016029593097,53.769668382188364
Task_11857,1633,991,38,10,48,1.6461693548387097,33.74216998736207
Task_11858,1347,823,76,65,141,1.6347087378640777,30.41855958677021
Task_11859,1861,358,48,93,141,5.183844011142061,37.497989236667784
Task_11860,606,987,59,58,117,0.6133603238866396,18.948785457793644
Task_11861,1404,786,93,62,155,1.7839898348157561,31.133215398571334
Task_11862,1125,101,136,48,184,11.029411764705882,23.890677089615433
Task_11863,1425,179,31,128,159,7.916666666666667,29.468101913945233
Task_11864,2141,399,151,179,330,5.3525,43.22812658134895
Task_11865,1743,175,79,182,261,9.903409090909092,35.59991190889424
Task_11866,732,883,153,152,305,0.8280542986425339,22.200696794863067
Task_11867,1289,148,187,72,259,8.651006711409396,27.72758399967026
Task_11868,1462,700,179,117,296,2.085592011412268,33.19031970244827
Task_11869,2851,409,175,106,281,6.953658536585366,54.16838285580479
Task_11870,1231,853,144,104,248,1.4414519906323184,29.702971997171787
Task_11871,1404,449,91,24,115,3.12,29.459964892540977
Task_11872,2816,652,197,155,352,4.312404287901991,54.79393229505198
Task_11873,1310,327,174,13,187,3.9939024390243905,28.116198918967232
Task_11874,2487,192,44,12,56,12.8860103626943,45.05677004303268
Task_11875,1822,304,57,197,254,5.973770491803279,37.70848073534859
Task_11876,2274,940,60,177,237,2.416578108395324,46.753808079070524
Task_11877,2832,663,166,126,292,4.265060240963855,54.76937677323451
Task_11878,1023,839,114,109,223,1.2178571428571427,26.203786330035843
Task_11879,1119,670,195,174,369,1.6676602086438153,28.06285183065417
Task_11880,2589,493,72,111,183,5.2408906882591095,49.80792482741319
Task_11881,1299,800,43,151,194,1.6217228464419475,30.50986787286661
Task_11882,2171,823,29,156,185,2.6347087378640777,44.27819407271411
Task_11883,590,546,130,67,197,1.0786106032906764,17.847835705273873
Task_11884,2519,1007,165,21,186,2.4990079365079363,49.34866720250841
Task_11885,2109,194,165,64,229,10.815384615384616,40.91394074736176
Task_11886,992,355,136,82,218,2.7865168539325844,23.976591262228055
Task_11887,2738,255,197,38,235,10.6953125,50.885673820871716
Task_11888,765,408,71,114,185,1.8704156479217604,20.731688807575463
Task_11889,1390,828,16,80,96,1.6767189384800965,30.778863276892963
Task_11890,2695,407,195,151,346,6.605392156862745,52.0520475776313
Task_11891,1337,391,150,45,195,3.4107142857142856,28.937833227472467
Task_11892,863,555,133,62,195,1.5521582733812949,22.20721110926861
Task_11893,1565,623,170,65,235,2.5080128205128207,33.78953960615234
Task_11894,2004,512,114,200,314,3.9064327485380117,41.38388924739222
Task_11895,1650,204,72,36,108,8.048780487804878,32.49082252678922
Task_11896,2099,620,11,179,190,3.3800322061191626,42.63228982748756
Task_11897,2381,837,154,21,175,2.841288782816229,46.64674684337649
Task_11898,2227,561,135,133,268,3.9626334519572954,44.765558586220855
Task_11899,516,485,90,185,275,1.0617283950617284,17.40990157915977
Task_11900,2834,251,22,156,178,11.246031746031745,52.74561857139478
Task_11901,2841,740,67,191,258,3.834008097165992,55.219997286694735
Task_11902,982,527,75,188,263,1.8598484848484849,25.139097680743898
Task_11903,2407,709,50,198,248,3.3901408450704227,48.279656316307005
Task_11904,1306,929,169,152,321,1.4043010752688172,31.526338749144173
Task_11905,691,507,82,179,261,1.360236220472441,20.349538424551813
Task_11906,792,977,182,11,193,0.8098159509202454,22.099284769338073
Task_11907,1188,532,141,27,168,2.2288930581613506,26.69530950637476
Task_11908,2783,796,111,65,176,3.491844416562108,53.17787597541284
Task_11909,2357,943,119,172,291,2.496822033898305,48.18644568487404
Task_11910,1554,922,81,137,218,1.6836403033586131,35.10679097278001
Task_11911,1163,676,84,58,142,1.7178729689807977,26.832595620367485
Task_11912,631,756,142,61,203,0.8335535006605019,19.183089034912925
Task_11913,2516,887,93,146,239,2.8333333333333335,50.37058054950333
Task_11914,563,319,154,13,167,1.759375,16.041274217525835
Task_11915,2146,344,52,138,190,6.220289855072464,42.591991609973135
Task_11916,2688,735,13,120,133,3.652173913043478,51.810554173465555
Task_11917,1203,393,71,186,257,3.053299492385787,28.174819323316637
Task_11918,2115,354,123,109,232,5.957746478873239,42.123465227466944
Task_11919,2126,148,194,52,246,14.268456375838927,40.88326044553019
Task_11920,2989,118,76,147,223,25.11764705882353,54.69661570960028
Task_11921,2597,1017,62,137,199,2.5510805500982316,51.882269750843875
Task_11922,2344,765,106,93,199,3.060052219321149,46.82814244818254
Task_11923,2299,853,154,182,336,2.6920374707259955,47.20401928769355
Task_11924,2753,366,88,43,131,7.501362397820164,50.79790637666022
Task_11925,928,101,174,105,279,9.098039215686274,22.027137195589187
Task_11926,1346,659,96,190,286,2.0393939393939395,31.339663768366346
Task_11927,2999,1010,36,64,100,2.9663699307616223,56.76575410978821
Task_11928,662,372,142,141,283,1.774798927613941,19.45941649060268
Task_11929,2635,464,170,171,341,5.666666666666667,51.297143401417806
Task_11930,738,90,114,148,262,8.10989010989011,18.99225756936544
Task_11931,2815,187,92,191,283,14.97340425531915,53.11946666255088
Task_11932,1341,702,118,151,269,1.9075391180654337,31.20802823393316
Task_11933,2696,957,14,162,176,2.81419624217119,52.958870223539726
Task_11934,1179,433,188,72,260,2.716589861751152,27.225857577955946
Task_11935,1940,297,131,10,141,6.510067114093959,37.54678699162643
Task_11936,2083,707,154,131,285,2.9420903954802258,43.020088992395245
Task_11937,1809,593,11,146,157,3.0454545454545454,37.460012684560375
Task_11938,531,152,160,50,210,3.4705882352941178,15.309942589644102
Task_11939,2014,586,33,65,98,3.431005110732538,39.82682602323651
Task_11940,1711,214,191,30,221,7.9581395348837205,34.42762555901849
Task_11941,2302,164,196,47,243,13.951515151515151,43.42423079168819
Task_11942,2186,581,66,84,150,3.7560137457044673,43.14845557556242
Task_11943,1021,313,176,162,338,3.251592356687898,25.241548452498847
Task_11944,1655,819,75,200,275,2.018292682926829,36.781950948701066
Task_11945,1949,854,182,54,236,2.27953216374269,40.567374771969824
Task_11946,1725,888,158,145,303,1.9403824521934758,38.015291187450835
Task_11947,511,252,181,159,340,2.0197628458498023,16.987944190632803
Task_11948,577,655,51,155,206,0.8795731707317073,18.70646347708941
Task_11949,1108,408,192,56,248,2.709046454767726,25.935409825480075
Task_11950,1423,911,62,177,239,1.5603070175438596,33.14877544664308
Task_11951,1185,503,101,198,299,2.3511904761904763,28.31854863816702
Task_11952,2674,238,99,109,208,11.188284518828452,50.445171910720354
Task_11953,2326,1015,38,47,85,2.2893700787401574,45.5360794056291
Task_11954,802,682,195,175,370,1.1742313323572475,23.016405206090266
Task_11955,1628,891,13,99,112,1.8251121076233183,35.27547449156481
Task_11956,981,146,23,150,173,6.673469387755102,22.818424696221786
Task_11957,2830,817,119,107,226,3.4596577017114916,54.89863021203016
Task_11958,2713,678,35,172,207,3.995581737849779,52.645852119551314
Task_11959,1217,115,70,98,168,10.491379310344827,26.191843734061177
Task_11960,787,529,38,66,104,1.4849056603773585,20.188145584332137
Task_11961,1565,650,102,20,122,2.403993855606759,32.54685940124212
Task_11962,660,119,75,193,268,5.5,18.34257167926772
Task_11963,2028,402,79,52,131,5.032258064516129,39.85094897979571
Task_11964,1989,271,37,157,194,7.3125,39.76725931093124
Task_11965,1196,974,18,88,106,1.2266666666666666,28.22432939994559
Task_11966,1865,110,35,100,135,16.8018018018018,35.62430042444202
Task_11967,706,656,47,88,135,1.0745814307458144,19.749079389808198
Task_11968,529,945,160,162,322,0.5591966173361522,19.358959453072583
Task_11969,1701,572,170,115,285,2.968586387434555,36.521454916336644
Task_11970,1743,370,75,41,116,4.69811320754717,34.667542815370105
Task_11971,2652,463,116,140,256,5.7155172413793105,51.134422444789074
Task_11972,2693,471,159,40,199,5.705508474576271,50.72121801254991
Task_11973,1017,181,137,197,334,5.587912087912088,24.411981931092612
Task_11974,1841,547,116,45,161,3.3594890510948905,36.97070983647575
Task_11975,2025,449,198,45,243,4.5,40.22898458713365
Task_11976,2433,840,102,164,266,2.8929845422116527,48.94460547791859
Task_11977,1852,508,14,196,210,3.638506876227898,38.53248154044855
Task_11978,1864,967,103,170,273,1.9256198347107438,40.36484367129557
Task_11979,2357,641,194,30,224,3.6713395638629285,46.06920152007434
Task_11980,529,104,193,87,280,5.038095238095238,15.585862862405842
Task_11981,2603,645,135,69,204,4.029411764705882,50.134724160391755
Task_11982,2860,706,145,106,251,4.045261669024045,55.13513096275627
Task_11983,1307,469,87,187,274,2.7808510638297874,30.022199421028564
Task_11984,686,567,34,186,220,1.2077464788732395,20.13648889226276
Task_11985,1526,792,14,76,90,1.9243379571248425,32.73396382726964
Task_11986,2215,258,102,23,125,8.552123552123552,41.75359652308004
Task_11987,1847,630,22,77,99,2.9270998415213945,37.31404260974598
Task_11988,1431,131,54,69,123,10.840909090909092,28.82503403320675
Task_11989,2073,520,125,163,288,3.978886756238004,42.33046126877768
Task_11990,2454,459,153,46,199,5.334782608695652,46.88769836542414
Task_11991,923,191,11,156,167,4.807291666666667,22.27436971042876
Task_11992,1386,425,160,132,292,3.2535211267605635,31.124576496645393
Task_11993,1058,418,193,195,388,2.5250596658711215,26.436558459695977
Task_11994,2084,805,144,104,248,2.5856079404466503,43.136616172728374
Task_11995,2841,166,124,83,207,17.01197604790419,52.212955935138694
Task_11996,1783,666,113,199,312,2.6731634182908546,38.36077056677886
Task_11997,2551,320,90,129,219,7.947040498442368,48.92373483015296
Task_11998,2938,324,123,17,140,9.04,53.31618877858818
Task_11999,971,987,189,166,355,0.9827935222672065,26.56255822677714
Task_12000,1317,600,91,176,267,2.1913477537437602,30.586052447729276
Task_12001,1673,176,200,80,280,9.451977401129943,34.063534218608304
Task_12002,2239,442,198,196,394,5.054176072234763,45.232991425583634
Task_12003,2493,395,135,85,220,6.295454545454546,47.87632392769718
Task_12004,2175,301,36,70,106,7.201986754966887,41.49882772725895
Task_12005,1214,210,115,142,257,5.753554502369668,27.552511199257157
Task_12006,1359,734,156,21,177,1.8489795918367347,30.029968406818536
Task_12007,2264,434,31,99,130,5.204597701149425,44.05045480899179
Task_12008,2341,978,174,108,282,2.3912155260469867,47.90756312118149
Task_12009,2683,379,53,91,144,7.060526315789474,50.55543151689046
Task_12010,2022,817,55,118,173,2.471882640586797,41.96140752066537
Task_12011,575,201,18,171,189,2.8465346534653464,17.117560474724435
Task_12012,522,413,98,52,150,1.2608695652173914,15.92128658508588
Task_12013,2265,518,53,125,178,4.364161849710983,44.80046525074214
Task_12014,1858,575,148,36,184,3.2256944444444446,37.59210087691857
Task_12015,824,798,82,157,239,1.0312891113892366,23.09101664224886
Task_12016,1319,446,14,109,123,2.9507829977628637,29.125952352383084
Task_12017,800,582,36,188,224,1.3722126929674099,22.005370953541302
Task_12018,2628,946,124,129,253,2.775079197465681,52.25580007317412
Task_12019,1909,226,43,131,174,8.409691629955947,38.142625673586494
Task_12020,1942,941,142,194,336,2.061571125265393,41.83916491378227
Task_12021,725,439,74,110,184,1.6477272727272727,20.13320512486892
Task_12022,2983,644,34,48,82,4.6248062015503875,54.83121532561659
Task_12023,1372,154,187,138,325,8.851612903225806,29.82927450361768
Task_12024,618,397,119,146,265,1.5527638190954773,18.73874407187908
Task_12025,1596,997,51,188,239,1.5991983967935872,36.2666706791989
Task_12026,1576,519,82,100,182,3.0307692307692307,33.79442356569332
Task_12027,1554,307,125,59,184,5.045454545454546,32.090697006939905
Task_12028,2994,993,187,179,366,3.0120724346076457,58.78498221326066
Task_12029,2159,69,136,178,314,30.84285714285714,41.34507549132663
Task_12030,2442,178,177,119,296,13.64245810055866,46.56274715139651
Task_12031,2340,505,194,167,361,4.624505928853755,46.84440444426733
Task_12032,1677,87,140,103,243,19.056818181818183,33.481147122890654
Task_12033,577,555,148,128,276,1.0377697841726619,18.520183246974494
Task_12034,872,550,11,50,61,1.5825771324863884,20.719966684062566
Task_12035,2741,491,104,151,255,5.571138211382114,52.64621231695694
Task_12036,2712,367,101,135,236,7.369565217391305,51.66743409004425
Task_12037,753,625,60,183,243,1.2028753993610224,21.62293119275012
Task_12038,1802,864,60,14,74,2.083236994219653,36.071224704698295
Task_12039,2369,250,22,71,93,9.43824701195219,44.324838207417145
Task_12040,1641,467,154,105,259,3.5064102564102564,35.106457549602396
Task_12041,1399,508,124,189,313,2.74852652259332,31.772209043932715
Task_12042,1364,852,180,184,364,1.5990621336459554,32.502163626197834
Task_12043,2573,543,40,104,144,4.729779411764706,49.30007899663551
Task_12044,2956,85,19,64,83,34.372093023255815,51.928765558993526
Task_12045,766,484,23,17,40,1.579381443298969,18.366514187552717
Task_12046,1131,294,59,47,106,3.833898305084746,24.389141073598157
Task_12047,810,560,45,180,225,1.4438502673796791,22.093091094227887
Task_12048,561,718,97,82,179,0.780250347705146,17.92534041347416
Task_12049,1195,569,27,67,94,2.0964912280701755,26.780517271924328
Task_12050,777,413,165,160,325,1.8768115942028984,21.63869700741957
Task_12051,2971,92,16,38,54,31.946236559139784,51.646146536342115
Task_12052,589,474,173,57,230,1.24,17.73292299678383
Task_12053,1381,864,142,197,339,1.5965317919075144,32.71515580915547
Task_12054,1063,688,109,143,252,1.5428156748911466,26.6297959398326
Task_12055,2259,894,136,105,241,2.524022346368715,46.15720097037822
Task_12056,1664,814,76,120,196,2.041717791411043,36.437778921883165
Task_12057,549,696,99,63,162,0.787661406025825,17.351445944510072
Task_12058,2966,263,101,182,283,11.234848484848484,55.59660535719689
Task_12059,1874,952,180,108,288,1.9664218258132213,40.45341777629462
Task_12060,1464,831,49,148,197,1.7596153846153846,33.37667130723498
Task_12061,2414,985,123,52,175,2.4482758620689653,48.03839936450331
Task_12062,2331,397,38,44,82,5.85678391959799,43.63219938873751
Task_12063,2549,801,45,189,234,3.178304239401496,50.55283103596241
Task_12064,2183,352,128,75,203,6.18413597733711,42.64763772739697
Task_12065,595,546,162,145,307,1.0877513711151736,18.92553781855342
Task_12066,835,367,121,20,141,2.2690217391304346,20.24258727641094
Task_12067,2201,906,170,98,268,2.426681367144432,45.390319249018034
Task_12068,1224,734,25,112,137,1.6653061224489796,28.54695141352724
Task_12069,917,685,24,21,45,1.336734693877551,21.64329149220931
Task_12070,2714,82,74,126,200,32.69879518072289,49.70362377437576
Task_12071,1280,362,25,61,86,3.5261707988980717,27.164015520699724
Task_12072,2256,163,148,161,309,13.75609756097561,43.783450129946935
Task_12073,2229,137,167,189,356,16.152173913043477,43.44536725480392
Task_12074,2953,666,127,48,175,4.427286356821589,55.295797652682666
Task_12075,1050,871,38,47,85,1.2041284403669725,24.981324780877966
Task_12076,2925,650,177,80,257,4.493087557603687,55.69063508590114
Task_12077,1156,828,171,135,306,1.3944511459589868,28.743932935866187
Task_12078,1455,909,12,129,141,1.598901098901099,32.740704947640424
Task_12079,853,239,130,122,252,3.5541666666666667,21.898013057841695
Task_12080,1892,242,20,138,158,7.7860082304526745,37.588250348432396
Task_12081,2474,528,194,20,214,4.676748582230624,47.30842700483961
Task_12082,1372,427,163,44,207,3.205607476635514,29.68992461891105
Task_12083,1673,742,139,100,239,2.2516823687752354,36.38209476729551
Task_12084,1471,132,168,120,288,11.06015037593985,31.011584679601025
Task_12085,2962,834,46,188,234,3.547305389221557,57.2325178573744
Task_12086,1098,501,187,32,219,2.187250996015936,25.661038929729386
Task_12087,1982,691,175,154,329,2.8641618497109826,41.60199560522131
Task_12088,1013,189,36,194,230,5.331578947368421,24.290786828519405
Task_12089,2955,476,143,112,255,6.19496855345912,55.92772211239094
Task_12090,626,449,189,44,233,1.3911111111111112,18.06535427669716
Task_12091,688,574,31,166,197,1.1965217391304348,20.067184487732366
Task_12092,2371,858,194,100,294,2.760186263096624,48.050942609705665
Task_12093,961,812,53,94,147,1.1820418204182042,24.62719698373729
Task_12094,1769,916,71,53,124,1.9291166848418757,37.19661129692828
Task_12095,728,140,152,141,293,5.163120567375887,19.472316161160926
Task_12096,2536,992,71,124,195,2.553877139979859,50.7996187683619
Task_12097,516,103,150,138,288,4.961538461538462,15.631120009132623
Task_12098,2925,213,102,112,214,13.66822429906542,54.340547092512715
Task_12099,550,361,21,62,83,1.5193370165745856,15.622981556847842
Task_12100,2304,376,42,33,75,6.111405835543766,42.712717881665846
Task_12101,2202,134,144,119,263,16.31111111111111,42.41586816704691
Task_12102,2910,460,154,151,305,6.31236442516269,55.44536545336532
Task_12103,2053,341,77,59,136,6.002923976608187,39.95523602776807
Task_12104,1052,397,58,31,89,2.64321608040201,23.370775477596652
Task_12105,2458,815,24,51,75,3.0122549019607843,46.8178024791542
Task_12106,2038,619,101,178,279,3.2870967741935484,42.07204895359042
Task_12107,2278,505,89,131,220,4.5019762845849804,45.21437476760726
Task_12108,1507,305,67,35,102,4.92483660130719,30.482985190571128
Task_12109,2132,986,178,132,310,2.160081053698075,44.78186571887212
Task_12110,2447,134,178,84,262,18.125925925925927,46.00604255204295
Task_12111,2336,1009,153,24,177,2.3128712871287127,46.41641939511637
Task_12112,2055,201,161,176,337,10.173267326732674,41.20624325425006
Task_12113,1399,212,44,37,81,6.568075117370892,28.37769838810914
Task_12114,874,752,115,99,214,1.1606905710491369,23.544709164726942
Task_12115,931,465,64,48,112,1.997854077253219,21.912201058927497
Task_12116,2983,967,185,178,363,3.081611570247934,58.51444848727192
Task_12117,1479,393,164,140,304,3.753807106598985,32.55933565681139
Task_12118,888,965,88,12,100,0.9192546583850931,22.802384195006656
Task_12119,930,249,16,82,98,3.72,21.69859160845216
Task_12120,1734,613,80,54,134,2.824104234527687,35.82258224725538
Task_12121,2292,917,42,182,224,2.496732026143791,46.80173090449595
Task_12122,2747,724,136,187,323,3.788965517241379,53.845277344339955
Task_12123,1347,278,188,42,230,4.827956989247312,28.921469098141596
Task_12124,1007,543,38,187,225,1.8511029411764706,25.288639655460923
Task_12125,1493,263,107,173,280,5.65530303030303,32.291874957140486
Task_12126,2897,226,69,181,250,12.762114537444933,54.33553351937149
Task_12127,708,894,157,71,228,0.7910614525139665,21.074035851884332
Task_12128,2342,451,136,110,246,5.18141592920354,46.09941939776135
Task_12129,1526,898,49,109,158,1.6974416017797553,34.01275903563951
Task_12130,1333,136,130,24,154,9.72992700729927,27.145144822199807
Task_12131,1628,796,150,121,271,2.042659974905897,36.012644386531406
Task_12132,1474,1002,49,117,166,1.469591226321037,33.66996968828545
Task_12133,2587,347,61,139,200,7.433908045977011,49.593662526130686
Task_12134,1261,472,154,12,166,2.6659619450317127,27.61443451103477
Task_12135,2614,102,198,32,230,25.37864077669903,47.7081025810674
Task_12136,629,478,144,51,195,1.313152400835073,18.284784620061362
Task_12137,706,805,110,70,180,0.8759305210918115,20.337799498462182
Task_12138,1827,324,165,151,316,5.621538461538462,37.90817858709822
Task_12139,1880,602,58,192,250,3.1177446102819237,39.560479069430876
Task_12140,1544,81,179,22,201,18.829268292682926,30.324235447679957
Task_12141,1325,82,103,115,218,15.963855421686747,27.858782432508118
Task_12142,842,73,96,76,172,11.378378378378379,19.470566729961003
Task_12143,1716,355,30,175,205,4.820224719101123,35.831222263384475
Task_12144,1839,247,33,137,170,7.415322580645161,37.01821122567413
Task_12145,2523,744,13,139,152,3.386577181208054,49.23068923672391
Task_12146,777,473,176,165,341,1.639240506329114,21.89297982059611
Task_12147,701,400,180,125,305,1.7481296758104738,20.24029773276003
Task_12148,1106,833,32,71,103,1.3261390887290168,26.30121673170117
Task_12149,829,708,52,13,65,1.1692524682651622,20.321861359535188
Task_12150,2442,932,35,148,183,2.617363344051447,48.82784583379953
Task_12151,2269,409,52,94,146,5.534146341463415,44.197326055993074
Task_12152,1766,1010,32,165,197,1.7467853610286845,38.62167529315064
Task_12153,1267,305,137,84,221,4.140522875816994,28.169812398620916
Task_12154,2125,172,179,192,371,12.283236994219653,42.0105619065849
Task_12155,1947,926,135,79,214,2.100323624595469,40.860471155022964
Task_12156,1079,106,55,131,186,10.08411214953271,23.924468618730838
Task_12157,2033,949,193,183,376,2.14,43.47020361629806
Task_12158,1624,693,87,93,180,2.3400576368876083,34.92666959707229
Task_12159,1777,1009,80,103,183,1.7594059405940594,38.54017169652203
Task_12160,1895,275,182,183,365,6.865942028985507,39.08431329849293
Task_12161,2982,993,74,44,118,3.0,56.21836345329862
Task_12162,1926,481,42,96,138,3.995850622406639,38.849911424752094
Task_12163,1717,228,90,15,105,7.497816593886463,33.44039810690746
Task_12164,990,370,114,150,264,2.6684636118598384,24.583169605472232
Task_12165,826,699,19,45,64,1.18,20.471439892328235
Task_12166,2473,211,176,91,267,11.665094339622641,47.25792734569723
Task_12167,1556,667,31,121,152,2.3293413173652695,33.6231246820742
Task_12168,2591,225,75,124,199,11.464601769911505,49.20002503407836
Task_12169,2718,542,98,23,121,5.005524861878453,50.582503959843216
Task_12170,1771,185,79,125,204,9.521505376344086,35.975602942237174
Task_12171,620,960,80,97,177,0.6451612903225806,20.14444547652246
Task_12172,912,636,33,97,130,1.4317111459968603,23.26673700856398
Task_12173,1086,95,143,53,196,11.3125,23.59030713153741
Task_12174,1288,535,55,155,210,2.4029850746268657,29.74452722094598
Task_12175,1314,694,156,46,202,1.8906474820143886,29.594612386463876
Task_12176,1862,83,164,73,237,22.166666666666668,35.88255832888419
Task_12177,1453,582,144,170,314,2.4922813036020584,32.83707028495019
Task_12178,886,166,168,124,292,5.3053892215568865,22.03272378561897
Task_12179,1281,492,41,51,92,2.5983772819472617,27.75545051554627
Task_12180,2685,564,178,148,326,4.752212389380531,52.31090137358748
Task_12181,1070,559,61,44,105,1.9107142857142858,24.180728466098476
Task_12182,2731,302,26,195,221,9.013201320132014,51.804352644301474
Task_12183,2718,452,147,98,245,6.0,52.03520289190692
Task_12184,2200,275,171,159,330,7.971014492753623,43.71213107308267
Task_12185,2602,627,50,147,197,4.143312101910828,50.80423180006508
Task_12186,1941,818,117,139,256,2.36996336996337,40.99897857790207
Task_12187,1110,644,49,14,63,1.7209302325581395,24.486251744964502
Task_12188,2968,341,117,47,164,8.678362573099415,54.388572312144426
Task_12189,699,963,31,146,177,0.725103734439834,21.23323630665254
Task_12190,902,804,172,42,214,1.1204968944099378,23.407498735706437
Task_12191,1975,481,119,122,241,4.097510373443983,40.38216603000144
Task_12192,2958,726,196,178,374,4.068775790921595,57.41073499172251
Task_12193,689,989,189,181,370,0.695959595959596,22.30651585322674
Task_12194,526,1023,122,130,252,0.513671875,19.25006657562838
Task_12195,2816,349,126,27,153,8.045714285714286,51.69894920652143
Task_12196,606,175,17,67,84,3.4431818181818183,15.721148968077294
Task_12197,2227,350,179,62,241,6.344729344729345,43.36069642026471
Task_12198,2866,464,85,99,184,6.163440860215053,53.99635580112106
Task_12199,1417,916,21,28,49,1.5452562704471102,30.39008416480894
Task_12200,826,966,79,117,196,0.8541882109617374,23.499416508345192
Task_12201,2131,885,55,178,233,2.405191873589165,44.33058942534253
Task_12202,850,96,152,34,186,8.762886597938145,19.389772031630134
Task_12203,2678,943,108,164,272,2.836864406779661,53.17568032186163
Task_12204,824,146,73,99,172,5.605442176870748,20.339082017159573
Task_12205,1761,265,126,187,313,6.620300751879699,36.70331111611174
Task_12206,2117,938,109,124,233,2.2545260915867944,44.03604501202336
Task_12207,2586,991,104,148,252,2.6068548387096775,51.753951763938666
Task_12208,854,626,103,83,186,1.3620414673046253,22.275721871166468
Task_12209,642,168,24,160,184,3.798816568047337,17.627635927724967
Task_12210,2611,388,120,102,222,6.712082262210797,50.0287563850243
Task_12211,1576,680,124,84,208,2.31424375917768,34.1948586689645
Task_12212,1204,331,195,194,389,3.6265060240963853,28.470659887809813
Task_12213,1699,406,157,129,286,4.174447174447175,35.985251321425956
Task_12214,1992,65,195,64,259,30.181818181818183,37.959416807989335
Task_12215,824,996,55,75,130,0.8264794383149449,22.838892694024945
Task_12216,551,139,19,112,131,3.9357142857142855,15.31762411254933
Task_12217,2301,478,106,51,157,4.803757828810021,44.29483098564987
Task_12218,1539,142,121,107,228,10.762237762237762,31.934171408037198
Task_12219,1270,274,178,102,280,4.618181818181818,28.70055672448382
Task_12220,2021,732,152,12,164,2.757162346521146,40.52586898619613
Task_12221,1511,119,119,90,209,12.591666666666667,31.078340700122343
Task_12222,1506,64,88,152,240,23.16923076923077,30.764457757229405
Task_12223,1371,885,114,137,251,1.5474040632054176,32.10801549376769
Task_12224,2043,597,15,33,48,3.4163879598662206,39.29677072030705
Task_12225,2700,998,200,46,246,2.7027027027027026,52.700872041830685
Task_12226,1188,897,109,46,155,1.3229398663697105,27.731209446680307
Task_12227,930,123,130,130,260,7.5,22.345865319567526
Task_12228,862,153,68,103,171,5.597402597402597,20.8735186327344
Task_12229,1925,328,153,49,202,5.851063829787234,38.18399826812166
Task_12230,1150,402,133,155,288,2.8535980148883375,27.332211276714343
Task_12231,1958,699,162,77,239,2.797142857142857,40.36981378138552
Task_12232,2299,721,165,157,322,3.1842105263157894,46.69056663135632
Task_12233,1264,452,57,40,97,2.7902869757174393,26.99485231623748
Task_12234,851,231,170,39,209,3.668103448275862,20.80416633431518
Task_12235,1430,342,101,129,230,4.169096209912537,31.26902634708127
Task_12236,1587,69,62,112,174,22.67142857142857,31.715216437110985
Task_12237,2477,946,134,74,208,2.6156282998944036,49.22267561314636
Task_12238,1122,564,137,102,239,1.9858407079646017,27.101397435669288
Task_12239,1913,201,175,55,230,9.470297029702971,37.879280794883506
Task_12240,1430,201,192,45,237,7.079207920792079,29.960276682343416
Task_12241,2678,232,110,135,245,11.493562231759658,50.68854939953841
Task_12242,2225,917,43,171,214,2.423747276688453,45.67887872252111
Task_12243,2383,909,147,115,262,2.6186813186813187,48.278133258884395
Task_12244,2579,480,99,169,268,5.361746361746362,50.132577623476834
Task_12245,2440,744,120,168,288,3.2751677852348995,48.85940502936692
Task_12246,1992,200,15,192,207,9.91044776119403,39.687902422577295
Task_12247,2763,751,93,81,174,3.6742021276595747,53.05648787745957
Task_12248,1551,245,31,43,74,6.304878048780488,30.427520564398236
Task_12249,2945,256,95,64,159,11.459143968871595,53.81010214999238
Task_12250,2219,941,40,149,189,2.3556263269639066,45.485574951639705
Task_12251,1943,80,33,167,200,23.987654320987655,37.5777691769466
Task_12252,1837,241,171,185,356,7.590909090909091,38.01066167765989
Task_12253,2646,128,33,32,65,20.511627906976745,46.95292685893343
Task_12254,2824,904,137,164,301,3.1204419889502764,55.497943304166334
Task_12255,2853,528,34,117,151,5.393194706994329,53.720324487118944
Task_12256,1195,140,17,143,160,8.47517730496454,25.651617812151816
Task_12257,2573,439,159,153,312,5.847727272727273,50.07682385648146
Task_12258,1987,614,185,44,229,3.2308943089430895,40.119392972825494
Task_12259,1848,288,35,163,198,6.3944636678200695,37.63360901355684
Task_12260,1367,160,43,178,221,8.490683229813664,29.425757398720705
Task_12261,673,560,179,134,313,1.1996434937611409,20.277499958469107
Task_12262,1726,129,137,27,164,13.276923076923078,33.584155933536444
Task_12263,951,470,53,162,215,2.0191082802547773,24.248831770174093
Task_12264,2827,1019,109,149,258,2.7715686274509803,55.68890697746298
Task_12265,1903,499,17,180,197,3.806,39.12448674564632
Task_12266,2147,492,138,17,155,4.354969574036511,41.42122500601863
Task_12267,2732,296,189,128,317,9.198653198653199,52.09234668839565
Task_12268,902,792,83,33,116,1.1374527112232031,22.666903473007864
Task_12269,1914,1004,121,143,264,1.9044776119402984,41.191963338284204
Task_12270,1347,676,136,200,336,1.9896602658788773,31.595753131871106
Task_12271,1373,417,197,174,371,3.284688995215311,31.310892269986812
Task_12272,883,504,123,59,182,1.7485148514851485,22.085527739303767
Task_12273,1046,259,94,163,257,4.023076923076923,25.180081142312037
Task_12274,1672,790,166,81,247,2.11378002528445,36.20108503043338
Task_12275,2177,979,102,115,217,2.2214285714285715,45.0291190730298
Task_12276,929,715,80,90,170,1.297486033519553,23.834689585145615
Task_12277,1518,891,30,130,160,1.701793721973094,33.78893725378368
Task_12278,1819,839,152,10,162,2.1654761904761903,37.491355522815674
Task_12279,595,959,161,144,305,0.6197916666666666,20.454814527423924
Task_12280,2916,1013,89,13,102,2.8757396449704142,54.93621781527251
Task_12281,1962,300,11,49,60,6.51827242524917,37.14650831131593
Task_12282,2998,898,193,196,389,3.3348164627363737,58.6797684728156
Task_12283,517,561,98,94,192,0.9199288256227758,17.171323007529708
Task_12284,2537,977,128,76,204,2.594069529652352,50.25050775000233
Task_12285,2238,818,120,172,292,2.7326007326007327,45.91514143763718
Task_12286,1129,815,142,123,265,1.383578431372549,28.073448119300995
Task_12287,2892,440,58,185,243,6.557823129251701,55.01941114646817
Task_12288,1270,303,188,125,313,4.177631578947368,28.979129429721457
Task_12289,2670,985,40,113,153,2.707910750507099,52.23219946216734
Task_12290,799,708,103,16,119,1.1269393511988717,20.504094760103957
Task_12291,1926,484,29,51,80,3.971134020618557,37.67929630557002
Task_12292,1572,842,132,136,268,1.8647686832740213,35.27706717267476
Task_12293,621,947,195,105,300,0.6550632911392406,20.696489338086067
Task_12294,2944,133,140,151,291,21.970149253731343,54.266977334510834
Task_12295,2455,180,84,44,128,13.56353591160221,45.095270049892044
Task_12296,2854,528,138,197,335,5.395085066162571,54.983265169110815
Task_12297,1072,68,141,97,238,15.53623188405797,23.917460402981273
Task_12298,1979,920,59,144,203,2.1487513572204127,41.8420510723722
Task_12299,705,688,75,39,114,1.02322206095791,19.248552642264364
Task_12300,2136,881,14,93,107,2.421768707482993,43.164655017930535
Task_12301,1598,282,121,193,314,5.646643109540636,34.19859386803266
Task_12302,1870,128,46,46,92,14.496124031007753,35.02971922558651
Task_12303,2032,115,15,194,209,17.517241379310345,39.42611825383599
Task_12304,1957,500,31,31,62,3.906187624750499,37.66487669313918
Task_12305,924,258,130,173,303,3.5675675675675675,23.387113359758786
Task_12306,1832,422,114,103,217,4.33096926713948,37.792641638960426
Task_12307,2887,557,149,75,224,5.173835125448028,54.55604842421078
Task_12308,1866,940,80,113,193,1.9829968119022316,39.99579826653593
Task_12309,1449,226,72,60,132,6.383259911894273,30.019455115301643
Task_12310,1162,218,174,32,206,5.30593607305936,25.69821450622636
Task_12311,568,444,77,161,238,1.2764044943820225,18.063599117700182
Task_12312,1145,799,127,121,248,1.43125,28.197781074719895
Task_12313,2423,319,48,80,128,7.571875,46.25313406554636
Task_12314,1411,370,168,95,263,3.803234501347709,31.13026351881217
Task_12315,539,373,23,63,86,1.4411764705882353,15.6314605575734
Task_12316,1549,331,199,69,268,4.6656626506024095,32.72811083420762
Task_12317,1651,518,180,26,206,3.1811175337186897,34.365232056024354
Task_12318,2866,504,66,75,141,5.675247524752475,53.596650999830224
Task_12319,2336,222,140,68,208,10.475336322869955,44.54312322907018
Task_12320,2721,256,49,35,84,10.587548638132295,49.3554638398933
Task_12321,2430,598,30,109,139,4.056761268781302,47.195397614688666
Task_12322,1075,443,153,18,171,2.421171171171171,24.41534880179991
Task_12323,1361,597,166,94,260,2.2759197324414715,31.016893811802632
Task_12324,1563,900,109,196,305,1.734739178690344,35.55601379153354
Task_12325,1091,146,182,23,205,7.421768707482993,23.981913296587635
Task_12326,2895,896,124,51,175,3.2274247491638794,55.3267578162004
Task_12327,2593,412,52,31,83,6.278450363196126,47.835598179349375
Task_12328,743,276,104,89,193,2.6823104693140793,19.776869107960273
Task_12329,1822,483,19,149,168,3.7644628099173554,37.47301239153541
Task_12330,2739,940,152,149,301,2.9107332624867164,54.24163655559156
Task_12331,1006,105,67,165,232,9.49056603773585,23.181509294841934
Task_12332,2605,525,151,111,262,4.952471482889734,50.57609418206763
Task_12333,1677,203,94,109,203,8.220588235294118,34.62863810388916
Task_12334,1072,583,190,51,241,1.8356164383561644,25.83690076122844
Task_12335,2221,559,118,114,232,3.9660714285714285,44.474070483986544
Task_12336,1124,630,138,187,325,1.7812995245641838,27.83810490090509
Task_12337,2458,778,127,161,288,3.155327342747112,49.241125212722615
Task_12338,802,683,149,51,200,1.172514619883041,21.711982282580834
Task_12339,680,740,10,200,210,0.9176788124156545,20.515697433877218
Task_12340,765,333,167,18,185,2.2904191616766467,19.295604302060145
Task_12341,2315,120,62,100,162,19.132231404958677,43.32650039645449
Task_12342,1092,807,153,51,204,1.3514851485148516,26.693178532399557
Task_12343,1388,800,165,177,342,1.7328339575530587,32.61142468847763
Task_12344,2285,147,28,154,182,15.43918918918919,43.30645605694869
Task_12345,1303,574,171,191,362,2.266086956521739,30.683735371818603
Task_12346,1784,71,94,49,143,24.77777777777778,33.48661072374772
Task_12347,2479,196,22,174,196,12.583756345177665,47.164549360121775
Task_12348,1900,250,92,184,276,7.569721115537849,38.75351344762213
Task_12349,1259,714,72,64,136,1.760839160839161,28.688462166137498
Task_12350,2929,781,148,66,214,3.7455242966751916,55.77690626622151
Task_12351,2194,889,31,11,42,2.465168539325843,42.277999728747794
Task_12352,1368,529,15,154,169,2.581132075471698,30.505210115326037
Task_12353,1654,107,188,87,275,15.314814814814815,33.25101201136247
Task_12354,2634,91,192,189,381,28.630434782608695,49.34450510916454
Task_12355,2485,827,107,117,224,3.001207729468599,49.469591046301254
Task_12356,2832,440,89,99,188,6.421768707482993,53.528982344730736
Task_12357,1868,125,61,190,251,14.825396825396826,37.24497554683277
Task_12358,2696,1010,36,91,127,2.6666666666666665,52.61392276611961
Task_12359,2848,303,193,139,332,9.368421052631579,54.035014273192246
Task_12360,1052,429,70,51,121,2.4465116279069767,24.235616451278243
Task_12361,1506,559,80,76,156,2.6892857142857145,32.23000301915143
Task_12362,2755,137,63,110,173,19.963768115942027,50.755949386627385
Task_12363,1619,918,38,95,133,1.7616974972796517,35.39363988009013
Task_12364,1854,251,154,34,188,7.357142857142857,36.62512013074044
Task_12365,1705,574,49,154,203,2.965217391304348,36.439495364504054
Task_12366,2430,191,63,67,130,12.65625,45.65446450492423
Task_12367,814,433,197,154,351,1.8755760368663594,22.395536047054122
Task_12368,1885,227,123,89,212,8.267543859649123,37.74112251096403
Task_12369,1548,994,124,156,280,1.5557788944723618,35.409373581942674
Task_12370,2184,803,25,50,75,2.716417910447761,42.27055556497876
Task_12371,1745,1019,119,43,162,1.7107843137254901,36.984649581437615
Task_12372,1056,589,131,191,322,1.7898305084745763,26.638977895230855
Task_12373,2542,856,148,70,218,2.9661610268378062,49.9230273155567
Task_12374,2334,108,181,185,366,21.412844036697248,44.64984767313621
Task_12375,2497,475,192,196,388,5.245798319327731,49.397016574872055
Task_12376,2720,283,58,68,126,9.577464788732394,50.492056157528104
Task_12377,2784,720,193,107,300,3.8613037447988905,54.19782483802692
Task_12378,1008,524,105,159,264,1.92,25.367293571076193
Task_12379,2025,225,146,20,166,8.960176991150442,38.806974929386115
Task_12380,2979,337,193,87,280,8.81360946745562,55.66153485854542
Task_12381,1234,85,137,34,171,14.348837209302326,25.245873706621936
Task_12382,2948,675,168,79,247,4.3609467455621305,56.0803131257501
Task_12383,1905,714,186,128,314,2.664335664335664,40.34872392054182
Task_12384,1699,272,154,64,218,6.2234432234432235,34.683909913401614
Task_12385,1283,334,96,123,219,3.8298507462686566,28.91241462804544
Task_12386,2433,65,92,112,204,36.86363636363637,45.09102298130088
Task_12387,534,522,193,29,222,1.0210325047801148,16.8048017528203
Task_12388,1567,955,147,142,289,1.639121338912134,35.63884759349563
Task_12389,1471,83,177,153,330,17.511904761904763,30.723796815683638
Task_12390,2265,101,172,196,368,22.205882352941178,43.56381223638005
Task_12391,825,501,120,25,145,1.6434262948207172,20.757030018568162
Task_12392,2814,864,123,144,267,3.253179190751445,55.031650118068114
Task_12393,2572,832,187,57,244,3.0876350540216086,50.36598848713777
Task_12394,2059,275,11,24,35,7.4601449275362315,38.20394730916057
Task_12395,1131,219,184,122,306,5.140909090909091,26.464754128680482
Task_12396,2441,737,70,124,194,3.307588075880759,48.50549549152324
Task_12397,1411,719,37,113,150,1.9597222222222221,31.461297640922606
Task_12398,2797,312,43,121,164,8.936102236421725,52.37525565728379
Task_12399,513,272,89,130,219,1.879120879120879,16.535328403596285
Task_12400,526,710,37,77,114,0.739803094233474,16.93667402161012
Task_12401,624,696,101,119,220,0.8952654232424677,19.500451312643097
Task_12402,863,919,185,28,213,0.9380434782608695,23.276008756530377
Task_12403,564,416,61,14,75,1.3525179856115108,15.118198801026942
Task_12404,2501,994,153,161,314,2.51356783919598,50.71480599591158
Task_12405,2194,729,165,128,293,3.0054794520547947,44.879177058532484
Task_12406,1068,733,36,27,63,1.4550408719346049,24.26225006878201
Task_12407,2368,556,169,191,360,4.2513464991023335,47.481958902018164
Task_12408,2455,801,102,152,254,3.061097256857855,49.09932212210331
Task_12409,1514,666,51,112,163,2.269865067466267,33.32378053092125
Task_12410,1836,554,62,144,206,3.308108108108108,38.41666604313452
Task_12411,859,619,104,185,289,1.385483870967742,23.38673995397663
Task_12412,1330,933,156,106,262,1.423982869379015,31.58572690321518
Task_12413,2322,703,26,159,185,3.2982954545454546,46.29837049437989
Task_12414,2062,357,42,148,190,5.759776536312849,41.16525007615619
Task_12415,2627,206,100,148,248,12.690821256038648,49.81331430660297
Task_12416,2629,606,165,131,296,4.3311367380560135,51.39825170427861
Task_12417,1683,401,112,172,284,4.186567164179104,35.76989847602427
Task_12418,2851,688,151,36,187,4.13788098693759,53.82875152018895
Task_12419,1943,542,111,134,245,3.578268876611418,40.10595303295501
Task_12420,1922,562,197,190,387,3.413854351687389,40.559025902446244
Task_12421,2947,684,143,20,163,4.302189781021898,54.90678725736768
Task_12422,1102,572,64,144,208,1.9232111692844678,26.859567700336296
Task_12423,1052,235,29,184,213,4.4576271186440675,24.984248002581193
Task_12424,2821,622,37,156,193,4.52808988764045,54.08242934732829
Task_12425,827,151,34,85,119,5.440789473684211,19.56057340791519
Task_12426,689,799,38,74,112,0.86125,19.76267937434252
Task_12427,2017,458,165,85,250,4.394335511982571,40.684540900405516
Task_12428,718,566,124,164,288,1.2663139329805997,20.916124375323516
Task_12429,1503,833,43,149,192,1.8021582733812949,33.84600212290652
Task_12430,672,794,92,67,159,0.8452830188679246,19.582686381840812
Task_12431,1130,190,159,107,266,5.9162303664921465,26.152836473424085
Task_12432,1917,495,38,89,127,3.8649193548387095,38.62738252655131
Task_12433,1929,89,75,47,122,21.433333333333334,35.768419148809336
Task_12434,1288,511,28,45,73,2.515625,27.082320628263048
Task_12435,707,1018,119,173,292,0.6938174681059862,22.327276483689584
Task_12436,1976,333,41,93,134,5.916167664670659,39.14941838542322
Task_12437,1238,863,135,94,229,1.4328703703703705,29.68905804637228
Task_12438,2191,938,143,122,265,2.3333333333333335,45.34994371390184
Task_12439,1773,553,25,75,100,3.200361010830325,36.02269858307424
Task_12440,887,130,16,172,188,6.770992366412214,21.300788003681436
Task_12441,912,113,52,16,68,8.0,19.312411122877837
Task_12442,1152,366,27,77,104,3.138964577656676,25.643418324574156
Task_12443,2443,171,31,157,188,14.203488372093023,46.113994088359355
Task_12444,1434,644,93,121,214,2.2232558139534886,32.32001186745716
Task_12445,1625,947,137,116,253,1.7141350210970465,36.33273610062333
Task_12446,2710,965,174,170,344,2.8053830227743273,54.08474842344324
Task_12447,520,628,199,180,379,0.8267090620031796,18.428142816492635
Task_12448,799,974,69,157,226,0.8194871794871795,23.265927373128267
Task_12449,921,461,44,112,156,1.9935064935064934,22.93715783947104
Task_12450,2476,526,105,19,124,4.698292220113852,46.57448603631121
Task_12451,2604,919,95,178,273,2.8304347826086955,52.0232890053697
Task_12452,1812,176,189,142,331,10.23728813559322,36.78747636254827
Task_12453,2138,1021,93,125,218,2.091976516634051,44.672800765289445
Task_12454,1573,865,74,129,203,1.8163972286374135,35.193024149282344
Task_12455,743,263,178,60,238,2.8143939393939394,19.56070048884212
Task_12456,1401,668,89,163,252,2.094170403587444,32.03306383581103
Task_12457,1232,869,15,113,128,1.4160919540229886,29.15921489978688
Task_12458,1949,470,193,177,370,4.138004246284501,40.59730264388809
Task_12459,1416,806,86,50,136,1.754646840148699,31.08724207974041
Task_12460,2612,419,115,128,243,6.219047619047619,50.280481968644686
Task_12461,1924,166,45,45,90,11.520958083832335,36.17562213796035
Task_12462,1998,334,138,129,267,5.964179104477612,40.392976224529605
Task_12463,2866,306,190,112,302,9.335504885993485,54.15549746539174
Task_12464,2787,745,53,17,70,3.7359249329758715,51.29098228524578
Task_12465,802,972,120,107,227,0.8242548818088387,23.16734761694973
Task_12466,753,575,76,135,211,1.3072916666666667,21.278274759079938
Task_12467,602,86,169,153,322,6.919540229885057,17.07898957388791
Task_12468,1748,395,177,45,222,4.414141414141414,35.57562665948566
Task_12469,2842,1007,167,176,343,2.8194444444444446,56.31186950478976
Task_12470,2607,1013,182,64,246,2.5710059171597632,51.54990721831024
Task_12471,2069,927,96,137,233,2.2295258620689653,43.31310360289058
Task_12472,2602,861,161,168,329,3.0185614849187936,51.97782974030662
Task_12473,1428,427,193,49,242,3.336448598130841,30.824542520411654
Task_12474,756,251,166,186,352,3.0,20.949478628497083
Task_12475,2793,539,30,16,46,5.1722222222222225,50.75046385460908
Task_12476,1481,1023,53,39,92,1.4462890625,32.206270983591224
Task_12477,882,320,83,81,164,2.7476635514018692,21.809220293372423
Task_12478,1404,795,35,198,233,1.763819095477387,32.418317896449345
Task_12479,2522,165,48,187,235,15.19277108433735,47.8053165296456
Task_12480,1346,144,128,118,246,9.282758620689656,29.029565169831567
Task_12481,550,697,21,66,87,0.7879656160458453,16.85939508838913
Task_12482,1884,801,41,114,155,2.349127182044888,39.250262127164085
Task_12483,1174,177,92,91,183,6.595505617977528,25.676698191047972
Task_12484,1183,81,98,44,142,14.426829268292684,24.089476975811067
Task_12485,972,715,165,56,221,1.3575418994413408,24.619034711357923
Task_12486,2196,356,20,180,200,6.151260504201681,43.35176325763816
Task_12487,593,378,148,87,235,1.5646437994722955,17.811718813668957
Task_12488,708,566,24,76,100,1.2486772486772486,19.108040917557528
Task_12489,1181,634,115,17,132,1.8598425196850394,26.543736971127718
Task_12490,703,825,110,126,236,0.851089588377724,21.221257339364072
Task_12491,1915,1008,37,100,137,1.8979187314172448,40.3141753428926
Task_12492,1903,76,140,180,320,24.714285714285715,37.40760462258323
Task_12493,2654,408,115,136,251,6.488997555012225,50.95642211620052
Task_12494,929,363,145,28,173,2.552197802197802,22.228002479835464
Task_12495,2089,929,78,133,211,2.246236559139785,43.609090499269854
Task_12496,2502,977,42,187,229,2.558282208588957,50.34633483907597
Task_12497,1460,620,59,132,191,2.3510466988727856,32.61178158640451
Task_12498,2683,193,116,155,271,13.829896907216495,50.76303499093702
Task_12499,1821,103,113,67,180,17.509615384615383,34.91599790717774
Task_12500,2764,249,74,186,260,11.056,52.38610450706934
Task_12501,1638,508,105,147,252,3.218074656188605,35.219519990854884
Task_12502,2008,283,88,136,224,7.070422535211268,40.213416933129274
Task_12503,979,644,160,155,315,1.5178294573643412,25.463933375663245
Task_12504,639,807,26,129,155,0.7908415841584159,19.486403305393036
Task_12505,1339,920,155,78,233,1.4538545059717698,31.232424200044232
Task_12506,644,785,77,124,201,0.8193384223918575,20.068234789199963
Task_12507,1260,921,128,181,309,1.3665943600867678,30.768078638802127
Task_12508,1663,153,66,109,175,10.7987012987013,33.70124255680619
Task_12509,2251,420,48,100,148,5.346793349168646,43.90330266192598
Task_12510,2016,96,60,182,242,20.783505154639176,38.99836621656194
Task_12511,2131,500,193,13,206,4.253493013972056,41.79359384471072
Task_12512,1188,410,23,131,154,2.8905109489051095,27.06608567498225
Task_12513,1396,266,122,174,296,5.228464419475656,30.842711695595032
Task_12514,1914,467,129,149,278,4.089743589743589,39.577943863009345
Task_12515,2343,145,145,60,205,16.04794520547945,44.06638492474482
Task_12516,2798,130,72,173,245,21.358778625954198,51.89392534219172
Task_12517,741,775,155,83,238,0.9548969072164949,21.374781010909604
Task_12518,907,300,36,133,169,3.0132890365448506,22.41710383308785
Task_12519,550,803,85,105,190,0.6840796019900498,18.662821181086205
Task_12520,2994,491,36,169,205,6.085365853658536,56.46133982523752
Task_12521,1278,624,10,65,75,2.0448,27.640295446573663
Task_12522,1655,819,181,48,229,2.018292682926829,35.52685966023153
Task_12523,2337,651,164,86,250,3.584355828220859,46.37910200875768
Task_12524,1008,323,199,171,370,3.111111111111111,25.225717782559816
Task_12525,1975,199,30,169,199,9.875,39.360634790069206
Task_12526,622,649,123,165,288,0.9569230769230769,19.693288156383655
Task_12527,2128,475,86,60,146,4.470588235294118,41.544076712135286
Task_12528,1354,64,68,143,211,20.83076923076923,28.274599633563138
Task_12529,2776,438,106,128,234,6.323462414578588,52.89820229637919
Task_12530,2407,950,31,134,165,2.5310199789695056,48.34011821189504
Task_12531,2363,888,99,183,282,2.658042744656918,48.087185779568735
Task_12532,2925,71,126,31,157,40.625,51.37662828034883
Task_12533,2023,82,139,86,225,24.373493975903614,38.636831597972524
Task_12534,1156,288,37,17,54,4.0,24.074533588490084
Task_12535,877,976,157,197,354,0.8976458546571137,25.093103603649315
Task_12536,2281,314,152,95,247,7.241269841269841,44.63240772975132
Task_12537,2521,245,141,144,285,10.247967479674797,48.45116187790859
Task_12538,2298,569,85,107,192,4.031578947368421,45.58200108436645
Task_12539,1329,146,124,113,237,9.040816326530612,28.642190725069202
Task_12540,2446,103,48,65,113,23.51923076923077,44.59338467694922
Task_12541,1594,199,78,23,101,7.97,31.567547143053588
Task_12542,1552,357,124,127,251,4.335195530726257,33.339517511995744
Task_12543,2694,260,141,128,269,10.32183908045977,51.144822468981125
Task_12544,2310,206,132,49,181,11.159420289855072,43.55904060705678
Task_12545,1822,942,79,63,142,1.9321314952279958,38.279289934646826
Task_12546,1956,784,121,182,303,2.49171974522293,41.405304195319836
Task_12547,2611,955,63,58,121,2.731171548117155,50.46697142610947
Task_12548,519,150,102,70,172,3.437086092715232,15.037870339294685
Task_12549,2882,92,178,94,272,30.989247311827956,52.61315607371944
Task_12550,859,773,168,181,349,1.1098191214470283,24.038641373296503
Task_12551,606,658,40,184,224,0.9195751138088012,19.074794987154625
Task_12552,1392,843,10,48,58,1.6492890995260663,29.895368150124472
Task_12553,1115,643,188,138,326,1.7313664596273293,27.668784798595066
Task_12554,2625,124,35,103,138,21.0,47.90421193501774
Task_12555,1005,347,11,115,126,2.8879310344827585,23.876082322683274
Task_12556,1766,317,155,83,238,5.553459119496855,36.17550367807677
Task_12557,2269,530,119,114,233,4.273069679849341,45.14596949950951
Task_12558,1512,461,129,159,288,3.272727272727273,33.255250010841884
Task_12559,1536,509,25,29,54,3.011764705882353,31.094577490148577
Task_12560,1338,274,86,38,124,4.865454545454545,28.011728634927138
Task_12561,1554,847,25,27,52,1.8325471698113207,32.398351521572614
Task_12562,2945,456,60,183,243,6.444201312910285,55.881643153135165
Task_12563,2432,191,34,112,146,12.666666666666666,45.885078611785076
Task_12564,2872,220,18,170,188,12.995475113122172,53.436577101140664
Task_12565,1422,865,169,47,216,1.6420323325635104,31.90848367840429
Task_12566,2660,132,50,75,125,20.0,48.38472166214178
Task_12567,2060,603,140,40,180,3.410596026490066,40.860593086120495
Task_12568,2337,313,50,80,130,7.442675159235669,44.83113195943532
Task_12569,1235,95,78,142,220,12.864583333333334,26.614961769034007
Task_12570,1946,807,41,63,104,2.4084158415841586,39.44227632149913
Task_12571,1370,586,133,26,159,2.3339011925042588,29.642204590549934
Task_12572,2853,507,14,32,46,5.616141732283465,51.820796430675976
Task_12573,1748,570,78,102,180,3.0612959719789843,36.71606160809569
Task_12574,942,875,187,67,254,1.0753424657534247,24.700303408317577
Task_12575,674,100,74,101,175,6.673267326732673,17.62178804369334
Task_12576,2538,187,98,65,163,13.5,47.48354631950145
Task_12577,1029,611,140,146,286,1.6813725490196079,26.03840416394011
Task_12578,731,981,98,121,219,0.7443991853360489,22.039124842851376
Task_12579,1078,303,122,174,296,3.5460526315789473,25.938629973558477
Task_12580,2590,577,198,42,240,4.4809688581314875,49.60898350789586
Task_12581,2259,517,122,90,212,4.361003861003861,44.65134812173741
Task_12582,1191,712,87,92,179,1.670406732117812,28.07546695636222
Task_12583,1564,856,68,164,232,1.824970828471412,35.19485574641856
Task_12584,707,737,106,46,152,0.9579945799457995,19.66278864394371
Task_12585,2565,1003,161,89,250,2.554780876494024,51.17555748925097
Task_12586,2833,286,29,65,94,9.871080139372822,51.76914847205716
Task_12587,1546,784,125,151,276,1.9694267515923567,34.74265717007327
Task_12588,1208,298,188,187,375,4.040133779264214,28.352749063829634
Task_12589,784,702,198,165,363,1.1152204836415363,22.67013719284216
Task_12590,2088,364,150,105,255,5.720547945205479,41.82745823573283
Task_12591,2389,566,44,106,150,4.213403880070547,46.44881387933507
Task_12592,1932,210,123,101,224,9.156398104265403,38.67957039762619
Task_12593,832,73,147,115,262,11.243243243243244,20.252730462447172
Task_12594,785,607,133,149,282,1.2911184210526316,22.069461225382657
Task_12595,2718,487,39,24,63,5.569672131147541,49.61912569445246
Task_12596,1766,322,33,184,217,5.46749226006192,36.586847612163524
Task_12597,1081,209,154,102,256,5.147619047619048,25.38608422976648
Task_12598,1763,250,165,172,337,7.0239043824701195,36.768731720328226
Task_12599,1040,214,62,37,99,4.837209302325581,22.62316724893866
Task_12600,1418,713,57,49,106,1.9859943977591037,30.379525557745605
Task_12601,1409,780,132,61,193,1.8040973111395646,31.524869435634198
Task_12602,1371,433,136,65,201,3.1589861751152073,29.96433987251116
Task_12603,2945,315,77,114,191,9.319620253164556,55.06514118334672
Task_12604,1252,737,174,30,204,1.6964769647696476,28.766367458507574
Task_12605,820,784,190,192,382,1.0445859872611465,23.65057042499451
Task_12606,817,78,173,185,358,10.341772151898734,20.579361394822943
Task_12607,1444,741,188,175,363,1.9460916442048517,33.42007452426294
Task_12608,1321,426,123,94,217,3.0936768149882905,29.64980471142599
Task_12609,2325,388,67,120,187,5.976863753213368,45.457129149000764
Task_12610,2070,534,48,47,95,3.869158878504673,40.09288944379173
Task_12611,2723,239,103,120,223,11.345833333333333,51.305084169175
Task_12612,2404,139,118,92,210,17.17142857142857,45.26429531656527
Task_12613,2947,311,118,146,264,9.445512820512821,55.33259917800441
Task_12614,2815,836,71,20,91,3.3632019115890084,52.64282731315404
Task_12615,837,690,121,65,186,1.211287988422576,22.038594442861854
Task_12616,678,922,78,50,128,0.7345612134344529,19.99451337364265
Task_12617,556,668,74,51,125,0.8310911808669657,17.24470654914545
Task_12618,1183,545,88,177,265,2.1666666666666665,28.25449239209624
Task_12619,1153,70,88,128,216,16.239436619718308,25.122303889749563
Task_12620,2354,610,145,20,165,3.8527004909983633,45.37145171245245
Task_12621,2923,308,178,23,201,9.459546925566343,53.75653094796257
Task_12622,2191,448,125,199,324,4.879732739420936,44.18168051703244
Task_12623,1050,845,193,139,332,1.2411347517730495,27.185414510426366
Task_12624,881,188,71,155,226,4.661375661375661,22.273305260295473
Task_12625,636,612,180,100,280,1.037520391517129,19.60837355304395
Task_12626,1672,311,181,199,380,5.358974358974359,35.772417597748515
Task_12627,2682,713,140,58,198,3.7563025210084033,51.516522065403365
Task_12628,567,1007,31,14,45,0.5625,17.055503466830565
Task_12629,1847,182,71,113,184,10.092896174863387,36.85770412290697
Task_12630,2115,744,88,100,188,2.838926174496644,43.14279846526913
Task_12631,1319,222,104,62,166,5.914798206278027,28.09087493343247
Task_12632,1722,110,197,122,319,15.513513513513514,34.74396213196958
Task_12633,2913,869,26,32,58,3.3482758620689657,53.957680348151875
Task_12634,1171,633,163,71,234,1.8470031545741326,27.589274700082644
Task_12635,1581,922,97,102,199,1.7128927410617552,35.31768889016311
Task_12636,1128,691,191,50,241,1.630057803468208,26.88577817643986
Task_12637,2957,367,195,133,328,8.035326086956522,55.95504952987435
Task_12638,2291,420,185,126,311,5.441805225653207,45.50739356947572
Task_12639,2566,736,30,104,134,3.4816824966078697,49.79554295656615
Task_12640,517,833,170,57,227,0.6199040767386091,17.992090291328335
Task_12641,1410,247,110,152,262,5.685483870967742,30.813671668155653
Task_12642,695,968,49,148,197,0.717234262125903,21.598251323557008
Task_12643,1683,994,116,112,228,1.6914572864321609,37.279139055029766
Task_12644,1809,113,96,84,180,15.868421052631579,35.19710397789393
Task_12645,1504,719,25,54,79,2.088888888888889,31.558386802184057
Task_12646,1698,160,10,105,115,10.546583850931677,33.386340803000174
Task_12647,709,364,104,189,293,1.9424657534246574,20.306583480152224
Task_12648,1781,884,48,84,132,2.0124293785310736,37.78275749667757
Task_12649,1351,524,83,91,174,2.5733333333333333,30.13022643352254
Task_12650,2042,919,28,132,160,2.2195652173913043,42.19534799334834
Task_12651,1373,259,39,141,180,5.280769230769231,29.714994724962608
Task_12652,2479,247,137,162,299,9.995967741935484,47.8845290397453
Task_12653,519,371,146,129,275,1.3951612903225807,17.085348265218173
Task_12654,1279,201,107,158,265,6.3316831683168315,28.60632102607275
Task_12655,1468,552,170,44,214,2.6546112115732368,31.63740459862154
Task_12656,2472,351,117,171,288,7.0227272727272725,48.103762426910784
Task_12657,1285,493,111,172,283,2.6012145748987856,29.759908586746846
Task_12658,1382,705,132,114,246,1.9575070821529745,31.70894069660298
Task_12659,1332,870,30,112,142,1.529276693455798,30.65712005908327
Task_12660,2822,858,36,107,143,3.2852153667054713,54.24142296404264
Task_12661,2440,264,100,157,257,9.20754716981132,47.133950330314654
Task_12662,1566,459,149,62,211,3.4043478260869566,33.12170918431808
Task_12663,1670,409,128,169,297,4.073170731707317,35.64426545174668
Task_12664,2815,906,56,181,237,3.103638368246968,55.25673901250486
Task_12665,2347,507,101,111,212,4.6200787401574805,46.20802116960514
Task_12666,1550,347,179,85,264,4.454022988505747,32.99741230492213
Task_12667,2545,361,173,87,260,7.030386740331492,48.788836805056356
Task_12668,1874,670,63,94,157,2.7928464977645304,38.74652024895739
Task_12669,1627,146,141,73,214,11.068027210884354,32.77653857090426
Task_12670,2737,89,46,72,118,30.41111111111111,48.94931298043864
Task_12671,2064,700,144,133,277,2.944365192582026,42.66400773255653
Task_12672,2673,927,121,196,317,2.8803879310344827,53.29620101969105
Task_12673,2156,955,147,150,297,2.2552301255230125,45.03353004408814
Task_12674,507,665,163,31,194,0.7612612612612613,16.74954022274703
Task_12675,2035,660,192,39,231,3.0786686838124053,41.013485538795514
Task_12676,1867,148,59,135,194,12.53020134228188,37.13831423944574
Task_12677,2766,807,15,110,125,3.4232673267326734,53.2224728660637
Task_12678,2136,890,140,90,230,2.3973063973063975,43.95940854834589
Task_12679,1639,785,84,47,131,2.0852417302798982,34.49382776779763
Task_12680,992,647,91,179,270,1.5308641975308641,25.564837497648117
Task_12681,833,340,186,11,197,2.442815249266862,20.70754294175428
Task_12682,1020,320,71,32,103,3.177570093457944,22.853082283854107
Task_12683,1392,524,148,152,300,2.6514285714285712,31.599075225476113
Task_12684,1401,305,14,36,50,4.578431372549019,28.320378143301056
Task_12685,2633,148,44,98,142,17.671140939597315,48.32350703314767
Task_12686,1718,99,175,22,197,17.18,33.278987153526664
Task_12687,946,755,96,120,216,1.2513227513227514,24.74883316616733
Task_12688,828,120,113,124,237,6.8429752066115705,20.617805418352628
Task_12689,1652,330,37,21,58,4.990936555891238,32.218113515019986
Task_12690,1506,599,171,154,325,2.51,33.75592396951254
Task_12691,512,378,43,123,166,1.3509234828496042,16.30351282211196
Task_12692,2931,292,153,194,347,10.003412969283277,55.456027356327354
Task_12693,2750,455,147,85,232,6.030701754385965,52.19583563169271
Task_12694,2937,810,35,72,107,3.6214549938347718,55.32610359023183
Task_12695,1922,515,108,132,240,3.7248062015503876,39.66202381598682
Task_12696,2412,478,68,101,169,5.035490605427975,46.8689347266425
Task_12697,1322,631,34,123,157,2.0917721518987342,29.857891590786437
Task_12698,594,95,175,173,348,6.1875,17.076419521874048
Task_12699,1633,925,14,182,196,1.763498920086393,36.27346360230858
Task_12700,2057,936,101,119,220,2.1953041622198506,43.01313887079008
Task_12701,2916,493,112,107,219,5.902834008097166,55.19637199768647
Task_12702,1579,363,113,77,190,4.337912087912088,33.06613005131378
Task_12703,1715,441,185,88,273,3.8800904977375565,35.98068389295164
Task_12704,1797,510,137,172,309,3.516634050880626,38.036701231100515
Task_12705,2391,455,51,75,126,5.243421052631579,46.071835952151226
Task_12706,2859,448,169,10,179,6.367483296213808,52.84325259733527
Task_12707,1081,549,191,87,278,1.9654545454545456,26.30479196631916
Task_12708,1146,543,196,82,278,2.1066176470588234,27.278768395365248
Task_12709,614,940,151,118,269,0.6524973432518597,20.44329991124898
Task_12710,2545,137,173,35,208,18.442028985507246,46.91628624331721
Task_12711,521,158,176,99,275,3.2767295597484276,16.1664006879705
Task_12712,2584,972,148,174,322,2.655704008221994,52.01663190442381
Task_12713,2781,712,169,24,193,3.900420757363254,52.79104924472673
Task_12714,752,968,66,118,184,0.7760577915376677,22.11820194246191
Task_12715,1310,965,157,144,301,1.3561076604554865,31.627322322030718
Task_12716,2270,341,32,74,106,6.637426900584796,43.27529293508966
Task_12717,1310,185,44,165,209,7.043010752688172,28.66878898346191
Task_12718,2055,788,45,102,147,2.6045627376425857,41.86802060060134
Task_12719,927,218,27,79,106,4.232876712328767,21.680211731068045
Task_12720,676,318,87,143,230,2.1191222570532915,19.29600781126317
Task_12721,2462,777,51,57,108,3.16452442159383,47.43606391165293
Task_12722,2729,841,102,92,194,3.2410926365795723,53.10485147647908
Task_12723,674,173,151,195,346,3.8735632183908044,19.013478930359405
Task_12724,1950,582,168,68,236,3.3447684391080617,39.76571467569037
Task_12725,2102,328,38,35,73,6.3890577507598785,39.382840014459354
Task_12726,2302,271,159,10,169,8.463235294117647,43.36675062721346
Task_12727,1236,96,173,18,191,12.742268041237113,25.44842433823948
Task_12728,2154,936,90,142,232,2.2988260405549625,44.68725841468747
Task_12729,2238,522,172,40,212,4.279158699808796,43.741552835726935
Task_12730,2561,844,187,139,326,3.0307692307692307,51.21894924529315
Task_12731,946,122,151,15,166,7.691056910569106,21.16831800313008
Task_12732,2716,841,114,54,168,3.2256532066508314,52.18085383617944
Task_12733,1285,599,107,34,141,2.1416666666666666,28.30555761434869
Task_12734,1065,627,113,165,278,1.6958598726114649,26.650238343314516
Task_12735,2823,359,14,77,91,7.841666666666667,51.908838778133635
Task_12736,1659,779,57,41,98,2.126923076923077,34.26251579592567
Task_12737,2176,766,55,11,66,2.837027379400261,41.68377181589806
Task_12738,2339,373,76,58,134,6.254010695187166,44.59518124545084
Task_12739,2619,77,77,166,243,33.57692307692308,48.40685342201613
Task_12740,1502,1006,100,190,290,1.4915590863952333,34.812513585734074
Task_12741,1267,128,186,78,264,9.821705426356589,27.33896640859876
Task_12742,1236,522,110,118,228,2.363288718929254,28.748519164258237
Task_12743,1481,941,59,41,100,1.5721868365180467,31.965739003850576
Task_12744,1391,457,37,88,125,3.037117903930131,30.164634079319526
Task_12745,2159,772,95,183,278,2.7930142302716687,44.54272061304536
Task_12746,1683,958,92,113,205,1.7549530761209593,37.142742954958145
Task_12747,2932,909,38,14,52,3.221978021978022,54.17958119710485
Task_12748,2336,542,93,48,141,4.302025782688766,44.90750518913296
Task_12749,2379,840,164,87,251,2.8287752675386444,47.65433813735782
Task_12750,2805,81,194,125,319,34.207317073170735,51.51524744419629
Task_12751,2774,978,200,88,288,2.833503575076609,54.51495156199198
Task_12752,636,534,110,198,308,1.188785046728972,19.68206924683516
Task_12753,2062,79,194,171,365,25.775,40.14089133343038
Task_12754,613,191,83,121,204,3.1927083333333335,17.77624199176492
Task_12755,1663,262,86,120,206,6.32319391634981,34.605783976078534
Task_12756,853,107,157,92,249,7.898148148148148,20.597651927787798
Task_12757,2549,641,107,182,289,3.970404984423676,50.2857610097581
Task_12758,2278,923,67,146,213,2.465367965367965,46.604825999427106
Task_12759,1391,457,12,128,140,3.037117903930131,30.31091420864375
Task_12760,898,780,137,159,296,1.1498079385403328,24.484030274075693
Task_12761,1563,912,147,198,345,1.7119386637458927,35.77649244089901
Task_12762,1147,415,190,22,212,2.7572115384615383,26.04815292110079
Task_12763,2181,88,152,87,239,24.50561797752809,41.27478969506903
Task_12764,636,738,151,71,222,0.8606224627875507,19.399347141761805
Task_12765,2874,240,110,114,224,11.925311203319502,53.690026271814226
Task_12766,2048,494,63,113,176,4.137373737373737,41.24514892232316
Task_12767,2007,495,12,180,192,4.046370967741935,40.79981888286155
Task_12768,1551,729,29,68,97,2.1246575342465754,32.936367657034246
Task_12769,2094,782,98,127,225,2.6743295019157087,43.16707746777717
Task_12770,2556,877,69,57,126,2.9111617312072893,49.578767680105955
Task_12771,2741,404,168,147,315,6.767901234567901,52.62436750824994
Task_12772,1354,958,79,156,235,1.4118873826903025,32.130107923379576
Task_12773,1557,252,25,79,104,6.154150197628459,31.71897212097733
Task_12774,2198,981,167,29,196,2.2382892057026478,44.49061437691478
Task_12775,1647,778,20,124,144,2.1142490372272142,35.37152922498206
Task_12776,1106,649,14,112,126,1.7015384615384614,26.452999867010842
Task_12777,890,710,103,97,200,1.2517580872011251,23.60912519701633
Task_12778,2842,221,76,32,108,12.801801801801801,51.418005474297246
Task_12779,532,309,70,70,140,1.7161290322580645,15.91657138757266
Task_12780,1232,380,70,191,261,3.2335958005249346,28.63082768751197
Task_12781,1229,524,173,94,267,2.340952380952381,28.729026784137265
Task_12782,2235,98,90,115,205,22.575757575757574,42.12401390815434
Task_12783,1055,496,119,34,153,2.1227364185110664,24.36690409985457
Task_12784,1500,821,120,37,157,1.8248175182481752,32.479840416580835
Task_12785,2206,814,179,97,276,2.7067484662576686,45.24718813387066
Task_12786,1383,112,75,189,264,12.238938053097344,29.416324005397655
Task_12787,1002,855,79,53,132,1.1705607476635513,25.078865171620876
Task_12788,1327,262,79,60,139,5.0456273764258555,28.180966059707586
Task_12789,2146,573,81,142,223,3.7386759581881535,43.43516130942023
Task_12790,2800,756,128,93,221,3.6988110964332894,54.12298620733458
Task_12791,2566,817,113,174,287,3.136919315403423,51.089085965260665
Task_12792,2991,1022,44,61,105,2.9237536656891496,56.49250980053517
Task_12793,620,694,188,156,344,0.8920863309352518,20.032384166307793
Task_12794,2786,568,30,176,206,4.896309314586995,53.464230994485085
Task_12795,2399,707,42,141,183,3.388418079096045,47.411943159351075
Task_12796,1628,93,90,149,239,17.319148936170212,32.76441767643072
Task_12797,1265,164,35,100,135,7.666666666666667,26.814521333841217
Task_12798,2276,1019,105,34,139,2.231372549019608,45.28848255561949
Task_12799,1979,917,140,44,184,2.155773420479303,40.55976044520864
Task_12800,2084,665,107,109,216,3.129129129129129,42.56060135023201
Task_12801,1518,828,52,44,96,1.8311218335343789,32.21245929675053
Task_12802,1915,906,21,40,61,2.11135611907387,38.254507270916946
Task_12803,593,232,172,166,338,2.5450643776824036,18.220159365614762
Task_12804,1471,800,13,111,124,1.83645443196005,32.66946303211309
Task_12805,2208,153,129,50,179,14.337662337662337,41.37908029185859
Task_12806,875,808,11,119,130,1.0815822002472189,23.074937072453054
Task_12807,1939,467,68,70,138,4.1431623931623935,38.667279420108166
Task_12808,2553,209,92,97,189,12.157142857142857,48.41033849403039
Task_12809,1143,79,48,172,220,14.2875,25.195316795810445
Task_12810,2628,566,146,164,310,4.634920634920635,51.366062235455956
Task_12811,1656,132,182,13,195,12.451127819548873,32.72290329032751
Task_12812,1765,781,24,167,191,2.2570332480818416,37.886084238484614
Task_12813,1090,790,188,13,201,1.3780025284450064,26.152586624521287
Task_12814,2137,357,80,94,174,5.9692737430167595,42.19284616898079
Task_12815,1820,704,182,155,337,2.5815602836879434,39.114178995803904
Task_12816,2011,825,171,107,278,2.4346246973365617,42.182129323678126
Task_12817,1338,509,104,155,259,2.623529411764706,30.51640124136688
Task_12818,2697,962,129,159,288,2.8006230529595015,53.60086040918443
Task_12819,2170,507,154,11,165,4.271653543307087,42.190771851439784
Task_12820,1541,156,148,149,297,9.815286624203821,32.422852453527376
Task_12821,738,936,82,44,126,0.7876200640341515,20.713160447476245
Task_12822,1896,108,176,29,205,17.394495412844037,36.33055039238263
Task_12823,1614,299,22,126,148,5.38,33.31129858155495
Task_12824,1550,584,90,140,230,2.6495726495726495,34.00612309684685
Task_12825,1369,284,96,36,132,4.803508771929825,28.705135411488794
Task_12826,2415,739,185,118,303,3.2635135135135136,48.441953120833354
Task_12827,2310,961,127,79,206,2.401247401247401,46.68550322520313
Task_12828,1310,783,167,132,299,1.6709183673469388,31.06305161422195
Task_12829,780,610,193,181,374,1.2765957446808511,22.46116120410373
Task_12830,2158,467,174,57,231,4.611111111111111,42.59368922646203
Task_12831,2322,451,67,79,146,5.1371681415929205,44.93725510835526
Task_12832,954,1010,178,134,312,0.9436201780415431,26.131795045612733
Task_12833,1905,425,13,25,38,4.471830985915493,36.41445004381977
Task_12834,1899,398,58,105,163,4.7593984962406015,38.51589238056161
Task_12835,1678,296,120,154,274,5.64983164983165,35.27316880909916
Task_12836,750,564,60,109,169,1.3274336283185841,20.797162654476974
Task_12837,1128,658,146,13,159,1.7116843702579667,25.903163106063687
Task_12838,2458,865,127,192,319,2.838337182448037,49.698840711998876
Task_12839,2843,129,96,187,283,21.869230769230768,52.70762022797149
Task_12840,1969,181,29,181,210,10.81868131868132,38.82025412255656
Task_12841,1108,903,172,39,211,1.2256637168141593,26.98511935812559
Task_12842,2092,858,183,16,199,2.4353899883585566,42.25570594500184
Task_12843,2884,75,111,128,239,37.94736842105263,52.316260625398236
Task_12844,692,645,19,69,88,1.0712074303405572,18.898586853692034
Task_12845,1313,365,197,109,306,3.587431693989071,29.806194105843037
Task_12846,1118,653,171,48,219,1.709480122324159,26.44534494645291
Task_12847,882,956,25,77,102,0.9216300940438872,23.165608686008824
Task_12848,2149,730,33,169,202,2.9398084815321477,43.86726903306954
Task_12849,2877,881,90,151,241,3.261904761904762,56.025487388011385
Task_12850,1937,858,195,43,238,2.2549476135040747,40.14228947596601
Task_12851,2879,564,62,111,173,5.0955752212389385,54.695458832742304
Task_12852,1941,818,32,103,135,2.36996336996337,40.15359334294237
Task_12853,733,454,87,37,124,1.610989010989011,18.984913098791758
Task_12854,1481,855,197,98,295,1.730140186915888,33.931507416601136
Task_12855,2854,183,61,53,114,15.51086956521739,51.791338610080224
Task_12856,1754,602,92,12,104,2.9087893864013266,35.32197527624757
Task_12857,2181,1006,71,186,257,2.16583912611718,45.58782399788324
Task_12858,1766,112,77,48,125,15.628318584070797,33.54074169019578
Task_12859,2065,704,140,94,234,2.9290780141843973,42.38588946641105
Task_12860,894,407,139,62,201,2.1911764705882355,22.276033840865605
Task_12861,2249,890,32,145,177,2.5241301907968574,45.61795089781321
Task_12862,562,114,46,15,61,4.886956521739131,13.829663007817503
Task_12863,2777,111,48,102,150,24.794642857142858,50.10325131048438
Task_12864,1242,264,39,50,89,4.686792452830189,26.11913281491729
Task_12865,2575,437,85,151,236,5.878995433789954,49.80375550867609
Task_12866,2862,172,115,84,199,16.54335260115607,52.47260852724171
Task_12867,1122,819,171,60,231,1.3682926829268294,27.250151083326468
Task_12868,1996,110,25,56,81,17.98198198198198,37.04259923417363
Task_12869,1675,913,182,51,233,1.8326039387308535,36.38103638695821
Task_12870,2656,311,84,165,249,8.512820512820513,50.73878148192358
Task_12871,2699,922,22,28,50,2.924160346695558,50.73869863386421
Task_12872,1787,349,125,79,204,5.105714285714286,36.4555132801599
Task_12873,786,960,61,111,172,0.81789802289282,22.62913945278559
Task_12874,716,151,196,139,335,4.7105263157894735,19.525805725204773
Task_12875,618,710,38,163,201,0.869198312236287,19.31128300648915
Task_12876,1995,563,89,188,277,3.5372340425531914,41.25923380224532
Task_12877,653,925,79,31,110,0.7051835853131749,19.397584031551705
Task_12878,2872,767,52,157,209,3.7395833333333335,55.57316107685782
Task_12879,2104,296,17,84,101,7.084175084175084,40.48051624748679
Task_12880,1405,335,193,35,228,4.181547619047619,30.034015737410304
Task_12881,981,758,142,173,315,1.2924901185770752,25.826848211579687
Task_12882,1988,895,49,153,202,2.21875,41.92165389081353
Task_12883,866,153,101,79,180,5.623376623376624,20.597605300809203
Task_12884,1015,856,131,182,313,1.1843640606767796,26.683500075743904
Task_12885,2892,258,71,194,265,11.166023166023166,54.47191068641083
Task_12886,632,679,166,82,248,0.9294117647058824,19.431397582537638
Task_12887,1338,551,151,79,230,2.4239130434782608,30.113773582237016
Task_12888,1613,572,85,61,146,2.8150087260034904,33.7063420243564
Task_12889,1121,713,150,140,290,1.5700280112044818,27.793164961069127
Task_12890,2644,801,30,163,193,3.2967581047381547,51.875828997857305
Task_12891,2024,80,167,52,219,24.987654320987655,38.294964438451416
Task_12892,2960,706,114,64,178,4.1867043847241865,55.6750772727626
Task_12893,1293,256,22,50,72,5.031128404669261,26.464539559460434
Task_12894,585,232,192,38,230,2.5107296137339055,16.76871740776492
Task_12895,1518,652,38,124,162,2.3246554364471668,33.07454655445957
Task_12896,2177,966,171,138,309,2.25129265770424,45.437034041881816
Task_12897,1480,150,141,49,190,9.801324503311259,30.173977179209
Task_12898,2288,354,66,50,116,6.445070422535212,43.3021452054326
Task_12899,1960,611,28,103,131,3.2026143790849675,39.83375544206027
Task_12900,2713,499,87,103,190,5.426,51.862800036189526
Task_12901,953,578,183,32,215,1.6459412780656304,23.584751536807556
Task_12902,980,486,195,77,272,2.0123203285420943,24.362045035145396
Task_12903,976,471,86,33,119,2.0677966101694913,22.81874855071031
Task_12904,1417,397,114,15,129,3.5603015075376883,29.600711547524025
Task_12905,2758,308,83,28,111,8.925566343042071,50.332488013219205
Task_12906,2194,990,109,95,204,2.2139253279515643,45.21668899485483
Task_12907,1876,826,11,76,87,2.2684401451027814,38.27269772789158
Task_12908,2672,298,26,20,46,8.936454849498327,47.96127171486194
Task_12909,551,810,126,199,325,0.6794081381011098,19.41254893449492
Task_12910,1970,614,123,192,315,3.203252032520325,41.16210034798911
Task_12911,672,606,96,170,266,1.1070840197693574,20.217711096779112
Task_12912,2074,591,81,174,255,3.5033783783783785,42.543239048096524
Task_12913,1351,515,195,180,375,2.618217054263566,31.30062072017221
Task_12914,2017,540,58,145,203,3.7282809611829943,41.25266001263087
Task_12915,2164,93,51,171,222,23.02127659574468,41.25156529209301
Task_12916,1092,445,78,199,277,2.4484304932735426,26.69642898352755
Task_12917,2105,1012,177,151,328,2.0779861796643635,44.54380395522643
Task_12918,1368,1011,95,138,233,1.3517786561264822,32.4357190828102
Task_12919,1146,841,61,173,234,1.3610451306413303,28.478559868734305
Task_12920,2755,306,79,20,99,8.973941368078176,50.04792269005164
Task_12921,1741,377,123,158,281,4.605820105820106,36.57548413510674
Task_12922,2704,99,64,157,221,27.04,49.758696816614254
Task_12923,1041,345,76,35,111,3.008670520231214,23.41229926052736
Task_12924,2238,552,177,129,306,4.047016274864376,45.0764465501228
Task_12925,1615,743,167,182,349,2.170698924731183,36.08238546826535
Task_12926,2839,872,129,185,314,3.252004581901489,55.724775359542
Task_12927,942,660,104,162,266,1.4251134644478063,24.6914787074416
Task_12928,2434,495,58,72,130,4.907258064516129,46.750657858607234
Task_12929,1008,645,180,169,349,1.5603715170278638,26.10012224611242
Task_12930,596,640,141,114,255,0.9297971918876755,19.02681175859394
Task_12931,921,181,131,162,293,5.06043956043956,22.661364431318777
Task_12932,865,777,109,46,155,1.1118251928020566,22.144870045283085
Task_12933,582,378,13,182,195,1.5356200527704484,17.90689851977777
Task_12934,1527,679,148,191,339,2.2455882352941177,34.45657708698525
Task_12935,1557,826,185,44,229,1.882708585247884,33.97161935905917
Task_12936,526,745,174,73,247,0.7050938337801609,17.97097552596385
Task_12937,2976,603,66,143,209,4.927152317880795,56.63214390593502
Task_12938,2716,951,48,180,228,2.8529411764705883,53.7512813378438
Task_12939,2551,700,45,38,83,3.6390870185449358,48.12769584076599
Task_12940,1011,793,71,160,231,1.2732997481108312,26.128147577171514
Task_12941,908,585,193,187,380,1.5494880546075085,24.495595605932248
Task_12942,2134,284,55,188,243,7.487719298245614,42.50954974727489
Task_12943,1384,277,162,17,179,4.9784172661870505,28.8511518843884
Task_12944,2525,591,133,69,202,4.265202702702703,48.71862795783915
Task_12945,1997,752,108,56,164,2.652058432934927,40.637670871093526
Task_12946,753,764,191,141,332,0.984313725490196,22.278318280098826
Task_12947,1886,398,84,136,220,4.726817042606516,38.6784024854195
Task_12948,1608,673,80,24,104,2.3857566765578637,33.27601984545097
Task_12949,668,846,151,172,323,0.7886658795749705,21.230155835766386
Task_12950,1933,286,166,49,215,6.735191637630662,38.22640390595319
Task_12951,1165,862,113,158,271,1.3499420625724219,28.895858348801326
Task_12952,1205,135,85,20,105,8.860294117647058,24.560586419914838
Task_12953,1339,994,117,54,171,1.3457286432160804,30.82997833966167
Task_12954,1237,766,119,133,252,1.6127770534550196,29.643336041817236
Task_12955,2249,241,83,39,122,9.293388429752065,42.14795794111692
Task_12956,1398,154,118,168,286,9.019354838709678,30.107266915204974
Task_12957,769,130,61,144,205,5.870229007633588,19.707707338489076
Task_12958,1229,567,145,198,343,2.163732394366197,29.414600737577718
Task_12959,944,623,107,53,160,1.5128205128205128,23.329501056382345
Task_12960,898,886,156,76,232,1.012401352874859,24.016338564372216
Task_12961,1238,911,154,152,306,1.3574561403508771,30.353370601584558
Task_12962,1902,857,123,38,161,2.2167832167832167,39.00347334303641
Task_12963,1700,784,34,99,133,2.1656050955414012,36.23945669135717
Task_12964,683,466,190,42,232,1.462526766595289,19.027136070740074
Task_12965,2489,615,127,78,205,4.040584415584416,48.424107801542895
Task_12966,1259,299,83,198,281,4.196666666666666,28.808442244616586
Task_12967,1022,683,39,75,114,1.4941520467836258,24.805771276750303
Task_12968,2322,987,129,20,149,2.3502024291497974,45.79338638688002
Task_12969,1546,680,167,163,330,2.2701908957415564,34.67904907776713
Task_12970,1745,161,194,133,327,10.771604938271604,35.75849418217579
Task_12971,701,987,52,95,147,0.7095141700404858,21.17094369812216
Task_12972,2381,478,151,50,201,4.970772442588727,45.876881663069575
Task_12973,879,973,117,154,271,0.9024640657084189,24.673908900968655
Task_12974,2023,502,135,157,292,4.021868787276342,41.490520994456
Task_12975,1925,936,162,62,224,2.054429028815368,40.36327192873567
Task_12976,2988,68,164,42,206,43.30434782608695,52.82601979458562
Task_12977,1523,600,54,141,195,2.534109816971714,33.58241601206406
Task_12978,2278,184,155,116,271,12.313513513513513,44.121442119546465
Task_12979,2513,287,100,23,123,8.725694444444445,46.55591122701815
Task_12980,2398,376,163,39,202,6.360742705570292,45.71586904684918
Task_12981,1577,705,28,156,184,2.23371104815864,34.45075400394306
Task_12982,2573,712,144,17,161,3.608695652173913,48.90693857825864
Task_12983,859,974,188,49,237,0.8810256410256411,23.550359001263924
Task_12984,675,569,54,160,214,1.1842105263157894,20.05355827903573
Task_12985,1765,185,151,159,310,9.489247311827956,36.27019142721292
Task_12986,2453,224,182,191,373,10.902222222222223,47.763127403730344
Task_12987,1338,601,169,194,363,2.222591362126246,31.3315586860781
Task_12988,1821,509,79,133,212,3.570588235294118,38.04984121619121
Task_12989,951,175,30,53,83,5.403409090909091,21.176535860765426
Task_12990,1240,377,76,30,106,3.2804232804232805,26.573941368999854
Task_12991,2194,647,33,118,151,3.3858024691358026,43.685789984097134
Task_12992,2461,1009,86,152,238,2.4366336633663366,49.813952109916166
Task_12993,746,796,46,24,70,0.9360100376411543,19.51895450852886
Task_12994,2315,265,153,141,294,8.703007518796992,45.30543007177423
Task_12995,752,219,56,15,71,3.418181818181818,17.405199082159477
Task_12996,925,193,183,68,251,4.768041237113402,22.46070997372813
Task_12997,2176,436,150,191,341,4.979405034324943,43.97015738042867
Task_12998,784,622,62,39,101,1.2584269662921348,19.96243491431594
Task_12999,1924,734,98,142,240,2.617687074829932,40.41327165974126
Task_13000,1828,518,83,109,192,3.5221579961464355,37.98690554593656
Task_13001,997,781,123,155,278,1.274936061381074,25.958516277759227
Task_13002,2806,961,92,176,268,2.916839916839917,55.33729216607242
Task_13003,2348,594,139,175,314,3.946218487394958,47.05559458898117
Task_13004,2496,909,15,135,150,2.742857142857143,49.30004753234358
Task_13005,2146,407,200,61,261,5.259803921568627,42.32066791011339
Task_13006,1015,644,17,148,165,1.573643410852713,25.2170904165332
Task_13007,1150,582,57,126,183,1.9725557461406518,27.360252491845902
Task_13008,1329,555,53,177,230,2.3902877697841727,30.590121961953532
Task_13009,2414,238,126,108,234,10.100418410041842,46.452007555674214
Task_13010,1790,708,72,114,186,2.524682651622003,37.9078663662936
Task_13011,2160,544,62,165,227,3.963302752293578,43.640566452761796
Task_13012,1968,710,66,52,118,2.7679324894514767,39.605722756190936
Task_13013,1795,782,140,63,203,2.292464878671775,37.7621191613264
Task_13014,1331,991,186,92,278,1.341733870967742,31.760029574954853
Task_13015,1065,977,93,163,256,1.0889570552147239,27.611339536827227
Task_13016,826,952,185,33,218,0.8667366211962224,22.78493148820971
Task_13017,2684,1017,130,68,198,2.6365422396856584,52.5866852619074
Task_13018,1255,1015,18,183,201,1.235236220472441,30.35451279809097
Task_13019,2336,946,62,43,105,2.466737064413939,45.474274976098606
Task_13020,1884,768,150,93,243,2.4499349804941484,39.74841045015835
Task_13021,2273,168,27,25,52,13.449704142011834,41.57779588971935
Task_13022,709,244,72,27,99,2.8938775510204082,17.668122603224045
Task_13023,1929,679,32,54,86,2.836764705882353,38.490978389986836
Task_13024,1292,193,133,15,148,6.65979381443299,27.033195132825664
Task_13025,2369,429,182,89,271,5.5093023255813955,46.349286092164846
Task_13026,702,1001,68,168,236,0.7005988023952096,22.048442861329637
Task_13027,558,900,172,191,363,0.6193118756936737,20.016756031695465
Task_13028,668,924,176,108,284,0.7221621621621621,21.270993685460187
Task_13029,2016,298,30,177,207,6.74247491638796,40.396435195545955
Task_13030,2637,188,125,112,237,13.952380952380953,49.83476690376326
Task_13031,1072,314,158,17,175,3.403174603174603,24.135423667461495
Task_13032,1677,281,93,178,271,5.946808510638298,35.34011652042484
Task_13033,2078,484,49,163,212,4.284536082474227,42.1125050198245
Task_13034,1754,788,37,24,61,2.223067173637516,35.283759771551864
Task_13035,2224,805,24,88,112,2.759305210918114,44.28894524310195
Task_13036,714,457,151,52,203,1.5589519650655022,19.64345668205946
Task_13037,2199,542,100,32,132,4.0497237569060776,42.62402704638529
Task_13038,2482,958,111,114,225,2.5881126173096978,49.83149787977603
Task_13039,2371,152,17,126,143,15.49673202614379,44.11020609615997
Task_13040,1345,81,107,146,253,16.402439024390244,28.3692473266732
Task_13041,1804,909,44,199,243,1.9824175824175825,39.15474674904861
Task_13042,1407,207,196,171,367,6.764423076923077,31.127172663863714
Task_13043,2877,650,95,102,197,4.419354838709677,55.04757205177277
Task_13044,784,448,188,119,307,1.7461024498886415,21.704779298356254
Task_13045,546,906,177,45,222,0.6019845644983461,18.54993076934037
Task_13046,2307,574,190,10,200,4.012173913043478,44.79366491881384
Task_13047,2262,920,38,127,165,2.456026058631922,45.912242532031314
Task_13048,572,670,161,117,278,0.8524590163934426,18.842624140063602
Task_13049,2365,745,132,27,159,3.170241286863271,45.8897510999007
Task_13050,1524,796,158,50,208,1.9121706398996237,33.34017943422322
Task_13051,892,454,13,121,134,1.9604395604395604,22.443351929122702
Task_13052,2746,892,127,82,209,3.0750279955207165,53.40629555022432
Task_13053,1047,944,47,189,236,1.107936507936508,27.02821109793726
Task_13054,616,202,160,94,254,3.0344827586206895,17.945346601979278
Task_13055,2228,680,36,68,104,3.2716593245227608,43.5640555676732
Task_13056,1624,237,100,99,199,6.823529411764706,33.783197040736006
Task_13057,1490,444,45,46,91,3.348314606741573,30.520638931274288
Task_13058,1994,441,59,39,98,4.51131221719457,38.464690960726024
Task_13059,2923,522,75,198,273,5.588910133843212,55.914378771516255
Task_13060,2590,909,104,141,245,2.8461538461538463,51.519638898556444
Task_13061,2027,540,89,87,176,3.746765249537893,40.6634548838312
Task_13062,2064,975,155,52,207,2.1147540983606556,42.676359716900144
Task_13063,2814,352,121,179,300,7.971671388101983,53.58277726862085
Task_13064,2879,506,153,108,261,5.678500986193294,54.84372478080822
Task_13065,2024,852,38,68,106,2.372801875732708,40.89875431725702
Task_13066,2567,118,138,138,276,21.571428571428573,48.14103274855364
Task_13067,2085,1020,54,102,156,2.0421155729676785,43.24173284352875
Task_13068,810,804,34,62,96,1.0062111801242235,21.21312921262204
Task_13069,2617,825,185,85,270,3.168280871670702,51.440333373801224
Task_13070,2080,206,121,49,170,10.048309178743962,39.85671435852442
Task_13071,1630,610,197,178,375,2.6677577741407528,36.01478857426471
Task_13072,1026,1006,54,120,174,1.0188679245283019,26.558862972905587
Task_13073,2274,336,155,192,347,6.747774480712166,45.217831822985666
Task_13074,929,826,130,137,267,1.1233373639661426,24.87774156504977
Task_13075,1414,339,64,66,130,4.158823529411765,29.95550291667314
Task_13076,2054,117,60,130,190,17.406779661016948,39.736883745927315
Task_13077,2588,928,145,49,194,2.7857911733046286,50.55848119619253
Task_13078,1457,615,107,163,270,2.36525974025974,32.79543835229454
Task_13079,2863,530,82,152,234,5.391713747645951,54.70347267026454
Task_13080,1346,689,53,52,105,1.9507246376811593,29.447442968053135
Task_13081,959,386,51,21,72,2.4780361757105944,21.4232523935349
Task_13082,1910,814,115,22,137,2.3435582822085887,38.824925820880686
Task_13083,2558,485,113,125,238,5.2633744855967075,49.614984494561725
Task_13084,1615,196,107,48,155,8.197969543147208,32.21590890581871
Task_13085,569,306,168,129,297,1.8534201954397393,17.83889655849384
Task_13086,859,949,37,154,191,0.9042105263157895,23.811553540924024
Task_13087,792,156,44,52,96,5.044585987261146,18.670946930833427
Task_13088,1037,749,21,107,128,1.3826666666666667,25.61770459400758
Task_13089,1824,664,86,72,158,2.742857142857143,37.45776508353976
Task_13090,2936,410,81,152,233,7.143552311435523,55.47157715231132
Task_13091,2244,677,83,50,133,3.309734513274336,43.82115433455931
Task_13092,1243,739,61,56,117,1.6797297297297298,28.166515387068884
Task_13093,650,752,51,32,83,0.8632138114209827,18.309635603641457
Task_13094,2801,378,179,167,346,7.3905013192612135,53.65540705010435
Task_13095,2322,335,160,42,202,6.910714285714286,44.40398183463398
Task_13096,608,113,198,160,358,5.333333333333333,17.611224825931522
Task_13097,2850,389,107,94,201,7.3076923076923075,53.65173163946459
Task_13098,627,153,149,52,201,4.071428571428571,17.079434045391938
Task_13099,1476,902,158,37,195,1.6345514950166113,32.802909248639445
Task_13100,1760,523,16,74,90,3.3587786259541983,35.58246487090725
Task_13101,2355,902,152,175,327,2.60797342192691,48.193529436225674
Task_13102,1024,555,96,193,289,1.841726618705036,25.933037091163857
Task_13103,984,703,58,184,242,1.3977272727272727,25.54104101881286
Task_13104,855,504,167,93,260,1.693069306930693,22.68881377269908
Task_13105,2620,639,47,180,227,4.09375,51.171930392920444
Task_13106,1127,160,149,101,250,7.0,25.626336203011714
Task_13107,2511,200,27,51,78,12.492537313432836,45.70977777712374
Task_13108,2496,69,159,139,298,35.65714285714286,46.48574783666958
Task_13109,1492,196,120,176,296,7.573604060913706,32.070804836124665
Task_13110,2368,793,163,191,354,2.982367758186398,48.20377373542602
Task_13111,2486,769,152,83,235,3.2285714285714286,49.00987877860317
Task_13112,2887,493,129,31,160,5.84412955465587,53.416324798487324
Task_13113,1284,187,119,140,259,6.829787234042553,28.686954498776004
Task_13114,1593,981,48,88,136,1.6221995926680244,35.08712283289491
Task_13115,1065,371,75,29,104,2.8629032258064515,23.794180469492506
Task_13116,2549,431,158,73,231,5.900462962962963,48.781474192062014
Task_13117,1897,938,77,39,116,2.020234291799787,38.85112173322173
Task_13118,1041,848,139,180,319,1.226148409893993,27.053621785309875
Task_13119,1730,201,78,181,259,8.564356435643564,35.86266601956565
Task_13120,1229,949,73,193,266,1.2936842105263158,30.275892174186975
Task_13121,1196,103,200,165,365,11.5,26.70148336710837
Task_13122,2894,344,160,68,228,8.388405797101449,53.892752189760216
Task_13123,1295,180,70,182,252,7.154696132596685,28.485919320658027
Task_13124,1339,816,134,81,215,1.6389228886168912,30.852639940777664
Task_13125,539,804,19,81,100,0.6695652173913044,17.446998390969707
Task_13126,2851,431,118,97,215,6.599537037037037,53.964563957064065
Task_13127,1359,993,81,118,199,1.3672032193158954,32.06191077344272
Task_13128,2488,430,90,157,247,5.77262180974478,48.464156143164395
Task_13129,2123,863,109,117,226,2.457175925925926,43.85556275032442
Task_13130,994,723,49,162,211,1.37292817679558,25.580296456269735
Task_13131,1012,443,79,10,89,2.279279279279279,22.92538478714327
Task_13132,1013,987,125,100,225,1.0253036437246963,26.494229924871934
Task_13133,1019,902,142,200,342,1.1284606866002216,26.969424955042555
Task_13134,1866,466,173,160,333,3.9957173447537473,39.078949311871725
Task_13135,1786,81,16,16,32,21.78048780487805,32.41430748110688
Task_13136,2074,529,44,54,98,3.913207547169811,40.40166878112825
Task_13137,1138,655,114,74,188,1.7347560975609757,26.954250896423996
Task_13138,2029,156,165,182,347,12.92356687898089,40.38867481638125
Task_13139,2175,728,87,76,163,2.983539094650206,43.4145390264417
Task_13140,638,305,194,175,369,2.084967320261438,19.318646938693828
Task_13141,2935,450,163,137,300,6.507760532150776,55.7650460884203
Task_13142,2039,806,54,79,133,2.526641883519207,41.6464989036679
Task_13143,2744,215,33,188,221,12.703703703703704,51.681528441778596
Task_13144,1516,261,17,179,196,5.786259541984733,32.216489428218125
Task_13145,2108,176,92,178,270,11.909604519774012,41.317977279437905
Task_13146,1080,604,155,23,178,1.7851239669421488,25.266955664449014
Task_13147,1611,741,20,125,145,2.1711590296495955,34.72834015154286
Task_13148,2219,215,47,162,209,10.273148148148149,43.30216964690444
Task_13149,2132,805,110,197,307,2.6451612903225805,44.29933709738796
Task_13150,1244,656,137,132,269,1.8934550989345509,29.50023905805089
Task_13151,1337,515,53,106,159,2.5910852713178296,29.839398060614243
Task_13152,1310,451,40,192,232,2.898230088495575,29.834512191465176
Task_13153,2323,507,98,91,189,4.572834645669292,45.53680739076734
Task_13154,2126,147,82,61,143,14.364864864864865,40.035328252448416
Task_13155,2011,272,83,137,220,7.366300366300366,40.23995494914484
Task_13156,1034,866,110,191,301,1.1926182237600922,26.974625411986228
Task_13157,1834,854,48,132,180,2.1450292397660817,39.00469429287773
Task_13158,2776,529,177,162,339,5.2377358490566035,53.718243575999075
Task_13159,1580,93,51,133,184,16.80851063829787,31.689229604144305
Task_13160,1863,374,155,49,204,4.968,37.364893907880365
Task_13161,1248,601,176,24,200,2.0730897009966776,28.192366183509193
Task_13162,1689,170,130,46,176,9.87719298245614,33.240743666776986
Task_13163,667,298,24,54,78,2.230769230769231,16.94245345340867
Task_13164,2791,645,49,97,146,4.320433436532507,53.29472841024622
Task_13165,2155,113,101,44,145,18.903508771929825,39.8347578566136
Task_13166,1790,281,63,153,216,6.347517730496454,36.8577947777821
Task_13167,2966,419,183,190,373,7.061904761904762,56.559437325015985
Task_13168,2478,168,184,121,305,14.662721893491124,47.255408662828565
Task_13169,1412,171,173,156,329,8.209302325581396,30.530765434847822
Task_13170,1193,907,94,146,240,1.3138766519823788,29.38526620330745
Task_13171,963,464,179,74,253,2.0709677419354837,23.935472876831238
Task_13172,2588,723,190,76,266,3.574585635359116,50.54234938742295
Task_13173,2970,657,167,38,205,4.513677811550152,55.76427635174235
Task_13174,1658,237,132,65,197,6.966386554621849,33.83619646096271
Task_13175,522,468,88,78,166,1.1130063965884862,16.38892570638781
Task_13176,925,475,20,35,55,1.9432773109243697,21.270569256483622
Task_13177,1419,222,120,82,202,6.36322869955157,30.21253556826343
Task_13178,2985,187,146,63,209,15.877659574468085,54.83084886929118
Task_13179,1637,594,189,27,216,2.7512605042016807,34.416986720322015
Task_13180,708,250,181,22,203,2.8207171314741037,18.535385897150558
Task_13181,2701,692,73,69,142,3.8975468975468974,51.4510275603569
Task_13182,2810,790,175,26,201,3.552465233881163,53.55832100770298
Task_13183,1371,751,27,191,218,1.8231382978723405,31.70567150479687
Task_13184,1076,427,11,163,174,2.514018691588785,25.678828523769777
Task_13185,1095,921,151,15,166,1.1876355748373102,26.351794776563196
Task_13186,2559,241,176,48,224,10.574380165289256,47.93195813539409
Task_13187,1270,242,98,170,268,5.226337448559671,28.652076300933672
Task_13188,2709,79,57,31,88,33.8625,47.452040947603145
Task_13189,2947,615,179,93,272,4.784090909090909,56.233950770636206
Task_13190,1472,936,44,164,208,1.5709711846318035,33.729645729944714
Task_13191,2795,776,160,157,317,3.597168597168597,54.6986133557632
Task_13192,1091,174,148,187,335,6.234285714285714,25.52765949266957
Task_13193,1248,1008,14,168,182,1.2368681863230921,30.0058400480593
Task_13194,1980,290,186,172,358,6.804123711340206,40.43207939757463
Task_13195,546,725,88,143,231,0.7520661157024794,18.421885750185755
Task_13196,1347,661,161,51,212,2.0347432024169185,30.3052068547111
Task_13197,1512,248,10,95,105,6.072289156626506,31.196584037618834
Task_13198,874,716,65,180,245,1.2189679218967922,23.76637564207964
Task_13199,1815,101,92,30,122,17.794117647058822,34.47427696246306
Task_13200,2185,484,123,97,220,4.505154639175258,43.61846603746679
Task_13201,583,789,96,81,177,0.7379746835443038,18.46801799580516
Task_13202,1990,953,11,58,69,2.0859538784067087,39.82868917222793
Task_13203,2267,760,97,199,296,2.978975032851511,46.27420039452096
Task_13204,2814,147,120,101,221,19.013513513513512,51.99202660919256
Task_13205,1309,119,144,48,192,10.908333333333333,27.190163382397355
Task_13206,2394,682,179,165,344,3.505124450951684,48.183418103146174
Task_13207,1259,609,107,154,261,2.0639344262295083,29.58714438344951
Task_13208,2958,413,88,27,115,7.144927536231884,53.943212790826514
Task_13209,2220,425,126,168,294,5.211267605633803,44.38509122025696
Task_13210,2797,83,11,135,146,33.29761904761905,50.19185170809851
Task_13211,1615,89,157,191,348,17.944444444444443,33.19663408179961
Task_13212,2272,105,20,172,192,21.433962264150942,42.787775359339484
Task_13213,2636,962,179,104,283,2.7372793354101765,52.53106886627044
Task_13214,1633,460,156,187,343,3.542299349240781,35.4562595580074
Task_13215,2348,903,170,181,351,2.5973451327433628,48.20269779262831
Task_13216,1793,971,94,129,223,1.8446502057613168,39.050498204725876
Task_13217,2355,634,75,45,120,3.7086614173228347,45.130112964972405
Task_13218,1081,257,35,194,229,4.189922480620155,25.591395672942372
Task_13219,1667,277,123,28,151,5.996402877697841,33.319584080528756
Task_13220,1242,83,31,97,128,14.785714285714286,25.844230515425874
Task_13221,1339,329,54,91,145,4.057575757575758,29.159771710017193
Task_13222,1944,264,146,64,210,7.335849056603774,38.492114786236826
Task_13223,1264,572,91,199,290,2.2059336823734728,29.796361930082046
Task_13224,2317,396,43,121,164,5.836272040302267,45.06826682260786
Task_13225,1049,866,128,133,261,1.209919261822376,26.905830188819525
Task_13226,664,664,179,137,316,0.9984962406015038,20.460303703733153
Task_13227,1675,1010,37,50,87,1.6567754698318498,35.303278621539604
Task_13228,1769,260,169,113,282,6.777777777777778,36.56416116420317
Task_13229,2852,282,135,198,333,10.07773851590106,54.11370844752074
Task_13230,2892,978,126,171,297,2.9540347293156284,56.79904692607064
Task_13231,2260,947,63,61,124,2.3839662447257384,44.951737606065954
Task_13232,1923,495,32,23,55,3.877016129032258,37.12952464450261
Task_13233,2642,861,144,135,279,3.0649651972157774,52.33788204165601
Task_13234,1889,898,91,36,127,2.1012235817575085,38.744253745744224
Task_13235,583,132,52,43,95,4.383458646616542,14.72496580967323
Task_13236,2429,793,159,121,280,3.05919395465995,48.73405742140437
Task_13237,2112,618,59,102,161,3.4119547657512115,42.4413597311056
Task_13238,1169,608,98,81,179,1.9195402298850575,27.180530596815604
Task_13239,2227,92,174,122,296,23.946236559139784,42.474080422788724
Task_13240,879,110,75,75,150,7.918918918918919,20.100578143079243
Task_13241,799,750,97,61,158,1.0639147802929427,21.2414625691119
Task_13242,2183,151,136,40,176,14.361842105263158,40.94509927679315
Task_13243,816,127,187,121,308,6.375,20.75854096010823
Task_13244,1141,711,186,57,243,1.6025280898876404,27.317940062180828
Task_13245,1859,177,38,120,158,10.4438202247191,36.297704889526905
Task_13246,1433,105,128,91,219,13.518867924528301,29.557333764403385
Task_13247,1805,783,44,94,138,2.302295918367347,37.857668765039485
Task_13248,1974,876,166,106,272,2.250855188141391,41.72643892449451
Task_13249,681,364,23,187,210,1.8657534246575342,19.582790589374742
Task_13250,2813,368,107,165,272,7.623306233062331,53.474885841158255
Task_13251,2304,616,69,111,180,3.73419773095624,45.6706133323461
Task_13252,2306,715,167,16,183,3.2206703910614527,44.941935087118374
Task_13253,1806,985,15,76,91,1.8316430020283976,37.79197419440958
Task_13254,2099,955,154,143,297,2.1956066945606696,44.12002947790173
Task_13255,2973,651,91,155,246,4.559815950920245,56.84892772844058
Task_13256,753,431,105,167,272,1.7430555555555556,21.07341475535092
Task_13257,751,779,117,19,136,0.9628205128205128,20.29069233881421
Task_13258,1836,191,77,155,232,9.5625,37.30992807438589
Task_13259,1778,816,25,92,117,2.17625458996328,37.45243342969124
Task_13260,745,71,90,40,130,10.347222222222221,17.03422030323663
Task_13261,1203,730,129,138,267,1.6456908344733243,29.067703460010836
Task_13262,1079,879,10,159,169,1.2261363636363636,26.824408879240465
Task_13263,650,975,64,70,134,0.6659836065573771,20.05755728537329
Task_13264,1316,256,25,100,125,5.120622568093385,28.488975381719666
Task_13265,1703,581,155,33,188,2.9261168384879723,35.31303320055008
Task_13266,733,406,110,78,188,1.800982800982801,19.836737187562278
Task_13267,2312,891,194,165,359,2.591928251121076,47.60742023234352
Task_13268,2475,406,182,50,232,6.081081081081081,47.26878879889037
Task_13269,2258,236,95,51,146,9.527426160337553,42.89110651021624
Task_13270,1440,141,149,107,256,10.140845070422536,30.47137276703361
Task_13271,815,682,128,21,149,1.1932650073206441,21.087641302105396
Task_13272,2672,176,106,80,186,15.096045197740112,49.211317257338784
Task_13273,2521,882,80,189,269,2.855039637599094,50.647754410669485
Task_13274,2247,926,14,60,74,2.423948220064725,43.88424377260235
Task_13275,609,497,121,190,311,1.2228915662650603,19.100080748006082
Task_13276,2284,766,46,93,139,2.9778357235984356,45.39919043258143
Task_13277,1960,983,145,156,301,1.991869918699187,42.04150895673023
Task_13278,2029,579,58,168,226,3.4982758620689656,41.70395471224979
Task_13279,2599,244,16,119,135,10.608163265306123,48.638869725003644
Task_13280,664,604,28,104,132,1.0975206611570247,19.088803185785988
Task_13281,1172,355,12,183,195,3.292134831460674,27.153637341747892
Task_13282,1893,941,135,164,299,2.0095541401273884,40.85196963303725
Task_13283,2063,920,187,68,255,2.239956568946797,42.70073348686653
Task_13284,627,216,117,99,216,2.889400921658986,18.041990208948686
Task_13285,2264,498,141,118,259,4.537074148296593,45.0871324618866
Task_13286,521,938,190,36,226,0.5548455804046858,18.224230589820014
Task_13287,1907,117,144,35,179,16.161016949152543,36.383087823805525
Task_13288,2970,668,27,107,134,4.439461883408072,55.984291374867546
Task_13289,2425,676,77,118,195,3.5819793205317576,48.04095954572904
Task_13290,686,167,111,170,281,4.083333333333333,18.931996307828417
Task_13291,1057,995,142,153,295,1.0612449799196788,27.600729444384054
Task_13292,2347,782,13,166,179,2.9974457215836527,46.88904786322792
Task_13293,1159,193,193,143,336,5.974226804123711,26.987222624224497
Task_13294,1417,510,180,147,327,2.7729941291585125,32.06503577672378
Task_13295,1540,115,119,140,259,13.275862068965518,31.830084277328496
Task_13296,2157,900,163,182,345,2.3940066592674807,45.14130695556412
Task_13297,2787,816,10,102,112,3.4112607099143206,53.37034404901203
Task_13298,1530,109,166,139,305,13.909090909090908,31.674391554575863
Task_13299,1516,826,36,15,51,1.8331318016928657,31.484466996357597
Task_13300,2201,149,28,72,100,14.673333333333334,40.8771510095892
Task_13301,2135,574,118,161,279,3.7130434782608694,43.44071674484928
Task_13302,1486,147,145,16,161,10.04054054054054,29.672456959729846
Task_13303,2813,536,52,135,187,5.238361266294227,53.7345233411296
Task_13304,1810,84,16,114,130,21.294117647058822,34.543172503518285
Task_13305,2600,234,113,190,303,11.063829787234043,49.80620426048889
Task_13306,1830,928,10,17,27,1.969860064585576,36.49013623288532
Task_13307,2728,632,98,64,162,4.309636650868878,51.64636007538561
Task_13308,2202,939,122,69,191,2.342553191489362,44.64393042528285
Task_13309,1979,248,172,53,225,7.947791164658635,39.08773210590039
Task_13310,2641,308,27,49,76,8.546925566343042,47.88566098857503
Task_13311,1174,314,46,46,92,3.726984126984127,25.202915872266402
Task_13312,723,936,23,53,76,0.7716115261472786,19.88114260436247
Task_13313,2721,379,172,127,299,7.160526315789474,52.1226134802468
Task_13314,2263,665,177,42,219,3.3978978978978978,44.614899181457254
Task_13315,2897,340,153,159,312,8.495601173020528,54.87899995463655
Task_13316,793,878,87,199,286,0.9021615472127418,23.103394858155784
Task_13317,2012,862,167,52,219,2.331402085747393,41.55464535323303
Task_13318,2252,659,118,175,293,3.412121212121212,45.64643234675302
Task_13319,848,829,173,79,252,1.0216867469879518,23.250150560463776
Task_13320,2663,347,99,85,184,7.652298850574713,50.045677154899465
Task_13321,873,408,143,98,241,2.1344743276283618,22.675901655901622
Task_13322,1771,322,107,95,202,5.4829721362229105,36.39186294587017
Task_13323,2975,927,95,117,212,3.2058189655172415,57.562719862192075
Task_13324,1323,665,118,123,241,1.9864864864864864,30.640221278965708
Task_13325,2656,759,145,190,335,3.4947368421052634,52.57252023126531
Task_13326,923,220,35,103,138,4.176470588235294,22.103928891789618
Task_13327,962,124,166,173,339,7.696,23.272555436445042
Task_13328,1685,828,184,158,342,2.0325693606755126,37.389635128740544
Task_13329,2607,449,199,101,300,5.793333333333333,50.517457335132654
Task_13330,1222,469,50,78,128,2.6,27.815525677921183
Task_13331,727,639,192,41,233,1.1359375,20.315730992329218
Task_13332,2339,423,95,25,120,5.5165094339622645,44.257084862747696
Task_13333,1412,359,143,193,336,3.922222222222222,31.611232308800457
Task_13334,2686,183,38,32,70,14.597826086956522,48.30390066210592
Task_13335,680,411,50,151,201,1.6504854368932038,19.701403929117735
Task_13336,535,118,170,183,353,4.495798319327731,16.589737286398616
Task_13337,1883,98,74,61,135,19.02020202020202,35.5535913732092
Task_13338,776,384,72,200,272,2.0155844155844154,21.478203595676163
Task_13339,2559,424,77,87,164,6.021176470588236,48.86152963931692
Task_13340,2203,279,137,97,234,7.867857142857143,43.283686748105275
Task_13341,1687,864,199,70,269,1.9502890173410405,36.63081532173308
Task_13342,2647,346,90,24,114,7.628242074927954,48.808105568738114
Task_13343,850,753,23,182,205,1.1273209549071619,23.233551080684567
Task_13344,2105,82,91,152,243,25.36144578313253,40.27327337658542
Task_13345,1296,181,82,45,127,7.1208791208791204,26.667613842417307
Task_13346,938,956,66,27,93,0.9801462904911181,23.74424121768654
Task_13347,600,195,105,74,179,3.061224489795918,16.76861534412112
Task_13348,513,751,106,139,245,0.6821808510638298,18.179750115010034
Task_13349,2537,1021,84,98,182,2.4823874755381605,50.54755044887884
Task_13350,2072,400,80,118,198,5.167082294264339,41.582528112968944
Task_13351,2145,95,81,19,100,22.34375,38.84126129212926
Task_13352,1448,906,114,124,238,1.5964718853362734,33.344906374690254
Task_13353,1934,773,129,104,233,2.498708010335917,40.59254865859145
Task_13354,2297,885,103,42,145,2.5925507900677203,45.30779244438572
Task_13355,2539,832,196,59,255,3.0480192076830734,49.86969539133207
Task_13356,1365,797,112,123,235,1.7105263157894737,31.67629119502961
Task_13357,1747,539,192,180,372,3.2351851851851854,37.632853862709204
Task_13358,918,868,173,161,334,1.0563866513233602,25.201490667588487
Task_13359,2219,903,104,182,286,2.454646017699115,45.86715346452795
Task_13360,886,129,190,131,321,6.815384615384615,21.941048311123676
Task_13361,2842,451,12,97,109,6.287610619469026,53.03768405794566
Task_13362,1472,320,109,17,126,4.585669781931464,30.100306576591976
Task_13363,1705,376,118,13,131,4.522546419098143,34.10253617843261
Task_13364,899,902,98,172,270,0.9955703211517165,24.777948088107195
Task_13365,2329,898,51,182,233,2.590656284760845,47.55159321358999
Task_13366,2795,357,92,98,190,7.807262569832402,52.752400418227786
Task_13367,1847,525,181,31,212,3.511406844106464,37.56220217067674
Task_13368,655,461,169,40,209,1.4177489177489178,18.470397390456892
Task_13369,2633,931,141,17,158,2.825107296137339,50.51825582725842
Task_13370,725,843,16,108,124,0.8590047393364929,20.752258046493044
Task_13371,2423,450,96,141,237,5.37250554323725,47.43595028351668
Task_13372,1683,845,132,71,203,1.9893617021276595,36.22104556546303
Task_13373,2372,985,196,127,323,2.4056795131845843,48.63325117298135
Task_13374,2386,888,151,61,212,2.683914510686164,47.42672671829687
Task_13375,2603,278,52,61,113,9.329749103942651,48.27186760216674
Task_13376,2635,701,74,20,94,3.7535612535612537,49.48519741462683
Task_13377,736,612,148,112,260,1.200652528548124,21.1656369635464
Task_13378,1298,828,132,48,180,1.5657418576598312,29.496568506798127
Task_13379,597,570,144,79,223,1.0455341506129596,18.348664466712926
Task_13380,1406,411,161,10,171,3.412621359223301,29.668425097123365
Task_13381,778,604,58,98,156,1.2859504132231405,21.09068666487603
Task_13382,2789,422,180,32,212,6.59338061465721,52.14110561499154
Task_13383,996,136,63,133,196,7.2700729927007295,23.305340095207487
Task_13384,2134,786,30,89,119,2.7115628970775094,42.895406233753214
Task_13385,745,221,137,170,307,3.355855855855856,20.45084995972654
Task_13386,2906,382,188,186,374,7.587467362924282,55.484248670651404
Task_13387,2074,283,65,145,210,7.302816901408451,41.312501168019416
Task_13388,896,663,144,87,231,1.3493975903614457,23.4822728010632
Task_13389,1390,413,83,25,108,3.357487922705314,29.01051429546888
Task_13390,2820,555,187,109,296,5.071942446043166,54.22728068244394
Task_13391,1653,360,55,49,104,4.578947368421052,32.968673055602416
Task_13392,2753,244,161,53,214,11.236734693877551,51.251855431993505
Task_13393,921,258,37,165,202,3.555984555984556,22.89276626151701
Task_13394,1944,487,50,95,145,3.9836065573770494,39.388808487031795
Task_13395,1232,935,85,65,150,1.3162393162393162,28.781137949461908
Task_13396,1435,310,72,199,271,4.614147909967846,31.657302265739546
Task_13397,2976,324,114,68,182,9.156923076923077,54.71753978943821
Task_13398,1735,79,142,23,165,21.6875,33.11292350577336
Task_13399,1981,673,182,103,285,2.9391691394658754,41.25652231668238
Task_13400,1802,800,184,121,305,2.2496878901373285,38.93504920475482
Task_13401,1815,927,46,86,132,1.9558189655172413,38.38651515887722
Task_13402,888,192,125,137,262,4.601036269430052,22.364637852371374
Task_13403,2351,216,155,71,226,10.834101382488479,44.84733583736013
Task_13404,1413,215,62,130,192,6.541666666666667,30.52960895755894
Task_13405,2609,385,42,165,207,6.759067357512953,50.025450140000906
Task_13406,1422,725,58,113,171,1.9586776859504131,32.021753559355524
Task_13407,843,791,75,186,261,1.0643939393939394,23.553841082378884
Task_13408,1296,606,157,191,348,2.1350906095551894,30.610073381572477
Task_13409,1014,434,86,141,227,2.331034482758621,25.02810636368339
Task_13410,1366,924,170,176,346,1.4767567567567568,32.62398052157415
Task_13411,1225,911,168,149,317,1.343201754385965,30.19255902862673
Task_13412,2286,916,154,136,290,2.4929116684841874,46.919934302894745
Task_13413,2418,484,18,195,213,4.985567010309278,47.35953572588648
Task_13414,1008,149,132,92,224,6.72,23.416188424589844
Task_13415,1229,784,73,31,104,1.5656050955414014,27.66754902335857
Task_13416,2005,273,18,128,146,7.317518248175182,39.42536967268655
Task_13417,2533,97,63,94,157,25.846938775510203,46.202647841779175
Task_13418,946,424,17,18,35,2.2258823529411766,20.827482620306956
Task_13419,2017,675,93,57,150,2.9837278106508878,40.46728847465363
Task_13420,1351,868,10,141,151,1.5546605293440736,30.96502943030782
Task_13421,2230,614,160,73,233,3.6260162601626016,44.328878440183864
Task_13422,1415,637,91,57,148,2.217868338557994,30.760965566309793
Task_13423,1940,550,96,177,273,3.5208711433756807,40.32595451926862
Task_13424,577,693,11,15,26,0.8314121037463977,16.199921382930153
Task_13425,810,244,186,141,327,3.306122448979592,21.601078435704746
Task_13426,1091,193,38,188,226,5.623711340206185,25.499646263125612
Task_13427,1890,288,176,110,286,6.539792387543253,38.58704629539312
Task_13428,1335,352,14,162,176,3.781869688385269,29.493764304124564
Task_13429,569,124,19,93,112,4.552,15.22808778982995
Task_13430,2370,186,138,121,259,12.67379679144385,45.83753083357717
Task_13431,770,189,159,62,221,4.052631578947368,19.81634378470742
Task_13432,2233,578,28,174,202,3.856649395509499,44.71828116915859
Task_13433,1859,191,130,181,311,9.682291666666666,37.954092123066395
Task_13434,1327,385,136,22,158,3.437823834196891,28.289591243427804
Task_13435,877,741,22,133,155,1.1819407008086253,22.959627713419156
Task_13436,1817,973,105,180,285,1.8655030800821355,39.707436270644806
Task_13437,1551,897,72,24,96,1.7271714922048997,33.04211396571477
Task_13438,1840,214,33,139,172,8.55813953488372,37.04314854071936
Task_13439,1703,290,176,144,320,5.852233676975945,35.84076486742168
Task_13440,1514,754,83,27,110,2.0052980132450333,32.04371069032808
Task_13441,1526,336,28,59,87,4.528189910979228,30.943892370066028
Task_13442,2090,682,64,112,176,3.060029282576867,42.50506325880776
Task_13443,2005,415,115,121,236,4.819711538461538,40.619698621472104
Task_13444,2438,850,64,182,246,2.864864864864865,49.11934874372442
Task_13445,2658,856,160,81,241,3.1015169194865813,52.00216324495872
Task_13446,2920,185,156,91,247,15.698924731182796,54.0212286243218
Task_13447,1091,131,31,157,188,8.265151515151516,24.56159128773699
Task_13448,1107,743,130,49,179,1.4879032258064515,26.26555710450019
Task_13449,890,1020,82,13,95,0.871694417238002,23.011842205114004
Task_13450,1266,140,200,134,334,8.97872340425532,28.120941115626476
Task_13451,1686,912,91,24,115,1.8466593647316538,35.377240545281715
Task_13452,2958,662,112,144,256,4.461538461538462,56.626048959592424
Task_13453,876,534,126,119,245,1.6373831775700936,23.150915227623198
Task_13454,648,910,158,155,313,0.7113062568605928,21.110455256526322
Task_13455,2862,437,24,124,148,6.534246575342466,53.584769256246794
Task_13456,1232,287,48,44,92,4.277777777777778,26.033600846572543
Task_13457,1288,659,93,68,161,1.9515151515151514,28.966754635972382
Task_13458,1925,352,148,157,305,5.453257790368272,39.51070957149848
Task_13459,2841,220,195,157,352,12.855203619909503,53.730343540852026
Task_13460,2602,894,19,55,74,2.9072625698324024,49.443741660557485
Task_13461,2239,985,191,197,388,2.27079107505071,46.92119844544941
Task_13462,1287,254,102,53,155,5.047058823529412,27.58360768088581
Task_13463,2710,306,33,145,178,8.827361563517915,51.04813306976635
Task_13464,2100,318,184,166,350,6.58307210031348,42.38035264586523
Task_13465,1468,807,46,59,105,1.816831683168317,31.675550772780024
Task_13466,1241,167,115,109,224,7.386904761904762,27.33749904685385
Task_13467,799,500,141,89,230,1.594810379241517,21.53057810420906
Task_13468,1245,874,155,102,257,1.4228571428571428,30.02755948209962
Task_13469,2212,449,200,146,346,4.915555555555556,44.538773000382285
Task_13470,1515,838,123,85,208,1.8057210965435042,33.74155369957538
Task_13471,1310,623,77,51,128,2.0993589743589745,29.16007502931456
Task_13472,1924,585,101,173,274,3.2832764505119454,40.129323497937065
Task_13473,1877,496,151,35,186,3.7766599597585513,37.6994453304004
Task_13474,620,449,44,64,108,1.3777777777777778,17.294509558684037
Task_13475,1934,173,67,164,231,11.114942528735632,38.420749734226916
Task_13476,2399,106,72,31,103,22.42056074766355,43.146895290424446
Task_13477,1997,777,99,183,282,2.5668380462724936,41.94147398426737
Task_13478,2582,906,74,194,268,2.846747519294377,51.696674499369315
Task_13479,1519,255,132,52,184,5.93359375,31.4722335725879
Task_13480,519,633,178,143,321,0.8186119873817035,18.112136583938376
Task_13481,1063,973,48,200,248,1.091375770020534,27.51461996920155
Task_13482,1989,861,54,11,65,2.3074245939675175,39.007613074413236
Task_13483,2567,998,43,74,117,2.5695695695695697,50.32217517568296
Task_13484,518,278,167,194,361,1.8566308243727598,17.32746815576908
Task_13485,685,870,103,126,229,0.7864523536165328,21.067084312081672
Task_13486,1901,605,142,34,176,3.136963696369637,38.34536142341747
Task_13487,2087,112,75,100,175,18.469026548672566,39.90211434442733
Task_13488,945,961,18,40,58,0.9823284823284824,23.302175708225672
Task_13489,1725,257,143,184,327,6.686046511627907,36.16531394568989
Task_13490,2805,459,72,175,247,6.0978260869565215,53.68082887717353
Task_13491,609,199,46,57,103,3.045,16.18854667797005
Task_13492,2631,169,96,81,177,15.476470588235294,48.61718951080591
Task_13493,805,669,165,143,308,1.2014925373134329,22.697236786409444
Task_13494,2082,723,72,181,253,2.8756906077348066,43.11052782254561
Task_13495,2875,321,191,51,242,8.928571428571429,53.52454727730149
Task_13496,1734,535,196,44,240,3.235074626865672,35.91266425573023
Task_13497,1377,493,151,64,215,2.7874493927125505,30.296345030224057
Task_13498,2248,76,83,113,196,29.194805194805195,42.19672727927124
Task_13499,2484,304,57,140,197,8.144262295081967,47.83500354563026
Task_13500,1771,409,146,148,294,4.319512195121951,37.19822184770403
Task_13501,2237,973,172,160,332,2.2967145790554415,46.54552556672238
Task_13502,2396,441,57,167,224,5.420814479638009,47.064563510517296
Task_13503,1573,721,101,136,237,2.1786703601108033,34.77614118992465
Task_13504,2171,625,22,198,220,3.4680511182108624,43.93025741274655
Task_13505,2653,957,145,58,203,2.769311064718163,51.84498250356874
Task_13506,1093,185,98,44,142,5.876344086021505,23.97877416178404
Task_13507,2763,729,99,124,223,3.7849315068493152,53.57315347285728
Task_13508,2244,987,172,121,293,2.2712550607287447,46.46707624734797
Task_13509,2024,576,130,33,163,3.5077989601386483,40.15629804937472
Task_13510,2696,472,35,84,119,5.6997885835095135,50.74882232842879
Task_13511,1927,186,63,123,186,10.304812834224599,38.491358871214864
Task_13512,647,130,183,192,375,4.938931297709924,18.528544831647963
Task_13513,724,496,45,123,168,1.4567404426559356,20.003209582552923
Task_13514,2790,714,35,46,81,3.902097902097902,51.97676434324509
Task_13515,1594,389,146,103,249,4.087179487179487,34.06387702431342
Task_13516,1693,540,85,147,232,3.129390018484288,36.14895944670909
Task_13517,2542,963,50,59,109,2.636929460580913,49.376253554368645
Task_13518,2267,565,130,115,245,4.0053003533568905,45.28165073368453
Task_13519,961,69,150,137,287,13.728571428571428,22.42913853777968
Task_13520,1089,920,79,58,137,1.1824104234527688,26.551957435879
Task_13521,2868,205,138,151,289,13.922330097087379,53.80296486251084
Task_13522,717,443,126,69,195,1.614864864864865,19.597163780534256
Task_13523,2367,858,151,23,174,2.7555296856810245,46.54308993552177
Task_13524,2495,623,43,69,112,3.9983974358974357,47.75811769645069
Task_13525,564,964,166,118,284,0.5844559585492228,19.7966124037405
Task_13526,1135,687,157,197,354,1.6497093023255813,28.335330850309123
Task_13527,2712,920,65,192,257,2.9446254071661238,53.74134816118417
Task_13528,2432,391,161,167,328,6.204081632653061,47.779577160558404
Task_13529,2643,144,23,72,95,18.22758620689655,47.91408244568378
Task_13530,1657,559,20,151,171,2.9589285714285714,35.108478214597405
Task_13531,2132,370,150,146,296,5.7466307277628035,42.788353728417015
Task_13532,2460,493,125,38,163,4.979757085020243,46.82132172957713
Task_13533,2195,945,70,131,201,2.3202959830866807,45.30029889278094
Task_13534,1295,1006,148,66,214,1.2859980139026812,30.559585302457744
Task_13535,963,130,112,59,171,7.351145038167939,21.70214459824973
Task_13536,1173,494,140,194,334,2.3696969696969696,28.252108832881785
Task_13537,1207,150,32,134,166,7.993377483443709,26.214010651167413
Task_13538,2918,413,152,51,203,7.048309178743962,54.34341466334818
Task_13539,2271,328,165,60,225,6.90273556231003,43.87595873348655
Task_13540,2365,183,25,121,146,12.853260869565217,44.66336752013134
Task_13541,1188,423,59,115,174,2.80188679245283,27.517280612249547
Task_13542,2891,98,159,41,200,29.2020202020202,51.62130183948295
Task_13543,985,506,164,114,278,1.942800788954635,24.943866518741473
Task_13544,1996,569,23,110,133,3.501754385964912,40.34542842898379
Task_13545,763,455,120,32,152,1.6732456140350878,19.60570139498944
Task_13546,686,262,100,30,130,2.6083650190114067,17.77822009458608
Task_13547,1931,305,146,93,239,6.310457516339869,38.99122457694782
Task_13548,2777,74,122,123,245,37.026666666666664,50.68618861832593
Task_13549,640,736,13,60,73,0.8683853459972863,17.916203746298162
Task_13550,2841,879,168,51,219,3.228409090909091,54.68738888526766
Task_13551,2777,458,157,184,341,6.050108932461874,53.54422401876152
Task_13552,1456,181,86,157,243,8.0,30.890922185732837
Task_13553,2625,618,76,68,144,4.240710823909532,50.03975785693112
Task_13554,2060,601,82,72,154,3.4219269102990033,41.01497807764789
Task_13555,1705,753,113,12,125,2.2612732095490715,35.216595522905784
Task_13556,2724,1007,49,61,110,2.7023809523809526,52.416280540889545
Task_13557,567,602,23,160,183,0.9402985074626866,17.991749538483017
Task_13558,900,128,127,41,168,6.976744186046512,20.44977170860954
Task_13559,814,290,197,28,225,2.797250859106529,20.486684155776768
Task_13560,2226,825,185,78,263,2.694915254237288,45.18063654101989
Task_13561,2426,957,166,25,191,2.5323590814196244,47.929372069724515
Task_13562,758,465,106,139,245,1.6266094420600858,21.096390787502816
Task_13563,2565,599,190,96,286,4.275,50.289611082039634
Task_13564,2658,207,106,20,126,12.778846153846153,48.46845564593335
Task_13565,1353,415,198,60,258,3.2524038461538463,29.78770253471127
Task_13566,662,311,173,73,246,2.121794871794872,18.60647031169833
Task_13567,2796,571,184,104,288,4.888111888111888,53.85528938724425
Task_13568,2913,922,65,114,179,3.1560130010834238,56.284948189933395
Task_13569,2443,458,126,116,242,5.32244008714597,47.711634195393096
Task_13570,1543,170,72,127,199,9.023391812865498,32.07829042684488
Task_13571,2562,532,94,53,147,4.806754221388368,48.75996934785462
Task_13572,1747,718,20,176,196,2.4297635605006955,37.37738686461049
Task_13573,584,131,33,114,147,4.424242424242424,15.894262924439388
Task_13574,510,409,59,35,94,1.2439024390243902,14.939228538219703
Task_13575,2404,321,144,23,167,7.46583850931677,45.27165864864861
Task_13576,952,251,117,163,280,3.7777777777777777,23.68811176424012
Task_13577,1055,660,96,99,195,1.5960665658093798,26.159922255057094
Task_13578,815,572,170,26,196,1.4223385689354275,21.250081000073443
Task_13579,1255,269,186,181,367,4.648148148148148,28.954686949416487
Task_13580,1978,1004,149,12,161,1.9681592039800995,40.503305821863
Task_13581,767,541,61,109,170,1.415129151291513,20.977696433665443
Task_13582,1994,815,11,17,28,2.4436274509803924,38.74793477608736
Task_13583,1064,517,147,161,308,2.054054054054054,26.43321289494079
Task_13584,1041,289,23,72,95,3.589655172413793,23.520077429483393
Task_13585,1839,368,13,104,117,4.983739837398374,37.04201068517309
Task_13586,913,137,116,33,149,6.615942028985507,20.611316824057983
Task_13587,1922,428,168,113,281,4.480186480186481,39.539505640045924
Task_13588,1583,258,89,115,204,6.111969111969112,33.30919988851938
Task_13589,2899,866,17,61,78,3.3437139561707037,54.025080267382435
Task_13590,670,802,129,85,214,0.8343711083437111,20.202953998738895
Task_13591,1200,379,59,36,95,3.1578947368421053,25.736660311300998
Task_13592,1678,860,46,14,60,1.948896631823461,34.092215969569786
Task_13593,2272,816,103,22,125,2.780905752753978,44.45368734158325
Task_13594,605,497,174,43,217,1.214859437751004,17.814632641018306
Task_13595,1507,752,138,173,311,2.00132802124834,34.21509001021702
Task_13596,2763,631,99,94,193,4.371835443037975,53.02747433187923
Task_13597,959,804,65,52,117,1.191304347826087,23.915244773626583
Task_13598,1864,885,161,191,352,2.1038374717832955,40.49669430873332
Task_13599,1005,349,155,82,237,2.8714285714285714,24.24865207090308
Task_13600,2225,474,178,148,326,4.684210526315789,44.7383077650998
Task_13601,2091,376,23,71,94,5.546419098143236,40.43168290310362
Task_13602,1759,467,28,114,142,3.7585470085470085,36.19927193832006
Task_13603,828,473,75,39,114,1.7468354430379747,20.48709980299428
Task_13604,1260,452,43,198,241,2.781456953642384,29.096864986179536
Task_13605,2239,125,119,102,221,17.76984126984127,42.741150243100286
Task_13606,1381,515,138,63,201,2.6763565891472867,30.358732364117273
Task_13607,710,739,83,69,152,0.9594594594594594,19.95652499685539
Task_13608,565,995,92,110,202,0.5672690763052208,19.55960307804555
Task_13609,1259,900,113,178,291,1.397336293007769,30.594611899854154
Task_13610,2210,953,189,48,237,2.3165618448637315,44.77416678421768
Task_13611,2530,680,10,101,111,3.7151248164464024,48.85980880962725
Task_13612,2714,984,73,14,87,2.7553299492385785,51.51623342845855
Task_13613,1078,214,154,52,206,5.013953488372093,24.645107704095636
Task_13614,1163,672,86,19,105,1.7280832095096583,26.0221829182763
Task_13615,2864,718,127,196,323,3.9833101529902644,55.692902319113706
Task_13616,1327,992,51,143,194,1.3363544813695871,31.64772460465949
Task_13617,2571,76,109,16,125,33.38961038961039,45.56588266276657
Task_13618,2334,996,88,148,236,2.341023069207623,47.72360263219295
Task_13619,1806,134,105,146,251,13.377777777777778,36.16588883812942
Task_13620,860,791,46,150,196,1.0858585858585859,23.33815589575235
Task_13621,964,965,150,145,295,0.9979296066252588,26.061928564179226
Task_13622,2382,785,36,26,62,3.030534351145038,45.26758804517394
Task_13623,1602,126,103,148,251,12.614173228346457,32.93558786570298
Task_13624,2152,411,178,185,363,5.223300970873787,43.59908505117295
Task_13625,1388,67,88,166,254,20.41176470588235,29.00074246576985
Task_13626,2789,583,79,187,266,4.7756849315068495,53.936153282307515
Task_13627,2364,510,34,63,97,4.626223091976517,45.087700081029105
Task_13628,2519,873,199,199,398,2.8821510297482837,51.05670301744508
Task_13629,2524,163,71,154,225,15.390243902439025,47.75372777889323
Task_13630,970,381,81,80,161,2.5392670157068062,23.27009680088025
Task_13631,934,396,90,98,188,2.3526448362720402,23.374371956965902
Task_13632,555,984,103,98,201,0.5634517766497462,19.253911034809352
Task_13633,2491,667,67,176,243,3.7290419161676644,49.35557850896566
Task_13634,958,853,148,119,267,1.1217798594847774,25.394437013341847
Task_13635,2645,751,16,32,48,3.5172872340425534,49.28841799392243
Task_13636,1931,507,59,155,214,3.8011811023622046,39.85016983558271
Task_13637,2378,549,76,76,152,4.323636363636363,45.985905260636564
Task_13638,605,506,132,103,235,1.193293885601578,18.635863953995884
Task_13639,2033,667,17,130,147,3.0434131736526946,41.119657870394626
Task_13640,1334,277,45,72,117,4.798561151079137,28.40847291907944
Task_13641,1582,948,158,123,281,1.6670179135932561,35.79091331970648
Task_13642,1091,707,139,50,189,1.5409604519774012,26.0827810936339
Task_13643,2297,692,112,175,287,3.3145743145743145,46.4362398363124
Task_13644,1878,495,83,84,167,3.786290322580645,38.107995139579636
Task_13645,2884,419,90,90,180,6.866666666666666,53.93738522436363
Task_13646,623,538,52,21,73,1.155844155844156,16.707778415671978
Task_13647,2015,319,152,199,351,6.296875,41.09248019841975
Task_13648,2056,118,113,179,292,17.277310924369747,40.234980001699405
Task_13649,1389,312,195,109,304,4.437699680511182,30.826365600528323
Task_13650,630,263,35,195,230,2.3863636363636362,18.49010717070168
Task_13651,1413,215,22,177,199,6.541666666666667,30.471523308364223
Task_13652,1646,479,92,127,219,3.4291666666666667,35.1533757300787
Task_13653,2767,606,185,15,200,4.5584843492586495,52.15768200872321
Task_13654,1374,752,80,20,100,1.8247011952191234,29.665035790619964
Task_13655,1741,117,98,113,211,14.754237288135593,34.80265205992842
Task_13656,1597,597,128,170,298,2.67056856187291,35.09252087669567
Task_13657,2432,781,123,192,315,3.1099744245524295,49.005767148950575
Task_13658,2720,663,187,60,247,4.096385542168675,52.17195390895074
Task_13659,2505,986,56,137,193,2.5379939209726445,50.331409626851276
Task_13660,1791,567,86,32,118,3.153169014084507,36.03195817983886
Task_13661,1106,450,108,17,125,2.4523281596452327,24.669070624170857
Task_13662,2035,424,127,118,245,4.788235294117647,41.159922175625105
Task_13663,2617,385,103,82,185,6.77979274611399,49.48390194640779
Task_13664,1767,437,15,51,66,4.034246575342466,34.7690990473259
Task_13665,880,205,25,86,111,4.271844660194175,21.089695804470797
Task_13666,2430,792,48,32,80,3.064312736443884,46.452021200188135
Task_13667,2744,731,44,117,161,3.748633879781421,52.699051997588676
Task_13668,726,174,196,133,329,4.148571428571429,19.664385336768316
Task_13669,2223,261,177,86,263,8.48473282442748,43.35276451649376
Task_13670,839,906,50,119,169,0.9250275633958104,23.20261224283617
Task_13671,2383,80,170,101,271,29.419753086419753,44.64193942418333
Task_13672,1984,504,121,160,281,3.9287128712871286,40.83431040242852
Task_13673,1071,574,126,23,149,1.862608695652174,24.831662776866164
Task_13674,1638,873,187,134,321,1.874141876430206,36.655143741053045
Task_13675,1452,735,131,57,188,1.9728260869565217,32.02027108263009
Task_13676,618,160,61,156,217,3.8385093167701863,17.637973026504326
Task_13677,1433,789,56,165,221,1.8139240506329113,32.899300519683905
Task_13678,2772,438,189,14,203,6.314350797266515,51.704733011454636
Task_13679,2432,211,160,60,220,11.471698113207546,45.975567723594224
Task_13680,2022,130,166,49,215,15.435114503816793,38.6361217330769
Task_13681,2641,327,65,115,180,8.051829268292684,50.06928172713603
Task_13682,2641,455,31,116,147,5.791666666666667,50.15039231154168
Task_13683,2849,796,88,176,264,3.57465495608532,55.425663717961136
Task_13684,2608,698,24,85,109,3.7310443490701,49.99067288948277
Task_13685,1687,539,110,19,129,3.1240740740740742,34.26808038915477
Task_13686,2186,440,147,149,296,4.956916099773243,43.87705517760833
Task_13687,1615,516,170,136,306,3.123791102514507,35.10802086547526
Task_13688,2831,944,155,74,229,2.9957671957671956,54.92060942246638
Task_13689,2286,633,20,82,102,3.6056782334384856,44.48318610044449
Task_13690,2921,668,51,64,115,4.366218236173393,54.82639792412592
Task_13691,1545,406,133,150,283,3.796068796068796,33.56560445645263
Task_13692,1344,498,69,20,89,2.693386773547094,28.228907684028687
Task_13693,1083,328,144,169,313,3.291793313069909,26.16812351285907
Task_13694,2871,137,193,177,370,20.804347826086957,53.60152879212476
Task_13695,1546,929,34,181,215,1.6623655913978495,34.97691334505603
Task_13696,2905,481,192,11,203,6.026970954356846,53.97945471257072
Task_13697,2661,740,166,101,267,3.591093117408907,52.15493826910906
Task_13698,1136,445,139,80,219,2.5470852017937218,26.541041999983573
Task_13699,798,102,104,56,160,7.747572815533981,18.757819606677007
Task_13700,1343,159,21,23,44,8.39375,26.642430967590844
Task_13701,1264,797,31,181,212,1.5839598997493733,30.06703036428443
Task_13702,570,998,93,104,197,0.5705705705705706,19.70746444958981
Task_13703,934,83,164,184,348,11.119047619047619,22.432710868079667
Task_13704,2742,936,161,22,183,2.926360725720384,52.63951146464106
Task_13705,893,146,195,165,360,6.074829931972789,22.403316076582772
Task_13706,1776,794,60,113,173,2.2339622641509433,37.9541573033883
Task_13707,1025,229,130,95,225,4.456521739130435,24.392043042627616
Task_13708,2639,789,181,157,338,3.340506329113924,52.36269094565853
Task_13709,1684,906,72,76,148,1.8566703417861081,36.1700011173902
Task_13710,2914,791,61,143,204,3.6792929292929295,56.229288134392164
Task_13711,1392,521,108,118,226,2.6666666666666665,31.20624552450241
Task_13712,2349,472,69,96,165,4.966173361522198,45.98246873483253
Task_13713,1734,570,108,126,234,3.0367775831873907,36.82396637803703
Task_13714,1020,1016,151,141,292,1.0029498525073746,27.03838599840167
Task_13715,1048,195,158,154,312,5.346938775510204,25.08589464746818
Task_13716,781,225,84,136,220,3.4557522123893807,20.638001464286088
Task_13717,2269,538,43,132,175,4.209647495361781,44.88485974474353
Task_13718,1824,880,138,196,334,2.0703745743473325,39.7735354003649
Task_13719,2268,864,94,143,237,2.621965317919075,46.32762670097062
Task_13720,1819,762,191,39,230,2.384010484927916,37.907250951433014
Task_13721,2845,217,51,32,83,13.05045871559633,51.13723242845074
Task_13722,1293,620,24,200,224,2.082125603864734,30.10357262513635
Task_13723,2125,961,158,166,324,2.208939708939709,44.706110701939274
Task_13724,1129,77,175,64,239,14.474358974358974,24.35723949860909
Task_13725,1946,468,117,159,276,4.149253731343284,40.09333590086617
Task_13726,843,184,110,89,199,4.556756756756757,21.01826163065404
Task_13727,1972,286,149,184,333,6.871080139372823,40.19673540101989
Task_13728,2486,919,156,165,321,2.7021739130434783,50.28065044576821
Task_13729,2196,824,93,48,141,2.6618181818181816,43.57981363923627
Task_13730,1997,338,37,132,169,5.890855457227139,39.788710405410775
Task_13731,2206,860,139,142,281,2.562137049941928,45.44583011465368
Task_13732,2473,113,142,53,195,21.69298245614035,45.666295942654955
Task_13733,543,509,71,67,138,1.0647058823529412,16.594831137186905
Task_13734,2400,361,177,89,266,6.629834254143646,46.59172494481431
Task_13735,806,788,95,25,120,1.0215462610899873,21.187162737836424
Task_13736,1132,607,151,135,286,1.861842105263158,27.654427884076465
Task_13737,2611,694,38,144,182,3.756834532374101,50.72774188343817
Task_13738,1453,84,196,108,304,17.094117647058823,30.26477105557389
Task_13739,2962,531,68,65,133,5.567669172932331,55.12692101291925
Task_13740,2458,523,66,148,214,4.690839694656488,48.20277864289798
Task_13741,1597,303,94,48,142,5.253289473684211,32.39863448753602
Task_13742,2538,110,59,82,141,22.864864864864863,46.295659002408065
Task_13743,2809,950,79,147,226,2.953732912723449,55.17186002040407
Task_13744,2263,441,73,178,251,5.119909502262443,45.065671315701536
Task_13745,924,195,11,50,61,4.714285714285714,20.550120320732386
Task_13746,2521,173,156,182,338,14.488505747126437,48.089778557879725
Task_13747,2061,808,85,145,230,2.547589616810878,42.80789007296146
Task_13748,2341,670,26,93,119,3.488822652757079,45.915706950533256
Task_13749,1001,485,66,43,109,2.0596707818930042,23.137411367024043
Task_13750,559,102,39,111,150,5.427184466019417,15.225585460224634
Task_13751,1588,514,95,97,192,3.0834951456310677,34.20697287003
Task_13752,957,462,24,122,146,2.0669546436285096,23.52509011890166
Task_13753,1786,774,78,169,247,2.304516129032258,38.54008747124797
Task_13754,1901,398,165,97,262,4.764411027568922,39.0341663514534
Task_13755,694,431,82,42,124,1.6064814814814814,18.25902535776204
Task_13756,1056,101,17,200,217,10.352941176470589,23.817492424563977
Task_13757,1566,995,34,144,178,1.572289156626506,35.07375117007312
Task_13758,1134,670,54,163,217,1.6900149031296572,27.75834685886296
Task_13759,2669,776,156,83,239,3.435006435006435,51.949072182518215
Task_13760,1277,485,186,96,282,2.6275720164609053,29.515670706815957
Task_13761,1078,628,48,93,141,1.713831478537361,25.953745969519257
Task_13762,663,757,144,142,286,0.8746701846965699,20.626053418513276
Task_13763,1360,384,27,178,205,3.5324675324675323,30.29793575870443
Task_13764,1096,424,49,115,164,2.5788235294117645,25.975580799854665
Task_13765,938,290,82,47,129,3.223367697594502,21.843912543918673
Task_13766,1329,243,58,54,112,5.44672131147541,27.82134984088574
Task_13767,2341,794,86,182,268,2.9446540880503145,47.42039164505678
Task_13768,2744,661,61,157,218,4.145015105740181,53.20909941949369
Task_13769,1469,611,174,16,190,2.400326797385621,31.562279250346347
Task_13770,930,365,88,104,192,2.540983606557377,23.24571306875937
Task_13771,911,466,112,41,153,1.9507494646680943,21.961450038984594
Task_13772,1202,437,151,66,217,2.7442922374429224,27.353234558356963
Task_13773,2908,405,196,60,256,7.16256157635468,54.35298128548438
Task_13774,2599,425,167,45,212,6.10093896713615,49.095480340219645
Task_13775,515,246,146,163,309,2.08502024291498,16.898059757236695
Task_13776,2388,773,186,38,224,3.0852713178294575,46.99701704691315
Task_13777,2595,165,195,15,210,15.632530120481928,47.820614604321634
Task_13778,1267,416,91,42,133,3.038369304556355,27.473024357584563
Task_13779,1329,577,55,114,169,2.2993079584775087,30.092616478407034
Task_13780,894,109,188,60,248,8.127272727272727,20.936784237966872
Task_13781,2091,699,42,154,196,2.987142857142857,42.7679048571277
Task_13782,2694,925,140,146,286,2.9092872570194386,53.40969937156742
Task_13783,2571,943,189,89,278,2.7235169491525424,51.209749309508425
Task_13784,2352,263,125,85,210,8.909090909090908,45.14749459856154
Task_13785,869,187,137,182,319,4.622340425531915,22.47065101038289
Task_13786,764,364,137,89,226,2.0931506849315067,20.540601176833317
Task_13787,790,850,39,20,59,0.9283196239717979,20.144702176461735
Task_13788,1792,284,168,72,240,6.287719298245614,36.34513022369429
Task_13789,1989,272,137,47,184,7.285714285714286,38.66835080233954
Task_13790,2543,435,155,101,256,5.83256880733945,49.26025516053945
Task_13791,2726,890,70,155,225,3.059483726150393,53.685995126550104
Task_13792,572,307,26,43,69,1.8571428571428572,15.135983131339039
Task_13793,1425,777,82,98,180,1.8316195372750643,32.20465744559454
Task_13794,1809,294,161,141,302,6.132203389830509,37.44458756952623
Task_13795,2449,306,103,57,160,7.977198697068404,46.05338489397237
Task_13796,761,239,25,84,109,3.1708333333333334,19.267124639643683
Task_13797,1437,808,148,132,280,1.7762669962917181,33.06721659763257
Task_13798,538,875,110,174,284,0.6141552511415526,19.244788832286947
Task_13799,1391,239,23,111,134,5.795833333333333,29.657336882874173
Task_13800,2023,120,187,131,318,16.71900826446281,39.793658213009884
Task_13801,2179,522,36,84,120,4.166347992351817,42.70757388028202
Task_13802,1550,455,106,121,227,3.3991228070175437,33.50695750495327
Task_13803,996,74,141,124,265,13.28,22.900079205588725
Task_13804,2389,883,80,29,109,2.7024886877828056,46.457672424785024
Task_13805,1915,748,100,167,267,2.5567423230974633,40.458948297647346
Task_13806,1801,704,80,14,94,2.554609929078014,36.31729966649237
Task_13807,1549,116,75,196,271,13.239316239316238,32.25082473311442
Task_13808,517,422,18,152,170,1.2222222222222223,16.43803952006426
Task_13809,2534,598,92,181,273,4.230383973288815,49.915419419304584
Task_13810,2049,744,90,42,132,2.7503355704697987,40.887175328983396
Task_13811,1972,210,33,190,223,9.345971563981042,39.484903002830336
Task_13812,751,1020,30,108,138,0.7355533790401567,21.79094222590319
Task_13813,754,881,167,58,225,0.854875283446712,21.64849075842776
Task_13814,2351,361,194,153,347,6.494475138121547,46.462969170960115
Task_13815,1616,794,198,108,306,2.0327044025157233,35.954987651343814
Task_13816,1104,813,22,37,59,1.3562653562653562,25.152054905743686
Task_13817,1696,854,185,192,377,1.983625730994152,37.852445372067706
Task_13818,1627,443,104,186,290,3.6644144144144146,35.06653747543411
Task_13819,1323,452,194,25,219,2.9205298013245033,28.999726629748896
Task_13820,517,578,52,173,225,0.8929188255613126,17.60356977866036
Task_13821,2710,517,69,176,245,5.231660231660232,52.35284509140177
Task_13822,749,294,200,132,332,2.538983050847458,20.808641515699538
Task_13823,2323,107,81,98,179,21.50925925925926,43.35213690771784
Task_13824,2985,100,104,177,281,29.554455445544555,54.43813336038619
Task_13825,1641,496,76,60,136,3.301810865191147,33.955535192690874
Task_13826,2405,634,57,124,181,3.7874015748031495,47.38743439139281
Task_13827,2716,387,55,62,117,7.0,50.47056147245232
Task_13828,2365,856,76,56,132,2.7596266044340725,46.618570099517264
Task_13829,2425,652,167,129,296,3.713629402756508,48.310506676171286
Task_13830,2164,761,183,176,359,2.8398950131233596,44.87214434238276
Task_13831,2594,120,43,186,229,21.43801652892562,48.456624303207484
Task_13832,539,563,99,186,285,0.9556737588652482,18.131162484273244
Task_13833,2188,789,62,141,203,2.769620253164557,44.713648107398654
Task_13834,1527,301,174,34,208,5.056291390728477,31.758594241496407
Task_13835,2605,993,22,188,210,2.6207243460764587,51.90007122775483
Task_13836,2699,953,25,141,166,2.8291404612159328,52.905871662666506
Task_13837,2755,697,170,139,309,3.9469914040114613,53.753192710347776
Task_13838,2378,842,34,71,105,2.8208778173190985,46.49809678212167
Task_13839,1933,538,100,39,139,3.5862708719851577,38.30127115439472
Task_13840,2399,177,159,101,260,13.47752808988764,45.67087941159917
Task_13841,717,614,11,150,161,1.1658536585365853,20.156086949680827
Task_13842,1090,440,69,165,234,2.4716553287981857,26.396098031992082
Task_13843,561,471,49,38,87,1.1885593220338984,16.057882533126342
Task_13844,2710,502,136,155,291,5.387673956262425,52.35930270173511
Task_13845,1492,230,158,133,291,6.458874458874459,32.1528127961312
Task_13846,1751,231,35,123,158,7.547413793103448,35.35303409066851
Task_13847,1800,697,63,44,107,2.5787965616045847,36.25581171212415
Task_13848,1083,670,136,136,272,1.6140089418777943,26.99974713204446
Task_13849,1508,718,67,73,140,2.097357440890125,32.71824592555057
Task_13850,1742,105,59,156,215,16.433962264150942,34.66182093586902
Task_13851,2352,627,126,149,275,3.745222929936306,47.00981060609514
Task_13852,1736,87,72,200,272,19.727272727272727,34.77417794304325
Task_13853,1454,182,17,166,183,7.945355191256831,30.484828263516537
Task_13854,1610,779,193,97,290,2.0641025641025643,35.75855278154071
Task_13855,1018,882,65,138,203,1.1528878822197055,26.35717183433023
Task_13856,714,123,115,61,176,5.758064516129032,17.83074075394575
Task_13857,2220,876,47,151,198,2.5313568985176738,45.407082394384354
Task_13858,2498,831,113,189,302,3.0024038461538463,50.14518588123595
Task_13859,755,73,122,168,290,10.202702702702704,19.251570336438654
Task_13860,2429,267,126,138,264,9.063432835820896,46.974652547184725
Task_13861,1462,771,10,173,183,1.8937823834196892,32.80779091414074
Task_13862,580,349,156,136,292,1.6571428571428573,18.123020743644656
Task_13863,2661,701,145,111,256,3.7905982905982905,51.99693649599586
Task_13864,2786,350,195,77,272,7.937321937321937,52.49866632523336
Task_13865,2472,775,42,152,194,3.185567010309278,49.030284013663824
Task_13866,1725,375,20,119,139,4.587765957446808,35.272117305792825
Task_13867,1663,122,69,120,189,13.520325203252032,33.61052843268939
Task_13868,2763,427,12,18,30,6.455607476635514,49.70231741621631
Task_13869,685,849,178,106,284,0.8058823529411765,21.204904106993826
Task_13870,872,204,116,163,279,4.253658536585366,22.262545009012303
Task_13871,2450,468,31,56,87,5.223880597014926,46.085912757970895
Task_13872,2509,994,193,58,251,2.521608040201005,49.89477350424894
Task_13873,2091,807,152,12,164,2.587871287128713,41.869585967454086
Task_13874,1835,179,148,30,178,10.194444444444445,35.68033424973138
Task_13875,2910,642,14,60,74,4.5256609642301715,53.49474817515864
Task_13876,2343,668,100,134,234,3.502242152466368,46.79018583969202
Task_13877,1370,127,13,101,114,10.703125,27.99992906204361
Task_13878,1999,262,181,34,215,7.600760456273764,39.11736878537927
Task_13879,1157,608,179,180,359,1.8998357963875205,28.448455731643254
Task_13880,716,606,143,49,192,1.1795716639209226,19.930770269240956
Task_13881,1463,387,27,118,145,3.770618556701031,31.317005073357052
Task_13882,2655,915,21,112,133,2.898471615720524,51.75980703686579
Task_13883,868,324,90,150,240,2.670769230769231,22.447495616678207
Task_13884,529,149,79,114,193,3.526666666666667,16.029520658524422
Task_13885,2460,849,135,169,304,2.8941176470588235,49.57915941707419
Task_13886,1927,257,21,179,200,7.4689922480620154,38.75799659340575
Task_13887,1020,970,168,143,311,1.050463439752832,27.003232203229967
Task_13888,1340,1008,64,126,190,1.32804757185332,31.818098686440283
Task_13889,1506,133,64,83,147,11.238805970149254,30.433464543865256
Task_13890,1003,599,143,150,293,1.6716666666666666,25.626632758610793
Task_13891,2293,272,164,26,190,8.3992673992674,43.627028762356304
Task_13892,1386,191,106,157,263,7.21875,30.23826743902772
Task_13893,1572,272,153,78,231,5.758241758241758,32.91321190862882
Task_13894,687,96,161,111,272,7.082474226804123,18.096928169883896
Task_13895,1148,84,15,153,168,13.505882352941176,24.80043161107744
Task_13896,1947,423,115,157,272,4.591981132075472,39.94287355712262
Task_13897,811,189,146,129,275,4.268421052631579,21.194961505282834
Task_13898,1442,381,47,43,90,3.774869109947644,29.573627684302952
Task_13899,1426,414,129,36,165,3.436144578313253,30.27355692085152
Task_13900,2942,410,35,73,108,7.158150851581508,54.188687417273975
Task_13901,2872,906,59,113,172,3.1664829106945978,55.69168269264827
Task_13902,1423,654,52,190,242,2.1725190839694655,32.462260620323896
Task_13903,1931,679,139,189,328,2.8397058823529413,40.80327344620036
Task_13904,2348,773,63,49,112,3.03359173126615,45.37114283005812
Task_13905,2358,801,180,66,246,2.9401496259351623,46.93767835287628
Task_13906,734,142,184,89,273,5.1328671328671325,19.282555189088157
Task_13907,2346,348,63,78,141,6.722063037249284,44.93153685419708
Task_13908,763,408,117,112,229,1.8655256723716382,20.89837719025917
Task_13909,810,90,66,93,159,8.901098901098901,19.164999660270535
Task_13910,1358,1005,13,57,70,1.3499005964214712,30.07235742187181
Task_13911,966,195,11,68,79,4.928571428571429,21.658744533509974
Task_13912,1269,501,179,170,349,2.5278884462151394,29.826396788785242
Task_13913,2408,1010,146,65,211,2.3818001978239365,48.245866954858975
Task_13914,985,1019,105,76,181,0.9656862745098039,25.483383732080522
Task_13915,1577,762,187,127,314,2.0668414154652686,35.30129679480718
Task_13916,856,158,180,150,330,5.383647798742138,21.784704117338634
Task_13917,2261,144,71,74,145,15.593103448275862,42.38702288582693
Task_13918,2737,682,180,10,190,4.007320644216691,51.89053361668909
Task_13919,2979,324,126,153,279,9.166153846153847,55.96245420024402
Task_13920,1098,485,193,159,352,2.259259259259259,27.066281554931688
Task_13921,1499,84,156,157,313,17.63529411764706,31.09833062292533
Task_13922,1475,515,181,164,345,2.858527131782946,33.10515453282738
Task_13923,958,640,180,109,289,1.4945397815912635,24.934265044242434
Task_13924,1865,451,24,126,150,4.126106194690266,37.842096544209575
Task_13925,2013,859,192,185,377,2.3406976744186045,42.880438129272996
Task_13926,1190,338,98,177,275,3.510324483775811,27.747124751280992
Task_13927,1248,684,43,65,108,1.821897810218978,28.117373831005537
Task_13928,683,126,86,76,162,5.377952755905512,17.325258814815026
Task_13929,2574,324,55,27,82,7.92,47.18926793774852
Task_13930,1687,412,23,34,57,4.084745762711864,33.18213766741588
Task_13931,746,369,144,24,168,2.016216216216216,19.17192242478417
Task_13932,1612,958,18,48,66,1.6809176225234619,33.716575710838214
Task_13933,1660,278,36,187,223,5.949820788530466,34.75498172334205
Task_13934,1536,719,172,51,223,2.1333333333333333,33.52967143388932
Task_13935,536,359,176,68,244,1.488888888888889,16.69853507570895
Task_13936,1206,487,97,191,288,2.471311475409836,28.564414873590934
Task_13937,1244,1016,131,173,304,1.2232055063913472,30.712616422913538
Task_13938,519,641,117,34,151,0.8084112149532711,16.35999780033786
Task_13939,2998,106,92,20,112,28.018691588785046,52.73817430930038
Task_13940,2930,608,64,135,199,4.811165845648604,55.86820481203205
Task_13941,1857,932,143,60,203,1.9903536977491962,39.14452061262606
Task_13942,1038,568,92,181,273,1.8242530755711774,26.130332522851507
Task_13943,1525,239,84,107,191,6.354166666666667,32.26410987450172
Task_13944,2620,764,10,98,108,3.4248366013071894,50.47065566509152
Task_13945,675,707,111,53,164,0.9533898305084746,19.661061304896563
Task_13946,1703,837,186,37,223,2.032219570405728,36.324978800568225
Task_13947,2683,960,65,112,177,2.7918834547346516,52.7471641592627
Task_13948,1329,220,25,196,221,6.013574660633484,29.368867534885442
Task_13949,2965,825,65,190,255,3.5895883777239708,57.44036279022847
Task_13950,2595,742,89,166,255,3.4925975773889637,51.19669731470676
Task_13951,1756,998,88,192,280,1.7577577577577577,38.81963862749185
Task_13952,662,951,49,44,93,0.6953781512605042,19.567304880176007
Task_13953,1106,497,140,94,234,2.2208835341365463,26.548026319098966
Task_13954,2894,718,189,198,387,4.025034770514604,56.45951261701642
Task_13955,1574,823,120,21,141,1.9101941747572815,33.469763777014386
Task_13956,1965,403,144,188,332,4.8638613861386135,40.47848100961623
Task_13957,1566,122,148,70,218,12.731707317073171,31.640628342722696
Task_13958,2872,164,171,83,254,17.406060606060606,52.93534205405257
Task_13959,564,102,188,64,252,5.475728155339806,15.751368603011386
Task_13960,1918,824,181,196,377,2.3248484848484847,41.28220901271451
Task_13961,1495,549,56,177,233,2.7181818181818183,33.20212682246875
Task_13962,961,987,87,77,164,0.9726720647773279,25.02690875051169
Task_13963,2367,349,177,114,291,6.7628571428571425,46.36607699416999
Task_13964,939,806,164,108,272,1.1635687732342008,25.031218124992893
Task_13965,2867,66,64,105,169,42.791044776119406,51.63343383306826
Task_13966,2874,862,165,55,220,3.3302433371958284,55.20786825092444
Task_13967,532,750,91,200,291,0.7083888149134487,18.79330751906965
Task_13968,1957,963,187,100,287,2.030082987551867,41.78662107343505
Task_13969,794,929,200,28,228,0.853763440860215,22.222441795525395
Task_13970,984,398,22,60,82,2.4661654135338344,22.524991339655458
Task_13971,574,964,154,90,244,0.5948186528497409,19.559991436159773
Task_13972,905,505,51,174,225,1.7885375494071147,23.71920540293824
Task_13973,1469,129,180,199,379,11.3,31.47952723244082
Task_13974,971,629,179,24,203,1.5412698412698413,23.90695146103379
Task_13975,2943,137,51,15,66,21.32608695652174,51.579296381862996
Task_13976,1549,774,61,15,76,1.998709677419355,31.79572087336666
Task_13977,1352,725,93,118,211,1.862258953168044,31.256139487013098
Task_13978,1413,119,35,180,215,11.775,29.790684414352167
Task_13979,1660,142,80,52,132,11.608391608391608,32.717212219106926
Task_13980,988,654,101,16,117,1.5083969465648854,23.34889571563527
Task_13981,534,803,57,144,201,0.664179104477612,18.596092048851542
Task_13982,840,67,105,79,184,12.352941176470589,19.581999087978236
Task_13983,2217,969,122,170,292,2.2855670103092782,46.05052021839932
Task_13984,920,1016,15,83,98,0.904621435594887,23.991846642981344
Task_13985,1949,222,58,144,202,8.739910313901346,39.11112480125493
Task_13986,2939,151,17,164,181,19.335526315789473,53.58461932701017
Task_13987,933,414,172,91,263,2.2481927710843372,23.58380769112752
Task_13988,1033,627,54,149,203,1.644904458598726,25.94105195047973
Task_13989,1811,620,148,163,311,2.9162640901771337,38.60235132769626
Task_13990,1880,278,132,64,196,6.738351254480286,37.46626183341936
Task_13991,1895,705,173,48,221,2.6841359773371103,38.93678565971978
Task_13992,2105,975,73,136,209,2.1567622950819674,43.997423651351276
Task_13993,2963,509,148,51,199,5.809803921568627,55.353952479720114
Task_13994,1047,961,73,107,180,1.0883575883575884,26.630805161609416
Task_13995,1198,507,122,102,224,2.358267716535433,28.0581987259946
Task_13996,2665,439,148,110,258,6.056818181818182,51.22649162744617
Task_13997,1549,938,102,17,119,1.6496272630457933,33.06862290564837
Task_13998,2038,794,34,150,184,2.5635220125786162,42.01012212239656
Task_13999,2077,411,27,88,115,5.04126213592233,40.78715303973656
Task_14000,1831,409,131,17,148,4.465853658536585,36.13526597218535
Task_14001,1147,305,198,59,257,3.7483660130718954,26.165950411208044
Task_14002,2274,214,65,200,265,10.576744186046511,44.549817262035994
Task_14003,654,501,30,51,81,1.302788844621514,17.703370567874263
Task_14004,2148,818,91,102,193,2.6227106227106227,43.98966967585354
Task_14005,2297,696,167,63,230,3.2955523672883786,45.5666412125413
Task_14006,596,286,184,177,361,2.076655052264808,18.560983403481163
Task_14007,900,633,123,63,186,1.4195583596214512,22.864761014674688
Task_14008,2513,93,42,75,117,26.73404255319149,45.45962702105093
Task_14009,1565,428,177,132,309,3.648018648018648,34.04364798286134
Task_14010,1639,968,23,48,71,1.6914344685242517,34.238790738155494
Task_14011,1047,752,81,116,197,1.3904382470119523,26.364306588789592
Task_14012,2595,856,115,97,212,3.028004667444574,51.25346445874606
Task_14013,574,1013,80,176,256,0.5660749506903353,20.154257917039587
Task_14014,901,277,109,56,165,3.241007194244604,21.814310927246453
Task_14015,2508,341,39,12,51,7.333333333333333,45.63483197767628
Task_14016,1266,885,160,84,244,1.4288939051918736,30.019795253589905
Task_14017,1632,90,49,49,98,17.934065934065934,30.928144741777302
Task_14018,1282,813,159,149,308,1.574938574938575,30.74885761638771
Task_14019,1085,564,165,80,245,1.920353982300885,26.225068530924336
Task_14020,2964,137,55,142,197,21.47826086956522,54.349688579650056
Task_14021,2912,661,187,93,280,4.398791540785498,55.862346580031634
Task_14022,518,955,30,141,171,0.5418410041841004,18.25515141258869
Task_14023,1515,73,150,175,325,20.472972972972972,31.313585019829446
Task_14024,2025,384,40,170,210,5.259740259740259,40.801754175949206
Task_14025,2290,665,101,32,133,3.4384384384384385,44.45994912229699
Task_14026,2776,223,113,79,192,12.392857142857142,51.58550636940138
Task_14027,2597,1010,46,89,135,2.568743818001978,51.03337216190928
Task_14028,1382,163,43,25,68,8.426829268292684,27.433503345773303
Task_14029,2796,104,170,107,277,26.62857142857143,51.35381935404501
Task_14030,1342,1011,68,152,220,1.326086956521739,32.03798105433625
Task_14031,1495,405,185,118,303,3.6822660098522166,32.81441476400749
Task_14032,702,379,28,140,168,1.8473684210526315,19.46435578778427
Task_14033,1318,119,106,198,304,10.983333333333333,28.72372766175366
Task_14034,652,709,158,20,178,0.9183098591549296,18.778369344988665
Task_14035,1949,750,137,142,279,2.5952063914780292,41.02126516044467
Task_14036,2794,855,188,63,251,3.264018691588785,54.03457784598339
Task_14037,965,254,97,162,259,3.784313725490196,23.831022127204037
Task_14038,2143,309,96,162,258,6.912903225806452,42.66191731034318
Task_14039,2458,951,180,20,200,2.581932773109244,48.325414006054
Task_14040,932,580,183,94,277,1.604130808950086,24.233253076069072
Task_14041,1267,248,99,41,140,5.088353413654619,26.85798952208401
Task_14042,2100,778,155,170,325,2.6957637997432604,43.74944290751474
Task_14043,1716,870,105,180,285,1.9701492537313432,37.78687901745459
Task_14044,902,835,112,195,307,1.0789473684210527,24.757642715436575
Task_14045,1602,879,198,91,289,1.8204545454545455,35.74999718788225
Task_14046,1055,698,151,174,325,1.5092989985693848,26.90863452234584
Task_14047,2332,555,71,58,129,4.194244604316546,45.07040138819652
Task_14048,2871,684,144,53,197,4.191240875912409,54.51116133934158
Task_14049,2026,465,66,130,196,4.347639484978541,41.06957603205026
Task_14050,2863,487,12,47,59,5.866803278688525,51.98444282104785
Task_14051,2610,531,157,160,317,4.906015037593985,50.9943097747288
Task_14052,1955,585,59,138,197,3.33617747440273,40.376541047326675
Task_14053,1901,76,54,182,236,24.68831168831169,37.1096559874696
Task_14054,509,907,64,69,133,0.5605726872246696,17.62138622406037
Task_14055,2456,996,65,186,251,2.4633901705115346,49.885950437501606
Task_14056,2558,776,183,179,362,3.292149292149292,51.179006482318734
Task_14057,506,72,129,186,315,6.931506849315069,15.51226602972846
Task_14058,1826,328,108,161,269,5.550151975683891,37.708568348443436
Task_14059,650,129,31,82,113,5.0,16.595364933730224
Task_14060,2830,942,130,162,292,3.0010604453870626,55.668370620816425
Task_14061,2509,715,26,107,133,3.5041899441340782,48.872392065653656
Task_14062,2100,376,180,97,277,5.570291777188329,42.178116266737156
Task_14063,2070,684,189,104,293,3.021897810218978,42.73835872479284
Task_14064,1861,635,150,168,318,2.9261006289308176,39.48034553155908
Task_14065,2478,488,68,119,187,5.067484662576687,48.20452852930544
Task_14066,1801,760,84,142,226,2.366622864651774,38.51637174932802
Task_14067,2103,889,165,122,287,2.3629213483146065,43.902013130124914
Task_14068,937,683,197,133,330,1.3698830409356726,24.93668352317998
Task_14069,1354,702,85,155,240,1.926031294452347,31.336429925591315
Task_14070,1400,512,177,102,279,2.729044834307992,31.519906843220312
Task_14071,1817,352,86,172,258,5.147308781869689,37.654547903278484
Task_14072,1469,674,117,178,295,2.176296296296296,33.30488248282505
Task_14073,1508,732,47,35,82,2.057298772169168,31.692451557308164
Task_14074,1495,550,196,143,339,2.7132486388384756,33.474511225943715
Task_14075,1164,323,58,10,68,3.5925925925925926,24.235000446270092
Task_14076,943,290,195,25,220,3.240549828178694,22.473121431804007
Task_14077,844,784,113,163,276,1.0751592356687898,23.494186640420356
Task_14078,2718,750,138,51,189,3.6191744340878826,52.1681518165644
Task_14079,1240,74,122,143,265,16.533333333333335,26.747225416120457
Task_14080,1969,871,174,186,360,2.25802752293578,42.14552871909313
Task_14081,2547,295,86,162,248,8.60472972972973,48.94490675532078
Task_14082,1164,249,28,166,194,4.656,26.688790834675682
Task_14083,2904,564,159,13,172,5.139823008849557,54.00280730678114
Task_14084,813,531,67,125,192,1.5281954887218046,22.01049619449391
Task_14085,951,874,81,190,271,1.086857142857143,25.533148232807644
Task_14086,1287,526,88,156,244,2.4421252371916506,29.716018233657433
Task_14087,2784,757,161,44,205,3.6728232189973613,53.08668190189152
Task_14088,2969,657,30,109,139,4.5121580547112465,55.91971243635143
Task_14089,2636,389,189,93,282,6.758974358974359,50.61955762559044
Task_14090,1986,638,81,121,202,3.107981220657277,40.98151865563393
Task_14091,1454,819,46,144,190,1.773170731707317,33.005677555245136
Task_14092,2157,376,160,139,299,5.721485411140583,43.20703144899636
Task_14093,675,402,138,28,166,1.6749379652605458,18.228366854169476
Task_14094,2905,316,136,84,220,9.16403785488959,54.10326309866878
Task_14095,2313,97,74,176,250,23.602040816326532,43.743292412532476
Task_14096,2805,677,40,171,211,4.1371681415929205,54.09946593565778
Task_14097,1239,144,128,68,196,8.544827586206896,26.6532688576379
Task_14098,1585,476,144,176,320,3.3228511530398324,34.627721120315535
Task_14099,960,350,154,150,304,2.735042735042735,24.22501217607771
Task_14100,2409,526,107,178,285,4.571157495256167,47.677947598666094
Task_14101,2877,863,114,69,183,3.329861111111111,54.87290794822897
Task_14102,1017,483,74,158,232,2.1012396694214877,25.36723845238366
Task_14103,1109,654,186,98,284,1.6931297709923665,27.363398980870397
Task_14104,1310,386,11,87,98,3.3850129198966408,28.205964633867126
Task_14105,2724,636,129,88,217,4.276295133437991,52.32729686330103
Task_14106,779,69,68,110,178,11.128571428571428,18.989636804943498
Task_14107,1785,955,127,62,189,1.8671548117154813,38.01609752269892
Task_14108,1308,568,78,27,105,2.298769771528998,28.237616080389135
Task_14109,2500,589,14,65,79,4.237288135593221,47.11678859285692
Task_14110,1231,146,27,86,113,8.374149659863946,25.840224791712767
Task_14111,1906,646,82,188,270,2.945904173106646,40.13308479550255
Task_14112,640,681,64,161,225,0.9384164222873901,19.8409210386988
Task_14113,945,970,166,144,310,0.9732234809474768,25.8586081297656
Task_14114,1508,79,131,52,183,18.85,29.9240501507149
Task_14115,1960,1018,102,73,175,1.9234543670264965,40.968382198453426
Task_14116,1714,73,23,148,171,23.16216216216216,33.65176405363612
Task_14117,666,845,127,192,319,0.7872340425531915,21.206667104821886
Task_14118,774,263,93,109,202,2.9318181818181817,20.59601042761378
Task_14119,1393,537,144,109,253,2.5892193308550184,31.381032319605538
Task_14120,1683,105,197,73,270,15.877358490566039,33.380889178900105
Task_14121,968,552,140,147,287,1.7504520795660037,24.894209819833065
Task_14122,953,705,67,115,182,1.3498583569405098,24.51806668445933
Task_14123,1400,534,193,57,250,2.616822429906542,30.892795324724347
Task_14124,2212,379,109,111,220,5.821052631578947,43.690039157926805
Task_14125,2158,897,90,68,158,2.403118040089087,43.422419667614996
Task_14126,2912,279,39,98,137,10.4,53.75757093014925
Task_14127,1752,463,70,45,115,3.7758620689655173,35.05046222584864
Task_14128,1017,371,169,85,254,2.7338709677419355,24.598377439560753
Task_14129,2931,81,63,18,81,35.74390243902439,50.79102010909556
Task_14130,1840,597,122,200,322,3.076923076923077,39.092923228966214
Task_14131,1359,755,153,105,258,1.7976190476190477,31.541277685111538
Task_14132,1557,862,21,103,124,1.8041714947856315,34.125449586118414
Task_14133,1268,607,68,129,197,2.085526315789474,29.520536109106008
Task_14134,1267,426,105,84,189,2.9672131147540983,28.384199773415688
Task_14135,1174,324,120,154,274,3.6123076923076924,27.396523622696083
Task_14136,943,761,42,149,191,1.23753280839895,24.54628208956343
Task_14137,518,242,45,23,68,2.1316872427983538,13.986560712706043
Task_14138,1453,241,167,98,265,6.0041322314049586,31.409955748424537
Task_14139,1660,448,106,49,155,3.6971046770601337,33.8759254274136
Task_14140,2431,1019,136,183,319,2.3833333333333333,49.73813335578806
Task_14141,1035,815,103,120,223,1.2683823529411764,26.35291468289903
Task_14142,1631,850,130,52,182,1.9165687426556992,35.13297911640675
Task_14143,905,693,180,13,193,1.3040345821325647,22.91281921345069
Task_14144,2591,502,32,63,95,5.151093439363817,48.65625564032377
Task_14145,1578,407,141,200,341,3.8676470588235294,34.42572920047501
Task_14146,1820,230,79,78,157,7.878787878787879,36.21709470554935
Task_14147,653,968,200,118,318,0.673890608875129,21.366269815341756
Task_14148,2004,514,52,128,180,3.89126213592233,40.66883737265922
Task_14149,852,781,11,113,124,1.0895140664961638,22.574193272540146
Task_14150,1171,562,162,200,362,2.079928952042629,28.56906828912172
Task_14151,1266,303,139,57,196,4.1644736842105265,27.78901002603784
Task_14152,2076,858,16,84,100,2.4167636786961584,41.83956557233356
Task_14153,860,258,103,199,302,3.3204633204633205,22.409392774573707
Task_14154,1099,796,194,184,378,1.3789209535759097,28.13792338893373
Task_14155,2950,98,28,89,117,29.7979797979798,52.48835487383263
Task_14156,1829,912,116,189,305,2.00328587075575,39.81135319025815
Task_14157,2473,141,189,96,285,17.41549295774648,46.85966137758544
Task_14158,2613,217,154,27,181,11.986238532110091,48.25777010431023
Task_14159,1710,65,26,45,71,25.90909090909091,31.118310745510595
Task_14160,2242,361,143,32,175,6.193370165745856,43.04701493178354
Task_14161,2384,145,30,117,147,16.328767123287673,44.4693081990016
Task_14162,1157,608,74,69,143,1.8998357963875205,26.74732052867034
Task_14163,2402,214,102,57,159,11.172093023255814,44.967512149711716
Task_14164,2036,851,123,59,182,2.3896713615023475,41.44238904463575
Task_14165,1860,276,51,170,221,6.714801444043322,38.06242497942982
Task_14166,837,395,26,38,64,2.1136363636363638,19.6183225411863
Task_14167,2347,246,25,165,190,9.502024291497976,45.34570051849655
Task_14168,2444,65,100,36,136,37.03030303030303,43.6363812596857
Task_14169,1433,200,46,194,240,7.129353233830845,31.007954236954884
Task_14170,1337,248,118,155,273,5.3694779116465865,29.717715527302445
Task_14171,2828,664,43,108,151,4.252631578947368,53.728925128521446
Task_14172,2359,745,91,32,123,3.1621983914209117,45.69639797717473
Task_14173,1959,897,19,30,49,2.181514476614699,38.90323432168187
Task_14174,1942,335,187,150,337,5.779761904761905,39.85691851293436
Task_14175,2006,874,178,62,240,2.2925714285714287,41.52584323269627
Task_14176,1427,159,196,40,236,8.91875,29.578846746238856
Task_14177,1195,160,72,105,177,7.422360248447205,26.272134973814783
Task_14178,919,683,107,51,158,1.3435672514619883,23.059735810992592
Task_14179,1509,415,179,161,340,3.6274038461538463,33.29790679414722
Task_14180,2463,713,177,152,329,3.4495798319327733,49.28749967302546
Task_14181,1312,962,158,179,337,1.3624091381100727,31.842367533425257
Task_14182,2228,991,107,125,232,2.245967741935484,45.95690428843735
Task_14183,2782,317,59,118,177,8.748427672955975,52.28441619983601
Task_14184,747,320,154,179,333,2.3271028037383177,20.9336174979795
Task_14185,1497,938,74,96,170,1.5942492012779552,33.857046659243615
Task_14186,2763,270,125,43,168,10.195571955719558,50.7955674172268
Task_14187,2922,838,78,110,188,3.4827175208581647,56.34876312334634
Task_14188,1599,347,191,47,238,4.594827586206897,33.176971520598734
Task_14189,1065,627,77,30,107,1.6958598726114649,24.601086804112047
Task_14190,2132,1009,180,76,256,2.110891089108911,44.16647373580272
Task_14191,1091,180,144,119,263,6.027624309392265,25.118454782686047
Task_14192,1276,879,40,116,156,1.45,29.744917604324645
Task_14193,2211,546,35,96,131,4.042047531992687,43.64470462568115
Task_14194,658,486,23,136,159,1.351129363449692,18.897654956487504
Task_14195,2741,597,199,57,256,4.583612040133779,52.354601452480004
Task_14196,2579,89,46,75,121,28.655555555555555,46.51242911473341
Task_14197,2865,106,124,165,289,26.77570093457944,52.591291934109194
Task_14198,2611,710,188,71,259,3.6722925457102673,50.75241347954235
Task_14199,2729,644,168,20,188,4.231007751937985,51.559556724598515
Task_14200,2759,338,184,17,201,8.138643067846608,51.09877184579698
Task_14201,1250,201,112,133,245,6.188118811881188,28.02177219063636
Task_14202,2860,680,15,195,210,4.199706314243759,55.040828834723754
Task_14203,2080,500,172,21,193,4.151696606786427,40.96521571933781
Task_14204,2547,399,106,90,196,6.3675,48.753220934935285
Task_14205,2611,422,83,95,178,6.1725768321513,49.75650982448116
Task_14206,1450,116,31,130,161,12.393162393162394,29.508186463127526
Task_14207,1938,414,150,10,160,4.669879518072289,37.986513909092785
Task_14208,1448,73,112,126,238,19.56756756756757,29.80109065753187
Task_14209,2221,683,103,62,165,3.247076023391813,43.94004128122565
Task_14210,1802,381,133,60,193,4.717277486910994,36.4894994371815
Task_14211,2001,619,98,112,210,3.22741935483871,41.09224136126719
Task_14212,593,758,144,64,208,0.7812911725955204,18.704061650215476
Task_14213,2612,850,193,154,347,3.0693301997649822,52.162432985736054
Task_14214,2021,229,157,149,306,8.78695652173913,40.59554965920387
Task_14215,1968,232,122,95,217,8.446351931330472,39.26098896969474
Task_14216,802,629,48,179,227,1.273015873015873,22.277573054738358
Task_14217,1689,962,196,121,317,1.7538940809968848,37.689240800564136
Task_14218,2525,612,94,18,112,4.1190864600326265,47.612047539206806
Task_14219,770,427,104,80,184,1.7990654205607477,20.338913099227998
Task_14220,2160,145,138,108,246,14.794520547945206,41.827101482422286
Task_14221,2105,546,26,32,58,3.8482632541133457,40.139323249318004
Task_14222,1987,861,162,123,285,2.305104408352668,41.969181474472315
Task_14223,2152,921,112,178,290,2.334056399132321,44.87376882496323
Task_14224,2739,713,189,37,226,3.8361344537815127,52.362576516578734
Task_14225,1091,422,29,60,89,2.57919621749409,24.39220986961763
Task_14226,2281,953,188,32,220,2.390985324947589,45.81809383158129
Task_14227,1361,871,185,99,284,1.5607798165137614,31.98435244687408
Task_14228,2783,406,25,92,117,6.837837837837838,52.06019731323934
Task_14229,1152,134,129,26,155,8.533333333333333,24.331131058724754
Task_14230,1940,817,15,34,49,2.371638141809291,38.421277950409284
Task_14231,1482,984,140,100,240,1.5045685279187817,34.07010957670148
Task_14232,1976,869,193,89,282,2.2712643678160918,41.568966500079405
Task_14233,746,593,41,59,100,1.2558922558922558,19.47833159279338
Task_14234,1326,960,109,183,292,1.379812695109261,31.85405611011851
Task_14235,1729,974,83,191,274,1.7733333333333334,38.322780145328046
Task_14236,1137,995,147,53,200,1.141566265060241,28.04057001168267
Task_14237,2927,1009,193,147,340,2.898019801980198,57.60908662625508
Task_14238,1483,921,185,73,258,1.6084598698481563,33.5695381680792
Task_14239,1186,105,135,138,273,11.18867924528302,26.088340280598192
Task_14240,922,709,53,61,114,1.2985915492957747,22.90971168676073
Task_14241,1028,539,106,66,172,1.9037037037037037,24.6239951212518
Task_14242,2418,741,30,38,68,3.2587601078167117,45.769257202530945
Task_14243,2825,368,48,189,237,7.6558265582655824,53.66548320148539
Task_14244,1407,452,50,181,231,3.1059602649006623,31.529431512746854
Task_14245,1875,432,172,151,323,4.330254041570439,39.053618639645094
Task_14246,2753,528,157,35,192,5.2041587901701325,51.832236490095276
Task_14247,1305,449,139,141,280,2.9,29.87817666329036
Task_14248,2637,462,142,15,157,5.695464362850972,49.15744239737214
Task_14249,640,882,52,53,105,0.72480181200453,19.02030597282761
Task_14250,1498,502,32,115,147,2.978131212723658,32.21101545038868
Task_14251,1863,319,192,115,307,5.821875,38.367371065789726
Task_14252,2471,789,112,93,205,3.1278481012658226,48.94249991666754
Task_14253,2753,369,20,176,196,7.440540540540541,52.183117057367376
Task_14254,1391,846,101,181,282,1.6422668240850058,32.537348475734966
Task_14255,1295,453,151,27,178,2.852422907488987,28.2034390861275
Task_14256,1863,988,175,16,191,1.8837209302325582,38.99556668556362
Task_14257,2048,846,102,197,299,2.4179456906729633,43.060477870430965
Task_14258,2057,366,84,58,142,5.604904632152588,40.009296846450475
Task_14259,858,746,86,82,168,1.1485943775100402,22.631072344177664
Task_14260,1386,670,118,102,220,2.0655737704918034,31.52827563776943
Task_14261,539,903,52,169,221,0.5962389380530974,19.09809942228701
Task_14262,2438,878,131,37,168,2.7736063708759953,47.650146597537855
Task_14263,2100,305,98,32,130,6.862745098039215,40.27994871545217
Task_14264,1619,365,12,138,150,4.423497267759563,33.65288868242765
Task_14265,1502,1002,55,181,236,1.497507477567298,34.706538969460304
Task_14266,713,76,193,46,239,9.25974025974026,17.470536643187817
Task_14267,2897,376,157,143,300,7.684350132625995,54.924949172587695
Task_14268,1227,102,41,27,68,11.912621359223301,24.4628454747951
Task_14269,1240,607,92,49,141,2.039473684210526,27.784186179269216
Task_14270,1200,653,22,166,188,1.834862385321101,28.410890378430285
Task_14271,2260,879,93,153,246,2.5681818181818183,46.33109282261281
Task_14272,2863,909,83,51,134,3.146153846153846,54.52801276911782
Task_14273,1232,469,199,180,379,2.6212765957446806,29.289460974142855
Task_14274,1453,457,22,58,80,3.1724890829694323,30.053911507370103
Task_14275,1170,908,192,153,345,1.2871287128712872,29.39220563358059
Task_14276,699,316,52,114,166,2.2050473186119874,19.30911919299269
Task_14277,1056,75,87,167,254,13.894736842105264,23.817605796501756
Task_14278,1519,608,82,101,183,2.4942528735632186,33.17837929830663
Task_14279,2999,1000,125,57,182,2.996003996003996,57.18995499001621
Task_14280,2220,368,67,90,157,6.016260162601626,43.14957813299384
Task_14281,1239,189,104,91,195,6.521052631578947,27.414051537613265
Task_14282,1091,819,177,90,267,1.3304878048780489,27.311640663347205
Task_14283,770,849,118,112,230,0.9058823529411765,22.317101684843237
Task_14284,597,322,138,173,311,1.848297213622291,18.4599402447356
Task_14285,1451,934,25,43,68,1.5518716577540106,31.021371672163724
Task_14286,1516,566,36,72,108,2.673721340388007,32.07219058055782
Task_14287,2338,980,65,106,171,2.383282364933741,47.290121562974115
Task_14288,2771,821,97,171,268,3.3710462287104623,54.283223060692684
Task_14289,724,138,24,29,53,5.2086330935251794,16.98966623800992
Task_14290,899,358,141,160,301,2.5041782729805013,23.286759177413597
Task_14291,724,361,190,66,256,2.0,19.72459061150743
Task_14292,2061,460,189,187,376,4.4707158351409975,42.3796417951824
Task_14293,2565,269,53,169,222,9.5,49.15721155581635
Task_14294,1756,793,157,187,344,2.211586901763224,38.45695843017413
Task_14295,691,970,42,173,215,0.7116374871266735,21.512309461241973
Task_14296,2920,198,121,141,262,14.673366834170855,54.50503053292209
Task_14297,1659,561,54,128,182,2.9519572953736657,35.35325118423187
Task_14298,1945,890,186,82,268,2.1829405162738498,40.97402652703256
Task_14299,1295,315,104,29,133,4.098101265822785,27.598486858443778
Task_14300,1671,373,87,90,177,4.467914438502674,34.538254958628364
Task_14301,2545,76,195,180,375,33.05194805194805,47.70812028055485
Task_14302,865,889,174,147,321,0.9719101123595506,24.394472345669442
Task_14303,2986,78,25,82,107,37.79746835443038,52.766160227412975
Task_14304,823,170,190,15,205,4.812865497076023,19.833394407581434
Task_14305,1962,949,173,12,185,2.0652631578947367,40.30839499935332
Task_14306,1613,347,115,46,161,4.635057471264368,32.75311214733256
Task_14307,1524,76,122,57,179,19.792207792207794,30.078684071575292
Task_14308,830,449,74,162,236,1.8444444444444446,22.324270283839656
Task_14309,2725,695,174,27,201,3.9152298850574714,51.90036957648656
Task_14310,1091,119,89,188,277,9.091666666666667,25.02695595317756
Task_14311,2260,387,170,185,355,5.824742268041237,45.19292809560318
Task_14312,1870,935,150,184,334,1.9978632478632479,40.6559226414303
Task_14313,832,369,99,149,248,2.2486486486486488,22.008496349487544
Task_14314,1308,998,200,105,305,1.3093093093093093,31.646528452903663
Task_14315,2042,658,145,153,298,3.0986342943854326,42.307396009386245
Task_14316,1992,903,54,64,118,2.2035398230088497,40.77061846572659
Task_14317,1198,574,151,86,237,2.083478260869565,28.039634771470773
Task_14318,1285,643,58,73,131,1.9953416149068324,29.05602316314692
Task_14319,2305,538,96,72,168,4.276437847866419,44.82905883196724
Task_14320,1756,406,21,130,151,4.314496314496314,35.92778054975356
Task_14321,1179,545,56,145,201,2.159340659340659,27.99485286302509
Task_14322,2873,858,52,93,145,3.3445867287543654,55.21460066907378
Task_14323,624,247,60,128,188,2.5161290322580645,18.117409520512712
Task_14324,1680,475,169,44,213,3.5294117647058822,34.74522353676526
Task_14325,2276,142,63,30,93,15.916083916083917,41.5852508736998
Task_14326,2356,824,100,92,192,2.855757575757576,47.13280783661639
Task_14327,1765,348,172,173,345,5.0573065902578795,37.17033539006709
Task_14328,2606,434,192,33,225,5.99080459770115,49.3439989382772
Task_14329,1713,266,17,12,29,6.415730337078652,32.56294113521807
Task_14330,1174,300,73,195,268,3.9003322259136213,27.478218280228575
Task_14331,504,496,159,62,221,1.0140845070422535,16.345010605084955
Task_14332,2842,665,115,16,131,4.267267267267267,53.01400709423137
Task_14333,1794,260,72,42,114,6.873563218390805,35.082517080174036
Task_14334,2632,241,152,145,297,10.87603305785124,50.24528995219521
Task_14335,2276,650,165,106,271,3.49615975422427,45.797834367334225
Task_14336,2158,821,161,25,186,2.625304136253041,43.10186974115721
Task_14337,1145,67,101,95,196,16.83823529411765,24.864371760076164
Task_14338,2898,878,143,50,193,3.2969283276450514,55.298405719547844
Task_14339,1426,752,170,76,246,1.8937583001328022,32.135318093093986
Task_14340,1507,143,131,187,318,10.465277777777779,31.95799537532749
Task_14341,842,781,31,17,48,1.0767263427109974,20.651813439730947
Task_14342,701,1015,10,148,158,0.6899606299212598,21.350626907917142
Task_14343,586,454,134,165,299,1.287912087912088,18.542353215284674
Task_14344,1036,478,198,149,347,2.162839248434238,26.025585410322986
Task_14345,2012,373,58,17,75,5.379679144385027,37.78569066892833
Task_14346,1521,242,131,144,275,6.2592592592592595,32.596893064304844
Task_14347,985,546,175,126,301,1.8007312614259599,25.19037399361874
Task_14348,2777,514,147,23,170,5.392233009708738,51.7979236568492
Task_14349,2839,954,103,83,186,2.972774869109948,54.803995546372846
Task_14350,656,1000,76,87,163,0.6553446553446554,20.5755497496631
Task_14351,2202,265,187,76,263,8.278195488721805,42.923193301007636
Task_14352,565,465,118,106,224,1.2124463519313304,17.78861907658712
Task_14353,1655,414,47,34,81,3.9879518072289155,33.05889210060153
Task_14354,984,666,74,49,123,1.4752623688155921,23.734534273279674
Task_14355,1180,1017,22,69,91,1.1591355599214146,27.886189237169617
Task_14356,1104,276,107,163,270,3.9855595667870034,26.127796890296
Task_14357,1496,358,74,148,222,4.167130919220056,32.488821006831024
Task_14358,2307,466,82,193,275,4.940042826552463,45.93894646292773
Task_14359,1507,113,158,20,178,13.219298245614034,29.822898692821123
Task_14360,1169,249,162,190,352,4.676,27.47412843401885
Task_14361,2803,270,182,34,216,10.343173431734318,51.85697016517017
Task_14362,559,489,41,161,202,1.1408163265306122,17.731791633525017
Task_14363,2756,336,171,199,370,8.178041543026707,52.95509297060526
Task_14364,2424,724,59,108,167,3.343448275862069,47.874030527850884
Task_14365,2165,345,127,87,214,6.257225433526012,42.516624412342445
Task_14366,1323,856,145,15,160,1.543757292882147,29.557208023975093
Task_14367,925,805,11,10,21,1.1476426799007444,21.93292868586394
Task_14368,1325,904,104,43,147,1.4640883977900552,29.901601500362883
Task_14369,1284,98,122,87,209,12.969696969696969,27.051262628379735
Task_14370,890,286,29,41,70,3.1010452961672472,20.092687216311095
Task_14371,2274,509,153,176,329,4.458823529411765,45.68133875523978
Task_14372,567,856,167,190,357,0.661610268378063,19.939952141666144
Task_14373,1552,569,41,108,149,2.7228070175438597,33.23156392615769
Task_14374,1820,441,101,149,250,4.117647058823529,37.880244802542855
Task_14375,1551,416,70,161,231,3.7194244604316546,33.61492954140945
Task_14376,2088,630,109,48,157,3.3090332805071316,41.17077183623396
Task_14377,897,634,19,179,198,1.4125984251968504,23.56564250855995
Task_14378,1248,601,190,52,242,2.0730897009966776,28.740528738265336
Task_14379,1951,444,76,68,144,4.384269662921349,38.810863637628685
Task_14380,518,742,108,193,301,0.6971736204576043,18.540933800891725
Task_14381,835,881,63,137,200,0.9467120181405896,23.414623847312942
Task_14382,1389,360,192,17,209,3.847645429362881,29.53804972941836
Task_14383,2799,464,118,175,293,6.019354838709678,53.68260953246122
Task_14384,2185,310,198,144,342,7.02572347266881,43.62880917244092
Task_14385,2869,550,196,123,319,5.206896551724138,55.11123967792139
Task_14386,2966,800,124,161,285,3.7028714107365794,57.34493103785068
Task_14387,2250,867,177,71,248,2.5921658986175116,45.47622411075022
Task_14388,967,196,130,107,237,4.908629441624366,23.41774429922153
Task_14389,2129,611,157,105,262,3.4787581699346406,43.304309416821575
Task_14390,1056,396,130,77,207,2.6599496221662466,24.98767074953247
Task_14391,1064,336,198,187,385,3.1572700296735907,26.24434729052862
Task_14392,1170,955,86,81,167,1.2238493723849373,28.171026666330537
Task_14393,2468,904,51,162,213,2.7270718232044198,49.653364057960296
Task_14394,1554,582,99,134,233,2.665523156089194,34.02032728831863
Task_14395,2218,842,83,125,208,2.631079478054567,45.27942425589538
Task_14396,1194,584,57,10,67,2.041025641025641,25.54659047324218
Task_14397,850,328,15,45,60,2.5835866261398177,19.6303758347043
Task_14398,2713,394,128,200,328,6.868354430379747,52.284158445865046
Task_14399,2380,593,113,119,232,4.006734006734007,47.107505294828876
Task_14400,654,195,44,23,67,3.336734693877551,16.224495053455914
Task_14401,2751,580,181,92,273,4.734939759036145,52.98564909252742
Task_14402,2538,324,27,143,170,7.809230769230769,48.3388018269146
Task_14403,2584,278,86,92,178,9.261648745519713,48.760489738061125
Task_14404,2261,965,166,80,246,2.3405797101449277,46.11082836021259
Task_14405,1454,187,145,20,165,7.73404255319149,29.898276794601713
Task_14406,1444,381,77,13,90,3.7801047120418847,29.55932767416175
Task_14407,1567,183,110,67,177,8.516304347826088,31.946836945045774
Task_14408,1082,616,118,150,268,1.753646677471637,26.81810673258251
Task_14409,2908,411,139,74,213,7.058252427184466,54.36676176482294
Task_14410,950,448,140,31,171,2.115812917594655,22.728793124733016
Task_14411,1614,384,68,87,155,4.1922077922077925,33.552072802404304
Task_14412,2522,408,28,190,218,6.166259168704157,48.83900233567445
Task_14413,1554,806,196,128,324,1.9256505576208178,35.12053165567648
Task_14414,2839,241,14,50,64,11.731404958677686,50.900602445480466
Task_14415,2913,346,57,96,153,8.394812680115274,54.201978593629974
Task_14416,1605,68,123,160,283,23.26086956521739,32.50729402293698
Task_14417,1278,437,112,195,307,2.9178082191780823,29.613545547225826
Task_14418,2045,210,184,91,275,9.691943127962086,40.53270829803616
Task_14419,1210,606,148,196,344,1.9934102141680394,29.237406884776487
Task_14420,2454,256,132,133,265,9.54863813229572,47.326930317164845
Task_14421,1919,517,32,138,170,3.7046332046332044,39.169257306846184
Task_14422,2718,762,62,108,170,3.562254259501966,52.64009981238689
Task_14423,2326,557,146,199,345,4.168458781362007,46.76422411720813
Task_14424,2994,167,42,152,194,17.821428571428573,54.948773096003265
Task_14425,2956,771,186,200,386,3.8290155440414506,57.60751343813818
Task_14426,683,1011,191,188,379,0.674901185770751,22.351924673567154
Task_14427,765,300,123,190,313,2.5415282392026577,21.08024624677476
Task_14428,1299,655,37,183,220,1.9801829268292683,30.24216493841662
Task_14429,2336,705,130,48,178,3.308781869688385,45.546647501408245
Task_14430,1807,128,165,199,364,14.007751937984496,36.72783047356367
Task_14431,1020,366,24,10,34,2.779291553133515,21.89665229656249
Task_14432,1128,187,19,48,67,6.0,23.781761933485072
Task_14433,2048,136,194,109,303,14.94890510948905,40.233928558049115
Task_14434,1924,538,68,26,94,3.569573283858998,37.81309115907306
Task_14435,1289,564,97,116,213,2.28141592920354,29.67285078112918
Task_14436,524,74,116,146,262,6.986666666666666,15.530665012272992
Task_14437,883,255,113,55,168,3.44921875,21.33014995863302
Task_14438,2866,593,42,99,141,4.824915824915825,54.054946333900325
Task_14439,690,160,123,182,305,4.285714285714286,19.103666388134894
Task_14440,1060,335,124,51,175,3.1547619047619047,24.494396532748066
Task_14441,1057,524,31,28,59,2.013333333333333,23.461429395251685
Task_14442,2788,118,56,194,250,23.428571428571427,51.7025301782463
Task_14443,2255,137,139,128,267,16.340579710144926,43.364284224736764
Task_14444,1596,788,25,25,50,2.0228136882129277,32.847774777719216
Task_14445,1548,700,55,101,156,2.2082738944365192,33.73477622495465
Task_14446,2736,824,40,127,167,3.3163636363636364,53.01680355295654
Task_14447,2687,72,45,51,96,36.80821917808219,47.22955994180958
Task_14448,1626,618,149,165,314,2.626817447495961,35.68259779178403
Task_14449,2386,871,65,112,177,2.7362385321100917,47.76308331519747
Task_14450,2738,886,161,133,294,3.0868094701240136,54.00192429312121
Task_14451,1239,788,24,47,71,1.570342205323194,27.229458478373086
Task_14452,578,896,163,38,201,0.6443701226309922,18.914926148239896
Task_14453,2740,750,149,14,163,3.648468708388815,51.86969582712185
Task_14454,1837,623,186,97,283,2.9439102564102564,38.83423282863662
Task_14455,1197,708,34,51,85,1.688293370944993,26.955132076715216
Task_14456,647,969,87,14,101,0.6670103092783505,19.245381724228
Task_14457,1985,598,17,198,215,3.313856427378965,40.844963940980044
Task_14458,2828,346,16,118,134,8.14985590778098,52.621487725004975
Task_14459,1275,958,200,134,334,1.329509906152242,31.185090242739076
Task_14460,2037,535,106,154,260,3.800373134328358,41.66895263205141
Task_14461,1687,187,132,130,262,8.97340425531915,35.04476364456206
Task_14462,1128,761,16,106,122,1.4803149606299213,26.899542887256533
Task_14463,2949,1003,123,65,188,2.937250996015936,56.645472603223816
Task_14464,673,496,124,197,321,1.3541247484909458,20.24822326396624
Task_14465,2609,439,45,141,186,5.929545454545455,49.931333140257436
Task_14466,1060,436,171,92,263,2.425629290617849,25.710127124746933
Task_14467,1006,823,60,108,168,1.220873786407767,25.534688081923438
Task_14468,2271,177,182,62,244,12.758426966292134,43.2481067213767
Task_14469,2204,555,173,143,316,3.964028776978417,44.61323843963427
Task_14470,1469,891,187,193,380,1.6468609865470851,34.37225020312231
Task_14471,886,343,157,92,249,2.5755813953488373,22.59852957207183
Task_14472,2815,609,74,28,102,4.614754098360656,52.249094639604515
Task_14473,1717,850,72,137,209,2.017626321974148,37.46189535281088
Task_14474,1422,724,131,106,237,1.9613793103448276,32.34953306907338
Task_14475,2536,775,85,145,230,3.268041237113402,50.22987442047535
Task_14476,1846,681,101,41,142,2.7067448680351904,37.419220937989664
Task_14477,832,276,185,177,362,3.003610108303249,22.263755899827263
Task_14478,2960,890,50,78,128,3.3221099887766554,56.668412108969456
Task_14479,1873,870,162,16,178,2.1504018369690012,38.541076313310576
Task_14480,1117,581,44,150,194,1.9192439862542956,26.956599359933396
Task_14481,1502,976,25,28,53,1.5373592630501536,32.02310901306872
Task_14482,1618,319,108,52,160,5.05625,33.04729583279744
Task_14483,2092,385,151,45,196,5.419689119170984,40.86865035761873
Task_14484,2468,934,179,71,250,2.639572192513369,49.148630254445344
Task_14485,1380,384,21,183,204,3.5844155844155843,30.55669300043955
Task_14486,1698,77,121,46,167,21.76923076923077,32.49188014433437
Task_14487,895,272,91,108,199,3.2783882783882783,22.45994376490513
Task_14488,2535,263,102,70,172,9.602272727272727,47.583219881626285
Task_14489,1037,956,196,47,243,1.083594566353187,26.1635743670702
Task_14490,1996,86,131,161,292,22.942528735632184,38.815934442424464
Task_14491,899,231,175,12,187,3.875,21.317632248496086
Task_14492,638,972,109,146,255,0.6557040082219938,20.900316053225932
Task_14493,2822,468,46,182,228,6.017057569296376,53.81139814872878
Task_14494,1489,68,113,153,266,21.579710144927535,30.606800128660563
Task_14495,1762,667,82,47,129,2.6377245508982035,36.083496016608784
Task_14496,2431,402,181,135,316,6.032258064516129,47.69925589003291
Task_14497,568,938,67,54,121,0.6048988285410011,18.298193149458452
Task_14498,664,226,43,148,191,2.9251101321585904,18.646694723935152
Task_14499,1329,910,140,193,333,1.4588364434687158,31.946115312487922
Task_14500,665,674,36,101,137,0.9851851851851852,19.307896727403445
Task_14501,571,1015,97,58,155,0.562007874015748,18.702956968998798
Task_14502,2999,437,67,158,225,6.84703196347032,56.549912396310226
Task_14503,1808,876,175,76,251,2.0615735461801594,38.59614401374835
Task_14504,680,286,54,179,233,2.3693379790940767,19.473979802412074
Task_14505,2919,184,193,53,246,15.778378378378378,53.83847025607141
Task_14506,2291,187,147,35,182,12.186170212765957,43.29188117428837
Task_14507,791,678,40,150,190,1.1649484536082475,21.911277627213522
Task_14508,1953,617,60,50,110,3.1601941747572817,38.59229929500457
Task_14509,1174,179,44,162,206,6.522222222222222,26.215152968407782
Task_14510,2834,1007,47,43,90,2.8115079365079363,53.59499575217006
Task_14511,616,137,76,76,152,4.463768115942029,16.35023861155706
Task_14512,812,579,87,170,257,1.4,22.357710297227403
Task_14513,2029,516,118,161,279,3.9245647969052224,41.577557431938935
Task_14514,616,401,159,57,216,1.5323383084577114,17.895375146640873
Task_14515,894,111,101,183,284,7.982142857142857,21.63931815492249
Task_14516,647,484,49,198,247,1.334020618556701,19.583121913157964
Task_14517,2824,586,115,58,173,4.810902896081772,53.162858224375135
Task_14518,2583,350,78,199,277,7.358974358974359,49.978341959335836
Task_14519,2723,853,123,177,300,3.1885245901639343,53.75243388021414
Task_14520,2241,122,47,107,154,18.21951219512195,41.946636522165164
Task_14521,1131,773,22,58,80,1.4612403100775193,25.885848771658292
Task_14522,2122,430,155,92,247,4.923433874709977,42.42649880918082
Task_14523,1844,911,184,60,244,2.0219298245614037,39.058013052454996
Task_14524,552,1019,166,96,262,0.5411764705882353,19.641627400221527
Task_14525,1791,732,111,47,158,2.4433833560709415,36.78139350910952
Task_14526,2785,884,153,99,252,3.146892655367232,54.486442673677665
Task_14527,1844,422,137,21,158,4.359338061465721,36.54970223058649
Task_14528,543,212,62,82,144,2.5492957746478875,16.030020715642777
Task_14529,549,953,84,66,150,0.5754716981132075,18.259296726078396
Task_14530,937,315,43,165,208,2.9651898734177213,23.351854507834577
Task_14531,2102,664,91,71,162,3.1609022556390975,41.908540001043576
Task_14532,907,335,161,118,279,2.699404761904762,23.179129427587274
Task_14533,2236,587,43,18,61,3.802721088435374,42.07185775799112
Task_14534,1845,76,53,33,86,23.961038961038962,33.90696376296981
Task_14535,1597,986,183,64,247,1.618034447821682,35.470361476960655
Task_14536,812,711,175,185,360,1.1404494382022472,23.234339924006406
Task_14537,2619,249,151,159,310,10.476,50.14909017023327
Task_14538,2388,748,143,45,188,3.1882510013351135,46.63902801619815
Task_14539,800,349,58,47,105,2.2857142857142856,19.3261717797302
Task_14540,953,382,180,155,335,2.4882506527415145,24.363320831929126
Task_14541,1867,285,51,36,87,6.527972027972028,35.91013755091801
Task_14542,2390,413,176,144,320,5.7729468599033815,47.11801608742991
Task_14543,2727,683,119,64,183,3.986842105263158,51.937284555310534
Task_14544,1584,925,83,178,261,1.7105831533477323,35.79532135009518
Task_14545,1250,116,166,117,283,10.683760683760683,27.3482211741248
Task_14546,2778,521,157,136,293,5.32183908045977,53.478603056329995
Task_14547,2910,299,200,174,374,9.7,55.24158710592915
Task_14548,1314,141,132,77,209,9.253521126760564,27.856786607383924
Task_14549,1018,784,82,20,102,1.2968152866242038,24.093547528088408
Task_14550,2562,844,97,36,133,3.0319526627218933,49.32972920777479
Task_14551,1838,800,17,39,56,2.2946317103620473,36.67529612537191
Task_14552,1813,466,178,115,293,3.8822269807280514,37.99376113557904
Task_14553,1108,763,72,98,170,1.450261780104712,27.054672484006744
Task_14554,2831,363,72,88,160,7.777472527472527,52.73866569461856
Task_14555,2158,440,173,92,265,4.893424036281179,43.10991263830917
Task_14556,2222,953,18,194,212,2.3291404612159328,45.72866193231985
Task_14557,2578,764,116,152,268,3.369934640522876,50.994888503581215
Task_14558,2262,145,92,100,192,15.493150684931507,43.24355070875894
Task_14559,1631,186,124,58,182,8.72192513368984,33.15071815118431
Task_14560,932,557,35,149,184,1.6702508960573477,23.73776645465288
Task_14561,1436,858,105,23,128,1.6717112922002328,31.542427511984524
Task_14562,2350,338,187,145,332,6.932153392330384,46.290147189952755
Task_14563,1704,140,141,52,193,12.085106382978724,33.87850283858786
Task_14564,1020,965,148,170,318,1.0559006211180124,27.058898156568095
Task_14565,2800,902,188,49,237,3.10077519379845,54.03027223801663
Task_14566,1830,393,193,154,347,4.644670050761421,38.32746893647905
Task_14567,2640,66,54,110,164,39.40298507462686,48.11291086523226
Task_14568,1969,533,60,169,229,3.6872659176029963,40.596170981030724
Task_14569,1988,795,70,62,132,2.4974874371859297,40.458873463632195
Task_14570,1043,899,158,64,222,1.1588888888888889,26.31307261924751
Task_14571,2572,130,183,14,197,19.633587786259543,47.11503939219704
Task_14572,1514,608,106,46,152,2.4860426929392445,31.94312647056027
Task_14573,512,626,58,118,176,0.8165869218500797,17.215287242238883
Task_14574,661,160,181,36,217,4.105590062111801,17.454724041237323
Task_14575,1471,498,35,163,198,2.9478957915831665,32.353449569742786
Task_14576,2724,324,43,28,71,8.381538461538462,49.22505309724121
Task_14577,1102,103,77,186,263,10.596153846153847,24.893820094199764
Task_14578,564,860,47,44,91,0.6550522648083623,17.5815857891522
Task_14579,2325,750,98,27,125,3.095872170439414,45.13494343080135
Task_14580,2628,704,184,108,292,3.727659574468085,51.64153895759853
Task_14581,2177,816,198,139,337,2.664626682986536,45.09687503160152
Task_14582,773,566,165,119,284,1.36331569664903,21.74761890847759
Task_14583,558,234,116,88,204,2.374468085106383,16.703559380769054
Task_14584,2537,909,40,114,154,2.7879120879120878,49.89343118493278
Task_14585,912,453,130,76,206,2.0088105726872247,22.880204420901805
Task_14586,2727,902,64,147,211,3.0199335548172757,53.65211720764764
Task_14587,1506,329,118,91,209,4.5636363636363635,32.13192713826168
Task_14588,1366,713,56,34,90,1.9131652661064427,29.35910452717386
Task_14589,2851,537,116,114,230,5.299256505576208,54.36995295398791
Task_14590,2811,408,134,37,171,6.872860635696822,52.066111147846264
Task_14591,1913,291,199,113,312,6.551369863013699,39.08251550559931
Task_14592,2086,242,88,176,264,8.584362139917696,41.53970269645101
Task_14593,2165,975,196,29,225,2.2182377049180326,44.07971092612984
Task_14594,1419,740,52,89,141,1.9149797570850202,31.627392978443577
Task_14595,2832,624,180,111,291,4.5312,54.61874907195416
Task_14596,2614,505,158,177,335,5.16600790513834,51.079753596433136
Task_14597,520,556,113,117,230,0.933572710951526,17.454566240669077
Task_14598,1982,265,87,81,168,7.451127819548872,38.87900569355301
Task_14599,2367,890,51,185,236,2.6565656565656566,48.146656275252546
Task_14600,1287,384,192,59,251,3.342857142857143,28.609039932976632
Task_14601,1186,522,166,150,316,2.2676864244741872,28.400416385250377
Task_14602,704,642,81,160,241,1.0948678071539657,20.722227839751415
Task_14603,627,590,33,84,117,1.0609137055837563,18.191685720911877
Task_14604,729,298,198,50,248,2.4381270903010033,19.36971132231251
Task_14605,1303,167,168,43,211,7.755952380952381,27.59095951740517
Task_14606,1464,210,88,124,212,6.938388625592417,31.28996539342536
Task_14607,2848,178,137,141,278,15.910614525139664,52.91844414790813
Task_14608,2734,503,171,161,332,5.424603174603175,52.9360883610781
Task_14609,1465,197,74,32,106,7.398989898989899,29.58965392889429
Task_14610,1626,296,127,26,153,5.474747474747475,32.711468975769414
Task_14611,533,745,150,75,225,0.7144772117962467,18.015742068614347
Task_14612,2982,1017,141,156,297,2.9292730844793713,58.325039720500534
Task_14613,541,729,148,144,292,0.7410958904109589,18.58770485249444
Task_14614,710,832,195,60,255,0.8523409363745498,20.916721984570284
Task_14615,1626,685,156,104,260,2.370262390670554,35.559889767937875
Task_14616,725,323,146,182,328,2.2376543209876543,20.577133496719892
Task_14617,2370,641,21,159,180,3.691588785046729,46.728066056475804
Task_14618,2676,704,74,60,134,3.795744680851064,51.01324870353593
Task_14619,1958,823,142,44,186,2.3762135922330097,39.98776885503954
Task_14620,2267,153,197,86,283,14.720779220779221,43.4748668348467
Task_14621,2273,269,91,65,156,8.41851851851852,43.21022269455832
Task_14622,1236,705,17,173,190,1.7507082152974505,29.143335144987148
Task_14623,1594,801,25,195,220,1.9875311720698254,35.41674433354688
Task_14624,832,925,194,137,331,0.8984881209503239,24.030802040205113
Task_14625,2502,409,132,60,192,6.102439024390244,47.65323635973011
Task_14626,1495,844,179,180,359,1.7692307692307692,34.524505172878925
Task_14627,771,756,142,81,223,1.0184940554821664,21.647923372684932
Task_14628,1684,172,48,38,86,9.734104046242775,32.568578008495656
Task_14629,2079,313,89,194,283,6.6210191082802545,41.81013327105602
Task_14630,2323,97,151,61,212,23.70408163265306,43.04750572839223
Task_14631,1529,120,147,29,176,12.636363636363637,30.450178041649508
Task_14632,2572,360,117,39,156,7.124653739612189,47.925844257561586
Task_14633,2656,988,127,188,315,2.685540950455005,53.196461787892964
Task_14634,2726,95,104,58,162,28.395833333333332,48.888161421080916
Task_14635,2279,293,54,64,118,7.7517006802721085,43.35986637566276
Task_14636,888,660,156,84,240,1.3434190620272315,23.342900886017475
Task_14637,805,775,81,176,257,1.0373711340206186,22.839035622207245
Task_14638,1669,487,191,181,372,3.4200819672131146,36.234189864984174
Task_14639,1368,967,11,166,177,1.4132231404958677,31.817106099610942
Task_14640,2595,647,60,95,155,4.00462962962963,50.12098222325145
Task_14641,932,1012,102,33,135,0.9200394866732478,24.09077943033878
Task_14642,2077,660,126,79,205,3.1422087745839637,42.04759864050899
Task_14643,1925,607,194,107,301,3.1661184210526314,40.239631906028244
Task_14644,1788,362,177,138,315,4.925619834710743,37.39379012287251
Task_14645,1673,841,124,98,222,1.986935866983373,36.614470832274904
Task_14646,990,665,184,155,339,1.4864864864864864,25.81167105448974
Task_14647,1490,893,199,171,370,1.6666666666666667,34.633887022649795
Task_14648,990,129,28,182,210,7.615384615384615,23.147922262608066
Task_14649,2476,163,165,123,288,15.097560975609756,47.10178674146267
Task_14650,1584,528,84,86,170,2.9943289224952743,33.56456044276495
Task_14651,1268,327,87,161,248,3.8658536585365852,28.794459771416513
Task_14652,1041,1002,193,164,357,1.0378863409770689,27.67307124796174
Task_14653,759,232,148,72,220,3.257510729613734,19.75653186385988
Task_14654,1550,957,185,116,301,1.6179540709812108,35.39163603944686
Task_14655,989,885,87,32,119,1.1162528216704288,24.24318572593857
Task_14656,630,806,40,147,187,0.7806691449814126,19.70492012695019
Task_14657,1318,156,175,115,290,8.394904458598726,28.826427506523018
Task_14658,1038,272,192,102,294,3.802197802197802,25.090188926243503
Task_14659,1698,437,165,57,222,3.8767123287671232,35.175550149751366
Task_14660,1885,646,62,134,196,2.9134466769706338,39.42336587973714
Task_14661,861,1022,75,177,252,0.841642228739003,24.557756063232905
Task_14662,2139,526,45,65,110,4.0588235294117645,41.733604354093444
Task_14663,2474,867,146,47,193,2.8502304147465436,48.480772581243976
Task_14664,2071,269,165,81,246,7.67037037037037,40.836037227732184
Task_14665,1883,266,120,199,319,7.052434456928839,38.67947419758581
Task_14666,635,542,200,143,343,1.1694290976058932,19.768237608673882
Task_14667,912,399,193,23,216,2.28,22.317005096306087
Task_14668,2757,923,89,11,100,2.9837662337662336,52.14455155354167
Task_14669,1239,392,99,29,128,3.1526717557251906,27.03283705533116
Task_14670,1992,227,16,63,79,8.736842105263158,37.84135447476454
Task_14671,844,921,187,122,309,0.9154013015184381,24.075949420376265
Task_14672,1552,742,167,154,321,2.088829071332436,34.91400135926428
Task_14673,2605,873,137,179,316,2.980549199084668,52.020454761762664
Task_14674,2296,206,59,120,179,11.091787439613526,44.208786510983735
Task_14675,2144,218,62,175,237,9.789954337899543,42.35216238408011
Task_14676,2763,527,109,13,122,5.232954545454546,51.18281686732953
Task_14677,736,205,80,45,125,3.5728155339805827,18.230946677147507
Task_14678,1145,886,197,182,379,1.29086809470124,29.123669239624707
Task_14679,1094,493,87,143,230,2.214574898785425,26.46334462338436
Task_14680,2042,334,95,82,177,6.095522388059702,40.21189638944656
Task_14681,1667,750,104,157,261,2.219707057256991,36.494736719990804
Task_14682,2180,561,170,134,304,3.8790035587188614,44.18504530281941
Task_14683,1149,65,80,66,146,17.40909090909091,23.811118287596482
Task_14684,1431,495,138,75,213,2.8850806451612905,31.255632776848213
Task_14685,1776,1022,99,125,224,1.7360703812316716,38.84250438028575
Task_14686,743,255,115,169,284,2.90234375,20.425701068082404
Task_14687,2600,214,133,53,186,12.093023255813954,48.456767475617426
Task_14688,2336,749,110,99,209,3.1146666666666665,46.75557791389562
Task_14689,2381,73,82,97,179,32.17567567567568,44.06683418496351
Task_14690,1902,857,36,152,188,2.2167832167832167,40.18686361098545
Task_14691,936,464,99,190,289,2.0129032258064514,24.198994124983006
Task_14692,2812,944,156,134,290,2.9756613756613755,55.33933219178607
Task_14693,2750,918,163,82,245,2.9923830250272037,53.71326351762517
Task_14694,777,326,127,116,243,2.376146788990826,20.929193484436894
Task_14695,2436,1006,40,37,77,2.4190665342601787,46.81506315282169
Task_14696,1760,791,80,151,231,2.2222222222222223,38.079311000638434
Task_14697,706,857,139,37,176,0.8228438228438228,20.23510998770806
Task_14698,931,785,20,37,57,1.1844783715012723,22.494143873977492
Task_14699,1767,836,196,194,390,2.111111111111111,38.982860866659166
Task_14700,1369,888,32,33,65,1.5399325084364455,29.568847232204373
Task_14701,1258,896,105,111,216,1.4024526198439242,30.1301216385025
Task_14702,2771,999,92,123,215,2.771,54.58469063587227
Task_14703,2663,955,35,196,231,2.7855648535564854,52.867010910697665
Task_14704,2906,551,120,171,291,5.2644927536231885,55.64449612106498
Task_14705,2363,413,118,57,175,5.707729468599034,45.33131497700666
Task_14706,2682,215,103,39,142,12.416666666666666,49.07848800958157
Task_14707,1394,146,164,31,195,9.482993197278912,28.783818157985294
Task_14708,2203,714,146,200,346,3.081118881118881,45.319038825001634
Task_14709,768,893,44,97,141,0.8590604026845637,21.68732658824355
Task_14710,2400,634,99,58,157,3.779527559055118,46.33390714992367
Task_14711,1654,569,107,21,128,2.9017543859649124,34.044991521789974
Task_14712,2442,100,171,86,257,24.178217821782177,45.52833614590741
Task_14713,2109,699,75,63,138,3.012857142857143,42.06436471812149
Task_14714,1793,610,34,115,149,2.934533551554828,37.206584588697865
Task_14715,562,618,109,38,147,0.9079159935379645,17.052055919773903
Task_14716,577,486,145,143,288,1.1848049281314168,18.427841790307607
Task_14717,611,637,45,36,81,0.957680250783699,17.386581281603068
Task_14718,2071,952,150,107,257,2.1731374606505773,43.43394430783669
Task_14719,1894,147,63,157,220,12.797297297297296,37.66562843291978
Task_14720,2500,319,131,52,183,7.8125,47.196351322345585
Task_14721,2633,438,86,172,258,5.997722095671982,50.849667994008875
Task_14722,2613,324,23,89,112,8.04,48.96752857146268
Task_14723,1259,624,163,157,320,2.0144,29.904370412191664
Task_14724,785,321,148,151,299,2.437888198757764,21.343448586266813
Task_14725,1887,484,163,196,359,3.890721649484536,39.639034522898285
Task_14726,915,451,61,156,217,2.024336283185841,23.577664047140473
Task_14727,1805,666,86,195,281,2.7061469265367317,38.60569394983952
Task_14728,2624,1009,106,128,234,2.598019801980198,52.30178884646241
Task_14729,567,681,35,114,149,0.8313782991202346,17.843394680420296
Task_14730,1354,817,47,175,222,1.6552567237163813,31.63218977976872
Task_14731,2724,948,27,125,152,2.8703898840885143,53.01360930997646
Task_14732,1799,110,119,154,273,16.207207207207208,35.794057382074406
Task_14733,1733,640,72,164,236,2.703588143525741,37.22032858379618
Task_14734,2249,877,129,185,314,2.561503416856492,46.39198850447127
Task_14735,1567,581,134,150,284,2.6924398625429555,34.47466951512032
Task_14736,2274,878,123,49,172,2.5870307167235493,45.25087503458652
Task_14737,2147,877,197,19,216,2.4453302961275627,43.20497351664511
Task_14738,1957,552,32,80,112,3.538878842676311,39.24664516848973
Task_14739,2710,545,89,76,165,4.9633699633699635,51.44128331851932
Task_14740,2269,786,12,22,34,2.883100381194409,43.163249591359886
Task_14741,973,855,158,118,276,1.1366822429906542,25.754359189410707
Task_14742,958,122,107,165,272,7.788617886178862,22.88779459684928
Task_14743,2938,299,151,196,347,9.793333333333333,55.594834204956065
Task_14744,1411,455,10,133,143,3.094298245614035,30.654842792612147
Task_14745,980,640,12,170,182,1.5288611544461779,24.717309922593746
Task_14746,646,941,95,90,185,0.6857749469214437,20.305166804976334
Task_14747,1496,444,163,180,343,3.3617977528089886,33.22643344631411
Task_14748,2309,870,45,187,232,2.65097588978186,46.95432721175152
Task_14749,2663,96,35,137,172,27.45360824742268,48.659196058124905
Task_14750,834,426,190,91,281,1.9531615925058547,22.13607077053601
Task_14751,586,488,159,15,174,1.1983640081799591,17.059423160625816
Task_14752,1643,112,43,193,236,14.539823008849558,33.280887725261515
Task_14753,2964,198,159,56,215,14.894472361809045,54.44889827765459
Task_14754,1653,981,138,148,286,1.6832993890020367,37.077585907658936
Task_14755,1152,502,192,101,293,2.290258449304175,27.6237265113223
Task_14756,2125,496,140,187,327,4.275653923541247,43.28779972258193
Task_14757,1479,755,158,191,349,1.9563492063492063,33.97852156461983
Task_14758,1846,279,46,84,130,6.5928571428571425,36.77629979568928
Task_14759,2425,907,193,32,225,2.670704845814978,47.9789943784833
Task_14760,2935,156,21,151,172,18.694267515923567,53.639242012217494
Task_14761,817,403,109,25,134,2.022277227722772,20.23413037537868
Task_14762,1664,682,178,176,354,2.4363103953147878,36.68161787893592
Task_14763,2571,790,112,149,261,3.25031605562579,50.929746546177135
Task_14764,2446,501,82,196,278,4.872509960159363,48.27049415384872
Task_14765,1527,443,12,131,143,3.439189189189189,32.4496572255161
Task_14766,2354,240,128,50,178,9.767634854771785,44.35546453030827
Task_14767,1442,859,21,158,179,1.6767441860465115,32.690181517581316
Task_14768,891,82,71,139,210,10.734939759036145,21.165597544171362
Task_14769,747,506,59,186,245,1.4733727810650887,21.237865157990587
Task_14770,2938,291,135,81,216,10.061643835616438,54.483858800765944
Task_14771,2732,999,100,55,155,2.732,52.812796310077395
Task_14772,1766,502,104,57,161,3.510934393638171,35.903436006907384
Task_14773,2496,707,76,68,144,3.5254237288135593,48.27843568513995
Task_14774,1273,627,188,75,263,2.0270700636942673,29.3941342979343
Task_14775,1552,543,32,188,220,2.8529411764705883,33.92420307815508
Task_14776,2096,114,111,187,298,18.22608695652174,40.794774569961305
Task_14777,1245,885,56,171,227,1.4051918735891649,30.15830399752475
Task_14778,2618,346,11,130,141,7.544668587896253,49.369862112214264
Task_14779,2243,104,39,66,105,21.36190476190476,40.97040502686401
Task_14780,2916,260,100,77,177,11.172413793103448,53.60661913512131
Task_14781,1711,408,121,163,284,4.183374083129585,36.22244132158185
Task_14782,2658,465,122,120,242,5.703862660944206,51.1435165380229
Task_14783,2427,460,145,28,173,5.264642082429501,46.24604619059034
Task_14784,2529,571,59,55,114,4.421328671328672,48.044099852956975
Task_14785,1505,720,60,116,176,2.087378640776699,33.36338548170741
Task_14786,740,304,46,70,116,2.4262295081967213,19.063317124553823
Task_14787,612,619,103,101,204,0.9870967741935484,18.96014524578311
Task_14788,1442,571,167,143,310,2.520979020979021,32.57069066257845
Task_14789,2058,985,90,14,104,2.0872210953346855,41.253784088214864
Task_14790,2758,803,63,108,171,3.4303482587064678,53.397241877167666
Task_14791,858,312,36,96,132,2.741214057507987,21.467179694571083
Task_14792,1534,160,196,90,286,9.527950310559007,32.07533224920866
Task_14793,1984,186,149,142,291,10.609625668449198,39.92201019360463
Task_14794,1937,143,136,52,188,13.45138888888889,37.57859674583835
Task_14795,1802,659,49,153,202,2.7303030303030305,38.237321777047576
Task_14796,814,920,151,151,302,0.8838219326818675,23.607789747423855
Task_14797,788,929,143,108,251,0.8473118279569892,22.922297644896332
Task_14798,1983,318,153,81,234,6.216300940438871,39.55961838651964
Task_14799,1094,135,178,63,241,8.044117647058824,24.4278087210244
Task_14800,1381,255,152,170,322,5.39453125,30.67964583378533
Task_14801,2081,685,57,12,69,3.0335276967930027,39.93417807832375
Task_14802,813,421,12,50,62,1.9265402843601895,19.4132277488287
Task_14803,2500,696,139,77,216,3.586800573888092,48.84211472273096
Task_14804,1926,194,198,44,242,9.876923076923077,37.80144993279547
Task_14805,1702,116,86,135,221,14.547008547008547,34.22606260752715
Task_14806,1837,680,81,88,169,2.697503671071953,38.11401066404094
Task_14807,1715,654,52,29,81,2.618320610687023,34.764718240460134
Task_14808,2357,263,110,189,299,8.928030303030303,46.05487121866627
Task_14809,2439,691,118,126,244,3.5245664739884393,48.41673894171055
Task_14810,1038,982,64,34,98,1.0559511698880977,25.13811037007091
Task_14811,686,943,33,121,154,0.7266949152542372,20.651289295321238
Task_14812,1934,402,92,12,104,4.799007444168734,37.53242695415269
Task_14813,708,442,127,81,208,1.5981941309255079,19.662110306636837
Task_14814,1778,256,101,78,179,6.918287937743191,35.680791718316264
Task_14815,1475,845,96,98,194,1.743498817966903,33.40103707190916
Task_14816,956,364,173,22,195,2.6191780821917807,22.787069449007607
Task_14817,1899,569,62,106,168,3.331578947368421,39.04661659579253
Task_14818,610,589,10,81,91,1.0338983050847457,17.601689454997132
Task_14819,1919,783,20,179,199,2.447704081632653,40.32332330331041
Task_14820,2409,426,90,50,140,5.6416861826697895,45.613553198044684
Task_14821,2272,255,54,44,98,8.875,42.24884328906899
Task_14822,1018,506,73,36,109,2.007889546351085,23.548147025214334
Task_14823,1675,552,161,134,295,3.0289330922242317,36.11948677410002
Task_14824,1117,77,82,75,157,14.320512820512821,23.55859677064251
Task_14825,1558,129,47,129,176,11.984615384615385,31.68229066800699
Task_14826,828,587,87,173,260,1.4081632653061225,22.653908490010707
Task_14827,886,467,125,178,303,1.893162393162393,23.46078586340722
Task_14828,1793,311,101,192,293,5.746794871794871,37.28333089233491
Task_14829,1723,408,96,14,110,4.212713936430318,34.24736755017492
Task_14830,2778,452,170,108,278,6.132450331125828,53.14498427394992
Task_14831,2532,88,38,192,230,28.44943820224719,47.02907258018385
Task_14832,1038,536,149,156,305,1.9329608938547487,26.060269916046526
Task_14833,965,993,172,65,237,0.9708249496981891,25.48646259116464
Task_14834,1433,414,87,43,130,3.4530120481927713,30.049610758129475
Task_14835,729,1003,199,63,262,0.7260956175298805,21.90036449465663
Task_14836,2184,703,188,200,388,3.102272727272727,45.17278012613145
Task_14837,967,479,23,139,162,2.0145833333333334,23.91185016477078
Task_14838,965,752,25,37,62,1.2815405046480743,22.76689246702161
Task_14839,1045,248,194,28,222,4.196787148594377,23.986260070579704
Task_14840,544,603,161,155,316,0.9006622516556292,18.42628208083174
Task_14841,1454,404,155,76,231,3.5901234567901232,31.41491036283715
Task_14842,1968,137,81,129,210,14.26086956521739,38.66776392143532
Task_14843,2585,880,156,144,300,2.9341657207718503,51.60203812244589
Task_14844,2932,769,161,126,287,3.807792207792208,56.666314097172744
Task_14845,2561,97,145,200,345,26.132653061224488,47.99188008004456
Task_14846,1816,586,25,53,78,3.093696763202726,36.04133211814589
Task_14847,2881,162,71,189,260,17.67484662576687,53.58674577397499
Task_14848,1539,374,193,174,367,4.104,33.780940876985746
Task_14849,1594,912,136,77,213,1.745892661555312,35.14146890445634
Task_14850,1800,711,112,91,203,2.5280898876404496,37.97540414734608
Task_14851,2912,640,177,43,220,4.542901716068643,54.82089795472962
Task_14852,1046,283,62,35,97,3.683098591549296,22.9661598572515
Task_14853,2161,372,21,135,156,5.793565683646112,42.27310074638008
Task_14854,2955,361,17,139,156,8.162983425414364,54.7601952395454
Task_14855,738,100,112,109,221,7.306930693069307,18.77465639189227
Task_14856,1513,510,121,64,185,2.9608610567514675,32.21767040218779
Task_14857,2274,230,149,14,163,9.844155844155845,42.780870183265726
Task_14858,1370,471,185,15,200,2.902542372881356,29.608277666270023
Task_14859,1058,977,167,128,295,1.081799591002045,27.51660183361403
Task_14860,943,568,42,184,226,1.657293497363796,24.341261118939112
Task_14861,1871,489,122,182,304,3.8183673469387753,39.13333527331573
Task_14862,2411,858,113,24,137,2.806752037252619,46.90160467027849
Task_14863,1744,133,31,77,108,13.014925373134329,33.61586883063596
Task_14864,2611,989,86,24,110,2.6373737373737374,50.1944978478736
Task_14865,1414,759,94,36,130,1.8605263157894736,30.954890756965543
Task_14866,2091,561,22,79,101,3.7206405693950177,41.137533630400114
Task_14867,2086,460,66,200,266,4.5249457700650755,42.421281156838695
Task_14868,970,212,179,103,282,4.553990610328638,23.762538855268385
Task_14869,1947,717,176,200,376,2.711699164345404,41.40842376684012
Task_14870,2568,302,47,133,180,8.475247524752476,48.77918247157988
Task_14871,1342,873,90,14,104,1.5354691075514875,29.51642774275129
Task_14872,1282,285,18,62,80,4.4825174825174825,26.86392629291542
Task_14873,812,675,100,78,178,1.2011834319526626,21.708942688984184
Task_14874,2474,1000,37,30,67,2.4715284715284715,47.394583743005064
Task_14875,2338,829,61,130,191,2.816867469879518,47.14512771950438
Task_14876,1779,788,63,79,142,2.2547528517110265,37.37179256002762
Task_14877,897,416,157,113,270,2.1510791366906474,23.230351865012043
Task_14878,1567,414,158,46,204,3.7759036144578313,32.726104025526084
Task_14879,1170,277,109,152,261,4.2086330935251794,27.11761461746201
Task_14880,983,861,192,27,219,1.140371229698376,24.953545853382323
Task_14881,2609,779,117,68,185,3.344871794871795,50.44492792368796
Task_14882,2925,171,154,10,164,17.00581395348837,52.73437165971233
Task_14883,2785,695,198,29,227,4.001436781609195,53.03444684434485
Task_14884,1508,953,110,192,302,1.580712788259958,34.80030515952877
Task_14885,1449,111,169,177,346,12.9375,30.635779606768935
Task_14886,2136,189,44,148,192,11.242105263157894,41.77701993242106
Task_14887,973,966,185,182,367,1.0062047569803516,26.53714462180091
Task_14888,2960,816,53,196,249,3.6230110159118727,57.35906936622005
Task_14889,2889,659,21,182,203,4.377272727272727,55.32090444618612
Task_14890,1739,915,168,138,306,1.898471615720524,38.32432648028301
Task_14891,2592,132,89,42,131,19.48872180451128,46.823962364128626
Task_14892,2773,811,175,33,208,3.415024630541872,53.11645470299373
Task_14893,2406,169,115,13,128,14.152941176470588,44.35286488279949
Task_14894,2865,313,127,49,176,9.124203821656051,52.71332090923807
Task_14895,1990,746,38,19,57,2.6639892904953144,38.70190738704042
Task_14896,2582,457,151,57,208,5.637554585152839,49.16892691427844
Task_14897,2406,252,190,39,229,9.5098814229249,45.5335264764012
Task_14898,2294,623,62,63,125,3.676282051282051,44.695906270595025
Task_14899,2978,182,83,180,263,16.273224043715846,55.261606777728254
Task_14900,1477,156,112,44,156,9.40764331210191,29.634530030279688
Task_14901,1372,437,138,120,258,3.132420091324201,30.770478518804282
Task_14902,1936,749,69,17,86,2.5813333333333333,38.375942955959175
Task_14903,1858,948,127,188,315,1.957850368809273,40.42640932056835
Task_14904,1246,468,71,182,253,2.656716417910448,29.069928204480444
Task_14905,1952,224,72,179,251,8.675555555555556,39.41046389077748
Task_14906,1417,791,166,123,289,1.7891414141414141,32.73827279878497
Task_14907,1288,598,62,27,89,2.1502504173622703,27.694585537466093
Task_14908,2443,361,52,67,119,6.748618784530387,46.24279968278224
Task_14909,869,233,149,58,207,3.713675213675214,21.322342583605916
Task_14910,772,376,10,121,131,2.047745358090186,20.277158688572623
Task_14911,1027,650,56,51,107,1.577572964669739,24.22914845173149
Task_14912,1367,155,24,178,202,8.762820512820513,29.288768669156397
Task_14913,2328,119,17,17,34,19.4,41.42638072597687
Task_14914,1457,839,64,162,226,1.7345238095238096,33.409050561005124
Task_14915,2853,780,195,149,344,3.653008962868118,55.74004031338067
Task_14916,1854,994,165,144,309,1.8633165829145728,40.41437462722866
Task_14917,2815,249,94,75,169,11.26,52.01007493408608
Task_14918,2646,619,166,179,345,4.267741935483871,52.000106986946
Task_14919,664,64,194,189,383,10.215384615384615,18.32163854842238
Task_14920,1898,212,156,166,322,8.910798122065728,38.687229807560634
Task_14921,1465,225,167,113,280,6.482300884955753,31.629876234383058
Task_14922,1049,722,137,89,226,1.4508990318118948,26.108346721242043
Task_14923,584,596,80,189,269,0.9782244556113903,18.934281522501294
Task_14924,1520,303,10,16,26,5.0,29.678203673148413
Task_14925,1396,1020,132,91,223,1.367286973555338,32.56420921127452
Task_14926,1217,627,17,169,186,1.9378980891719746,28.47368123553351
Task_14927,2069,963,144,103,247,2.146265560165975,43.385537356297824
Task_14928,1949,496,37,79,116,3.921529175050302,38.98814605906729
Task_14929,1173,476,35,60,95,2.459119496855346,25.952947276420456
Task_14930,2058,880,164,78,242,2.3359818388195235,42.595842480683615
Task_14931,2330,240,75,90,165,9.66804979253112,44.71155374159523
Task_14932,2452,511,87,88,175,4.7890625,47.372092704367155
Task_14933,1816,1014,118,28,146,1.7891625615763547,38.052305076268496
Task_14934,1525,125,193,56,249,12.103174603174603,31.216464692862843
Task_14935,2595,528,78,61,139,4.905482041587902,49.12471793211747
Task_14936,2459,293,82,30,112,8.363945578231293,45.61660123514804
Task_14937,1008,448,27,60,87,2.244988864142539,23.11078059498705
Task_14938,2729,196,32,64,96,13.852791878172589,49.817204292982105
Task_14939,985,131,40,117,157,7.462121212121212,22.241061393879907
Task_14940,2754,701,94,53,147,3.923076923076923,52.33928298921857
Task_14941,2415,406,93,98,191,5.933660933660934,46.95693321597091
Task_14942,909,475,65,70,135,1.9096638655462186,22.416644934924893
Task_14943,568,484,24,168,192,1.1711340206185568,17.872120427366543
Task_14944,927,841,96,176,272,1.1009501187648456,25.03589267537518
Task_14945,1775,448,190,112,302,3.953229398663697,37.37066598915735
Task_14946,2019,108,32,178,210,18.522935779816514,38.9995951358793
Task_14947,2346,650,81,69,150,3.6036866359447006,45.61578731165468
Task_14948,2335,916,106,82,188,2.5463467829880044,46.825963716348745
Task_14949,2673,690,144,68,212,3.8683068017366136,51.45023337951522
Task_14950,2378,989,125,132,257,2.402020202020202,48.45065024639893
Task_14951,1720,965,84,22,106,1.7805383022774328,35.869059949703285
Task_14952,1738,160,170,50,220,10.79503105590062,34.4417312614672
Task_14953,1157,819,88,104,192,1.4109756097560975,28.18968564012287
Task_14954,2620,1005,189,145,334,2.6043737574552686,52.70156292596158
Task_14955,736,956,130,113,243,0.7690700104493208,22.184888904147176
Task_14956,1938,788,28,165,193,2.456273764258555,40.65289597008743
Task_14957,2099,852,114,73,187,2.4607268464243846,42.745612053093645
Task_14958,2915,116,174,69,243,24.914529914529915,52.84835268864427
Task_14959,2113,905,150,21,171,2.3322295805739515,42.45885210615787
Task_14960,2008,767,99,123,222,2.6145833333333335,41.726080505551145
Task_14961,1480,354,90,195,285,4.169014084507042,32.492969496329074
Task_14962,2676,143,15,171,186,18.583333333333332,49.62121405901714
Task_14963,2369,476,32,143,175,4.966457023060797,46.3142755906784
Task_14964,1477,151,10,44,54,9.717105263157896,28.82833914889555
Task_14965,2486,900,107,61,168,2.7591564927857934,48.65483297295836
Task_14966,1734,525,29,30,59,3.296577946768061,34.17628704149263
Task_14967,2572,939,181,119,300,2.7361702127659573,51.54374254392445
Task_14968,544,553,152,170,322,0.9819494584837545,18.311560030773794
Task_14969,2093,837,56,62,118,2.4976133651551313,42.041812283462114
Task_14970,1198,473,151,159,310,2.5274261603375527,28.422134613748174
Task_14971,1476,851,187,24,211,1.732394366197183,32.622214172289034
Task_14972,2704,313,29,182,211,8.611464968152866,51.352085374604115
Task_14973,1052,942,193,114,307,1.1155885471898197,27.33230183863971
Task_14974,970,708,103,159,262,1.3681241184767279,25.268701365196378
Task_14975,2130,446,53,198,251,4.76510067114094,43.04902221833694
Task_14976,2340,882,119,174,293,2.6500566251415627,47.73871043605822
Task_14977,1398,595,58,90,148,2.3456375838926173,30.86393467321574
Task_14978,2154,273,113,86,199,7.861313868613139,42.01650161848142
Task_14979,1680,581,58,30,88,2.88659793814433,33.8971474662232
Task_14980,1179,168,91,180,271,6.976331360946745,26.753604923466384
Task_14981,1964,533,159,58,217,3.6779026217228465,39.66034217387713
Task_14982,1307,345,74,87,161,3.777456647398844,28.604007599795608
Task_14983,2966,297,155,187,342,9.953020134228188,55.9945983441678
Task_14984,1152,516,106,187,293,2.228239845261122,27.79382630658344
Task_14985,983,110,148,12,160,8.855855855855856,21.430725741059252
Task_14986,2272,424,138,193,331,5.345882352941176,45.408169426492236
Task_14987,2635,484,49,164,213,5.43298969072165,50.93596026122163
Task_14988,2566,707,179,149,328,3.6242937853107344,50.891257063227975
Task_14989,1234,340,94,155,249,3.6187683284457477,28.369974382293304
Task_14990,2559,734,172,142,314,3.4816326530612245,50.79214027323324
Task_14991,1856,664,10,129,139,2.7909774436090227,38.30892661785828
Task_14992,2633,357,23,133,156,7.354748603351955,49.80240467833675
Task_14993,1900,746,75,185,260,2.5435073627844713,40.345959771349605
Task_14994,2509,651,149,78,227,3.848159509202454,48.954263963348176
Task_14995,1899,298,101,66,167,6.351170568561873,37.527422443130725
Task_14996,739,355,45,138,183,2.0758426966292136,19.999973821476342
Task_14997,2495,976,43,176,219,2.5537359263050154,50.17109602835145
Task_14998,1684,147,33,200,233,11.378378378378379,34.35479446036539
Task_14999,610,628,81,63,144,0.9697933227344993,18.092088763429416
Task_15000,539,264,57,96,153,2.0339622641509436,16.3917203966477
Task_15001,579,377,36,124,160,1.5317460317460319,17.2451710274193
Task_15002,740,655,63,58,121,1.1280487804878048,19.7881343254766
Task_15003,2084,709,88,72,160,2.935211267605634,41.68366132771239
Task_15004,2709,587,122,137,259,4.607142857142857,52.44652858246334
Task_15005,1151,1012,30,160,190,1.136229022704837,28.702295049984155
Task_15006,738,91,190,171,361,8.021739130434783,19.476636168221187
Task_15007,544,1020,14,58,72,0.5328109696376102,17.082945996632724
Task_15008,997,433,137,89,226,2.2972350230414746,24.445618811636262
Task_15009,1851,768,179,129,308,2.4070221066319895,39.636682408185514
Task_15010,608,937,80,39,119,0.6481876332622601,18.666818020488876
Task_15011,748,480,184,20,204,1.5550935550935552,19.786306222947427
Task_15012,2865,230,88,187,275,12.402597402597403,53.865483301541424
Task_15013,1928,324,85,164,249,5.932307692307693,39.26982702051016
Task_15014,2275,899,177,190,367,2.5277777777777777,47.118815141608366
Task_15015,923,411,45,172,217,2.2402912621359223,23.47377242852822
Task_15016,2353,893,107,92,199,2.631991051454139,47.33446344521593
Task_15017,1609,97,166,33,199,16.418367346938776,31.525683349312228
Task_15018,1597,773,191,48,239,2.0633074935400515,34.50971085757149
Task_15019,535,218,139,166,305,2.442922374429224,17.109937484565922
Task_15020,1526,258,101,115,216,5.891891891891892,32.42276990744687
Task_15021,2273,262,175,91,266,8.642585551330798,44.28530099503615
Task_15022,2191,433,76,81,157,5.048387096774194,42.769792695969024
Task_15023,1428,906,129,139,268,1.5744211686879823,33.15590417509596
Task_15024,556,968,20,120,140,0.5737874097007224,18.65411586250539
Task_15025,1608,288,162,168,330,5.56401384083045,34.4124407573021
Task_15026,2766,208,163,38,201,13.23444976076555,50.992068207324316
Task_15027,2089,830,135,37,172,2.5138387484957883,42.112139359186536
Task_15028,2830,795,65,153,218,3.5552763819095476,54.98616604182909
Task_15029,1653,348,171,76,247,4.736389684813753,34.45344338871344
Task_15030,2504,155,119,184,303,16.05128205128205,47.6439284236913
Task_15031,1124,885,62,80,142,1.2686230248306998,27.25935919079636
Task_15032,2650,917,114,163,277,2.886710239651416,52.67184606253657
Task_15033,1377,763,74,85,159,1.8023560209424083,30.97785480601705
Task_15034,2695,797,16,150,166,3.3771929824561404,52.28189691883767
Task_15035,2192,337,158,20,178,6.485207100591716,41.857682937683954
Task_15036,1909,70,160,89,249,26.887323943661972,36.9688815875504
Task_15037,1725,563,196,120,316,3.0585106382978724,37.02011529265913
Task_15038,1573,590,87,81,168,2.661590524534687,33.46605684272543
Task_15039,1430,171,160,81,241,8.313953488372093,30.035362204833543
Task_15040,792,496,167,86,253,1.5935613682092555,21.429938537610578
Task_15041,2269,908,128,156,284,2.4961496149614963,46.627888296384505
Task_15042,620,489,158,58,216,1.2653061224489797,18.21401731786021
Task_15043,2189,421,11,119,130,5.187203791469194,42.831040198156415
Task_15044,1405,800,55,54,109,1.7540574282147317,30.769909807712427
Task_15045,2387,628,118,128,246,3.794912559618442,47.4058119263975
Task_15046,1766,592,153,32,185,2.9780775716694774,36.23752209320225
Task_15047,583,420,56,62,118,1.3847980997624703,16.721431537127458
Task_15048,1868,545,133,104,237,3.421245421245421,38.84791018700444
Task_15049,1137,505,55,187,242,2.2470355731225298,27.45057584271957
Task_15050,1247,295,155,74,229,4.212837837837838,27.77885955940812
Task_15051,1643,197,23,184,207,8.297979797979798,34.25155430234746
Task_15052,2290,843,189,177,366,2.713270142180095,47.15804821151755
Task_15053,1211,282,51,36,87,4.279151943462898,25.53033930283442
Task_15054,2064,830,38,167,205,2.4837545126353793,42.808819248469526
Task_15055,2127,370,162,95,257,5.7331536388140165,42.430580360047976
Task_15056,2653,120,130,56,186,21.925619834710744,48.48311658339199
Task_15057,1151,754,94,77,171,1.5245033112582782,27.29603807987885
Task_15058,775,441,25,160,185,1.753393665158371,20.972875177328458
Task_15059,2252,919,50,27,77,2.4478260869565216,43.646008947535364
Task_15060,1508,686,104,128,232,2.1950509461426493,33.60290039379026
Task_15061,1243,1003,57,112,169,1.2380478087649402,29.86195834757334
Task_15062,611,345,64,125,189,1.7658959537572254,18.22152223285654
Task_15063,2388,945,18,49,67,2.52431289640592,45.970592262342045
Task_15064,551,167,142,28,170,3.2797619047619047,15.292275229241971
Task_15065,2218,753,16,47,63,2.9416445623342176,42.70047423764837
Task_15066,1596,301,15,47,62,5.28476821192053,31.407056377692044
Task_15067,2019,757,45,146,191,2.663588390501319,41.761509115851034
Task_15068,1432,590,10,117,127,2.4230118443316413,31.358514612660006
Task_15069,2201,276,36,156,192,7.945848375451264,43.11400217525617
Task_15070,2198,545,148,147,295,4.0256410256410255,44.3975526075677
Task_15071,1961,886,144,66,210,2.2108229988726045,40.75079811563154
Task_15072,2400,445,104,36,140,5.381165919282512,45.45636173925741
Task_15073,1055,443,161,166,327,2.376126126126126,26.15075874723486
Task_15074,686,1003,73,19,92,0.6832669322709163,20.08276622113976
Task_15075,2182,882,84,14,98,2.4711211778029445,42.825798446466536
Task_15076,1131,155,159,165,324,7.25,26.06971069593656
Task_15077,2530,276,36,192,228,9.133574007220217,48.5291807921138
Task_15078,697,392,88,19,107,1.7735368956743003,17.820133646405143
Task_15079,1199,803,49,79,128,1.4912935323383085,28.451031718691628
Task_15080,1333,435,31,81,112,3.0573394495412844,28.968156163028727
Task_15081,880,236,18,71,89,3.7130801687763713,20.64812247248682
Task_15082,1710,392,157,150,307,4.351145038167939,36.23933598761853
Task_15083,1887,325,169,187,356,5.788343558282208,39.0934490993373
Task_15084,1967,253,90,82,172,7.744094488188976,38.80611795174695
Task_15085,2356,406,197,182,379,5.788697788697789,46.878526881109245
Task_15086,1432,945,77,12,89,1.5137420718816068,31.12856091393014
Task_15087,2205,528,142,20,162,4.168241965973535,42.56623537432907
Task_15088,1716,854,123,133,256,2.007017543859649,37.537489444081835
Task_15089,735,599,160,102,262,1.225,21.062605734979282
Task_15090,783,489,26,59,85,1.5979591836734695,19.726909353689543
Task_15091,623,989,181,41,222,0.6292929292929293,20.040435562109764
Task_15092,2496,966,92,93,185,2.5811789038262667,49.72701417319962
Task_15093,2306,931,197,71,268,2.4742489270386265,46.65336498327684
Task_15094,986,91,63,150,213,10.717391304347826,22.70990495818245
Task_15095,2325,615,55,25,80,3.7743506493506493,44.11367903552556
Task_15096,2155,303,18,108,126,7.088815789473684,41.866483318996075
Task_15097,1939,342,72,189,261,5.653061224489796,39.674466491217785
Task_15098,954,575,41,23,64,1.65625,21.961033159729954
Task_15099,905,360,199,119,318,2.5069252077562325,23.404561723531767
Task_15100,2690,245,90,24,114,10.934959349593496,49.127523192158726
Task_15101,709,882,171,17,188,0.8029445073612684,20.361055024697365
Task_15102,1969,684,90,40,130,2.8744525547445257,39.4242767325559
Task_15103,1661,828,143,89,232,2.0036188178528347,36.2249610814796
Task_15104,1557,151,147,154,301,10.243421052631579,32.648032447893655
Task_15105,1663,264,198,35,233,6.275471698113208,33.89782263809921
Task_15106,2863,371,178,189,367,7.696236559139785,54.739455399505324
Task_15107,1218,876,71,166,237,1.3888255416191562,29.73520709117929
Task_15108,2474,262,82,91,173,9.406844106463879,47.05740793027976
Task_15109,1688,225,200,16,216,7.469026548672566,33.897764316445006
Task_15110,2692,488,139,27,166,5.505112474437627,50.41139835126311
Task_15111,2063,537,35,179,214,3.8345724907063197,41.94575978543595
Task_15112,759,227,158,78,236,3.3289473684210527,19.939167027068272
Task_15113,1138,797,89,176,265,1.4260651629072683,28.275176239325095
Task_15114,1592,109,188,93,281,14.472727272727273,32.427812204309724
Task_15115,1715,759,168,29,197,2.2565789473684212,36.15036823703655
Task_15116,2088,816,114,141,255,2.5556915544675642,43.32015576149248
Task_15117,1604,721,13,123,136,2.221606648199446,34.56300357311042
Task_15118,1826,447,13,180,193,4.075892857142857,37.839034488044085
Task_15119,2642,627,131,84,215,4.207006369426751,50.94332472536724
Task_15120,2247,773,57,149,206,2.9031007751937983,45.65418125549096
Task_15121,1003,312,20,66,86,3.2044728434504792,22.747734581248675
Task_15122,2218,721,19,79,98,3.07202216066482,43.55402644449322
Task_15123,2647,544,111,143,254,4.856880733944954,51.313121107006566
Task_15124,1750,276,24,81,105,6.317689530685921,34.849024733101864
Task_15125,1409,438,66,100,166,3.2095671981776763,30.863398342700748
Task_15126,2967,676,191,64,255,4.382570162481536,56.2361255020165
Task_15127,1785,177,107,55,162,10.02808988764045,34.94561821311749
Task_15128,2902,389,176,107,283,7.441025641025641,54.918682225911574
Task_15129,1258,830,34,28,62,1.5138387484957883,27.64550547346822
Task_15130,1544,905,18,46,64,1.7041942604856513,32.40963959958336
Task_15131,592,298,36,56,92,1.979933110367893,16.277916227219297
Task_15132,648,493,39,125,164,1.311740890688259,18.854919268029423
Task_15133,2363,455,93,96,189,5.182017543859649,46.28451609308121
Task_15134,1661,691,174,147,321,2.4002890173410405,36.47103134640818
Task_15135,668,408,41,100,141,1.6332518337408313,18.674345862858083
Task_15136,2343,816,65,196,261,2.86780905752754,47.59324140544857
Task_15137,872,661,114,180,294,1.3172205438066464,23.754178760792026
Task_15138,1027,142,149,117,266,7.181818181818182,24.05473163972842
Task_15139,2389,1014,199,164,363,2.3536945812807883,49.22744526329078
Task_15140,2740,942,168,77,245,2.9056203605514317,53.54716651430591
Task_15141,2622,735,122,150,272,3.5625,51.61572752849461
Task_15142,2363,118,100,57,157,19.857142857142858,43.520121239855946
Task_15143,781,253,39,11,50,3.074803149606299,18.02249367332151
Task_15144,1832,620,70,185,255,2.9500805152979064,38.85522112374109
Task_15145,1994,598,182,109,291,3.328881469115192,41.26178279179136
Task_15146,900,397,152,152,304,2.2613065326633164,23.428181773945102
Task_15147,1857,960,104,71,175,1.9323621227887617,39.124123312974596
Task_15148,1880,899,155,38,193,2.088888888888889,39.202201863809115
Task_15149,2227,772,13,73,86,2.8809831824062098,43.76507285096661
Task_15150,2840,275,11,63,74,10.289855072463768,51.23069634738883
Task_15151,2940,910,195,16,211,3.2272228320526892,55.90887713703975
Task_15152,1228,140,50,29,79,8.709219858156029,25.048822760412836
Task_15153,1318,722,147,74,221,1.8229598893499308,30.2198975085546
Task_15154,2983,961,103,99,202,3.100831600831601,57.63945184046296
Task_15155,1755,157,108,93,201,11.10759493670886,35.19609983244228
Task_15156,1250,709,56,186,242,1.7605633802816902,29.86322471959249
Task_15157,1450,877,98,126,224,1.6514806378132119,33.24032341558394
Task_15158,1016,742,84,198,282,1.3674293405114402,26.28403820117116
Task_15159,2834,776,141,97,238,3.6473616473616475,54.906064595982976
Task_15160,1528,142,145,91,236,10.685314685314685,31.610095897728744
Task_15161,1062,986,50,117,167,1.0759878419452888,26.9187548459256
Task_15162,2178,148,196,56,252,14.61744966442953,41.716211870946154
Task_15163,1006,76,85,43,128,13.064935064935066,21.11820570794971
Task_15164,2115,207,187,86,273,10.16826923076923,41.492075828915816
Task_15165,2534,399,137,166,303,6.335,49.30597958531026
Task_15166,1757,742,188,101,289,2.3647375504710633,37.93960686922024
Task_15167,538,714,127,117,244,0.7524475524475525,18.259194195615077
Task_15168,2967,319,115,53,168,9.271875,54.512476358903335
Task_15169,2074,747,69,184,253,2.772727272727273,43.057970133054674
Task_15170,1674,855,27,113,140,1.955607476635514,36.05260618148635
Task_15171,2161,472,192,61,253,4.568710359408033,42.73333709803078
Task_15172,1897,712,57,200,257,2.6605890603085554,40.2230489752129
Task_15173,2299,211,159,59,218,10.84433962264151,43.86327477803462
Task_15174,1097,486,19,117,136,2.252566735112936,25.707575126883587
Task_15175,1563,65,79,10,89,23.681818181818183,29.248266926092423
Task_15176,1171,827,14,164,178,1.4142512077294687,28.28897474880961
Task_15177,1581,306,91,62,153,5.149837133550489,32.312493983559754
Task_15178,1825,832,186,57,243,2.1908763505402162,38.526109580791264
Task_15179,1624,289,66,16,82,5.6,31.95928765424591
Task_15180,1548,387,99,127,226,3.9896907216494846,33.262781944619725
Task_15181,645,744,156,101,257,0.8657718120805369,20.109876210966238
Task_15182,2910,919,199,182,381,3.1630434782608696,57.29455398948477
Task_15183,1893,432,63,21,84,4.371824480369515,36.6571069956569
Task_15184,1407,368,30,68,98,3.813008130081301,29.519821708576263
Task_15185,545,762,101,63,164,0.7142857142857143,17.76480910607131
Task_15186,2730,580,80,134,214,4.698795180722891,52.6767507228952
Task_15187,2645,891,59,35,94,2.9652466367713006,50.24388456630344
Task_15188,2272,377,42,197,239,6.01058201058201,44.85801186490371
Task_15189,2414,977,15,82,97,2.4683026584867074,47.552253281053275
Task_15190,510,116,115,163,278,4.358974358974359,15.75424664762324
Task_15191,2021,962,10,60,70,2.09865005192108,40.34247373765837
Task_15192,866,722,107,80,187,1.197786998616874,22.916467806589875
Task_15193,678,160,33,13,46,4.211180124223603,16.091022962015003
Task_15194,2991,827,35,161,196,3.61231884057971,57.45427408878422
Task_15195,1033,866,27,171,198,1.1914648212226067,26.455520907428845
Task_15196,1522,147,34,173,207,10.283783783783784,31.64865175673296
Task_15197,2638,497,31,144,175,5.2971887550200805,50.63780958389476
Task_15198,715,795,132,72,204,0.8982412060301508,20.785042359783944
Task_15199,2500,855,179,62,241,2.9205607476635516,49.298239166868974
Task_15200,1537,243,29,186,215,6.299180327868853,32.68524752206098
Task_15201,1054,390,67,52,119,2.6956521739130435,24.124086578541892
Task_15202,2189,803,17,134,151,2.722636815920398,44.00555964620247
Task_15203,1157,96,198,146,344,11.927835051546392,25.85195832517935
Task_15204,854,76,147,174,321,11.090909090909092,20.977762227952926
Task_15205,2677,229,173,102,275,11.639130434782608,50.748005769229394
Task_15206,2834,907,59,197,256,3.1211453744493394,55.66599799661503
Task_15207,1005,430,71,96,167,2.331786542923434,24.471558322410626
Task_15208,1129,587,106,198,304,1.9200680272108843,27.717892963427158
Task_15209,1869,826,80,25,105,2.259975816203144,37.899969527257134
Task_15210,2020,247,183,123,306,8.14516129032258,40.60703611110721
Task_15211,2183,371,34,33,67,5.868279569892473,40.81535648935476
Task_15212,566,829,131,35,166,0.6819277108433734,18.151200883833287
Task_15213,2220,408,37,115,152,5.427872860635697,43.28666536633897
Task_15214,2592,745,22,86,108,3.474530831099196,49.795963408577705
Task_15215,874,655,111,16,127,1.3323170731707317,21.749588742049195
Task_15216,2080,752,150,37,187,2.762284196547145,41.8296214167576
Task_15217,2833,477,11,69,80,5.926778242677824,52.14477823631961
Task_15218,1146,191,50,106,156,5.96875,25.74462928525561
Task_15219,2066,96,43,74,117,21.298969072164947,38.42375649161313
Task_15220,1177,173,70,141,211,6.764367816091954,26.375484629719548
Task_15221,2172,375,109,69,178,5.776595744680851,42.12449774808118
Task_15222,1021,813,190,36,226,1.2542997542997543,25.443722747106435
Task_15223,1172,595,163,29,192,1.9664429530201342,27.01454452493739
Task_15224,1110,335,155,102,257,3.3035714285714284,26.26715002365349
Task_15225,1166,213,29,149,178,5.4485981308411215,26.322168970229956
Task_15226,1222,684,35,166,201,1.783941605839416,28.99846852114604
Task_15227,1808,128,45,25,70,14.015503875968992,33.73755306765931
Task_15228,1697,863,58,182,240,1.9641203703703705,37.418713515564995
Task_15229,922,258,185,138,323,3.55984555984556,23.39434428058569
Task_15230,765,787,119,117,236,0.9708121827411168,22.0674405695882
Task_15231,761,643,118,190,308,1.1816770186335404,21.988522752564602
Task_15232,1856,629,101,200,301,2.9460317460317462,39.35255388152624
Task_15233,1764,437,48,129,177,4.027397260273973,36.56428854199482
Task_15234,1629,711,103,102,205,2.287921348314607,35.437915312921
Task_15235,2447,870,40,32,72,2.809414466130884,46.567547714525226
Task_15236,2244,392,59,65,124,5.709923664122138,43.21605872822408
Task_15237,1484,960,34,90,124,1.5442247658688866,33.13936829870716
Task_15238,2345,232,57,128,185,10.064377682403434,45.17680179343832
Task_15239,1358,615,148,26,174,2.2045454545454546,29.8178173794925
Task_15240,568,149,104,173,277,3.7866666666666666,16.98453714095788
Task_15241,1952,376,156,50,206,5.177718832891247,38.77733518895367
Task_15242,2880,774,173,195,368,3.7161290322580647,56.3244896990081
Task_15243,2327,673,89,110,199,3.4525222551928785,46.399414348853696
Task_15244,945,143,188,93,281,6.5625,22.69709848120253
Task_15245,2024,947,197,122,319,2.1350210970464136,42.975043579600595
Task_15246,2850,790,108,12,120,3.6030341340075855,53.3535549697414
Task_15247,2110,329,120,187,307,6.393939393939394,42.41276794930725
Task_15248,2374,851,129,23,152,2.7863849765258215,46.3025882117534
Task_15249,886,388,39,73,112,2.2776349614395888,21.66943325728232
Task_15250,1235,563,191,39,230,2.1897163120567376,28.034439751141118
Task_15251,2099,657,42,174,216,3.189969604863222,42.88190471761362
Task_15252,2689,661,194,126,320,4.061933534743202,52.62424547462772
Task_15253,2257,750,33,53,86,3.0053262316910785,43.94135691095301
Task_15254,2091,130,93,76,169,15.961832061068701,39.605129962149874
Task_15255,670,648,73,48,121,1.0323574730354392,18.570135980846143
Task_15256,604,789,51,101,152,0.7645569620253164,18.925013908611206
Task_15257,1093,728,71,158,229,1.4993141289437586,27.27900598314167
Task_15258,1999,189,43,74,117,10.521052631578947,38.829450141141585
Task_15259,2490,861,126,194,320,2.8886310904872388,50.20079470026847
Task_15260,2156,222,194,110,304,9.668161434977579,42.63543752711846
Task_15261,735,475,79,173,252,1.5441176470588236,20.950008676051443
Task_15262,1171,458,169,198,367,2.55119825708061,28.26140682156689
Task_15263,773,68,43,69,112,11.202898550724637,17.757538633702836
Task_15264,1691,234,49,148,197,7.195744680851064,35.06932360499689
Task_15265,2119,276,40,189,229,7.649819494584838,42.03656355454682
Task_15266,1511,734,150,81,231,2.05578231292517,33.40375449943017
Task_15267,2319,667,20,169,189,3.4715568862275448,46.20896698806147
Task_15268,1199,228,122,133,255,5.235807860262009,27.35587188966348
Task_15269,500,217,168,82,250,2.293577981651376,15.899684715949041
Task_15270,1015,89,16,139,155,11.277777777777779,22.27953107149933
Task_15271,1324,1005,36,113,149,1.31610337972167,30.89347369700484
Task_15272,633,97,176,107,283,6.459183673469388,17.302438510233788
Task_15273,1316,317,126,59,185,4.138364779874214,28.40957398131387
Task_15274,2826,565,147,140,287,4.992932862190813,54.35933487528799
Task_15275,1775,64,130,135,265,27.307692307692307,35.06507531892282
Task_15276,522,279,174,32,206,1.8642857142857143,15.787828942381674
Task_15277,627,858,169,163,332,0.729918509895227,20.620561559372092
Task_15278,832,365,160,35,195,2.273224043715847,20.918222725186336
Task_15279,1975,687,81,166,247,2.870639534883721,41.230244671943474
Task_15280,2019,477,108,190,298,4.2238493723849375,41.4224210250051
Task_15281,1765,281,185,74,259,6.25886524822695,36.05571774324996
Task_15282,2591,311,120,139,259,8.304487179487179,49.670620561918554
Task_15283,936,859,176,29,205,1.0883720930232559,24.145710786888017
Task_15284,676,246,142,120,262,2.736842105263158,19.166837679695202
Task_15285,1141,658,131,27,158,1.7314112291350532,26.21363748809092
Task_15286,1524,298,23,184,207,5.096989966555184,32.68333574137474
Task_15287,2728,545,80,83,163,4.996336996336996,51.7922855195751
Task_15288,1619,214,34,80,114,7.530232558139535,32.856228115025324
Task_15289,2316,618,65,172,237,3.741518578352181,46.398903398816884
Task_15290,1607,285,133,63,196,5.618881118881119,33.16750512909261
Task_15291,1047,505,71,154,225,2.069169960474308,25.869035187994267
Task_15292,2380,921,11,129,140,2.581344902386117,47.434838969395685
Task_15293,1313,993,96,91,187,1.3209255533199196,31.022432716675038
Task_15294,1535,357,84,67,151,4.287709497206704,31.811966085557696
Task_15295,2520,645,99,199,298,3.9009287925696596,49.90630945831257
Task_15296,1063,403,125,167,292,2.631188118811881,25.99434631453717
Task_15297,2260,882,104,183,287,2.5594563986409966,46.45726579895274
Task_15298,1582,761,70,100,170,2.0761154855643045,34.640490369744775
Task_15299,1067,83,67,44,111,12.702380952380953,21.95229285890973
Task_15300,1147,411,171,19,190,2.783980582524272,25.775257655893572
Task_15301,1335,624,151,166,317,2.136,31.107698455296994
Task_15302,2634,916,73,134,207,2.872410032715376,52.18416613897269
Task_15303,1825,69,91,64,155,26.071428571428573,34.53368339421224
Task_15304,545,429,17,20,37,1.2674418604651163,14.591707708637939
Task_15305,632,737,126,42,168,0.8563685636856369,18.604566050997207
Task_15306,589,187,142,185,327,3.132978723404255,18.09297833951735
Task_15307,1943,299,150,200,350,6.476666666666667,39.88298001513703
Task_15308,1242,542,74,191,265,2.287292817679558,29.311991318899924
Task_15309,2379,340,19,66,85,6.976539589442815,44.56887497170772
Task_15310,653,780,102,126,228,0.8361075544174136,20.24548384983049
Task_15311,1758,274,82,29,111,6.392727272727273,34.45970121107105
Task_15312,2139,481,24,194,218,4.437759336099585,43.023066540065656
Task_15313,2653,607,26,67,93,4.363486842105263,50.001651873772595
Task_15314,2192,954,10,28,38,2.2952879581151833,42.56615179945175
Task_15315,1160,326,63,200,263,3.547400611620795,27.327458707188242
Task_15316,1436,552,40,55,95,2.596745027124774,30.413093563472945
Task_15317,2522,614,55,46,101,4.100813008130081,47.47745449829886
Task_15318,1157,615,176,133,309,1.8782467532467533,28.176073111710537
Task_15319,2177,899,88,73,161,2.418888888888889,43.76691002520649
Task_15320,1144,205,41,173,214,5.553398058252427,26.293951642654488
Task_15321,765,973,168,171,339,0.7854209445585215,23.21463474562258
Task_15322,787,666,184,153,337,1.1799100449775113,22.54818431032392
Task_15323,2536,354,90,52,142,7.143661971830986,47.63793726998096
Task_15324,2593,117,137,67,204,21.97457627118644,47.68895025512827
Task_15325,1063,459,189,146,335,2.3108695652173914,26.334633859566093
Task_15326,2557,696,182,151,333,3.66857962697274,50.73943221415385
Task_15327,1294,462,157,64,221,2.794816414686825,28.91132290244929
Task_15328,518,470,119,173,292,1.099787685774947,17.443621062605448
Task_15329,2853,457,165,157,322,6.229257641921397,54.61868513613848
Task_15330,615,348,172,67,239,1.7621776504297995,17.89721280513361
Task_15331,1263,684,172,152,324,1.8437956204379562,30.1657323718684
Task_15332,2072,553,153,12,165,3.740072202166065,40.79250973596843
Task_15333,1219,336,127,87,214,3.6172106824925816,27.524328783567487
Task_15334,1659,775,158,183,341,2.1378865979381443,36.844687299883496
Task_15335,1797,938,171,174,345,1.9137380191693292,39.54340982663292
Task_15336,874,221,43,161,204,3.936936936936937,22.02421751986526
Task_15337,2537,298,190,34,224,8.48494983277592,47.788898315288215
Task_15338,985,96,55,163,218,10.154639175257731,22.6899457485185
Task_15339,1724,104,137,158,295,16.419047619047618,34.66555993290671
Task_15340,2432,875,48,125,173,2.776255707762557,48.61363335218767
Task_15341,1189,558,170,40,210,2.1270125223613596,27.237090753981644
Task_15342,1677,95,87,72,159,17.46875,32.219529597892034
Task_15343,952,568,179,46,225,1.67311072056239,23.570685102202873
Task_15344,1032,867,121,31,152,1.1889400921658986,25.16596563573732
Task_15345,1630,565,115,112,227,2.8798586572438163,35.10925946492709
Task_15346,2669,548,40,129,169,4.861566484517304,51.09493473080678
Task_15347,537,835,102,94,196,0.6423444976076556,18.488128162122518
Task_15348,1965,265,191,158,349,7.387218045112782,40.04698523423887
Task_15349,1101,327,51,153,204,3.356707317073171,26.13075921281703
Task_15350,2647,158,176,129,305,16.647798742138363,49.87411967305869
Task_15351,2244,799,32,158,190,2.805,45.49877386166455
Task_15352,1651,838,35,56,91,1.967818831942789,34.66031478053584
Task_15353,2218,903,21,65,86,2.4535398230088497,43.87164796267046
Task_15354,502,556,36,95,131,0.9012567324955116,16.40042590638312
Task_15355,2382,972,117,96,213,2.448098663926002,48.233608307607284
Task_15356,2052,836,19,101,120,2.4516129032258065,41.7986246532792
Task_15357,843,439,61,181,242,1.915909090909091,22.54967050835741
Task_15358,1829,808,89,100,189,2.2608158220024723,38.84710529962526
Task_15359,984,919,82,63,145,1.0695652173913044,24.872844700269045
Task_15360,1923,252,200,147,347,7.600790513833992,39.312266541380055
Task_15361,853,581,136,131,267,1.465635738831615,23.00965606074095
Task_15362,2174,783,44,11,55,2.7729591836734695,41.7905585734354
Task_15363,1049,430,199,184,383,2.433874709976798,26.293474160081967
Task_15364,1309,95,165,126,291,13.635416666666666,27.975237514526572
Task_15365,1275,99,17,31,48,12.75,24.957265351299498
Task_15366,1516,621,96,153,249,2.437299035369775,33.692204037261675
Task_15367,1455,423,29,176,205,3.431603773584906,31.923497289596384
Task_15368,1823,654,187,168,355,2.783206106870229,39.10500469761488
Task_15369,2398,95,184,188,372,24.979166666666668,45.52715230474062
Task_15370,698,513,142,125,267,1.3579766536964981,20.348087999887543
Task_15371,770,952,19,74,93,0.8079748163693599,21.304152023213096
Task_15372,1588,735,156,66,222,2.157608695652174,34.42451623541293
Task_15373,1307,613,45,108,153,2.1286644951140063,29.454836772005056
Task_15374,1793,740,122,116,238,2.4197031039136303,38.2957784737907
Task_15375,533,970,173,195,368,0.548918640576725,19.721963585265478
Task_15376,2447,456,151,194,345,5.354485776805252,48.34699782414045
Task_15377,980,685,130,104,234,1.4285714285714286,25.141847199196025
Task_15378,592,75,38,31,69,7.7894736842105265,14.001986325244308
Task_15379,2783,402,140,115,255,6.905707196029777,52.96495063083379
Task_15380,756,780,164,194,358,0.967989756722151,22.5659283428386
Task_15381,865,742,29,169,198,1.164199192462988,23.395328853196045
Task_15382,749,113,58,25,83,6.5701754385964914,17.064087489597917
Task_15383,2838,383,125,49,174,7.390625,52.616331641473955
Task_15384,1896,125,90,90,180,15.047619047619047,36.82884507223059
Task_15385,592,219,97,145,242,2.690909090909091,17.72224265512457
Task_15386,2733,892,89,151,240,3.0604703247480405,53.76428408180842
Task_15387,2167,126,75,25,100,17.062992125984252,39.866181074683574
Task_15388,2313,799,24,140,164,2.89125,46.35130578816191
Task_15389,2240,254,161,119,280,8.784313725490197,43.98526355012837
Task_15390,2118,680,19,120,139,3.1101321585903086,42.468924608229095
Task_15391,2351,811,177,10,187,2.895320197044335,46.13903537066025
Task_15392,1731,136,86,26,112,12.635036496350365,33.13423251855947
Task_15393,2805,294,55,198,253,9.508474576271187,53.212138045891045
Task_15394,2907,162,86,75,161,17.834355828220858,52.623750645976706
Task_15395,2417,249,70,19,89,9.668,44.389611722082215
Task_15396,1824,751,171,15,186,2.425531914893617,37.47604249922515
Task_15397,2299,271,26,84,110,8.452205882352942,43.68178516775253
Task_15398,2862,655,111,58,169,4.362804878048781,53.85761130398405
Task_15399,592,820,59,18,77,0.7210718635809987,17.08644199892674
Task_15400,1510,516,54,169,223,2.920696324951644,33.279019955291695
Task_15401,1620,785,178,179,357,2.0610687022900764,36.324252451085975
Task_15402,1568,669,63,182,245,2.3402985074626868,34.76583538970153
Task_15403,2782,722,50,182,232,3.847856154910097,54.165402595514415
Task_15404,2661,80,198,168,366,32.851851851851855,49.524139772896376
Task_15405,604,224,95,194,289,2.6844444444444444,18.25818416535276
Task_15406,706,214,157,31,188,3.2837209302325583,18.361272637085087
Task_15407,1247,1007,40,191,231,1.2371031746031746,30.365760217117536
Task_15408,1368,132,164,163,327,10.285714285714286,29.62872152447424
Task_15409,2950,646,180,180,360,4.559505409582689,56.969904680885314
Task_15410,2258,598,197,50,247,3.7696160267111853,44.52104942735948
Task_15411,850,175,137,183,320,4.829545454545454,21.643230894299663
Task_15412,1068,631,138,63,201,1.6898734177215189,25.757235838139337
Task_15413,872,740,184,116,300,1.1767881241565452,23.903151470715613
Task_15414,1600,560,22,26,48,2.8520499108734403,32.07727394946426
Task_15415,1322,265,109,15,124,4.969924812030075,27.532070829112516
Task_15416,2678,401,126,12,138,6.661691542288557,49.55503474166451
Task_15417,1217,839,30,199,229,1.4488095238095238,29.490729183481292
Task_15418,1241,833,185,109,294,1.4880095923261392,30.039626405128804
Task_15419,2898,856,157,71,228,3.381563593932322,55.61890074293698
Task_15420,533,361,117,60,177,1.4723756906077348,16.07246779522243
Task_15421,853,998,108,29,137,0.8538538538538538,22.735805890537605
Task_15422,2133,454,183,175,358,4.687912087912088,43.4011711586881
Task_15423,1313,345,74,92,166,3.7947976878612715,28.9721632860465
Task_15424,1774,856,162,77,239,2.070011668611435,37.94535508559043
Task_15425,605,543,45,118,163,1.1121323529411764,18.12623297354972
Task_15426,823,685,133,129,262,1.1997084548104957,22.804154065836613
Task_15427,1978,209,30,175,205,9.41904761904762,39.46584888231918
Task_15428,2991,835,196,123,319,3.577751196172249,57.94864660181946
Task_15429,552,355,126,35,161,1.550561797752809,16.02223442417352
Task_15430,1883,897,96,73,169,2.096881959910913,39.28847577450019
Task_15431,1849,103,139,72,211,17.778846153846153,35.75026999911517
Task_15432,1747,190,134,116,250,9.146596858638743,35.83038630430807
Task_15433,906,514,46,144,190,1.7592233009708738,23.37509073500543
Task_15434,1360,916,168,177,345,1.4830970556161396,32.51217612831241
Task_15435,1276,705,197,168,365,1.8073654390934843,30.6453502008858
Task_15436,1827,915,56,168,224,1.994541484716157,39.55181257217385
Task_15437,1355,537,56,171,227,2.5185873605947955,30.911738234684776
Task_15438,712,404,48,197,245,1.7580246913580246,20.385376741412923
Task_15439,1877,449,19,184,203,4.171111111111111,38.62811557671966
Task_15440,2292,580,177,134,311,3.944922547332186,46.05062063717162
Task_15441,531,141,85,168,253,3.73943661971831,16.25586566589364
Task_15442,1958,953,70,30,100,2.052410901467505,39.74820067793237
Task_15443,2712,290,23,51,74,9.31958762886598,49.23080143541092
Task_15444,1712,121,17,189,206,14.032786885245901,34.37346439400694
Task_15445,1027,246,89,164,253,4.157894736842105,24.77603462264143
Task_15446,1001,616,96,140,236,1.6223662884927066,25.429255139998975
Task_15447,812,960,124,46,170,0.8449531737773153,22.139564660027293
Task_15448,2642,787,126,109,235,3.3527918781725887,51.86934396872757
Task_15449,1619,223,125,191,316,7.227678571428571,34.331451142457475
Task_15450,2370,308,104,125,229,7.669902912621359,46.00997825325177
Task_15451,800,546,158,25,183,1.4625228519195612,20.67470623831534
Task_15452,2734,416,155,198,353,6.556354916067146,52.79959336473669
Task_15453,2081,1003,25,89,114,2.0727091633466137,42.73908749986632
Task_15454,2323,1000,38,49,87,2.3206793206793206,45.500476158272285
Task_15455,2220,832,150,84,234,2.6650660264105643,44.989610104321
Task_15456,2542,857,121,123,244,2.9627039627039626,50.56557501983307
Task_15457,2295,347,156,159,315,6.594827586206897,45.3945871061163
Task_15458,1073,636,42,37,79,1.684458398744113,24.254407671722507
Task_15459,1760,114,143,121,264,15.304347826086957,35.26089500546038
Task_15460,1374,261,77,198,275,5.244274809160306,30.54454608709422
Task_15461,1028,716,97,127,224,1.4337517433751743,26.010847370139654
Task_15462,1063,479,83,43,126,2.214583333333333,24.3077880908542
Task_15463,1497,207,75,183,258,7.197115384615385,32.21038897511523
Task_15464,1324,570,50,30,80,2.318739054290718,28.255297006605648
Task_15465,1052,534,198,27,225,1.966355140186916,25.005660507090937
Task_15466,2056,315,138,151,289,6.506329113924051,41.37745310369812
Task_15467,2882,172,92,130,222,16.658959537572255,53.27405173168859
Task_15468,774,591,192,176,368,1.3074324324324325,22.297875702872403
Task_15469,1023,136,110,48,158,7.467153284671533,22.31096304175593
Task_15470,2479,480,35,21,56,5.153846153846154,45.83950831786177
Task_15471,2538,603,178,19,197,4.201986754966887,48.451356679283755
Task_15472,2520,405,93,82,175,6.206896551724138,48.14366696635238
Task_15473,761,601,48,189,237,1.2641196013289036,21.587097225379427
Task_15474,2773,296,50,194,244,9.336700336700337,52.697759150247
Task_15475,2143,411,151,160,311,5.201456310679611,43.1856491049445
Task_15476,2827,775,115,29,144,3.643041237113402,53.32387652795915
Task_15477,2866,830,190,138,328,3.4488567990373045,56.01500436004611
Task_15478,2695,877,144,185,329,3.069476082004556,53.52639314603871
Task_15479,933,1023,194,54,248,0.9111328125,25.09002676756583
Task_15480,1544,372,97,193,290,4.13941018766756,33.5580395182695
Task_15481,2301,685,179,71,250,3.3542274052478134,45.722512425385595
Task_15482,808,270,160,76,236,2.981549815498155,20.78756843363884
Task_15483,597,381,193,155,348,1.5628272251308901,18.74354009584977
Task_15484,2091,87,27,44,71,23.761363636363637,37.68615883782021
Task_15485,1891,827,21,162,183,2.283816425120773,39.741328388192784
Task_15486,647,434,69,142,211,1.4873563218390804,19.19015408230035
Task_15487,1147,642,183,182,365,1.7838258164852254,28.41276726427037
Task_15488,1457,716,33,27,60,2.03207810320781,30.418582440016223
Task_15489,2840,653,90,190,280,4.342507645259939,54.95329801747642
Task_15490,1732,131,71,137,208,13.121212121212121,34.899679523900254
Task_15491,2479,476,153,158,311,5.19706498951782,48.71258111400589
Task_15492,1516,159,44,92,136,9.475,30.78314950297137
Task_15493,744,514,155,24,179,1.4446601941747572,19.665644316657236
Task_15494,2474,936,81,173,254,2.64034151547492,49.95698767122377
Task_15495,2720,529,65,101,166,5.132075471698113,51.9132353143631
Task_15496,1790,914,48,18,66,1.9562841530054644,36.04960281710044
Task_15497,1216,947,111,27,138,1.2827004219409284,28.191495714063247
Task_15498,630,413,80,118,198,1.5217391304347827,18.767383036265535
Task_15499,605,866,86,52,138,0.6978085351787774,18.861525361005967
Task_15500,2485,717,124,39,163,3.4610027855153205,47.86259823009225
Task_15501,530,391,13,196,209,1.3520408163265305,17.195419650102455
Task_15502,826,557,103,77,180,1.4802867383512546,21.510171322539055
Task_15503,2954,373,29,98,127,7.898395721925134,54.79258936212502
Task_15504,2921,923,193,153,346,3.161255411255411,57.28111598031327
Task_15505,2980,611,159,62,221,4.869281045751634,56.041141039834145
Task_15506,2343,809,102,127,229,2.8925925925925924,47.20062399357149
Task_15507,1998,969,172,51,223,2.0597938144329895,41.628288441327776
Task_15508,1672,573,36,190,226,2.912891986062718,35.918321855147916
Task_15509,2829,166,171,61,232,16.940119760479043,51.94049168537117
Task_15510,1645,627,168,164,332,2.6194267515923566,36.09144703135277
Task_15511,1119,909,92,29,121,1.2296703296703297,26.562443298074385
Task_15512,1041,659,121,192,313,1.5772727272727274,26.537844963137516
Task_15513,2529,905,58,123,181,2.7913907284768213,50.19794573674079
Task_15514,2889,704,107,46,153,4.097872340425532,54.02880951477653
Task_15515,1280,558,95,125,220,2.289803220035778,29.60269186057863
Task_15516,2212,819,58,56,114,2.6975609756097563,43.80532915407574
Task_15517,2611,376,63,122,185,6.925729442970822,49.84909316410788
Task_15518,861,400,123,63,186,2.14713216957606,21.546790589294048
Task_15519,1662,445,118,53,171,3.726457399103139,34.281179528720855
Task_15520,1165,506,120,149,269,2.2978303747534516,27.80431859639405
Task_15521,2408,184,79,113,192,13.016216216216216,45.93898795659561
Task_15522,2082,625,127,51,178,3.3258785942492013,41.495959458475234
Task_15523,1822,664,95,74,169,2.73984962406015,37.66099176995823
Task_15524,1707,826,22,43,65,2.064087061668682,34.728349506263335
Task_15525,2024,169,126,163,289,11.905882352941177,40.08430033556282
Task_15526,1048,429,17,106,123,2.437209302325581,24.66174948144157
Task_15527,1397,450,178,200,378,3.097560975609756,31.865697184599014
Task_15528,729,695,90,30,120,1.0474137931034482,19.652606059043908
Task_15529,2212,182,197,178,375,12.087431693989071,43.61902659329294
Task_15530,2335,364,123,186,309,6.397260273972603,46.09702783658894
Task_15531,2126,291,82,98,180,7.280821917808219,41.744004891529165
Task_15532,2018,568,44,50,94,3.546572934973638,39.456951281062004
Task_15533,2552,560,21,51,72,4.549019607843137,47.544904175904755
Task_15534,515,186,166,15,181,2.7540106951871657,15.133691496147955
Task_15535,735,437,53,138,191,1.678082191780822,20.569575586972263
Task_15536,1233,857,67,109,176,1.437062937062937,29.39455635054902
Task_15537,2127,731,185,27,212,2.9057377049180326,42.59061908586281
Task_15538,1157,585,124,178,302,1.9744027303754266,28.116712141562534
Task_15539,2490,241,137,171,308,10.289256198347108,48.08970592341981
Task_15540,894,286,62,63,125,3.1149825783972127,21.46044139493634
Task_15541,556,156,181,21,202,3.5414012738853504,15.588635167773788
Task_15542,2330,862,121,179,300,2.6998841251448438,47.55666849179261
Task_15543,1395,847,123,32,155,1.6450471698113207,30.87675372670843
Task_15544,2972,103,105,94,199,28.576923076923077,53.75180356276105
Task_15545,1102,436,126,31,157,2.5217391304347827,24.962191609595166
Task_15546,2353,559,183,105,288,4.201785714285714,46.80344785783657
Task_15547,1907,294,159,170,329,6.464406779661017,39.15811071608345
Task_15548,2925,438,150,68,218,6.662870159453303,54.6556860062198
Task_15549,1204,143,97,170,267,8.36111111111111,26.950078575201825
Task_15550,794,983,67,44,111,0.806910569105691,21.50589188917927
Task_15551,615,875,16,109,125,0.702054794520548,19.305900392752136
Task_15552,2810,160,37,111,148,17.453416149068325,51.25834459847231
Task_15553,2152,417,125,200,325,5.148325358851674,43.46943805354069
Task_15554,888,250,66,88,154,3.537848605577689,21.589442743678887
Task_15555,2728,402,19,76,95,6.769230769230769,50.532009815280475
Task_15556,2276,541,87,106,193,4.199261992619927,45.10851455338035
Task_15557,764,894,112,67,179,0.8536312849162011,21.521230122055062
Task_15558,2871,510,189,109,298,5.61839530332681,54.898298039288385
Task_15559,1885,514,166,170,336,3.6601941747572817,39.56142563985841
Task_15560,2549,868,31,194,225,2.9332566168009206,50.764574589509174
Task_15561,2274,984,11,55,66,2.3086294416243653,44.523278684733945
Task_15562,1476,337,132,126,258,4.366863905325443,32.10202311204754
Task_15563,569,370,138,156,294,1.5336927223719676,18.024095711416603
Task_15564,2280,818,146,51,197,2.7838827838827838,45.50861558819429
Task_15565,2287,628,168,131,299,3.6359300476947536,46.065310035306915
Task_15566,2020,691,23,62,85,2.9190751445086707,40.02462824092504
Task_15567,2171,107,80,16,96,20.10185185185185,39.563632645539364
Task_15568,2830,328,34,102,136,8.601823708206688,52.641806148508685
Task_15569,2015,673,48,162,210,2.9896142433234423,41.666842230523756
Task_15570,833,821,87,92,179,1.0133819951338199,22.534247068152457
Task_15571,1981,393,17,116,133,5.027918781725888,39.39258354003135
Task_15572,1823,635,95,68,163,2.8663522012578615,37.515475713266525
Task_15573,2162,911,83,75,158,2.370614035087719,43.682410839206824
Task_15574,2005,174,67,118,185,11.457142857142857,39.10543719848121
Task_15575,644,529,100,18,118,1.2150943396226415,17.425379829902685
Task_15576,2631,178,24,134,158,14.69832402234637,48.47302418524188
Task_15577,2148,614,27,178,205,3.4926829268292683,43.50577641262608
Task_15578,1140,404,34,86,120,2.814814814814815,25.929013954121857
Task_15579,2371,402,180,52,232,5.883374689826303,45.83734885583732
Task_15580,1044,79,17,20,37,13.05,20.669243792229448
Task_15581,2556,797,23,14,37,3.2030075187969924,47.69846592908229
Task_15582,638,216,161,189,350,2.9400921658986174,18.966358111508313
Task_15583,1420,513,133,112,245,2.762645914396887,31.70112740645047
Task_15584,1818,893,48,102,150,2.033557046979866,38.53310780758748
Task_15585,2493,413,33,167,200,6.021739130434782,48.28868073720012
Task_15586,2184,636,43,41,84,3.4285714285714284,42.111812125699
Task_15587,1675,801,23,180,203,2.0885286783042396,36.64903241040421
Task_15588,1364,460,151,155,306,2.9587852494577005,30.98469076176224
Task_15589,2235,807,175,110,285,2.766089108910891,45.710760919057826
Task_15590,948,231,80,151,231,4.086206896551724,23.447149553930018
Task_15591,2796,315,30,184,214,8.848101265822784,52.83033855600139
Task_15592,1756,490,134,103,237,3.576374745417515,36.89822250919238
Task_15593,2862,442,158,155,313,6.460496613995486,54.668182432436176
Task_15594,2198,1015,178,110,288,2.1633858267716537,45.78653899385019
Task_15595,2792,569,89,176,265,4.898245614035088,53.82721181805027
Task_15596,2325,684,37,147,184,3.394160583941606,46.199100032615526
Task_15597,748,788,149,29,178,0.9480354879594424,20.747955127266078
Task_15598,2311,398,115,191,306,5.791979949874687,45.82422420278781
Task_15599,2992,67,197,120,317,44.0,54.28871918620961
Task_15600,1505,948,132,75,207,1.5858798735511064,33.7872485972394
Task_15601,1117,600,14,41,55,1.8585690515806987,24.78716981257595
Task_15602,2394,786,13,20,33,3.0419313850063534,45.01436968755339
Task_15603,2756,337,26,184,210,8.153846153846153,52.256389673976486
Task_15604,2741,990,25,199,224,2.765893037336024,54.20423797858239
Task_15605,1010,282,108,79,187,3.568904593639576,23.82344314805
Task_15606,1504,435,97,121,218,3.44954128440367,32.6980891207893
Task_15607,2399,251,145,64,209,9.51984126984127,45.630802486070685
Task_15608,2061,299,90,173,263,6.87,41.36616029672265
Task_15609,889,411,184,36,220,2.157766990291262,22.07446818086919
Task_15610,2675,168,57,69,126,15.828402366863905,48.93838143315898
Task_15611,1681,156,38,132,170,10.707006369426752,33.769863184416366
Task_15612,1173,380,148,123,271,3.078740157480315,27.50232185453693
Task_15613,2750,521,198,39,237,5.268199233716475,51.92045169467068
Task_15614,1218,468,107,69,176,2.5970149253731343,27.333623409966922
Task_15615,2333,652,68,44,112,3.572741194486983,44.77249715530738
Task_15616,1175,382,159,150,309,3.0678851174934727,27.751216967381485
Task_15617,1401,142,194,172,366,9.797202797202797,30.477561486269124
Task_15618,1055,166,127,39,166,6.317365269461078,23.177112235386442
Task_15619,1951,526,102,19,121,3.7020872865275143,38.19175259792356
Task_15620,719,169,179,78,257,4.229411764705882,19.002078268434875
Task_15621,1848,551,53,115,168,3.347826086956522,38.2370058039504
Task_15622,1002,722,47,20,67,1.3858921161825726,22.94482415485032
Task_15623,2782,476,183,162,345,5.832285115303983,53.668103721677674
Task_15624,1246,391,35,66,101,3.1785714285714284,27.065206428742027
Task_15625,1917,948,145,55,200,2.0200210748155953,40.222169970040596
Task_15626,1768,328,186,82,268,5.37386018237082,36.387682618488874
Task_15627,2659,207,108,26,134,12.783653846153847,48.703371075141234
Task_15628,618,802,188,22,210,0.7696139476961394,18.961312016910654
Task_15629,537,489,42,131,173,1.0959183673469388,17.037308714424487
Task_15630,641,978,78,170,248,0.6547497446373851,21.101845556807103
Task_15631,1669,137,24,93,117,12.094202898550725,32.83212299969859
Task_15632,2764,997,146,73,219,2.7695390781563125,53.92787577448928
Task_15633,843,651,135,137,272,1.2929447852760736,23.062130885392886
Task_15634,2049,579,115,155,270,3.532758620689655,42.04537500846252
Task_15635,1804,600,143,39,182,3.0016638935108153,36.7663292892197
Task_15636,2167,108,97,150,247,19.880733944954127,41.46347917970411
Task_15637,1004,973,153,180,333,1.0308008213552362,26.912357437670565
Task_15638,1001,229,146,61,207,4.352173913043479,23.38127510745491
Task_15639,624,593,111,122,233,1.0505050505050506,19.179800245845374
Task_15640,821,518,128,130,258,1.581888246628131,22.275551899490996
Task_15641,1943,77,106,167,273,24.91025641025641,37.80544048207713
Task_15642,2630,300,177,96,273,8.737541528239202,50.272284066945424
Task_15643,1257,657,84,10,94,1.9103343465045592,27.50393336695845
Task_15644,1464,931,73,193,266,1.5708154506437768,34.00463044741333
Task_15645,2351,1006,118,14,132,2.3346573982125123,46.306112052278195
Task_15646,2283,903,94,107,201,2.525442477876106,46.47200315190625
Task_15647,2229,554,139,134,273,4.0162162162162165,44.798913691713125
Task_15648,2214,873,170,160,330,2.533180778032037,45.86040127181229
Task_15649,2672,279,135,58,193,9.542857142857143,49.9095141447764
Task_15650,1915,370,190,77,267,5.1617250673854445,38.76486553598083
Task_15651,1943,236,82,84,166,8.19831223628692,38.32809430681942
Task_15652,1459,818,92,183,275,1.7814407814407816,33.57661180563082
Task_15653,939,850,49,187,236,1.1034077555816686,25.133499967675885
Task_15654,2237,426,47,169,216,5.23887587822014,44.35768916083621
Task_15655,1307,366,131,134,265,3.561307901907357,29.566361941883873
Task_15656,571,116,106,141,247,4.880341880341881,16.54169822146328
Task_15657,2163,64,75,97,172,33.276923076923076,40.82583591537684
Task_15658,1350,589,170,55,225,2.288135593220339,30.232352796828575
Task_15659,1828,442,72,48,120,4.126410835214447,36.25079392903372
Task_15660,824,755,114,52,166,1.08994708994709,21.94700317538864
Task_15661,1629,1008,176,72,248,1.6144697720515362,36.10112673342973
Task_15662,1828,754,161,68,229,2.4211920529801323,38.342422840618475
Task_15663,2689,572,151,73,224,4.692844677137871,51.423362379495245
Task_15664,2085,643,82,85,167,3.237577639751553,41.91257515449641
Task_15665,1326,530,31,132,163,2.4971751412429377,29.791983006597828
Task_15666,1987,154,99,104,203,12.819354838709678,38.92439579854405
Task_15667,1606,243,109,73,182,6.581967213114754,32.81809614685577
Task_15668,2144,651,132,196,328,3.2883435582822087,44.09912949774168
Task_15669,2367,728,49,14,63,3.246913580246914,44.66006700179179
Task_15670,811,858,170,47,217,0.9441210710128056,22.300023442043937
Task_15671,2991,838,155,193,348,3.5649582836710367,58.191392150155174
Task_15672,1785,347,149,113,262,5.129310344827586,37.02134129033702
Task_15673,2580,240,88,57,145,10.705394190871369,47.922400942605634
Task_15674,2232,849,40,126,166,2.6258823529411766,45.11954276547632
Task_15675,690,212,131,59,190,3.23943661971831,18.325411613658925
Task_15676,1914,473,193,131,324,4.037974683544304,39.77815043634997
Task_15677,2186,575,23,179,202,3.795138888888889,44.02701831171833
Task_15678,778,455,38,196,234,1.706140350877193,21.428039511707876
Task_15679,1396,345,39,141,180,4.034682080924855,30.36394485670965
Task_15680,2893,560,101,200,301,5.1568627450980395,55.55523529261702
Task_15681,1712,720,127,72,199,2.3744798890429957,36.29381991187252
Task_15682,1786,520,14,11,25,3.4280230326295587,34.611634698616676
Task_15683,917,304,162,174,336,3.0065573770491802,23.576575848846442
Task_15684,2366,679,175,78,253,3.4794117647058824,46.89498916448752
Task_15685,2561,540,132,145,277,4.733826247689464,50.04515272460721
Task_15686,638,529,112,180,292,1.2037735849056603,19.599682396363203
Task_15687,1947,198,19,72,91,9.78391959798995,37.43124854424291
Task_15688,1734,1005,65,196,261,1.7236580516898607,38.518657939651554
Task_15689,1875,303,45,43,88,6.167763157894737,36.11777626701504
Task_15690,1790,257,138,77,215,6.937984496124031,36.172161129947206
Task_15691,531,759,57,84,141,0.6986842105263158,17.582055813870024
Task_15692,2593,282,31,199,230,9.162544169611307,49.59212001713282
Task_15693,2148,186,20,98,118,11.48663101604278,41.15807358988794
Task_15694,2020,883,117,58,175,2.2850678733031673,41.37918423197255
Task_15695,2329,200,180,54,234,11.587064676616915,44.42833764795731
Task_15696,721,1019,191,61,252,0.7068627450980393,21.76340722221617
Task_15697,2194,906,80,63,143,2.4189636163175305,44.056862845551315
Task_15698,1143,160,83,91,174,7.099378881987578,25.35941444606999
Task_15699,909,765,41,75,116,1.1866840731070496,23.22829436816012
Task_15700,1515,684,148,103,251,2.2116788321167884,33.75651393853911
Task_15701,2413,670,153,87,240,3.596125186289121,47.60918939331807
Task_15702,2151,782,43,74,117,2.7471264367816093,43.05617272315459
Task_15703,1659,422,111,95,206,3.921985815602837,34.965381100199586
Task_15704,1903,389,86,166,252,4.87948717948718,39.10091630033714
Task_15705,1023,748,76,95,171,1.3658210947930574,25.65923267006757
Task_15706,1519,324,126,84,210,4.673846153846154,32.16768958023672
Task_15707,1048,313,130,92,222,3.337579617834395,24.9423475552632
Task_15708,2643,195,46,26,72,13.48469387755102,47.657285242573245
Task_15709,1627,120,196,164,360,13.446280991735538,33.801199484260884
Task_15710,1639,484,80,160,240,3.379381443298969,35.25129521468744
Task_15711,2303,655,171,97,268,3.510670731707317,46.24816919715676
Task_15712,1074,731,53,93,146,1.4672131147540983,26.243126475489735
Task_15713,1325,596,39,151,190,2.219430485762144,30.26833592004156
Task_15714,1086,970,38,75,113,1.1184346035015449,26.63468955294574
Task_15715,2299,451,84,140,224,5.086283185840708,45.410957642769084
Task_15716,659,411,42,158,200,1.5995145631067962,19.199003346328144
Task_15717,2244,701,169,76,245,3.1965811965811968,44.92919929293245
Task_15718,2235,726,40,112,152,3.0742778541953233,44.52404571380375
Task_15719,652,128,114,106,220,5.054263565891473,17.761951037959232
Task_15720,2461,303,82,173,255,8.095394736842104,47.711378817336886
Task_15721,666,757,38,67,105,0.8786279683377308,19.041099370579627
Task_15722,1896,491,114,183,297,3.8536585365853657,39.50541623524504
Task_15723,855,634,49,160,209,1.3464566929133859,23.116725088052107
Task_15724,2328,229,127,169,296,10.121739130434783,45.428652494492816
Task_15725,1657,1022,130,156,286,1.619745845552297,37.27985757784382
Task_15726,2000,959,173,174,347,2.0833333333333335,42.83448063594159
Task_15727,1945,121,59,171,230,15.942622950819672,38.337404163336814
Task_15728,1469,950,128,114,242,1.5446898002103049,33.7882338210787
Task_15729,859,322,175,156,331,2.6594427244582044,22.668436517880895
Task_15730,982,966,135,45,180,1.015511892450879,24.771444566738936
Task_15731,508,139,39,16,55,3.6285714285714286,13.318115500794034
Task_15732,1702,68,90,75,165,24.666666666666668,32.98285116735152
Task_15733,1346,297,132,40,172,4.516778523489933,28.63906561748051
Task_15734,2936,461,116,63,179,6.354978354978355,54.5038846307206
Task_15735,1572,439,170,102,272,3.5727272727272728,33.9789641638389
Task_15736,2996,777,29,121,150,3.8508997429305913,56.78056553496395
Task_15737,2225,677,182,28,210,3.281710914454277,43.98401500052978
Task_15738,2642,541,161,198,359,4.874538745387454,51.77816934693758
Task_15739,633,481,18,166,184,1.3132780082987552,18.659589704369637
Task_15740,2169,728,34,118,152,2.9753086419753085,43.51267924493319
Task_15741,1874,657,85,142,227,2.8480243161094223,39.3545120975111
Task_15742,1059,432,61,125,186,2.4457274826789837,25.481735243430574
Task_15743,2891,334,69,185,254,8.629850746268657,54.661456232956304
Task_15744,2807,948,171,67,238,2.957850368809273,54.499068156736065
Task_15745,2481,955,69,161,230,2.5951882845188283,50.01922568664648
Task_15746,1909,483,71,200,271,3.9442148760330578,39.72032001961036
Task_15747,1949,936,150,130,280,2.080042689434365,41.588323087545994
Task_15748,2791,754,150,186,336,3.696688741721854,54.69408115398702
Task_15749,1298,226,46,20,66,5.71806167400881,26.051075844983504
Task_15750,1397,220,181,137,318,6.321266968325792,30.744816056854493
Task_15751,1537,857,125,148,273,1.7913752913752914,34.809283305546124
Task_15752,1988,763,148,41,189,2.602094240837696,40.405863597943124
Task_15753,2770,156,195,27,222,17.643312101910826,50.6536495985922
Task_15754,1726,970,65,177,242,1.7775489186405766,38.16978076486574
Task_15755,2523,992,138,41,179,2.540785498489426,49.40065427938376
Task_15756,1485,287,74,109,183,5.15625,31.6651235834895
Task_15757,1936,643,28,66,94,3.0062111801242235,38.71412406133897
Task_15758,2945,551,75,29,104,5.3351449275362315,54.13084605851321
Task_15759,1255,993,56,83,139,1.2625754527162978,29.59787236387358
Task_15760,1954,300,61,89,150,6.4916943521594686,38.652105697384336
Task_15761,800,74,62,192,254,10.666666666666666,19.960811923362307
Task_15762,1294,562,195,89,284,2.2984014209591472,29.814984600443086
Task_15763,1533,138,146,55,201,11.028776978417266,31.199124928878447
Task_15764,2493,711,47,50,97,3.5014044943820224,47.42032909910305
Task_15765,521,590,83,74,157,0.8815566835871405,16.6528442825735
Task_15766,1058,842,57,40,97,1.255041518386714,24.961563255722776
Task_15767,1214,987,172,187,359,1.228744939271255,30.415869715130203
Task_15768,2535,1002,85,140,225,2.527417746759721,50.89393100031307
Task_15769,1139,321,68,110,178,3.5372670807453415,26.27657290044766
Task_15770,630,465,17,163,180,1.351931330472103,18.510102091744766
Task_15771,778,406,181,170,351,1.9115479115479115,21.764327556483675
Task_15772,693,155,152,80,232,4.4423076923076925,18.376213864702944
Task_15773,1727,84,188,87,275,20.31764705882353,34.258004086639716
Task_15774,2276,322,119,133,252,7.046439628482972,44.68713960163311
Task_15775,2345,519,31,83,114,4.509615384615385,45.35650758277503
Task_15776,612,95,160,46,206,6.375,15.88020840850794
Task_15777,2605,444,154,40,194,5.853932584269663,49.217385141614955
Task_15778,1300,849,67,29,96,1.5294117647058822,28.946257436252868
Task_15779,1457,855,109,156,265,1.7021028037383177,33.49776066115203
Task_15780,2706,428,43,129,172,6.3076923076923075,51.42138738959914
Task_15781,2582,276,194,98,292,9.321299638989169,49.496129307268326
Task_15782,1605,646,152,147,299,2.480680061823802,35.34390040476469
Task_15783,2664,174,192,60,252,15.222857142857142,49.475007580991594
Task_15784,1838,477,83,126,209,3.8451882845188283,38.11589493697525
Task_15785,2814,933,64,173,237,3.012847965738758,55.28292548857295
Task_15786,856,837,48,91,139,1.0214797136038185,22.79021630833367
Task_15787,1171,853,15,191,206,1.3711943793911008,28.708438425910895
Task_15788,2337,743,161,43,204,3.1411290322580645,45.966530750114934
Task_15789,2761,403,17,56,73,6.834158415841584,50.40938944807883
Task_15790,2228,785,117,100,217,2.8346055979643765,45.20984369632026
Task_15791,1614,378,95,169,264,4.258575197889182,34.5790928131109
Task_15792,2912,496,61,154,215,5.859154929577465,55.321691378347886
Task_15793,2341,533,122,46,168,4.383895131086143,44.99753858419027
Task_15794,956,415,64,142,206,2.298076923076923,24.042911869780497
Task_15795,1221,418,168,160,328,2.9140811455847255,28.69433492450065
Task_15796,2821,572,112,199,311,4.923211169284468,54.49730439742583
Task_15797,744,179,85,185,270,4.133333333333334,19.796476492500002
Task_15798,2661,679,192,175,367,3.913235294117647,52.52144800099804
Task_15799,914,429,47,190,237,2.125581395348837,23.554917424715256
Task_15800,1921,373,192,50,242,5.136363636363637,38.43926846712867
Task_15801,1020,613,66,45,111,1.6612377850162867,23.828803979219984
Task_15802,1682,682,118,176,294,2.4626647144948755,36.69630884243955
Task_15803,1628,547,196,51,247,2.9708029197080292,34.55505594710822
Task_15804,885,80,40,127,167,10.925925925925926,20.62546781931218
Task_15805,879,503,161,158,319,1.744047619047619,23.49217869984754
Task_15806,1358,580,39,152,191,2.3373493975903616,30.75806131923414
Task_15807,1884,802,33,32,65,2.3462017434620175,37.46596857832358
Task_15808,1761,373,78,90,168,4.708556149732621,36.02930770622189
Task_15809,1363,826,40,46,86,1.6481257557436517,29.707217023845107
Task_15810,2041,369,186,48,234,5.5162162162162165,40.233406794692364
Task_15811,1411,240,130,192,322,5.854771784232365,31.13440098384582
Task_15812,2640,392,13,88,101,6.717557251908397,49.430386957407244
Task_15813,1285,223,183,32,215,5.736607142857143,27.698495540184467
Task_15814,1239,661,93,172,265,1.8716012084592144,29.5892115080858
Task_15815,1815,488,162,87,249,3.7116564417177913,37.602267283870056
Task_15816,1608,609,198,195,393,2.636065573770492,35.7692786047914
Task_15817,1612,216,128,91,219,7.428571428571429,33.46582054930091
Task_15818,1672,876,33,195,228,1.9064994298745723,36.921306015250316
Task_15819,1638,385,192,123,315,4.243523316062176,35.07386007819073
Task_15820,1266,753,196,106,302,1.6790450928381964,30.248106517287777
Task_15821,2680,74,11,107,118,35.733333333333334,48.037564574052084
Task_15822,1681,167,40,70,110,10.005952380952381,32.9263230864641
Task_15823,1800,490,134,125,259,3.6659877800407332,37.72617880687688
Task_15824,1462,983,131,127,258,1.4857723577235773,33.87078109459065
Task_15825,926,836,89,128,217,1.1063321385902032,24.625954709746527
Task_15826,1223,600,59,94,153,2.0349417637271214,28.19244504061903
Task_15827,1211,291,97,153,250,4.147260273972603,27.787584030094326
Task_15828,1541,269,88,71,159,5.707407407407407,31.64787285500326
Task_15829,541,212,65,134,199,2.539906103286385,16.785802772576798
Task_15830,2931,198,174,11,185,14.728643216080402,53.21301604784102
Task_15831,1110,1009,67,60,127,1.099009900990099,26.998345798675984
Task_15832,2260,303,79,59,138,7.434210526315789,43.059940484423656
Task_15833,1686,471,153,173,326,3.5720338983050848,36.23320538769528
Task_15834,1439,341,25,52,77,4.207602339181286,29.202966227814198
Task_15835,2906,599,161,41,202,4.843333333333334,54.51684276941103
Task_15836,1161,811,173,98,271,1.4298029556650247,28.56175205317099
Task_15837,690,921,64,70,134,0.7483731019522777,20.308658824890014
Task_15838,2978,151,45,116,161,19.592105263157894,53.92387380091196
Task_15839,541,418,185,154,339,1.2911694510739857,17.881919356266746
Task_15840,1551,820,65,110,175,1.8891595615103531,34.478633038155955
Task_15841,1432,688,134,136,270,2.078374455732946,32.58831330747234
Task_15842,933,447,41,38,79,2.0825892857142856,21.447914203901444
Task_15843,2186,332,16,110,126,6.564564564564565,42.45442714004295
Task_15844,1394,252,153,103,256,5.509881422924901,30.479137834781053
Task_15845,719,661,162,37,199,1.0861027190332326,20.07004259967783
Task_15846,1857,255,145,36,181,7.25390625,36.515155785262245
Task_15847,2283,201,114,158,272,11.301980198019802,44.48583874423296
Task_15848,2243,1001,50,39,89,2.2385229540918163,44.1901032923441
Task_15849,1940,998,96,40,136,1.941941941941942,39.980045925400084
Task_15850,2648,611,33,148,181,4.326797385620915,51.090842677334614
Task_15851,1241,759,174,31,205,1.6328947368421052,28.663552256542005
Task_15852,2043,893,41,166,207,2.285234899328859,42.68012717456268
Task_15853,2310,797,145,106,251,2.8947368421052633,46.708585144493235
Task_15854,886,497,100,131,231,1.7791164658634537,23.148012234307146
Task_15855,1289,471,15,79,94,2.7309322033898304,28.09030024997432
Task_15856,1907,122,85,176,261,15.504065040650406,37.81530542678229
Task_15857,2913,397,155,119,274,7.319095477386934,55.09672310744336
Task_15858,1510,851,113,15,128,1.772300469483568,32.56396280837715
Task_15859,807,397,20,51,71,2.027638190954774,19.400221966983676
Task_15860,722,766,90,25,115,0.9413298565840938,19.768186150612514
Task_15861,1944,473,26,12,38,4.10126582278481,36.94114979457691
Task_15862,1865,391,118,190,308,4.75765306122449,38.75173297821525
Task_15863,641,757,119,46,165,0.8456464379947229,18.920938679341074
Task_15864,2661,286,66,149,215,9.27177700348432,50.62789182045094
Task_15865,2807,1024,161,167,328,2.738536585365854,55.72942961421764
Task_15866,777,821,144,200,344,0.9452554744525548,22.98377711929689
Task_15867,2215,888,14,80,94,2.4915635545556807,44.0980183368481
Task_15868,1462,599,91,90,181,2.4366666666666665,32.00560590228581
Task_15869,2474,571,122,196,318,4.325174825174825,49.02641456503459
Task_15870,1199,170,106,82,188,7.011695906432749,26.13575980488363
Task_15871,935,766,161,58,219,1.2190352020860495,24.059679265929805
Task_15872,1600,236,159,14,173,6.751054852320675,32.267896481016216
Task_15873,1787,684,159,80,239,2.6087591240875914,37.6919056626898
Task_15874,2077,196,189,103,292,10.543147208121827,41.17873362469416
Task_15875,2221,662,128,150,278,3.349924585218703,45.06063850123663
Task_15876,2620,910,59,75,134,2.87596048298573,51.05295798781905
Task_15877,580,1006,68,102,170,0.5759682224428997,19.53156687526919
Task_15878,1473,363,51,47,98,4.0467032967032965,30.05077407667996
Task_15879,1152,653,125,98,223,1.761467889908257,27.766415735405673
Task_15880,1823,744,145,188,333,2.4469798657718123,39.3172499431637
Task_15881,1811,80,12,85,97,22.358024691358025,34.172947168429886
Task_15882,1629,109,20,66,86,14.809090909090909,31.26510820599408
Task_15883,557,314,152,182,334,1.7682539682539682,17.905515547207283
Task_15884,1599,310,174,187,361,5.141479099678457,34.51155910435721
Task_15885,2604,498,28,41,69,5.218436873747495,47.88606777542487
Task_15886,2956,599,58,46,104,4.926666666666667,54.23697641306944
Task_15887,1045,134,26,11,37,7.7407407407407405,21.424922378533058
Task_15888,1495,672,145,151,296,2.221396731054978,33.67538141633268
Task_15889,1342,141,89,139,228,9.450704225352112,28.85743972526191
Task_15890,2674,545,35,63,98,4.897435897435898,50.11303660538531
Task_15891,2777,733,177,94,271,3.7833787465940056,53.922681793915196
Task_15892,1414,528,109,63,172,2.67296786389414,30.698305579113008
Task_15893,1269,620,109,63,172,2.0434782608695654,28.691054506917762
Task_15894,2567,115,154,142,296,22.129310344827587,48.15145104633225
Task_15895,2528,857,165,105,270,2.9463869463869465,50.43455067235857
Task_15896,993,661,128,35,163,1.5,24.098232152954
Task_15897,2192,288,89,29,118,7.58477508650519,41.474449436225285
Task_15898,1582,377,89,126,215,4.185185185185185,33.755352676513716
Task_15899,807,91,84,180,264,8.771739130434783,20.111041074112727
Task_15900,1538,687,74,167,241,2.23546511627907,34.31077460699701
Task_15901,770,470,24,108,132,1.634819532908705,20.55316898151965
Task_15902,2752,530,151,145,296,5.182674199623352,53.12275525370857
Task_15903,2566,614,81,197,278,4.172357723577235,50.54530340408038
Task_15904,611,1009,25,160,185,0.6049504950495049,20.20087568739708
Task_15905,986,453,128,121,249,2.171806167400881,24.672682086496682
Task_15906,2650,147,15,90,105,17.905405405405407,48.11776805962075
Task_15907,1301,873,151,75,226,1.488558352402746,30.40775209202319
Task_15908,590,607,60,107,167,0.9703947368421053,18.2871663103316
Task_15909,2749,745,111,81,192,3.6849865951742626,52.872303226841616
Task_15910,2844,392,71,164,235,7.236641221374046,54.005283130290046
Task_15911,2568,582,43,87,130,4.404802744425386,49.22611148303076
Task_15912,1342,725,120,103,223,1.8484848484848484,31.017867562789217
Task_15913,2769,150,47,125,172,18.337748344370862,51.02820823992249
Task_15914,1607,550,131,33,164,2.9165154264972775,33.539046770724035
Task_15915,1708,922,66,52,118,1.8504875406283856,36.14783860997829
Task_15916,823,717,185,130,315,1.1462395543175488,23.143749438506134
Task_15917,637,205,36,41,77,3.092233009708738,15.798456448866816
Task_15918,2816,213,157,140,297,13.158878504672897,53.03465602967018
Task_15919,1793,888,53,45,98,2.016872890888639,36.7190047644827
Task_15920,1211,751,34,127,161,1.610372340425532,28.499469025452445
Task_15921,1731,920,87,177,264,1.8794788273615635,38.0894974090886
Task_15922,2789,875,150,157,307,3.1837899543378994,54.869342428935646
Task_15923,1620,564,50,68,118,2.8672566371681416,33.932091204106335
Task_15924,1942,740,134,73,207,2.620782726045884,40.04654785418056
Task_15925,2400,569,97,191,288,4.2105263157894735,47.72936737227662
Task_15926,2015,191,163,129,292,10.494791666666666,40.254031157818716
Task_15927,2245,487,158,186,344,4.600409836065574,45.233694594250785
Task_15928,2193,85,10,167,177,25.5,41.231377829974356
Task_15929,1562,275,100,108,208,5.659420289855072,33.003454418769024
Task_15930,2523,321,140,41,181,7.8354037267080745,47.26597727087623
Task_15931,1863,797,186,71,257,2.3345864661654137,39.16666996453487
Task_15932,1731,927,92,128,220,1.865301724137931,37.91010088025887
Task_15933,1635,548,58,70,128,2.978142076502732,34.31595414180765
Task_15934,2823,291,183,147,330,9.667808219178083,53.59953909988301
Task_15935,2581,381,167,115,282,6.7565445026178015,49.82012582491736
Task_15936,2669,721,108,165,273,3.6966759002770084,52.342604762616396
Task_15937,2946,766,187,107,294,3.8409387222946547,56.8823421269722
Task_15938,1195,325,134,157,291,3.665644171779141,27.812895344166545
Task_15939,1340,92,67,44,111,14.408602150537634,26.307385635020257
Task_15940,997,881,81,22,103,1.1303854875283448,24.292422933647
Task_15941,2061,989,66,95,161,2.081818181818182,42.75372323468449
Task_15942,1748,929,63,92,155,1.8795698924731183,37.50610534276957
Task_15943,1033,518,195,32,227,1.9903660886319845,24.72139749789137
Task_15944,2988,571,192,76,268,5.223776223776224,56.40304078144078
Task_15945,660,826,40,62,102,0.7980652962515115,18.979190470337375
Task_15946,1506,207,72,45,117,7.240384615384615,30.286918404263165
Task_15947,1632,153,65,60,125,10.597402597402597,32.10695287419732
Task_15948,2830,339,95,32,127,8.323529411764707,51.964410843044476
Task_15949,2891,265,135,198,333,10.868421052631579,54.66762525021144
Task_15950,2977,883,73,19,92,3.3676470588235294,55.47609244876378
Task_15951,2306,993,39,119,158,2.319919517102616,46.556145810989726
Task_15952,1557,762,69,40,109,2.040629095674967,32.84505422304574
Task_15953,2840,529,38,74,112,5.3584905660377355,53.07576523580703
Task_15954,2931,994,183,93,276,2.9457286432160803,57.192708153212685
Task_15955,1860,248,109,134,243,7.469879518072289,37.81487967328352
Task_15956,1178,701,107,93,200,1.6780626780626782,28.148161883057906
Task_15957,2573,292,29,11,40,8.781569965870307,46.30603347514906
Task_15958,1858,716,79,117,196,2.591352859135286,39.193228697347806
Task_15959,1009,622,179,123,302,1.6195826645264848,25.794348741262016
Task_15960,1524,806,145,139,284,1.8884758364312269,34.48107600258141
Task_15961,2337,708,25,121,146,3.296191819464034,46.15714503000964
Task_15962,2348,251,56,130,186,9.317460317460318,45.30202209467368
Task_15963,1282,926,25,177,202,1.3829557713052858,30.64161768883331
Task_15964,1249,507,128,127,255,2.4586614173228347,29.04198598860324
Task_15965,915,624,138,98,236,1.464,23.926118265200653
Task_15966,825,392,138,99,237,2.099236641221374,21.831184597008033
Task_15967,1574,977,18,123,141,1.6094069529652353,34.79461628235655
Task_15968,512,406,25,82,107,1.257985257985258,15.724661797630496
Task_15969,2721,65,126,49,175,41.22727272727273,48.45987787255667
Task_15970,892,275,44,19,63,3.2318840579710146,19.833977068865266
Task_15971,2162,97,85,149,234,22.06122448979592,41.13824484602137
Task_15972,1718,1001,65,189,254,1.7145708582834331,38.210884166645094
Task_15973,2092,429,100,116,216,4.865116279069768,41.944630176025186
Task_15974,2765,898,53,172,225,3.0756395995550614,54.3832812653234
Task_15975,2180,599,80,160,240,3.6333333333333333,44.18273151392528
Task_15976,926,609,162,10,172,1.518032786885246,22.787186182923563
Task_15977,1419,964,76,189,265,1.4704663212435234,33.38432434630591
Task_15978,1966,470,44,50,94,4.174097664543525,38.32081454485332
Task_15979,2882,897,121,138,259,3.2093541202672604,56.16764601966304
Task_15980,1244,256,134,174,308,4.840466926070039,28.46100962128074
Task_15981,1025,194,153,115,268,5.256410256410256,24.45110674399609
Task_15982,1829,334,82,149,231,5.459701492537313,37.67959182423932
Task_15983,2686,755,25,130,155,3.552910052910053,51.870505334337615
Task_15984,827,177,63,56,119,4.646067415730337,19.3282305388999
Task_15985,2470,610,188,187,375,4.042553191489362,49.33106484685749
Task_15986,2959,188,133,123,256,15.656084656084657,55.01751467027898
Task_15987,1317,285,34,199,233,4.604895104895105,29.438370107171437
Task_15988,1828,742,199,166,365,2.4602960969044414,39.502179646218444
Task_15989,648,314,42,185,227,2.057142857142857,18.893686916708372
Task_15990,1680,305,186,128,314,5.490196078431373,35.47725595240106
Task_15991,1567,303,55,127,182,5.154605263157895,33.063841478850755
Task_15992,2875,531,133,162,295,5.404135338345864,55.093878080224954
Task_15993,1409,525,21,97,118,2.678707224334601,30.64247520497369
Task_15994,659,336,186,122,308,1.9554896142433233,19.39651847432221
Task_15995,956,251,190,139,329,3.7936507936507935,23.93697764292665
Task_15996,1460,551,97,80,177,2.6449275362318843,31.647083052923794
Task_15997,2538,840,131,165,296,3.0178359096313914,50.744908738873185
Task_15998,1189,964,80,66,146,1.232124352331606,28.314290057060656
Task_15999,1849,397,72,90,162,4.6457286432160805,37.43073692580467
Task_16000,1316,743,57,17,74,1.7688172043010753,27.947963536133447
Task_16001,2296,884,30,142,172,2.5943502824858755,46.428518947403184
Task_16002,2855,73,148,155,303,38.58108108108108,52.15612226750312
Task_16003,2280,675,86,142,228,3.3727810650887573,45.841126678697215
Task_16004,1105,356,189,196,385,3.0952380952380953,26.97039937555566
Task_16005,941,208,63,12,75,4.502392344497608,20.43678108256959
Task_16006,2559,642,34,95,129,3.979782270606532,49.453937501902494
Task_16007,1051,108,148,162,310,9.642201834862385,24.197122994790533
Task_16008,2081,302,153,163,316,6.867986798679868,41.86762921799486
Task_16009,1848,964,23,154,177,1.9150259067357513,39.56390294163343
Task_16010,1119,804,189,171,360,1.3900621118012422,28.379423008909313
Task_16011,1888,589,26,27,53,3.2,36.90002195930509
Task_16012,991,754,194,108,302,1.3125827814569537,25.85844883362141
Task_16013,2677,779,98,166,264,3.432051282051282,52.626863066859016
Task_16014,1913,684,11,161,172,2.7927007299270072,39.72376718853645
Task_16015,2639,451,183,96,279,5.838495575221239,50.95212606874811
Task_16016,900,615,25,127,152,1.4610389610389611,22.972690028184775
Task_16017,726,146,20,111,131,4.938775510204081,18.05937570556758
Task_16018,2302,369,68,166,234,6.221621621621622,45.34656822667075
Task_16019,1893,368,88,42,130,5.130081300813008,37.188241782500526
Task_16020,1212,720,176,90,266,1.680998613037448,28.943562144743172
Task_16021,2903,650,161,34,195,4.459293394777266,54.6099028006035
Task_16022,2296,182,56,64,120,12.546448087431694,43.18846939370928
Task_16023,1460,71,74,29,103,20.27777777777778,27.797495257902778
Task_16024,2023,1008,42,166,208,2.0049554013875124,42.72668495982695
Task_16025,1934,82,200,175,375,23.301204819277107,38.1992508038499
Task_16026,1190,446,70,153,223,2.6621923937360177,27.949593674912407
Task_16027,2057,466,68,85,153,4.404710920770878,40.75085977152001
Task_16028,1660,1011,71,143,214,1.640316205533597,37.07670721486259
Task_16029,1781,715,177,90,267,2.4874301675977653,37.955266039515735
Task_16030,1640,833,144,119,263,1.9664268585131894,36.279000617244954
Task_16031,711,619,47,197,244,1.146774193548387,20.83783132556715
Task_16032,2477,766,72,53,125,3.229465449804433,47.983270514824405
Task_16033,1353,409,84,199,283,3.3,30.65613602892577
Task_16034,1891,513,142,16,158,3.678988326848249,37.51838285695276
Task_16035,2179,280,42,96,138,7.754448398576512,42.18585323000807
Task_16036,1268,520,123,161,284,2.433781190019194,29.564296508106747
Task_16037,2004,833,146,138,284,2.402877697841727,42.1686784813064
Task_16038,663,250,98,22,120,2.641434262948207,17.087116767554296
Task_16039,2893,634,99,174,273,4.555905511811024,55.629657309907294
Task_16040,1913,848,200,196,396,2.253239104829211,41.36346727845132
Task_16041,2898,164,181,105,286,17.563636363636363,53.72472450773583
Task_16042,2875,394,29,107,136,7.2784810126582276,53.595357343744354
Task_16043,2250,352,42,86,128,6.373937677053824,43.54068235369542
Task_16044,1563,993,88,147,235,1.5724346076458753,35.445043867469614
Task_16045,2216,823,107,187,294,2.6893203883495147,45.61322165503038
Task_16046,707,203,192,191,383,3.465686274509804,20.164298515255457
Task_16047,2265,345,137,147,284,6.546242774566474,44.75600816747107
Task_16048,509,117,171,118,289,4.313559322033898,15.783258242373803
Task_16049,818,868,42,199,241,0.9413118527042578,23.202355035150223
Task_16050,725,934,88,174,262,0.7754010695187166,22.110218434360018
Task_16051,2853,732,152,169,321,3.892223738062756,55.514308614161585
Task_16052,2042,588,177,72,249,3.466893039049236,41.33073132971152
Task_16053,1303,767,13,35,48,1.6966145833333333,28.1363260298279
Task_16054,1519,913,64,121,185,1.661925601750547,34.24643773078552
Task_16055,1318,1015,133,169,302,1.297244094488189,31.898458557401668
Task_16056,2434,268,114,137,251,9.048327137546469,46.997221909359304
Task_16057,1608,574,163,139,302,2.796521739130435,35.16687873889546
Task_16058,2592,879,193,75,268,2.9454545454545453,51.10021596297793
Task_16059,807,550,171,108,279,1.4646098003629764,22.190518264916776
Task_16060,2360,918,166,168,334,2.568008705114255,48.34396763660047
Task_16061,1064,493,149,140,289,2.1538461538461537,26.241413174477703
Task_16062,1477,552,158,177,335,2.670886075949367,33.227611453797515
Task_16063,1248,193,43,44,87,6.43298969072165,26.03976466369659
Task_16064,2389,510,109,51,160,4.675146771037182,45.8072882401267
Task_16065,564,900,166,76,242,0.6259711431742508,19.17241541777467
Task_16066,2300,435,175,30,205,5.275229357798165,44.420597407076606
Task_16067,2599,584,183,176,359,4.442735042735043,51.20286256731928
Task_16068,1345,328,59,66,125,4.088145896656535,28.789597305393418
Task_16069,2263,108,107,180,287,20.761467889908257,43.17045871039596
Task_16070,2751,878,17,176,193,3.1296928327645053,53.72846322488326
Task_16071,1414,685,25,85,110,2.061224489795918,31.040850608884938
Task_16072,2709,150,180,174,354,17.94039735099338,51.065877704505766
Task_16073,2953,646,70,190,260,4.564142194744977,56.72180228004077
Task_16074,2693,213,82,142,224,12.58411214953271,50.858918180437165
Task_16075,519,523,31,24,55,0.9904580152671756,15.203464413142314
Task_16076,2813,163,127,12,139,17.152439024390244,50.626938173548474
Task_16077,1552,686,40,107,147,2.2590975254730714,33.60225390464239
Task_16078,1405,508,97,96,193,2.760314341846758,31.2353404064573
Task_16079,2832,322,39,136,175,8.76780185758514,53.084185946362396
Task_16080,1029,72,20,199,219,14.095890410958905,23.274602848103285
Task_16081,2324,967,186,115,301,2.4008264462809916,47.69981046113079
Task_16082,1634,675,54,79,133,2.4171597633136095,34.82091809003577
Task_16083,1601,136,89,181,270,11.686131386861314,33.16049388078327
Task_16084,709,858,97,83,180,0.8253783469150174,20.65237783088968
Task_16085,1791,291,162,160,322,6.133561643835616,37.26780338792534
Task_16086,2459,518,179,64,243,4.737957610789981,47.63223847146636
Task_16087,641,617,198,127,325,1.0372168284789645,19.945466621460294
Task_16088,1030,781,31,187,218,1.3171355498721227,26.2820908957583
Task_16089,947,368,179,60,239,2.5663956639566394,23.128038238729882
Task_16090,1713,326,182,177,359,5.238532110091743,36.34392090636285
Task_16091,1777,466,34,96,130,3.805139186295503,36.50668046715073
Task_16092,1072,127,160,131,291,8.375,24.725960400601736
Task_16093,728,826,120,119,239,0.8802902055622733,21.623702239993577
Task_16094,2361,943,141,189,330,2.5010593220338984,48.45052593501013
Task_16095,606,930,133,10,143,0.6509129967776585,18.788449805424833
Task_16096,1228,521,180,92,272,2.3524904214559386,28.678199852189888
Task_16097,2367,95,159,163,322,24.65625,44.77848974758704
Task_16098,1150,647,63,54,117,1.7746913580246915,26.332777156658636
Task_16099,2812,76,94,88,182,36.51948051948052,50.655583807647076
Task_16100,795,128,182,25,207,6.162790697674419,19.21630615492716
Task_16101,561,456,182,69,251,1.2275711159737417,17.36221151629084
Task_16102,1425,198,140,170,310,7.160804020100502,31.1673181948476
Task_16103,2091,728,150,43,193,2.8683127572016462,41.97287490079296
Task_16104,1847,329,197,192,389,5.596969696969697,38.63031573116496
Task_16105,1106,947,183,152,335,1.1666666666666667,28.453071405444376
Task_16106,881,974,172,164,336,0.9035897435897436,25.016310474978
Task_16107,1974,878,61,154,215,2.2457337883959045,41.6741182517132
Task_16108,725,409,134,165,299,1.7682926829268293,20.679959251417362
Task_16109,898,535,46,130,176,1.6753731343283582,23.085628226947417
Task_16110,1201,192,137,144,281,6.22279792746114,27.40004721560867
Task_16111,2560,704,96,145,241,3.631205673758865,50.44161804017924
Task_16112,2259,661,25,103,128,3.4123867069486407,44.85326410046266
Task_16113,1986,65,78,49,127,30.09090909090909,36.40122644334374
Task_16114,2826,752,44,39,83,3.752988047808765,52.6149927876213
Task_16115,1973,995,93,51,144,1.9809236947791165,40.835470740083075
Task_16116,559,459,108,173,281,1.2152173913043478,18.030064214235736
Task_16117,2562,778,148,59,207,3.288831835686778,49.84833505992791
Task_16118,1788,66,26,68,94,26.686567164179106,33.29998786964168
Task_16119,1069,407,176,114,290,2.6200980392156863,26.01529253619106
Task_16120,1479,628,171,171,342,2.3513513513513513,33.52085494796913
Task_16121,1567,294,123,40,163,5.311864406779661,32.00739370056589
Task_16122,1880,281,86,178,264,6.666666666666667,38.44746295454677
Task_16123,1150,421,15,77,92,2.7251184834123223,25.68872169728577
Task_16124,578,477,80,117,197,1.209205020920502,18.086911046254418
Task_16125,2305,822,183,157,340,2.800729040097205,47.1835269884746
Task_16126,1589,198,116,155,271,7.984924623115578,33.55807335794549
Task_16127,775,117,128,51,179,6.567796610169491,18.687680328250995
Task_16128,1733,880,168,65,233,1.9670828603859252,37.244374313787965
Task_16129,1744,297,95,183,278,5.852348993288591,36.45067135024805
Task_16130,1557,988,126,123,249,1.5743174924165824,35.34530033222665
Task_16131,1404,914,187,63,250,1.5344262295081967,32.17423992418481
Task_16132,2673,222,46,88,134,11.986547085201794,49.63420042124299
Task_16133,895,286,103,173,276,3.1184668989547037,22.89858519101576
Task_16134,2002,868,63,130,193,2.3037974683544302,41.95227032374037
Task_16135,2933,524,165,79,244,5.586666666666667,55.345161473041095
Task_16136,2601,497,121,110,231,5.22289156626506,50.28108834609744
Task_16137,2947,126,36,100,136,23.20472440944882,52.98492050317795
Task_16138,856,450,113,79,192,1.8980044345898004,21.992343774945258
Task_16139,1400,698,21,147,168,2.0028612303290414,31.46494451039104
Task_16140,706,299,146,64,210,2.3533333333333335,19.04009036336139
Task_16141,2061,192,73,33,106,10.678756476683938,39.111669247217115
Task_16142,2066,793,91,93,184,2.602015113350126,42.29620722607678
Task_16143,2405,497,16,172,188,4.829317269076305,47.001209942875526
Task_16144,698,256,81,184,265,2.7159533073929962,19.757921474616
Task_16145,1977,998,162,127,289,1.978978978978979,42.26091469251606
Task_16146,2302,407,180,199,379,5.642156862745098,46.05224010720616
Task_16147,2510,592,32,20,52,4.232715008431703,46.53969152825152
Task_16148,2679,609,46,13,59,4.391803278688524,49.17620020731249
Task_16149,2346,760,187,198,385,3.082785808147175,47.90170276038932
Task_16150,530,240,165,133,298,2.199170124481328,17.02219681283537
Task_16151,2177,677,96,113,209,3.2109144542772863,44.09862195974972
Task_16152,2469,805,131,60,191,3.063275434243176,48.390979736956126
Task_16153,1972,139,87,156,243,14.085714285714285,38.82903250094437
Task_16154,1180,1023,188,194,382,1.15234375,30.143536642418454
Task_16155,2514,294,161,181,342,8.522033898305084,48.82913382063189
Task_16156,2228,652,49,144,193,3.411944869831547,44.90884590686719
Task_16157,1820,237,198,76,274,7.647058823529412,36.83701684782772
Task_16158,2877,643,200,173,373,4.467391304347826,55.852476875790785
Task_16159,1872,246,163,80,243,7.578947368421052,37.63297630719011
Task_16160,2491,490,195,148,343,5.0733197556008145,49.07750591256028
Task_16161,2013,856,27,77,104,2.348891481913652,40.82066700888425
Task_16162,964,619,134,105,239,1.5548387096774194,24.732691268056655
Task_16163,2063,710,133,132,265,2.90154711673699,42.624022747586324
Task_16164,1916,370,59,17,76,5.164420485175202,36.27101592166958
Task_16165,678,941,200,176,376,0.7197452229299363,21.996273063431545
Task_16166,786,537,142,28,170,1.4609665427509293,20.37492179108925
Task_16167,2772,476,54,30,84,5.811320754716981,50.85413866130856
Task_16168,2397,591,39,84,123,4.048986486486487,46.45713336333518
Task_16169,1336,72,149,148,297,18.301369863013697,28.362522203083103
Task_16170,2446,397,54,20,74,6.1457286432160805,44.75778526401282
Task_16171,1383,116,43,113,156,11.820512820512821,28.340665076792572
Task_16172,859,258,18,40,58,3.3166023166023164,19.54025451415465
Task_16173,1718,859,96,41,137,1.9976744186046511,36.027007969936356
Task_16174,1534,153,134,182,316,9.96103896103896,32.40243669207948
Task_16175,1837,555,146,199,345,3.303956834532374,39.014788796744945
Task_16176,2834,105,124,97,221,26.735849056603772,51.69730584407062
Task_16177,693,798,35,54,89,0.867334167709637,19.2843052775648
Task_16178,1526,311,139,172,311,4.891025641025641,33.11325362756702
Task_16179,2234,371,55,181,236,6.005376344086022,44.344917767351234
Task_16180,1671,268,140,55,195,6.211895910780669,34.140098696133435
Task_16181,1195,190,14,29,43,6.2565445026178015,24.715275609812778
Task_16182,2338,413,64,43,107,5.647342995169082,43.87635560184808
Task_16183,2247,235,64,190,254,9.521186440677965,44.1411505431808
Task_16184,992,78,47,143,190,12.556962025316455,22.564551103762046
Task_16185,829,255,50,186,236,3.23828125,21.782670226962864
Task_16186,739,535,171,135,306,1.3787313432835822,21.22830239376559
Task_16187,2641,662,164,23,187,3.9834087481146305,50.35459129005966
Task_16188,1702,972,197,11,208,1.749229188078109,36.48579965409778
Task_16189,550,610,163,54,217,0.900163666121113,17.607892919531817
Task_16190,2143,134,57,39,96,15.874074074074073,39.20552858498501
Task_16191,2913,694,161,21,182,4.19136690647482,54.546640826490936
Task_16192,1202,323,133,99,232,3.7098765432098766,27.55135069889434
Task_16193,594,907,58,39,97,0.6541850220264317,18.159909952437932
Task_16194,1931,478,73,122,195,4.031315240083507,39.595675334935606
Task_16195,1852,660,165,33,198,2.8018154311649015,38.00703500657308
Task_16196,1114,356,25,133,158,3.1204481792717087,25.731857154382624
Task_16197,1538,574,54,16,70,2.674782608695652,30.989121382992334
Task_16198,849,371,182,122,304,2.282258064516129,22.494912289556897
Task_16199,2034,896,176,20,196,2.2675585284280935,41.41737112842295
Task_16200,1115,821,53,88,141,1.356447688564477,26.95355427104808
Task_16201,2193,179,11,40,51,12.183333333333334,40.31516804618221
Task_16202,2649,451,61,122,183,5.860619469026549,50.63789722836288
Task_16203,573,501,176,118,294,1.1414342629482073,18.40159921814109
Task_16204,2774,841,173,165,338,3.294536817102138,54.676538702497396
Task_16205,2202,960,27,44,71,2.291363163371488,42.959097726549324
Task_16206,976,470,96,104,200,2.0721868365180467,24.374989783127607
Task_16207,2121,279,157,23,180,7.575,40.704477563052755
Task_16208,916,844,111,57,168,1.0840236686390532,23.541874597097692
Task_16209,1036,529,41,91,132,1.9547169811320755,24.866557365775837
Task_16210,1217,843,182,159,341,1.4419431279620853,29.949912737138444
Task_16211,1441,506,121,179,300,2.842209072978304,32.3575687713688
Task_16212,1442,928,61,86,147,1.5522066738428417,32.494937102793024
Task_16213,1255,615,70,120,190,2.0373376623376624,29.30180787072341
Task_16214,1778,563,54,155,209,3.152482269503546,37.587517423212596
Task_16215,1550,312,72,26,98,4.952076677316294,31.21025665401022
Task_16216,630,791,25,90,115,0.7954545454545454,18.933348298664516
Task_16217,2752,988,138,163,301,2.782608695652174,54.618013243897984
Task_16218,512,413,133,44,177,1.2367149758454106,15.692255825155122
Task_16219,2260,831,102,156,258,2.7163461538461537,46.12766434076318
Task_16220,2307,224,148,28,176,10.253333333333334,43.46175165218555
Task_16221,827,899,130,199,329,0.9188888888888889,23.941583364114752
Task_16222,790,895,139,183,322,0.8816964285714286,23.287280927561824
Task_16223,2607,142,129,185,314,18.23076923076923,49.25997130185639
Task_16224,2990,623,92,163,255,4.791666666666667,57.10937890291229
Task_16225,2308,179,179,130,309,12.822222222222223,44.53684523679214
Task_16226,2908,101,46,134,180,28.50980392156863,52.5561728101186
Task_16227,1991,534,132,137,269,3.721495327102804,40.953074894520846
Task_16228,1307,784,90,137,227,1.6649681528662421,30.750713176830487
Task_16229,2592,722,132,145,277,3.5850622406639006,51.11471433317988
Task_16230,2822,71,188,34,222,39.19444444444444,50.34667630639243
Task_16231,1037,304,149,135,284,3.4,25.1823764350183
Task_16232,1860,908,24,32,56,2.046204620462046,37.4048018037737
Task_16233,2771,398,132,148,280,6.9448621553884715,52.9227304696372
Task_16234,1434,682,124,77,201,2.0995607613469986,31.84515331541741
Task_16235,1981,678,191,172,363,2.917525773195876,41.72493844717944
Task_16236,2291,266,141,143,284,8.58052434456929,44.887588543851415
Task_16237,2279,375,134,176,310,6.0611702127659575,45.23768202707811
Task_16238,1394,1018,71,107,178,1.368007850834151,32.42486913336967
Task_16239,2101,942,157,196,353,2.227995758218452,44.44135279146445
Task_16240,1241,455,134,12,146,2.7214912280701755,27.096666927013093
Task_16241,1184,497,94,85,179,2.3775100401606424,27.189873997117235
Task_16242,2129,206,178,71,249,10.285024154589372,41.407353564845685
Task_16243,2477,928,21,169,190,2.666307857911733,49.550679225539845
Task_16244,978,882,141,109,250,1.1075877689694225,25.709824358247015
Task_16245,2556,646,139,141,280,3.9505409582689337,50.31182489440685
Task_16246,2611,552,40,65,105,4.7215189873417724,49.21014058203222
Task_16247,637,192,113,173,286,3.300518134715026,18.564500037011868
Task_16248,2330,360,67,174,241,6.454293628808864,45.802660286733904
Task_16249,1582,765,147,126,273,2.0652741514360313,35.20360600008823
Task_16250,2548,780,194,148,342,3.262483994878361,50.89756337267912
Task_16251,1856,671,151,73,224,2.761904761904762,38.54454275903992
Task_16252,753,775,136,123,259,0.970360824742268,21.952647131997036
Task_16253,1796,159,47,27,74,11.225,33.98593844051159
Task_16254,1478,701,55,15,70,2.1054131054131053,30.4200925840825
Task_16255,2627,909,195,90,285,2.8868131868131868,52.04664458291732
Task_16256,1148,683,149,109,258,1.6783625730994152,27.967116553430344
Task_16257,2642,716,83,157,240,3.684797768479777,51.79227965644114
Task_16258,1512,664,177,125,302,2.2736842105263158,33.90855087361893
Task_16259,1142,827,65,99,164,1.3792270531400965,27.821973803898207
Task_16260,2754,813,63,60,123,3.383292383292383,52.357226050598136
Task_16261,1224,130,101,149,250,9.34351145038168,26.985599301847014
Task_16262,662,155,68,186,254,4.243589743589744,18.511364847707743
Task_16263,752,248,87,81,168,3.0200803212851404,19.385278286364922
Task_16264,1739,550,134,160,294,3.1560798548094375,37.160157759368765
Task_16265,2444,343,192,98,290,7.104651162790698,47.53900679113544
Task_16266,2514,770,99,114,213,3.2607003891050583,49.69794007603679
Task_16267,1253,573,195,200,395,2.182926829268293,30.05075692984805
Task_16268,2804,962,32,191,223,2.9117341640706127,55.08999383267678
Task_16269,2930,449,125,197,322,6.511111111111111,55.86971341752896
Task_16270,1685,110,198,110,308,15.18018018018018,34.09511922795444
Task_16271,1475,305,123,180,303,4.8202614379084965,32.26258444541677
Task_16272,2436,818,132,182,314,2.9743589743589745,49.16597842867035
Task_16273,2880,845,53,86,139,3.404255319148936,55.049048612446455
Task_16274,822,551,23,28,51,1.4891304347826086,19.96133932946704
Task_16275,515,589,191,189,380,0.8728813559322034,18.254279964734305
Task_16276,2632,819,124,39,163,3.209756097560976,50.51207573651815
Task_16277,1287,562,20,186,206,2.285968028419183,29.662737640165947
Task_16278,1071,924,124,139,263,1.1578378378378378,27.49297469762423
Task_16279,1107,1020,181,63,244,1.0842311459353575,27.706153085004164
Task_16280,2688,67,53,180,233,39.529411764705884,49.33994641109888
Task_16281,1170,962,110,13,123,1.2149532710280373,27.323802034476486
Task_16282,1787,646,58,172,230,2.7619783616692426,38.10670239514403
Task_16283,2432,569,56,189,245,4.266666666666667,48.1743485089477
Task_16284,2929,976,51,146,197,2.9979529170931425,57.0877009498335
Task_16285,2720,492,34,180,214,5.517241379310345,52.20260353873727
Task_16286,1423,816,62,17,79,1.7417380660954713,29.982647021594193
Task_16287,897,848,136,97,233,1.0565371024734982,24.29143573884822
Task_16288,2950,801,84,91,175,3.678304239401496,56.32514842598309
Task_16289,1038,964,142,164,306,1.0756476683937823,27.261812692132835
Task_16290,2832,1004,38,58,96,2.817910447761194,53.894317403847964
Task_16291,1191,845,33,160,193,1.4078014184397163,28.882395836150454
Task_16292,718,866,144,193,337,0.8281430219146482,22.130662190114634
Task_16293,1369,416,15,132,147,3.2829736211031175,29.92412416033488
Task_16294,2453,876,29,33,62,2.797035347776511,46.696001408445305
Task_16295,1104,351,35,55,90,3.1363636363636362,24.443779130823305
Task_16296,2656,743,110,154,264,3.5698924731182795,52.149355923566816
Task_16297,985,264,75,128,203,3.7169811320754715,23.990229359176805
Task_16298,1623,476,178,25,203,3.40251572327044,33.75266699978565
Task_16299,2448,690,25,118,143,3.5426917510853837,47.83929527010602
Task_16300,1026,375,50,161,211,2.728723404255319,25.135387016134686
Task_16301,632,746,15,35,50,0.8460508701472557,17.701797054082295
Task_16302,1941,690,44,18,62,2.808972503617945,37.74383800635191
Task_16303,1585,373,95,198,293,4.237967914438503,34.277235692252795
Task_16304,1238,594,42,78,120,2.080672268907563,28.028258875587937
Task_16305,2212,73,129,137,266,29.89189189189189,41.90001950008968
Task_16306,2964,379,11,103,114,7.8,54.848593231024154
Task_16307,1848,142,103,54,157,12.923076923076923,35.70107822326559
Task_16308,2897,976,128,55,183,2.9651995905834188,55.577853494195146
Task_16309,577,989,122,89,211,0.5828282828282828,19.534562053963054
Task_16310,1648,797,102,31,133,2.0651629072681703,34.70216223575937
Task_16311,1395,97,160,197,357,14.23469387755102,29.73290281562018
Task_16312,2229,725,84,165,249,3.0702479338842976,45.3242980576743
Task_16313,1156,318,43,181,224,3.623824451410658,26.920225473810987
Task_16314,1835,988,161,117,278,1.8554095045500505,39.915355519590996
Task_16315,1300,746,37,143,180,1.7402945113788488,30.11120492317605
Task_16316,2195,379,173,19,192,5.776315789473684,42.274206240355134
Task_16317,1241,119,56,119,175,10.341666666666667,26.853797783788934
Task_16318,657,585,77,35,112,1.121160409556314,18.096102892840825
Task_16319,2372,137,113,164,277,17.18840579710145,45.30472294834163
Task_16320,2918,239,100,30,130,12.158333333333333,52.96283285550148
Task_16321,1677,214,194,137,331,7.8,35.20324956673826
Task_16322,2675,339,81,49,130,7.867647058823529,49.55360113336831
Task_16323,526,695,26,163,189,0.7557471264367817,17.782995685027817
Task_16324,1244,323,43,164,207,3.8395061728395063,28.22659038159536
Task_16325,1805,856,77,148,225,2.106184364060677,38.96204343157532
Task_16326,1165,712,26,90,116,1.6339410939691446,27.322845065057027
Task_16327,1734,612,73,119,192,2.828711256117455,36.88383284509304
Task_16328,2079,721,115,118,233,2.8795013850415514,42.74725525957678
Task_16329,1847,844,119,15,134,2.1857988165680475,37.81006835716242
Task_16330,2305,801,199,42,241,2.874064837905237,45.80679755185326
Task_16331,1330,946,60,151,211,1.4044350580781415,31.588707010481585
Task_16332,2779,238,188,87,275,11.627615062761507,52.1176718742965
Task_16333,647,455,117,40,157,1.418859649122807,17.78273829532268
Task_16334,1715,167,165,180,345,10.208333333333334,35.46146482870811
Task_16335,1195,250,144,131,275,4.760956175298805,27.454766203375076
Task_16336,769,281,168,106,274,2.726950354609929,20.783433636070892
Task_16337,2894,386,44,88,132,7.478036175710594,53.750721600675924
Task_16338,1587,669,102,13,115,2.3686567164179104,32.93635803744878
Task_16339,2154,457,167,182,349,4.703056768558952,43.71297492043956
Task_16340,694,589,165,65,230,1.176271186440678,19.87601045308149
Task_16341,1285,242,52,55,107,5.288065843621399,27.115248492219294
Task_16342,2871,578,170,28,198,4.958549222797927,53.846412118038494
Task_16343,2553,128,93,194,287,19.790697674418606,48.201787468252455
Task_16344,1188,678,26,126,152,1.7496318114874816,27.823709564545112
Task_16345,2751,915,103,105,208,3.0032751091703056,53.86999022139876
Task_16346,741,622,22,107,129,1.189406099518459,20.414706061752277
Task_16347,2866,846,84,58,142,3.38370720188902,54.35345946033093
Task_16348,2652,682,130,187,317,3.882869692532943,52.18062489167077
Task_16349,1674,330,155,77,232,5.057401812688822,34.662815263767115
Task_16350,2824,193,83,39,122,14.556701030927835,51.19558416087526
Task_16351,2315,867,57,16,73,2.6670506912442398,44.2292414431497
Task_16352,1099,250,155,155,310,4.378486055776892,26.130890784080602
Task_16353,1753,746,128,11,139,2.3467202141900936,36.01055223356581
Task_16354,875,964,136,197,333,0.9067357512953368,24.92518342515162
Task_16355,2317,868,118,162,280,2.666283084004603,47.254372477754195
Task_16356,1951,651,104,36,140,2.9923312883435584,39.00512741081685
Task_16357,1910,153,162,160,322,12.402597402597403,38.32319044688813
Task_16358,2950,781,152,82,234,3.772378516624041,56.40262518002955
Task_16359,2799,93,187,89,276,29.77659574468085,51.17665867126473
Task_16360,1332,129,120,110,230,10.246153846153845,28.520901868698257
Task_16361,2948,806,75,111,186,3.6530359355638167,56.56526444746164
Task_16362,1690,338,116,135,251,4.985250737463127,35.47163920952978
Task_16363,1136,152,101,136,237,7.42483660130719,25.702419673856067
Task_16364,1265,795,76,27,103,1.5891959798994975,28.25865511014135
Task_16365,2790,688,87,69,156,4.049346879535559,52.692386057724576
Task_16366,809,821,30,25,55,0.9841849148418491,20.72241593911308
Task_16367,2267,264,38,164,202,8.554716981132076,44.17476317826714
Task_16368,1332,655,17,182,199,2.0304878048780486,30.586511963195715
Task_16369,2052,73,114,91,205,27.72972972972973,38.966387557598836
Task_16370,2896,911,151,173,324,3.175438596491228,56.777580666827625
Task_16371,2290,340,156,79,235,6.715542521994135,44.521181877496424
Task_16372,654,764,182,102,284,0.8549019607843137,20.43747767004142
Task_16373,2769,314,121,35,156,8.790476190476191,50.932953867461855
Task_16374,584,665,80,190,270,0.8768768768768769,19.17167325283729
Task_16375,1529,800,54,177,231,1.9088639200998752,34.51755029885738
Task_16376,2798,603,127,109,236,4.632450331125828,53.7624161053724
Task_16377,2021,192,19,88,107,10.471502590673575,39.033100083818326
Task_16378,1791,358,122,124,246,4.988857938718663,37.096570869911176
Task_16379,1900,957,58,155,213,1.9832985386221293,40.76637502307821
Task_16380,2430,962,58,26,84,2.5233644859813085,46.934004553771324
Task_16381,786,156,101,155,256,5.006369426751593,20.346179308532683
Task_16382,954,71,155,199,354,13.25,22.7246440703474
Task_16383,2083,805,40,59,99,2.5843672456575684,41.346917100772515
Task_16384,1365,484,94,187,281,2.814432989690722,31.094658759290184
Task_16385,2258,531,160,198,358,4.2443609022556394,45.66152525435022
Task_16386,2067,186,74,87,161,11.053475935828876,40.383949445886856
Task_16387,2802,380,44,120,164,7.354330708661418,52.68713739043619
Task_16388,2801,428,86,45,131,6.529137529137529,51.727987986366145
Task_16389,2470,297,76,150,226,8.288590604026846,47.71400900898664
Task_16390,2917,448,131,60,191,6.496659242761693,54.34551487871266
Task_16391,737,233,89,34,123,3.1495726495726495,18.37729561354401
Task_16392,1370,772,79,24,103,1.7723156532988358,29.812379890981145
Task_16393,2441,293,33,184,217,8.302721088435375,47.16039191660682
Task_16394,1281,545,198,169,367,2.3461538461538463,30.23459176012877
Task_16395,865,827,14,142,156,1.0446859903381642,23.054080375755166
Task_16396,2861,461,13,33,46,6.192640692640692,51.811491129939725
Task_16397,2219,281,124,160,284,7.868794326241135,43.82772659021376
Task_16398,2556,598,108,26,134,4.267111853088481,48.40608920606763
Task_16399,747,375,153,80,233,1.9867021276595744,20.22706515280386
Task_16400,1174,347,90,190,280,3.3735632183908044,27.60009233558293
Task_16401,990,834,162,86,248,1.18562874251497,25.530715352666586
Task_16402,2020,212,136,164,300,9.48356807511737,40.51138275354953
Task_16403,1569,759,136,10,146,2.0644736842105265,33.23441417929705
Task_16404,1394,884,185,123,308,1.575141242937853,32.705727335289275
Task_16405,1178,909,194,122,316,1.2945054945054946,29.3459193137812
Task_16406,1234,682,59,184,243,1.8067349926793559,29.536636056142175
Task_16407,1951,877,160,181,341,2.222095671981777,41.78605338988627
Task_16408,1556,440,136,22,158,3.5283446712018143,32.08988972851696
Task_16409,662,877,161,199,360,0.7539863325740319,21.385029585110914
Task_16410,1769,1003,79,130,209,1.7619521912350598,38.74137224683379
Task_16411,1826,453,132,128,260,4.022026431718062,38.02811894030617
Task_16412,1968,598,132,39,171,3.285475792988314,39.28144595770886
Task_16413,1074,550,138,190,328,1.9491833030852994,26.82763345511837
Task_16414,750,602,172,51,223,1.243781094527363,20.694517486668758
Task_16415,2410,240,190,136,326,10.0,46.851983669817464
Task_16416,2169,368,164,38,202,5.878048780487805,42.13439285585397
Task_16417,1266,554,168,154,322,2.281081081081081,29.800547140223102
Task_16418,1462,391,90,78,168,3.729591836734694,31.14486444107253
Task_16419,2064,1009,19,151,170,2.0435643564356436,42.96852198918642
Task_16420,1881,717,185,192,377,2.6197771587743732,40.35570794494791
Task_16421,1439,859,34,60,94,1.6732558139534883,31.39047677587276
Task_16422,919,462,52,53,105,1.9848812095032398,21.98762284262915
Task_16423,1560,804,110,40,150,1.937888198757764,33.304663229279086
Task_16424,1063,87,109,31,140,12.079545454545455,22.33206142053622
Task_16425,2013,984,140,16,156,2.0436548223350255,40.91890369364064
Task_16426,2727,122,118,179,297,22.170731707317074,50.85579798861759
Task_16427,1062,561,79,196,275,1.8896797153024911,26.572681547855883
Task_16428,2893,830,99,42,141,3.4813477737665464,54.46603072317271
Task_16429,2712,449,103,36,139,6.026666666666666,50.3848403032608
Task_16430,2095,250,194,127,321,8.346613545816734,41.87626815120941
Task_16431,2351,82,135,163,298,28.325301204819276,44.37028974897222
Task_16432,2285,263,65,125,190,8.655303030303031,44.445939388244064
Task_16433,992,97,104,43,147,10.122448979591837,21.245435845327076
Task_16434,1319,856,158,58,216,1.5390898483080513,30.43557812809864
Task_16435,1042,641,183,180,363,1.6230529595015577,26.73468610649084
Task_16436,1298,566,23,23,46,2.289241622574956,27.36781384903581
Task_16437,2722,95,127,80,207,28.354166666666668,49.4636590342593
Task_16438,2648,1017,92,50,142,2.601178781925344,51.365671064687575
Task_16439,2408,557,101,175,276,4.315412186379929,47.71648856427282
Task_16440,1523,989,111,141,252,1.5383838383838384,34.84951464007709
Task_16441,1791,866,119,127,246,2.065743944636678,38.70931188874817
Task_16442,1759,255,163,184,347,6.87109375,36.785725183359425
Task_16443,500,350,88,200,288,1.4245014245014245,16.898695693187904
Task_16444,2298,644,29,24,53,3.562790697674419,43.56898045408585
Task_16445,1544,655,143,147,290,2.3536585365853657,34.365386492964355
Task_16446,1369,888,100,35,135,1.5399325084364455,30.533538048000022
Task_16447,1684,925,199,81,280,1.818574514038877,36.96000289149549
Task_16448,2346,469,22,119,141,4.991489361702127,45.419501319710356
Task_16449,2211,73,196,200,396,29.87837837837838,42.56263976652786
Task_16450,629,969,115,146,261,0.6484536082474227,20.77548135666284
Task_16451,2316,408,183,137,320,5.662591687041565,45.92026997393919
Task_16452,1195,515,126,187,313,2.315891472868217,28.56161137949553
Task_16453,2234,877,187,196,383,2.5444191343963554,46.481428388935875
Task_16454,2330,429,117,103,220,5.4186046511627906,45.71022713941878
Task_16455,1626,352,43,25,68,4.606232294617564,31.914478169237935
Task_16456,2975,202,65,126,191,14.655172413793103,55.12650296253495
Task_16457,2651,499,134,144,278,5.302,51.34080498387258
Task_16458,1109,445,69,35,104,2.486547085201794,24.64518933179183
Task_16459,2094,517,76,139,215,4.042471042471043,42.42735264447694
Task_16460,1412,943,158,37,195,1.4957627118644068,31.916917920051834
Task_16461,2457,738,198,152,350,3.324763193504736,49.36582245813685
Task_16462,2165,280,55,49,104,7.704626334519573,40.79516536018071
Task_16463,832,140,14,51,65,5.900709219858156,18.823425108606852
Task_16464,1161,526,131,103,234,2.20303605313093,27.578690005369847
Task_16465,1589,863,52,72,124,1.8391203703703705,34.454926632884245
Task_16466,1156,978,111,76,187,1.180796731358529,28.23307944945468
Task_16467,1778,406,86,34,120,4.368550368550369,35.30217076195808
Task_16468,1803,399,10,12,22,4.5075,34.426605076284474
Task_16469,1967,991,87,159,246,1.9828629032258065,41.94232633562958
Task_16470,2311,612,190,13,203,3.769983686786297,44.98743284452212
Task_16471,2227,579,178,91,269,3.839655172413793,44.6196670915441
Task_16472,2091,258,89,87,176,8.073359073359073,40.7432797682962
Task_16473,712,377,14,14,28,1.8835978835978835,17.176877130402076
Task_16474,2915,212,132,98,230,13.685446009389672,54.233455045044686
Task_16475,994,226,74,138,212,4.378854625550661,24.05668894982551
Task_16476,815,343,134,65,199,2.369186046511628,20.871270385885165
Task_16477,1000,650,115,183,298,1.5360983102918586,25.779641584190202
Task_16478,1193,439,163,95,258,2.7113636363636364,27.87903975603692
Task_16479,1727,699,56,102,158,2.467142857142857,36.57754128783112
Task_16480,1884,778,58,184,242,2.418485237483954,40.128432250861515
Task_16481,2166,638,90,88,178,3.3896713615023475,43.18297966243117
Task_16482,790,64,73,158,231,12.153846153846153,19.550359609429496
Task_16483,1177,191,87,139,226,6.130208333333333,26.757040945210075
Task_16484,2439,423,151,128,279,5.752358490566038,47.71812630937339
Task_16485,2010,677,134,129,263,2.9646017699115044,41.66740191585529
Task_16486,1321,401,175,29,204,3.2860696517412937,28.814771372252093
Task_16487,930,797,36,146,182,1.1654135338345866,24.25930716685492
Task_16488,1648,285,165,182,347,5.7622377622377625,35.13174711336564
Task_16489,2932,473,98,193,291,6.185654008438819,55.84870317283137
Task_16490,723,635,152,84,236,1.1367924528301887,20.616398783543843
Task_16491,2429,264,126,75,201,9.166037735849057,46.22327870724151
Task_16492,1484,961,19,36,55,1.5426195426195426,31.672763539189063
Task_16493,2317,428,140,173,313,5.400932400932401,46.022984004661055
Task_16494,1368,976,180,24,204,1.4002047082906857,31.277504310469308
Task_16495,1279,654,142,14,156,1.952671755725191,28.259236484470375
Task_16496,2103,725,157,85,242,2.896694214876033,42.857403212717266
Task_16497,1343,553,16,147,163,2.4241877256317688,30.083553192883503
Task_16498,669,742,86,173,259,0.9004037685060565,20.591896359484064
Task_16499,642,377,123,68,191,1.6984126984126984,18.199150534434946
Task_16500,679,696,131,162,293,0.9741750358680057,20.746192997012596
Task_16501,2606,510,115,139,254,5.099804305283757,50.54849438729997
Task_16502,660,958,149,86,235,0.6882168925964547,20.80191489027474
Task_16503,2261,418,150,37,187,5.39618138424821,43.63211888741457
Task_16504,1267,390,196,86,282,3.2404092071611252,28.752888942213797
Task_16505,718,582,150,181,331,1.2315608919382504,21.167346522334856
Task_16506,2246,899,178,46,224,2.4955555555555557,45.09881148074944
Task_16507,2372,203,176,13,189,11.627450980392156,44.480377648269446
Task_16508,2075,687,136,79,215,3.015988372093023,42.145967749849035
Task_16509,1321,853,127,143,270,1.5468384074941453,31.310901573024267
Task_16510,1121,227,193,130,323,4.916666666666667,26.422607793043834
Task_16511,1084,813,25,42,67,1.3316953316953317,24.834680318570744
Task_16512,2711,160,21,27,48,16.838509316770185,48.27242718426391
Task_16513,2629,763,46,173,219,3.4410994764397906,51.64393659469365
Task_16514,1080,748,189,51,240,1.4419225634178905,26.45573146248277
Task_16515,2461,968,131,14,145,2.539731682146543,48.01625422752852
Task_16516,2776,916,124,63,187,3.0272628135223556,53.60370646097601
Task_16517,2444,289,145,184,329,8.427586206896551,47.65065545829513
Task_16518,1655,914,162,70,232,1.8087431693989071,36.1124453890888
Task_16519,1378,561,30,102,132,2.4519572953736657,30.462710223892355
Task_16520,1882,220,21,136,157,8.515837104072398,37.34303339158639
Task_16521,2300,482,115,43,158,4.761904761904762,44.04549621232568
Task_16522,861,375,57,132,189,2.2898936170212765,22.325605413092987
Task_16523,1926,83,56,138,194,22.928571428571427,37.324232481040376
Task_16524,2470,864,115,198,313,2.8554913294797686,49.867601452691495
Task_16525,1630,463,167,53,220,3.5129310344827585,34.260132347459695
Task_16526,2471,479,61,32,93,5.147916666666666,46.16116521762456
Task_16527,885,552,58,86,144,1.6003616636528029,22.53460899847782
Task_16528,2990,1023,115,137,252,2.919921875,58.23987165789432
Task_16529,1132,96,40,89,129,11.670103092783505,24.02081346318514
Task_16530,1069,668,195,140,335,1.5979073243647235,27.06157976070531
Task_16531,1090,683,17,150,167,1.5935672514619883,26.449447915581516
Task_16532,2810,92,64,57,121,30.21505376344086,49.89966286368321
Task_16533,739,690,107,101,208,1.069464544138929,21.14270332001299
Task_16534,1851,737,141,129,270,2.508130081300813,39.368483537646945
Task_16535,665,327,76,20,96,2.027439024390244,17.098608133056214
Task_16536,1464,442,38,98,136,3.304740406320542,31.400526809282994
Task_16537,1352,1000,143,51,194,1.3506493506493507,31.366000474397584
Task_16538,890,680,57,128,185,1.3069016152716593,23.510922404385667
Task_16539,2979,376,51,57,108,7.901856763925729,54.32928117531508
Task_16540,1064,722,79,61,140,1.4716459197787,25.485570967194516
Task_16541,742,344,66,155,221,2.1507246376811593,20.51356253766185
Task_16542,2850,106,62,78,140,26.635514018691588,51.0977192279027
Task_16543,793,174,23,149,172,4.531428571428571,19.985511105529806
Task_16544,1974,233,85,152,237,8.435897435897436,39.60855660277529
Task_16545,2802,527,92,175,267,5.306818181818182,53.89550084929191
Task_16546,1846,866,126,125,251,2.129181084198385,39.600369111987895
Task_16547,1948,68,73,17,90,28.231884057971016,35.22534711416005
Task_16548,623,843,78,30,108,0.7381516587677726,18.433355493508397
Task_16549,512,681,159,150,309,0.750733137829912,18.08663379045555
Task_16550,2455,676,17,98,115,3.62629246676514,47.6202451945152
Task_16551,2569,181,12,173,185,14.115384615384615,47.97946139995639
Task_16552,2013,796,83,194,277,2.5257214554579672,42.29987940984981
Task_16553,1849,351,123,170,293,5.252840909090909,38.27019079910106
Task_16554,1588,428,187,64,251,3.7016317016317015,33.59134781585168
Task_16555,2603,70,108,98,206,36.66197183098591,47.72343660897098
Task_16556,803,815,196,85,281,0.9840686274509803,22.65295323700307
Task_16557,1476,423,106,195,301,3.481132075471698,32.67540670897161
Task_16558,669,261,30,191,221,2.553435114503817,19.065065968146786
Task_16559,2234,484,79,197,276,4.606185567010309,44.89024508954611
Task_16560,1054,541,129,198,327,1.944649446494465,26.489990613200018
Task_16561,2425,100,14,105,119,24.00990099009901,44.248147483537274
Task_16562,1404,443,36,83,119,3.1621621621621623,30.181977854538726
Task_16563,1429,848,60,18,78,1.6831566548881036,30.11331830537127
Task_16564,970,446,76,85,161,2.170022371364653,23.551363891721945
Task_16565,663,859,42,66,108,0.7709302325581395,19.328911152588148
Task_16566,2043,134,144,13,157,15.133333333333333,38.30871827974894
Task_16567,1181,546,62,132,194,2.1590493601462524,27.9483625591336
Task_16568,2771,959,170,121,291,2.886458333333333,54.72194487740694
Task_16569,1699,415,167,82,249,4.084134615384615,35.49538593244126
Task_16570,2410,834,30,134,164,2.8862275449101795,47.98699726376041
Task_16571,1209,821,156,52,208,1.4708029197080292,28.641477803180198
Task_16572,1481,682,28,124,152,2.168374816983895,32.48770506571291
Task_16573,2137,499,136,189,325,4.274,43.48132299445405
Task_16574,2148,722,112,95,207,2.970954356846473,43.66438742252651
Task_16575,2676,962,149,142,291,2.778816199376947,53.25668645552222
Task_16576,2820,179,136,156,292,15.666666666666666,52.57529335669768
Task_16577,2870,94,195,44,239,30.210526315789473,51.457254657565244
Task_16578,2918,171,23,166,189,16.96511627906977,53.70161654657978
Task_16579,678,199,24,15,39,3.39,16.04818942929174
Task_16580,1440,928,86,90,176,1.55005382131324,32.62919305845646
Task_16581,1773,679,163,45,208,2.6073529411764707,36.81096721572952
Task_16582,1494,449,25,13,38,3.32,29.76317345236257
Task_16583,2579,937,74,168,242,2.7494669509594885,51.59065916343311
Task_16584,2203,121,102,145,247,18.057377049180328,42.33019894559076
Task_16585,2601,164,70,127,197,15.763636363636364,48.80869335930694
Task_16586,2022,1023,12,60,72,1.974609375,40.56290091606299
Task_16587,1936,685,134,37,171,2.8221574344023326,39.10185698091999
Task_16588,773,820,38,42,80,0.9415347137637028,20.330186203035044
Task_16589,2964,990,25,198,223,2.9909182643794145,57.732120313954844
Task_16590,1878,632,10,110,120,2.9668246445497632,38.449909366242174
Task_16591,1580,321,40,91,131,4.906832298136646,32.8052285227807
Task_16592,1174,384,99,105,204,3.0493506493506493,27.20427880953955
Task_16593,572,486,71,61,132,1.1745379876796715,17.03059250737558
Task_16594,1858,192,84,121,205,9.626943005181348,37.44093554296175
Task_16595,617,812,192,84,276,0.7589175891758918,19.703771927068896
Task_16596,1617,677,145,47,192,2.3849557522123894,34.304862844705305
Task_16597,653,691,164,171,335,0.9436416184971098,20.533937761324704
Task_16598,2690,606,134,78,212,4.43163097199341,51.610238744515065
Task_16599,1414,727,185,198,383,1.9423076923076923,33.025051863174426
Task_16600,1233,385,112,128,240,3.194300518134715,28.335256338276974
Task_16601,1169,414,186,198,384,2.816867469879518,28.16679949497396
Task_16602,1058,679,151,126,277,1.5558823529411765,26.61035384077542
Task_16603,1307,115,88,181,269,11.267241379310345,28.268040701415913
Task_16604,1527,103,177,105,282,14.682692307692308,31.439910463431175
Task_16605,1294,413,179,166,345,3.1256038647342996,29.9190253279718
Task_16606,2147,81,143,22,165,26.182926829268293,39.53233192422332
Task_16607,2616,582,168,172,340,4.487135506003431,51.37418190291703
Task_16608,2674,835,199,158,357,3.1985645933014353,53.14869288938316
Task_16609,2288,896,125,147,272,2.550724637681159,46.82423862262567
Task_16610,1895,527,124,70,194,3.5890151515151514,38.52805342708498
Task_16611,719,808,165,84,249,0.8887515451174289,21.16252740383349
Task_16612,997,874,122,83,205,1.1394285714285715,25.562418636402608
Task_16613,1154,284,16,141,157,4.049122807017544,26.052215106420828
Task_16614,967,580,170,137,307,1.6643717728055079,25.041296828454666
Task_16615,1242,911,176,63,239,1.361842105263158,29.54049269016185
Task_16616,2710,921,23,176,199,2.9392624728850327,53.398767465531925
Task_16617,1293,702,87,50,137,1.8392603129445235,28.807100655608988
Task_16618,1125,981,24,150,174,1.145621181262729,28.042677639253924
Task_16619,1126,520,185,58,243,2.161228406909789,26.46842145096686
Task_16620,2804,983,165,60,225,2.8495934959349594,54.40904020329492
Task_16621,510,967,145,195,340,0.5268595041322314,19.34968152451618
Task_16622,1008,78,52,15,67,12.759493670886076,20.30465867783711
Task_16623,2128,184,99,156,255,11.502702702702702,41.74300437201102
Task_16624,1646,638,116,22,138,2.575899843505477,34.04621746629917
Task_16625,579,130,27,150,177,4.419847328244275,16.265292583321497
Task_16626,2018,563,152,184,336,3.578014184397163,41.843687060937285
Task_16627,1534,146,38,145,183,10.435374149659864,31.4337266237786
Task_16628,655,814,43,148,191,0.803680981595092,20.185085263590466
Task_16629,1228,693,130,183,313,1.7694524495677233,29.621823658922068
Task_16630,1308,706,56,130,186,1.85007072135785,30.321631872148938
Task_16631,1119,800,155,65,220,1.3970037453183521,27.17881932734861
Task_16632,2145,437,132,136,268,4.897260273972603,43.073139919978054
Task_16633,2771,590,53,74,127,4.688663282571912,52.440070046255435
Task_16634,2570,553,77,99,176,4.6389891696750905,49.66237163158781
Task_16635,1630,897,102,14,116,1.8151447661469933,34.312625904467495
Task_16636,2172,853,77,112,189,2.5433255269320845,44.525680028979934
Task_16637,2709,700,68,112,180,3.8644793152639085,52.3535088026041
Task_16638,1609,685,49,94,143,2.3454810495626823,34.61610051734859
Task_16639,1339,325,55,17,72,4.107361963190184,26.9985291050388
Task_16640,1527,91,130,163,293,16.597826086956523,31.53912907438628
Task_16641,557,414,25,126,151,1.342168674698795,16.958511424318633
Task_16642,2426,977,109,161,270,2.4805725971370145,49.275024266582
Task_16643,959,284,192,159,351,3.364912280701754,24.221278999321367
Task_16644,1161,204,25,97,122,5.663414634146341,25.82350987849742
Task_16645,1225,849,61,183,244,1.4411764705882353,29.819900383693078
Task_16646,787,239,32,148,180,3.279166666666667,20.430501809461294
Task_16647,929,498,29,45,74,1.8617234468937875,21.35330332771751
Task_16648,2178,753,184,88,272,2.8885941644562334,44.2957863047331
Task_16649,1157,362,140,173,313,3.18732782369146,27.454041756964028
Task_16650,977,214,157,11,168,4.544186046511628,22.23454241797843
Task_16651,882,526,159,15,174,1.6736242884250474,21.853361171088736
Task_16652,1740,688,31,113,144,2.525399129172714,36.606657748399236
Task_16653,2631,341,93,55,148,7.692982456140351,49.2218942024705
Task_16654,2752,803,151,36,187,3.4228855721393034,52.623269194116006
Task_16655,2319,239,72,93,165,9.6625,44.618721352783865
Task_16656,2475,356,119,83,202,6.932773109243698,47.358180052272125
Task_16657,2888,928,57,194,251,3.108719052744887,56.56445654697856
Task_16658,1661,580,127,200,327,2.8588640275387265,36.227173195617
Task_16659,1768,625,75,174,249,2.8242811501597442,37.809823106201485
Task_16660,1739,324,23,80,103,5.350769230769231,34.90615148075195
Task_16661,953,782,71,12,83,1.2171136653895274,23.064456505151384
Task_16662,2268,922,141,171,312,2.457204767063922,46.8038811061603
Task_16663,2981,346,155,199,354,8.590778097982708,56.47635965076105
Task_16664,819,594,170,187,357,1.3764705882352941,22.984897467692264
Task_16665,1398,641,84,149,233,2.177570093457944,31.8024852426087
Task_16666,2440,617,115,133,248,3.9482200647249193,48.226638957500825
Task_16667,2935,112,138,79,217,25.97345132743363,53.04074216620585
Task_16668,2951,550,120,49,169,5.3557168784029034,54.800513869171176
Task_16669,2853,303,196,136,332,9.384868421052632,54.10967148260289
Task_16670,724,712,110,64,174,1.0154277699859748,20.235459341667905
Task_16671,2695,412,144,192,336,6.52542372881356,52.0837149845216
Task_16672,2714,399,60,132,192,6.785,51.732056095675944
Task_16673,511,732,173,28,201,0.6971350613915416,17.21064375059675
Task_16674,2489,777,108,11,119,3.1992287917737787,47.582514562819945
Task_16675,2880,506,14,71,85,5.680473372781065,53.19251358815314
Task_16676,682,165,94,67,161,4.108433734939759,17.533808426151698
Task_16677,2984,708,185,178,363,4.208744710860366,57.71602778743746
Task_16678,1849,925,132,88,220,1.9967602591792657,39.385582830666664
Task_16679,2330,387,97,114,211,6.005154639175258,45.571070474575684
Task_16680,915,531,90,195,285,1.7199248120300752,24.099988490293907
Task_16681,2693,183,130,48,178,14.63586956521739,49.468274809300034
Task_16682,2557,133,59,43,102,19.082089552238806,45.72232138391342
Task_16683,2213,398,172,21,193,5.546365914786968,42.739311771535284
Task_16684,2623,989,46,125,171,2.6494949494949496,51.77133019549879
Task_16685,2706,659,63,124,187,4.1,52.375472014886206
Task_16686,2362,919,166,134,300,2.5673913043478263,48.175697518939224
Task_16687,1608,552,25,62,87,2.907775768535262,33.00970817160718
Task_16688,1144,690,141,50,191,1.6555716353111434,26.910752061817053
Task_16689,1661,711,14,66,80,2.332865168539326,34.369111929132394
Task_16690,1535,459,54,193,247,3.3369565217391304,33.63708688853179
Task_16691,1890,1007,160,44,204,1.875,39.69802068702298
Task_16692,2030,230,172,116,288,8.787878787878787,40.611873671682325
Task_16693,2204,398,177,119,296,5.523809523809524,43.98051443233603
Task_16694,2565,197,153,167,320,12.954545454545455,49.19602170285273
Task_16695,888,206,55,157,212,4.2898550724637685,22.36983869506223
Task_16696,878,214,146,161,307,4.083720930232558,22.514417639998744
Task_16697,2111,269,111,133,244,7.818518518518519,41.85857162386548
Task_16698,1703,953,170,54,224,1.7851153039832286,36.92330026986279
Task_16699,1669,395,171,150,321,4.2146464646464645,35.66343666697282
Task_16700,2738,128,85,118,203,21.224806201550386,50.56692036928214
Task_16701,964,938,106,138,244,1.0266240681576144,25.70757546501676
Task_16702,1878,991,144,10,154,1.8931451612903225,38.80336735275372
Task_16703,1937,167,19,79,98,11.529761904761905,36.89429876024531
Task_16704,1192,540,53,172,225,2.2033271719038816,28.343869441436922
Task_16705,1587,222,188,179,367,7.116591928251121,34.034785624253196
Task_16706,2671,443,39,177,216,6.0157657657657655,51.255956056746165
Task_16707,1340,397,126,42,168,3.3668341708542715,28.719472049235105
Task_16708,970,300,126,161,287,3.222591362126246,24.161696739219753
Task_16709,1632,210,29,36,65,7.734597156398104,31.53542739565967
Task_16710,1823,312,88,149,237,5.824281150159744,37.46526012189681
Task_16711,2735,241,58,126,184,11.301652892561984,51.31605330072366
Task_16712,1672,83,96,129,225,19.904761904761905,33.39036706443044
Task_16713,1963,817,40,161,201,2.399755501222494,41.14119748099917
Task_16714,1524,220,176,196,372,6.895927601809955,33.08020997310674
Task_16715,2191,880,69,157,226,2.4869466515323495,45.16617656795099
Task_16716,1478,374,199,91,290,3.941333333333333,32.201034306492694
Task_16717,2269,720,50,151,201,3.147018030513176,45.8475220039702
Task_16718,1432,191,121,14,135,7.458333333333333,29.216382132854324
Task_16719,1248,723,160,49,209,1.723756906077348,28.74375423033128
Task_16720,908,659,36,153,189,1.3757575757575757,23.724455930543353
Task_16721,563,354,142,84,226,1.5859154929577466,17.177225563064884
Task_16722,1643,309,132,125,257,5.3,34.644329168200855
Task_16723,1245,941,78,21,99,1.321656050955414,28.346516564289246
Task_16724,502,644,132,189,321,0.7782945736434108,17.976279208292244
Task_16725,1961,225,62,197,259,8.676991150442477,39.619731436684326
Task_16726,2611,234,93,139,232,11.11063829787234,49.69715260916093
Task_16727,726,362,41,56,97,2.0,18.596494324824402
Task_16728,2530,285,67,178,245,8.846153846153847,48.73079031389741
Task_16729,914,905,124,149,273,1.0088300220750552,24.94155936478205
Task_16730,2714,159,109,82,191,16.9625,50.12704533371806
Task_16731,738,627,167,32,199,1.1751592356687899,20.302519370530028
Task_16732,526,725,56,92,148,0.7245179063360881,17.504333515643435
Task_16733,2320,959,23,135,158,2.4166666666666665,46.77846172704026
Task_16734,2944,931,148,16,164,3.1587982832618025,55.74117249314195
Task_16735,1511,805,77,143,220,1.8746898263027296,34.11532122341016
Task_16736,1826,90,33,185,218,20.065934065934066,35.9136765886367
Task_16737,620,171,161,192,353,3.604651162790698,18.200889925106164
Task_16738,1956,567,53,154,207,3.443661971830986,40.41902228465707
Task_16739,2862,150,118,11,129,18.95364238410596,51.31174964849833
Task_16740,1870,404,159,18,177,4.617283950617284,36.921671542256185
Task_16741,2368,553,43,146,189,4.274368231046932,46.622470857512816
Task_16742,933,191,69,45,114,4.859375,21.364952790953442
Task_16743,1818,949,116,17,133,1.9136842105263159,37.620743809756
Task_16744,2931,111,118,154,272,26.169642857142858,53.56883528845993
Task_16745,1362,245,121,87,208,5.536585365853658,29.455578670861687
Task_16746,1506,946,119,194,313,1.590285110876452,34.79941039945151
Task_16747,2250,733,200,176,376,3.0653950953678475,46.223300358620115
Task_16748,1092,786,23,51,74,1.3875476493011436,25.137304206705114
Task_16749,1791,165,137,29,166,10.789156626506024,34.89210798377224
Task_16750,1178,299,154,50,204,3.9266666666666667,26.27342418507405
Task_16751,2565,276,114,108,222,9.259927797833935,48.92330099874968
Task_16752,1562,660,167,152,319,2.363086232980333,34.804179552875745
Task_16753,1041,960,185,118,303,1.0832466181061395,27.216027101823673
Task_16754,2016,383,24,83,107,5.25,39.50844105057235
Task_16755,1225,233,23,150,173,5.235042735042735,27.46725615736527
Task_16756,1205,963,114,141,255,1.25,29.662793444584562
Task_16757,2576,444,156,118,274,5.78876404494382,49.918142708984796
Task_16758,2012,889,144,34,178,2.2606741573033706,40.98721500514441
Task_16759,1155,158,39,110,149,7.264150943396227,25.182126209637826
Task_16760,842,950,164,127,291,0.8853838065194533,24.05942648590796
Task_16761,541,699,88,80,168,0.7728571428571429,17.478415359774136
Task_16762,2438,668,108,81,189,3.6442451420029895,47.659272188076216
Task_16763,2794,228,56,141,197,12.200873362445416,52.456326360188115
Task_16764,1214,947,195,130,325,1.280590717299578,30.086355457001194
Task_16765,1526,346,35,129,164,4.3976945244956775,32.42084895557207
Task_16766,556,109,30,134,164,5.054545454545455,15.571822639708843
Task_16767,1822,587,103,172,275,3.098639455782313,38.52341978624363
Task_16768,2671,153,57,183,240,17.344155844155843,50.102688946910625
Task_16769,2614,153,190,178,368,16.974025974025974,49.65231825598983
Task_16770,998,942,117,23,140,1.058324496288441,24.73267335740003
Task_16771,1406,122,37,185,222,11.43089430894309,29.725174080376323
Task_16772,2459,191,116,111,227,12.807291666666666,46.94134725750439
Task_16773,1155,168,57,88,145,6.834319526627219,25.261717050432306
Task_16774,2736,686,161,110,271,3.982532751091703,53.20363109546321
Task_16775,2416,528,108,152,260,4.56710775047259,47.644411604880794
Task_16776,2179,305,21,47,68,7.120915032679738,40.55326133860453
Task_16777,2905,88,187,194,381,32.640449438202246,53.56351412356738
Task_16778,2366,286,103,103,206,8.24390243902439,45.733917957688114
Task_16779,1459,219,64,42,106,6.631818181818182,29.262517279869257
Task_16780,1791,79,149,15,164,22.3875,33.89469187975016
Task_16781,1458,873,137,165,302,1.668192219679634,33.7494696960242
Task_16782,726,381,69,129,198,1.9005235602094241,20.234563813237372
Task_16783,2742,641,116,37,153,4.271028037383178,51.545037664514325
Task_16784,2738,367,29,175,204,7.440217391304348,52.034123059700384
Task_16785,607,777,159,60,219,0.7802056555269923,18.946166528785426
Task_16786,1001,479,136,14,150,2.0854166666666667,23.2779758975324
Task_16787,1052,354,110,92,202,2.963380281690141,25.047641685247815
Task_16788,1552,494,46,77,123,3.1353535353535356,32.70833574121152
Task_16789,2574,849,195,34,229,3.028235294117647,50.17883361135517
Task_16790,2848,751,143,95,238,3.7872340425531914,54.98438270696781
Task_16791,1886,664,197,37,234,2.8360902255639098,38.73273729361771
Task_16792,1541,962,172,177,349,1.6002076843198338,35.57028667450905
Task_16793,1234,941,91,189,280,1.3099787685774946,30.349052373683932
Task_16794,716,360,17,63,80,1.9833795013850415,18.213183973986556
Task_16795,1012,118,195,166,361,8.504201680672269,24.104305385267736
Task_16796,1378,909,22,162,184,1.5142857142857142,31.831666468017108
Task_16797,797,975,53,73,126,0.8165983606557377,22.3232445274094
Task_16798,892,656,188,118,306,1.3576864535768645,24.030771686279067
Task_16799,2032,435,30,108,138,4.660550458715596,40.363676161679884
Task_16800,744,788,102,21,123,0.9429657794676806,20.284958398037325
Task_16801,1531,173,196,158,354,8.798850574712644,32.51214659919673
Task_16802,2912,713,62,149,211,4.078431372549019,55.991739381335925
Task_16803,1654,629,31,113,144,2.6253968253968254,35.05943433856845
Task_16804,1809,777,134,74,208,2.3251928020565553,38.11116824485476
Task_16805,510,176,196,76,272,2.8813559322033897,15.606279850137938
Task_16806,2400,508,11,126,137,4.715127701375246,46.44664258769862
Task_16807,1307,380,111,155,266,3.4304461942257216,29.64676930520787
Task_16808,1689,129,137,30,167,12.992307692307692,32.95336817830124
Task_16809,1509,331,54,158,212,4.545180722891566,32.60292259005562
Task_16810,1000,169,29,195,224,5.882352941176471,23.701261797405806
Task_16811,2300,952,120,12,132,2.4134312696747116,45.37431088165488
Task_16812,2228,382,20,109,129,5.8172323759791125,43.31467520097184
Task_16813,1955,302,71,56,127,6.452145214521452,38.2483571838851
Task_16814,2880,978,196,113,309,2.9417773237997955,56.57794933257372
Task_16815,611,526,161,112,273,1.159392789373814,18.977543860815683
Task_16816,2168,642,19,159,178,3.3716951788491447,43.52288393529815
Task_16817,1115,221,83,147,230,5.0225225225225225,25.96669526384987
Task_16818,1045,939,177,145,322,1.1117021276595744,27.32514617616214
Task_16819,1065,284,26,78,104,3.736842105263158,24.05025108363343
Task_16820,604,203,94,166,260,2.9607843137254903,18.031155737978555
Task_16821,2410,966,110,69,179,2.4922440537745607,47.773636449262774
Task_16822,2951,852,140,114,254,3.459554513481829,57.06212661186252
Task_16823,1960,415,11,193,204,4.711538461538462,39.87090262175554
Task_16824,1775,975,189,63,252,1.8186475409836065,38.26672867869994
Task_16825,1525,890,171,59,230,1.7115600448933783,33.861580539798005
Task_16826,1066,655,159,26,185,1.625,25.31753009400172
Task_16827,2384,657,110,31,141,3.6231003039513676,45.89006690419141
Task_16828,2569,990,105,131,236,2.5923309788092834,51.38440453161684
Task_16829,732,278,160,152,312,2.6236559139784945,20.42761095132529
Task_16830,2958,622,140,96,236,4.747993579454254,56.36161515631107
Task_16831,826,900,82,175,257,0.9167591564927858,23.59157468688657
Task_16832,2823,559,179,94,273,5.041071428571429,54.106456219397764
Task_16833,1065,679,62,187,249,1.5661764705882353,26.81603964776652
Task_16834,1539,759,16,25,41,2.025,31.698488991139353
Task_16835,2291,466,14,191,205,4.905781584582441,45.317252869100535
Task_16836,2287,758,17,190,207,3.013175230566535,46.08454089614437
Task_16837,2785,871,40,114,154,3.1938073394495414,53.70414160403367
Task_16838,2499,785,90,94,184,3.1793893129770994,49.109963798913945
Task_16839,2499,819,122,51,173,3.047560975609756,48.79430043456923
Task_16840,1812,570,76,60,136,3.1733800350262698,36.89767341690902
Task_16841,765,833,194,50,244,0.9172661870503597,21.69348680970194
Task_16842,2110,262,50,69,119,8.022813688212928,40.67013699634653
Task_16843,1458,89,98,131,229,16.2,30.109072413403357
Task_16844,2661,778,128,160,288,3.4159178433889603,52.455699209089175
Task_16845,2741,468,166,77,243,5.844349680170576,52.049990709843264
Task_16846,2414,917,17,128,145,2.6296296296296298,47.96192676963514
Task_16847,2417,782,87,43,130,3.086845466155811,46.796103336664665
Task_16848,1479,742,169,37,206,1.990578734858681,32.40358711242767
Task_16849,2044,563,27,116,143,3.624113475177305,41.02832796837148
Task_16850,1972,763,63,167,230,2.581151832460733,41.370099534722804
Task_16851,993,742,70,195,265,1.3364737550471064,25.958482673050884
Task_16852,2344,244,71,124,195,9.56734693877551,45.34311828711293
Task_16853,2772,917,165,16,181,3.019607843137255,52.94937604020553
Task_16854,1694,234,24,20,44,7.208510638297873,32.220926539127284
Task_16855,541,493,83,81,164,1.0951417004048583,16.82365898399465
Task_16856,908,864,23,150,173,1.0497109826589595,24.222064964266483
Task_16857,1515,621,158,87,245,2.4356913183279745,33.25452948100483
Task_16858,1442,360,56,102,158,3.994459833795014,30.99003231662476
Task_16859,983,263,127,173,300,3.7234848484848486,24.322418043723854
Task_16860,2074,1021,128,177,305,2.0293542074363993,44.01495343118696
Task_16861,1096,868,145,78,223,1.2612197928653626,27.19076131472363
Task_16862,1867,101,113,74,187,18.30392156862745,35.8896955773135
Task_16863,2210,1002,175,17,192,2.2033898305084745,44.485081996182906
Task_16864,1207,1011,86,75,161,1.1926877470355732,28.808204618957586
Task_16865,2929,706,181,132,313,4.142857142857143,56.54567714928415
Task_16866,2250,426,66,174,240,5.269320843091335,44.75119412516352
Task_16867,1785,547,63,60,123,3.2572992700729926,36.17011810373399
Task_16868,2817,211,89,57,146,13.287735849056604,51.54906358106271
Task_16869,939,247,108,168,276,3.786290322580645,23.458761190141104
Task_16870,1277,132,103,66,169,9.601503759398497,26.595095197088302
Task_16871,503,605,135,35,170,0.83003300330033,16.163704238623986
Task_16872,1744,119,78,140,218,14.533333333333333,35.077395417222725
Task_16873,1233,591,77,107,184,2.08277027027027,28.655228324129737
Task_16874,1484,363,189,197,386,4.076923076923077,32.99443487946899
Task_16875,594,434,58,73,131,1.3655172413793104,17.391759239252803
Task_16876,733,427,172,158,330,1.7126168224299065,20.992553600920946
Task_16877,2839,164,84,84,168,17.206060606060607,51.865410242892835
Task_16878,1848,446,187,111,298,4.134228187919463,38.5001535889167
Task_16879,2608,362,101,149,250,7.184573002754821,50.088862737032024
Task_16880,1975,599,41,107,148,3.2916666666666665,40.00926695184405
Task_16881,1284,516,93,74,167,2.483558994197292,28.725485073865997
Task_16882,1753,317,189,120,309,5.512578616352202,36.63752860698894
Task_16883,741,944,188,154,342,0.7841269841269841,22.733361939327438
Task_16884,1464,529,188,161,349,2.762264150943396,32.988866294904106
Task_16885,2847,1008,24,138,162,2.821605550049554,55.29329976865591
Task_16886,770,620,33,99,132,1.2399355877616747,20.83328339175594
Task_16887,2690,645,35,58,93,4.164086687306502,50.52815122306092
Task_16888,1297,933,88,158,246,1.3886509635974305,31.083964784710627
Task_16889,1162,176,141,38,179,6.564971751412429,24.983657761228645
Task_16890,2534,941,156,189,345,2.6900212314225054,51.25326555479895
Task_16891,1252,334,177,80,257,3.737313432835821,28.192279390949476
Task_16892,1212,910,133,59,192,1.3304061470911086,28.799994026232298
Task_16893,1614,563,175,37,212,2.8617021276595747,34.00788573614688
Task_16894,2120,575,165,100,265,3.6805555555555554,43.05384335925754
Task_16895,1273,803,42,185,227,1.5833333333333333,30.280144895280532
Task_16896,2011,567,173,185,358,3.540492957746479,41.846161509184974
Task_16897,2631,932,50,183,233,2.819935691318328,52.438122117233554
Task_16898,2705,231,162,109,271,11.65948275862069,51.190226845035944
Task_16899,1675,124,49,148,197,13.4,33.910028901058176
Task_16900,2176,351,181,34,215,6.181818181818182,42.22113368021019
Task_16901,1839,190,134,127,261,9.6282722513089,37.34788020602811
Task_16902,938,777,184,196,380,1.205655526992288,25.541268189884686
Task_16903,1124,689,164,96,260,1.6289855072463768,27.619195597116573
Task_16904,2818,198,140,145,285,14.160804020100503,53.004623961774996
Task_16905,1212,98,118,181,299,12.242424242424242,26.610576418921465
Task_16906,1777,973,97,193,290,1.824435318275154,39.13884921349307
Task_16907,2134,411,195,192,387,5.179611650485437,43.432673908719494
Task_16908,2263,273,142,144,286,8.25912408759124,44.480499290930815
Task_16909,1610,683,107,118,225,2.353801169590643,35.162968964228455
Task_16910,2240,475,14,165,179,4.705882352941177,44.205661257869075
Task_16911,2116,973,136,130,266,2.1724845995893225,44.28664270820419
Task_16912,2902,110,77,37,114,26.144144144144143,51.30118823416027
Task_16913,912,627,114,40,154,1.4522292993630572,22.48451153451572
Task_16914,2313,786,107,110,217,2.9390088945362134,46.574269976670884
Task_16915,1166,372,142,143,285,3.1260053619302948,27.458351714844884
Task_16916,1643,396,37,20,57,4.138539042821159,32.11706073301769
Task_16917,1112,84,187,182,369,13.08235294117647,25.320164995580175
Task_16918,2470,267,67,41,108,9.216417910447761,45.637754269294646
Task_16919,2641,521,159,44,203,5.059386973180077,50.0616582046037
Task_16920,1566,944,75,172,247,1.6571428571428573,35.57961030744079
Task_16921,1058,863,163,47,210,1.224537037037037,26.08939217477546
Task_16922,1039,900,100,191,291,1.1531631520532741,27.114053772096508
Task_16923,1291,193,134,141,275,6.654639175257732,28.792532910175513
Task_16924,1114,465,138,142,280,2.390557939914163,26.907080927747998
Task_16925,2733,515,197,196,393,5.296511627906977,53.28538505020157
Task_16926,891,734,125,106,231,1.2122448979591838,23.818727076822537
Task_16927,2486,404,10,15,25,6.1382716049382715,45.27718750801866
Task_16928,946,490,167,15,182,1.9266802443991853,22.69099257430189
Task_16929,2761,643,176,85,261,4.287267080745342,53.10666215669625
Task_16930,1148,195,121,40,161,5.857142857142857,24.887300456327967
Task_16931,2338,1024,78,156,234,2.2809756097560974,47.987918226353166
Task_16932,2269,100,64,145,209,22.465346534653467,42.86181662349036
Task_16933,2017,897,169,85,254,2.2461024498886415,42.08650742464741
Task_16934,930,378,183,31,214,2.453825857519789,22.589616535791475
Task_16935,2228,168,16,104,120,13.183431952662723,41.74080717754921
Task_16936,1778,558,27,108,135,3.1806797853309483,36.759744118146806
Task_16937,2525,342,36,61,97,7.3615160349854225,46.925884816589644
Task_16938,797,448,111,21,132,1.7750556792873051,20.010064538015772
Task_16939,2542,1016,196,180,376,2.4995083579154374,51.74035076183554
Task_16940,2009,452,119,177,296,4.434878587196468,41.155514090219604
Task_16941,2038,702,138,89,227,2.8990042674253202,41.781088845290945
Task_16942,1447,475,141,169,310,3.0399159663865545,32.384705842699894
Task_16943,1642,365,149,66,215,4.4863387978142075,34.07498127510919
Task_16944,2250,835,31,182,213,2.6913875598086126,45.85224890734463
Task_16945,2974,461,130,198,328,6.437229437229437,56.634252133048754
Task_16946,2790,529,77,47,124,5.264150943396227,51.805873905257435
Task_16947,2370,498,56,125,181,4.749498997995992,46.400296512831346
Task_16948,1334,192,67,34,101,6.9119170984455955,27.589222520703228
Task_16949,1110,666,98,136,234,1.6641679160419791,27.25759427638235
Task_16950,2961,143,27,27,54,20.5625,52.235126008430655
Task_16951,2099,218,143,73,216,9.584474885844749,40.86255018762821
Task_16952,2401,151,142,145,287,15.796052631578947,45.87249650899833
Task_16953,701,885,71,95,166,0.791196388261851,20.957888567634665
Task_16954,2946,460,192,61,253,6.390455531453362,55.120025578818144
Task_16955,1126,405,41,102,143,2.773399014778325,25.945601145884854
Task_16956,994,606,108,122,230,1.6375617792421746,25.180942449219696
Task_16957,1415,204,81,34,115,6.902439024390244,28.862611504606438
Task_16958,1301,573,67,72,139,2.2665505226480835,28.966144277849168
Task_16959,2967,970,148,77,225,3.055612770339856,57.141625065022644
Task_16960,1595,281,83,193,276,5.656028368794326,34.03013410276582
Task_16961,1268,845,163,84,247,1.4988179669030732,29.966537560251748
Task_16962,2189,786,143,62,205,2.781448538754765,43.992647934235386
Task_16963,1287,176,90,116,206,7.271186440677966,27.95130033333108
Task_16964,1413,720,111,53,164,1.9597780859916782,31.303988069703916
Task_16965,968,715,20,151,171,1.3519553072625698,24.60614338213779
Task_16966,1217,445,114,123,237,2.7286995515695067,28.25245797670772
Task_16967,2040,944,124,155,279,2.1587301587301586,43.087340331013614
Task_16968,1566,1023,42,173,215,1.529296875,35.53370773126791
Task_16969,1305,789,41,75,116,1.6518987341772151,29.67143292525977
Task_16970,2288,594,145,108,253,3.8453781512605043,45.73226966997151
Task_16971,604,865,23,61,84,0.6974595842956121,18.37451984312806
Task_16972,1962,238,154,161,315,8.209205020920502,39.75457581970121
Task_16973,1512,145,52,98,150,10.356164383561644,30.823904134056704
Task_16974,2425,655,173,150,323,3.6966463414634148,48.47247503630238
Task_16975,2427,827,110,144,254,2.931159420289855,48.725444392611166
Task_16976,2522,904,14,60,74,2.7867403314917127,48.17313461866376
Task_16977,2768,905,94,97,191,3.055187637969095,54.13713389581259
Task_16978,2824,294,115,104,219,9.572881355932203,53.06280471686055
Task_16979,1969,630,115,189,304,3.1204437400950873,41.14277286159666
Task_16980,2036,671,100,176,276,3.0297619047619047,42.18784457427224
Task_16981,2235,579,177,95,272,3.853448275862069,44.88372648901136
Task_16982,578,118,142,134,276,4.857142857142857,16.847274123302185
Task_16983,995,348,16,153,169,2.8510028653295127,23.946864819595657
Task_16984,2319,598,142,63,205,3.8714524207011687,45.49248576768315
Task_16985,1800,587,122,182,304,3.061224489795918,38.32039179654519
Task_16986,1815,803,191,23,214,2.2574626865671643,37.87490429622632
Task_16987,1004,123,147,172,319,8.096774193548388,23.837799194172806
Task_16988,1442,257,146,72,218,5.589147286821706,30.621966457118003
Task_16989,1920,170,190,186,376,11.228070175438596,38.79425824827222
Task_16990,705,417,143,169,312,1.686602870813397,20.453048903765154
Task_16991,780,526,115,72,187,1.4800759013282732,20.808186516080468
Task_16992,1199,809,151,196,347,1.480246913580247,29.66610949043341
Task_16993,2246,216,60,100,160,10.350230414746544,43.17308870134992
Task_16994,2570,78,51,84,135,32.53164556962025,46.51814210940415
Task_16995,1437,575,142,180,322,2.4947916666666665,32.61241388808674
Task_16996,2612,829,159,92,251,3.146987951807229,51.472352800550944
Task_16997,1929,970,33,26,59,1.9866117404737385,38.68474691513772
Task_16998,573,823,185,167,352,0.6953883495145631,19.86355935457179
Task_16999,2409,418,115,19,134,5.749403341288783,45.299544931932445
Task_17000,2097,406,53,117,170,5.152334152334152,41.724433005585595
Task_17001,1269,143,148,68,216,8.8125,27.177111978613638
Task_17002,1699,722,197,91,288,2.3499308437067774,36.792999615895866
Task_17003,716,1011,56,111,167,0.7075098814229249,21.658616301077757
Task_17004,2132,256,13,91,104,8.295719844357977,40.99208361672436
Task_17005,2602,185,181,142,323,13.989247311827956,49.51015291602098
Task_17006,1500,609,22,194,216,2.459016393442623,33.22912520930817
Task_17007,2042,928,65,114,179,2.1980624327233587,42.50200862408446
Task_17008,1514,559,160,161,321,2.7035714285714287,33.74899413684852
Task_17009,2123,392,140,115,255,5.402035623409669,42.48844122378281
Task_17010,840,212,158,74,232,3.943661971830986,21.085209513292302
Task_17011,875,753,70,145,215,1.160477453580902,23.77139500672081
Task_17012,1582,156,80,146,226,10.07643312101911,32.86725141050175
Task_17013,505,67,200,129,329,7.426470588235294,15.481116497286402
Task_17014,1599,502,171,198,369,3.1789264413518885,35.18512326736726
Task_17015,799,124,104,31,135,6.392,18.647122344221042
Task_17016,956,1018,113,191,304,0.9381746810598626,26.233512174150064
Task_17017,1529,490,157,154,311,3.114052953156823,33.71293600776642
Task_17018,2062,636,88,79,167,3.2370486656200943,41.41749505422124
Task_17019,2159,566,79,130,209,3.8077601410934743,43.5651048971063
Task_17020,2697,441,119,165,284,6.101809954751131,51.937350983962084
Task_17021,1577,690,120,28,148,2.2821997105643996,33.21625684191515
Task_17022,1474,956,146,152,298,1.5402298850574712,34.19417037992314
Task_17023,699,322,174,157,331,2.1640866873065017,20.139658010781638
Task_17024,1437,83,74,83,157,17.107142857142858,28.838383471155964
Task_17025,1706,935,174,172,346,1.8226495726495726,38.09368066389589
Task_17026,1966,886,128,140,268,2.216459977452086,41.662644900307434
Task_17027,1903,187,176,189,365,10.122340425531915,39.00374884730696
Task_17028,1845,874,188,72,260,2.1085714285714285,39.15630305462032
Task_17029,2653,840,68,154,222,3.154577883472057,52.339544120475075
Task_17030,2351,691,144,168,312,3.397398843930636,47.39086544895537
Task_17031,2106,368,185,57,242,5.7073170731707314,41.496675610310234
Task_17032,1048,289,118,28,146,3.613793103448276,23.611278709860425
Task_17033,2003,948,45,173,218,2.110642781875659,42.26508848820123
Task_17034,1979,786,107,164,271,2.5146124523506987,41.605326082644204
Task_17035,1159,523,25,53,78,2.2118320610687023,25.439622980782598
Task_17036,1311,880,121,67,188,1.4880817253121452,30.292126122256192
Task_17037,1348,754,60,58,118,1.7854304635761589,29.81541482858957
Task_17038,1655,693,17,161,178,2.384726224783862,35.517924935178335
Task_17039,2668,169,66,199,265,15.694117647058823,50.29533639100398
Task_17040,608,483,147,165,312,1.256198347107438,19.008497111149406
Task_17041,2682,623,153,132,285,4.298076923076923,52.24366968186007
Task_17042,2330,320,183,60,243,7.258566978193146,44.86278362306323
Task_17043,1594,845,65,37,102,1.884160756501182,33.52448460343496
Task_17044,2417,333,85,101,186,7.236526946107785,46.52355521418733
Task_17045,1855,844,169,142,311,2.195266272189349,39.96977832064655
Task_17046,1026,370,168,59,227,2.765498652291105,24.326720948996883
Task_17047,2772,633,70,26,96,4.37223974763407,51.607352606065255
Task_17048,2349,230,25,131,156,10.168831168831169,44.811956716503495
Task_17049,827,398,141,76,217,2.072681704260652,21.411292047424343
Task_17050,2237,73,66,21,87,30.22972972972973,39.70726096668297
Task_17051,2612,230,128,103,231,11.307359307359308,49.52837955803515
Task_17052,2937,472,25,72,97,6.209302325581396,54.07809335697732
Task_17053,1581,832,122,148,270,1.8979591836734695,35.41516013481137
Task_17054,1771,565,89,39,128,3.128975265017668,35.95416196912378
Task_17055,2503,786,81,116,197,3.1804320203303686,49.60673055144063
Task_17056,1703,387,57,58,115,4.389175257731959,34.34522516274054
Task_17057,865,800,60,170,230,1.079900124843945,23.758536956531785
Task_17058,1254,611,37,65,102,2.049019607843137,27.89722990778041
Task_17059,1262,607,123,129,252,2.075657894736842,29.551186189837868
Task_17060,1346,443,104,120,224,3.0315315315315314,30.22484721833283
Task_17061,1194,371,113,116,229,3.2096774193548385,27.606141532376313
Task_17062,2769,260,72,46,118,10.60919540229885,50.479201204202845
Task_17063,2589,69,15,166,181,36.98571428571429,47.331179265701316
Task_17064,2134,360,148,14,162,5.911357340720222,40.92202508029715
Task_17065,2239,94,87,179,266,23.568421052631578,42.47004670328777
Task_17066,1848,192,152,97,249,9.575129533678757,37.43443017613851
Task_17067,2376,981,27,83,110,2.419551934826884,47.1669705078884
Task_17068,2875,441,187,178,365,6.504524886877828,55.13871296621253
Task_17069,536,71,117,200,317,7.444444444444445,16.020115598958586
Task_17070,807,298,126,169,295,2.698996655518395,21.625941476799255
Task_17071,1870,334,124,191,315,5.582089552238806,38.675782109780876
Task_17072,536,75,31,139,170,7.052631578947368,15.180834365568472
Task_17073,1686,869,169,140,309,1.9379310344827587,37.35796133660318
Task_17074,628,651,34,197,231,0.9631901840490797,19.489188610668265
Task_17075,1477,92,97,43,140,15.881720430107526,28.8293733014067
Task_17076,2383,317,111,33,144,7.4937106918239,44.803642334330426
Task_17077,2910,390,114,18,132,7.442455242966752,53.106128950298846
Task_17078,865,1022,152,49,201,0.8455522971652004,23.61579932907809
Task_17079,1266,679,141,35,176,1.861764705882353,28.522361721917132
Task_17080,711,549,198,114,312,1.2927272727272727,20.801121158354878
Task_17081,2672,954,145,81,226,2.7979057591623038,52.46280875662978
Task_17082,801,837,17,187,204,0.9558472553699284,22.604898593580078
Task_17083,2931,875,101,175,276,3.345890410958904,57.005971001766966
Task_17084,1550,450,170,115,285,3.436807095343681,33.743601491681126
Task_17085,2753,972,180,69,249,2.829393627954779,53.74151849368683
Task_17086,1336,944,62,11,73,1.4137566137566138,28.952831678481378
Task_17087,1746,840,121,171,292,2.0760998810939357,38.187187418056446
Task_17088,2400,847,131,128,259,2.830188679245283,48.3593289060409
Task_17089,1932,970,112,154,266,1.9897013388259526,41.3967257102464
Task_17090,797,84,40,58,98,9.376470588235295,18.0562561621586
Task_17091,847,935,14,16,30,0.9049145299145299,21.3038094075307
Task_17092,2886,389,159,161,320,7.4,54.911443786325606
Task_17093,1696,207,171,71,242,8.153846153846153,34.54385358464162
Task_17094,1693,859,71,61,132,1.9686046511627906,35.915712493922136
Task_17095,1293,526,163,162,325,2.4535104364326377,30.165263420320812
Task_17096,889,428,128,161,289,2.0722610722610724,23.297593238728812
Task_17097,643,260,84,165,249,2.4636015325670497,18.74541602288029
Task_17098,1586,184,121,32,153,8.572972972972973,31.803603653013592
Task_17099,2762,885,75,43,118,3.1173814898419865,52.443533041045946
Task_17100,549,726,148,141,289,0.7551581843191196,18.72310356998784
Task_17101,2977,900,143,193,336,3.304106548279689,58.11001240580888
Task_17102,2590,239,132,180,312,10.791666666666666,49.69314340830177
Task_17103,890,532,58,170,228,1.6697936210131332,23.5190200625152
Task_17104,2179,158,182,126,308,13.70440251572327,42.50580821902034
Task_17105,2748,327,96,84,180,8.378048780487806,51.342979889720745
Task_17106,2695,470,101,174,275,5.721868365180467,51.97342450836802
Task_17107,1034,953,57,72,129,1.0838574423480083,25.95526146307493
Task_17108,2995,533,42,146,188,5.608614232209738,56.47096522069023
Task_17109,1768,186,47,146,193,9.454545454545455,36.1201280727116
Task_17110,911,251,27,62,89,3.615079365079365,21.061369586930436
Task_17111,2000,587,18,175,193,3.401360544217687,40.95114987587619
Task_17112,1216,607,50,93,143,2.0,28.157652162605867
Task_17113,2863,399,100,14,114,7.1575,52.27067180971222
Task_17114,1925,315,141,140,281,6.091772151898734,39.25377553196223
Task_17115,2026,440,12,41,53,4.594104308390023,38.645894333699545
Task_17116,2419,127,44,20,64,18.8984375,43.17759942207669
Task_17117,1342,939,74,191,265,1.4276595744680851,32.063052930698724
Task_17118,2269,164,109,180,289,13.751515151515152,43.93052448939999
Task_17119,547,371,89,179,268,1.4704301075268817,17.621860679977676
Task_17120,702,832,14,114,128,0.8427370948379351,20.635605731914595
Task_17121,1371,753,178,65,243,1.8183023872679045,31.158883845020657
Task_17122,1227,938,25,123,148,1.3067092651757188,29.173469259038693
Task_17123,530,293,159,45,204,1.8027210884353742,15.901064248817447
Task_17124,1045,198,29,171,200,5.251256281407035,24.718699464082082
Task_17125,2659,387,84,39,123,6.853092783505154,49.19223895334213
Task_17126,917,706,141,32,173,1.297029702970297,23.131362828786738
Task_17127,2414,269,48,121,169,8.940740740740742,46.226830763091044
Task_17128,2951,352,77,33,110,8.359773371104815,53.60861532723808
Task_17129,1598,416,181,25,206,3.8321342925659474,33.17832873136867
Task_17130,1308,949,42,141,183,1.3768421052631579,30.75963326905091
Task_17131,1941,98,197,39,236,19.606060606060606,36.81612953924748
Task_17132,1699,917,149,113,262,1.8507625272331154,37.46175921696106
Task_17133,2298,99,174,166,340,22.98,43.89063731571763
Task_17134,2133,394,104,183,287,5.4,42.897159095974814
Task_17135,2920,96,102,26,128,30.103092783505154,51.62381321886468
Task_17136,2337,350,193,59,252,6.6581196581196584,45.11269583168678
Task_17137,1637,753,109,158,267,2.1710875331564985,36.057353642753164
Task_17138,2403,769,160,119,279,3.120779220779221,48.239406442726796
Task_17139,2191,578,64,105,169,3.784110535405872,43.70214126666074
Task_17140,2729,777,146,62,208,3.507712082262211,52.53295257751523
Task_17141,1284,388,102,175,277,3.3007712082262213,29.387466388883386
Task_17142,2029,447,159,108,267,4.529017857142857,41.224058256990716
Task_17143,2836,186,107,188,295,15.165775401069519,53.450817220005014
Task_17144,786,208,34,124,158,3.7607655502392343,20.034232695973106
Task_17145,802,347,138,135,273,2.3045977011494254,21.554537474896136
Task_17146,1242,249,173,63,236,4.968,27.457408139176128
Task_17147,2936,365,62,83,145,8.021857923497267,54.37767552570947
Task_17148,2211,119,33,107,140,18.425,41.38985831896317
Task_17149,2292,936,199,52,251,2.4461045891141944,46.366223864908044
Task_17150,2304,821,195,64,259,2.802919708029197,46.207944479258515
Task_17151,869,295,150,83,233,2.935810810810811,21.89761577452316
Task_17152,1350,469,44,91,135,2.872340425531915,29.61354202692627
Task_17153,705,552,86,18,104,1.274864376130199,18.403514712779977
Task_17154,1723,198,110,86,196,8.658291457286433,34.978869978911455
Task_17155,1994,350,53,127,180,5.680911680911681,39.97619542446093
Task_17156,1508,695,51,99,150,2.1666666666666665,33.05934995045374
Task_17157,2735,615,167,119,286,4.439935064935065,53.043010038595526
Task_17158,2445,873,184,122,306,2.7974828375286043,49.356666610716424
Task_17159,2682,963,18,25,43,2.7821576763485476,50.41960749239306
Task_17160,2336,403,120,109,229,5.782178217821782,45.76907718944292
Task_17161,970,430,115,180,295,2.2505800464037122,24.640715580082524
Task_17162,1755,320,123,19,142,5.4672897196261685,34.61065651106851
Task_17163,1547,494,139,83,222,3.125252525252525,33.212026237761535
Task_17164,606,467,143,158,301,1.294871794871795,18.898232562130733
Task_17165,1207,108,89,163,252,11.073394495412844,26.366663233999944
Task_17166,1851,961,88,42,130,1.9241164241164241,38.396213872713794
Task_17167,1385,939,182,178,360,1.4734042553191489,33.03758821088119
Task_17168,2008,381,114,21,135,5.2565445026178015,38.95646205281106
Task_17169,2066,813,33,27,60,2.538083538083538,40.369360982075285
Task_17170,1310,302,101,147,248,4.323432343234323,29.347559752497943
Task_17171,1581,752,80,186,266,2.099601593625498,35.33091724420545
Task_17172,2793,97,74,23,97,28.5,49.16511296595785
Task_17173,2347,639,112,34,146,3.6671875,45.33269235837967
Task_17174,1928,143,155,44,199,13.38888888888889,37.22967553477912
Task_17175,2067,478,194,190,384,4.315240083507307,42.5730783569375
Task_17176,1357,193,14,63,77,6.994845360824742,27.752986848206234
Task_17177,2773,830,182,86,268,3.3369434416365826,53.93079591545171
Task_17178,1657,630,188,110,298,2.6259904912836767,36.05852446951641
Task_17179,1085,428,59,191,250,2.5291375291375293,26.422359739559983
Task_17180,1145,181,16,144,160,6.291208791208791,25.06181540356509
Task_17181,2532,854,144,47,191,2.9614035087719297,49.35006823554722
Task_17182,599,786,59,91,150,0.761118170266836,18.714599964120172
Task_17183,2796,806,117,60,177,3.4646840148698885,53.32036201519612
Task_17184,2430,371,70,103,173,6.532258064516129,46.95707220447315
Task_17185,2278,540,23,37,60,4.210720887245841,42.92737356564646
Task_17186,793,733,133,200,333,1.0803814713896458,22.839396972142122
Task_17187,2020,738,89,190,279,2.733423545331529,42.21860553202449
Task_17188,1838,186,100,17,117,9.828877005347593,35.41616277125782
Task_17189,1498,647,187,88,275,2.3117283950617282,33.205708893135146
Task_17190,1767,730,165,127,292,2.417236662106703,38.11213737701344
Task_17191,2146,116,82,40,122,18.34188034188034,39.57899432612125
Task_17192,2230,128,73,56,129,17.286821705426355,41.45876687907252
Task_17193,1907,493,148,197,345,3.860323886639676,39.92281443418308
Task_17194,2560,112,147,17,164,22.654867256637168,46.32113663977063
Task_17195,1010,743,140,147,287,1.35752688172043,26.127020828086682
Task_17196,1752,472,183,177,360,3.704016913319239,37.440249639792675
Task_17197,2297,742,176,17,193,3.091520861372813,45.05605433094115
Task_17198,2214,693,130,123,253,3.190201729106628,44.89519637063048
Task_17199,727,417,121,97,218,1.7392344497607655,20.30559783895163
Task_17200,2184,347,55,160,215,6.275862068965517,43.34827780221409
Task_17201,1464,254,14,159,173,5.741176470588235,31.274507380668283
Task_17202,1947,750,38,10,48,2.59254327563249,37.96920288872608
Task_17203,1328,108,135,10,145,12.18348623853211,26.76752638129663
Task_17204,2921,994,130,97,227,2.935678391959799,56.91819767898133
Task_17205,2166,987,193,41,234,2.1923076923076925,44.15762479917536
Task_17206,955,197,182,18,200,4.8232323232323235,22.126568479427743
Task_17207,1699,868,142,164,306,1.95512082853855,37.58249166153872
Task_17208,678,676,95,62,157,1.0014771048744462,19.117799372585644
Task_17209,2727,317,108,163,271,8.575471698113208,51.93141002804748
Task_17210,1614,222,146,126,272,7.237668161434978,33.955310228864604
Task_17211,2597,514,113,19,132,5.042718446601942,48.594910027553425
Task_17212,1286,367,78,187,265,3.494565217391304,29.445776489981373
Task_17213,1753,445,187,186,373,3.930493273542601,37.44129489237357
Task_17214,1011,768,29,129,158,1.3146944083224967,25.275347423870034
Task_17215,2818,479,142,17,159,5.870833333333334,52.01932624581386
Task_17216,1152,595,40,118,158,1.9328859060402686,27.031111845543506
Task_17217,2552,458,57,135,192,5.559912854030501,49.398113429370625
Task_17218,2063,80,26,120,146,25.469135802469136,38.69177734012151
Task_17219,762,242,113,31,144,3.1358024691358026,18.925782080915777
Task_17220,2255,691,67,145,212,3.258670520231214,45.50801851733282
Task_17221,2733,306,117,187,304,8.90228013029316,52.17152620374795
Task_17222,1149,440,46,107,153,2.6054421768707483,26.44164442865259
Task_17223,2462,159,88,200,288,15.3875,47.018579361166104
Task_17224,760,733,142,17,159,1.0354223433242506,20.184261002837612
Task_17225,608,807,161,111,272,0.7524752475247525,19.78756239596787
Task_17226,540,824,64,194,258,0.6545454545454545,19.079088578053643
Task_17227,828,964,128,46,174,0.8580310880829015,22.563991067279236
Task_17228,598,75,15,128,143,7.868421052631579,15.668102608043407
Task_17229,1303,161,43,183,226,8.04320987654321,28.441844138938887
Task_17230,2538,399,158,55,213,6.345,48.37503559706071
Task_17231,2179,999,190,149,339,2.179,45.72272398952109
Task_17232,2117,535,171,126,297,3.949626865671642,43.061340790931105
Task_17233,1764,565,160,145,305,3.11660777385159,37.63106929472769
Task_17234,1097,830,45,136,181,1.3200962695547533,27.054365856776656
Task_17235,2324,440,47,82,129,5.26984126984127,44.947966555481486
Task_17236,2147,863,37,69,106,2.4849537037037037,42.866955607012976
Task_17237,2547,457,43,146,189,5.56113537117904,49.14640590844376
Task_17238,2865,569,20,97,117,5.026315789473684,53.841277539309175
Task_17239,725,463,82,153,235,1.5625,20.6048801348199
Task_17240,581,540,36,183,219,1.0739371534195934,18.258595339810018
Task_17241,564,894,108,195,303,0.6301675977653631,19.776837954649338
Task_17242,874,548,84,148,232,1.5919854280510017,23.194197851006624
Task_17243,2546,417,60,27,87,6.090909090909091,46.98022098183228
Task_17244,2312,696,128,39,167,3.317073170731707,45.055759325426344
Task_17245,686,137,131,27,158,4.971014492753623,17.0117679765488
Task_17246,2884,242,118,150,268,11.868312757201647,54.10678555739346
Task_17247,2112,502,57,147,204,4.198807157057654,42.646918279248126
Task_17248,2131,422,148,121,269,5.037825059101655,42.785235064691356
Task_17249,2871,647,144,93,237,4.430555555555555,54.9746128699584
Task_17250,2546,522,28,169,197,4.868068833652008,49.465315448337215
Task_17251,2545,439,79,109,188,5.784090909090909,49.1037000183559
Task_17252,1422,238,94,46,140,5.949790794979079,29.381923874884688
Task_17253,2716,664,30,195,225,4.08421052631579,52.775351018729275
Task_17254,2912,999,183,103,286,2.912,57.03228946032294
Task_17255,2661,932,186,156,342,2.852090032154341,53.175711183806605
Task_17256,1783,803,42,158,200,2.2176616915422884,38.238023066771504
Task_17257,2114,584,146,60,206,3.6136752136752137,42.13896498030589
Task_17258,2980,234,197,56,253,12.680851063829786,54.96092781651094
Task_17259,854,441,172,153,325,1.9321266968325792,22.935110409126192
Task_17260,1869,674,107,196,303,2.7688888888888887,39.70310400121726
Task_17261,2902,112,58,42,100,25.68141592920354,50.872215737992406
Task_17262,1759,474,93,169,262,3.703157894736842,37.215991105873535
Task_17263,2056,299,164,184,348,6.8533333333333335,41.63707432492394
Task_17264,2605,285,159,147,306,9.108391608391608,50.02364030535083
Task_17265,2677,551,123,66,189,4.84963768115942,50.91009032962106
Task_17266,577,338,46,149,195,1.7020648967551621,17.657071588695104
Task_17267,2506,255,105,126,231,9.7890625,47.98143211089433
Task_17268,2082,204,134,153,287,10.15609756097561,41.38496573745907
Task_17269,675,478,18,99,117,1.4091858037578289,18.711836445836337
Task_17270,604,311,62,174,236,1.935897435897436,18.327194052296388
Task_17271,911,1016,102,13,115,0.895771878072763,23.3998153312932
Task_17272,2764,520,146,180,326,5.305182341650672,53.46694379847562
Task_17273,2906,491,191,166,357,5.90650406504065,55.73999883818643
Task_17274,1308,217,190,125,315,6.0,29.29774924657843
Task_17275,761,66,69,151,220,11.35820895522388,19.111904177511303
Task_17276,2313,603,39,120,159,3.8294701986754967,45.44464902116969
Task_17277,1893,668,35,20,55,2.8295964125560538,36.98196924046679
Task_17278,1816,1016,87,109,196,1.7856440511307767,39.32839041796651
Task_17279,2322,96,72,168,240,23.938144329896907,43.78829822387178
Task_17280,670,316,63,172,235,2.1135646687697163,19.379278035301706
Task_17281,2760,502,111,113,224,5.487077534791252,52.78733504639589
Task_17282,926,421,163,165,328,2.1943127962085307,24.042705323840266
Task_17283,1621,748,145,185,330,2.164218958611482,36.11180472202231
Task_17284,2226,593,53,98,151,3.7474747474747474,44.120766156607345
Task_17285,987,640,29,193,222,1.5397815912636506,25.259293643087876
Task_17286,2702,965,114,170,284,2.7971014492753623,53.687552633942154
Task_17287,2437,338,23,115,138,7.188790560471976,46.515452956102315
Task_17288,661,607,129,24,153,1.087171052631579,18.368848188663282
Task_17289,1078,834,29,30,59,1.2910179640718562,24.768284430123696
Task_17290,901,807,73,138,211,1.11509900990099,24.231909215539066
Task_17291,1082,359,192,20,212,3.0055555555555555,24.724997775288283
Task_17292,2832,564,107,80,187,5.012389380530974,53.57902086879621
Task_17293,1483,343,51,152,203,4.311046511627907,32.218546551462445
Task_17294,1717,940,194,151,345,1.8246546227417642,38.2482258223702
Task_17295,2531,694,194,42,236,3.641726618705036,49.02809088575979
Task_17296,1777,324,156,47,203,5.467692307692308,35.75831981687469
Task_17297,2478,403,167,18,185,6.133663366336633,46.62330340806502
Task_17298,516,137,87,14,101,3.739130434782609,13.885176887958549
Task_17299,2648,874,53,188,241,3.0262857142857142,52.5498710018392
Task_17300,2708,203,50,27,77,13.27450980392157,48.50696141187171
Task_17301,2401,303,151,52,203,7.8980263157894735,45.84633937815001
Task_17302,2102,323,29,159,188,6.487654320987654,41.692204832056525
Task_17303,2583,210,122,111,233,12.24170616113744,49.01288093366863
Task_17304,2075,148,190,83,273,13.926174496644295,40.350511017891144
Task_17305,1384,92,118,174,292,14.881720430107526,29.302678648223374
Task_17306,2666,406,168,33,201,6.5503685503685505,50.09267345191693
Task_17307,2591,543,47,184,231,4.762867647058823,50.430025285102
Task_17308,1053,471,177,199,376,2.2309322033898304,26.476652271020797
Task_17309,541,805,86,45,131,0.6712158808933002,17.501392725330994
Task_17310,2960,641,181,197,378,4.610591900311526,57.21839837735448
Task_17311,1343,956,105,110,215,1.4033437826541275,31.65699629352193
Task_17312,1043,785,134,18,152,1.326972010178117,24.79908853211802
Task_17313,695,626,148,148,296,1.1084529505582137,20.697830327335996
Task_17314,850,613,119,155,274,1.3843648208469055,23.1139570662168
Task_17315,2973,574,59,137,196,5.170434782608695,56.45616094515907
Task_17316,2558,728,39,197,236,3.5089163237311385,50.49888985795798
Task_17317,1147,213,134,185,319,5.359813084112149,26.84760281071063
Task_17318,2789,977,182,160,342,2.8517382413087935,55.350409675561366
Task_17319,2932,278,198,36,234,10.508960573476703,54.0046924146264
Task_17320,2549,588,148,81,229,4.3276740237691005,49.37551480191427
Task_17321,2558,481,153,24,177,5.3070539419087135,48.26698391008993
Task_17322,2360,816,114,90,204,2.8886168910648715,47.16016826983154
Task_17323,2417,507,29,54,83,4.7578740157480315,45.63206836455273
Task_17324,1577,797,34,157,191,1.9761904761904763,34.92783607932915
Task_17325,1933,366,115,197,312,5.267029972752043,39.77378530005549
Task_17326,2942,467,67,158,225,6.286324786324786,55.74682546567331
Task_17327,2413,317,31,177,208,7.588050314465409,46.73784565168708
Task_17328,869,298,126,190,316,2.9063545150501673,22.73160087025791
Task_17329,1292,752,30,114,144,1.7158034528552457,29.703707485555157
Task_17330,2642,538,36,90,126,4.901669758812616,50.30467106759426
Task_17331,2133,936,199,176,375,2.2764140875133405,44.999584076156246
Task_17332,642,845,146,81,227,0.7588652482269503,19.96214615477433
Task_17333,510,493,42,29,71,1.0323886639676114,14.835055124555529
Task_17334,1032,834,119,23,142,1.2359281437125749,24.938091012987897
Task_17335,2891,539,18,79,97,5.353703703703704,53.623160045354815
Task_17336,2293,457,175,149,324,5.006550218340611,45.75207058199704
Task_17337,928,819,74,138,212,1.1317073170731706,24.775937422367864
Task_17338,869,844,96,168,264,1.0284023668639053,24.09478552565602
Task_17339,2196,584,38,121,159,3.753846153846154,43.53292799240874
Task_17340,769,121,35,72,107,6.30327868852459,18.174707935682104
Task_17341,2683,452,191,179,370,5.922737306843267,52.16005167306963
Task_17342,1790,944,105,164,269,1.8941798941798942,39.09393490235281
Task_17343,1600,162,39,149,188,9.815950920245399,32.85593314673775
Task_17344,2274,127,157,128,285,17.765625,43.61372135166069
Task_17345,2390,545,183,31,214,4.377289377289378,46.232577393798714
Task_17346,1699,920,80,89,169,1.8447339847991313,36.76133889138602
Task_17347,584,493,19,128,147,1.1821862348178138,17.554461777394298
Task_17348,1090,545,117,171,288,1.9963369963369964,26.85718349184874
Task_17349,1622,542,198,125,323,2.987108655616943,35.361668795594
Task_17350,2834,593,122,52,174,4.771043771043771,53.454115804473936
Task_17351,2515,739,133,74,207,3.3986486486486487,49.172010864482814
Task_17352,665,177,10,97,107,3.735955056179775,17.047431293494476
Task_17353,2792,856,169,135,304,3.2578763127187864,54.811560086466805
Task_17354,710,732,167,46,213,0.9686221009549796,20.275060525482463
Task_17355,2466,727,191,146,337,3.3873626373626373,49.40638478261756
Task_17356,2803,681,135,112,247,4.109970674486804,54.14381541534592
Task_17357,2918,650,156,198,354,4.482334869431644,56.47515649013629
Task_17358,2924,846,156,137,293,3.4521841794569066,56.82498646799238
Task_17359,2935,966,133,150,283,3.035160289555326,57.349080845614196
Task_17360,2512,515,145,13,158,4.868217054263566,47.37391199331895
Task_17361,1864,594,196,81,277,3.1327731092436975,38.7631207643526
Task_17362,1056,271,78,108,186,3.8823529411764706,24.894189213917155
Task_17363,2237,1012,92,35,127,2.2082922013820334,44.701838839483024
Task_17364,2437,478,57,52,109,5.087682672233821,46.14663596922315
Task_17365,519,98,105,80,185,5.242424242424242,14.644481434686563
Task_17366,2619,689,41,124,165,3.7956521739130435,50.83933760431851
Task_17367,1608,74,142,94,236,21.44,32.3329000509256
Task_17368,1903,766,86,72,158,2.48109517601043,39.0287396317194
Task_17369,528,359,179,73,252,1.4666666666666666,16.637983949156048
Task_17370,1285,755,158,75,233,1.6997354497354498,29.83935396719109
Task_17371,822,901,172,77,249,0.9113082039911308,23.069856181847275
Task_17372,1941,239,121,128,249,8.0875,39.08060817514544
Task_17373,1040,821,77,62,139,1.2652068126520681,25.442451062950244
Task_17374,2388,325,146,118,264,7.325153374233129,46.50070449709536
Task_17375,828,977,181,186,367,0.8466257668711656,24.341599961558995
Task_17376,1414,765,127,45,172,1.845953002610966,31.153554823624148
Task_17377,1571,1013,114,88,202,1.54930966469428,35.13364010908855
Task_17378,1865,457,32,25,57,4.072052401746725,36.09514943029818
Task_17379,720,297,79,84,163,2.4161073825503356,19.24401168925182
Task_17380,565,650,144,70,214,0.8678955453149002,17.977747365221543
Task_17381,1454,78,128,111,239,18.40506329113924,29.912176953273473
Task_17382,680,518,160,137,297,1.3102119460500963,20.21933741053098
Task_17383,2556,981,111,20,131,2.6028513238289204,49.44847185907097
Task_17384,2089,392,134,170,304,5.315521628498728,42.25193977552631
Task_17385,2474,104,52,163,215,23.561904761904763,46.18762585611034
Task_17386,2898,599,11,194,205,4.83,55.32017063311765
Task_17387,1312,287,167,117,284,4.555555555555555,29.447776563066853
Task_17388,1088,383,68,124,192,2.8333333333333335,25.934701289101316
Task_17389,2663,710,55,28,83,3.7454289732770745,49.84843357875476
Task_17390,1908,296,10,173,183,6.424242424242424,38.350426384441185
Task_17391,1033,1019,104,142,246,1.0127450980392156,27.047814948014153
Task_17392,1503,812,111,160,271,1.848708487084871,34.13922850598811
Task_17393,2852,937,149,70,219,3.0405117270788913,55.09293328463607
Task_17394,521,793,50,71,121,0.6561712846347607,17.314821267702342
Task_17395,1915,353,150,84,234,5.409604519774011,38.63512039020653
Task_17396,2847,918,21,96,117,3.0979325353645266,54.657969550285344
Task_17397,1444,246,77,89,166,5.846153846153846,30.619034585969825
Task_17398,1890,430,140,144,284,4.385150812064965,39.09850814176584
Task_17399,1908,596,87,173,260,3.1959798994974875,39.85614808678628
Task_17400,2390,423,33,140,173,5.636792452830188,46.46240718418337
Task_17401,1534,401,140,59,199,3.81592039800995,32.33761141991983
Task_17402,2007,286,176,53,229,6.993031358885017,39.68181674065756
Task_17403,2591,309,156,59,215,8.358064516129032,48.82222087491908
Task_17404,1575,762,144,144,288,2.0642201834862384,35.17734906130057
Task_17405,787,704,51,178,229,1.1163120567375886,22.27842130610324
Task_17406,726,946,68,132,200,0.7666314677930306,21.912676100406102
Task_17407,2858,153,90,151,241,18.558441558441558,52.93699636987654
Task_17408,1833,266,36,82,118,6.865168539325842,36.4176965474824
Task_17409,766,823,122,93,215,0.9296116504854369,22.009931595803067
Task_17410,2049,232,130,102,232,8.793991416309012,40.646402658464865
Task_17411,2716,647,35,54,89,4.191358024691358,50.861282261430254
Task_17412,1073,675,133,161,294,1.5872781065088757,26.96342596065483
Task_17413,1084,772,78,26,104,1.4023285899094438,25.30837423046555
Task_17414,626,877,79,121,200,0.7129840546697038,20.232846375532592
Task_17415,719,503,16,39,55,1.4265873015873016,18.071257746191666
Task_17416,1025,939,52,47,99,1.0904255319148937,24.713064512995132
Task_17417,2550,938,116,151,267,2.7156549520766773,51.09018467538832
Task_17418,2737,545,118,88,206,5.012820512820513,52.192474460021565
Task_17419,2307,243,121,169,290,9.454918032786885,45.12204674901698
Task_17420,1690,750,30,174,204,2.2503328894806924,36.66807523720455
Task_17421,2234,290,199,94,293,7.676975945017182,43.98463191727679
Task_17422,1164,768,134,124,258,1.5136540962288687,28.477620080977427
Task_17423,2625,247,178,167,345,10.584677419354838,50.40587938088098
Task_17424,596,593,128,200,328,1.0033670033670035,19.26039804854707
Task_17425,2098,1017,70,115,185,2.06090373280943,43.76161951913654
Task_17426,2237,510,51,59,110,4.3776908023483365,43.10735454254708
Task_17427,1073,212,151,133,284,5.037558685446009,25.441781924415334
Task_17428,613,121,49,190,239,5.024590163934426,17.43727009809881
Task_17429,1594,1002,35,60,95,1.5892323030907278,34.23958028091983
Task_17430,1986,419,49,157,206,4.728571428571429,40.41039786292934
Task_17431,1135,293,134,99,233,3.860544217687075,26.398416822222327
Task_17432,1503,717,96,58,154,2.0933147632311977,32.39785758583264
Task_17433,925,829,33,86,119,1.1144578313253013,23.646127002802626
Task_17434,2141,655,25,102,127,3.263719512195122,42.813775763230886
Task_17435,2768,588,134,134,268,4.699490662139219,53.42021951083416
Task_17436,1488,431,57,183,240,3.4444444444444446,32.75709644453972
Task_17437,2828,228,64,195,259,12.34934497816594,53.32122993086599
Task_17438,2948,229,10,49,59,12.817391304347826,52.45916623758874
Task_17439,888,112,101,63,164,7.8584070796460175,20.352685625450402
Task_17440,1486,559,167,16,183,2.6535714285714285,31.463622907707776
Task_17441,2081,234,197,65,262,8.85531914893617,40.8001417661696
Task_17442,1023,409,88,21,109,2.495121951219512,23.195430929138848
Task_17443,2251,910,141,21,162,2.4709110867178925,44.59400321805911
Task_17444,834,287,107,197,304,2.8958333333333335,22.09891621274585
Task_17445,628,556,104,92,196,1.1274685816876122,18.78155390222506
Task_17446,1715,243,39,47,86,7.028688524590164,33.39927176980722
Task_17447,1734,987,94,145,239,1.7550607287449393,38.247353359558495
Task_17448,2095,785,92,155,247,2.6653944020356235,43.39611140564887
Task_17449,2486,828,34,68,102,2.9987937273823886,48.10336335132062
Task_17450,1695,505,196,25,221,3.349802371541502,35.06593132372082
Task_17451,2834,781,124,144,268,3.6240409207161126,55.09231260189008
Task_17452,1308,203,61,44,105,6.411764705882353,26.790346915861036
Task_17453,1321,927,93,109,202,1.4234913793103448,31.27449154932422
Task_17454,1276,78,43,186,229,16.151898734177216,27.244735599438105
Task_17455,892,256,28,167,195,3.470817120622568,22.42027795055542
Task_17456,1280,413,69,114,183,3.0917874396135265,28.830270867771347
Task_17457,2412,609,42,60,102,3.954098360655738,46.00163992518185
Task_17458,2127,1007,76,180,256,2.1101190476190474,44.73310211275075
Task_17459,1360,975,52,37,89,1.3934426229508197,30.102530072407074
Task_17460,1754,872,42,14,56,2.009163802978236,35.390281602820856
Task_17461,1838,156,25,50,75,11.707006369426752,34.669536135528496
Task_17462,2420,65,95,19,114,36.666666666666664,42.996249753916366
Task_17463,1601,709,89,185,274,2.2549295774647886,35.46058521856698
Task_17464,1555,159,198,12,210,9.71875,31.44782316699717
Task_17465,2099,370,109,45,154,5.657681940700809,40.421925932026475
Task_17466,2581,390,190,172,362,6.601023017902813,50.29437489249517
Task_17467,1058,517,197,120,317,2.0424710424710426,26.31868039183061
Task_17468,1583,569,43,153,196,2.7771929824561403,34.311649851704
Task_17469,2081,593,60,81,141,3.5033670033670035,41.51994266794727
Task_17470,1143,932,174,65,239,1.22508038585209,28.042360888816315
Task_17471,780,470,135,187,322,1.6560509554140128,21.877692664368485
Task_17472,1211,289,155,64,219,4.175862068965517,27.031904729052055
Task_17473,2980,74,179,44,223,39.733333333333334,52.848388918722584
Task_17474,1429,986,141,186,327,1.447821681864235,33.72899521591929
Task_17475,2131,334,69,169,238,6.361194029850746,42.545900841534745
Task_17476,1973,876,26,110,136,2.249714937286203,40.85306904166141
Task_17477,661,564,176,155,331,1.1699115044247788,20.211827610518935
Task_17478,1004,319,104,166,270,3.1375,24.691513317655776
Task_17479,681,963,75,38,113,0.7064315352697096,20.067872972954955
Task_17480,1114,546,49,105,154,2.036563071297989,26.349464923924824
Task_17481,1050,873,128,176,304,1.2013729977116705,27.241352685158756
Task_17482,2169,954,92,181,273,2.2712041884816756,45.25120825099867
Task_17483,2604,852,173,55,228,3.052754982415006,50.93459086017135
Task_17484,1370,589,180,26,206,2.3220338983050848,30.139674705713393
Task_17485,1515,193,77,160,237,7.809278350515464,32.29534065628746
Task_17486,2915,437,157,16,173,6.655251141552512,53.75004436325972
Task_17487,2064,812,115,158,273,2.5387453874538743,43.03346177733133
Task_17488,2057,203,134,195,329,10.083333333333334,41.237331175111976
Task_17489,2362,253,131,39,170,9.299212598425196,44.37553905998853
Task_17490,1614,92,163,177,340,17.35483870967742,33.1329150140934
Task_17491,1938,625,96,123,219,3.0958466453674123,40.20903818504765
Task_17492,2829,626,178,32,210,4.511961722488039,53.4267618174511
Task_17493,1395,975,44,29,73,1.4293032786885247,30.24625035605499
Task_17494,2372,757,51,169,220,3.129287598944591,47.71392724945539
Task_17495,1354,620,10,87,97,2.180354267310789,29.638037790278037
Task_17496,2691,986,87,12,99,2.7264437689969605,51.24266896966449
Task_17497,649,989,85,194,279,0.6555555555555556,21.35423552229862
Task_17498,1796,504,95,113,208,3.5564356435643565,37.53019081177299
Task_17499,2378,159,170,158,328,14.8625,45.78327033474716
Task_17500,640,369,74,182,256,1.7297297297297298,19.172148104891203
Task_17501,755,191,24,184,208,3.9322916666666665,20.085098815987717
Task_17502,1640,190,89,27,116,8.586387434554974,32.50701902395551
Task_17503,1828,612,50,187,237,2.9820554649265905,38.73751661808504
Task_17504,501,831,192,124,316,0.6021634615384616,18.593667200281043
Task_17505,2071,206,70,31,101,10.004830917874395,39.1239675734786
Task_17506,544,180,13,191,204,3.005524861878453,16.325427370960856
Task_17507,571,841,48,24,72,0.6781472684085511,17.158350663433172
Task_17508,1311,467,169,154,323,2.801282051282051,30.24312591726748
Task_17509,2993,70,94,70,164,42.15492957746479,53.104133294214336
Task_17510,1862,156,29,140,169,11.859872611464969,36.611407290046984
Task_17511,1277,1001,44,161,205,1.2744510978043913,30.7060422047915
Task_17512,879,764,56,51,107,1.1490196078431372,22.272030855823278
Task_17513,2106,473,198,140,338,4.443037974683544,42.89371719538576
Task_17514,766,111,86,122,208,6.839285714285714,19.185096178231817
Task_17515,1937,858,11,162,173,2.2549476135040747,40.6540387908835
Task_17516,1322,657,134,47,181,2.0091185410334345,29.341480023489087
Task_17517,2089,947,173,114,287,2.2035864978902953,43.849090925453844
Task_17518,2627,371,46,17,63,7.061827956989247,47.55188796787408
Task_17519,1196,870,32,112,144,1.373134328358209,28.454958472504604
Task_17520,1730,324,174,111,285,5.323076923076923,36.17583381191746
Task_17521,2044,672,66,96,162,3.037147102526003,41.57351625060968
Task_17522,905,109,147,63,210,8.227272727272727,20.927816798052703
Task_17523,2771,731,104,194,298,3.7855191256830603,54.145150798071576
Task_17524,1734,353,108,59,167,4.898305084745763,35.035651538203325
Task_17525,1120,894,132,70,202,1.2513966480446927,27.38249614796656
Task_17526,1461,286,99,74,173,5.090592334494773,30.79471751232403
Task_17527,2469,474,133,21,154,5.197894736842105,46.57261841891138
Task_17528,1170,385,11,170,181,3.0310880829015545,26.957425893226784
Task_17529,2645,261,15,57,72,10.095419847328245,48.06864221806995
Task_17530,1609,147,103,181,284,10.871621621621621,33.40679357318444
Task_17531,2637,869,88,102,190,3.0310344827586206,51.842477806591184
Task_17532,2090,720,132,84,216,2.89875173370319,42.49819468253053
Task_17533,1639,224,74,159,233,7.2844444444444445,34.36171125361138
Task_17534,772,121,84,163,247,6.327868852459017,19.870302989566138
Task_17535,2544,400,82,128,210,6.344139650872818,49.08509526862917
Task_17536,784,83,24,111,135,9.333333333333334,18.568497562031414
Task_17537,2387,127,200,200,400,18.6484375,46.01617248804632
Task_17538,1073,549,21,164,185,1.950909090909091,25.98019190701811
Task_17539,1984,420,135,124,259,4.712589073634204,40.41170439548058
Task_17540,1142,223,128,26,154,5.098214285714286,24.82304387822933
Task_17541,1459,613,116,84,200,2.3762214983713354,32.09582792439841
Task_17542,2236,248,185,180,365,8.97991967871486,44.372800607417844
Task_17543,1646,682,70,164,234,2.4099560761346996,35.97849410023959
Task_17544,1938,343,193,117,310,5.633720930232558,39.650304790918156
Task_17545,2877,762,22,93,115,3.770642201834862,54.61571241468234
Task_17546,1591,817,120,173,293,1.9449877750611246,35.66722590836826
Task_17547,2534,791,145,32,177,3.1994949494949494,48.94463909418707
Task_17548,1900,845,107,130,237,2.2458628841607564,40.33476816992562
Task_17549,791,825,124,172,296,0.9576271186440678,22.961679696220894
Task_17550,1118,102,24,17,41,10.854368932038835,22.386272302206176
Task_17551,2956,878,131,59,190,3.3629124004550626,56.31674824219894
Task_17552,2673,588,168,83,251,4.538200339558574,51.47105728545787
Task_17553,1369,924,124,120,244,1.48,32.14082335856234
Task_17554,2271,664,199,83,282,3.4150375939849624,45.485358530036194
Task_17555,2906,159,18,173,191,18.1625,53.427783892789705
Task_17556,982,736,116,59,175,1.332428765264586,24.461271343114333
Task_17557,1773,551,37,143,180,3.2119565217391304,37.00484223824875
Task_17558,537,417,199,171,370,1.284688995215311,17.98013420727491
Task_17559,1817,319,127,193,320,5.678125,37.81287877082932
Task_17560,2655,93,10,52,62,28.24468085106383,46.87968881687353
Task_17561,2916,410,132,168,300,7.094890510948905,55.376834828066045
Task_17562,2974,972,13,198,211,3.0565262076053443,57.787662493051904
Task_17563,2024,718,196,157,353,2.8150208623087623,42.46460974348283
Task_17564,2292,778,62,199,261,2.9422336328626444,46.67326091851942
Task_17565,1377,491,39,158,197,2.798780487804878,30.81431317990098
Task_17566,680,341,56,101,157,1.9883040935672514,18.86977966091044
Task_17567,1440,874,39,95,134,1.6457142857142857,32.379142765116605
Task_17568,1208,838,56,103,159,1.4398092967818832,28.686874582192335
Task_17569,2160,738,33,163,196,2.9228687415426253,44.03079191342321
Task_17570,1927,385,87,196,283,4.992227979274611,39.61772137138929
Task_17571,2744,715,24,192,216,3.8324022346368714,53.337280355971785
Task_17572,2512,261,80,111,191,9.587786259541986,48.02324988403649
Task_17573,2697,774,22,97,119,3.48,51.815849100943154
Task_17574,2941,437,32,26,58,6.7146118721461185,53.06402298529221
Task_17575,2610,689,99,64,163,3.782608695652174,50.061992323496774
Task_17576,882,696,21,24,45,1.2654232424677188,21.156923861487815
Task_17577,2243,450,78,150,228,4.9733924611973395,44.63742736227402
Task_17578,2025,586,180,55,235,3.4497444633730834,40.95727944766005
Task_17579,759,832,79,180,259,0.9111644657863145,22.389654943472053
Task_17580,914,491,46,149,195,1.8577235772357723,23.48434259518429
Task_17581,2107,100,70,89,159,20.861386138613863,39.628151465695815
Task_17582,1521,91,165,91,256,16.532608695652176,31.08736107192574
Task_17583,2395,710,183,160,343,3.3684950773558366,48.27570762147514
Task_17584,1623,886,36,139,175,1.8297632468996619,35.754390225296525
Task_17585,837,864,127,148,275,0.9676300578034682,23.66763710440813
Task_17586,829,372,107,169,276,2.222520107238606,22.124372187612085
Task_17587,1250,640,77,85,162,1.9500780031201248,28.61549734677662
Task_17588,975,871,139,56,195,1.1181192660550459,24.943314407204053
Task_17589,2307,918,53,33,86,2.510337323177367,44.91200056256893
Task_17590,2451,682,93,166,259,3.588579795021962,48.8166047784295
Task_17591,1863,570,171,160,331,3.2626970227670755,39.35373302024956
Task_17592,2988,878,38,136,174,3.3993174061433447,57.3487367697243
Task_17593,831,468,81,188,269,1.7718550106609807,22.544992146070594
Task_17594,1767,127,114,139,253,13.8046875,35.50555776317059
Task_17595,785,428,136,121,257,1.82983682983683,21.448819708142622
Task_17596,1325,139,28,89,117,9.464285714285714,27.401080913529793
Task_17597,1248,797,43,149,192,1.5639097744360901,29.654909122448515
Task_17598,2569,882,76,135,211,2.909399773499434,51.07865053633008
Task_17599,2808,742,58,27,85,3.779273216689098,52.23504588052509
Task_17600,1921,937,104,198,302,2.0479744136460556,41.34658236286469
Task_17601,613,890,30,115,145,0.6879910213243546,19.47315499971763
Task_17602,1499,849,126,179,305,1.7635294117647058,34.35857569534313
Task_17603,1986,101,56,10,66,19.470588235294116,36.12607279557787
Task_17604,1002,442,33,74,107,2.2618510158013545,23.601357835960997
Task_17605,1922,301,22,196,218,6.364238410596027,38.926441553997215
Task_17606,936,274,36,166,202,3.403636363636364,23.17268912703194
Task_17607,963,204,161,192,353,4.697560975609756,24.075102230967445
Task_17608,1124,876,184,155,339,1.281641961231471,28.540080021513706
Task_17609,1509,1017,97,180,277,1.4823182711198428,34.90796262731346
Task_17610,1001,130,10,19,29,7.641221374045801,20.689572821881626
Task_17611,937,191,29,80,109,4.880208333333333,22.019632935342837
Task_17612,1528,485,172,143,315,3.1440329218106995,33.68312743005513
Task_17613,554,953,179,91,270,0.5807127882599581,19.366473318732357
Task_17614,2690,430,24,169,193,6.241299303944316,51.428886901436755
Task_17615,735,422,72,177,249,1.7375886524822695,20.798268919092976
Task_17616,2966,800,89,168,257,3.7028714107365794,57.26879623935317
Task_17617,2335,87,162,118,280,26.53409090909091,43.98987487135145
Task_17618,2827,737,48,25,73,3.830623306233062,52.18806230369984
Task_17619,2355,264,36,31,67,8.88679245283019,43.13349133716608
Task_17620,793,922,14,41,55,0.8591549295774648,20.800087168414723
Task_17621,652,108,129,148,277,5.981651376146789,17.756254823847076
Task_17622,2840,228,97,43,140,12.40174672489083,51.644162802762196
Task_17623,1434,302,143,93,236,4.732673267326732,31.109520760920518
Task_17624,1466,607,198,23,221,2.411184210526316,31.765141000284373
Task_17625,1081,135,39,179,218,7.948529411764706,24.662823569603045
Task_17626,2056,221,55,23,78,9.26126126126126,38.23111925020877
Task_17627,2503,983,71,131,202,2.5436991869918697,50.29043938523711
Task_17628,1265,532,50,105,155,2.373358348968105,28.759050527771453
Task_17629,2952,532,17,80,97,5.538461538461538,54.544364594611814
Task_17630,2508,682,116,31,147,3.67203513909224,47.99351493379097
Task_17631,2502,77,89,82,171,32.07692307692308,45.599166112025216
Task_17632,2352,680,64,109,173,3.4537444933920707,46.715446211469356
Task_17633,1231,702,95,99,194,1.7510668563300142,29.09323958114149
Task_17634,955,408,139,34,173,2.334963325183374,22.822360406121486
Task_17635,2373,419,135,124,259,5.65,46.56448826541452
Task_17636,2514,779,131,171,302,3.223076923076923,50.209207126421155
Task_17637,1218,652,132,26,158,1.8652373660030628,27.43691364541455
Task_17638,2612,863,170,173,343,3.0231481481481484,52.212964541257236
Task_17639,2764,552,106,28,134,4.998191681735985,51.55766946317818
Task_17640,1175,762,118,145,263,1.5399737876802098,28.68656278588961
Task_17641,2697,959,200,62,262,2.809375,52.83944935769023
Task_17642,2298,1004,111,188,299,2.2865671641791043,47.500964837732624
Task_17643,1110,802,28,32,60,1.3823163138231631,25.11537872660662
Task_17644,548,1015,16,14,30,0.5393700787401575,16.69192532521934
Task_17645,1460,374,30,132,162,3.8933333333333335,31.314219226266218
Task_17646,2479,729,158,175,333,3.3958904109589043,49.64310021338381
Task_17647,1161,694,174,178,352,1.6705035971223021,28.732097362128098
Task_17648,1995,439,188,19,207,4.534090909090909,39.37334206974655
Task_17649,2398,187,21,97,118,12.75531914893617,45.08106436200229
Task_17650,1412,585,125,103,228,2.409556313993174,31.711402454817975
Task_17651,2196,809,62,98,160,2.7111111111111112,44.32619153704679
Task_17652,1474,457,117,195,312,3.2183406113537116,32.801961170281565
Task_17653,1994,647,90,166,256,3.0771604938271606,41.3915112177452
Task_17654,912,1012,157,185,342,0.9002961500493584,25.682801011373115
Task_17655,1503,578,17,181,198,2.5958549222797926,33.0473632317935
Task_17656,1636,633,132,166,298,2.580441640378549,35.81744001448125
Task_17657,1961,748,182,120,302,2.618157543391188,41.27651897191632
Task_17658,1892,929,134,199,333,2.0344086021505374,41.00335705199413
Task_17659,2383,489,58,108,166,4.863265306122449,46.488177744480794
Task_17660,1962,891,137,60,197,2.1995515695067263,40.653682805658576
Task_17661,1889,445,136,122,258,4.23542600896861,38.981700721145835
Task_17662,2204,669,60,118,178,3.28955223880597,44.262073438546686
Task_17663,1217,542,189,133,322,2.241252302025783,28.9562093142019
Task_17664,1994,624,125,110,235,3.1904,41.09299455504924
Task_17665,2549,399,189,174,363,6.3725,49.825481937723225
Task_17666,2504,848,41,44,85,2.949352179034158,47.80992646834332
Task_17667,889,904,40,190,230,0.9823204419889503,24.36965798428915
Task_17668,1539,517,104,92,196,2.971042471042471,33.24694440730678
Task_17669,2816,632,132,165,297,4.448657187993681,54.49704870227085
Task_17670,2062,748,175,99,274,2.753004005340454,42.704756422942204
Task_17671,1598,401,33,156,189,3.9751243781094527,33.99424956069376
Task_17672,2930,990,79,72,151,2.9566094853683147,56.060060846387074
Task_17673,1817,442,23,52,75,4.10158013544018,35.59646354528879
Task_17674,2807,881,199,53,252,3.1825396825396823,54.36557452029974
Task_17675,1337,444,169,41,210,3.004494382022472,29.216469088105953
Task_17676,1692,1014,186,23,209,1.6669950738916257,36.55827362845182
Task_17677,1746,804,92,29,121,2.1689440993788818,36.18845049291939
Task_17678,1015,843,25,198,223,1.20260663507109,26.259217872404374
Task_17679,2078,542,141,51,192,3.826887661141805,41.41655897154964
Task_17680,717,586,88,128,216,1.221465076660988,20.57293367178347
Task_17681,502,599,193,144,337,0.8366666666666667,17.811199420821684
Task_17682,2431,322,184,154,338,7.526315789473684,47.55670547271696
Task_17683,1457,865,131,120,251,1.6824480369515011,33.41295317122359
Task_17684,1793,985,11,17,28,1.8184584178498986,36.09218423628333
Task_17685,2046,889,66,78,144,2.298876404494382,41.92439231070452
Task_17686,2730,412,100,47,147,6.610169491525424,50.612106472582674
Task_17687,976,403,137,65,202,2.4158415841584158,23.622489361290963
Task_17688,2064,658,50,44,94,3.1320182094081943,40.370739410380004
Task_17689,1147,544,84,101,185,2.1045871559633027,27.10304390939615
Task_17690,1579,314,111,131,242,5.012698412698413,33.590201735896315
Task_17691,532,595,30,28,58,0.8926174496644296,15.578699492783292
Task_17692,1825,65,59,96,155,27.651515151515152,34.95055084233685
Task_17693,2941,415,96,91,187,7.069711538461538,55.031442187649155
Task_17694,2283,916,22,140,162,2.489640130861505,45.99848915000481
Task_17695,2776,434,113,85,198,6.381609195402299,52.384918459202986
Task_17696,1181,761,79,12,91,1.5498687664041995,26.624287127613826
Task_17697,1430,539,151,83,234,2.6481481481481484,31.556072981016452
Task_17698,2690,537,167,100,267,5.0,51.96699716319313
Task_17699,2113,650,145,39,184,3.2457757296466974,41.82686830212949
Task_17700,1954,629,102,120,222,3.1015873015873017,40.43132626512777
Task_17701,2368,832,154,180,334,2.8427370948379354,48.219647845110124
Task_17702,1880,640,157,70,227,2.932917316692668,38.79866543873275
Task_17703,1883,1015,107,34,141,1.8533464566929134,39.07541523077191
Task_17704,2447,751,38,61,99,3.2539893617021276,46.98295541970265
Task_17705,2156,353,142,187,329,6.090395480225989,43.32020050989062
Task_17706,819,272,189,173,362,3.0,22.03943137172048
Task_17707,1968,606,124,35,159,3.242174629324547,39.22577658034165
Task_17708,1382,498,11,128,139,2.7695390781563125,30.2783222367386
Task_17709,698,271,130,36,166,2.5661764705882355,18.218200160820945
Task_17710,1494,589,93,91,184,2.5322033898305083,32.578187156933225
Task_17711,2915,965,88,187,275,3.0175983436853,57.066828166918896
Task_17712,1122,869,22,73,95,1.289655172413793,26.569172225155157
Task_17713,2345,537,125,180,305,4.358736059479554,46.79297755158833
Task_17714,2696,798,181,128,309,3.3742177722152693,53.12080110548978
Task_17715,1306,1023,150,42,192,1.275390625,30.446982413168296
Task_17716,1544,931,150,138,288,1.6566523605150214,35.18954674943106
Task_17717,2849,209,77,106,183,13.566666666666666,52.91933523134295
Task_17718,1975,614,200,194,394,3.2113821138211383,41.60027626969208
Task_17719,2466,203,152,131,283,12.088235294117647,47.39249617562319
Task_17720,2122,211,179,39,218,10.00943396226415,40.84496340305281
Task_17721,1479,969,194,116,310,1.524742268041237,34.31502117552078
Task_17722,1970,676,62,65,127,2.909896602658789,39.79646572287377
Task_17723,2738,948,168,16,184,2.8851422550052686,52.521018519559924
Task_17724,1108,274,185,162,347,4.029090909090909,26.529989966672492
Task_17725,1252,903,190,185,375,1.3849557522123894,30.881848610841573
Task_17726,572,463,56,181,237,1.2327586206896552,18.169702394683778
Task_17727,2401,997,78,157,235,2.405811623246493,48.908243656158426
Task_17728,1875,82,107,191,298,22.59036144578313,36.95094939613674
Task_17729,1351,529,138,190,328,2.549056603773585,31.147592540091832
Task_17730,668,812,101,19,120,0.8216482164821648,18.792272960104665
Task_17731,1499,387,29,21,50,3.86340206185567,30.009681101153603
Task_17732,2795,377,176,72,248,7.394179894179894,52.56014195080264
Task_17733,2240,175,187,72,259,12.727272727272727,42.821364295301294
Task_17734,1419,469,106,33,139,3.019148936170213,29.99569711874561
Task_17735,2126,280,134,130,264,7.565836298932385,42.22006498462975
Task_17736,734,283,76,19,95,2.584507042253521,18.04115258213916
Task_17737,2559,818,21,145,166,3.1245421245421245,50.20299642187703
Task_17738,1814,267,115,77,192,6.768656716417911,36.48065901021933
Task_17739,1925,408,168,59,227,4.706601466992665,38.673657909942726
Task_17740,2016,174,79,129,208,11.52,39.598576976441755
Task_17741,763,404,195,17,212,1.8839506172839506,19.787712049239527
Task_17742,948,270,173,68,241,3.4981549815498156,22.93180192890024
Task_17743,2390,787,31,39,70,3.032994923857868,45.38151084380044
Task_17744,960,917,189,29,218,1.0457516339869282,24.766408909017546
Task_17745,625,337,60,18,78,1.849112426035503,15.778215249552156
Task_17746,768,86,36,170,206,8.827586206896552,19.23122361137293
Task_17747,1684,1004,167,57,224,1.6756218905472637,36.7457423193192
Task_17748,2325,904,127,151,278,2.569060773480663,47.468381964972316
Task_17749,1035,350,162,196,358,2.948717948717949,25.722168808670308
Task_17750,751,797,99,78,177,0.9411027568922306,21.164646416872873
Task_17751,578,345,108,117,225,1.670520231213873,17.748957305258735
Task_17752,2769,502,51,46,97,5.504970178926441,51.032334683054096
Task_17753,1749,606,164,62,226,2.8813838550247115,36.55252506707351
Task_17754,2738,1021,133,90,223,2.679060665362035,53.87569368991211
Task_17755,1253,118,174,44,218,10.529411764705882,26.411432607279178
Task_17756,2679,844,80,141,221,3.1704142011834318,52.745538201801516
Task_17757,511,988,137,124,261,0.5166835187057633,18.942644360041474
Task_17758,2882,242,59,146,205,11.860082304526749,53.940035896241454
Task_17759,2507,722,115,57,172,3.467496542185339,48.57980448053518
Task_17760,943,455,177,120,297,2.067982456140351,24.213241705088986
Task_17761,675,504,162,183,345,1.3366336633663367,20.39247468660447
Task_17762,1481,416,150,191,341,3.551558752997602,32.90650277262644
Task_17763,1164,780,195,138,333,1.4903969270166453,28.873444036061397
Task_17764,1539,456,169,103,272,3.3676148796498904,33.51247034895141
Task_17765,2281,781,118,132,250,2.9168797953964196,46.23261547638268
Task_17766,2596,650,138,144,282,3.9877112135176653,50.971464119818336
Task_17767,721,831,86,48,134,0.8665865384615384,20.17934577977567
Task_17768,2021,109,197,41,238,18.37272727272727,38.352942562357704
Task_17769,703,788,113,53,166,0.8910012674271229,20.254803145344567
Task_17770,1729,222,71,52,123,7.753363228699552,34.34442941160538
Task_17771,1987,618,38,41,79,3.210016155088853,38.64471509252062
Task_17772,2760,734,10,76,86,3.7551020408163267,52.009516552905524
Task_17773,818,579,154,113,267,1.410344827586207,22.408257368251043
Task_17774,1033,174,157,35,192,5.902857142857143,23.243004806347546
Task_17775,1803,304,16,61,77,5.911475409836066,34.85897141143602
Task_17776,2033,349,67,33,100,5.808571428571429,38.96676870257239
Task_17777,822,564,200,144,344,1.454867256637168,22.8174009899478
Task_17778,2751,408,133,168,301,6.726161369193154,52.763639075963205
Task_17779,2077,687,110,52,162,3.0188953488372094,41.53466762615355
Task_17780,809,797,116,43,159,1.0137844611528821,21.336998546499686
Task_17781,1123,144,133,193,326,7.744827586206896,25.986888716642415
Task_17782,2853,754,147,75,222,3.7788079470198674,54.63552450636473
Task_17783,2691,559,136,132,268,4.805357142857143,52.104999855948925
Task_17784,2328,352,119,199,318,6.594900849858357,46.00559174612554
Task_17785,2473,149,69,24,93,16.486666666666668,44.82777652317077
Task_17786,653,988,54,152,206,0.660262891809909,21.071957302738863
Task_17787,577,302,162,140,302,1.9042904290429044,17.991356290760944
Task_17788,2813,276,92,48,140,10.155234657039712,51.52614992001117
Task_17789,1232,997,136,39,175,1.2344689378757514,28.993218035707827
Task_17790,1286,390,179,162,341,3.289002557544757,29.694923679484557
Task_17791,973,751,47,198,245,1.2938829787234043,25.401014204847538
Task_17792,940,153,191,124,315,6.103896103896104,22.951149782111568
Task_17793,943,860,161,20,181,1.0952380952380953,23.728012191181318
Task_17794,1853,337,182,102,284,5.482248520710059,38.1467291997319
Task_17795,664,736,112,131,243,0.9009497964721845,20.374645443348356
Task_17796,2383,464,91,188,279,5.124731182795699,47.102999528217445
Task_17797,618,456,44,53,97,1.3522975929978118,17.11629428387782
Task_17798,653,895,157,179,336,0.7287946428571429,21.209290406467805
Task_17799,1725,670,97,107,204,2.570789865871833,36.85670269637398
Task_17800,2046,703,161,116,277,2.90625,42.36338396366201
Task_17801,1388,984,140,63,203,1.4091370558375635,31.912368949625474
Task_17802,2747,897,28,125,153,3.0590200445434297,53.222712421717034
Task_17803,564,996,170,139,309,0.5656970912738215,19.98739441528558
Task_17804,2816,541,17,81,98,5.195571955719557,52.406566214359934
Task_17805,1958,327,45,146,191,5.969512195121951,39.419393316675226
Task_17806,1313,777,190,197,387,1.6876606683804627,31.583829001299772
Task_17807,814,918,174,113,287,0.8857453754080522,23.47829845331273
Task_17808,970,786,29,53,82,1.2325285895806861,23.573237568686125
Task_17809,1976,846,33,118,151,2.332939787485242,40.85629373286178
Task_17810,552,861,23,185,208,0.6403712296983759,19.063776408054146
Task_17811,2306,117,144,184,328,19.54237288135593,44.321413999382294
Task_17812,2045,1003,119,108,227,2.0368525896414345,43.04675897593876
Task_17813,1287,442,151,76,227,2.905191873589165,28.87544953805673
Task_17814,2049,604,76,200,276,3.386776859504132,42.355765091666925
Task_17815,2234,536,97,49,146,4.160148975791434,43.278620490829496
Task_17816,2273,816,89,192,281,2.782129742962056,46.48294980461273
Task_17817,1673,549,41,146,187,3.041818181818182,35.584274734460266
Task_17818,2881,623,149,110,259,4.61698717948718,55.24590676773861
Task_17819,731,986,122,157,279,0.7406281661600811,22.372681647243212
Task_17820,1966,930,96,111,207,2.111707841031149,41.53502225388104
Task_17821,1535,806,187,140,327,1.902106567534077,34.85062165380764
Task_17822,2404,74,185,118,303,32.053333333333335,45.10175787108924
Task_17823,1932,82,36,144,180,23.27710843373494,37.136725503846286
Task_17824,889,563,59,55,114,1.576241134751773,21.984142362556828
Task_17825,2650,289,168,138,306,9.137931034482758,50.736108620877815
Task_17826,959,967,189,77,266,0.9907024793388429,25.50942974025745
Task_17827,2780,83,99,163,262,33.095238095238095,50.95268084380624
Task_17828,2034,702,119,73,192,2.8933143669985775,41.31519309797104
Task_17829,1926,814,12,160,172,2.36319018404908,40.33508612958254
Task_17830,2457,836,142,104,246,2.935483870967742,49.13424590219777
Task_17831,640,810,34,69,103,0.7891491985203453,18.787378970562806
Task_17832,1337,180,170,149,319,7.386740331491713,29.295670774478257
Task_17833,2312,652,142,127,269,3.540581929555896,46.396115364815934
Task_17834,1573,594,135,132,267,2.6436974789915966,34.50758790412909
Task_17835,1992,945,29,193,222,2.105708245243129,42.16959831370506
Task_17836,2215,689,78,28,106,3.210144927536232,42.9889017683509
Task_17837,772,685,33,199,232,1.1253644314868805,21.872542420617517
Task_17838,2532,1016,105,139,244,2.489675516224189,50.92684321196894
Task_17839,714,774,123,85,208,0.9212903225806451,20.799545264978857
Task_17840,2510,604,138,49,187,4.148760330578512,48.23127395618002
Task_17841,2479,102,60,51,111,24.067961165048544,44.65443493811825
Task_17842,2684,125,139,61,200,21.3015873015873,49.1908763859739
Task_17843,800,642,73,166,239,1.244167962674961,22.33499849681212
Task_17844,2713,850,164,153,317,3.188014101057579,53.62602646369919
Task_17845,1649,918,146,133,279,1.794341675734494,36.7785224603988
Task_17846,2863,569,191,143,334,5.02280701754386,55.17431865827376
Task_17847,1973,747,177,115,292,2.6377005347593583,41.411088950995946
Task_17848,509,640,137,108,245,0.7940717628705148,17.62898193567057
Task_17849,666,887,118,44,162,0.75,19.474457609502977
Task_17850,2744,633,148,44,192,4.3280757097791795,52.001908736112796
Task_17851,548,667,146,14,160,0.8203592814371258,16.785048280609782
Task_17852,559,414,185,171,356,1.346987951807229,18.30742801900523
Task_17853,2927,278,102,187,289,10.491039426523297,55.07017157796827
Task_17854,678,1001,147,46,193,0.6766467065868264,20.74821271679976
Task_17855,1539,973,131,195,326,1.5800821355236139,35.46613699459323
Task_17856,2063,836,191,195,386,2.4647550776583036,43.656111131699156
Task_17857,1019,1022,53,120,173,0.9960899315738025,26.531987309001153
Task_17858,1208,910,152,163,315,1.3260153677277717,29.93159550388903
Task_17859,1787,755,131,165,296,2.363756613756614,38.580853088526695
Task_17860,2979,615,98,72,170,4.836038961038961,55.71799834691265
Task_17861,709,940,38,144,182,0.7534537725823592,21.16550288266163
Task_17862,2261,224,147,170,317,10.04888888888889,44.44773087681847
Task_17863,2693,376,169,78,247,7.143236074270557,51.06553167772566
Task_17864,995,898,12,140,152,1.10678531701891,25.258474224726836
Task_17865,2351,460,95,165,260,5.099783080260304,46.48500523283568
Task_17866,2727,804,175,81,256,3.387577639751553,52.99987409591213
Task_17867,2294,965,132,41,173,2.3747412008281574,45.765698799918106
Task_17868,2590,928,72,160,232,2.7879440258342303,51.675229267009605
Task_17869,2634,361,85,64,149,7.276243093922652,49.240917920934685
Task_17870,2403,92,166,113,279,25.838709677419356,45.14631897077739
Task_17871,2728,108,88,87,175,25.027522935779817,49.625280255676806
Task_17872,2783,416,176,197,373,6.6738609112709835,53.66369456249256
Task_17873,843,612,136,108,244,1.3752039151712887,22.795877230818153
Task_17874,2530,717,49,27,76,3.5236768802228413,47.41695054844438
Task_17875,2888,385,30,181,211,7.481865284974093,54.508585836963306
Task_17876,1928,987,114,61,175,1.951417004048583,40.23230863688406
Task_17877,2548,81,190,50,240,31.073170731707318,46.30399345519965
Task_17878,1354,795,125,175,300,1.7010050251256281,31.864985797996866
Task_17879,2292,523,162,10,172,4.374045801526718,44.184638724049584
Task_17880,2151,505,142,50,192,4.25098814229249,42.28224982279098
Task_17881,2342,525,71,14,85,4.452471482889734,44.13729998515387
Task_17882,519,285,168,190,358,1.8146853146853146,17.34613458156726
Task_17883,952,380,105,77,182,2.4986876640419946,22.983571800010267
Task_17884,2267,378,16,74,90,5.981530343007916,43.137658510023556
Task_17885,1087,826,16,129,145,1.3143893591293834,26.603177535336275
Task_17886,1665,142,23,90,113,11.643356643356643,32.86783763127354
Task_17887,1268,733,117,171,288,1.7275204359673024,30.249744639992873
Task_17888,1268,1018,190,23,213,1.2443572129538762,29.867035464113318
Task_17889,1799,194,130,60,190,9.225641025641025,35.75010588202435
Task_17890,1531,920,150,100,250,1.6623235613463627,34.72243897412304
Task_17891,1753,510,133,198,331,3.4305283757338554,37.47736377389128
Task_17892,1772,213,181,151,332,8.280373831775702,36.724603873177415
Task_17893,2096,707,56,86,142,2.9604519774011298,42.19826975300385
Task_17894,2501,517,58,40,98,4.828185328185328,46.76084371424579
Task_17895,1119,462,73,69,142,2.4168466522678185,25.672085062506905
Task_17896,970,208,135,135,270,4.641148325358851,23.741688813765098
Task_17897,2348,801,97,117,214,2.9276807980049875,47.196202181220734
Task_17898,1805,211,18,133,151,8.514150943396226,36.037270717257556
Task_17899,2483,312,120,80,200,7.932907348242812,47.32873197939903
Task_17900,2968,719,167,15,182,4.122222222222222,55.43522458373244
Task_17901,2470,550,110,34,144,4.482758620689655,46.9491515275287
Task_17902,1390,709,171,164,335,1.9577464788732395,32.32256469945435
Task_17903,1268,941,134,140,274,1.346072186836518,30.759879092854973
Task_17904,2587,552,162,120,282,4.678119349005425,50.48125495691323
Task_17905,1492,334,148,106,254,4.453731343283582,32.29788724213984
Task_17906,1633,754,149,116,265,2.1629139072847683,35.92652480640556
Task_17907,1567,768,102,34,136,2.037711313394018,33.312067032359366
Task_17908,2005,863,188,40,228,2.3206018518518516,41.19719936927077
Task_17909,2836,520,181,188,369,5.4433781190019195,54.812418627917076
Task_17910,907,111,54,60,114,8.098214285714286,20.142059082159523
Task_17911,1971,744,195,177,372,2.6456375838926176,41.821463182674435
Task_17912,2804,516,23,108,131,5.423597678916828,52.957345971180736
Task_17913,1933,501,180,192,372,3.850597609561753,40.474364425246826
Task_17914,1707,330,131,36,167,5.157099697885196,34.34478388804683
Task_17915,730,999,180,86,266,0.73,22.05800112983623
Task_17916,2278,464,155,49,204,4.898924731182795,44.22582098186641
Task_17917,1638,990,119,150,269,1.6528758829465187,36.79411389207772
Task_17918,2802,660,155,157,312,4.2390317700453854,54.42026129802559
Task_17919,1181,331,125,77,202,3.5572289156626504,26.733951513659857
Task_17920,1620,113,42,73,115,14.210526315789474,31.607911680133824
Task_17921,2033,640,96,180,276,3.171606864274571,42.10139925965586
Task_17922,657,252,34,124,158,2.5968379446640317,18.141579667840784
Task_17923,2309,407,81,59,140,5.659313725490196,44.159463600228925
Task_17924,2317,809,90,64,154,2.860493827160494,45.60517687390089
Task_17925,2601,579,23,10,33,4.48448275862069,47.65996194465064
Task_17926,2074,649,193,74,267,3.190769230769231,42.17343624119669
Task_17927,2937,827,79,168,247,3.5471014492753623,56.94010650661432
Task_17928,844,317,93,30,123,2.6540880503144653,20.498845374816586
Task_17929,883,629,45,191,236,1.4015873015873015,23.529608375665546
Task_17930,1286,548,66,186,252,2.3424408014571947,29.95244252334321
Task_17931,1824,165,191,144,335,10.987951807228916,37.072730058571054
Task_17932,533,764,170,93,263,0.6967320261437908,18.471724857849555
Task_17933,550,413,174,76,250,1.328502415458937,17.191947994906613
Task_17934,982,841,63,137,200,1.166270783847981,25.647482911949535
Task_17935,2246,573,52,131,183,3.912891986062718,44.706073181663236
Task_17936,676,345,97,191,288,1.953757225433526,19.72858267060369
Task_17937,532,827,52,44,96,0.642512077294686,17.009466275779378
Task_17938,2978,720,94,191,285,4.130374479889043,57.41028571403686
Task_17939,794,384,100,112,212,2.0623376623376624,21.236593877731412
Task_17940,1756,313,55,44,99,5.592356687898089,34.26615624318841
Task_17941,640,589,23,187,210,1.0847457627118644,19.413644279007
Task_17942,3000,177,110,62,172,16.853932584269664,54.29538085651689
Task_17943,1470,484,134,112,246,3.0309278350515463,32.405361538190284
Task_17944,1849,67,184,17,201,27.191176470588236,34.793320467872
Task_17945,2819,236,25,87,112,11.89451476793249,51.830272444701144
Task_17946,2819,480,84,60,144,5.860706860706861,52.45169194630239
Task_17947,2326,993,194,190,384,2.3400402414486923,48.29648324933217
Task_17948,601,803,167,20,187,0.7475124378109452,18.387874792597987
Task_17949,943,883,131,40,171,1.0667420814479638,23.95048555172293
Task_17950,1701,846,15,170,185,2.0082644628099175,36.925268145222454
Task_17951,718,79,160,86,246,8.975,18.273291766025356
Task_17952,832,346,21,58,79,2.397694524495677,19.724175751155798
Task_17953,842,920,19,95,114,0.9142236699239956,22.755181821537082
Task_17954,2895,709,137,22,159,4.077464788732394,54.15329484620585
Task_17955,1932,446,186,82,268,4.322147651006712,39.36863717170501
Task_17956,1647,300,192,98,290,5.471760797342193,34.78984276857428
Task_17957,917,710,191,99,290,1.289732770745429,24.42810251876661
Task_17958,2114,157,153,47,200,13.379746835443038,40.23981084357657
Task_17959,2239,182,100,176,276,12.234972677595628,43.595867079232825
Task_17960,616,212,143,136,279,2.892018779342723,18.208137926258406
Task_17961,2567,619,73,180,253,4.140322580645162,50.46275034117974
Task_17962,1290,980,122,40,162,1.3149847094801224,29.66910371341537
Task_17963,1129,272,14,34,48,4.135531135531136,23.79986241582901
Task_17964,1428,113,102,148,250,12.526315789473685,30.001093784724915
Task_17965,769,871,45,177,222,0.8818807339449541,22.33454011202871
Task_17966,1982,545,10,164,174,3.63003663003663,40.397296061820775
Task_17967,1323,570,17,158,175,2.316987740805604,29.97277458221383
Task_17968,2043,790,122,159,281,2.5828065739570163,42.669512731594295
Task_17969,1546,155,77,46,123,9.91025641025641,30.47265927938476
Task_17970,1768,943,33,132,165,1.8728813559322033,38.20233531189509
Task_17971,1264,616,51,138,189,2.048622366288493,29.509326906344075
Task_17972,2254,554,190,125,315,4.0612612612612615,45.370877498873234
Task_17973,1668,874,136,199,335,1.9062857142857144,37.291978589549586
Task_17974,2993,399,132,29,161,7.4825,54.80436233469846
Task_17975,1204,973,144,174,318,1.2361396303901437,30.010223083534147
Task_17976,719,934,116,19,135,0.7689839572192514,20.218289066053476
Task_17977,2283,477,26,51,77,4.7761506276150625,42.97118410899859
Task_17978,2160,831,141,165,306,2.5961538461538463,44.77281177260513
Task_17979,2615,615,161,109,270,4.24512987012987,51.055772432289245
Task_17980,2828,79,181,86,267,35.35,51.42312694618093
Task_17981,1871,120,33,18,51,15.462809917355372,34.6095654178406
Task_17982,1927,81,148,34,182,23.5,36.15986272499189
Task_17983,1970,927,94,182,276,2.122844827586207,42.03507693494683
Task_17984,1990,677,161,176,337,2.9351032448377583,41.75303107528266
Task_17985,2711,514,188,127,315,5.264077669902913,52.481141086399475
Task_17986,1412,110,178,60,238,12.72072072072072,29.047308369915225
Task_17987,1228,114,45,149,194,10.678260869565218,26.592500139291218
Task_17988,699,418,178,198,376,1.668257756563246,20.692199863377585
Task_17989,1203,533,164,171,335,2.252808988764045,28.820565656339426
Task_17990,1779,138,92,122,214,12.798561151079136,35.69089023631849
Task_17991,967,413,168,116,284,2.3357487922705316,24.396108712532698
Task_17992,1477,713,35,23,58,2.0686274509803924,30.73473289535754
Task_17993,1310,460,86,152,238,2.841648590021692,29.861111457101657
Task_17994,2869,703,131,24,155,4.075284090909091,53.70904779093211
Task_17995,1034,294,128,160,288,3.5050847457627117,25.157055000175756
Task_17996,1522,94,121,36,157,16.021052631578947,29.634723447956684
Task_17997,1421,993,102,24,126,1.4295774647887325,31.583493056325583
Task_17998,2786,724,17,83,100,3.842758620689655,52.60573331770112
Task_17999,2216,523,195,89,284,4.229007633587786,44.29012221529059
Task_18000,1187,1003,164,53,217,1.1822709163346614,28.934292124704285
Task_18001,1364,214,108,48,156,6.344186046511628,28.354450171539597
Task_18002,1212,722,154,82,236,1.6763485477178424,28.684338082807894
Task_18003,1190,845,43,83,126,1.4066193853427895,28.06560499520069
Task_18004,2627,918,88,195,283,2.8585418933623505,52.4040923678648
Task_18005,2468,844,175,190,365,2.9207100591715975,49.99598067870992
Task_18006,907,421,159,20,179,2.1492890995260665,21.805131123927712
Task_18007,2339,325,33,72,105,7.174846625766871,44.24374350454096
Task_18008,1187,366,86,88,174,3.23433242506812,26.913240066825193
Task_18009,2310,1017,168,195,363,2.269155206286837,48.03028644056989
Task_18010,603,514,87,150,237,1.170873786407767,18.697707350745034
Task_18011,1183,463,176,44,220,2.5495689655172415,26.87149716143308
Task_18012,926,1009,38,73,111,0.9168316831683169,24.144542346682485
Task_18013,2089,924,64,191,255,2.2583783783783784,43.87412883259797
Task_18014,1273,957,33,183,216,1.3288100208768268,30.687738313007287
Task_18015,2972,898,28,117,145,3.305895439377086,56.831325921780724
Task_18016,1834,425,90,95,185,4.305164319248826,37.535281895189094
Task_18017,759,96,110,41,151,7.824742268041237,17.612014312470404
Task_18018,1522,659,97,131,228,2.306060606060606,33.7502493613173
Task_18019,1211,794,11,162,173,1.5232704402515724,28.914493773011525
Task_18020,2614,681,73,31,104,3.832844574780059,49.28453912013193
Task_18021,1346,747,129,189,318,1.7994652406417113,31.70398858576313
Task_18022,1528,984,60,53,113,1.551269035532995,33.37512557701914
Task_18023,2195,454,16,68,84,4.824175824175824,42.11021749397229
Task_18024,1597,993,21,106,127,1.6066398390342052,35.17337923344131
Task_18025,1116,998,176,56,232,1.117117117117117,27.737322592237163
Task_18026,1291,636,107,37,144,2.0266875981161694,28.555622762242873
Task_18027,2779,782,87,18,105,3.549169859514687,51.93631923233543
Task_18028,2197,672,146,167,313,3.264487369985141,44.89469907999154
Task_18029,987,942,13,31,44,1.0466595970307528,23.72339305718258
Task_18030,2654,761,116,41,157,3.4829396325459316,50.53766479266625
Task_18031,2468,521,152,71,223,4.727969348659004,47.7239045555699
Task_18032,2915,75,197,118,315,38.35526315789474,53.12946252608628
Task_18033,848,607,64,114,178,1.394736842105263,22.515711496893996
Task_18034,794,983,89,17,106,0.806910569105691,21.24611373415794
Task_18035,2081,964,68,22,90,2.1564766839378238,41.52598730290609
Task_18036,836,222,171,11,182,3.7488789237668163,20.119920526186053
Task_18037,1218,891,150,93,243,1.3654708520179373,29.517795299676948
Task_18038,2213,323,96,66,162,6.830246913580247,42.511164703780786
Task_18039,2554,435,31,109,140,5.8577981651376145,48.65163713800383
Task_18040,1139,734,101,13,114,1.5496598639455783,26.01417474136682
Task_18041,2865,491,145,144,289,5.823170731707317,54.75220691899693
Task_18042,2380,406,150,33,183,5.847665847665848,45.307160818718266
Task_18043,1120,106,175,133,308,10.467289719626168,25.206248544200722
Task_18044,1512,293,173,26,199,5.142857142857143,31.40589799117021
Task_18045,2338,824,144,130,274,2.833939393939394,47.37558079833567
Task_18046,2547,81,63,128,191,31.0609756097561,46.99490098389476
Task_18047,966,654,50,97,147,1.4748091603053435,24.40101955177543
Task_18048,1549,905,106,118,224,1.7097130242825607,34.87029368747242
Task_18049,2540,320,35,124,159,7.912772585669782,48.13737265023133
Task_18050,1463,600,118,34,152,2.4342762063227954,31.149348152165402
Task_18051,1587,124,109,190,299,12.696,32.95270293175019
Task_18052,991,294,114,70,184,3.359322033898305,23.237017129513266
Task_18053,1261,652,169,158,327,1.9310872894333844,30.056535179888936
Task_18054,1403,660,133,176,309,2.122541603630862,32.27589692335004
Task_18055,910,733,159,153,312,1.2397820163487738,24.550580388317968
Task_18056,1904,961,161,112,273,1.9792099792099793,40.89503609619704
Task_18057,1853,407,64,69,133,4.541666666666667,37.15696475656756
Task_18058,1821,954,115,153,268,1.9068062827225132,39.59560443079716
Task_18059,1486,142,29,81,110,10.391608391608392,29.795750357400024
Task_18060,1125,218,184,189,373,5.136986301369863,26.766752491632634
Task_18061,1414,810,199,23,222,1.7435265104808877,31.568944584968424
Task_18062,2511,581,103,47,150,4.314432989690721,47.66463775473489
Task_18063,1725,250,92,158,250,6.872509960159363,35.8332084826733
Task_18064,600,632,31,186,217,0.9478672985781991,18.928559070741304
Task_18065,676,200,144,189,333,3.36318407960199,19.436654994545044
Task_18066,2072,314,156,178,334,6.5777777777777775,41.86945435965589
Task_18067,2033,439,173,52,225,4.620454545454545,40.57785750941105
Task_18068,1953,1023,96,175,271,1.9072265625,42.00031076204879
Task_18069,1011,742,40,175,215,1.360699865410498,25.782138169017742
Task_18070,1100,505,146,99,245,2.1739130434782608,26.575851743662184
Task_18071,1834,638,153,119,272,2.8701095461658843,38.78300444042038
Task_18072,2866,336,166,173,339,8.504451038575668,54.517026321747096
Task_18073,2667,870,157,121,278,3.0619977037887485,52.737147326146136
Task_18074,851,120,109,70,179,7.033057851239669,19.96508398585564
Task_18075,2284,234,82,112,194,9.719148936170212,44.301547040734874
Task_18076,1639,238,87,130,217,6.857740585774058,34.1735668563096
Task_18077,2214,732,62,16,78,3.020463847203274,42.27640737504019
Task_18078,1854,445,151,172,323,4.15695067264574,38.79399350977896
Task_18079,704,992,145,104,249,0.7089627391742196,21.887779852379992
Task_18080,2529,554,24,65,89,4.556756756756757,47.738323796268
Task_18081,800,390,181,133,314,2.0460358056265986,21.840984447688925
Task_18082,673,664,21,181,202,1.0120300751879698,19.995751236786692
Task_18083,1529,384,140,116,256,3.9714285714285715,33.06984825208293
Task_18084,696,280,75,69,144,2.4768683274021353,18.421262277141192
Task_18085,1163,629,25,176,201,1.8460317460317461,27.939656429541344
Task_18086,1814,723,192,154,346,2.505524861878453,39.117730442901404
Task_18087,2295,510,24,47,71,4.4911937377690805,43.062331197052
Task_18088,1863,287,133,45,178,6.46875,36.655056719657296
Task_18089,2539,980,182,38,220,2.588175331294597,50.01870867427607
Task_18090,2991,374,41,169,210,7.976,56.05020567344369
Task_18091,1947,413,11,147,158,4.702898550724638,39.075374484454294
Task_18092,556,995,97,77,174,0.5582329317269076,18.873921331738813
Task_18093,1394,847,42,175,217,1.6438679245283019,32.29987204591305
Task_18094,713,912,22,111,133,0.7809419496166484,20.874817881299627
Task_18095,2530,718,141,178,319,3.5187760778859527,50.35763581445258
Task_18096,1987,923,109,76,185,2.1504329004329006,41.13090811803247
Task_18097,2122,821,22,123,145,2.5815085158150852,43.059857316549376
Task_18098,1945,930,66,78,144,2.0891514500537056,40.45164710549411
Task_18099,1501,662,67,63,130,2.26395173453997,32.36409230398079
Task_18100,1447,266,128,84,212,5.419475655430712,30.844469360453065
Task_18101,630,695,87,37,124,0.9051724137931034,18.14070994620312
Task_18102,1264,862,116,29,145,1.4646581691772886,28.90282192770861
Task_18103,755,123,170,172,342,6.088709677419355,20.023247517231866
Task_18104,1330,319,144,42,186,4.15625,28.456137525541134
Task_18105,2478,327,128,54,182,7.554878048780488,46.82714438866008
Task_18106,1800,77,71,86,157,23.076923076923077,34.53721491592544
Task_18107,2092,583,57,64,121,3.5821917808219177,41.363345973548505
Task_18108,2072,469,59,12,71,4.408510638297872,39.13042210131629
Task_18109,951,411,82,184,266,2.308252427184466,24.24755807650084
Task_18110,1872,786,94,83,177,2.3786531130876747,38.96171890123571
Task_18111,2711,622,107,200,307,4.351524879614767,52.89860969618841
Task_18112,2175,1004,66,65,131,2.1641791044776117,44.14662069556531
Task_18113,1780,316,40,166,206,5.615141955835962,36.67675798447221
Task_18114,583,794,160,113,273,0.7333333333333333,19.385933239711125
Task_18115,2973,933,49,40,89,3.1830835117773018,55.56717467782416
Task_18116,1119,680,39,197,236,1.6431718061674008,27.540688831308895
Task_18117,2349,483,136,67,203,4.853305785123967,45.6162514540153
Task_18118,1815,916,114,152,266,1.9792802617230099,39.37194022412887
Task_18119,2504,189,106,193,299,13.178947368421053,48.11232980094179
Task_18120,2762,525,177,181,358,5.250950570342205,53.59714130864745
Task_18121,2122,651,182,89,271,3.254601226993865,43.14942683042714
Task_18122,2395,202,91,151,242,11.798029556650246,46.16152137766719
Task_18123,1906,554,50,17,67,3.4342342342342342,36.759427680807924
Task_18124,597,704,142,29,171,0.8468085106382979,17.97176718935028
Task_18125,2150,882,175,104,279,2.434881087202718,44.56245971342764
Task_18126,1336,968,78,131,209,1.3787409700722395,31.72202303543622
Task_18127,1091,258,80,64,144,4.212355212355212,24.55392740450569
Task_18128,2452,459,67,155,222,5.3304347826086955,47.946594741597465
Task_18129,2828,115,111,98,209,24.379310344827587,51.795261154918684
Task_18130,936,968,18,12,30,0.9659442724458205,22.731586863513854
Task_18131,1584,159,95,38,133,9.9,31.42650235871383
Task_18132,961,953,53,131,184,1.0073375262054507,25.30709731193601
Task_18133,2833,457,133,171,304,6.185589519650655,54.24151260431686
Task_18134,1689,138,79,158,237,12.151079136690647,34.4593023297865
Task_18135,1251,350,91,111,202,3.5641025641025643,28.360394961849142
Task_18136,2458,877,146,53,199,2.7995444191343966,48.58432081046047
Task_18137,877,604,99,52,151,1.449586776859504,22.141221629634273
Task_18138,1703,1010,115,130,245,1.6844708209693373,37.74871774139847
Task_18139,1302,912,129,161,290,1.4260679079956189,31.283774633804793
Task_18140,572,100,147,34,181,5.663366336633663,15.135927649798985
Task_18141,704,573,73,57,130,1.2264808362369337,19.313675582067052
Task_18142,2642,324,175,23,198,8.12923076923077,49.355722908326214
Task_18143,1574,603,63,80,143,2.6059602649006623,33.565117626508254
Task_18144,2170,711,112,83,195,3.047752808988764,43.63946538739939
Task_18145,980,814,124,26,150,1.2024539877300613,24.149757577013066
Task_18146,2886,935,197,28,225,3.0833333333333335,55.33349868451209
Task_18147,1377,991,38,73,111,1.3881048387096775,31.15918192933715
Task_18148,1978,488,127,182,309,4.044989775051125,40.84654373933012
Task_18149,2981,215,141,177,318,13.800925925925926,55.7969422173558
Task_18150,2394,378,37,91,128,6.316622691292876,45.98742557697195
Task_18151,1954,1004,143,44,187,1.944278606965174,40.58583916491754
Task_18152,990,611,18,127,145,1.6176470588235294,24.47813922678684
Task_18153,2765,908,95,193,288,3.041804180418042,54.62963213827543
Task_18154,2468,685,137,107,244,3.597667638483965,48.82930372064586
Task_18155,2827,352,156,188,344,8.008498583569406,53.999917501064566
Task_18156,2487,536,191,88,279,4.631284916201118,48.534125461067326
Task_18157,713,391,14,185,199,1.8188775510204083,20.067904822382232
Task_18158,2447,623,100,10,110,3.921474358974359,46.39869946177162
Task_18159,572,310,20,124,144,1.8392282958199357,16.884076237153245
Task_18160,794,963,56,107,163,0.8236514522821576,22.63192289790531
Task_18161,2600,313,158,183,341,8.280254777070065,50.25399691014297
Task_18162,1485,560,39,35,74,2.6470588235294117,30.361314899055316
Task_18163,2306,744,66,78,144,3.0953020134228186,45.59023589249505
Task_18164,1594,495,81,125,206,3.213709677419355,34.345752145706754
Task_18165,2629,493,98,71,169,5.321862348178137,49.761339562012274
Task_18166,2430,280,22,140,162,8.647686832740213,46.27738528382022
Task_18167,2409,358,101,147,248,6.710306406685237,46.91539050351427
Task_18168,1424,485,127,106,233,2.9300411522633745,31.61295060420362
Task_18169,2552,470,180,48,228,5.418259023354564,48.62440211064813
Task_18170,1014,686,147,19,166,1.4759825327510918,24.27790075052737
Task_18171,2293,1011,88,105,193,2.265810276679842,46.863707158316664
Task_18172,2683,229,48,76,124,11.665217391304347,49.75913448447401
Task_18173,2329,222,12,129,141,10.443946188340806,44.35705342199037
Task_18174,2337,454,193,73,266,5.136263736263737,45.65908074698816
Task_18175,1728,460,69,96,165,3.7483731019522777,36.11395566263229
Task_18176,1751,924,159,125,284,1.892972972972973,38.424233074878636
Task_18177,1452,600,76,57,133,2.415973377703827,31.28875535116103
Task_18178,2831,694,151,115,266,4.073381294964029,54.718561720492424
Task_18179,1525,777,45,145,190,1.9601542416452442,33.98056609812593
Task_18180,1577,627,141,26,167,2.511146496815287,33.19115804400673
Task_18181,1364,983,196,101,297,1.386178861788618,32.4298078496255
Task_18182,2236,726,66,107,173,3.075653370013755,45.01451299718119
Task_18183,1092,551,82,148,230,1.9782608695652173,26.704938475721317
Task_18184,1315,800,124,67,191,1.6416978776529338,30.18895119852425
Task_18185,618,132,73,33,106,4.646616541353383,15.45281232948387
Task_18186,1255,674,19,85,104,1.8592592592592592,28.325137314702392
Task_18187,692,967,79,83,162,0.7148760330578512,20.86632996889333
Task_18188,1885,453,14,57,71,4.151982378854625,36.69396464771939
Task_18189,704,1015,89,26,115,0.6929133858267716,20.389900268055733
Task_18190,1899,400,130,121,251,4.7356608478802995,38.961042597271394
Task_18191,1871,250,130,13,143,7.4541832669322705,36.30835990805294
Task_18192,2523,268,110,148,258,9.37918215613383,48.451473827944824
Task_18193,1685,661,155,67,222,2.5453172205438066,35.75277032548498
Task_18194,1211,216,163,63,226,5.580645161290323,26.809456399239664
Task_18195,898,482,36,43,79,1.8592132505175984,20.98113172340783
Task_18196,2187,946,27,116,143,2.309398099260824,44.49529502417584
Task_18197,569,968,49,25,74,0.587203302373581,17.477208671199225
Task_18198,2885,182,60,71,131,15.765027322404372,52.70709929603748
Task_18199,1242,786,103,186,289,1.5781448538754765,29.999863518252408
Task_18200,918,372,48,64,112,2.46112600536193,22.032132549025913
Task_18201,1572,365,44,134,178,4.295081967213115,33.195144589684254
Task_18202,2451,94,95,11,106,25.8,43.90612514190142
Task_18203,2343,556,117,97,214,4.206463195691203,46.32387563332595
Task_18204,2501,135,190,141,331,18.389705882352942,47.478513488821285
Task_18205,1159,342,128,77,205,3.379008746355685,26.435127488877196
Task_18206,552,940,43,119,162,0.5866099893730075,18.681623924987573
Task_18207,729,598,167,94,261,1.2170283806343907,20.88831069302908
Task_18208,1010,379,199,19,218,2.6578947368421053,23.64310296227642
Task_18209,2079,617,198,148,346,3.3640776699029127,42.97305623317468
Task_18210,2488,291,190,160,350,8.520547945205479,48.41277150090436
Task_18211,789,769,164,122,286,1.0246753246753246,22.570027758527516
Task_18212,2606,887,192,104,296,2.934684684684685,51.88001199688688
Task_18213,1737,586,78,133,211,2.959114139693356,36.959297040302935
Task_18214,1027,916,89,33,122,1.1199563794983642,25.04821287802496
Task_18215,1195,966,164,153,317,1.235780765253361,29.81064481366703
Task_18216,2675,299,160,27,187,8.916666666666666,49.70705321436599
Task_18217,1615,71,73,17,90,22.430555555555557,30.054078261083912
Task_18218,713,339,103,147,250,2.097058823529412,20.03534312930387
Task_18219,1777,404,18,15,33,4.387654320987655,33.98409133813574
Task_18220,2151,887,133,83,216,2.4222972972972974,43.98581136533721
Task_18221,619,753,46,68,114,0.8209549071618037,18.475189766601726
Task_18222,604,170,144,171,315,3.5321637426900585,17.743099014873838
Task_18223,1895,341,193,193,386,5.54093567251462,39.41746093238614
Task_18224,626,789,157,199,356,0.7924050632911392,20.576873282296102
Task_18225,1543,583,180,142,322,2.642123287671233,34.26044740479311
Task_18226,1214,753,60,178,238,1.610079575596817,29.36940811284207
Task_18227,2578,748,85,150,235,3.4419225634178905,50.840201295750376
Task_18228,2597,872,158,170,328,2.974799541809851,51.93145938932088
Task_18229,1021,744,79,49,128,1.3704697986577181,24.792912739246564
Task_18230,2590,101,189,59,248,25.392156862745097,47.58709438974435
Task_18231,976,998,56,128,184,0.9769769769769769,25.73662717256131
Task_18232,1938,285,89,134,223,6.776223776223776,39.12654869977767
Task_18233,2170,341,162,22,184,6.345029239766082,41.68680445416227
Task_18234,1769,593,113,158,271,2.978114478114478,37.66449222161304
Task_18235,1911,78,84,167,251,24.189873417721518,37.24037298613202
Task_18236,964,195,54,35,89,4.918367346938775,21.444945092033084
Task_18237,2794,823,68,79,147,3.3907766990291264,53.5989343178675
Task_18238,1588,329,80,39,119,4.8121212121212125,32.0328415882
Task_18239,2535,714,143,12,155,3.5454545454545454,48.38233222348003
Task_18240,1656,681,51,46,97,2.4281524926686218,33.97601483299655
Task_18241,850,307,140,31,171,2.75974025974026,20.69874142885422
Task_18242,1543,219,143,55,198,7.013636363636364,31.95986575252242
Task_18243,2429,224,156,34,190,10.795555555555556,45.647241146280415
Task_18244,2915,876,40,72,112,3.3238312428734322,55.2825844069208
Task_18245,2542,887,130,55,185,2.8626126126126126,49.7281587241059
Task_18246,2722,487,127,155,282,5.577868852459017,52.45996633289599
Task_18247,2634,982,46,86,132,2.6795523906408953,51.535879649609434
Task_18248,1450,673,37,68,105,2.1513353115727,31.234526964465385
Task_18249,2238,401,31,14,45,5.567164179104478,41.4814248909089
Task_18250,2472,397,187,19,206,6.211055276381909,46.77980612161627
Task_18251,927,202,52,190,242,4.566502463054187,23.16653743467474
Task_18252,2623,691,85,31,116,3.790462427745665,49.56481560364742
Task_18253,2108,225,144,12,156,9.327433628318584,40.01851385369983
Task_18254,815,529,107,107,214,1.5377358490566038,21.982873593791954
Task_18255,1853,141,44,119,163,13.049295774647888,36.348385626778715
Task_18256,1357,325,168,21,189,4.162576687116564,28.910010190835294
Task_18257,639,815,170,188,358,0.7830882352941176,20.84059822367143
Task_18258,1840,348,73,36,109,5.2722063037249285,36.050032146125936
Task_18259,1328,577,192,171,363,2.2975778546712804,31.064224265859696
Task_18260,1983,463,58,48,106,4.273706896551724,38.45557849425017
Task_18261,2946,862,142,195,337,3.413673232908459,57.50711377875164
Task_18262,1990,144,84,28,112,13.724137931034482,37.25792061812032
Task_18263,1827,112,58,127,185,16.168141592920353,35.73448321189051
Task_18264,2071,666,105,94,199,3.1049475262368817,42.20368330823978
Task_18265,2024,811,29,83,112,2.4926108374384235,41.1087814620631
Task_18266,1048,268,93,72,165,3.895910780669145,24.237026132008634
Task_18267,2927,818,31,200,231,3.573870573870574,56.632682455381484
Task_18268,1636,325,77,31,108,5.0184049079754605,32.71529334201164
Task_18269,1376,92,84,77,161,14.795698924731182,27.680654363961107
Task_18270,2721,581,173,91,264,4.675257731958763,52.42633594827888
Task_18271,797,72,58,50,108,10.917808219178083,17.60761025289931
Task_18272,2809,521,30,144,174,5.381226053639847,53.42406109041235
Task_18273,648,778,58,73,131,0.8318356867779204,19.346090174617895
Task_18274,576,325,197,63,260,1.7668711656441718,17.276373875774617
Task_18275,1354,231,55,62,117,5.836206896551724,28.404021391104507
Task_18276,1295,854,38,119,157,1.5146198830409356,30.055241327587925
Task_18277,2208,414,75,73,148,5.320481927710843,42.86783210923797
Task_18278,1326,605,52,82,134,2.1881188118811883,29.721161350008327
Task_18279,659,850,200,77,277,0.7743830787309048,20.455730044652928
Task_18280,2249,169,195,142,337,13.229411764705882,43.81814104715141
Task_18281,2807,182,185,73,258,15.33879781420765,52.08967532948996
Task_18282,1126,448,52,42,94,2.507795100222717,24.84196238659412
Task_18283,2337,693,85,179,264,3.367435158501441,47.02251309412389
Task_18284,1899,225,88,188,276,8.402654867256636,38.595618390778185
Task_18285,748,913,131,162,293,0.8183807439824945,22.5074906451736
Task_18286,1909,484,42,174,216,3.936082474226804,39.32418077863958
Task_18287,527,919,161,59,220,0.5728260869565217,18.28092295065586
Task_18288,2518,536,14,19,33,4.68901303538175,46.16813163116757
Task_18289,2720,797,69,166,235,3.408521303258145,53.34156904176771
Task_18290,966,394,105,164,269,2.4455696202531647,24.32284075273435
Task_18291,690,258,54,115,169,2.664092664092664,18.971391446002333
Task_18292,2088,342,163,131,294,6.087463556851312,41.96791073715159
Task_18293,689,603,145,146,291,1.140728476821192,20.58291008494388
Task_18294,725,97,180,88,268,7.3979591836734695,18.50895515341315
Task_18295,1778,427,148,187,335,4.154205607476635,37.60918151068682
Task_18296,1261,338,145,46,191,3.71976401179941,27.58065478688584
Task_18297,545,859,99,77,176,0.6337209302325582,18.171663348248728
Task_18298,1973,324,11,78,89,6.070769230769231,38.31595147363577
Task_18299,2057,678,120,79,199,3.0294550810014726,41.76043385328244
Task_18300,1473,657,35,42,77,2.2386018237082066,30.4919703937681
Task_18301,2874,783,155,162,317,3.6658163265306123,55.97954906596866
Task_18302,2496,965,25,111,136,2.5838509316770186,49.42683110544258
Task_18303,2128,772,139,166,305,2.7529107373868045,44.078243250455614
Task_18304,1773,409,14,113,127,4.324390243902439,36.215675070906805
Task_18305,2531,915,60,151,211,2.763100436681223,50.59290178908325
Task_18306,1842,379,86,149,235,4.847368421052631,38.00149814309441
Task_18307,2420,91,39,34,73,26.304347826086957,42.93281369725579
Task_18308,756,387,143,162,305,1.9484536082474226,21.137280011455708
Task_18309,2440,500,173,43,216,4.870259481037924,46.87992637721086
Task_18310,1683,376,137,163,300,4.464190981432361,35.74756155580978
Task_18311,1192,167,187,71,258,7.095238095238095,26.32334673152292
Task_18312,1184,214,32,94,126,5.506976744186047,26.288094459342986
Task_18313,763,646,156,180,336,1.179289026275116,22.141051077288775
Task_18314,2517,882,153,58,211,2.8505096262740657,49.49176606132727
Task_18315,2850,263,19,89,108,10.795454545454545,52.31383456050014
Task_18316,1127,804,134,158,292,1.4,28.1806315048152
Task_18317,1841,588,128,180,308,3.1256366723259763,38.987923222643964
Task_18318,1166,217,31,163,194,5.348623853211009,26.60106251875604
Task_18319,2563,219,24,66,90,11.65,47.119989348890904
Task_18320,1739,250,30,106,136,6.9282868525896415,35.13643334796185
Task_18321,2593,929,95,49,144,2.7881720430107526,50.251741256613265
Task_18322,2291,892,70,136,206,2.5655095184770436,46.68613110923983
Task_18323,2029,1020,151,146,297,1.9872673849167484,43.21721649540414
Task_18324,515,855,86,161,247,0.6016355140186916,18.69848745863918
Task_18325,2258,118,186,134,320,18.974789915966387,43.4727663807267
Task_18326,904,259,177,153,330,3.476923076923077,23.166733334957787
Task_18327,2376,973,171,44,215,2.439425051334702,47.34345439969082
Task_18328,2616,178,45,96,141,14.614525139664805,48.126604800632556
Task_18329,2151,973,136,23,159,2.208418891170431,43.20427814217146
Task_18330,1605,637,23,65,88,2.5156739811912225,33.41730654533317
Task_18331,1501,429,60,169,229,3.4906976744186045,32.85564334734791
Task_18332,1627,136,80,116,196,11.875912408759124,33.23572784097417
Task_18333,860,999,28,45,73,0.86,21.91993554090278
Task_18334,1502,714,53,46,99,2.1006993006993007,31.5681183795049
Task_18335,1895,450,192,37,229,4.201773835920178,38.17332207050689
Task_18336,2323,267,157,79,236,8.667910447761194,44.793914615574295
Task_18337,1502,381,132,85,217,3.931937172774869,32.13695184839001
Task_18338,2544,116,36,151,187,21.743589743589745,47.220925454508524
Task_18339,1200,858,195,101,296,1.3969732246798603,29.439206994814118
Task_18340,1817,681,42,150,192,2.664222873900293,38.347339816611246
Task_18341,1490,714,160,62,222,2.0839160839160837,32.77074136264409
Task_18342,2744,186,186,52,238,14.67379679144385,51.240741517352404
Task_18343,1593,445,183,143,326,3.571748878923767,34.63403382669249
Task_18344,1661,487,64,198,262,3.403688524590164,35.76467623249396
Task_18345,1446,565,129,81,210,2.5547703180212014,31.75042130426378
Task_18346,2010,992,10,148,158,2.02416918429003,41.899046405850214
Task_18347,2717,547,81,164,245,4.958029197080292,52.52505007953778
Task_18348,2275,91,159,183,342,24.72826086956522,43.52663687346169
Task_18349,1183,635,137,162,299,1.860062893081761,28.647740546878264
Task_18350,2054,480,164,167,331,4.27027027027027,42.10113101404202
Task_18351,1740,203,154,57,211,8.529411764705882,34.999302724764526
Task_18352,2261,257,167,103,270,8.763565891472869,44.25940969138136
Task_18353,1917,929,197,185,382,2.0612903225806454,41.59982680693662
Task_18354,1104,437,173,93,266,2.5205479452054793,26.460030353741157
Task_18355,2824,616,54,13,67,4.576985413290114,51.47572412738581
Task_18356,1515,511,72,78,150,2.958984375,32.28678428829532
Task_18357,2596,490,55,94,149,5.287169042769857,49.62623487195692
Task_18358,2902,419,189,51,240,6.90952380952381,54.277009488808595
Task_18359,1995,195,120,10,130,10.178571428571429,38.05254780072146
Task_18360,660,481,103,173,276,1.3692946058091287,19.736721647936317
Task_18361,2044,545,118,20,138,3.7435897435897436,39.91843541365328
Task_18362,685,808,18,176,194,0.8467243510506799,20.643730029805077
Task_18363,2264,836,13,74,87,2.7048984468339308,44.55625606297616
Task_18364,701,828,34,181,215,0.8455971049457177,21.094093835897095
Task_18365,2299,777,81,122,203,2.955012853470437,46.382433017402455
Task_18366,654,83,121,144,265,7.785714285714286,17.610894016319264
Task_18367,2492,404,97,39,136,6.153086419753087,46.768973308043655
Task_18368,2983,735,103,185,288,4.052989130434782,57.45788530923077
Task_18369,2313,272,189,144,333,8.472527472527473,45.47903466418726
Task_18370,628,392,132,191,323,1.5979643765903309,19.23795267557914
Task_18371,2277,858,40,152,192,2.650756693830035,46.19049216469123
Task_18372,778,400,100,67,167,1.940149625935162,20.151650035078394
Task_18373,2446,788,171,175,346,3.100126742712294,49.364327835029066
Task_18374,865,353,46,103,149,2.443502824858757,21.686628687799303
Task_18375,1447,322,98,42,140,4.479876160990712,29.959623876609538
Task_18376,2656,829,31,74,105,3.2,50.941302921365796
Task_18377,1374,531,192,16,208,2.582706766917293,29.89881286378194
Task_18378,2777,777,82,135,217,3.569408740359897,54.02605729046109
Task_18379,1386,459,144,46,190,3.0130434782608697,29.930972758146567
Task_18380,1413,417,14,91,105,3.3803827751196174,30.1502445732696
Task_18381,848,883,120,56,176,0.9592760180995475,22.867875447392866
Task_18382,2503,341,10,68,78,7.318713450292398,46.23524161163302
Task_18383,1764,932,100,188,288,1.8906752411575563,38.76546863171513
Task_18384,1210,516,126,65,191,2.3404255319148937,27.63154526920042
Task_18385,2472,215,196,156,352,11.444444444444445,47.88234927809109
Task_18386,2572,528,154,93,247,4.862003780718337,49.903945077914216
Task_18387,2448,862,192,138,330,2.836616454229432,49.50143299484446
Task_18388,1763,503,21,190,211,3.498015873015873,37.041282451972926
Task_18389,1880,114,187,155,342,16.347826086956523,37.549390325722314
Task_18390,1121,368,135,121,256,3.037940379403794,26.570657071008686
Task_18391,1627,770,82,10,92,2.1102464332036317,33.725270735449875
Task_18392,2136,576,187,172,359,3.701906412478336,43.83959595019368
Task_18393,2006,770,99,52,151,2.601815823605707,40.588072545720166
Task_18394,1888,898,180,60,240,2.100111234705228,39.69673520069994
Task_18395,2439,751,190,98,288,3.2433510638297873,48.76625010523292
Task_18396,560,807,191,74,265,0.693069306930693,18.843573234412105
Task_18397,818,342,174,121,295,2.3848396501457727,21.87033417828538
Task_18398,1974,538,159,56,215,3.6623376623376624,39.90863463432627
Task_18399,1623,1012,198,124,322,1.6021717670286277,36.82539132964451
Task_18400,2811,390,184,184,368,7.189258312020461,53.9781841985018
Task_18401,2724,243,72,164,236,11.163934426229508,51.586184435292274
Task_18402,557,182,72,95,167,3.0437158469945356,16.399132995788886
Task_18403,2511,191,49,132,181,13.078125,47.535688023341685
Task_18404,510,244,23,163,186,2.0816326530612246,16.22814541285318
Task_18405,1512,95,20,187,207,15.75,30.82552981584172
Task_18406,578,206,150,71,221,2.792270531400966,16.795965966312345
Task_18407,850,962,174,57,231,0.8826583592938733,23.45726000968128
Task_18408,1995,533,98,76,174,3.735955056179775,40.0708411862992
Task_18409,1529,672,184,123,307,2.2719167904903417,34.22245283380198
Task_18410,1580,286,158,87,245,5.505226480836237,33.207011002511145
Task_18411,792,739,83,91,174,1.0702702702702702,21.734235407401957
Task_18412,2004,320,61,115,176,6.242990654205608,39.98184130969584
Task_18413,2467,208,146,150,296,11.803827751196172,47.51465792528531
Task_18414,697,849,153,36,189,0.82,20.26160673954737
Task_18415,2038,969,47,59,106,2.1010309278350516,41.22325233990577
Task_18416,2892,674,170,49,219,4.2844444444444445,54.688684917505306
Task_18417,1943,804,147,184,331,2.413664596273292,41.39095543187006
Task_18418,2522,962,140,132,272,2.618899273104881,50.71604409037733
Task_18419,2950,333,78,128,206,8.832335329341317,55.30041907759972
Task_18420,1138,634,178,122,300,1.7921259842519686,27.877781122889832
Task_18421,1285,856,105,181,286,1.499416569428238,30.87763191651972
Task_18422,2288,798,129,74,203,2.8635794743429286,45.74300828554734
Task_18423,665,432,193,192,385,1.535796766743649,20.20048101170072
Task_18424,1775,569,144,75,219,3.1140350877192984,36.9634461357517
Task_18425,1165,701,87,99,186,1.6595441595441596,27.814221483135658
Task_18426,626,337,17,54,71,1.8520710059171597,16.37923376978867
Task_18427,2989,809,12,198,210,3.6901234567901233,57.45586971397956
Task_18428,2085,920,163,111,274,2.263843648208469,43.638664849135864
Task_18429,2502,119,108,101,209,20.85,46.77954025025216
Task_18430,1873,531,167,162,329,3.5206766917293235,39.38227472700067
Task_18431,591,357,92,58,150,1.6508379888268156,16.862934117566
Task_18432,2172,266,193,107,300,8.134831460674157,43.02627659878999
Task_18433,1792,655,96,120,216,2.731707317073171,37.97315074938538
Task_18434,1591,567,168,174,342,2.801056338028169,35.10720129548691
Task_18435,1831,155,123,196,319,11.737179487179487,37.125910160545466
Task_18436,1230,746,12,119,131,1.6465863453815262,28.675447499212257
Task_18437,1282,495,18,94,112,2.5846774193548385,28.48320469129017
Task_18438,2871,954,11,59,70,3.006282722513089,53.79146642101949
Task_18439,1184,891,19,68,87,1.3273542600896862,27.45213596259283
Task_18440,2135,88,53,185,238,23.98876404494382,40.88927823163038
Task_18441,636,828,136,41,177,0.767189384800965,19.031418604940423
Task_18442,2043,507,129,33,162,4.021653543307087,40.14467986934659
Task_18443,1127,393,88,144,232,2.8604060913705585,26.690680789412344
Task_18444,675,735,53,103,156,0.9171195652173914,19.846456452660707
Task_18445,515,224,41,121,162,2.2888888888888888,15.844065861767803
Task_18446,845,483,157,56,213,1.7458677685950412,21.84157153879332
Task_18447,951,644,130,176,306,1.4744186046511627,24.99956280315867
Task_18448,2061,743,29,161,190,2.7701612903225805,42.429951180175635
Task_18449,2209,219,163,154,317,10.040909090909091,43.58416081216962
Task_18450,718,405,168,91,259,1.7684729064039408,20.121731252693596
Task_18451,2332,941,157,103,260,2.475583864118896,47.5431938319339
Task_18452,1016,694,35,187,222,1.4618705035971222,25.795509010347544
Task_18453,1273,580,120,39,159,2.1910499139414803,28.087897010879143
Task_18454,1226,505,165,198,363,2.4229249011857705,29.262396010016143
Task_18455,2678,424,109,85,194,6.301176470588235,50.780884103270914
Task_18456,582,850,130,192,322,0.6839012925969448,20.00345898046224
Task_18457,1789,631,33,184,217,2.8306962025316458,37.9435154974632
Task_18458,819,590,172,27,199,1.385786802030457,21.37121051036266
Task_18459,1029,389,189,54,243,2.6384615384615384,24.569445992396847
Task_18460,967,179,71,58,129,5.372222222222222,21.943851447549804
Task_18461,1662,208,114,158,272,7.952153110047847,34.709326732350675
Task_18462,1931,342,15,17,32,5.629737609329446,36.28892720339209
Task_18463,2571,272,174,102,276,9.417582417582418,49.23827990586839
Task_18464,1029,793,53,88,141,1.2959697732997482,25.431990976957323
Task_18465,657,454,47,110,157,1.443956043956044,18.65379725754446
Task_18466,1069,397,57,88,145,2.685929648241206,25.017068853507684
Task_18467,1512,959,26,33,59,1.575,32.010680834046426
Task_18468,1281,706,198,57,255,1.811881188118812,29.569308748522804
Task_18469,1531,94,40,42,82,16.11578947368421,29.267619127746986
Task_18470,971,595,37,125,162,1.6291946308724832,24.232507506875937
Task_18471,901,66,29,64,93,13.447761194029852,19.45361250533438
Task_18472,951,208,163,63,226,4.55023923444976,22.67675542116773
Task_18473,948,237,114,55,169,3.9831932773109244,22.301972229267935
Task_18474,2950,477,164,106,270,6.171548117154812,55.91066303791879
Task_18475,1624,279,168,181,349,5.8,34.7395416625484
Task_18476,506,215,14,21,35,2.3425925925925926,13.509237920985633
Task_18477,590,281,71,55,126,2.0921985815602837,16.63905096798779
Task_18478,1473,479,65,89,154,3.06875,31.622721440602884
Task_18479,1658,787,196,91,287,2.1040609137055837,36.341893171139276
Task_18480,2205,876,156,111,267,2.514253135689852,45.371386401011456
Task_18481,2616,793,112,172,284,3.2947103274559195,51.78947683116428
Task_18482,1649,487,163,173,336,3.3790983606557377,35.74359809922453
Task_18483,2840,849,98,181,279,3.3411764705882354,55.51880055376995
Task_18484,2534,495,96,107,203,5.108870967741935,49.136182507392256
Task_18485,2378,694,64,83,147,3.42158273381295,46.589678913403496
Task_18486,1641,384,143,16,159,4.2623376623376625,33.151281357263656
Task_18487,1193,166,113,132,245,7.1437125748503,26.67354634395255
Task_18488,1621,475,162,146,308,3.4054621848739495,35.09634306005963
Task_18489,2552,657,41,122,163,3.878419452887538,49.56748567671048
Task_18490,678,274,155,11,166,2.4654545454545453,17.754209222615472
Task_18491,609,841,85,52,137,0.7232779097387173,18.861039193021725
Task_18492,990,817,45,59,104,1.2102689486552567,24.026043643647466
Task_18493,1623,770,122,45,167,2.105058365758755,34.36431058144816
Task_18494,2179,193,123,168,291,11.231958762886597,42.91829915797454
Task_18495,887,960,146,126,272,0.922996878251821,24.716973070766425
Task_18496,2223,613,155,40,195,3.6205211726384365,43.71722551735885
Task_18497,821,705,90,21,111,1.1628895184135977,21.010540465362116
Task_18498,2695,543,111,200,311,4.954044117647059,52.41038796514217
Task_18499,2460,830,86,55,141,2.96028880866426,47.93564315348673
Task_18500,2921,864,175,109,284,3.376878612716763,56.75233284737518
Task_18501,2492,896,88,159,247,2.778149386845039,49.98119756941514
Task_18502,1133,577,172,175,347,1.9602076124567474,27.910045939854438
Task_18503,1303,259,84,198,282,5.0115384615384615,29.36876201445847
Task_18504,2511,371,117,194,311,6.75,48.92559138557535
Task_18505,1514,646,135,45,180,2.340030911901082,32.30308549643468
Task_18506,1511,728,79,171,250,2.072702331961591,34.056457953567524
Task_18507,1339,394,111,74,185,3.389873417721519,29.206996742662053
Task_18508,1803,534,30,173,203,3.3700934579439252,37.772671785308106
Task_18509,2692,783,81,49,130,3.433673469387755,51.2585716671013
Task_18510,1187,695,98,23,121,1.7054597701149425,26.808434666070312
Task_18511,2858,976,160,55,215,2.925281473899693,55.288503917287805
Task_18512,1331,279,184,134,318,4.753571428571429,29.899608638346532
Task_18513,761,763,183,36,219,0.9960732984293194,21.17499650432064
Task_18514,2801,611,56,179,235,4.576797385620915,54.09226716920596
Task_18515,1729,619,25,146,171,2.7887096774193547,36.49859058586927
Task_18516,2384,495,37,87,124,4.806451612903226,45.97855602645196
Task_18517,972,556,146,190,336,1.7450628366247756,25.253927397167264
Task_18518,1903,845,198,118,316,2.2494089834515365,40.72076814068893
Task_18519,2983,741,20,99,119,4.020215633423181,56.2116571379293
Task_18520,790,568,111,45,156,1.3884007029876977,20.348688778375145
Task_18521,1836,109,107,136,243,16.69090909090909,36.2007655454443
Task_18522,982,1020,29,129,158,0.9618021547502449,25.528918432829602
Task_18523,988,203,47,93,140,4.8431372549019605,23.100777589590976
Task_18524,2308,962,12,161,173,2.3966770508826585,46.85527502543738
Task_18525,506,333,162,115,277,1.5149700598802396,16.774522827339094
Task_18526,1884,73,155,130,285,25.45945945945946,36.84218986207083
Task_18527,2307,791,139,58,197,2.912878787878788,45.816638527485395
Task_18528,2244,723,139,70,209,3.0994475138121547,44.74422638650422
Task_18529,2421,918,23,120,143,2.634385201305767,48.177034215214455
Task_18530,2312,791,100,129,229,2.919191919191919,46.65603325285601
Task_18531,982,774,189,133,322,1.2670967741935484,25.851371503276482
Task_18532,591,303,98,134,232,1.944078947368421,17.905506315712234
Task_18533,635,214,141,29,170,2.953488372093023,17.009298460318384
Task_18534,910,712,13,33,46,1.276297335203366,21.721232966419322
Task_18535,2324,690,162,146,308,3.3632416787264834,46.90975491897317
Task_18536,2863,353,114,135,249,8.087570621468927,54.06694382742853
Task_18537,1481,879,54,184,238,1.6829545454545454,34.031037864790925
Task_18538,1652,875,189,78,267,1.8858447488584476,36.259943635668584
Task_18539,2438,638,46,189,235,3.815336463223787,48.31939315299078
Task_18540,2889,521,67,12,79,5.5344827586206895,52.50158789137951
Task_18541,2003,316,193,151,344,6.318611987381703,40.79064579604322
Task_18542,1980,407,119,50,169,4.852941176470588,38.957489409098905
Task_18543,2075,135,90,32,122,15.257352941176471,38.650708962080316
Task_18544,2741,457,120,53,173,5.9847161572052405,51.53545384857449
Task_18545,773,155,147,194,341,4.955128205128205,20.546101149024448
Task_18546,2947,126,20,195,215,23.20472440944882,53.94228355299947
Task_18547,2063,183,22,134,156,11.21195652173913,39.85835531208964
Task_18548,1088,617,138,131,269,1.7605177993527508,26.892905612062773
Task_18549,2571,419,67,157,224,6.121428571428571,49.71073938977625
Task_18550,818,416,153,19,172,1.961630695443645,20.420655703136376
Task_18551,1339,99,14,162,176,13.39,27.956822098613213
Task_18552,2598,251,84,180,264,10.30952380952381,49.69552085710196
Task_18553,991,441,94,77,171,2.242081447963801,23.80885613962312
Task_18554,870,304,181,102,283,2.8524590163934427,22.489032534879232
Task_18555,2427,315,103,48,151,7.680379746835443,45.48567558668439
Task_18556,2230,654,92,119,211,3.404580152671756,44.90803898694933
Task_18557,2006,231,81,65,146,8.64655172413793,38.950800224007864
Task_18558,2825,900,59,78,137,3.1354051054384016,54.337166905418144
Task_18559,2815,1010,23,137,160,2.7843719090009893,54.79078807807093
Task_18560,2022,195,84,196,280,10.316326530612244,40.42394096833578
Task_18561,2524,825,119,46,165,3.055690072639225,48.945913657286575
Task_18562,1188,889,117,87,204,1.3348314606741574,28.68778880419813
Task_18563,2087,426,159,59,218,4.887587822014051,41.25537167409888
Task_18564,1718,496,126,176,302,3.456740442655936,36.71574327696503
Task_18565,1953,670,85,181,266,2.910581222056632,40.879612455380645
Task_18566,2441,867,70,182,252,2.8122119815668203,49.25953329614114
Task_18567,810,925,100,14,114,0.8747300215982722,21.479573774416867
Task_18568,804,429,129,100,229,1.869767441860465,21.595677389700196
Task_18569,858,208,64,154,218,4.105263157894737,21.894967694958556
Task_18570,2289,562,88,10,98,4.065719360568384,43.56565339380285
Task_18571,962,340,102,102,204,2.8211143695014664,23.703558430025026
Task_18572,871,754,34,42,76,1.1536423841059602,21.336461910142194
Task_18573,2174,472,59,194,253,4.5961945031712474,43.81761184153621
Task_18574,2488,371,162,103,265,6.688172043010753,48.22099924506827
Task_18575,1448,823,108,118,226,1.7572815533980584,33.02423333192643
Task_18576,813,873,163,53,216,0.9302059496567505,22.66727149278862
Task_18577,1599,745,169,74,243,2.14343163538874,34.84218127493708
Task_18578,2920,607,157,120,277,4.802631578947368,55.90821124870539
Task_18579,979,403,147,120,267,2.4232673267326734,24.483573165580072
Task_18580,1283,703,93,54,147,1.8224431818181819,29.037610868515383
Task_18581,2591,856,103,74,177,3.0233372228704782,50.40979223521759
Task_18582,929,1009,71,182,253,0.9198019801980198,25.59959613176342
Task_18583,1861,170,73,40,113,10.883040935672515,35.43605752862497
Task_18584,960,680,50,24,74,1.4096916299559472,22.412123111371827
Task_18585,2632,68,132,66,198,38.14492753623188,47.551200776735904
Task_18586,1114,826,11,25,36,1.347037484885127,25.04420475743974
Task_18587,1957,268,87,73,160,7.275092936802974,38.24676422753769
Task_18588,991,707,63,82,145,1.3997175141242937,24.65112899453489
Task_18589,1174,988,32,195,227,1.187057633973711,29.23198786081619
Task_18590,2572,341,36,182,218,7.52046783625731,49.36098839707024
Task_18591,890,307,48,139,187,2.8896103896103895,22.522504857805828
Task_18592,2713,106,31,86,117,25.35514018691589,48.761558586384076
Task_18593,897,976,189,62,251,0.9181166837256909,24.370922190478623
Task_18594,1800,536,200,21,221,3.35195530726257,36.773144519611776
Task_18595,2745,354,89,45,134,7.732394366197183,50.58222439533588
Task_18596,2472,322,139,100,239,7.6532507739938085,47.67972248089537
Task_18597,2739,219,114,35,149,12.45,50.098630984687
Task_18598,727,844,152,164,316,0.8603550295857988,22.07652070709132
Task_18599,1305,297,141,151,292,4.379194630872483,29.45616529911163
Task_18600,1182,289,86,41,127,4.075862068965518,25.592179819174245
Task_18601,1303,448,191,74,265,2.9020044543429844,29.32060901793143
Task_18602,616,458,160,119,279,1.3420479302832244,18.92373203259606
Task_18603,2631,140,147,121,268,18.659574468085108,49.30468148459048
Task_18604,2444,277,200,88,288,8.79136690647482,47.0305539334286
Task_18605,1107,137,110,157,267,8.021739130434783,25.327309164632595
Task_18606,1289,618,124,171,295,2.0823909531502425,30.268576405228472
Task_18607,1000,212,78,129,207,4.694835680751174,24.0670017187836
Task_18608,1792,641,194,104,298,2.791277258566978,38.22243073968439
Task_18609,2775,885,47,100,147,3.1320541760722347,53.626515365889865
Task_18610,1404,553,171,194,365,2.5342960288808665,32.23498733429981
Task_18611,2986,998,94,178,272,2.988988988988989,58.33248044917048
Task_18612,1002,507,148,47,195,1.9724409448818898,24.046450260227658
Task_18613,2146,104,63,170,233,20.438095238095237,41.0820551802197
Task_18614,1771,591,57,148,205,2.991554054054054,37.536407132695125
Task_18615,727,203,130,16,146,3.5637254901960786,18.113351001082478
Task_18616,2469,341,38,65,103,7.219298245614035,46.276006798534645
Task_18617,1410,940,123,91,214,1.4984059511158343,32.51626624247347
Task_18618,2398,728,63,124,187,3.2894375857338822,47.71470500021621
Task_18619,1667,895,38,175,213,1.8604910714285714,36.76879854653115
Task_18620,2551,238,80,192,272,10.673640167364017,49.03787692293372
Task_18621,2697,995,15,117,132,2.7078313253012047,52.74534788469895
Task_18622,2778,696,15,44,59,3.985652797704448,51.311374606507506
Task_18623,799,647,176,34,210,1.2330246913580247,21.33137053001438
Task_18624,1460,432,175,152,327,3.371824480369515,32.505152350773336
Task_18625,793,81,86,185,271,9.670731707317072,19.885821199455368
Task_18626,1106,756,18,120,138,1.4610303830911493,26.565756426674593
Task_18627,2686,740,87,127,214,3.624831309041835,52.35873887665854
Task_18628,1060,325,189,109,298,3.2515337423312882,25.639127408156124
Task_18629,2869,653,44,195,239,4.386850152905199,55.19953970237393
Task_18630,1921,953,164,78,242,2.0136268343815513,40.65222465265047
Task_18631,1825,483,83,97,180,3.770661157024793,37.61666996910083
Task_18632,659,357,33,150,183,1.8407821229050279,18.809715622971044
Task_18633,1910,418,155,147,302,4.558472553699284,39.461654407913514
Task_18634,2886,912,180,176,356,3.1610076670317633,56.77087941513317
Task_18635,1106,668,145,84,229,1.6532137518684604,26.798153047652324
Task_18636,2145,281,177,12,189,7.6063829787234045,41.19712437881383
Task_18637,1723,263,85,43,128,6.526515151515151,34.20002858635815
Task_18638,2677,282,66,120,186,9.459363957597173,50.56328673857536
Task_18639,1929,843,58,15,73,2.2855450236966823,38.00314650869213
Task_18640,2054,912,171,15,186,2.249726177437021,41.622392894188636
Task_18641,2713,969,35,127,162,2.796907216494845,53.02308233326639
Task_18642,709,554,148,135,283,1.2774774774774775,20.685091817127667
Task_18643,727,717,160,171,331,1.0125348189415042,21.690640764795784
Task_18644,1948,319,151,76,227,6.0875,38.9323596775937
Task_18645,1323,642,164,40,204,2.057542768273717,29.59509002085296
Task_18646,675,756,67,74,141,0.8916776750330251,19.713107475267783
Task_18647,2987,835,183,197,380,3.5729665071770333,58.26867840250645
Task_18648,2179,951,78,127,205,2.2888655462184873,45.06789057614213
Task_18649,2298,870,119,10,129,2.6383467278989667,45.07753943583907
Task_18650,1109,198,182,96,278,5.57286432160804,25.950579041433343
Task_18651,1992,356,68,79,147,5.579831932773109,39.406297809357454
Task_18652,2857,125,52,36,88,22.674603174603174,50.41583275729698
Task_18653,1685,525,116,180,296,3.203422053231939,36.26426894080785
Task_18654,2447,878,81,97,178,2.783845278725825,48.75469398770889
Task_18655,864,766,182,178,360,1.1264667535853976,24.14134512917025
Task_18656,2196,509,23,16,39,4.305882352941176,41.15160084277813
Task_18657,2232,577,62,177,239,3.86159169550173,44.95745233973086
Task_18658,1334,672,43,117,160,1.9821693907875186,30.160185893050564
Task_18659,2670,640,96,150,246,4.1653666146645865,52.01114995136163
Task_18660,1010,456,75,86,161,2.210065645514223,24.237073420912353
Task_18661,1586,882,114,182,296,1.7961494903737258,35.81687289925204
Task_18662,1601,500,48,128,176,3.1956087824351296,34.20509315557762
Task_18663,2143,655,117,191,308,3.2667682926829267,43.99843732605762
Task_18664,999,494,197,149,346,2.018181818181818,25.485640270791134
Task_18665,2479,971,176,190,366,2.5504115226337447,50.57138847300897
Task_18666,2687,117,49,162,211,22.771186440677965,49.82074264537436
Task_18667,1280,312,152,84,236,4.0894568690095845,28.46596648456145
Task_18668,656,499,53,25,78,1.312,17.081592621103486
Task_18669,2758,300,23,32,55,9.162790697674419,49.74856434322984
Task_18670,2442,626,177,170,347,3.8947368421052633,48.78732331885942
Task_18671,2378,320,113,75,188,7.40809968847352,45.507369414401005
Task_18672,1401,1019,133,149,282,1.3735294117647059,33.130402316288006
Task_18673,1985,342,70,36,106,5.7871720116618075,38.19586744253295
Task_18674,2549,659,148,174,322,3.8621212121212123,50.47982970412759
Task_18675,775,449,114,22,136,1.7222222222222223,19.69650722018776
Task_18676,2790,413,144,153,297,6.739130434782608,53.357443426360646
Task_18677,2462,500,174,41,215,4.9141716566866265,47.22678050612601
Task_18678,1040,186,151,178,329,5.561497326203209,25.251074580398583
Task_18679,836,791,153,142,295,1.0555555555555556,23.460320378218736
Task_18680,1883,246,81,166,247,7.623481781376518,38.33977206880565
Task_18681,1374,856,127,151,278,1.6032672112018669,32.237044490581546
Task_18682,2607,119,117,181,298,21.725,48.949755666966105
Task_18683,2480,712,81,65,146,3.4782608695652173,48.03041023998
Task_18684,638,962,170,132,302,0.6625129802699896,21.059279924314207
Task_18685,1947,888,195,199,394,2.1901012373453317,42.02219651380675
Task_18686,1228,614,119,87,206,1.9967479674796749,28.511521165330652
Task_18687,1753,775,139,89,228,2.259020618556701,37.499288706301606
Task_18688,1417,353,146,162,308,4.002824858757062,31.49918379591557
Task_18689,2781,630,18,132,150,4.4072900158478605,52.85849035352161
Task_18690,761,760,161,41,202,1.0,20.982893336854314
Task_18691,2779,722,169,69,238,3.843706777316736,53.31954456994893
Task_18692,1946,431,144,67,211,4.50462962962963,39.10517796370855
Task_18693,777,1007,92,114,206,0.7708333333333334,22.87451536196009
Task_18694,551,334,40,193,233,1.644776119402985,17.447124145242224
Task_18695,2075,643,44,159,203,3.222049689440994,42.377056683112535
Task_18696,2348,625,45,137,182,3.7507987220447285,46.321197071352536
Task_18697,1805,947,114,30,144,1.9040084388185654,37.66689667976177
Task_18698,1725,988,153,43,196,1.744186046511628,36.9872687242773
Task_18699,2557,194,55,90,145,13.112820512820512,47.81595064282337
Task_18700,573,539,117,106,223,1.0611111111111111,18.127346085616022
Task_18701,2040,875,89,142,231,2.328767123287671,42.676864165377424
Task_18702,1156,918,17,111,128,1.2578890097932536,27.939091196621693
Task_18703,734,518,91,46,137,1.4142581888246628,19.343251205554267
Task_18704,1342,1020,33,167,200,1.3143976493633693,31.868528709209887
Task_18705,1603,196,44,123,167,8.137055837563452,33.01998169821054
Task_18706,1335,947,142,179,321,1.4082278481012658,32.081234381967086
Task_18707,1910,618,70,43,113,3.08562197092084,38.119788687481126
Task_18708,2427,450,127,135,262,5.381374722838138,47.550291876468954
Task_18709,942,102,155,49,204,9.145631067961165,21.258314952727428
Task_18710,611,1002,138,176,314,0.609172482552343,20.931573503992237
Task_18711,1901,209,141,170,311,9.052380952380952,38.67964852532786
Task_18712,902,978,181,75,256,0.9213483146067416,24.593659697838913
Task_18713,1599,131,169,125,294,12.113636363636363,33.056729319919235
Task_18714,2020,559,32,94,126,3.607142857142857,40.64030868575288
Task_18715,2583,1001,147,100,247,2.5778443113772456,51.644676077458335
Task_18716,686,534,180,159,339,1.2822429906542057,20.546241653057212
Task_18717,1772,711,59,115,174,2.4887640449438204,37.67179444346774
Task_18718,2684,535,121,171,292,5.007462686567164,52.08230762687771
Task_18719,2256,91,97,105,202,24.52173913043478,42.49852824169515
Task_18720,1461,918,159,97,256,1.589771490750816,33.633992206699
Task_18721,839,71,165,20,185,11.652777777777779,18.883015844641147
Task_18722,1992,1005,179,190,369,1.9801192842942346,42.973283297837746
Task_18723,679,339,190,157,347,1.9970588235294118,19.949427780047866
Task_18724,2869,569,35,178,213,5.033333333333333,54.80472120442676
Task_18725,754,193,120,55,175,3.88659793814433,19.323679603353796
Task_18726,551,326,90,176,266,1.6850152905198776,17.58253881655725
Task_18727,2250,360,10,51,61,6.232686980609419,42.0583749357539
Task_18728,1518,886,106,112,218,1.7113866967305524,34.28425036865915
Task_18729,962,920,49,65,114,1.0445168295331162,24.448471180472307
Task_18730,610,626,188,23,211,0.9728867623604466,18.333529150976453
Task_18731,2131,925,102,58,160,2.301295896328294,42.99153932879173
Task_18732,2197,337,108,121,229,6.5,43.36746222695442
Task_18733,2266,764,192,22,214,2.962091503267974,44.87770978217525
Task_18734,2448,922,134,158,292,2.6522210184182016,49.54691166156374
Task_18735,1390,321,178,168,346,4.316770186335404,31.147596067899087
Task_18736,863,726,65,137,202,1.18707015130674,23.423553414498432
Task_18737,1294,541,100,59,159,2.3874538745387452,28.51251437038901
Task_18738,2440,604,123,92,215,4.033057851239669,47.87577826271484
Task_18739,894,923,198,64,262,0.9675324675324676,24.24016173861187
Task_18740,779,152,11,98,109,5.091503267973856,18.78185067396256
Task_18741,956,467,192,10,202,2.0427350427350426,23.074010242329717
Task_18742,2266,194,110,19,129,11.62051282051282,42.249297168805036
Task_18743,2514,487,82,33,115,5.151639344262295,47.1978387770473
Task_18744,1860,819,66,32,98,2.268292682926829,37.66028261707962
Task_18745,1096,176,18,127,145,6.192090395480226,24.08533122286424
Task_18746,2509,386,196,141,337,6.483204134366925,48.983689038684446
Task_18747,2433,555,61,73,134,4.375899280575539,46.8864668384816
Task_18748,2121,1008,144,110,254,2.1020812685827552,44.391302438670245
Task_18749,2212,429,112,24,136,5.144186046511628,42.38799295697782
Task_18750,2583,990,87,61,148,2.6064581231079718,50.318311104361406
Task_18751,2570,171,76,94,170,14.94186046511628,47.78376075045719
Task_18752,1289,815,52,172,224,1.579656862745098,30.694493316592368
Task_18753,1415,625,29,90,119,2.2603833865814695,31.00969514413094
Task_18754,2749,99,30,105,135,27.49,49.4995049767476
Task_18755,2430,319,12,111,123,7.59375,46.24833414714205
Task_18756,2940,446,200,175,375,6.577181208053691,56.22469936253399
Task_18757,1039,207,197,97,294,4.9951923076923075,24.913641425539453
Task_18758,2649,794,112,106,218,3.332075471698113,51.92121975044004
Task_18759,2401,560,96,171,267,4.279857397504457,47.62165918966162
Task_18760,2766,376,143,196,339,7.336870026525199,53.10586514371605
Task_18761,1572,438,73,142,215,3.580865603644647,33.904474176124815
Task_18762,2132,766,53,128,181,2.7796610169491527,43.49570618401791
Task_18763,769,749,146,161,307,1.0253333333333334,22.3507591375334
Task_18764,1802,524,130,94,224,3.4323809523809525,37.607407384113486
Task_18765,1792,157,101,168,269,11.341772151898734,36.28772597428041
Task_18766,1293,353,161,57,218,3.652542372881356,28.478292149789088
Task_18767,539,77,13,125,138,6.910256410256411,14.731276784444924
Task_18768,2226,165,120,177,297,13.409638554216867,43.28854224841024
Task_18769,2791,426,75,188,263,6.5362997658079625,53.45060533363358
Task_18770,2994,259,55,50,105,11.515384615384615,53.83900811918812
Task_18771,763,412,67,161,228,1.847457627118644,21.100502684388804
Task_18772,2075,410,12,185,197,5.048661800486618,41.631159756020246
Task_18773,1299,442,88,159,247,2.9322799097065464,29.65823671956116
Task_18774,2296,346,26,165,191,6.61671469740634,44.89790843538517
Task_18775,1002,242,14,174,188,4.1234567901234565,24.05471301881829
Task_18776,1467,563,194,77,271,2.601063829787234,32.31024694647781
Task_18777,1439,196,135,21,156,7.304568527918781,29.343800762032018
Task_18778,1058,611,17,89,106,1.7287581699346406,24.996891028379327
Task_18779,1131,351,68,183,251,3.2130681818181817,26.86481281650272
Task_18780,1698,1020,195,147,342,1.6630754162585701,38.162600817938404
Task_18781,2866,378,184,155,339,7.562005277044855,54.63464674659252
Task_18782,2175,162,130,73,203,13.343558282208589,41.532596432357735
Task_18783,2578,252,123,153,276,10.189723320158103,49.35041444834847
Task_18784,2271,788,145,173,318,2.8783269961977185,46.46270515724353
Task_18785,1904,580,182,91,273,3.2771084337349397,39.52595238854484
Task_18786,1639,324,137,179,316,5.0430769230769235,34.97613017478722
Task_18787,740,91,30,162,192,8.043478260869565,18.73316278349256
Task_18788,2264,264,164,101,265,8.543396226415094,44.30652538643388
Task_18789,1143,408,73,91,164,2.7946210268948657,26.494583860273607
Task_18790,2946,565,20,88,108,5.204946996466431,54.83502040661583
Task_18791,2141,980,86,98,184,2.182466870540265,44.156798022312195
Task_18792,1074,991,53,120,173,1.0826612903225807,27.254890285985937
Task_18793,1601,809,121,108,229,1.9765432098765432,35.41701766703853
Task_18794,2041,451,193,77,270,4.515486725663717,41.03638089217226
Task_18795,1100,147,75,145,220,7.4324324324324325,25.18640524353447
Task_18796,2427,167,169,49,218,14.446428571428571,45.38871670947166
Task_18797,2901,887,143,112,255,3.266891891891892,56.38123682437165
Task_18798,2287,407,139,179,318,5.605392156862745,45.5106283291336
Task_18799,1952,263,73,176,249,7.393939393939394,39.53717244848889
Task_18800,1727,901,168,97,265,1.9146341463414633,37.87937666614621
Task_18801,607,625,169,156,325,0.9696485623003195,19.521219628202655
Task_18802,2662,848,167,57,224,3.1354534746760896,51.751950715656314
Task_18803,1601,583,37,101,138,2.7414383561643834,33.98549250789155
Task_18804,614,654,166,168,334,0.9374045801526718,19.79049474015023
Task_18805,1144,878,80,86,166,1.3014789533560864,27.695771195695205
Task_18806,1182,650,196,36,232,1.8156682027649769,27.516760049047548
Task_18807,960,337,141,67,208,2.8402366863905324,23.188077665326016
Task_18808,1298,212,116,116,232,6.093896713615023,28.734986372927107
Task_18809,927,333,41,154,195,2.7754491017964074,23.175636777350988
Task_18810,1761,160,57,179,236,10.937888198757763,35.79416991939727
Task_18811,2519,562,106,175,281,4.474245115452931,49.512668035901605
Task_18812,2060,731,59,57,116,2.814207650273224,41.03992104970579
Task_18813,2652,647,12,152,164,4.092592592592593,51.21912218422179
Task_18814,1474,669,105,134,239,2.2,33.051550704404434
Task_18815,2631,885,121,192,313,2.969525959367946,52.47550107936502
Task_18816,1461,655,149,18,167,2.2271341463414633,31.21005053088115
Task_18817,2881,725,123,13,136,3.96831955922865,53.83500738516856
Task_18818,1448,236,122,26,148,6.109704641350211,29.708345972558046
Task_18819,760,527,200,137,337,1.4393939393939394,21.678550934736553
Task_18820,2667,145,167,40,207,18.267123287671232,48.924390756020046
Task_18821,1348,272,150,159,309,4.937728937728938,30.140932117110626
Task_18822,876,270,115,192,307,3.2324723247232474,22.713761755900308
Task_18823,1752,568,176,122,298,3.07908611599297,37.385267956906866
Task_18824,2936,893,108,174,282,3.2841163310961967,57.16719177218901
Task_18825,1127,893,139,96,235,1.2606263982102908,28.094796997365183
Task_18826,2339,288,85,34,119,8.093425605536332,43.74763198949
Task_18827,879,298,182,130,312,2.939799331103679,22.78371984216777
Task_18828,2156,435,163,153,316,4.944954128440367,43.48198810498459
Task_18829,2595,886,118,73,191,2.9255918827508456,50.77507284831045
Task_18830,2931,759,32,92,124,3.856578947368421,55.60494746407225
Task_18831,2754,548,90,199,289,5.016393442622951,53.309325741027514
Task_18832,500,893,37,167,204,0.5592841163310962,18.16930773604293
Task_18833,2819,814,162,138,300,3.4588957055214724,55.09389120178486
Task_18834,1919,767,138,24,162,2.4986979166666665,38.928695681168605
Task_18835,1325,218,198,140,338,6.050228310502283,29.695351997763073
Task_18836,1566,600,145,192,337,2.605657237936772,34.819048603491645
Task_18837,826,850,159,40,199,0.9706227967097533,22.44030645879106
Task_18838,1885,998,11,78,89,1.8868868868868869,39.05874302570976
Task_18839,2045,475,103,75,178,4.296218487394958,40.55558907657845
Task_18840,1083,87,18,110,128,12.306818181818182,23.198214880660274
Task_18841,2868,238,150,150,300,12.0,53.98283224284241
Task_18842,1592,874,45,95,140,1.8194285714285714,34.7699426479102
Task_18843,968,734,136,132,268,1.3170068027210884,25.313968044988684
Task_18844,2549,902,91,112,203,2.82281284606866,50.66555690762953
Task_18845,600,283,45,164,209,2.112676056338028,17.910667020069678
Task_18846,2535,692,188,13,201,3.658008658008658,48.77947737867791
Task_18847,1831,479,79,145,224,3.814583333333333,38.184039923262475
Task_18848,2389,465,180,63,243,5.126609442060086,46.34535382210701
Task_18849,1370,577,19,159,178,2.370242214532872,30.680255900812956
Task_18850,2417,831,44,18,62,2.905048076923077,45.726641067994144
Task_18851,867,595,116,115,231,1.4546979865771812,23.07475725322314
Task_18852,978,861,68,152,220,1.134570765661253,25.752399233478773
Task_18853,987,200,188,190,378,4.91044776119403,24.549900093700256
Task_18854,2494,89,83,142,225,27.711111111111112,46.34600347746916
Task_18855,2951,535,192,102,294,5.505597014925373,56.21769206237142
Task_18856,2129,153,195,49,244,13.824675324675324,40.67531428846799
Task_18857,634,906,75,32,107,0.6990077177508269,19.03643560556661
Task_18858,2045,400,38,31,69,5.0997506234413965,38.69813115123744
Task_18859,1282,690,61,150,211,1.8552821997105644,30.101153961740845
Task_18860,2395,210,74,176,250,11.350710900473933,46.34842987786868
Task_18861,872,549,100,145,245,1.5854545454545454,23.143232184059553
Task_18862,1908,719,139,59,198,2.65,39.26212592738498
Task_18863,1713,593,179,168,347,2.8838383838383836,37.134857361002744
Task_18864,2788,676,181,164,345,4.118168389955687,54.40828685130803
Task_18865,1844,335,149,103,252,5.488095238095238,37.85496109290162
Task_18866,2838,876,140,74,214,3.2360319270239453,54.75113049312225
Task_18867,1458,950,22,65,87,1.5331230283911672,31.90952744988301
Task_18868,1747,872,197,187,384,2.0011454753722795,38.740748694724154
Task_18869,2625,554,20,51,71,4.72972972972973,48.67904181978073
Task_18870,617,211,74,132,206,2.910377358490566,18.017575027774125
Task_18871,740,709,12,47,59,1.0422535211267605,19.125369080622544
Task_18872,1973,649,170,155,325,3.0353846153846153,41.31080425536673
Task_18873,1360,949,14,99,113,1.431578947368421,31.156655505643744
Task_18874,1188,823,95,43,138,1.441747572815534,27.504993303550744
Task_18875,2156,1020,30,158,188,2.1116552399608226,44.75980391511518
Task_18876,2459,158,188,50,238,15.465408805031446,45.88311483926071
Task_18877,1627,835,59,162,221,1.9461722488038278,36.10764627281703
Task_18878,2745,363,182,74,256,7.541208791208791,51.81970900654565
Task_18879,1304,331,62,171,233,3.927710843373494,29.44336421154041
Task_18880,828,166,72,139,211,4.958083832335329,20.914260748876398
Task_18881,1636,466,109,172,281,3.5032119914346893,35.22148927693686
Task_18882,520,1003,68,95,163,0.5179282868525896,18.603362340244303
Task_18883,934,405,49,89,138,2.3004926108374386,22.899705072369176
Task_18884,2315,831,113,143,256,2.782451923076923,46.97100519725277
Task_18885,1726,199,150,179,329,8.63,35.99002464695564
Task_18886,1243,320,37,78,115,3.872274143302181,27.246869565251018
Task_18887,2187,953,174,89,263,2.292452830188679,45.08837999376911
Task_18888,505,739,162,191,353,0.6824324324324325,18.578928698338114
Task_18889,1782,991,129,178,307,1.7963709677419355,39.304909166255506
Task_18890,2990,577,84,169,253,5.173010380622838,56.931488425067904
Task_18891,2684,199,64,199,263,13.42,50.9709831376849
Task_18892,1154,713,83,122,205,1.6162464985994398,27.98933661245618
Task_18893,1516,831,112,154,266,1.8221153846153846,34.37296575321993
Task_18894,2375,182,58,99,157,12.978142076502733,44.89870939801191
Task_18895,2519,823,166,189,355,3.0570388349514563,50.691714962407865
Task_18896,1716,673,198,161,359,2.5459940652818993,37.47762307256718
Task_18897,2736,339,152,93,245,8.047058823529412,51.865021394034024
Task_18898,2370,856,82,93,175,2.765460910151692,47.433791328680904
Task_18899,2925,600,118,130,248,4.8668885191347755,55.848939430353994
Task_18900,2891,857,26,100,126,3.3694638694638694,55.38475612659662
Task_18901,1536,358,179,76,255,4.278551532033426,32.67151835724973
Task_18902,2631,556,188,179,367,4.723518850987433,51.660392556563274
Task_18903,1149,171,175,107,282,6.680232558139535,26.099269689368835
Task_18904,2335,297,170,45,215,7.8355704697986575,44.5002631633647
Task_18905,2073,528,146,97,243,3.9187145557655954,42.0900503849399
Task_18906,642,697,34,62,96,0.9197707736389685,18.320051159224615
Task_18907,1349,595,78,191,269,2.2634228187919465,31.189605622015097
Task_18908,1838,311,127,187,314,5.891025641025641,38.082203703700976
Task_18909,2318,754,43,118,161,3.070198675496689,46.0243935272714
Task_18910,595,629,136,170,306,0.9444444444444444,19.291036623151594
Task_18911,2497,418,84,119,203,5.959427207637232,48.3111177183022
Task_18912,584,761,188,104,292,0.7664041994750657,19.381733149407353
Task_18913,955,645,99,30,129,1.478328173374613,23.251890952484683
Task_18914,753,401,127,191,318,1.873134328358209,21.235036554979285
Task_18915,623,480,199,186,385,1.2952182952182951,19.62751362963999
Task_18916,858,539,113,10,123,1.5888888888888888,21.06647009020818
Task_18917,846,638,23,82,105,1.323943661971831,21.751995904861857
Task_18918,1252,833,169,188,357,1.501199040767386,30.61366042138671
Task_18919,1415,389,181,178,359,3.628205128205128,31.837386854301457
Task_18920,1268,1001,39,141,180,1.2654690618762474,30.20810314558037
Task_18921,695,213,72,191,263,3.2476635514018692,19.59426469275482
Task_18922,588,362,103,107,210,1.6198347107438016,17.87840043243333
Task_18923,2938,623,152,107,259,4.708333333333333,56.144248888515904
Task_18924,1337,741,129,135,264,1.8018867924528301,31.220192788067376
Task_18925,2863,205,38,149,187,13.898058252427184,53.23649564678885
Task_18926,2732,306,200,148,348,8.899022801302932,52.296855608763224
Task_18927,2061,557,165,154,319,3.693548387096774,42.38491754544766
Task_18928,2590,649,46,108,154,3.9846153846153847,49.92692339351015
Task_18929,1443,383,12,138,150,3.7578125,30.926879472542467
Task_18930,622,1008,36,187,223,0.6164519326065411,20.666997532859877
Task_18931,1817,875,116,26,142,2.074200913242009,37.55223797222125
Task_18932,2447,714,138,93,231,3.4223776223776223,48.44368237055431
Task_18933,1066,864,132,196,328,1.2323699421965317,27.56331804862421
Task_18934,2995,583,168,134,302,5.1284246575342465,57.15217854669172
Task_18935,775,712,88,108,196,1.0869565217391304,21.705479242968995
Task_18936,1028,690,53,94,147,1.487698986975398,25.410570090640817
Task_18937,529,423,25,34,59,1.2476415094339623,14.771077250855447
Task_18938,2769,320,146,148,294,8.626168224299066,52.68774862659035
Task_18939,1684,443,175,153,328,3.7927927927927927,36.09158811871208
Task_18940,2256,902,43,120,163,2.4983388704318936,45.64560167180943
Task_18941,1709,637,151,198,349,2.6786833855799372,37.26294650622315
Task_18942,1467,996,11,156,167,1.4714142427281847,33.43171277282406
Task_18943,2942,370,101,23,124,7.929919137466308,53.6174991925067
Task_18944,1777,506,128,188,316,3.504930966469428,37.76233215413707
Task_18945,2907,340,33,184,217,8.52492668621701,54.693490651756065
Task_18946,2909,653,39,119,158,4.448012232415902,55.0422442626153
Task_18947,2662,432,27,93,120,6.147806004618937,50.23834624833785
Task_18948,640,856,69,67,136,0.7467911318553092,19.3359170730028
Task_18949,2023,981,134,39,173,2.060081466395112,41.48807582410884
Task_18950,604,360,167,124,291,1.6731301939058172,18.515207484220415
Task_18951,1376,725,123,45,168,1.8953168044077136,30.285343754773223
Task_18952,2250,247,17,195,212,9.07258064516129,43.860533993357045
Task_18953,1238,96,47,114,161,12.762886597938145,25.892321677038677
Task_18954,2130,750,132,196,328,2.8362183754993344,44.18863710652112
Task_18955,659,769,145,28,173,0.8558441558441559,19.253081764486833
Task_18956,1505,706,170,50,220,2.128712871287129,32.81267319038142
Task_18957,1086,234,22,173,195,4.621276595744681,25.34917383670881
Task_18958,2409,769,180,181,361,3.1285714285714286,48.79492556692833
Task_18959,1217,915,185,93,278,1.3286026200873362,29.7549864046207
Task_18960,1168,710,181,170,351,1.6427566807313643,28.87654631126573
Task_18961,613,313,21,158,179,1.9522292993630572,17.869845440897702
Task_18962,1644,528,17,108,125,3.107750472589792,34.45163478825669
Task_18963,2694,440,46,23,69,6.108843537414966,49.071988513657715
Task_18964,1847,560,16,96,112,3.2923351158645278,37.653739666049624
Task_18965,1513,572,16,175,191,2.6404886561954624,33.17196180950831
Task_18966,2380,816,60,118,178,2.913096695226438,47.51193720417737
Task_18967,1296,404,130,17,147,3.2,27.67235519639112
Task_18968,687,649,86,91,177,1.0569230769230769,19.68524095204595
Task_18969,2885,300,164,126,290,9.584717607973422,54.40095157282584
Task_18970,1392,449,95,31,126,3.0933333333333333,29.597797769697806
Task_18971,2447,427,12,170,182,5.7172897196261685,47.30556833210292
Task_18972,2597,624,47,177,224,4.1552,50.7420687297898
Task_18973,2065,946,23,42,65,2.180570221752904,40.84361424187146
Task_18974,910,102,156,71,227,8.83495145631068,21.05286222276659
Task_18975,2046,658,178,107,285,3.104704097116844,42.2447283340156
Task_18976,1621,497,162,56,218,3.255020080321285,34.202917476958746
Task_18977,642,643,91,92,183,0.9968944099378882,19.08306516183291
Task_18978,2358,909,62,198,260,2.5912087912087913,48.12263943551837
Task_18979,1120,145,21,19,40,7.671232876712328,22.781816218138147
Task_18980,1316,527,172,183,355,2.492424242424242,30.69856580504005
Task_18981,1112,330,194,154,348,3.3595166163141994,26.76898735906401
Task_18982,2123,110,52,59,111,19.126126126126128,39.21267599370036
Task_18983,2385,657,19,11,30,3.6246200607902734,44.49511885596289
Task_18984,1705,968,33,113,146,1.759545923632611,36.93904691790723
Task_18985,803,365,74,52,126,2.1939890710382515,20.299947293457297
Task_18986,2551,1018,27,94,121,2.5034347399411185,50.36548740471841
Task_18987,1008,844,98,195,293,1.1928994082840236,26.478248720912017
Task_18988,1679,755,167,102,269,2.2208994708994707,36.6558804962189
Task_18989,989,455,123,181,304,2.168859649122807,25.06231023977413
Task_18990,2646,404,81,50,131,6.533333333333333,49.32952175823763
Task_18991,620,974,68,41,109,0.6358974358974359,18.938112519356203
Task_18992,1937,539,114,186,300,3.587037037037037,40.32552743785305
Task_18993,2859,747,193,69,262,3.822192513368984,54.773960522787156
Task_18994,1703,963,87,191,278,1.766597510373444,37.84955599715013
Task_18995,1838,590,29,129,158,3.1099830795262267,37.922843397793436
Task_18996,2296,188,22,34,56,12.148148148148149,42.147347096832995
Task_18997,730,964,37,32,69,0.7564766839378239,19.735052413621037
Task_18998,2834,595,86,174,260,4.75503355704698,54.55243978960428
Task_18999,1852,115,10,150,160,15.96551724137931,35.81863720156644
Task_19000,995,622,48,97,145,1.5971107544141252,24.765569785812716
Task_19001,1712,732,116,141,257,2.3356070941336973,37.10989623410254
Task_19002,2135,467,23,144,167,4.561965811965812,42.47803966227351
Task_19003,2361,538,147,122,269,4.380333951762523,46.802240778608564
Task_19004,2331,404,28,38,66,5.7555555555555555,43.2871804874942
Task_19005,2167,255,89,64,153,8.46484375,41.41192774545318
Task_19006,2928,931,19,83,102,3.1416309012875536,55.583563748181795
Task_19007,1877,897,56,149,205,2.0902004454342986,40.17460093892971
Task_19008,2704,655,128,97,225,4.121951219512195,52.405712681330584
Task_19009,2677,892,20,177,197,2.9977603583426653,52.661920628249554
Task_19010,836,613,29,146,175,1.3615635179153094,22.363029643715397
Task_19011,2203,165,73,143,216,13.271084337349398,42.64237451404062
Task_19012,1455,846,157,168,325,1.717827626918536,33.726123418215955
Task_19013,1921,215,155,145,300,8.893518518518519,38.93163259495716
Task_19014,1656,389,134,171,305,4.246153846153846,35.39694275840217
Task_19015,2602,131,29,196,225,19.71212121212121,48.63581087004051
Task_19016,1572,499,11,125,136,3.144,33.30710181984586
Task_19017,1087,182,113,10,123,5.939890710382514,23.62782550969328
Task_19018,2720,367,88,10,98,7.391304347826087,49.750438865785604
Task_19019,1461,595,150,174,324,2.4513422818791946,33.055531925603695
Task_19020,1603,591,29,55,84,2.70777027027027,33.05637492029387
Task_19021,1779,845,78,43,121,2.102836879432624,36.77327553718475
Task_19022,2278,700,153,81,234,3.2496433666191153,45.460660502963414
Task_19023,1460,888,176,52,228,1.642294713160855,32.93460049984879
Task_19024,1405,982,183,171,354,1.429298067141404,33.43598091584091
Task_19025,1541,910,176,84,260,1.6915477497255762,34.58182940323291
Task_19026,2567,911,152,20,172,2.8146929824561404,49.707352958772994
Task_19027,559,188,56,198,254,2.9576719576719577,17.39393001035797
Task_19028,548,388,16,133,149,1.4087403598971722,16.658654418632285
Task_19029,2430,485,62,92,154,5.0,46.87591236526944
Task_19030,1070,297,72,196,268,3.5906040268456376,25.82560609318321
Task_19031,2323,424,57,180,237,5.465882352941176,45.931237737723144
Task_19032,1977,378,134,184,318,5.216358839050132,40.5174359967091
Task_19033,1777,795,123,115,238,2.2324120603015074,38.21260587177593
Task_19034,683,339,184,45,229,2.0088235294117647,18.578970023434028
Task_19035,2860,469,29,17,46,6.085106382978723,51.51030300108321
Task_19036,2301,935,94,146,240,2.4583333333333335,47.08994916920193
Task_19037,587,922,148,180,328,0.6359696641386782,20.29196799364051
Task_19038,752,658,125,191,316,1.1411229135053111,21.93004946794657
Task_19039,2933,817,190,187,377,3.5855745721271393,57.32835220292071
Task_19040,1269,135,13,54,67,9.330882352941176,25.652061454151607
Task_19041,1172,238,181,26,207,4.903765690376569,25.883227492784957
Task_19042,2222,864,182,174,356,2.56878612716763,46.096770271671325
Task_19043,2517,212,46,70,116,11.816901408450704,46.820671632939764
Task_19044,1821,464,90,179,269,3.9161290322580644,38.14888664947484
Task_19045,2003,280,67,88,155,7.128113879003559,39.34486575146299
Task_19046,1349,588,28,38,66,2.2903225806451615,28.330376404401537
Task_19047,1323,578,58,38,96,2.284974093264249,28.365955106377495
Task_19048,775,184,13,94,107,4.1891891891891895,19.22496906116584
Task_19049,1374,989,120,127,247,1.387878787878788,32.419621435818804
Task_19050,2716,954,23,83,106,2.843979057591623,52.41717620558483
Task_19051,2603,69,197,62,259,37.18571428571428,47.46539121217425
Task_19052,1536,263,41,36,77,5.818181818181818,30.18932375464591
Task_19053,2842,341,37,15,52,8.309941520467836,50.92855872121233
Task_19054,1008,397,130,188,318,2.5326633165829144,25.252960069326786
Task_19055,1246,340,124,81,205,3.653958944281525,27.846052748309063
Task_19056,1376,193,132,99,231,7.092783505154639,29.859293777163725
Task_19057,1560,452,34,147,181,3.443708609271523,33.33560598100539
Task_19058,2293,973,164,91,255,2.3542094455852154,46.838619588371806
Task_19059,967,963,22,169,191,1.0031120331950207,25.500931195536634
Task_19060,2189,847,134,170,304,2.581367924528302,45.28058726119596
Task_19061,1947,1009,122,155,277,1.9277227722772277,41.80662865553933
Task_19062,1744,952,73,50,123,1.8300104931794334,36.698530594636416
Task_19063,1614,144,89,92,181,11.13103448275862,32.58872804195535
Task_19064,2272,376,22,129,151,6.026525198938992,43.98128542839973
Task_19065,827,497,92,66,158,1.6606425702811245,21.108927655482905
Task_19066,1080,814,147,113,260,1.3251533742331287,27.28474901934803
Task_19067,1374,277,35,200,235,4.942446043165468,30.324686264931614
Task_19068,502,201,124,105,229,2.485148514851485,16.101561921658192
Task_19069,1476,987,40,109,149,1.4939271255060729,33.29363240265153
Task_19070,2632,294,170,44,214,8.922033898305084,49.2095319225358
Task_19071,2436,862,133,199,332,2.8227114716106603,49.40973259738519
Task_19072,500,620,151,37,188,0.8051529790660226,16.441446153839216
Task_19073,2707,156,47,196,243,17.24203821656051,50.68175195242464
Task_19074,814,944,121,43,164,0.8613756613756614,22.233221080719556
Task_19075,2365,744,26,123,149,3.174496644295302,46.708730393993754
Task_19076,1144,235,77,151,228,4.8474576271186445,26.541665536417074
Task_19077,927,751,171,102,273,1.2327127659574468,24.62518019689144
Task_19078,2939,769,182,33,215,3.8168831168831168,55.64572908331075
Task_19079,2254,488,110,199,309,4.6094069529652355,45.24070266956412
Task_19080,994,877,56,171,227,1.132118451025057,26.117513887579904
Task_19081,1814,647,40,110,150,2.799382716049383,37.603738203633945
Task_19082,2618,341,36,98,134,7.654970760233918,49.32177508525439
Task_19083,1403,266,190,122,312,5.254681647940075,30.949224667446956
Task_19084,528,200,126,129,255,2.626865671641791,16.66105259167849
Task_19085,2031,905,117,125,242,2.2417218543046356,42.61258838665115
Task_19086,2702,171,200,59,259,15.709302325581396,50.07583677664176
Task_19087,2099,166,165,71,236,12.568862275449101,40.48464142305614
Task_19088,2229,982,14,148,162,2.2675483214649033,45.43854901029084
Task_19089,2623,583,155,58,213,4.491438356164384,50.23684376420783
Task_19090,997,745,181,67,248,1.3364611260053618,25.217705391810444
Task_19091,1749,530,24,84,108,3.2937853107344632,35.805615599484995
Task_19092,2420,991,88,150,238,2.439516129032258,49.08281908369201
Task_19093,2032,489,173,39,212,4.146938775510204,40.337544396778924
Task_19094,737,968,79,54,133,0.760577915376677,21.17326489636856
Task_19095,931,916,172,82,254,1.015267175572519,24.827955624336457
Task_19096,2421,846,48,174,222,2.858323494687131,48.71292046542576
Task_19097,2864,508,142,115,257,5.626719056974459,54.60498236963955
Task_19098,1508,207,187,47,234,7.25,31.243065772529093
Task_19099,2110,549,60,145,205,3.8363636363636364,42.736330168120936
Task_19100,2862,406,121,144,265,7.031941031941032,54.31600560383146
Task_19101,2839,748,194,122,316,3.7903871829105475,55.251607545171545
Task_19102,2613,80,115,39,154,32.25925925925926,46.51939448340237
Task_19103,2600,708,143,50,193,3.6671368124118477,50.04264712128847
Task_19104,1299,974,166,157,323,1.3323076923076924,31.59909759508334
Task_19105,1565,459,14,76,90,3.402173913043478,32.30522474010134
Task_19106,2119,479,75,121,196,4.414583333333334,42.587037141568565
Task_19107,1519,991,88,57,145,1.53125,33.51739676729919
Task_19108,1912,154,128,57,185,12.335483870967742,37.06799750297318
Task_19109,1067,205,90,139,229,5.179611650485437,25.133007489796473
Task_19110,1022,314,40,194,234,3.2444444444444445,24.851194326557692
Task_19111,1799,67,188,73,261,26.455882352941178,34.911259148598354
Task_19112,2450,149,120,193,313,16.333333333333332,46.83230523633299
Task_19113,1713,497,191,41,232,3.4397590361445785,35.43617186216816
Task_19114,776,937,92,114,206,0.8272921108742004,22.60428157057181
Task_19115,2002,429,190,73,263,4.655813953488372,40.26220946012347
Task_19116,2208,79,108,51,159,27.6,40.481120638438476
Task_19117,1449,600,35,157,192,2.410981697171381,32.29077847337051
Task_19118,1149,320,175,66,241,3.5794392523364484,26.247702493525267
Task_19119,1530,594,48,41,89,2.5714285714285716,31.649747564489232
Task_19120,1207,285,44,79,123,4.22027972027972,26.62873550767263
Task_19121,2534,83,123,93,216,30.166666666666668,46.76541362853376
Task_19122,1646,778,40,23,63,2.1129653401797177,33.55818736063357
Task_19123,1458,779,34,35,69,1.8692307692307693,30.642769457965965
Task_19124,1837,715,147,63,210,2.565642458100559,38.249549964686274
Task_19125,1125,493,141,167,308,2.277327935222672,27.332311645304156
Task_19126,936,443,89,144,233,2.108108108108108,23.851196412802228
Task_19127,2067,927,69,119,188,2.2273706896551726,43.08354618991809
Task_19128,637,649,175,38,213,0.98,18.90930154125131
Task_19129,1431,584,50,182,232,2.4461538461538463,32.332456586973954
Task_19130,2557,357,31,136,167,7.14245810055866,48.72052296328638
Task_19131,1831,706,44,99,143,2.5898161244695896,38.04134942624
Task_19132,1524,911,124,22,146,1.6710526315789473,33.07193772261883
Task_19133,2319,477,30,127,157,4.851464435146443,45.17045517728918
Task_19134,1310,862,186,38,224,1.517960602549247,30.195100202676514
Task_19135,1424,184,199,189,388,7.697297297297298,31.28165225966386
Task_19136,564,153,59,136,195,3.6623376623376624,16.632719463266454
Task_19137,516,431,46,53,99,1.1944444444444444,15.434712317972872
Task_19138,1129,824,196,166,362,1.3684848484848484,28.608594716534203
Task_19139,2507,836,69,80,149,2.995221027479092,49.09505851492229
Task_19140,1148,147,195,10,205,7.756756756756757,24.914328105229373
Task_19141,880,708,19,11,30,1.2411847672778562,20.821442981442114
Task_19142,1345,98,44,150,194,13.585858585858587,28.195473091250804
Task_19143,2334,504,129,52,181,4.6217821782178214,45.17330861917561
Task_19144,2175,551,105,138,243,3.9402173913043477,43.80494584874208
Task_19145,2797,243,89,83,172,11.46311475409836,51.85764164018749
Task_19146,2097,851,50,55,105,2.461267605633803,41.91655072304092
Task_19147,1485,562,152,148,300,2.6376554174067497,33.18553277802778
Task_19148,556,781,186,74,260,0.710997442455243,18.649184040508114
Task_19149,728,377,142,120,262,1.9259259259259258,20.407351136593753
Task_19150,868,219,101,190,291,3.9454545454545453,22.343742017373714
Task_19151,719,520,176,151,327,1.3800383877159308,20.982997643921966
Task_19152,691,308,55,10,65,2.236245954692557,16.719890251803612
Task_19153,2978,115,136,120,256,25.67241379310345,54.40273342255125
Task_19154,827,644,21,159,180,1.2821705426356589,22.148811885686587
Task_19155,1788,95,153,123,276,18.625,35.42294295608523
Task_19156,2207,477,152,87,239,4.617154811715481,43.727316918871225
Task_19157,1646,663,11,31,42,2.4789156626506026,33.100057860764345
Task_19158,514,934,134,75,209,0.5497326203208556,18.22755699385863
Task_19159,678,900,119,195,314,0.7524972253052165,21.496403694707812
Task_19160,1104,363,137,186,323,3.032967032967033,26.68294794846688
Task_19161,2900,368,48,151,199,7.8590785907859075,54.625018333243425
Task_19162,519,322,118,85,203,1.6068111455108358,16.3265517907559
Task_19163,639,405,178,126,304,1.5738916256157636,19.24259073997604
Task_19164,628,353,120,167,287,1.7740112994350283,18.917803026031688
Task_19165,2977,1022,167,122,289,2.9100684261974585,58.17550831227722
Task_19166,1704,659,58,172,230,2.581818181818182,36.832909471217675
Task_19167,969,134,106,193,299,7.177777777777778,23.27160112482763
Task_19168,1977,242,91,83,174,8.135802469135802,38.925761330439464
Task_19169,1601,437,113,160,273,3.6552511415525113,34.521063571925175
Task_19170,604,445,27,122,149,1.3542600896860986,17.805472843420784
Task_19171,1383,506,85,150,235,2.727810650887574,31.151176882238605
Task_19172,1189,692,14,129,143,1.7157287157287158,27.909741553448825
Task_19173,685,83,10,113,123,8.154761904761905,16.883808891132322
Task_19174,1577,182,130,28,158,8.617486338797814,31.656762293908987
Task_19175,2995,670,159,134,293,4.463487332339791,57.38964680019141
Task_19176,2312,629,55,17,72,3.6698412698412697,43.37482688834813
Task_19177,2516,473,11,60,71,5.30801687763713,46.650631949711254
Task_19178,1330,389,133,22,155,3.41025641025641,28.33639413096091
Task_19179,664,911,112,39,151,0.7280701754385965,19.580092598542524
Task_19180,688,911,172,150,322,0.7543859649122807,21.65892254859293
Task_19181,2804,995,145,188,333,2.8152610441767068,55.64476493726024
Task_19182,2868,863,82,79,161,3.3194444444444446,54.83909396223404
Task_19183,2802,604,114,136,250,4.6314049586776855,53.93163728017936
Task_19184,1484,875,163,162,325,1.6940639269406392,34.266910142236185
Task_19185,2788,236,152,65,217,11.763713080168776,51.772663267440315
Task_19186,2044,683,84,184,268,2.9883040935672516,42.37529348598816
Task_19187,859,791,50,117,167,1.0845959595959596,23.098767019868376
Task_19188,2260,481,27,29,56,4.6887966804979255,42.425110611244456
Task_19189,761,277,131,182,313,2.737410071942446,20.931248927431856
Task_19190,1212,907,134,78,212,1.3348017621145374,29.112986102003926
Task_19191,2075,420,29,78,107,4.92874109263658,40.54927215203116
Task_19192,2244,982,77,21,98,2.2828077314343846,44.249676045863055
Task_19193,2231,796,187,91,278,2.7992471769134255,45.40743160001176
Task_19194,668,1002,40,197,237,0.6660019940179461,21.399870640102133
Task_19195,2761,295,54,173,227,9.327702702702704,52.366693683176074
Task_19196,2091,527,184,187,371,3.960227272727273,43.04708108820973
Task_19197,1577,558,32,73,105,2.821109123434705,32.968901445386834
Task_19198,2407,625,108,190,298,3.8450479233226837,48.03830488781417
Task_19199,637,668,149,19,168,0.9521674140508222,18.330651815476845
Task_19200,1787,243,107,104,211,7.323770491803279,36.45561746135724
Task_19201,1898,760,161,53,214,2.4940867279894876,39.413757906997766
Task_19202,1855,735,105,137,242,2.520380434782609,39.311120204613125
Task_19203,1029,318,113,139,252,3.225705329153605,24.96291197774455
Task_19204,2974,886,48,21,69,3.3528748590755355,54.92090926841062
Task_19205,948,200,38,175,213,4.7164179104477615,23.18107371878507
Task_19206,2102,808,180,170,350,2.5982694684796046,43.98764312717261
Task_19207,2954,120,162,135,297,24.41322314049587,54.351972390729316
Task_19208,886,460,120,57,177,1.9219088937093276,22.002272764162853
Task_19209,2303,912,187,140,327,2.5224534501642935,47.349459637205456
Task_19210,1335,387,25,90,115,3.4407216494845363,28.997838081682705
Task_19211,2370,1012,184,133,317,2.3395853899308983,48.66735594465073
Task_19212,2144,354,200,159,359,6.03943661971831,43.2278918426962
Task_19213,2211,734,79,197,276,3.0081632653061225,45.319419840756815
Task_19214,2937,1013,192,19,211,2.896449704142012,56.12518457219797
Task_19215,1144,998,58,135,193,1.145145145145145,28.665930640732295
Task_19216,1091,214,71,98,169,5.074418604651163,25.10472181799086
Task_19217,1242,701,29,44,73,1.7692307692307692,26.956100792598864
Task_19218,1482,543,31,109,140,2.724264705882353,32.02822814438702
Task_19219,1496,789,41,164,205,1.8936708860759495,33.67756472115747
Task_19220,959,180,122,127,249,5.298342541436464,22.984679313954434
Task_19221,1178,770,162,33,195,1.5278858625162126,27.657700950176196
Task_19222,1621,951,36,84,120,1.7027310924369747,35.205603038783394
Task_19223,1989,885,32,188,220,2.244920993227991,41.91760581593166
Task_19224,2499,488,199,180,379,5.110429447852761,49.40683610109668
Task_19225,1279,425,162,61,223,3.0023474178403755,28.487276250470703
Task_19226,532,960,111,26,137,0.5535900104058272,17.7731667144236
Task_19227,2319,911,61,120,181,2.5427631578947367,46.858174000917614
Task_19228,1391,821,119,173,292,1.6922141119221412,32.49301972083117
Task_19229,1861,581,156,17,173,3.1975945017182132,37.458705455789946
Task_19230,957,712,109,182,291,1.3422159887798037,25.26053123766506
Task_19231,2953,428,151,137,288,6.883449883449884,55.92291659075033
Task_19232,2078,224,29,24,53,9.235555555555555,38.698173320686195
Task_19233,1825,872,75,38,113,2.0904925544100803,37.6203360450336
Task_19234,515,648,114,191,305,0.7935285053929122,18.140864167192763
Task_19235,1912,475,183,120,303,4.016806722689076,39.64213575495529
Task_19236,1817,245,63,70,133,7.3861788617886175,36.05386891533147
Task_19237,560,901,81,198,279,0.6208425720620843,19.79263463518723
Task_19238,1792,892,73,20,93,2.0067189249720045,36.735710362545426
Task_19239,2202,550,169,99,268,3.9963702359346644,44.26999007314174
Task_19240,2583,998,97,114,211,2.5855855855855854,51.51728130002041
Task_19241,870,112,53,137,190,7.699115044247788,20.89397905339865
Task_19242,1381,484,149,10,159,2.8474226804123712,29.387843492742736
Task_19243,2219,290,145,88,233,7.625429553264605,43.271879303200414
Task_19244,2156,426,159,155,314,5.049180327868853,43.446585872145555
Task_19245,849,264,94,23,117,3.2037735849056603,20.203319852115285
Task_19246,2428,113,108,16,124,21.29824561403509,44.04350503003085
Task_19247,2626,385,75,15,90,6.803108808290156,48.28198492658825
Task_19248,2006,177,72,107,179,11.269662921348315,38.97808419524319
Task_19249,1339,395,101,135,236,3.3813131313131315,30.036753128189776
Task_19250,1302,127,35,74,109,10.171875,26.6285294056983
Task_19251,2013,253,112,197,309,7.925196850393701,40.639910238569406
Task_19252,794,186,59,87,146,4.245989304812834,20.230896412042245
Task_19253,1922,352,71,84,155,5.444759206798867,38.26263150191556
Task_19254,2967,132,178,35,213,22.30827067669173,53.50107756552463
Task_19255,2366,497,57,150,207,4.751004016064257,46.669910076155816
Task_19256,1120,560,16,138,154,1.9964349376114081,26.340147720886396
Task_19257,2064,299,128,101,229,6.88,41.10554613731943
Task_19258,682,468,127,66,193,1.4541577825159915,19.076105490950546
Task_19259,1619,173,38,118,156,9.304597701149426,32.54428591114289
Task_19260,838,176,59,166,225,4.734463276836158,21.08717498774936
Task_19261,2838,528,150,135,285,5.3648393194707,54.41369797672812
Task_19262,2090,562,145,53,198,3.7122557726465364,41.75918176883665
Task_19263,1852,283,193,108,301,6.52112676056338,38.03385186599826
Task_19264,1566,78,98,11,109,19.82278481012658,29.73202240338303
Task_19265,904,984,65,76,141,0.917766497461929,24.038075392340545
Task_19266,2342,915,45,113,158,2.556768558951965,46.85418589849257
Task_19267,2885,277,73,61,134,10.377697841726619,52.91677319661273
Task_19268,695,605,32,154,186,1.146864686468647,20.05737667607493
Task_19269,2626,166,110,33,143,15.724550898203592,47.78376474150884
Task_19270,1289,145,133,114,247,8.82876712328767,28.11785742861495
Task_19271,2334,727,134,150,284,3.206043956043956,47.082342681385065
Task_19272,2036,748,151,145,296,2.718291054739653,42.47425539923489
Task_19273,2490,267,132,64,196,9.291044776119403,47.0685321338973
Task_19274,2917,338,102,174,276,8.604719764011799,55.04812058676523
Task_19275,1902,369,100,158,258,5.140540540540541,38.99270553686542
Task_19276,1443,277,101,105,206,5.190647482014389,31.115904174335203
Task_19277,1275,524,20,102,122,2.4285714285714284,28.57175052237694
Task_19278,1533,466,87,141,228,3.2826552462526766,33.31530257658675
Task_19279,924,647,108,31,139,1.4259259259259258,22.698555136439797
Task_19280,2485,295,100,39,139,8.39527027027027,46.234475563063505
Task_19281,573,477,146,165,311,1.198744769874477,18.472404624430904
Task_19282,2917,168,119,190,309,17.2603550295858,54.29744237621645
Task_19283,1993,375,100,61,161,5.300531914893617,39.0623881884165
Task_19284,1048,225,25,197,222,4.6371681415929205,24.954449565339143
Task_19285,1614,1012,149,151,300,1.5932872655478776,36.62319005423415
Task_19286,2381,630,19,31,50,3.77337559429477,44.806126771858864
Task_19287,2140,839,84,57,141,2.5476190476190474,42.81821413198759
Task_19288,1443,688,54,131,185,2.0943396226415096,32.40128846491637
Task_19289,2546,495,197,165,362,5.133064516129032,50.07494944296794
Task_19290,509,741,170,158,328,0.6859838274932615,18.487423421477626
Task_19291,1935,181,167,88,255,10.631868131868131,38.242816045929345
Task_19292,2874,166,50,189,239,17.209580838323355,53.42492485907226
Task_19293,2059,722,142,31,173,2.847856154910097,41.28874376278244
Task_19294,1024,184,88,33,121,5.535135135135135,22.694403706563623
Task_19295,948,243,162,183,345,3.8852459016393444,23.920642473637646
Task_19296,1373,253,52,169,221,5.405511811023622,30.259538884538898
Task_19297,1054,730,186,36,222,1.441860465116279,25.691539585926417
Task_19298,1474,491,174,168,342,2.9959349593495936,33.005660326542035
Task_19299,1954,540,157,18,175,3.611829944547135,38.7921119690401
Task_19300,1021,991,10,170,180,1.029233870967742,26.29429534742717
Task_19301,2731,863,71,67,138,3.1608796296296298,52.45350030851245
Task_19302,1291,444,57,98,155,2.901123595505618,28.858747520900053
Task_19303,2323,90,62,158,220,25.52747252747253,43.72545453115856
Task_19304,2103,661,22,123,145,3.176737160120846,42.25702368189397
Task_19305,2760,872,18,165,183,3.161512027491409,53.64869865118467
Task_19306,2848,357,63,17,80,7.955307262569832,51.32372171532967
Task_19307,2465,331,126,67,193,7.424698795180723,46.90134459460166
Task_19308,2480,190,15,157,172,12.984293193717278,47.02830099423565
Task_19309,2479,812,43,30,73,3.0492004920049203,46.94397818463566
Task_19310,2570,655,188,194,382,3.917682926829268,51.0995133650164
Task_19311,2299,138,199,113,312,16.53956834532374,44.233770394083024
Task_19312,2331,915,79,116,195,2.5447598253275108,47.30309186986699
Task_19313,1724,219,175,139,314,7.836363636363636,35.88991616613276
Task_19314,2769,397,141,86,227,6.957286432160804,52.29389171159048
Task_19315,565,980,31,177,208,0.5759429153924567,19.55634187433853
Task_19316,1089,455,81,92,173,2.388157894736842,25.85202976388966
Task_19317,1759,205,155,144,299,8.53883495145631,36.33072051912425
Task_19318,1191,878,167,80,247,1.3549488054607508,28.853751567918206
Task_19319,522,593,122,66,188,0.8787878787878788,16.946806144487184
Task_19320,1670,669,74,80,154,2.4925373134328357,35.25991230608317
Task_19321,2416,505,125,149,274,4.774703557312253,47.629109369442254
Task_19322,1516,721,97,180,277,2.0997229916897506,34.14167358890796
Task_19323,1780,444,96,59,155,4.0,35.93595554528712
Task_19324,835,70,183,51,234,11.76056338028169,19.532938181902725
Task_19325,1397,249,31,135,166,5.588,30.021853834330667
Task_19326,1743,155,160,71,231,11.173076923076923,34.77122086773062
Task_19327,1833,858,107,182,289,2.1338766006984864,39.6243004246152
Task_19328,802,85,170,82,252,9.325581395348838,19.574465199616863
Task_19329,2362,939,26,24,50,2.5127659574468084,45.45333162168845
Task_19330,1232,932,180,70,250,1.3204715969989282,29.530634690188577
Task_19331,2072,663,123,69,192,3.1204819277108435,41.72520932195515
Task_19332,940,692,164,132,296,1.3564213564213565,24.878372190782226
Task_19333,2239,442,22,181,203,5.054176072234763,44.319608364804374
Task_19334,826,104,83,79,162,7.866666666666666,19.322788547505894
Task_19335,1810,355,91,14,105,5.084269662921348,35.343864263203095
Task_19336,2155,439,69,83,152,4.8977272727272725,42.1679948211703
Task_19337,1910,499,107,99,206,3.82,39.204552193461126
Task_19338,1831,989,158,25,183,1.8494949494949495,38.38543529911946
Task_19339,2592,943,63,77,140,2.7457627118644066,50.65020241459526
Task_19340,2788,228,191,59,250,12.174672489082969,51.7957334305083
Task_19341,668,768,193,198,391,0.8686605981794538,21.29462398382803
Task_19342,756,1018,191,49,240,0.7419038272816487,22.00771803786496
Task_19343,1356,1022,24,137,161,1.3255131964809383,31.57720478307912
Task_19344,1174,90,94,149,243,12.901098901098901,25.78451579125147
Task_19345,1137,72,146,120,266,15.575342465753424,25.06798639239861
Task_19346,617,488,162,198,360,1.261758691206544,19.448521636203385
Task_19347,2195,860,31,64,95,2.5493612078977934,43.522124163879226
Task_19348,1151,921,129,42,171,1.2483731019522777,27.359213309186572
Task_19349,2519,152,164,59,223,16.464052287581698,46.939947604802484
Task_19350,703,526,66,56,122,1.333965844402277,18.996310131753074
Task_19351,2775,669,155,166,321,4.141791044776119,54.07493304577798
Task_19352,656,638,182,167,349,1.02660406885759,20.414964941762285
Task_19353,1375,478,146,85,231,2.8705636743215033,30.5005066004047
Task_19354,581,959,41,37,78,0.6052083333333333,17.763367124873792
Task_19355,2700,296,34,174,208,9.090909090909092,51.190459523490034
Task_19356,2246,278,50,104,154,8.050179211469533,43.41444367209075
Task_19357,2837,817,79,182,261,3.468215158924205,55.407938484569826
Task_19358,2777,645,39,186,225,4.298761609907121,53.639437634648495
Task_19359,2336,136,66,149,215,17.05109489051095,44.53334439687092
Task_19360,631,715,173,167,340,0.8812849162011173,20.26920141844188
Task_19361,1369,174,43,129,172,7.822857142857143,29.00721458247398
Task_19362,2385,494,192,39,231,4.818181818181818,46.027546027548055
Task_19363,1908,408,75,93,168,4.665036674816626,38.585212494948046
Task_19364,1093,261,54,101,155,4.17175572519084,25.132105537181385
Task_19365,1560,143,66,32,98,10.833333333333334,30.40647076281873
Task_19366,543,1019,174,152,326,0.5323529411764706,19.83778960226771
Task_19367,1871,136,52,128,180,13.656934306569344,36.79969567802338
Task_19368,1344,547,18,48,66,2.4525547445255476,28.182165851028525
Task_19369,556,649,88,42,130,0.8553846153846154,16.956603554015917
Task_19370,2547,840,115,181,296,3.028537455410226,50.91095957460626
Task_19371,1880,455,142,56,198,4.12280701754386,38.07840304254736
Task_19372,712,489,168,108,276,1.453061224489796,20.482614084488905
Task_19373,2549,551,43,123,166,4.617753623188406,49.19702203670689
Task_19374,2501,336,97,139,236,7.421364985163205,48.25378395437743
Task_19375,1854,837,109,86,195,2.2124105011933173,39.06115916393298
Task_19376,1760,181,123,92,215,9.67032967032967,35.299629301415074
Task_19377,1999,762,153,78,231,2.6199213630406293,41.24298953446659
Task_19378,2821,257,87,83,170,10.934108527131784,52.149404780811885
Task_19379,2458,188,191,138,329,13.005291005291005,47.463005672003995
Task_19380,608,94,17,51,68,6.4,14.760697323771575
Task_19381,999,910,10,124,134,1.0965971459934138,25.339854522177877
Task_19382,2976,520,41,176,217,5.712092130518234,56.338732359114225
Task_19383,995,858,102,102,204,1.1583236321303843,25.764262569119484
Task_19384,1179,691,28,140,168,1.703757225433526,27.979268295780287
Task_19385,2415,215,25,164,189,11.180555555555555,46.28110916534206
Task_19386,751,503,128,123,251,1.4900793650793651,21.078661071033782
Task_19387,2543,774,158,36,194,3.281290322580645,49.29300278955398
Task_19388,2092,85,104,126,230,24.325581395348838,39.98316501204797
Task_19389,1749,302,158,15,173,5.772277227722772,34.851304482190805
Task_19390,2976,331,60,25,85,8.963855421686747,53.485645974519265
Task_19391,2329,334,147,127,274,6.95223880597015,45.65661496127939
Task_19392,1391,435,109,160,269,3.1903669724770642,31.173021651371133
Task_19393,1855,514,139,82,221,3.6019417475728157,38.15584036839117
Task_19394,1440,109,49,157,206,13.090909090909092,29.941287518896882
Task_19395,1638,711,39,19,58,2.300561797752809,33.011013987396915
Task_19396,2911,756,62,70,132,3.845442536327609,55.0305285652422
Task_19397,942,404,13,138,151,2.325925925925926,23.133362571825558
Task_19398,982,586,148,112,260,1.6729131175468483,25.049076937168156
Task_19399,820,939,52,154,206,0.8723404255319149,23.407058911432998
Task_19400,1897,275,165,188,353,6.8731884057971016,39.069169444463704
Task_19401,506,214,104,143,247,2.353488372093023,16.343897919984432
Task_19402,2979,717,189,122,311,4.149025069637883,57.34887530240125
Task_19403,1627,588,71,178,249,2.762308998302207,35.457142093512026
Task_19404,1206,127,119,40,159,9.421875,25.08570338986708
Task_19405,1099,151,37,188,225,7.230263157894737,25.166459453453303
Task_19406,1173,555,62,47,109,2.1097122302158273,25.96582104085277
Task_19407,2465,581,96,108,204,4.2353951890034365,48.32586395007372
Task_19408,716,955,65,177,242,0.7489539748953975,22.015284554406474
Task_19409,2626,955,140,88,228,2.7468619246861925,51.827466426158416
Task_19410,606,876,160,152,312,0.6909920182440137,20.35277086899315
Task_19411,1320,266,182,87,269,4.943820224719101,29.138190230026055
Task_19412,1264,784,123,168,291,1.6101910828025479,30.354111458900746
Task_19413,2031,1023,124,167,291,1.9833984375,43.26197072374412
Task_19414,1601,960,185,82,267,1.6659729448491154,35.72679208995815
Task_19415,2395,165,167,76,243,14.427710843373495,45.23407585577021
Task_19416,733,376,107,161,268,1.9442970822281167,20.57044455782325
Task_19417,2595,785,139,144,283,3.301526717557252,51.38609559942762
Task_19418,2026,84,164,22,186,23.83529411764706,37.72224753393876
Task_19419,1250,629,55,110,165,1.9841269841269842,29.09293131265594
Task_19420,1107,184,35,87,122,5.9837837837837835,24.614334762223184
Task_19421,2670,186,48,131,179,14.27807486631016,50.146432926797125
Task_19422,2306,65,200,116,316,34.93939393939394,43.57313338718615
Task_19423,1982,67,159,119,278,29.147058823529413,38.32393069023129
Task_19424,1633,753,111,104,215,2.1657824933687,35.68046009225851
Task_19425,614,514,76,180,256,1.192233009708738,19.140937129743794
Task_19426,1425,907,134,18,152,1.5693832599118942,31.19991395335032
Task_19427,1221,969,169,90,259,1.2587628865979381,29.73032547008592
Task_19428,1888,517,149,129,278,3.6447876447876446,39.29697111980692
Task_19429,1243,137,24,37,61,9.007246376811594,25.055948490603768
Task_19430,865,977,42,136,178,0.8844580777096115,23.736416981828302
Task_19431,2470,282,56,96,152,8.72791519434629,46.973347549193186
Task_19432,2396,72,168,136,304,32.821917808219176,44.96239988523553
Task_19433,520,133,49,137,186,3.8805970149253732,15.548103605673772
Task_19434,2207,941,185,31,216,2.342887473460722,44.58860659430545
Task_19435,608,406,45,66,111,1.4938574938574938,17.08253719978562
Task_19436,1604,490,154,165,319,3.2668024439918533,34.952420374022154
Task_19437,1361,475,109,120,229,2.8592436974789917,30.586450602016114
Task_19438,2898,752,177,70,247,3.848605577689243,55.36714041214225
Task_19439,2566,546,153,60,213,4.691042047531993,49.20665839131342
Task_19440,1850,535,171,168,339,3.451492537313433,39.08468802964058
Task_19441,2233,581,182,183,365,3.836769759450172,45.43470595036607
Task_19442,868,480,86,180,266,1.8045738045738047,23.094846078978218
Task_19443,1427,538,59,20,79,2.647495361781076,29.209036961607882
Task_19444,627,783,150,60,210,0.7997448979591837,19.25649196307069
Task_19445,1452,741,53,173,226,1.9568733153638813,33.09620563117307
Task_19446,2498,815,140,63,203,3.0612745098039214,49.00303282443142
Task_19447,2586,927,74,196,270,2.7866379310344827,51.837602019868086
Task_19448,2301,400,47,199,246,5.738154613466334,45.46427335075084
Task_19449,1327,476,180,185,365,2.7819706498951784,30.75965287877054
Task_19450,2123,505,85,87,172,4.195652173913044,42.16537497181389
Task_19451,1630,978,116,180,296,1.664964249233912,36.795783942170296
Task_19452,1555,943,196,178,374,1.6472457627118644,35.847334223393226
Task_19453,2592,281,43,14,57,9.191489361702128,46.76285750656382
Task_19454,2614,571,192,148,340,4.56993006993007,51.27214146245685
Task_19455,2573,512,119,91,210,5.015594541910332,49.61770068693621
Task_19456,1232,991,185,198,383,1.2419354838709677,30.837788154876975
Task_19457,741,931,200,29,229,0.7950643776824035,21.45526515058707
Task_19458,2668,198,110,105,215,13.407035175879397,50.26294526735031
Task_19459,1178,656,67,142,209,1.7929984779299848,28.321330042386933
Task_19460,867,548,197,115,312,1.5792349726775956,23.318937325875538
Task_19461,2222,198,82,29,111,11.165829145728644,41.56274060668551
Task_19462,2867,689,126,104,230,4.155072463768116,55.094578880720974
Task_19463,1920,894,13,42,55,2.1452513966480447,38.43692743678019
Task_19464,1048,625,92,151,243,1.6741214057507987,26.274008548537342
Task_19465,2112,93,200,170,370,22.46808510638298,41.02408951726641
Task_19466,1169,1015,94,199,293,1.1505905511811023,29.63482693944154
Task_19467,864,761,67,56,123,1.1338582677165354,22.402053851873138
Task_19468,2413,136,181,70,251,17.613138686131386,45.223785343741866
Task_19469,1220,789,82,95,177,1.5443037974683544,28.883044596298515
Task_19470,2321,901,130,129,259,2.573170731707317,47.2777558319058
Task_19471,512,664,38,36,74,0.7699248120300752,15.390369678153172
Task_19472,1916,878,196,157,353,2.179749715585893,41.25350174709588
Task_19473,1736,894,133,148,281,1.9396648044692737,38.11348781094058
Task_19474,1938,665,149,18,167,2.90990990990991,38.79659724994744
Task_19475,1380,108,104,108,212,12.660550458715596,28.84760145641931
Task_19476,2696,965,191,185,376,2.790890269151139,54.02911240460097
Task_19477,1879,375,62,93,155,4.997340425531915,37.86328380362209
Task_19478,2176,150,114,29,143,14.410596026490067,40.589872210820204
Task_19479,1360,928,125,79,204,1.463939720129171,31.456484548830517
Task_19480,2643,359,34,92,126,7.341666666666667,49.81117513050893
Task_19481,1163,790,77,66,143,1.470290771175727,27.367916634051678
Task_19482,2283,644,130,78,208,3.5395348837209304,45.26697428078452
Task_19483,2644,88,89,68,157,29.707865168539325,47.38088975119451
Task_19484,504,149,82,40,122,3.36,13.91979151599442
Task_19485,1735,822,125,143,268,2.1081409477521262,37.807619890058255
Task_19486,921,177,122,27,149,5.174157303370786,20.896138480606968
Task_19487,2242,404,34,142,176,5.5358024691358025,43.96973698247624
Task_19488,2150,403,34,147,181,5.321782178217822,42.51437596000043
Task_19489,2406,785,196,20,216,3.0610687022900764,47.054597180479185
Task_19490,1068,375,88,59,147,2.8404255319148937,24.418427514883785
Task_19491,885,79,197,140,337,11.0625,21.530409456282598
Task_19492,821,920,164,159,323,0.8914223669923995,23.82508507640136
Task_19493,805,954,50,158,208,0.8429319371727748,23.254610893059255
Task_19494,1910,351,136,156,292,5.426136363636363,39.210061803107074
Task_19495,1348,796,21,53,74,1.6913425345043915,29.22586137331334
Task_19496,1482,762,140,85,225,1.9423328964613369,33.0588185142907
Task_19497,2810,728,105,167,272,3.8545953360768177,54.596722049703125
Task_19498,962,993,10,191,201,0.9678068410462777,25.724658788358862
Task_19499,973,461,150,171,321,2.106060606060606,24.889908375246943
Task_19500,584,215,164,158,322,2.7037037037037037,17.93877408529992
Task_19501,2179,178,65,107,172,12.1731843575419,41.81938741223169
Task_19502,907,99,147,55,202,9.07,20.91919304146521
Task_19503,1933,985,95,58,153,1.960446247464503,40.04414097807608
Task_19504,1406,611,133,200,333,2.2973856209150325,32.31338732490524
Task_19505,2015,966,197,133,330,2.0837642192347468,42.95722149795811
Task_19506,1861,438,40,30,70,4.239179954441913,35.9261736003569
Task_19507,1515,306,80,183,263,4.93485342019544,32.84977227660975
Task_19508,1237,303,61,94,155,4.069078947368421,27.484142372991883
Task_19509,1000,894,70,188,258,1.1173184357541899,26.368428025562753
Task_19510,1035,1020,179,80,259,1.0137120470127325,26.807108186525483
Task_19511,966,348,44,128,172,2.767908309455587,23.628395351084986
Task_19512,570,709,16,87,103,0.8028169014084507,17.532735151474036
Task_19513,1061,524,66,119,185,2.020952380952381,25.784443138567656
Task_19514,524,488,68,87,155,1.0715746421267893,16.44092892703394
Task_19515,2686,220,95,132,227,12.153846153846153,50.75275895976259
Task_19516,613,521,138,162,300,1.1743295019157087,19.188643565821312
Task_19517,1833,557,100,84,184,3.28494623655914,37.56760717444473
Task_19518,2699,413,139,181,320,6.519323671497585,52.062099599412555
Task_19519,1789,318,92,191,283,5.608150470219436,37.274570018472815
Task_19520,1726,186,46,197,243,9.229946524064172,35.7575420052854
Task_19521,1143,950,47,72,119,1.2018927444794953,27.458732795789164
Task_19522,1397,408,193,11,204,3.415647921760391,29.879508637980376
Task_19523,1836,981,140,31,171,1.8696537678207739,38.42629106778203
Task_19524,1634,173,92,167,259,9.39080459770115,33.80841750433722
Task_19525,1886,683,109,70,179,2.757309941520468,38.61419890432056
Task_19526,936,249,50,147,197,3.744,23.220626301217834
Task_19527,774,994,110,45,155,0.7778894472361809,21.464208677870484
Task_19528,1015,157,25,105,130,6.424050632911392,22.86000071946275
Task_19529,1956,911,71,89,160,2.1447368421052633,40.68948244975899
Task_19530,1112,135,41,200,241,8.176470588235293,25.298831925902686
Task_19531,1839,924,42,182,224,1.988108108108108,39.64543114464242
Task_19532,2808,872,171,90,261,3.216494845360825,54.6906550402559
Task_19533,2645,542,47,30,77,4.871086556169429,48.67731546524629
Task_19534,2706,290,191,142,333,9.29896907216495,51.75251822461123
Task_19535,2997,688,53,200,253,4.34978229317852,57.5647856299178
Task_19536,2829,87,48,48,96,32.14772727272727,49.62773064762522
Task_19537,2195,1004,179,173,352,2.18407960199005,46.08559896843213
Task_19538,1692,1010,197,200,397,1.6735905044510386,38.3620855827817
Task_19539,2186,431,36,126,162,5.060185185185185,42.951187231950335
Task_19540,568,877,39,159,198,0.6469248291571754,19.19736448393251
Task_19541,2359,254,50,103,153,9.250980392156864,45.10824748837089
Task_19542,1628,512,22,112,134,3.1734892787524367,34.17244068560006
Task_19543,1895,439,79,70,149,4.306818181818182,37.90721386807534
Task_19544,2735,75,148,89,237,35.98684210526316,49.8476397424298
Task_19545,2185,378,143,130,273,5.7651715039577835,43.52627530177674
Task_19546,2449,793,179,128,307,3.084382871536524,49.18286836898235
Task_19547,2863,803,26,124,150,3.560945273631841,54.75974098866064
Task_19548,915,297,69,62,131,3.0704697986577183,21.88312708958855
Task_19549,1915,71,109,40,149,26.59722222222222,35.480246487528476
Task_19550,2653,656,101,72,173,4.038051750380517,50.78725700818203
Task_19551,2949,918,14,151,165,3.2089227421109903,56.86076726232586
Task_19552,957,164,48,174,222,5.8,23.047238944818734
Task_19553,1125,423,45,109,154,2.6533018867924527,25.981192642530704
Task_19554,563,743,164,111,275,0.7567204301075269,18.890364264783337
Task_19555,942,622,100,84,184,1.5120385232744784,23.623046001629778
Task_19556,2878,212,129,29,158,13.511737089201878,52.28730239117193
Task_19557,1595,667,101,37,138,2.3877245508982035,33.400372972602
Task_19558,1686,528,29,195,224,3.1871455576559544,36.028053426912386
Task_19559,1353,109,48,170,218,12.3,28.619166533853086
Task_19560,1447,120,117,171,288,11.958677685950413,30.655074618275307
Task_19561,1471,114,133,86,219,12.791304347826086,30.289040919202794
Task_19562,2857,999,89,125,214,2.857,55.908245679615675
Task_19563,2466,637,45,167,212,3.865203761755486,48.58962968832609
Task_19564,1276,489,86,160,246,2.6040816326530614,29.462488876818526
Task_19565,1213,203,15,116,131,5.946078431372549,26.7122927725167
Task_19566,2645,694,161,26,187,3.805755395683453,50.53817333867642
Task_19567,1200,429,154,88,242,2.7906976744186047,27.65188389927991
Task_19568,1487,86,166,82,248,17.091954022988507,30.303233271352337
Task_19569,2943,496,142,22,164,5.921529175050302,54.44110160697293
Task_19570,1268,603,153,157,310,2.0993377483443707,29.936143286756806
Task_19571,2052,113,62,101,163,18.0,39.226457740621946
Task_19572,1339,434,52,22,74,3.0781609195402297,27.59228266916837
Task_19573,1115,939,128,71,199,1.1861702127659575,27.489981816341995
Task_19574,1957,771,40,195,235,2.534974093264249,41.10550276886593
Task_19575,1161,287,46,146,192,4.03125,26.72291882254238
Task_19576,1897,843,20,86,106,2.2476303317535544,39.04753423239501
Task_19577,1171,880,112,153,265,1.3291713961407492,29.012347916613212
Task_19578,2006,616,22,151,173,3.2512155591572123,40.93995260241767
Task_19579,2778,696,160,200,360,3.985652797704448,54.43363254294743
Task_19580,2594,212,97,156,253,12.178403755868544,49.37431095802549
Task_19581,1580,833,132,72,204,1.894484412470024,34.577550595579446
Task_19582,2999,249,93,182,275,11.996,56.14093763678637
Task_19583,1679,564,134,189,323,2.9716814159292033,36.427566751842896
Task_19584,2776,790,137,71,208,3.509481668773704,53.38850856850968
Task_19585,950,506,90,59,149,1.873767258382643,22.996371941610914
Task_19586,896,614,164,195,359,1.4569105691056912,24.287352464611928
Task_19587,1301,657,153,11,164,1.9772036474164134,28.879845408998417
Task_19588,2096,94,184,180,364,22.063157894736843,40.731647190336034
Task_19589,581,605,70,106,176,0.9587458745874587,18.24242579046555
Task_19590,2990,269,123,159,282,11.074074074074074,55.96007308309578
Task_19591,1154,200,116,124,240,5.741293532338308,26.4671772636605
Task_19592,2331,962,51,11,62,2.4205607476635516,44.806685555798914
Task_19593,1652,501,10,12,22,3.2908366533864544,32.36417649698873
Task_19594,2429,403,166,176,342,6.012376237623762,47.84820438198343
Task_19595,750,136,123,169,292,5.474452554744525,19.831597375183552
Task_19596,1983,311,142,16,158,6.355769230769231,38.314375618951075
Task_19597,2440,324,169,17,186,7.507692307692308,45.786471406822955
Task_19598,2305,519,193,171,364,4.4326923076923075,46.35466829675156
Task_19599,1148,443,40,192,232,2.5855855855855854,27.245062061076826
Task_19600,1264,253,32,28,60,4.9763779527559056,25.872886504814588
Task_19601,2236,89,58,86,144,24.844444444444445,41.46435189242931
Task_19602,2489,516,116,30,146,4.81431334622824,47.19380710040605
Task_19603,1348,712,163,179,342,1.8906030855539973,31.720149650537333
Task_19604,1314,1022,83,69,152,1.284457478005865,30.326617833792046
Task_19605,2353,415,175,97,272,5.65625,46.28745085533413
Task_19606,1246,972,63,32,95,1.2805755395683454,28.379197736664086
Task_19607,581,871,187,56,243,0.6662844036697247,19.18679795275159
Task_19608,2726,178,145,131,276,15.22905027932961,50.97024373782182
Task_19609,912,106,81,61,142,8.523364485981308,20.450813818607408
Task_19610,2280,610,84,142,226,3.7315875613747953,45.631833900603205
Task_19611,1309,432,89,199,288,3.023094688221709,30.048287738470023
Task_19612,2262,603,182,152,334,3.7450331125827816,45.77866831482271
Task_19613,1793,245,198,98,296,7.288617886178862,36.93509547059351
Task_19614,1750,674,172,11,183,2.5925925925925926,36.031302605698876
Task_19615,1427,614,101,22,123,2.3203252032520325,30.424412617006652
Task_19616,2835,256,159,60,219,11.03112840466926,52.50908897593249
Task_19617,1920,810,83,177,260,2.367447595561036,40.76864919761713
Task_19618,937,168,174,144,318,5.544378698224852,23.046748380205894
Task_19619,2986,365,93,128,221,8.158469945355192,56.029351977571885
Task_19620,596,933,134,46,180,0.6381156316916489,18.980453790826786
Task_19621,2296,496,70,21,91,4.619718309859155,43.47020114409941
Task_19622,1538,569,154,169,323,2.6982456140350877,34.181280180403185
Task_19623,937,211,156,17,173,4.419811320754717,21.644350213953924
Task_19624,1764,646,30,149,179,2.7264296754250386,37.187135892356245
Task_19625,1941,478,165,107,272,4.052192066805845,39.952049577669165
Task_19626,1839,415,137,47,184,4.420673076923077,36.77383075055648
Task_19627,1752,148,60,142,202,11.758389261744966,35.34589749450743
Task_19628,2990,270,188,111,299,11.033210332103321,55.97004890334669
Task_19629,2634,277,85,62,147,9.474820143884893,48.91772524933316
Task_19630,699,917,51,142,193,0.761437908496732,21.395018210672863
Task_19631,2840,383,153,180,333,7.395833333333333,54.24981320062693
Task_19632,2903,687,175,176,351,4.219476744186046,56.30937356060847
Task_19633,1143,108,83,137,220,10.486238532110091,25.203390097071473
Task_19634,2603,419,80,173,253,6.197619047619048,50.37638117867859
Task_19635,2673,258,127,150,277,10.32046332046332,50.87388134510193
Task_19636,1151,599,195,63,258,1.9183333333333332,27.23746868531303
Task_19637,1839,110,21,148,169,16.56756756756757,35.67427040789678
Task_19638,728,619,195,189,384,1.1741935483870967,21.732429857522806
Task_19639,2560,277,192,191,383,9.20863309352518,49.69517749487761
Task_19640,2566,203,10,25,35,12.57843137254902,45.94193325936044
Task_19641,1345,1002,62,147,209,1.340977068793619,32.00651897792406
Task_19642,1274,338,104,49,153,3.75811209439528,27.37837781132708
Task_19643,2395,532,14,31,45,4.493433395872421,44.64489071732775
Task_19644,2755,699,52,44,96,3.9357142857142855,51.404841842609436
Task_19645,645,839,80,135,215,0.7678571428571429,20.37363876054839
Task_19646,998,361,121,63,184,2.7569060773480665,23.536760083773885
Task_19647,1433,148,128,51,179,9.61744966442953,29.302681638708076
Task_19648,2783,296,91,124,215,9.37037037037037,52.48232014013582
Task_19649,1318,867,77,30,107,1.5184331797235022,29.375082400575696
Task_19650,1209,286,147,151,298,4.2125435540069684,27.929175638296712
Task_19651,1314,239,89,131,220,5.475,29.089277145359144
Task_19652,1709,700,47,30,77,2.4379457917261056,34.353987800973734
Task_19653,1275,171,77,73,150,7.412790697674419,26.906468365510097
Task_19654,2673,361,164,23,187,7.383977900552487,49.88295407719907
Task_19655,2445,843,94,14,108,2.896919431279621,47.14112817619114
Task_19656,2158,380,85,56,141,5.664041994750656,41.714004724708815
Task_19657,1711,1008,182,152,334,1.6957383548067393,38.30267035232111
Task_19658,2151,319,132,131,263,6.721875,42.74682282721403
Task_19659,978,639,81,57,138,1.528125,23.782784596744506
Task_19660,2718,889,200,46,246,3.053932584269663,52.64564974021999
Task_19661,625,800,131,122,253,0.7802746566791511,20.00244090570697
Task_19662,2562,756,23,35,58,3.3844121532364597,48.13354121194066
Task_19663,2440,679,27,63,90,3.588235294117647,46.72152599569532
Task_19664,2283,1014,134,112,246,2.2492610837438423,46.94408213457114
Task_19665,2112,408,190,11,201,5.163814180929095,41.18034552613319
Task_19666,2480,414,90,84,174,5.975903614457831,47.47104177133462
Task_19667,1771,294,66,119,185,6.003389830508475,36.27696006037155
Task_19668,2685,910,50,12,62,2.947310647639956,50.2831318843561
Task_19669,1821,516,139,116,255,3.5222437137330753,38.11030012808479
Task_19670,1921,862,159,41,200,2.2259559675550404,39.73304636247219
Task_19671,862,275,198,49,247,3.1231884057971016,21.404640537463937
Task_19672,2218,940,125,197,322,2.357066950053135,46.15086094646441
Task_19673,2728,81,129,69,198,33.26829268292683,49.18119955953524
Task_19674,2686,233,186,136,322,11.478632478632479,51.16727210666528
Task_19675,812,601,84,14,98,1.3488372093023255,20.296231008809954
Task_19676,1400,527,92,127,219,2.6515151515151514,31.410998328773818
Task_19677,1659,563,100,152,252,2.9414893617021276,35.73347125387828
Task_19678,2688,866,116,123,239,3.1003460207612457,52.884516229948474
Task_19679,2487,783,72,132,204,3.1721938775510203,49.42213300321206
Task_19680,1056,829,56,29,85,1.272289156626506,24.849444430175165
Task_19681,699,466,98,134,232,1.4967880085653105,20.084303157280686
Task_19682,2506,916,118,77,195,2.732824427480916,49.530717341078635
Task_19683,2648,182,189,141,330,14.469945355191257,50.24062744216973
Task_19684,1589,776,24,24,48,2.045045045045045,32.58072648108655
Task_19685,1418,371,170,67,237,3.8118279569892475,30.673199773243997
Task_19686,1160,85,84,87,171,13.488372093023257,24.770754367475604
Task_19687,1669,292,36,66,102,5.696245733788396,33.40946220352419
Task_19688,1031,811,34,114,148,1.269704433497537,25.589959836142416
Task_19689,1049,870,123,151,274,1.2043628013777268,27.044357076341758
Task_19690,1766,452,83,76,159,3.8984547461368653,35.95713278709697
Task_19691,2670,830,180,35,215,3.2129963898916967,51.579419792677875
Task_19692,724,493,162,131,293,1.465587044534413,20.809904792717806
Task_19693,1060,117,86,172,258,8.983050847457626,24.41131223096856
Task_19694,1624,924,40,50,90,1.7556756756756757,34.22629993824059
Task_19695,566,829,136,158,294,0.6819277108433734,19.50906317859706
Task_19696,1209,963,122,160,282,1.254149377593361,29.875722075689335
Task_19697,2249,166,101,81,182,13.467065868263473,42.484460739811
Task_19698,2403,221,73,133,206,10.824324324324325,46.251267147971355
Task_19699,808,286,122,127,249,2.8153310104529616,21.334174610136213
Task_19700,2202,966,194,73,267,2.277145811789038,45.141751019604385
Task_19701,1795,772,17,52,69,2.3221216041397152,36.248982075426426
Task_19702,2411,534,175,23,198,4.506542056074767,46.394301166101165
Task_19703,1406,136,74,35,109,10.262773722627736,28.076925085661454
Task_19704,1735,505,179,84,263,3.4288537549407114,36.40917823945333
Task_19705,1420,672,186,100,286,2.109955423476969,32.36759659720523
Task_19706,1694,839,36,196,232,2.0166666666666666,37.1353166009103
Task_19707,2955,463,130,62,192,6.368534482758621,55.03509756568828
Task_19708,803,789,110,196,306,1.0164556962025317,23.05236247685967
Task_19709,2046,813,60,131,191,2.5135135135135136,42.470233345122054
Task_19710,1901,927,113,31,144,2.0484913793103448,39.11727086464368
Task_19711,2731,867,191,174,365,3.1463133640552994,54.211618362433285
Task_19712,1149,536,191,21,212,2.1396648044692737,26.425003130526658
Task_19713,1668,678,12,114,126,2.456553755522828,35.4163947701907
Task_19714,1668,894,86,123,209,1.8636871508379889,36.716903629667115
Task_19715,2658,157,169,197,366,16.82278481012658,50.41828717929607
Task_19716,2484,440,24,51,75,5.63265306122449,46.03569000862237
Task_19717,1770,197,127,87,214,8.93939393939394,35.808151089182196
Task_19718,1975,713,121,64,185,2.7661064425770308,40.17365051719546
Task_19719,2142,509,124,19,143,4.2,41.376997462933424
Task_19720,1782,139,117,39,156,12.728571428571428,34.223711009541724
Task_19721,1535,887,139,59,198,1.7286036036036037,33.866487485473776
Task_19722,2207,532,55,132,187,4.140712945590995,44.111144492044694
Task_19723,575,593,35,195,230,0.968013468013468,18.464147898971607
Task_19724,983,318,158,40,198,3.0815047021943576,23.162142778062503
Task_19725,2674,138,68,32,100,19.237410071942445,47.91737134821346
Task_19726,1396,635,59,81,140,2.1949685534591197,30.8402066062085
Task_19727,569,597,186,29,215,0.9515050167224081,17.68079680561228
Task_19728,690,991,99,93,192,0.6955645161290323,21.357932535785338
Task_19729,1595,625,88,116,204,2.547923322683706,34.665635660259206
Task_19730,2843,927,191,55,246,3.0635775862068964,55.03740775063215
Task_19731,1660,888,33,135,168,1.8672665916760405,36.22553357919542
Task_19732,1237,764,59,123,182,1.6169934640522876,29.279287644801258
Task_19733,1803,276,186,151,337,6.509025270758123,37.46052655810187
Task_19734,1633,403,28,46,74,4.042079207920792,32.21898258818469
Task_19735,540,222,38,50,88,2.42152466367713,14.88234779016035
Task_19736,1185,916,106,162,268,1.292257360959651,29.32081888942024
Task_19737,665,121,108,29,137,5.450819672131147,16.554501234052456
Task_19738,735,762,57,173,230,0.963302752293578,21.64361179412695
Task_19739,2620,602,69,49,118,4.344941956882256,49.36160045115994
Task_19740,2129,928,160,40,200,2.2917115177610334,43.23834330599203
Task_19741,1007,189,91,62,153,5.3,22.994879608223915
Task_19742,2648,937,195,82,277,2.8230277185501067,52.300586536227456
Task_19743,920,989,169,162,331,0.9292929292929293,25.652584384866845
Task_19744,2404,577,111,133,244,4.159169550173011,47.51121224402514
Task_19745,1650,982,120,162,282,1.6785350966429298,37.03564234824997
Task_19746,2367,817,187,17,204,2.893643031784841,46.4497991318111
Task_19747,2115,580,121,87,208,3.640275387263339,42.46037297940874
Task_19748,1026,482,132,55,187,2.124223602484472,24.552474284100253
Task_19749,2303,110,100,73,173,20.74774774774775,42.61790060863844
Task_19750,1086,206,189,107,296,5.246376811594203,25.642229053177857
Task_19751,716,590,37,17,54,1.2115059221658206,18.105858768659484
Task_19752,1975,830,116,63,179,2.3766546329723224,40.45723233734948
Task_19753,2019,94,149,38,187,21.25263157894737,37.858137500668626
Task_19754,1401,815,114,170,284,1.7169117647058822,32.59235176069089
Task_19755,1234,250,67,98,165,4.916334661354582,27.58006382705283
Task_19756,2668,226,36,98,134,11.753303964757709,49.696712402030016
Task_19757,1571,548,64,149,213,2.8615664845173043,34.24048834286234
Task_19758,946,777,154,90,244,1.2159383033419022,24.693392022482794
Task_19759,1822,974,155,125,280,1.8687179487179486,39.68661519755032
Task_19760,1719,345,100,112,212,4.968208092485549,35.74396470305424
Task_19761,1415,294,36,195,231,4.796610169491525,30.983749959364555
Task_19762,2741,645,159,56,215,4.243034055727554,52.39530955836679
Task_19763,1687,752,85,111,196,2.240371845949535,36.50474515191223
Task_19764,2338,309,12,23,35,7.541935483870968,42.72878237886579
Task_19765,689,195,113,75,188,3.5153061224489797,18.358054146188955
Task_19766,1658,866,163,109,272,1.9123414071510958,36.692775988341474
Task_19767,814,930,142,145,287,0.874328678839957,23.56229215750263
Task_19768,1444,974,180,112,292,1.481025641025641,33.68889881678491
Task_19769,1371,157,94,143,237,8.677215189873417,29.5687457326335
Task_19770,2789,664,13,51,64,4.193984962406015,51.67133824264682
Task_19771,1788,622,193,116,309,2.869983948635634,38.16647572878885
Task_19772,878,128,43,147,190,6.8062015503875966,21.217532213005303
Task_19773,504,222,69,39,108,2.2600896860986546,14.425595730677413
Task_19774,1134,257,172,59,231,4.395348837209302,25.684743373131536
Task_19775,2230,256,64,160,224,8.67704280155642,43.77016923078744
Task_19776,782,150,33,52,85,5.178807947019868,18.395531984672782
Task_19777,2187,668,170,14,184,3.2690582959641254,42.9105332354525
Task_19778,884,620,64,192,256,1.423510466988728,23.773976804526786
Task_19779,2670,451,69,118,187,5.907079646017699,51.12098321526536
Task_19780,1503,201,77,161,238,7.4405940594059405,32.150737915849064
Task_19781,2195,451,120,17,137,4.856194690265487,42.010656326947775
Task_19782,1232,923,26,25,51,1.3333333333333333,27.557752694440026
Task_19783,846,739,28,149,177,1.1432432432432433,22.766459980564914
Task_19784,1617,259,137,160,297,6.219230769230769,34.29524164775763
Task_19785,1914,397,112,82,194,4.809045226130653,38.5892556628524
Task_19786,1947,963,151,118,269,2.0197095435684647,41.573415648613135
Task_19787,2261,426,133,92,225,5.295081967213115,44.51411552296438
Task_19788,931,770,73,68,141,1.2075226977950713,23.682588696585977
Task_19789,2012,311,134,29,163,6.448717948717949,39.112639133389514
Task_19790,688,634,64,75,139,1.0834645669291338,19.445244819617646
Task_19791,2983,945,157,192,349,3.153276955602537,58.403084257591196
Task_19792,1053,409,166,129,295,2.5682926829268293,25.81297850975186
Task_19793,2471,940,159,178,337,2.6259298618490967,50.199663139622146
Task_19794,2792,638,188,96,284,4.369327073552426,53.99990302688911
Task_19795,2018,758,88,139,227,2.6587615283267456,41.92025409056904
Task_19796,2353,404,67,104,171,5.809876543209876,45.696623083769985
Task_19797,1913,646,48,165,213,2.956723338485317,39.98423950150205
Task_19798,2964,435,158,101,259,6.798165137614679,55.936800610876105
Task_19799,1779,673,181,148,329,2.6394658753709197,38.321237374165364
Task_19800,2474,575,83,197,280,4.295138888888889,48.92300685169448
Task_19801,2895,768,98,128,226,3.764629388816645,55.81890868829265
Task_19802,2154,471,32,83,115,4.563559322033898,42.183363585052284
Task_19803,1403,811,23,200,223,1.727832512315271,32.47682478030373
Task_19804,2679,602,100,191,291,4.442786069651741,52.242749293237374
Task_19805,1038,797,170,101,271,1.300751879699248,26.546982432075612
Task_19806,1546,885,101,81,182,1.744920993227991,34.00301027519367
Task_19807,1507,412,174,169,343,3.648910411622276,33.28186472595746
Task_19808,2156,795,64,112,176,2.708542713567839,43.905064209095734
Task_19809,2213,929,104,48,152,2.379569892473118,44.03902646460733
Task_19810,1896,688,83,66,149,2.7518142235123366,38.62249715635087
Task_19811,2625,422,21,102,123,6.205673758865248,49.633292062744154
Task_19812,1644,909,41,186,227,1.8065934065934066,36.52708326359062
Task_19813,614,914,72,76,148,0.6710382513661202,19.438506903489753
Task_19814,2704,904,43,195,238,2.9878453038674033,53.371635710803595
Task_19815,867,680,134,88,222,1.2731277533039647,22.987274613034305
Task_19816,1442,145,121,148,269,9.876712328767123,30.677358170756946
Task_19817,1965,280,39,16,55,6.99288256227758,36.85231085796595
Task_19818,1915,666,139,104,243,2.871064467766117,40.00129268671561
Task_19819,626,139,125,95,220,4.4714285714285715,17.41004254423553
Task_19820,2694,727,173,29,202,3.7005494505494507,51.58140910593024
Task_19821,2195,834,132,28,160,2.62874251497006,43.50225070705619
Task_19822,659,230,31,172,203,2.8528138528138527,18.691669713115385
Task_19823,2791,211,79,125,204,13.165094339622641,52.32140618867289
Task_19824,1993,849,86,68,154,2.344705882352941,40.59579790423298
Task_19825,808,128,166,139,305,6.263565891472868,20.648978902414466
Task_19826,1221,178,107,127,234,6.82122905027933,27.033988474978134
Task_19827,834,554,136,128,264,1.5027027027027027,22.617840887281123
Task_19828,713,228,183,182,365,3.11353711790393,20.24758513150149
Task_19829,1801,493,14,66,80,3.645748987854251,35.89878478709638
Task_19830,2720,584,86,190,276,4.64957264957265,52.80748185792033
Task_19831,751,325,116,27,143,2.303680981595092,18.961921444513532
Task_19832,1607,266,102,164,266,6.0187265917602994,34.02744333576406
Task_19833,1315,1010,111,84,195,1.3006923837784372,30.955908994376944
Task_19834,2736,687,127,144,271,3.9767441860465116,53.256638216571844
Task_19835,2156,279,40,63,103,7.7,41.07419586738977
Task_19836,1559,700,111,195,306,2.223965763195435,34.88624073249155
Task_19837,2443,587,198,87,285,4.154761904761905,48.0238340994444
Task_19838,1837,982,99,100,199,1.8687690742624619,39.549128945586425
Task_19839,1580,458,38,42,80,3.4422657952069717,31.88391082221608
Task_19840,585,405,98,184,282,1.4408866995073892,18.3622602543013
Task_19841,1333,281,128,98,226,4.726950354609929,29.473773475542856
Task_19842,1752,233,150,192,342,7.487179487179487,36.58651809747548
Task_19843,2730,876,60,53,113,3.112884834663626,52.14923136684941
Task_19844,903,476,50,53,103,1.8930817610062893,21.81493758121391
Task_19845,2506,723,52,80,132,3.4613259668508287,48.8026319871419
Task_19846,1625,740,124,41,165,2.192982456140351,34.4448042576427
Task_19847,2277,93,172,96,268,24.22340425531915,43.05386913148627
Task_19848,1197,982,66,125,191,1.2177009155645981,29.381448809861183
Task_19849,2534,534,100,98,198,4.736448598130841,49.176700255992785
Task_19850,615,588,53,172,225,1.0441426146010186,19.135731247460843
Task_19851,934,867,61,23,84,1.076036866359447,23.012543826492674
Task_19852,2412,229,91,78,169,10.486956521739131,45.61439324563637
Task_19853,2528,371,171,161,332,6.795698924731183,49.240812754778744
Task_19854,1299,734,103,99,202,1.7673469387755103,30.23598881927997
Task_19855,846,922,150,33,183,0.9165763813651138,22.70973089492126
Task_19856,2678,982,55,137,192,2.7243133265513735,53.05592691797696
Task_19857,1041,626,69,87,156,1.6602870813397128,25.23728785618104
Task_19858,2074,965,99,52,151,2.1469979296066253,42.273611487502265
Task_19859,1645,916,31,173,204,1.7938931297709924,36.46475573905321
Task_19860,2716,740,21,143,164,3.6653171390013495,52.49233877960234
Task_19861,2851,881,170,196,366,3.2324263038548753,56.19360813032247
Task_19862,579,766,63,149,212,0.7548891786179922,19.08242043915111
Task_19863,1103,137,86,81,167,7.992753623188406,24.25569219777998
Task_19864,1815,217,115,28,143,8.325688073394495,35.42979263803502
Task_19865,2727,353,187,153,340,7.703389830508475,52.35218479276606
Task_19866,1323,146,97,22,119,9.0,26.73999706449482
Task_19867,2761,392,198,143,341,7.025445292620865,53.011982974928344
Task_19868,727,706,66,181,247,1.0282885431400284,21.37455098191886
Task_19869,2153,912,184,143,327,2.35815991237678,44.977028216627694
Task_19870,2007,411,176,68,244,4.871359223300971,40.156014614437645
Task_19871,1512,136,41,190,231,11.036496350364963,31.615461108875447
Task_19872,1595,788,81,172,253,2.0215462610899873,35.5622163634411
Task_19873,607,395,14,165,179,1.5328282828282829,18.066556175316215
Task_19874,1756,702,78,90,168,2.4978662873399715,36.9966177806871
Task_19875,1952,876,32,179,211,2.225769669327252,41.24954918236107
Task_19876,1239,786,47,103,150,1.5743329097839898,28.90891028029091
Task_19877,1857,614,168,31,199,3.0195121951219512,37.94369626646496
Task_19878,735,196,184,153,337,3.730964467005076,20.27426094139903
Task_19879,519,974,74,110,184,0.5323076923076923,18.56861821984531
Task_19880,2912,529,156,16,172,5.494339622641509,53.999166896075764
Task_19881,1887,851,129,41,170,2.214788732394366,38.82434533692552
Task_19882,1887,916,134,65,199,2.057797164667394,39.64328832786337
Task_19883,1204,633,200,63,263,1.8990536277602523,28.205599237672615
Task_19884,2868,587,45,62,107,4.877551020408164,53.26550787059903
Task_19885,1417,227,65,152,217,6.214912280701754,30.777374828880976
Task_19886,1732,68,82,180,262,25.10144927536232,34.482370349620204
Task_19887,888,415,20,77,97,2.1346153846153846,21.470801839953804
Task_19888,1845,191,150,59,209,9.609375,36.693654456677365
Task_19889,2121,276,64,79,143,7.657039711191335,41.14803921277039
Task_19890,984,490,36,155,191,2.0040733197556007,24.554728704650273
Task_19891,1576,132,37,176,213,11.849624060150376,32.40103576340767
Task_19892,2801,179,72,126,198,15.561111111111112,51.91527263065594
Task_19893,1994,606,107,48,155,3.2850082372322897,39.597224967894235
Task_19894,1942,372,95,186,281,5.206434316353888,39.85024631138041
Task_19895,544,546,151,98,249,0.9945155393053017,17.85856535866706
Task_19896,2511,899,110,130,240,2.79,50.1979494529373
Task_19897,1511,461,135,11,146,3.2705627705627704,31.382973041222993
Task_19898,871,848,80,152,232,1.0259128386336867,23.997533498135606
Task_19899,740,614,149,114,263,1.2032520325203253,21.251650988615953
Task_19900,862,155,173,188,361,5.5256410256410255,22.030251353060866
Task_19901,992,359,162,75,237,2.7555555555555555,23.98382570582571
Task_19902,2379,824,33,39,72,2.8836363636363638,45.35099196935425
Task_19903,2410,741,117,13,130,3.247978436657682,46.41869120516008
Task_19904,2965,551,11,53,64,5.371376811594203,54.058979543938484
Task_19905,829,878,157,137,294,0.9431171786120591,23.661247769095905
Task_19906,1447,471,145,130,275,3.065677966101695,32.15708112203467
Task_19907,768,420,100,132,232,1.824228028503563,21.05808563629502
Task_19908,2893,729,150,47,197,3.963013698630137,54.70337234754653
Task_19909,2492,716,33,37,70,3.4755927475592747,46.87580823370859
Task_19910,2675,493,66,72,138,5.41497975708502,50.457124288440674
Task_19911,760,871,177,171,348,0.8715596330275229,22.837339907283326
Task_19912,1689,203,157,141,298,8.279411764705882,35.2093553328258
Task_19913,1968,634,190,19,209,3.099212598425197,39.57636239646774
Task_19914,2373,162,192,146,338,14.558282208588958,45.73240546753999
Task_19915,1159,320,193,44,237,3.6105919003115265,26.110918440619567
Task_19916,953,227,51,61,112,4.1798245614035086,21.924977873397584
Task_19917,1050,128,84,179,263,8.13953488372093,24.356426374866697
Task_19918,551,423,10,179,189,1.2995283018867925,17.37560671605822
Task_19919,1577,474,34,65,99,3.32,32.5045982231261
Task_19920,2130,846,167,37,204,2.5147579693034237,43.032829853372995
Task_19921,628,864,171,12,183,0.7260115606936416,19.03847269027195
Task_19922,966,403,143,79,222,2.391089108910891,23.722118403595655
Task_19923,2140,311,137,43,180,6.858974358974359,41.170326536705495
Task_19924,2832,938,134,77,211,3.015974440894569,54.8392620890007
Task_19925,1391,345,127,129,256,4.020231213872832,30.779132075091425
Task_19926,1248,646,177,92,269,1.928902627511592,29.373032479598717
Task_19927,1897,269,162,121,283,7.025925925925926,38.63460219116972
Task_19928,2809,721,160,83,243,3.8905817174515236,54.01156690105599
Task_19929,1120,388,152,101,253,2.879177377892031,26.575963450616086
Task_19930,1283,1006,72,104,176,1.2740814299900696,30.598769014166425
Task_19931,709,980,154,119,273,0.7227319062181448,22.06012980129783
Task_19932,884,169,160,194,354,5.2,22.44472326678935
Task_19933,1453,984,41,68,109,1.4751269035532995,32.298487354561466
Task_19934,1881,1008,170,25,195,1.8642220019821605,39.469556059773375
Task_19935,682,113,105,175,280,5.982456140350878,18.445287099745517
Task_19936,501,911,56,189,245,0.5493421052631579,18.580136928337662
Task_19937,808,669,184,31,215,1.2059701492537314,21.612243699627456
Task_19938,1886,601,40,183,223,3.132890365448505,39.37533274239302
Task_19939,1932,876,187,168,355,2.202964652223489,41.52592874509592
Task_19940,2675,722,190,42,232,3.699861687413555,51.37949865556268
Task_19941,1351,772,26,168,194,1.7477360931435963,31.298875865223227
Task_19942,754,713,144,20,164,1.0560224089635855,20.309858728820675
Task_19943,1176,258,139,70,209,4.54054054054054,26.3500196480917
Task_19944,1483,847,141,61,202,1.7488207547169812,32.936198362059805
Task_19945,1685,718,87,116,203,2.343532684283727,36.3669151313969
Task_19946,2305,226,120,123,243,10.154185022026432,44.74776571951444
Task_19947,3000,478,72,118,190,6.263048016701461,56.47809788498825
Task_19948,943,961,135,130,265,0.9802494802494802,25.58007104061979
Task_19949,675,794,65,133,198,0.8490566037735849,20.603394387543297
Task_19950,1596,979,183,159,342,1.6285714285714286,36.43663930482379
Task_19951,2271,977,76,54,130,2.3220858895705523,45.44169589608513
Task_19952,836,600,95,30,125,1.3910149750415974,21.21189387475999
Task_19953,1552,235,163,155,318,6.576271186440678,33.27204850916011
Task_19954,696,889,88,135,223,0.7820224719101123,21.27875364014668
Task_19955,2533,562,158,131,289,4.49911190053286,49.70591233064531
Task_19956,2883,363,149,134,283,7.920329670329671,54.569361111611954
Task_19957,1705,848,85,27,112,2.0082449941107186,35.42901642550492
Task_19958,2758,707,83,191,274,3.8954802259887007,53.804446056645276
Task_19959,1384,794,158,132,290,1.7408805031446541,32.22906140918128
Task_19960,2321,765,166,64,230,3.0300261096605743,46.171106712615305
Task_19961,2360,285,143,67,210,8.251748251748252,45.159848615709244
Task_19962,2691,157,168,103,271,17.031645569620252,50.3725044501202
Task_19963,2647,234,145,57,202,11.263829787234043,49.398559830817646
Task_19964,1244,399,91,74,165,3.11,27.763868879827793
Task_19965,983,636,108,54,162,1.543171114599686,23.979536481677826
Task_19966,1338,442,46,169,215,3.020316027088036,30.160616611169786
Task_19967,1340,763,43,146,189,1.7539267015706805,30.987638987444758
Task_19968,1328,705,26,41,67,1.8810198300283285,28.335787413064796
Task_19969,659,190,126,161,287,3.450261780104712,18.894103229329634
Task_19970,1429,67,33,43,76,21.014705882352942,26.92622437005217
Task_19971,1264,619,197,16,213,2.0387096774193547,28.455646379900838
Task_19972,2240,776,16,48,64,2.8828828828828827,43.151276739423224
Task_19973,1770,368,102,35,137,4.796747967479675,35.2615550285602
Task_19974,2251,294,74,47,121,7.6305084745762715,42.468270402171505
Task_19975,1229,255,145,196,341,4.80078125,28.401600404439534
Task_19976,883,469,46,140,186,1.8787234042553191,22.740911876162397
Task_19977,2686,553,62,93,155,4.8483754512635375,51.214313590303625
Task_19978,1282,454,158,183,341,2.817582417582418,29.866506500831317
Task_19979,2181,372,18,65,83,5.847184986595174,41.54077008655121
Task_19980,2781,406,28,31,59,6.832923832923833,50.336929562564
Task_19981,2376,478,39,69,108,4.960334029227558,45.359925750848866
Task_19982,2238,243,109,178,287,9.172131147540984,44.03163970176686
Task_19983,1313,133,57,158,215,9.798507462686567,28.36425712050604
Task_19984,722,541,118,79,197,1.3321033210332103,20.144257910087532
Task_19985,1566,202,117,91,208,7.714285714285714,32.63900077607235
Task_19986,2782,604,114,192,306,4.598347107438016,53.94938836596492
Task_19987,2900,798,99,64,163,3.6295369211514394,54.99982858252608
Task_19988,2015,83,12,78,90,23.988095238095237,37.21187081346891
Task_19989,2889,176,161,159,320,16.322033898305083,53.751223027860384
Task_19990,1333,1017,197,57,254,1.3094302554027506,31.33909964706282
Task_19991,1906,739,18,81,99,2.575675675675676,38.63707197509786
Task_19992,1930,662,128,129,257,2.9110105580693815,40.32605000018052
Task_19993,1669,600,92,116,208,2.777038269550749,35.834911795028205
Task_19994,1235,1014,125,152,277,1.2167487684729064,30.411327594801694
Task_19995,2689,276,144,45,189,9.707581227436823,49.87442200209511
Task_19996,2200,822,72,100,172,2.67314702308627,44.734060763936746
Task_19997,2755,660,70,101,171,4.167927382753404,52.89989634698026
Task_19998,1739,992,79,197,276,1.7512588116817724,38.63201634022871
Task_19999,1255,64,159,179,338,19.307692307692307,27.335905606380482
Task_20000,2159,653,162,117,279,3.301223241590214,44.00636691473795
Task_20001,2567,555,150,65,215,4.616906474820144,49.35156304510264
Task_20002,1512,605,134,10,144,2.495049504950495,31.801733060925063
Task_20003,936,166,128,180,308,5.604790419161676,22.975351843907493
Task_20004,1376,317,52,69,121,4.327044025157233,29.228452752229803
Task_20005,1757,115,151,93,244,15.14655172413793,35.05751597858821
Task_20006,1675,244,57,172,229,6.836734693877551,35.02921607955232
Task_20007,2453,501,195,56,251,4.886454183266932,47.53609275537113
Task_20008,1388,585,110,178,288,2.368600682593857,31.71170713683715
Task_20009,2647,299,146,184,330,8.823333333333334,50.89982877240188
Task_20010,1555,343,53,121,174,4.520348837209302,33.089765855513896
Task_20011,711,294,196,80,276,2.4101694915254237,19.59403180240783
Task_20012,2861,176,13,77,90,16.163841807909606,51.39093759008242
Task_20013,1862,374,18,124,142,4.965333333333334,37.47592597383801
Task_20014,1657,462,94,68,162,3.5788336933045355,34.20539051367019
Task_20015,1819,300,162,26,188,6.043189368770764,36.19308229935243
Task_20016,780,376,178,178,356,2.0689655172413794,21.735574148891022
Task_20017,2320,260,192,17,209,8.88888888888889,43.91937524006753
Task_20018,2059,609,47,195,242,3.375409836065574,42.281556555531466
Task_20019,2625,463,131,95,226,5.657327586206897,50.477731056596944
Task_20020,1558,923,158,148,306,1.6861471861471862,35.48234389657181
Task_20021,2458,494,178,95,273,4.965656565656565,48.14670870802371
Task_20022,707,525,191,141,332,1.344106463878327,20.844390242061248
Task_20023,1322,770,16,136,152,1.7146562905317768,30.169763806052902
Task_20024,2078,283,138,158,296,7.316901408450704,41.65706887671093
Task_20025,1903,445,44,108,152,4.266816143497758,38.3699873756711
Task_20026,2345,162,83,127,210,14.386503067484663,44.74077735422495
Task_20027,1402,778,107,109,216,1.7997432605905006,32.1106452115695
Task_20028,2101,340,68,184,252,6.161290322580645,42.1774266874494
Task_20029,1456,939,86,48,134,1.548936170212766,32.07043999329938
Task_20030,2522,811,188,78,266,3.105911330049261,49.84001132265421
Task_20031,2470,138,63,123,186,17.769784172661872,46.27562838245863
Task_20032,2585,512,111,17,128,5.038986354775829,48.46529095357863
Task_20033,1583,964,115,179,294,1.6404145077720207,35.99708406898416
Task_20034,2436,180,122,99,221,13.458563535911603,46.103474171559206
Task_20035,2742,374,146,120,266,7.312,52.27897515495071
Task_20036,1278,950,118,115,233,1.3438485804416405,30.724783529816822
Task_20037,2284,278,179,129,308,8.186379928315413,44.90730699058313
Task_20038,1566,244,160,162,322,6.391836734693878,33.55299961786968
Task_20039,1730,930,173,81,254,1.8582169709989258,37.587259697860226
Task_20040,695,114,108,23,131,6.043478260869565,16.859283048131385
Task_20041,1044,88,16,199,215,11.730337078651685,23.549760992141387
Task_20042,1311,544,70,173,243,2.4055045871559635,30.29388233952294
Task_20043,2916,663,28,136,164,4.391566265060241,55.46689183510933
Task_20044,2303,275,172,65,237,8.344202898550725,44.34314062171986
Task_20045,1746,407,177,200,377,4.279411764705882,37.24644629376658
Task_20046,1627,777,134,47,181,2.0912596401028276,34.54738431141389
Task_20047,2442,1017,104,112,216,2.398821218074656,49.33792247223786
Task_20048,2020,548,25,115,140,3.6794171220400727,40.58037201004762
Task_20049,1209,643,12,171,183,1.8773291925465838,28.398181294405052
Task_20050,1362,297,134,80,214,4.570469798657718,29.616471759795285
Task_20051,1113,253,104,152,256,4.381889763779528,26.114363010473923
Task_20052,894,323,119,17,136,2.759259259259259,21.0117921920714
Task_20053,1280,608,46,71,117,2.1018062397372743,28.630832979105445
Task_20054,1788,717,165,172,337,2.4902506963788302,38.67290882050646
Task_20055,734,304,194,164,358,2.40655737704918,20.76763173532056
Task_20056,1038,741,83,64,147,1.398921832884097,25.163258567519595
Task_20057,611,1015,72,110,182,0.6013779527559056,20.214143241393487
Task_20058,1528,485,66,116,182,3.1440329218106995,32.984420569092826
Task_20059,2065,373,93,102,195,5.521390374331551,41.330564716565554
Task_20060,666,342,13,159,172,1.9416909620991254,18.95551481155815
Task_20061,1570,496,88,176,264,3.158953722334004,34.221092947449044
Task_20062,2364,678,138,96,234,3.4815905743740796,47.12227750451728
Task_20063,2952,500,57,170,227,5.892215568862276,56.07621237619614
Task_20064,850,394,109,10,119,2.151898734177215,20.417961349135364
Task_20065,1394,587,200,190,390,2.370748299319728,32.29031240768461
Task_20066,1642,129,184,142,326,12.63076923076923,33.88040371546597
Task_20067,1391,635,197,118,315,2.1871069182389937,31.949661554264974
Task_20068,2834,675,107,183,290,4.1923076923076925,54.9136950574063
Task_20069,557,301,11,161,172,1.8443708609271523,17.050887980332224
Task_20070,760,819,178,36,214,0.926829268292683,21.370776075186175
Task_20071,2076,74,68,16,84,27.68,37.26943520977198
Task_20072,979,756,39,198,237,1.2932628797886394,25.42240462142963
Task_20073,2450,462,21,24,45,5.291576673866091,45.20249459772635
Task_20074,2945,548,125,20,145,5.3642987249544625,54.333787970647855
Task_20075,1221,650,134,60,194,1.8755760368663594,28.14976872584747
Task_20076,2748,671,157,95,252,4.089285714285714,53.210414065505034
Task_20077,2325,423,68,161,229,5.4834905660377355,45.85924211754079
Task_20078,2292,675,142,112,254,3.3905325443786984,46.06236287122854
Task_20079,661,443,54,73,127,1.4887387387387387,18.475233716518225
Task_20080,745,407,176,19,195,1.8259803921568627,19.43501602951308
Task_20081,2165,833,168,181,349,2.595923261390887,45.0755383747962
Task_20082,2309,366,22,100,122,6.291553133514986,44.422659395135945
Task_20083,1069,421,51,54,105,2.5331753554502368,24.205236960965262
Task_20084,737,606,39,55,94,1.2141680395387149,19.473095943321496
Task_20085,1850,193,111,180,291,9.536082474226804,37.743738678725656
Task_20086,916,261,48,20,68,3.49618320610687,20.166611429478586
Task_20087,2768,832,105,45,150,3.3229291716686675,52.48566432144861
Task_20088,701,425,120,60,180,1.6455399061032865,18.969144337118053
Task_20089,824,267,127,19,146,3.074626865671642,19.79594137286862
Task_20090,2642,896,159,132,291,2.9453734671125975,52.49709223528206
Task_20091,1455,938,46,86,132,1.549520766773163,32.67582902497376
Task_20092,2265,633,53,36,89,3.5725552050473186,43.35765712115699
Task_20093,651,389,174,55,229,1.6692307692307693,18.5617918197068
Task_20094,2453,615,164,163,327,3.982142857142857,48.82620525412068
Task_20095,2392,631,114,13,127,3.7848101265822787,45.72757826116816
Task_20096,2141,486,20,159,179,4.3963039014373715,42.60319652197301
Task_20097,2620,389,159,98,257,6.717948717948718,50.32967991367472
Task_20098,1995,390,158,94,252,5.10230179028133,40.3567200577545
Task_20099,2776,918,69,179,248,3.0206746463547334,54.68576675743525
Task_20100,2400,816,169,26,195,2.9375764993880047,47.11718438469571
Task_20101,810,319,89,186,275,2.53125,21.715335712954204
Task_20102,2681,815,167,182,349,3.2855392156862746,53.1959792806289
Task_20103,920,839,122,95,217,1.0952380952380953,24.470472058385866
Task_20104,2169,518,29,111,140,4.179190751445087,42.830316270612485
Task_20105,2295,839,36,126,162,2.732142857142857,45.971660252419504
Task_20106,1344,489,115,194,309,2.742857142857143,30.83071381989482
Task_20107,1946,753,87,121,208,2.580901856763926,40.64086642522986
Task_20108,2121,172,193,96,289,12.260115606936417,41.4331768698299
Task_20109,2360,784,33,28,61,3.0063694267515926,44.943062308534614
Task_20110,2951,992,96,122,218,2.971802618328298,57.40269064859083
Task_20111,1072,934,124,17,141,1.146524064171123,25.732855062930494
Task_20112,1839,279,95,157,252,6.567857142857143,37.73571446134935
Task_20113,1427,756,69,84,153,1.8850726552179657,31.663771429545964
Task_20114,1080,459,110,123,233,2.347826086956522,26.1102826574995
Task_20115,1777,1002,119,112,231,1.7716849451645065,38.80710116982279
Task_20116,1415,892,105,52,157,1.5845464725643896,31.601751335247016
Task_20117,1575,231,34,106,140,6.788793103448276,32.46818070117316
Task_20118,666,1021,126,198,324,0.6516634050880626,21.882447856278173
Task_20119,2347,539,189,152,341,4.3462962962962965,46.95225906389904
Task_20120,2359,319,66,60,126,7.371875,44.666511900834074
Task_20121,1828,993,34,13,47,1.8390342052313884,36.874907638198295
Task_20122,1177,328,167,147,314,3.5775075987841944,27.626982963117346
Task_20123,623,820,23,169,192,0.758830694275274,19.83306367123124
Task_20124,1705,483,17,173,190,3.522727272727273,35.8857556787655
Task_20125,2616,90,142,126,268,28.747252747252748,48.45241038590709
Task_20126,2268,838,38,72,110,2.703218116805721,44.88571853596088
Task_20127,2975,366,126,74,200,8.106267029972752,55.216080609108694
Task_20128,1861,980,78,124,202,1.8970438328236494,40.10096671770899
Task_20129,1071,578,15,131,146,1.849740932642487,25.711830881530602
Task_20130,2566,827,73,91,164,3.0990338164251208,50.35112260743989
Task_20131,2267,764,108,143,251,2.9633986928104576,45.97815382662733
Task_20132,2595,720,160,110,270,3.5991678224687935,51.07307378252074
Task_20133,2570,418,68,102,170,6.133651551312649,49.17940964918699
Task_20134,1115,749,91,58,149,1.4866666666666666,26.356944381997792
Task_20135,884,159,187,188,375,5.525,22.487112434665118
Task_20136,2737,640,78,45,123,4.2698907956318255,51.29899450713118
Task_20137,2667,699,199,99,298,3.81,52.2425650923329
Task_20138,2177,540,190,105,295,4.024029574861368,43.98751485631393
Task_20139,1072,887,99,63,162,1.2072072072072073,26.170972276154355
Task_20140,2927,670,66,138,204,4.362146050670641,56.03995305168377
Task_20141,2363,836,146,188,334,2.823178016726404,48.16467085442861
Task_20142,2838,638,156,128,284,4.44131455399061,54.75176778840197
Task_20143,1154,395,87,25,112,2.914141414141414,25.284925506377338
Task_20144,2045,754,173,63,236,2.7086092715231787,41.783881291470145
Task_20145,836,735,186,35,221,1.1358695652173914,22.30542492066479
Task_20146,1707,802,124,172,296,2.1257783312577834,37.470384828025445
Task_20147,2385,488,183,151,334,4.877300613496932,47.356821512101874
Task_20148,1145,239,25,187,212,4.770833333333333,26.47436039518575
Task_20149,1056,303,100,61,161,3.473684210526316,24.006302247072785
Task_20150,609,733,186,73,259,0.829700272479564,19.152778887238224
Task_20151,2489,666,113,154,267,3.7316341829085458,49.274439223182036
Task_20152,2482,846,22,49,71,2.9303423848878394,47.154037426947895
Task_20153,2450,310,165,60,225,7.877813504823151,46.64468500073863
Task_20154,2546,123,98,106,204,20.532258064516128,47.487063807722876
Task_20155,680,889,170,144,314,0.7640449438202247,21.456043321341287
Task_20156,2505,696,64,14,78,3.593974175035868,46.758726905390425
Task_20157,1014,380,96,131,227,2.661417322834646,24.85297900778512
Task_20158,2870,405,123,161,284,7.068965517241379,54.549803956154165
Task_20159,2675,706,110,89,199,3.783592644978784,51.75785121456651
Task_20160,1410,84,90,131,221,16.58823529411765,29.257077790604523
Task_20161,1056,886,79,163,242,1.1905298759864713,27.200867209951685
Task_20162,1910,568,173,188,361,3.3567662565905096,40.26790853159409
Task_20163,2988,102,46,89,135,29.009708737864077,53.333425235331866
Task_20164,567,245,98,178,276,2.3048780487804876,17.603554486952405
Task_20165,1451,651,153,150,303,2.2254601226993866,32.94285492502249
Task_20166,999,121,20,116,136,8.188524590163935,22.221610727720144
Task_20167,566,543,59,86,145,1.0404411764705883,17.313323266086485
Task_20168,2972,987,90,171,261,3.0080971659919027,57.98190209243466
Task_20169,579,716,103,103,206,0.8075313807531381,18.75844273785033
Task_20170,2664,203,199,130,329,13.058823529411764,50.72390277548967
Task_20171,2535,555,151,62,213,4.559352517985611,48.778806247812646
Task_20172,519,90,148,123,271,5.7032967032967035,15.560117327541613
Task_20173,2872,892,72,92,164,3.2161254199328106,55.4399503511965
Task_20174,1911,108,136,69,205,17.53211009174312,36.64655842504121
Task_20175,2061,413,185,106,291,4.978260869565218,41.72526690391852
Task_20176,746,589,82,32,114,1.264406779661017,19.518856520471967
Task_20177,1106,272,120,94,214,4.051282051282051,25.7370936454622
Task_20178,1845,640,109,34,143,2.8783151326053042,37.332462036148115
Task_20179,2680,1019,34,89,123,2.627450980392157,52.33980366240592
Task_20180,1829,937,71,41,112,1.9498933901918976,37.72448417387173
Task_20181,2369,575,80,186,266,4.112847222222222,47.254732436783776
Task_20182,610,727,68,65,133,0.8379120879120879,18.518523475560997
Task_20183,2570,186,142,154,296,13.743315508021391,49.20838231026247
Task_20184,1000,881,14,79,93,1.1337868480725624,24.840228130126544
Task_20185,1838,408,76,75,151,4.493887530562347,36.99900415008415
Task_20186,2851,544,13,31,44,5.231192660550459,51.879289269230945
Task_20187,1074,699,76,73,149,1.5342857142857143,25.79890425194698
Task_20188,2685,393,110,97,207,6.814720812182741,51.17503277712637
Task_20189,2317,907,127,90,217,2.551762114537445,46.82182899937201
Task_20190,2676,776,75,104,179,3.444015444015444,52.06799753401771
Task_20191,1017,358,100,46,146,2.832869080779944,23.345132883031653
Task_20192,1475,305,144,51,195,4.8202614379084965,31.120310517646445
Task_20193,1143,152,51,70,121,7.470588235294118,24.479433826679074
Task_20194,1350,239,113,185,298,5.625,30.04888320573512
Task_20195,1589,806,37,107,144,1.9690210656753409,34.559022350000454
Task_20196,1280,717,142,16,158,1.7827298050139275,28.4728088702104
Task_20197,2434,137,24,138,162,17.63768115942029,45.33349709350531
Task_20198,1691,499,197,94,291,3.382,36.07252051630547
Task_20199,2825,99,114,55,169,28.25,50.69979261033052
Task_20200,765,300,131,33,164,2.5415282392026577,19.419638143505683
Task_20201,1261,578,58,132,190,2.1778929188255614,29.312687787305766
Task_20202,2367,432,40,37,77,5.466512702078522,43.90725237924536
Task_20203,1491,298,26,176,202,4.986622073578595,32.07212363513755
Task_20204,1401,800,169,124,293,1.749063670411985,32.518846310488726
Task_20205,2734,695,169,73,242,3.92816091954023,52.60863225397022
Task_20206,1615,934,129,80,209,1.7272727272727273,35.60168033284812
Task_20207,1893,663,53,13,66,2.8509036144578315,36.91598462371805
Task_20208,749,967,112,161,273,0.7737603305785123,22.630435993502484
Task_20209,2608,94,165,130,295,27.45263157894737,48.38424918952802
Task_20210,1055,197,151,133,284,5.328282828282828,25.15121272665081
Task_20211,1381,175,177,50,227,7.846590909090909,28.87193760078155
Task_20212,2319,429,28,14,42,5.3930232558139535,42.775746676636714
Task_20213,2338,259,27,161,188,8.992307692307692,45.20248848744569
Task_20214,1601,416,33,173,206,3.839328537170264,34.218513028717815
Task_20215,1619,617,122,93,215,2.6197411003236244,34.95151395306558
Task_20216,2088,845,44,177,221,2.4680851063829787,43.32389448863074
Task_20217,2745,709,76,28,104,3.8661971830985915,51.4252145136335
Task_20218,2178,443,79,50,129,4.905405405405405,42.09225956701746
Task_20219,2875,584,112,85,197,4.914529914529915,54.43523938236144
Task_20220,536,146,181,118,299,3.6462585034013606,16.434714856285733
Task_20221,1694,355,52,117,169,4.758426966292135,35.1765834912756
Task_20222,739,783,44,170,214,0.9426020408163265,21.523562011715764
Task_20223,2379,765,15,122,137,3.1057441253263707,46.96379471475654
Task_20224,2803,1016,37,178,215,2.7561455260570304,55.1679239333323
Task_20225,2452,817,55,160,215,2.997555012224939,49.0965699916917
Task_20226,764,341,184,144,328,2.2339181286549707,21.19549409957919
Task_20227,1543,192,38,62,100,7.994818652849741,31.176003060666932
Task_20228,800,421,29,155,184,1.8957345971563981,21.255812223876177
Task_20229,640,708,48,12,60,0.9026798307475318,17.425878002632093
Task_20230,2765,539,112,136,248,5.12037037037037,53.128098853653476
Task_20231,547,664,151,117,268,0.8225563909774436,18.37458264638327
Task_20232,2396,241,99,196,295,9.900826446280991,46.58446594322594
Task_20233,1430,607,11,97,108,2.351973684210526,31.152433729387738
Task_20234,1464,201,196,163,359,7.247524752475248,31.957508139632168
Task_20235,2614,114,33,10,43,22.730434782608697,46.08911574690388
Task_20236,1478,477,36,120,156,3.092050209205021,31.815259085128996
Task_20237,2386,772,65,20,85,3.0866752910737385,45.4648839812645
Task_20238,683,698,165,192,357,0.977110157367668,21.148177963639302
Task_20239,1490,143,61,72,133,10.347222222222221,30.12301514129452
Task_20240,1559,513,164,21,185,3.0330739299610894,32.58822597900815
Task_20241,1148,504,177,93,270,2.273267326732673,27.38596796576152
Task_20242,1596,129,130,109,239,12.276923076923078,32.71579788970366
Task_20243,1908,594,45,20,65,3.2067226890756304,36.87694835124764
Task_20244,1710,963,110,107,217,1.7738589211618256,37.553890867627054
Task_20245,830,938,130,92,222,0.8839190628328009,23.377227726721085
Task_20246,1362,909,198,144,342,1.4967032967032967,32.460263563876104
Task_20247,1590,433,65,95,160,3.6635944700460827,33.54057234264277
Task_20248,2444,1022,76,123,199,2.389051808406647,49.462881745094826
Task_20249,2306,392,70,182,252,5.867684478371501,45.60912108822409
Task_20250,2875,552,81,159,240,5.198915009041591,55.013087803551194
Task_20251,2050,977,43,37,80,2.096114519427403,41.00627331287695
Task_20252,2911,788,31,43,74,3.6894803548795942,53.71202953339394
Task_20253,1298,355,65,103,168,3.646067415730337,28.842937053098954
Task_20254,2537,299,188,139,327,8.456666666666667,49.08121019153066
Task_20255,1757,941,164,52,216,1.865180467091295,37.7464169103925
Task_20256,1983,200,113,11,124,9.865671641791044,37.776975837899734
Task_20257,1926,289,132,180,312,6.641379310344828,39.37937871956648
Task_20258,1854,66,165,51,216,27.671641791044777,35.456549347928615
Task_20259,1421,273,52,12,64,5.186131386861314,28.194438156586596
Task_20260,2069,676,143,199,342,3.056129985228951,43.05746014015273
Task_20261,2125,777,191,123,314,2.7313624678663238,44.02390133295747
Task_20262,2281,665,15,171,186,3.424924924924925,45.55269090123613
Task_20263,2451,872,160,156,316,2.8075601374570445,49.5435203645369
Task_20264,800,787,44,96,140,1.015228426395939,21.774525657800325
Task_20265,2586,375,151,149,300,6.877659574468085,50.010047931851126
Task_20266,1537,757,126,161,287,2.0277044854881265,34.580174678201026
Task_20267,868,847,166,14,180,1.0235849056603774,22.515801917893857
Task_20268,1866,357,129,51,180,5.212290502793296,37.23073460256669
Task_20269,2142,405,157,141,298,5.275862068965517,43.063718307655485
Task_20270,906,929,148,111,259,0.9741935483870968,24.835616914869888
Task_20271,2705,608,134,21,155,4.441707717569787,50.764761726959016
Task_20272,2673,727,136,12,148,3.6717032967032965,50.59307230908835
Task_20273,1260,223,18,83,101,5.625,26.911591679890563
Task_20274,1684,975,157,51,208,1.7254098360655739,36.593485098321715
Task_20275,671,964,144,173,317,0.6953367875647668,21.70279602193935
Task_20276,2612,391,134,68,202,6.663265306122449,49.47397361586437
Task_20277,1528,757,164,34,198,2.015831134564644,33.17965469769505
Task_20278,2807,674,91,200,291,4.158518518518519,54.56154417978531
Task_20279,649,356,164,151,315,1.8179271708683473,19.375625803417574
Task_20280,2066,434,36,191,227,4.749425287356321,41.71782645298254
Task_20281,2821,536,91,139,230,5.253258845437617,53.977626098090134
Task_20282,2822,1015,199,192,391,2.77755905511811,56.25967056989416
Task_20283,2756,657,106,71,177,4.188449848024316,52.3134992069079
Task_20284,1003,994,149,23,172,1.0080402010050251,25.275092375394465
Task_20285,1044,106,79,39,118,9.757009345794392,22.034619343691077
Task_20286,742,112,111,76,187,6.566371681415929,18.228360990231945
Task_20287,550,792,174,190,364,0.6935687263556116,19.49120627050893
Task_20288,2231,627,36,119,155,3.5525477707006368,44.208018346637225
Task_20289,624,139,76,189,265,4.457142857142857,17.880021516156283
Task_20290,1434,1014,179,73,252,1.412807881773399,33.00497862778345
Task_20291,664,73,50,112,162,8.972972972972974,16.98775933011399
Task_20292,688,375,135,183,318,1.8297872340425532,20.112950379116068
Task_20293,2143,585,74,200,274,3.656996587030717,43.76878410507294
Task_20294,2572,546,10,89,99,4.70201096892139,48.71253137049913
Task_20295,1349,600,10,100,110,2.24459234608985,29.866377756729367
Task_20296,1362,852,27,195,222,1.596717467760844,31.887555882955002
Task_20297,1774,750,20,69,89,2.362183754993342,36.38299270976575
Task_20298,1347,644,14,68,82,2.088372093023256,29.294915572820795
Task_20299,2291,949,64,149,213,2.411578947368421,46.90201806008622
Task_20300,2156,101,122,174,296,21.137254901960784,41.49483655658637
Task_20301,2967,1016,37,161,198,2.9174041297935105,57.665339237199085
Task_20302,2914,994,33,60,93,2.928643216080402,55.19300362948508
Task_20303,1683,651,95,177,272,2.581288343558282,36.58740929206326
Task_20304,1848,365,138,161,299,5.049180327868853,38.314439954544646
Task_20305,1974,455,37,17,54,4.328947368421052,37.55869958310405
Task_20306,1301,97,17,62,79,13.275510204081632,25.82641141887007
Task_20307,2848,92,148,112,260,30.623655913978496,52.0428156054294
Task_20308,1938,1017,173,161,334,1.9037328094302555,41.954543075406086
Task_20309,2713,92,81,26,107,29.172043010752688,47.91665149154963
Task_20310,2258,699,153,20,173,3.2257142857142855,44.15180014824059
Task_20311,1452,220,31,56,87,6.570135746606335,29.47096231408975
Task_20312,2546,129,39,29,68,19.584615384615386,45.39404654093568
Task_20313,2535,666,147,11,158,3.800599700149925,48.23776535257992
Task_20314,1232,413,182,28,210,2.975845410628019,27.42518339693582
Task_20315,604,74,69,62,131,8.053333333333333,15.410722341329281
Task_20316,1125,900,128,191,319,1.248612652608213,28.561788390766253
Task_20317,1890,437,142,82,224,4.315068493150685,38.47652235843662
Task_20318,1016,206,180,92,272,4.908212560386473,24.306291874064698
Task_20319,2353,113,36,75,111,20.640350877192983,43.05572155135874
Task_20320,1668,663,69,154,223,2.5120481927710845,36.18426349197657
Task_20321,1997,74,117,95,212,26.626666666666665,38.30144953071957
Task_20322,2212,617,24,75,99,3.5792880258899675,43.088813006110094
Task_20323,2880,664,188,143,331,4.330827067669173,55.733525682640355
Task_20324,702,185,80,57,137,3.774193548387097,18.178964960162787
Task_20325,943,448,35,190,225,2.1002227171492205,23.998750422043837
Task_20326,1025,310,140,146,286,3.2958199356913185,25.037255054168245
Task_20327,2435,445,47,148,195,5.459641255605381,47.42804318931556
Task_20328,2696,625,153,196,349,4.306709265175719,52.85403322056978
Task_20329,2387,116,112,75,187,20.4017094017094,44.307511747817095
Task_20330,2616,542,115,176,291,4.81767955801105,51.03097762194235
Task_20331,2274,548,190,189,379,4.14207650273224,46.050677716010405
Task_20332,1207,76,113,163,276,15.675324675324676,26.286198358827264
Task_20333,2255,142,138,48,186,15.76923076923077,42.18024175821342
Task_20334,1961,220,106,110,216,8.873303167420815,39.15193888715021
Task_20335,2154,150,182,62,244,14.264900662251655,41.291456857759535
Task_20336,887,758,121,162,283,1.168642951251647,24.178127756065937
Task_20337,2602,897,199,139,338,2.8975501113585747,52.08850315776683
Task_20338,2955,528,54,79,133,5.586011342155009,55.273659415695114
Task_20339,664,545,199,122,321,1.216117216117216,20.065650256406798
Task_20340,1686,240,171,19,190,6.995850622406639,33.73307877026611
Task_20341,542,977,43,150,193,0.5541922290388548,19.00443786490531
Task_20342,2731,529,116,189,305,5.152830188679245,52.89209461720708
Task_20343,1930,798,108,75,183,2.415519399249061,39.780167491749445
Task_20344,2837,659,93,17,110,4.298484848484849,52.714415005925524
Task_20345,1424,522,16,191,207,2.7227533460803057,31.700675624961388
Task_20346,1914,657,98,200,298,2.9088145896656536,40.35968386936666
Task_20347,965,183,127,55,182,5.244565217391305,22.519291520994912
Task_20348,2994,858,31,40,71,3.4854481955762515,55.24445720630962
Task_20349,1622,946,73,154,227,1.712777191129884,36.34759457894027
Task_20350,2781,705,23,61,84,3.9390934844192635,52.0479577461651
Task_20351,1218,413,197,83,280,2.9420289855072466,28.0083586840266
Task_20352,1606,812,126,184,310,1.9753997539975399,35.982056519731245
Task_20353,2663,732,127,80,207,3.6330150068212825,51.57496241304827
Task_20354,1068,339,88,112,200,3.1411764705882352,25.393148326450078
Task_20355,1615,959,112,100,212,1.6822916666666667,36.00327082825169
Task_20356,2878,454,17,182,199,6.325274725274725,54.42457629547695
Task_20357,2045,238,120,43,163,8.556485355648535,39.359520886254
Task_20358,858,156,63,148,211,5.464968152866242,21.372119616569865
Task_20359,1568,186,111,79,190,8.385026737967914,32.64534033106478
Task_20360,2418,218,183,152,335,11.04109589041096,46.958852692028756
Task_20361,2426,149,158,168,326,16.173333333333332,46.47606223484263
Task_20362,816,374,146,43,189,2.176,20.62198793996622
Task_20363,1342,497,50,164,214,2.6947791164658637,30.541679275206445
Task_20364,2911,481,143,12,155,6.039419087136929,53.59089224708279
Task_20365,2124,628,61,16,77,3.3767885532591415,40.44934994956431
Task_20366,1211,444,80,72,152,2.7213483146067414,27.076027167556898
Task_20367,1197,489,76,18,94,2.442857142857143,26.003436197968657
Task_20368,1428,354,155,69,224,4.022535211267606,30.691265179024345
Task_20369,1019,874,34,175,209,1.1645714285714286,26.286269402646173
Task_20370,2470,280,28,148,176,8.790035587188612,47.17574961315298
Task_20371,1680,652,91,152,243,2.572741194486983,36.35480529551527
Task_20372,2214,150,36,100,136,14.66225165562914,41.68276490415092
Task_20373,2343,550,102,96,198,4.252268602540835,46.221115420839716
Task_20374,2223,757,64,78,142,2.9327176781002637,44.30243677410092
Task_20375,1064,505,158,13,171,2.102766798418972,24.549186782803456
Task_20376,2543,464,15,200,215,5.468817204301075,49.357919627950515
Task_20377,1971,662,189,103,292,2.9728506787330318,41.09508399172808
Task_20378,1564,782,63,100,163,1.9974457215836525,34.39242734378005
Task_20379,2220,964,121,166,287,2.300518134715026,46.0540970418883
Task_20380,508,407,124,200,324,1.2450980392156863,17.29405295807297
Task_20381,629,805,32,138,170,0.7803970223325062,19.479875684206466
Task_20382,2504,628,48,162,210,3.9809220985691574,49.26973567686812
Task_20383,2454,72,182,140,322,33.61643835616438,45.95692209635203
Task_20384,2322,665,162,28,190,3.4864864864864864,45.38115732970062
Task_20385,703,538,146,34,180,1.3042671614100185,19.183483472209947
Task_20386,2342,970,61,172,233,2.411946446961895,47.89945476262963
Task_20387,1130,817,200,69,269,1.3814180929095354,27.588528680088316
Task_20388,2987,123,141,55,196,24.088709677419356,53.96918220308881
Task_20389,518,191,60,104,164,2.6979166666666665,16.01449277662981
Task_20390,1909,977,70,138,208,1.9519427402862985,40.90957019947687
Task_20391,1054,557,36,59,95,1.8888888888888888,24.310299645382802
Task_20392,2939,291,41,130,171,10.065068493150685,54.50600457706178
Task_20393,2802,489,137,50,187,5.718367346938775,52.47360732958014
Task_20394,940,354,35,127,162,2.647887323943662,23.00934173606014
Task_20395,944,677,173,98,271,1.392330383480826,24.707974342022812
Task_20396,1995,537,117,139,256,3.70817843866171,40.97030188273451
Task_20397,2686,72,52,166,218,36.794520547945204,49.26943860061769
Task_20398,2506,816,161,124,285,3.0673194614443084,50.053030953927475
Task_20399,2541,356,183,193,376,7.117647058823529,49.641048047723665
Task_20400,713,951,14,94,108,0.7489495798319328,20.756667006811895
Task_20401,1946,196,163,163,326,9.878172588832488,39.3523743635376
Task_20402,2265,766,12,200,212,2.9530638852672753,45.862529537909346
Task_20403,2068,659,178,144,322,3.1333333333333333,42.817333715350536
Task_20404,523,836,51,195,246,0.6248506571087217,18.872085581855178
Task_20405,2377,190,113,176,289,12.44502617801047,46.03573004716237
Task_20406,1979,931,47,99,146,2.1233905579399144,41.138203715043765
Task_20407,2176,638,26,60,86,3.405320813771518,42.22665693209823
Task_20408,2696,233,106,189,295,11.521367521367521,51.28122880581102
Task_20409,2448,174,137,118,255,13.98857142857143,46.469641357853625
Task_20410,545,510,80,13,93,1.066536203522505,15.938433157396341
Task_20411,1567,469,177,184,361,3.3340425531914892,34.51700390315498
Task_20412,2533,124,87,158,245,20.264,47.53931495551237
Task_20413,2692,108,24,94,118,24.69724770642202,48.51955237409275
Task_20414,1977,334,44,114,158,5.901492537313433,39.24808175603939
Task_20415,896,758,71,129,200,1.1805006587615283,24.026455281736105
Task_20416,1344,485,151,137,288,2.765432098765432,30.639852038208574
Task_20417,1424,843,107,193,300,1.6872037914691944,33.14960413104785
Task_20418,1102,255,65,149,214,4.3046875,25.878870442835133
Task_20419,2204,472,135,112,247,4.659619450317125,43.99059524153657
Task_20420,2585,559,91,38,129,4.616071428571429,48.83007329715637
Task_20421,1267,283,101,71,172,4.461267605633803,27.621872603193157
Task_20422,1407,715,179,164,343,1.9650837988826815,32.64662543971979
Task_20423,2918,540,35,96,131,5.393715341959335,54.819950628714615
Task_20424,2236,918,43,152,195,2.4330794341675737,45.74281138199844
Task_20425,597,624,12,108,120,0.9552,18.001311334523802
Task_20426,790,385,98,180,278,2.0466321243523318,21.58752528881143
Task_20427,1723,385,102,193,295,4.463730569948186,36.43120021959584
Task_20428,2283,869,124,166,290,2.6241379310344826,46.76971147057236
Task_20429,2831,708,82,107,189,3.9929478138222847,54.46966543121001
Task_20430,2159,724,34,145,179,2.9779310344827588,43.66989601841976
Task_20431,2325,930,150,33,183,2.497314715359828,46.09898526099931
Task_20432,2375,204,177,73,250,11.585365853658537,45.31935639400524
Task_20433,2734,624,168,12,180,4.3744,51.45412461674755
Task_20434,2135,161,165,42,207,13.179012345679013,40.62508149322985
Task_20435,2389,815,78,95,173,2.9276960784313726,47.70285943637074
Task_20436,1042,1015,73,13,86,1.0255905511811023,25.27417393202406
Task_20437,2632,85,102,147,249,30.6046511627907,48.56661899835732
Task_20438,2284,176,111,89,200,12.903954802259888,43.431536609206745
Task_20439,1195,800,77,188,265,1.491885143570537,29.32371615881927
Task_20440,1543,863,68,134,202,1.7858796296296295,34.704692080082474
Task_20441,2703,910,68,132,200,2.9670691547749724,53.219510083595985
Task_20442,1166,232,146,134,280,5.0042918454935625,26.96248982071066
Task_20443,791,604,110,143,253,1.3074380165289257,22.0408360596406
Task_20444,1179,973,116,160,276,1.2104722792607803,29.40423851741494
Task_20445,755,312,109,134,243,2.412140575079872,20.562975892640996
Task_20446,1602,438,57,178,235,3.6492027334851938,34.55389186597774
Task_20447,1693,123,137,60,197,13.653225806451612,33.569997214983566
Task_20448,1734,816,101,126,227,2.1223990208078334,37.56337002161132
Task_20449,656,811,75,102,177,0.8078817733990148,20.037349054584595
Task_20450,1441,520,27,147,174,2.7658349328214973,31.76628902389865
Task_20451,2885,380,198,149,347,7.572178477690288,54.96929125703656
Task_20452,2293,202,81,17,98,11.295566502463053,42.31279505245238
Task_20453,2312,934,179,122,301,2.4727272727272727,47.41709713320579
Task_20454,2262,916,164,180,344,2.4667393675027265,46.84752097404396
Task_20455,2194,521,179,103,282,4.203065134099617,44.13440625042792
Task_20456,2140,451,144,107,251,4.734513274336283,42.9203133160436
Task_20457,2362,754,114,157,271,3.128476821192053,47.56242769145527
Task_20458,1752,265,172,199,371,6.586466165413534,36.840079525603926
Task_20459,1797,694,183,200,383,2.585611510791367,38.99180761394148
Task_20460,2490,826,46,142,188,3.010882708585248,49.41706898764968
Task_20461,1008,508,16,130,146,1.9803536345776032,24.409024052371944
Task_20462,1733,576,61,155,216,3.003466204506066,36.91645203433422
Task_20463,2401,183,47,199,246,13.048913043478262,46.1152218755553
Task_20464,2220,315,135,94,229,7.025316455696203,43.56124676527074
Task_20465,1635,1013,12,56,68,1.6124260355029585,34.51005391599489
Task_20466,2537,863,78,164,242,2.9363425925925926,50.68693039040516
Task_20467,886,1013,65,142,207,0.873767258382643,24.67732689142772
Task_20468,1411,311,25,84,109,4.522435897435898,29.77807745550548
Task_20469,1103,1007,63,100,163,1.0942460317460319,27.583972302728835
Task_20470,744,275,137,172,309,2.6956521739130435,20.623401139364912
Task_20471,2456,992,131,41,172,2.473313192346425,48.41244557624011
Task_20472,2818,184,111,102,213,15.232432432432432,52.359449621901604
Task_20473,2428,445,100,59,159,5.443946188340807,46.15753342690547
Task_20474,968,623,177,134,311,1.5512820512820513,25.175519946680254
Task_20475,2051,462,69,13,82,4.429805615550756,39.339495802256764
Task_20476,2585,177,129,126,255,14.52247191011236,48.61901500834042
Task_20477,2717,775,119,128,247,3.5012886597938144,53.101745545743086
Task_20478,1171,673,78,184,262,1.7373887240356083,28.55896117413937
Task_20479,1084,677,200,139,339,1.59882005899705,27.34374824367249
Task_20480,2860,977,179,125,304,2.9243353783231085,56.25294851752826
Task_20481,526,475,148,22,170,1.1050420168067228,15.990386290083494
Task_20482,2250,696,102,56,158,3.2281205164992826,44.24225963167745
Task_20483,1797,487,52,105,157,3.682377049180328,37.02782215816537
Task_20484,2582,362,12,198,210,7.112947658402204,49.57111178398563
Task_20485,562,613,96,75,171,0.9153094462540716,17.51586053083086
Task_20486,1341,837,113,170,283,1.600238663484487,31.705574857731506
Task_20487,2712,545,185,70,255,4.967032967032967,51.79849743101247
Task_20488,1612,361,157,61,218,4.45303867403315,33.52737585920254
Task_20489,2386,627,33,152,185,3.799363057324841,47.06859401364709
Task_20490,2088,728,196,142,338,2.8641975308641974,43.42021276232202
Task_20491,2553,618,19,104,123,4.124394184168013,49.129658036634176
Task_20492,1999,598,113,91,204,3.337228714524207,40.776339390726505
Task_20493,1011,983,115,105,220,1.0274390243902438,26.434963185086218
Task_20494,1313,294,135,11,146,4.450847457627119,27.70996367991192
Task_20495,1094,737,188,40,228,1.4823848238482384,26.371668054509055
Task_20496,1507,918,183,169,352,1.6398258977149076,34.89680358622167
Task_20497,1091,317,98,60,158,3.430817610062893,24.61309350726219
Task_20498,2864,136,16,24,40,20.905109489051096,50.28172775024583
Task_20499,1752,267,155,170,325,6.537313432835821,36.5971681566022
Task_20500,753,92,54,189,243,8.096774193548388,19.253198025374783
Task_20501,2568,158,69,62,131,16.150943396226417,47.17497257528249
Task_20502,562,535,55,93,148,1.0485074626865671,17.34116502268647
Task_20503,1970,715,75,171,246,2.7513966480446927,41.27412075851709
Task_20504,1531,315,181,132,313,4.844936708860759,33.155973065791976
Task_20505,1957,903,81,47,128,2.1648230088495577,39.98665846370068
Task_20506,998,811,144,46,190,1.229064039408867,24.86724858954885
Task_20507,1148,718,199,184,383,1.5966620305980528,28.749368785434854
Task_20508,2699,64,149,189,338,41.52307692307692,49.90663633260527
Task_20509,2207,106,103,195,298,20.626168224299064,42.33495000281973
Task_20510,640,301,71,129,200,2.119205298013245,18.63538652799805
Task_20511,2188,940,180,90,270,2.325185972369819,45.11946255085254
Task_20512,1192,270,65,152,217,4.398523985239852,27.369092932896503
Task_20513,2739,211,189,162,351,12.919811320754716,52.086467071027734
Task_20514,2998,901,180,96,276,3.3237250554323725,58.05687912226776
Task_20515,1402,985,31,196,227,1.4219066937119675,32.85562984634125
Task_20516,2052,836,97,148,245,2.4516129032258065,42.801119149504395
Task_20517,2611,983,107,89,196,2.6534552845528454,51.59880116090551
Task_20518,2758,479,113,10,123,5.745833333333334,51.00079864340745
Task_20519,2858,911,88,33,121,3.133771929824561,54.034201894845445
Task_20520,2532,632,161,147,308,4.0,50.02227683841469
Task_20521,983,138,136,121,257,7.071942446043166,23.27126417070998
Task_20522,2705,341,196,93,289,7.909356725146199,51.579905312379914
Task_20523,1916,972,200,59,259,1.9691675231243577,40.45276323712469
Task_20524,1640,297,81,133,214,5.503355704697986,34.4782381053723
Task_20525,2749,789,59,141,200,3.479746835443038,53.61462913405611
Task_20526,2803,96,33,31,64,28.896907216494846,48.999533894425774
Task_20527,1503,696,180,166,346,2.1563845050215207,34.12445939743712
Task_20528,2731,663,193,126,319,4.1129518072289155,53.29132245129514
Task_20529,1016,326,55,97,152,3.1070336391437308,24.14498332187033
Task_20530,2234,293,154,126,280,7.598639455782313,44.0389580295371
Task_20531,922,940,161,65,226,0.9798087141339001,24.591646231820175
Task_20532,2960,206,26,193,219,14.29951690821256,55.04650924771722
Task_20533,1872,525,38,83,121,3.55893536121673,37.8938922775046
Task_20534,1321,1019,127,147,274,1.2950980392156863,31.79993476248057
Task_20535,705,911,113,94,207,0.7730263157894737,21.308181970024517
Task_20536,2250,384,107,143,250,5.8441558441558445,44.489958675330264
Task_20537,536,316,78,160,238,1.6908517350157728,17.245552569248073
Task_20538,1594,278,178,191,369,5.71326164874552,34.366749035895154
Task_20539,825,806,166,33,199,1.0223048327137547,22.178451827456744
Task_20540,553,365,186,96,282,1.510928961748634,17.636831987703655
Task_20541,1870,873,22,93,115,2.139588100686499,39.00895404401475
Task_20542,924,241,87,176,263,3.8181818181818183,23.163523874461635
Task_20543,768,898,24,76,100,0.8542825361512792,21.137632516984123
Task_20544,1069,640,164,46,210,1.6677067082683308,25.580539751774
Task_20545,1859,967,146,163,309,1.9204545454545454,40.437604245907615
Task_20546,2012,391,74,163,237,5.13265306122449,40.849893574837786
Task_20547,1298,245,34,72,106,5.276422764227642,27.506707396761787
Task_20548,712,474,13,186,199,1.4989473684210526,20.289488987189735
Task_20549,506,444,65,114,179,1.1370786516853932,16.54704762362088
Task_20550,1136,677,110,18,128,1.6755162241887906,26.013309515696704
Task_20551,1379,904,46,48,94,1.5237569060773481,30.31889661117889
Task_20552,2973,762,164,168,332,3.896461336828309,57.55814940917211
Task_20553,2781,304,21,47,68,9.118032786885246,50.06813109112745
Task_20554,2942,933,14,59,73,3.1498929336188435,54.931710427114716
Task_20555,2634,589,96,53,149,4.464406779661017,50.05215407067474
Task_20556,1980,365,107,197,304,5.409836065573771,40.47795521233172
Task_20557,539,390,128,193,321,1.3785166240409208,17.76244158107123
Task_20558,691,377,180,40,220,1.8280423280423281,18.83055451819922
Task_20559,2267,381,183,122,305,5.93455497382199,44.96608100840667
Task_20560,2899,885,128,65,193,3.2720090293453725,55.55294938444127
Task_20561,2075,547,193,34,227,3.7864963503649633,41.31357671771905
Task_20562,2760,883,78,42,120,3.1221719457013575,52.40724387221167
Task_20563,1846,694,35,16,51,2.656115107913669,36.34956597544717
Task_20564,2478,931,81,106,187,2.6587982832618025,49.56727611662453
Task_20565,2214,212,133,12,145,10.394366197183098,41.6939679150943
Task_20566,2268,139,20,43,63,16.2,41.22968622711078
Task_20567,2876,708,80,46,126,4.056417489421721,53.8177584825982
Task_20568,2371,949,145,72,217,2.4957894736842103,47.53087834814295
Task_20569,2106,593,153,175,328,3.5454545454545454,43.28313704355987
Task_20570,667,404,133,70,203,1.6469135802469135,18.748778114112866
Task_20571,1534,269,90,46,136,5.681481481481481,31.210116709316996
Task_20572,1560,603,91,92,183,2.5827814569536423,33.64595814693902
Task_20573,1637,325,106,27,133,5.021472392638037,32.97629593640686
Task_20574,2165,214,53,138,191,10.069767441860465,42.448821137137685
Task_20575,1039,465,108,39,147,2.2296137339055795,24.002531892079702
Task_20576,2992,408,108,137,245,7.315403422982885,56.27945125631961
Task_20577,1095,802,63,174,237,1.3636363636363635,27.564562878487777
Task_20578,2270,433,39,132,171,5.2304147465437785,44.40957274664046
Task_20579,1487,430,113,90,203,3.4501160092807424,32.111503123871536
Task_20580,764,688,16,123,139,1.1088534107402033,20.83682398987985
Task_20581,2536,240,160,151,311,10.522821576763485,48.79684386165122
Task_20582,2414,201,41,92,133,11.950495049504951,45.60273689099288
Task_20583,651,465,124,173,297,1.3969957081545064,19.631951070249503
Task_20584,2980,549,30,128,158,5.418181818181818,55.87422912587377
Task_20585,2485,819,160,183,343,3.0304878048780486,50.077616813464715
Task_20586,1351,690,35,10,45,1.955137481910275,28.361092549231227
Task_20587,558,711,160,82,242,0.7837078651685393,18.3301613072797
Task_20588,1588,68,59,125,184,23.014492753623188,31.712670410296138
Task_20589,1383,190,49,73,122,7.2408376963350785,29.20584517288641
Task_20590,2849,678,129,186,315,4.195876288659794,55.27788111877978
Task_20591,854,637,106,143,249,1.3385579937304075,23.149598934834415
Task_20592,1817,253,97,93,190,7.153543307086614,36.80092769803796
Task_20593,1461,677,169,97,266,2.1548672566371683,32.97170684866531
Task_20594,2845,599,189,157,346,4.741666666666666,55.06008556997796
Task_20595,1275,406,174,48,222,3.1326781326781328,28.179757205533324
Task_20596,2585,672,199,163,362,3.8410104011887074,51.25536030561682
Task_20597,917,890,97,37,134,1.0291806958473626,23.406870098128937
Task_20598,594,771,66,90,156,0.7694300518134715,18.585043004836955
Task_20599,1716,535,78,82,160,3.201492537313433,35.61763573573738
Task_20600,2917,936,192,152,344,3.113127001067236,57.24792325437617
Task_20601,1090,962,154,90,244,1.1318795430944963,27.579032922628357
Task_20602,1985,706,84,141,225,2.8076379066478077,41.25613189535352
Task_20603,2224,533,29,40,69,4.164794007490637,41.99186883450839
Task_20604,777,75,33,86,119,10.223684210526315,18.289078785293206
Task_20605,2023,653,64,56,120,3.0932721712538225,40.21574845669158
Task_20606,2018,871,99,165,264,2.3142201834862384,42.460146928139366
Task_20607,1420,456,40,151,191,3.1072210065645516,31.346612269187233
Task_20608,1891,240,12,180,192,7.846473029045643,38.11567083633424
Task_20609,577,77,187,180,367,7.397435897435898,16.85534612436245
Task_20610,2170,121,161,77,238,17.78688524590164,41.32899647006813
Task_20611,665,571,45,21,66,1.1625874125874125,17.435863183823756
Task_20612,2380,475,12,43,55,5.0,44.34385480752774
Task_20613,1506,189,86,125,211,7.926315789473684,31.924103975387066
Task_20614,2107,760,118,171,289,2.7687253613666227,43.64318726236021
Task_20615,2464,674,11,33,44,3.6503703703703705,46.10509451203604
Task_20616,2864,127,97,158,255,22.375,52.829104404628374
Task_20617,669,64,158,170,328,10.292307692307693,18.12400055085354
Task_20618,1484,337,49,80,129,4.390532544378698,31.444295512473264
Task_20619,2932,998,125,50,175,2.934934934934935,56.062275217449525
Task_20620,2832,574,130,24,154,4.925217391304348,52.687497344552945
Task_20621,748,126,100,21,121,5.889763779527559,17.630844535099637
Task_20622,1290,953,52,124,176,1.3522012578616351,30.64931448122076
Task_20623,1842,545,191,148,339,3.3736263736263736,38.960448183785466
Task_20624,2872,357,12,92,104,8.022346368715084,53.03316251363302
Task_20625,1186,824,100,144,244,1.4375757575757575,28.940628377434308
Task_20626,2954,949,75,166,241,3.1094736842105264,57.567237535148905
Task_20627,2544,919,39,138,177,2.765217391304348,50.34177451415124
Task_20628,1170,855,156,109,265,1.3668224299065421,28.83359130821398
Task_20629,2719,708,57,96,153,3.834978843441467,52.30970024484176
Task_20630,2213,529,139,17,156,4.175471698113207,42.58929219654913
Task_20631,2764,959,106,137,243,2.879166666666667,54.418135450851615
Task_20632,1800,616,51,108,159,2.9173419773095626,37.518404746969175
Task_20633,662,495,64,105,169,1.3346774193548387,19.183056141254994
Task_20634,946,160,96,193,289,5.875776397515528,23.145056619317003
Task_20635,1119,107,141,117,258,10.36111111111111,24.94632523070921
Task_20636,1201,563,140,43,183,2.129432624113475,27.135427730279684
Task_20637,2392,517,14,125,139,4.617760617760617,46.365066880817885
Task_20638,1439,786,160,64,224,1.8284625158831005,32.23660133267459
Task_20639,2839,892,58,11,69,3.1791713325867863,52.570150033490364
Task_20640,2923,621,34,109,143,4.69935691318328,55.11430654333781
Task_20641,638,399,24,111,135,1.595,18.21356715573981
Task_20642,1310,423,178,176,354,3.089622641509434,30.259373112804138
Task_20643,2000,1007,133,78,211,1.9841269841269842,41.932202464563105
Task_20644,1986,669,109,145,254,2.964179104477612,41.244989343868326
Task_20645,532,1003,76,86,162,0.5298804780876494,18.51575603295628
Task_20646,1095,954,171,168,339,1.1465968586387434,28.351169344275018
Task_20647,1297,302,37,68,105,4.2805280528052805,27.63301379855875
Task_20648,1472,326,79,83,162,4.5015290519877675,31.09340269231483
Task_20649,2066,885,107,182,289,2.3318284424379234,43.40024640916025
Task_20650,2662,290,147,181,328,9.147766323024054,51.09157157246352
Task_20651,1658,340,183,20,203,4.86217008797654,33.7337262076568
Task_20652,2653,564,109,42,151,4.695575221238938,49.86732213651825
Task_20653,847,692,148,62,210,1.2222222222222223,22.421176220370228
Task_20654,2973,969,28,32,60,3.0649484536082476,55.178694360478865
Task_20655,2697,695,121,32,153,3.875,50.995736663475554
Task_20656,1305,731,172,125,297,1.7827868852459017,30.802778471204096
Task_20657,1356,988,96,182,278,1.3710819009100101,32.39940319180906
Task_20658,1394,741,28,55,83,1.8787061994609164,30.200025426102087
Task_20659,1346,387,82,170,252,3.4690721649484537,30.337644625386037
Task_20660,1520,679,133,131,264,2.235294117647059,33.91971584572675
Task_20661,548,869,180,23,203,0.6298850574712643,18.292586058118623
Task_20662,2545,773,67,181,248,3.2881136950904395,50.57497120308855
Task_20663,2142,450,15,33,48,4.749445676274944,40.394108057604804
Task_20664,2121,574,92,133,225,3.688695652173913,43.01211037100922
Task_20665,1048,625,152,121,273,1.6741214057507987,26.28772774214867
Task_20666,2868,125,101,65,166,22.761904761904763,51.776681418039
Task_20667,1502,746,47,83,130,2.0107095046854084,32.84290835382878
Task_20668,2038,658,190,89,279,3.0925644916540214,41.87708972143775
Task_20669,1755,498,31,58,89,3.5170340681362724,35.150913853868204
Task_20670,2953,658,112,117,229,4.48103186646434,56.372856389212565
Task_20671,1996,851,31,29,60,2.3427230046948355,39.38522470561889
Task_20672,2239,822,67,51,118,2.720534629404617,44.218926119506534
Task_20673,2599,150,143,164,307,17.211920529801326,49.10595117934901
Task_20674,1283,584,131,52,183,2.1931623931623934,28.794821285534002
Task_20675,1405,191,12,19,31,7.317708333333333,27.62702069435849
Task_20676,546,300,81,55,136,1.813953488372093,16.02085478999601
Task_20677,1302,709,116,77,193,1.8338028169014085,29.800465335153785
Task_20678,1412,1013,169,84,253,1.3925049309664694,32.770513984764506
Task_20679,2612,195,65,34,99,13.326530612244898,47.50144198002125
Task_20680,1966,468,71,12,83,4.1918976545842215,38.03626974656765
Task_20681,1326,250,72,191,263,5.282868525896414,29.6854216455894
Task_20682,762,641,89,35,124,1.1869158878504673,20.07967778648263
Task_20683,1590,924,159,10,169,1.718918918918919,34.17623678413823
Task_20684,847,697,83,92,175,1.2134670487106016,22.58497470573859
Task_20685,1425,600,132,179,311,2.3710482529118138,32.449851109652826
Task_20686,566,337,43,177,220,1.6745562130177514,17.612995356273586
Task_20687,2056,737,52,41,93,2.785907859078591,40.49623904900431
Task_20688,2503,813,145,58,203,3.074938574938575,49.017892274368215
Task_20689,947,269,128,137,265,3.5074074074074075,23.56269320554479
Task_20690,2610,124,24,180,204,20.88,48.614472444906106
Task_20691,1520,214,152,88,240,7.069767441860465,31.99036664492172
Task_20692,594,467,16,22,38,1.2692307692307692,15.770097015608895
Task_20693,1308,837,196,47,243,1.5608591885441527,30.13468829705289
Task_20694,2299,343,125,196,321,6.683139534883721,45.5256266737095
Task_20695,2340,576,59,118,177,4.055459272097054,46.143496822332615
Task_20696,2933,94,157,159,316,30.873684210526317,53.622946675435514
Task_20697,2781,409,176,121,297,6.782926829268293,53.15477843469554
Task_20698,1261,694,55,147,202,1.814388489208633,29.76670975582607
Task_20699,2495,615,36,160,196,4.050324675324675,48.905454331893615
Task_20700,1994,871,82,181,263,2.286697247706422,42.18954944517128
Task_20701,2031,765,166,16,182,2.651436031331593,40.73789965264877
Task_20702,1449,840,156,181,337,1.72294887039239,33.68555503289695
Task_20703,2159,935,23,90,113,2.3066239316239314,43.838184221155664
Task_20704,2780,763,117,85,202,3.6387434554973823,53.52140062640576
Task_20705,2047,901,153,149,302,2.2694013303769403,43.15926077364286
Task_20706,1445,786,194,76,270,1.8360864040660736,32.65035312219323
Task_20707,837,1010,195,116,311,0.827893175074184,24.231140521996178
Task_20708,1844,311,44,12,56,5.910256410256411,35.060841619849974
Task_20709,2376,226,126,163,289,10.466960352422907,46.13505905062197
Task_20710,2011,376,55,132,187,5.334217506631299,40.50348230187745
Task_20711,1122,295,138,126,264,3.7905405405405403,26.393549870758914
Task_20712,2619,649,24,135,159,4.029230769230769,50.48854682455775
Task_20713,1321,254,170,136,306,5.180392156862745,29.606221971851053
Task_20714,1506,81,80,103,183,18.365853658536587,30.480832384535642
Task_20715,1317,880,198,62,260,1.4948921679909195,30.70228656137053
Task_20716,852,717,20,179,199,1.1866295264623956,23.094825321106867
Task_20717,529,744,78,194,272,0.7100671140939597,18.71669013491026
Task_20718,745,856,42,100,142,0.8693115519253208,21.15834608383075
Task_20719,507,358,125,124,249,1.4122562674094707,16.730231983961485
Task_20720,2769,355,131,179,310,7.77808988764045,52.9262973376324
Task_20721,1100,191,41,26,67,5.729166666666667,23.37132507818701
Task_20722,2941,787,138,17,155,3.732233502538071,54.93332378078593
Task_20723,829,150,36,31,67,5.490066225165563,18.626433036755923
Task_20724,2311,688,164,150,314,3.3541364296081277,46.730437364431616
Task_20725,1656,273,187,86,273,6.043795620437956,34.4789799712216
Task_20726,749,728,127,140,267,1.027434842249657,21.757819966384318
Task_20727,2997,407,11,164,175,7.345588235294118,56.019607478229794
Task_20728,2537,559,182,15,197,4.5303571428571425,48.35162065837514
Task_20729,2508,916,63,132,195,2.7350054525627043,50.131610664149115
Task_20730,1121,200,96,35,131,5.577114427860696,24.509195487471573
Task_20731,2340,187,167,89,256,12.446808510638299,45.14212827057753
Task_20732,2552,466,34,77,111,5.464668094218416,48.30327768861059
Task_20733,1348,178,119,198,317,7.5307262569832405,29.51555516446868
Task_20734,2450,631,190,43,233,3.8765822784810124,47.533701022870254
Task_20735,1435,877,161,130,291,1.6343963553530751,33.29657558647972
Task_20736,2536,880,27,28,55,2.8785471055618617,48.03666847114797
Task_20737,2116,488,54,83,137,4.32719836400818,41.80665883078615
Task_20738,2203,686,76,113,189,3.2066957787481805,44.50713969745806
Task_20739,1566,802,181,192,373,1.950186799501868,35.61286064913447
Task_20740,750,825,23,92,115,0.9079903147699758,21.037135197611935
Task_20741,2456,856,63,137,200,2.865810968494749,49.15002584960221
Task_20742,2058,186,192,30,222,11.005347593582888,40.02618774029209
Task_20743,1584,990,144,161,305,1.598385469223007,36.11676139933008
Task_20744,2580,974,47,64,111,2.646153846153846,50.1763626766965
Task_20745,1414,394,12,116,128,3.579746835443038,30.603423468555135
Task_20746,1228,681,106,111,217,1.8005865102639296,29.05963137580714
Task_20747,1430,752,196,154,350,1.899070385126162,33.14319007319011
Task_20748,515,74,133,31,164,6.866666666666666,13.969618018379963
Task_20749,2807,473,57,149,206,5.921940928270042,53.567173408018135
Task_20750,2456,191,83,182,265,12.791666666666666,47.2245508451785
Task_20751,1373,464,73,58,131,2.9526881720430107,29.613003694789267
Task_20752,2615,209,119,33,152,12.452380952380953,48.06157082436363
Task_20753,891,123,61,67,128,7.185483870967742,20.520951360140923
Task_20754,1426,72,187,135,322,19.534246575342465,29.864380594926
Task_20755,1744,760,183,55,238,2.2917214191852824,37.06671960943529
Task_20756,826,286,86,155,241,2.8780487804878048,21.6657500369962
Task_20757,1285,808,132,77,209,1.588380716934487,29.884396076547333
Task_20758,1521,921,76,100,176,1.6496746203904555,34.21503477519979
Task_20759,1676,474,37,178,215,3.528421052631579,35.611535493053196
Task_20760,1756,153,47,62,109,11.402597402597403,33.883728800044814
Task_20761,1254,859,155,103,258,1.458139534883721,30.129610390943956
Task_20762,2196,168,53,159,212,12.994082840236686,42.577934475325286
Task_20763,1680,804,93,121,214,2.0869565217391304,36.71646917425148
Task_20764,1251,544,55,183,238,2.295412844036697,29.354220249239674
Task_20765,2310,355,154,187,341,6.48876404494382,45.81703097379995
Task_20766,2899,184,131,114,245,15.67027027027027,53.79925753009574
Task_20767,1059,464,167,163,330,2.2774193548387096,26.28947153755507
Task_20768,2857,409,124,35,159,6.96829268292683,52.663254683758204
Task_20769,1770,174,134,72,206,10.114285714285714,35.17827500701768
Task_20770,788,580,25,147,172,1.3562822719449226,21.516110837884355
Task_20771,2456,668,124,186,310,3.671150971599402,48.99878350506145
Task_20772,1522,1023,122,160,282,1.486328125,35.102100270496585
Task_20773,1173,515,111,52,163,2.2732558139534884,26.78158954534453
Task_20774,1710,448,62,137,199,3.8084632516703785,36.04227216195377
Task_20775,2068,613,81,44,125,3.3680781758957656,40.5928271292475
Task_20776,2664,103,33,30,63,25.615384615384617,47.031826629765476
Task_20777,741,516,167,62,229,1.4332688588007736,20.293673698933954
Task_20778,2664,836,147,23,170,3.182795698924731,51.03050656762545
Task_20779,2815,362,149,166,315,7.754820936639119,53.681357909783
Task_20780,2889,849,41,97,138,3.398823529411765,55.27709578665645
Task_20781,2771,542,134,77,211,5.1031307550644565,52.620899984608315
Task_20782,2709,722,154,86,240,3.7468879668049793,52.45077941501567
Task_20783,1494,100,92,159,251,14.792079207920793,30.911411287548987
Task_20784,2536,981,104,170,274,2.5824847250509166,51.061847745372596
Task_20785,616,328,49,194,243,1.872340425531915,18.664505178362734
Task_20786,570,731,54,182,236,0.7786885245901639,19.0025136533626
Task_20787,2220,768,143,180,323,2.886866059817945,45.62485728044178
Task_20788,1314,725,10,131,141,1.8099173553719008,29.94215333033767
Task_20789,1209,874,48,144,192,1.3817142857142857,29.310623165338573
Task_20790,875,131,136,120,256,6.628787878787879,21.4798406738297
Task_20791,2153,601,159,194,353,3.5764119601328903,44.193332137002436
Task_20792,2219,409,83,13,96,5.412195121951219,41.925235111702
Task_20793,2714,671,125,119,244,4.038690476190476,52.69913671095526
Task_20794,2282,759,74,181,255,3.0026315789473683,46.40565122162803
Task_20795,1838,420,143,156,299,4.365795724465558,38.32839116736932
Task_20796,2475,985,194,142,336,2.5101419878296145,50.346052349035006
Task_20797,2789,240,67,125,192,11.572614107883817,52.3413597633181
Task_20798,1946,380,73,80,153,5.107611548556431,38.69598299900081
Task_20799,1166,136,94,93,187,8.510948905109489,25.715784444992092
Task_20800,1703,306,74,127,201,5.547231270358306,35.46533099350936
Task_20801,1581,229,107,97,204,6.873913043478261,33.143707916321084
Task_20802,2050,1011,55,82,137,2.025691699604743,42.44144330773815
Task_20803,749,829,106,65,171,0.9024096385542169,21.04637690363907
Task_20804,1078,723,130,12,142,1.488950276243094,25.228644253728916
Task_20805,2364,465,98,35,133,5.072961373390558,45.004179082683436
Task_20806,2896,650,154,108,262,4.448540706605223,55.58012657339324
Task_20807,2251,688,139,151,290,3.267053701015965,45.67333840364807
Task_20808,1131,1000,174,94,268,1.12987012987013,28.56832807750934
Task_20809,1494,290,54,133,187,5.134020618556701,32.04298686474623
Task_20810,735,855,103,176,279,0.8586448598130841,22.088108893973157
Task_20811,2433,1006,90,29,119,2.4160873882820257,47.59439013710136
Task_20812,2005,422,154,45,199,4.739952718676123,39.62660355465025
Task_20813,587,451,109,93,202,1.2986725663716814,17.940753988537164
Task_20814,2358,723,173,172,345,3.2569060773480665,47.757127515915364
Task_20815,2003,567,132,151,283,3.5264084507042255,41.331610534847066
Task_20816,1288,234,116,15,131,5.480851063829787,27.017173886606766
Task_20817,2573,702,173,145,318,3.660028449502134,50.935422414835195
Task_20818,2133,69,100,88,188,30.47142857142857,40.08505508077983
Task_20819,1483,752,55,14,69,1.9694555112881806,30.650639698855443
Task_20820,756,422,168,172,340,1.7872340425531914,21.419864831301595
Task_20821,2036,520,15,10,25,3.907869481765835,38.55307002209249
Task_20822,977,861,55,115,170,1.1334106728538282,25.26216076577901
Task_20823,2697,546,99,129,228,4.93053016453382,51.97523406318779
Task_20824,2138,806,109,141,250,2.6493184634448577,44.05853059455836
Task_20825,1520,371,183,147,330,4.086021505376344,33.26426423955569
Task_20826,2992,595,166,10,176,5.02013422818792,55.427930408480115
Task_20827,606,395,191,129,320,1.5303030303030303,18.76556196539543
Task_20828,723,1019,42,76,118,0.7088235294117647,21.232725409457462
Task_20829,1695,279,101,29,130,6.053571428571429,33.78337786597952
Task_20830,1715,683,120,198,318,2.507309941520468,37.362572209924444
Task_20831,1583,674,150,141,291,2.3451851851851853,35.03831293267119
Task_20832,1949,773,146,65,211,2.5180878552971575,40.23383095695589
Task_20833,2016,162,46,167,213,12.368098159509202,39.62560207618757
Task_20834,1729,354,178,16,194,4.870422535211268,34.8866273033808
Task_20835,2853,484,96,105,201,5.882474226804124,54.13845113115411
Task_20836,2275,163,39,25,64,13.871951219512194,41.506633667522316
Task_20837,2357,522,132,121,253,4.506692160611855,46.61401433479447
Task_20838,2596,500,106,100,206,5.181636726546906,50.084314672078484
Task_20839,1685,551,145,127,272,3.052536231884058,36.16074361946436
Task_20840,1972,561,135,51,186,3.508896797153025,39.63536153152446
Task_20841,2205,879,165,114,279,2.5056818181818183,45.43923014858827
Task_20842,823,487,110,71,181,1.6864754098360655,21.179912720958477
Task_20843,1599,452,105,93,198,3.5298013245033113,34.03586336059207
Task_20844,1155,589,147,54,201,1.9576271186440677,27.004664625230713
Task_20845,2864,591,149,160,309,4.837837837837838,55.172996831928536
Task_20846,1875,214,128,108,236,8.720930232558139,37.85889644992148
Task_20847,1609,955,151,31,182,1.6830543933054394,34.82068884068832
Task_20848,1680,700,161,52,213,2.3965763195435095,35.7619161941299
Task_20849,1838,566,140,16,156,3.241622574955908,36.83852589434832
Task_20850,2905,875,18,179,197,3.3162100456621006,56.21791615466142
Task_20851,810,645,41,111,152,1.2538699690402477,21.48389176792683
Task_20852,1208,387,193,92,285,3.11340206185567,27.995447975089444
Task_20853,2254,96,99,164,263,23.237113402061855,42.738363063108004
Task_20854,690,727,101,69,170,0.9478021978021978,19.79891435936972
Task_20855,1846,181,101,99,200,10.142857142857142,36.728101856886845
Task_20856,2095,995,86,77,163,2.103413654618474,43.00555760953025
Task_20857,1545,975,195,129,324,1.5829918032786885,35.461655248929866
Task_20858,547,644,131,29,160,0.8480620155038759,16.86273038573574
Task_20859,521,859,138,197,335,0.6058139534883721,19.189622164796884
Task_20860,1402,651,178,118,296,2.1503067484662575,32.08830411993904
Task_20861,2269,402,171,99,270,5.630272952853598,44.86092072434125
Task_20862,602,349,74,131,205,1.72,18.2033860546168
Task_20863,2601,864,187,40,227,3.006936416184971,50.63917399331501
Task_20864,2157,874,62,155,217,2.4651428571428573,44.57172938222741
Task_20865,1714,1019,125,51,176,1.6803921568627451,36.90705240568877
Task_20866,2240,351,97,145,242,6.363636363636363,44.21222314765083
Task_20867,2605,117,193,49,242,22.076271186440678,47.85501526770731
Task_20868,2191,993,23,109,132,2.204225352112676,44.75710885831643
Task_20869,749,619,106,63,169,1.2080645161290322,20.324988311908466
Task_20870,1121,764,152,22,174,1.465359477124183,26.49144345513157
Task_20871,592,825,169,119,288,0.7167070217917676,19.79519412066843
Task_20872,676,864,191,108,299,0.7815028901734105,21.195053182395053
Task_20873,1014,626,130,194,324,1.6172248803827751,26.089235719779477
Task_20874,2053,459,30,161,191,4.46304347826087,41.41882375480528
Task_20875,1765,637,194,190,384,2.7664576802507836,38.29589993330945
Task_20876,1176,230,51,63,114,5.090909090909091,25.77348062934988
Task_20877,917,876,63,114,177,1.0456100342075256,24.31481522400598
Task_20878,2143,686,121,77,198,3.119359534206696,43.0745831293575
Task_20879,2381,925,170,77,247,2.5712742980561556,47.814427154056176
Task_20880,1346,386,59,27,86,3.4780361757105944,27.966690173185338
Task_20881,2057,814,63,97,160,2.5239263803680982,42.19234671446535
Task_20882,2990,891,119,93,212,3.3520179372197307,57.51699296283859
Task_20883,1805,921,166,67,233,1.9577006507592192,38.51474518976984
Task_20884,590,369,177,179,356,1.5945945945945945,18.69562783339455
Task_20885,1518,307,54,171,225,4.928571428571429,32.74348936796942
Task_20886,1351,876,152,116,268,1.540478905359179,31.809026445342898
Task_20887,1696,142,108,132,240,11.86013986013986,34.49807293671022
Task_20888,817,726,11,84,95,1.123796423658872,21.368536757532116
Task_20889,1660,653,46,88,134,2.53822629969419,35.03948353968846
Task_20890,1547,197,194,42,236,7.813131313131313,31.881176596550787
Task_20891,2143,780,56,136,192,2.7439180537772088,43.94633161765584
Task_20892,1598,275,120,187,307,5.7898550724637685,34.134466166862204
Task_20893,2853,729,59,167,226,3.908219178082192,55.22838243457568
Task_20894,1543,760,58,163,221,2.0275952693823918,34.54459121529721
Task_20895,763,72,142,186,328,10.452054794520548,19.592160898790215
Task_20896,2354,491,124,108,232,4.784552845528455,46.35300770656556
Task_20897,767,862,80,119,199,0.8887601390498262,22.256153343529252
Task_20898,950,974,121,117,238,0.9743589743589743,25.586117786449886
Task_20899,2073,597,179,143,322,3.4665551839464883,42.699258374635356
Task_20900,2915,761,170,19,189,3.825459317585302,54.857391309323155
Task_20901,1192,279,138,143,281,4.257142857142857,27.548930957121385
Task_20902,2904,580,174,200,374,4.998278829604131,56.122747158088465
Task_20903,634,237,102,33,135,2.6638655462184873,16.87018173847641
Task_20904,2534,241,63,189,252,10.47107438016529,48.686783195076295
Task_20905,1478,245,29,65,94,6.008130081300813,30.209819680216114
Task_20906,575,1014,95,47,142,0.5665024630541872,18.737301784248547
Task_20907,2795,1004,194,153,347,2.781094527363184,55.54200930984598
Task_20908,1230,956,112,61,173,1.2852664576802508,29.01628343691296
Task_20909,1564,1010,125,52,177,1.5469831849653808,34.526431722146796
Task_20910,2725,434,16,148,164,6.264367816091954,51.643225634875584
Task_20911,530,886,101,104,205,0.5975197294250282,18.643036142942766
Task_20912,1030,407,43,200,243,2.5245098039215685,25.326024302523553
Task_20913,1218,671,114,111,225,1.8125,28.90611827932666
Task_20914,1593,699,61,106,167,2.275714285714286,34.60239251789152
Task_20915,2189,527,90,73,163,4.145833333333333,42.97366709233506
Task_20916,973,226,68,188,256,4.286343612334802,23.987032190730346
Task_20917,1419,632,43,199,242,2.241706161137441,32.18709490266637
Task_20918,2554,849,27,153,180,3.0047058823529413,50.34902832151528
Task_20919,1172,290,83,146,229,4.027491408934708,27.092771553640844
Task_20920,969,910,113,128,241,1.0636663007683864,25.66332645469497
Task_20921,1531,140,15,114,129,10.858156028368795,30.893730605082197
Task_20922,1265,702,91,184,275,1.7994310099573259,30.12883677530868
Task_20923,2338,268,60,59,119,8.691449814126393,43.91107852568419
Task_20924,867,873,48,197,245,0.9919908466819222,24.14408109946845
Task_20925,2680,357,79,37,116,7.4860335195530725,49.45634294612836
Task_20926,2801,72,182,57,239,38.36986301369863,50.469454341918244
Task_20927,2139,339,156,10,166,6.291176470588235,41.06532026359765
Task_20928,2322,579,179,67,246,4.003448275862069,45.69038271047602
Task_20929,1504,868,80,128,208,1.7307249712313004,34.11218366917324
Task_20930,963,672,48,92,140,1.4309063893016345,24.137821056860005
Task_20931,2325,846,65,147,212,2.7449822904368357,47.109233065871
Task_20932,2310,803,88,26,114,2.873134328358209,44.94187683964242
Task_20933,2167,340,64,200,264,6.354838709677419,43.304631673303454
Task_20934,2273,379,154,43,197,5.981578947368421,43.755584454904415
Task_20935,701,163,49,33,82,4.274390243902439,17.019527406822107
Task_20936,893,519,131,128,259,1.7173076923076922,23.449484499206523
Task_20937,818,109,172,92,264,7.4363636363636365,20.12283884305697
Task_20938,2852,727,128,163,291,3.9175824175824174,55.338662022035955
Task_20939,1259,812,142,135,277,1.5485854858548584,30.221111691578162
Task_20940,2081,738,53,17,70,2.8159675236806496,40.0848213295278
Task_20941,2898,880,29,184,213,3.2894438138479,56.26897276603403
Task_20942,2654,635,144,21,165,4.172955974842767,50.298667820443335
Task_20943,2185,81,81,177,258,26.646341463414632,41.68834938533933
Task_20944,2870,645,129,165,294,4.442724458204334,55.38019124936843
Task_20945,2433,797,98,191,289,3.0488721804511276,48.967061542444505
Task_20946,2793,713,128,21,149,3.911764705882353,52.49403908959184
Task_20947,1572,896,184,86,270,1.7525083612040133,35.107191886703205
Task_20948,1848,337,122,187,309,5.4674556213017755,38.30492628609643
Task_20949,1276,400,29,93,122,3.1820448877805485,28.244624981691114
Task_20950,2927,698,38,166,204,4.187410586552217,56.05963825412507
Task_20951,1823,101,16,120,136,17.872549019607842,34.91591081919102
Task_20952,2416,710,37,89,126,3.39803094233474,47.27576006028939
Task_20953,2393,451,152,169,321,5.29424778761062,47.33116231024093
Task_20954,1918,458,79,85,164,4.178649237472767,38.79743266884636
Task_20955,2568,804,147,63,210,3.190062111801242,50.10911888066416
Task_20956,2007,420,170,67,237,4.767220902612826,40.15202665613567
Task_20957,2654,139,60,24,84,18.957142857142856,47.40419564409092
Task_20958,1247,515,60,133,193,2.4166666666666665,28.892869855708124
Task_20959,613,838,62,36,98,0.7306317044100119,18.14567126292547
Task_20960,2370,800,156,68,224,2.958801498127341,47.0505156091262
Task_20961,1768,799,99,173,272,2.21,38.322447268182735
Task_20962,1903,740,61,91,152,2.5681511470985154,39.29751039803576
Task_20963,1711,995,48,167,215,1.7178714859437751,37.87131066462306
Task_20964,2317,85,74,105,179,26.941860465116278,43.228716887338486
Task_20965,2771,880,60,184,244,3.145289443813848,54.48341742562108
Task_20966,1729,912,95,192,287,1.8937568455640745,38.22020430022307
Task_20967,2687,314,179,26,205,8.53015873015873,50.082950375991174
Task_20968,2969,440,46,58,104,6.732426303854876,54.27956540142259
Task_20969,726,740,80,35,115,0.979757085020243,19.83828945589676
Task_20970,1425,597,57,119,176,2.382943143812709,31.746519269748646
Task_20971,1199,109,74,125,199,10.9,26.075259550156403
Task_20972,1882,515,53,82,135,3.647286821705426,38.241989921283384
Task_20973,2572,354,28,31,59,7.245070422535211,46.85519854613607
Task_20974,1207,629,77,55,132,1.915873015873016,27.55004125950265
Task_20975,1678,712,109,154,263,2.3534361851332397,36.55487167680413
Task_20976,1168,699,54,161,215,1.6685714285714286,28.37526037414739
Task_20977,2223,420,146,79,225,5.280285035629453,43.681937638328186
Task_20978,1325,578,114,122,236,2.2884283246977546,30.375628942437753
Task_20979,2243,248,200,199,399,9.008032128514056,44.664489734156454
Task_20980,914,894,75,20,95,1.0212290502793295,22.94093429018422
Task_20981,1409,244,35,116,151,5.751020408163265,29.93553464412822
Task_20982,921,867,127,123,250,1.0610599078341014,24.802944891041275
Task_20983,1085,649,41,170,211,1.6692307692307693,26.75334992324814
Task_20984,523,473,137,157,294,1.1033755274261603,17.517664492633468
Task_20985,2834,220,46,55,101,12.823529411764707,51.437367852589794
Task_20986,950,796,86,74,160,1.191969887076537,24.060830992584844
Task_20987,2157,443,51,188,239,4.858108108108108,43.42401192911768
Task_20988,1842,597,185,142,327,3.080267558528428,39.06210933611387
Task_20989,1124,732,187,146,333,1.5334242837653478,28.10236208088641
Task_20990,638,153,195,55,250,4.142857142857143,17.456705990814562
Task_20991,1160,608,171,143,314,1.9047619047619047,28.2389102437451
Task_20992,1622,417,95,142,237,3.8803827751196174,34.67062130838457
Task_20993,704,509,133,52,185,1.380392156862745,19.416807159088137
Task_20994,691,439,15,101,116,1.5704545454545455,19.003966053664872
Task_20995,1654,1013,159,60,219,1.631163708086785,36.25608719421267
Task_20996,2219,850,167,11,178,2.607520564042303,43.98616260989629
Task_20997,995,646,113,76,189,1.5378670788253477,24.660367040123415
Task_20998,2735,83,47,117,164,32.55952380952381,49.66680190269872
Task_20999,2279,995,16,160,176,2.288152610441767,46.38714829003067
Task_21000,590,506,193,195,388,1.1637080867850098,19.222831275900898
Task_21001,635,1010,153,62,215,0.6280909990108803,20.36172023111749
Task_21002,710,615,180,173,353,1.1525974025974026,21.2717640272559
Task_21003,2422,168,109,53,162,14.331360946745562,45.082444481992376
Task_21004,1952,919,185,74,259,2.121739130434783,41.04931991958373
Task_21005,1080,142,84,192,276,7.5524475524475525,25.09153007137284
Task_21006,1197,418,163,31,194,2.856801909307876,26.851508063494418
Task_21007,2326,582,57,24,81,3.9897084048027445,44.11746218923474
Task_21008,687,132,75,24,99,5.165413533834586,16.559022553377062
Task_21009,1300,440,76,22,98,2.947845804988662,27.657103034837515
Task_21010,867,758,193,54,247,1.1422924901185771,23.184624827866084
Task_21011,2445,329,18,67,85,7.409090909090909,45.61275780160605
Task_21012,2358,714,131,164,295,3.297902097902098,47.49172262872858
Task_21013,1430,882,93,23,116,1.6194790486976218,31.386381864491494
Task_21014,581,1000,107,175,282,0.5804195804195804,20.233607795371714
Task_21015,586,560,29,160,189,1.0445632798573976,18.248455316945712
Task_21016,1926,587,132,57,189,3.2755102040816326,39.08428897627679
Task_21017,2078,734,129,182,311,2.8272108843537413,43.217565118264794
Task_21018,1818,834,38,148,186,2.1772455089820357,38.68028058370196
Task_21019,1589,396,147,17,164,4.002518891687657,32.519197488175394
Task_21020,2010,317,84,165,249,6.320754716981132,40.544396286350036
Task_21021,2177,945,87,68,155,2.3012684989429175,43.797129943148654
Task_21022,2408,453,120,113,233,5.3039647577092515,47.09638958793119
Task_21023,632,864,132,40,172,0.730635838150289,19.20906953604622
Task_21024,1293,734,23,199,222,1.7591836734693878,30.48864487791077
Task_21025,2032,602,101,124,225,3.369817578772803,41.600747428727
Task_21026,2331,191,14,149,163,12.140625,44.536088965357784
Task_21027,2413,767,75,183,258,3.1419270833333335,48.52677827945339
Task_21028,1927,538,133,142,275,3.575139146567718,39.98683540708849
Task_21029,2014,958,101,185,286,2.100104275286757,42.79441377977721
Task_21030,1495,569,70,43,113,2.6228070175438596,31.39332876155258
Task_21031,2226,334,95,42,137,6.6447761194029855,42.437997380334174
Task_21032,1017,721,130,44,174,1.4085872576177285,24.768935052361527
Task_21033,1003,179,15,168,183,5.572222222222222,23.182278468221302
Task_21034,2777,713,188,147,335,3.8893557422969187,54.28119900569718
Task_21035,1276,402,78,79,157,3.166253101736973,28.19733190404935
Task_21036,2567,982,143,45,188,2.6113936927772126,50.20719804414778
Task_21037,2545,586,118,92,210,4.335604770017036,49.45871275141524
Task_21038,2242,700,197,99,296,3.1982881597717547,45.504579297131535
Task_21039,2207,690,12,170,182,3.193921852387844,44.34707128697374
Task_21040,2423,382,99,72,171,6.326370757180157,46.13147608462655
Task_21041,2842,188,23,26,49,15.037037037037036,50.76910965014471
Task_21042,2315,439,173,115,288,5.261363636363637,45.82958689607617
Task_21043,2162,281,94,59,153,7.666666666666667,41.42140725068495
Task_21044,2640,744,161,112,273,3.5436241610738257,51.87803644592869
Task_21045,1012,196,25,59,84,5.137055837563452,22.373788903050166
Task_21046,2339,783,158,35,193,2.983418367346939,46.088755927232306
Task_21047,1902,675,180,50,230,2.8136094674556213,39.04914263003314
Task_21048,2814,185,186,84,270,15.129032258064516,52.384658488878536
Task_21049,762,923,108,117,225,0.8246753246753247,22.38777871914063
Task_21050,2265,661,122,140,262,3.421450151057402,45.66762685864584
Task_21051,771,820,24,100,124,0.9390986601705238,21.45469949031204
Task_21052,2234,355,187,11,198,6.275280898876405,42.921585020915906
Task_21053,1404,209,30,184,214,6.685714285714286,30.457409398284327
Task_21054,1435,876,161,113,274,1.6362599771949828,33.19193040295343
Task_21055,1035,256,166,158,324,4.027237354085603,25.20715284260321
Task_21056,2977,915,152,108,260,3.25,57.689857350089234
Task_21057,2336,673,40,96,136,3.4658753709198815,45.979398034487225
Task_21058,683,543,141,81,222,1.255514705882353,19.580983965721455
Task_21059,1384,786,45,77,122,1.758576874205845,30.902831818238727
Task_21060,2765,637,127,132,259,4.33385579937304,53.485588794658895
Task_21061,1450,494,40,198,238,2.9292929292929295,32.222892671556565
Task_21062,2236,674,116,156,272,3.3125925925925928,45.31782605364623
Task_21063,634,920,23,71,94,0.6883821932681867,19.285982423380375
Task_21064,2699,787,122,25,147,3.4251269035532994,51.286392808898256
Task_21065,1592,523,93,101,194,3.0381679389312977,34.32191271050471
Task_21066,621,267,69,179,248,2.3171641791044775,18.510461747188145
Task_21067,1433,944,105,182,287,1.5164021164021164,33.50166589389184
Task_21068,1222,414,76,104,180,2.944578313253012,27.904729345633836
Task_21069,2982,811,67,177,244,3.6724137931034484,57.59392667320565
Task_21070,1554,188,60,199,259,8.222222222222221,33.07594807466972
Task_21071,2449,382,30,10,40,6.394255874673629,44.66853370566762
Task_21072,1881,582,52,35,87,3.2264150943396226,37.087054211594726
Task_21073,778,317,138,81,219,2.4465408805031448,20.43364954143321
Task_21074,2069,234,144,42,186,8.804255319148936,39.84413361677417
Task_21075,1387,872,159,133,292,1.5887743413516608,32.50011399915522
Task_21076,1266,259,129,87,216,4.869230769230769,28.022372335792628
Task_21077,679,397,78,158,236,1.7060301507537687,19.750854208068578
Task_21078,1284,514,42,200,242,2.4932038834951458,29.68022567522385
Task_21079,2356,208,58,133,191,11.272727272727273,45.41863635437583
Task_21080,2215,604,115,36,151,3.6611570247933884,43.08787016179573
Task_21081,1723,685,100,110,210,2.511661807580175,36.87979446683088
Task_21082,2614,949,26,154,180,2.751578947368421,51.61378927279685
Task_21083,2336,621,116,94,210,3.7556270096463025,46.30825653590222
Task_21084,1115,75,41,108,149,14.671052631578947,23.810808313769456
Task_21085,1698,566,59,52,111,2.994708994708995,34.728385834994185
Task_21086,1831,250,48,139,187,7.294820717131474,37.20471579073895
Task_21087,2810,593,62,167,229,4.730639730639731,54.101929235137014
Task_21088,1924,751,145,113,258,2.5585106382978724,40.491189587749645
Task_21089,1838,927,50,95,145,1.980603448275862,39.09208173194699
Task_21090,1756,770,102,71,173,2.277561608300908,36.9153928942068
Task_21091,1366,560,32,112,144,2.4349376114081998,30.284678338181923
Task_21092,744,1008,172,113,285,0.7373637264618434,22.609151485372678
Task_21093,1173,955,147,79,226,1.2269874476987448,28.667307160176218
Task_21094,2987,884,96,107,203,3.375141242937853,57.545658774802064
Task_21095,1742,523,152,114,266,3.3244274809160306,36.92842961610196
Task_21096,1056,307,87,153,240,3.4285714285714284,25.329144469476773
Task_21097,2253,136,52,103,155,16.445255474452555,42.41794452016178
Task_21098,1449,376,86,168,254,3.843501326259947,31.88749411199159
Task_21099,2170,462,50,192,242,4.686825053995681,43.70429371094309
Task_21100,930,71,171,193,364,12.916666666666666,22.38546099761678
Task_21101,1098,398,90,132,222,2.7518796992481205,26.21472489781726
Task_21102,2221,454,153,75,228,4.881318681318682,43.69730623667473
Task_21103,503,302,184,127,311,1.66006600660066,16.829437062033097
Task_21104,2373,640,96,175,271,3.702028081123245,47.456525768249996
Task_21105,572,947,11,157,168,0.6033755274261603,19.255432028351958
Task_21106,2813,516,114,36,150,5.44100580270793,52.26054108002594
Task_21107,924,345,127,59,186,2.6705202312138727,22.305097007773526
Task_21108,1579,154,19,97,116,10.187096774193549,31.324189376364554
Task_21109,2589,508,134,177,311,5.086444007858546,50.58549368736243
Task_21110,2953,179,132,15,147,16.405555555555555,52.97867729139185
Task_21111,796,448,163,102,265,1.7728285077951003,21.68049470077464
Task_21112,2775,775,129,158,287,3.5760309278350517,54.244869177676
Task_21113,767,894,144,194,338,0.8569832402234637,23.00798877989902
Task_21114,1534,272,174,50,224,5.619047619047619,31.901029962379052
Task_21115,2399,397,125,34,159,6.027638190954774,45.37380876796899
Task_21116,1898,564,81,48,129,3.35929203539823,37.93258327711914
Task_21117,1525,324,170,10,180,4.6923076923076925,31.337879281240816
Task_21118,2727,867,190,175,365,3.141705069124424,54.14970572730243
Task_21119,617,767,22,169,191,0.8033854166666666,19.442583393978424
Task_21120,2817,210,71,17,88,13.350710900473933,50.549341766362396
Task_21121,2685,590,85,175,260,4.543147208121828,52.18358528335856
Task_21122,1978,83,85,11,96,23.547619047619047,36.08094186090441
Task_21123,1352,530,17,164,181,2.5461393596986817,30.225002792324176
Task_21124,2357,773,53,38,91,3.045219638242894,45.33305645767268
Task_21125,2571,89,132,107,239,28.566666666666666,47.579796441882934
Task_21126,1354,805,56,110,166,1.6799007444168734,31.180979005786966
Task_21127,1695,109,44,97,141,15.409090909090908,33.062853668799214
Task_21128,1775,368,24,48,72,4.8102981029810294,34.42705016520033
Task_21129,1203,955,181,28,209,1.25836820083682,28.656473750691166
Task_21130,2471,1021,175,19,194,2.4178082191780823,48.688652012020064
Task_21131,1649,500,41,152,193,3.291417165668663,35.12208614173171
Task_21132,999,602,84,149,233,1.6567164179104477,25.348071598025303
Task_21133,1563,993,166,178,344,1.5724346076458753,35.96467953090109
Task_21134,1477,355,60,73,133,4.148876404494382,31.14664983502342
Task_21135,933,104,18,119,137,8.885714285714286,20.886928079959816
Task_21136,779,155,41,128,169,4.993589743589744,19.50628785696024
Task_21137,2502,664,173,20,193,3.762406015037594,48.090591096281116
Task_21138,1792,227,159,126,285,7.859649122807017,36.84305991612327
Task_21139,652,353,48,177,225,1.8418079096045197,19.169411068846905
Task_21140,1532,633,70,99,169,2.416403785488959,33.43101895053146
Task_21141,1304,111,169,94,263,11.642857142857142,27.8447228344068
Task_21142,1603,832,17,188,205,1.9243697478991597,35.46718354661399
Task_21143,866,713,53,56,109,1.2128851540616246,21.931728596967105
Task_21144,1531,787,16,183,199,1.9428934010152283,34.1774769488601
Task_21145,2469,159,87,108,195,15.43125,46.5659498172252
Task_21146,1834,693,81,139,220,2.642651296829971,38.85436589209176
Task_21147,1361,531,123,192,315,2.558270676691729,31.256565988625933
Task_21148,765,402,65,20,85,1.8982630272952854,18.632130738692094
Task_21149,706,425,103,95,198,1.6572769953051643,19.843559502087174
Task_21150,1541,781,112,152,264,1.9705882352941178,34.60147981958375
Task_21151,1616,611,123,64,187,2.6405228758169934,34.27834590913317
Task_21152,561,869,141,28,169,0.6448275862068965,18.117476051186188
Task_21153,2230,906,111,74,185,2.4586549062844543,44.93001040391215
Task_21154,1484,180,62,40,102,8.19889502762431,29.203185543173365
Task_21155,2308,710,150,11,161,3.246132208157525,44.807272173586426
Task_21156,2842,550,50,22,72,5.157894736842105,51.80637453430372
Task_21157,2329,239,20,78,98,9.704166666666667,43.721601066031475
Task_21158,2818,700,118,42,160,4.019971469329529,52.954659697923596
Task_21159,1837,444,61,97,158,4.128089887640449,37.53212059951423
Task_21160,1575,109,38,80,118,14.318181818181818,30.88229178689194
Task_21161,813,384,144,186,330,2.1116883116883116,22.17751990507054
Task_21162,1666,725,114,124,238,2.2947658402203857,36.248769160186825
Task_21163,2697,684,103,128,231,3.937226277372263,52.425648945211854
Task_21164,2808,943,92,141,233,2.9745762711864407,55.10369709398245
Task_21165,796,926,168,145,313,0.8586839266450917,23.38189057576581
Task_21166,1502,512,91,156,247,2.9278752436647175,33.11897157753911
Task_21167,1190,177,118,85,203,6.685393258426966,26.14140479321819
Task_21168,848,489,116,156,272,1.7306122448979593,22.742824293592403
Task_21169,2438,1013,94,40,134,2.4043392504930967,47.96252274768046
Task_21170,1600,225,196,114,310,7.079646017699115,33.89862345781058
Task_21171,2815,421,60,195,255,6.670616113744076,53.77995336455124
Task_21172,1974,667,41,79,120,2.9550898203592815,39.91370862774522
Task_21173,2085,857,129,176,305,2.43006993006993,43.677297853919846
Task_21174,1002,565,180,112,292,1.7703180212014133,25.444440817760846
Task_21175,1804,333,129,155,284,5.401197604790419,37.43612035510901
Task_21176,710,269,80,150,230,2.6296296296296298,19.805636419199523
Task_21177,938,437,198,22,220,2.141552511415525,22.846242859002984
Task_21178,1239,543,117,191,308,2.2775735294117645,29.329617056505
Task_21179,2178,617,36,188,224,3.5242718446601944,44.0586318741473
Task_21180,2615,131,125,195,320,19.810606060606062,49.27191720555103
Task_21181,1198,452,29,72,101,2.644591611479029,26.591500439800217
Task_21182,2276,570,178,142,320,3.9859894921190895,45.817706153274436
Task_21183,1245,911,60,170,230,1.3651315789473684,30.241764364810177
Task_21184,1064,933,179,134,313,1.139186295503212,27.627931694087888
Task_21185,1307,665,22,80,102,1.9624624624624625,29.052991638975353
Task_21186,2394,210,112,194,306,11.345971563981042,46.479605359494265
Task_21187,2948,324,99,133,232,9.070769230769232,55.23274930836315
Task_21188,1975,671,200,177,377,2.9389880952380953,41.678324290634556
Task_21189,722,832,48,177,225,0.8667466986794717,21.605972491076074
Task_21190,1502,244,132,133,265,6.130612244897959,32.24248119767396
Task_21191,1988,177,171,150,321,11.168539325842696,39.53439410211784
Task_21192,1501,766,123,37,160,1.9569752281616688,32.34056808325585
Task_21193,877,493,118,123,241,1.7753036437246963,23.02634905982565
Task_21194,1067,387,192,167,359,2.75,26.30869329571961
Task_21195,1091,602,155,131,286,1.8092868988391377,26.983640917084774
Task_21196,588,647,105,170,275,0.9074074074074074,19.09665567700868
Task_21197,2742,461,118,44,162,5.935064935064935,51.01819665004547
Task_21198,2686,245,70,31,101,10.91869918699187,48.98512598984268
Task_21199,2398,744,180,30,210,3.2187919463087247,46.980371056805616
Task_21200,1466,796,168,114,282,1.8393977415307403,33.48539199168567
Task_21201,2626,157,137,199,336,16.620253164556964,49.781587033913496
Task_21202,957,389,160,161,321,2.453846153846154,24.394538096340217
Task_21203,2796,93,26,172,198,29.74468085106383,51.00817941517704
Task_21204,2427,531,89,189,278,4.56203007518797,48.0033755702847
Task_21205,1660,338,166,119,285,4.896755162241888,35.126935255327865
Task_21206,2701,485,40,189,229,5.55761316872428,51.94440348979348
Task_21207,1708,749,31,100,131,2.2773333333333334,36.26969231863259
Task_21208,993,993,124,187,311,0.9989939637826962,26.741725143198806
Task_21209,606,483,99,136,235,1.2520661157024793,18.588970800442294
Task_21210,665,922,196,97,293,0.7204767063921993,21.281382901670266
Task_21211,1141,104,19,32,51,10.866666666666667,23.092686858620954
Task_21212,1840,530,128,31,159,3.465160075329567,36.952168697056145
Task_21213,2885,561,194,176,370,5.133451957295374,55.70758317689674
Task_21214,1282,121,10,104,114,10.508196721311476,26.551980816726658
Task_21215,1507,372,74,100,174,4.040214477211796,32.35579709264254
Task_21216,2011,236,56,115,171,8.485232067510548,39.76534430242962
Task_21217,2522,866,34,104,138,2.908881199538639,49.47507917003574
Task_21218,2100,124,116,188,304,16.8,41.04529298409702
Task_21219,524,973,79,110,189,0.5379876796714579,18.826068288642396
Task_21220,2349,686,195,85,280,3.4192139737991267,46.802744986021075
Task_21221,2389,148,53,48,101,16.033557046979865,43.39403233404145
Task_21222,958,378,158,159,317,2.5277044854881265,24.354448170299836
Task_21223,1224,497,70,132,202,2.4578313253012047,28.523560344019753
Task_21224,2699,318,68,79,147,8.460815047021944,50.45905154562053
Task_21225,1910,607,152,170,322,3.1414473684210527,40.18907876263302
Task_21226,2554,647,107,134,241,3.941358024691358,50.09728247439555
Task_21227,1340,294,28,34,62,4.5423728813559325,27.21224966821393
Task_21228,2219,87,72,26,98,25.21590909090909,40.02827166257118
Task_21229,2158,411,114,73,187,5.237864077669903,42.2815246749653
Task_21230,1916,69,26,85,111,27.37142857142857,35.94245881905433
Task_21231,2631,543,79,195,274,4.836397058823529,51.35364575710394
Task_21232,2439,359,114,41,155,6.775,45.82999833480887
Task_21233,2471,1006,146,175,321,2.4538232373386295,50.328840726214935
Task_21234,2993,831,70,66,136,3.597355769230769,56.545709199647895
Task_21235,2410,490,185,69,254,4.908350305498982,46.80803175828501
Task_21236,1873,88,176,41,217,21.04494382022472,35.69607326666499
Task_21237,1522,798,163,83,246,1.9048811013767208,33.87777250238545
Task_21238,1819,149,69,106,175,12.126666666666667,36.12586031398659
Task_21239,825,982,82,91,173,0.8392675483214649,23.113226929302794
Task_21240,2310,342,37,162,199,6.73469387755102,45.116527122923976
Task_21241,2009,928,121,27,148,2.16254036598493,40.785969489462566
Task_21242,2517,925,83,67,150,2.7181425485961124,49.16869782032594
Task_21243,1167,189,54,43,97,6.1421052631578945,24.788598069277356
Task_21244,613,731,73,54,127,0.837431693989071,18.404637057751277
Task_21245,1842,532,78,116,194,3.455909943714822,38.34945248770109
Task_21246,555,322,123,63,186,1.7182662538699691,16.45091994701043
Task_21247,1744,222,166,124,290,7.820627802690583,36.08648758832672
Task_21248,1148,657,160,49,209,1.7446808510638299,26.954168955744894
Task_21249,1023,340,67,132,199,3.0,24.812030013598676
Task_21250,1538,657,31,131,162,2.337386018237082,33.443670169641145
Task_21251,1604,819,130,172,302,1.9560975609756097,35.91851559808364
Task_21252,2654,474,154,51,205,5.5873684210526315,50.37526021720157
Task_21253,2109,354,74,51,125,5.940845070422535,40.81575057029155
Task_21254,2447,890,186,132,318,2.7463524130190797,49.51022333479752
Task_21255,1159,717,111,141,252,1.6142061281337048,28.26704825232513
Task_21256,2191,624,26,72,98,3.5056,42.764710377718075
Task_21257,914,147,13,25,38,6.175675675675675,19.676420145446894
Task_21258,1116,910,164,117,281,1.2250274423710208,28.17040408957654
Task_21259,2460,427,160,126,286,5.747663551401869,48.092237850948095
Task_21260,2484,329,154,147,301,7.527272727272727,48.24192261551388
Task_21261,2892,126,53,47,100,22.771653543307085,51.04258604448565
Task_21262,864,613,193,116,309,1.4071661237785016,23.43625417397013
Task_21263,2695,253,190,116,306,10.61023622047244,51.283787206189025
Task_21264,2777,498,200,45,245,5.565130260521042,52.30072972319267
Task_21265,1814,602,100,155,255,3.0082918739635156,38.32900998386386
Task_21266,1019,706,103,34,137,1.4413012729844412,24.428401819593265
Task_21267,672,317,20,137,157,2.1132075471698113,18.54966843200759
Task_21268,2034,535,36,82,118,3.794776119402985,40.48174735021162
Task_21269,1188,283,95,111,206,4.183098591549296,27.18414200149698
Task_21270,2830,66,106,187,293,42.23880597014925,51.818590599223455
Task_21271,2331,263,51,41,92,8.829545454545455,43.3101660486393
Task_21272,2102,536,26,56,82,3.914338919925512,40.76691696454848
Task_21273,2561,399,44,114,158,6.4025,48.703955811867694
Task_21274,1450,786,37,179,216,1.8424396442185516,33.018602181313035
Task_21275,2572,986,68,47,115,2.6058763931104356,49.719667901105254
Task_21276,2162,716,194,171,365,3.01534170153417,44.718974870337455
Task_21277,1130,797,30,189,219,1.4160401002506267,27.91982190464563
Task_21278,1014,856,24,84,108,1.1831971995332555,25.103730661346095
Task_21279,1924,647,22,131,153,2.9691358024691357,39.33749840299837
Task_21280,2069,388,67,130,197,5.318766066838046,41.503656765208035
Task_21281,2793,735,127,199,326,3.7948369565217392,54.63981417688306
Task_21282,976,487,151,115,266,2.0,24.689148854899013
Task_21283,2852,796,147,158,305,3.5784190715181934,55.61197634693175
Task_21284,959,168,138,69,207,5.674556213017752,22.43286208723175
Task_21285,591,946,43,134,177,0.6240760295670539,19.515657671948393
Task_21286,718,242,74,143,217,2.954732510288066,19.780057731282948
Task_21287,1727,417,177,55,232,4.131578947368421,35.6861686683966
Task_21288,1173,734,157,46,203,1.5959183673469388,27.507282985418787
Task_21289,2167,242,136,177,313,8.91769547325103,43.022031247771366
Task_21290,652,191,70,178,248,3.3958333333333335,18.750139377640327
Task_21291,1261,385,167,121,288,3.266839378238342,28.984349781412728
Task_21292,1376,774,142,168,310,1.7754838709677419,32.18301942738435
Task_21293,1161,335,50,82,132,3.455357142857143,26.326290016247025
Task_21294,1762,680,26,148,174,2.5873715124816448,37.35458400768602
Task_21295,1916,479,105,166,271,3.9916666666666667,39.6414895946023
Task_21296,1474,227,138,42,180,6.464912280701754,30.352122210332713
Task_21297,1721,597,50,140,190,2.8779264214046822,36.70363411823107
Task_21298,1833,1024,109,102,211,1.7882926829268293,39.67144035784223
Task_21299,2088,630,131,75,206,3.3090332805071316,42.054433278045686
Task_21300,648,807,93,139,232,0.801980198019802,20.443476342004303
Task_21301,1501,930,184,121,305,1.6122448979591837,34.55677114182779
Task_21302,2833,186,87,63,150,15.149732620320856,51.957213194778184
Task_21303,612,821,101,27,128,0.7445255474452555,18.388030663058874
Task_21304,1130,978,158,197,355,1.1542390194075587,29.094680578201235
Task_21305,2350,597,180,113,293,3.9297658862876252,46.91127136504713
Task_21306,2665,309,196,114,310,8.596774193548388,51.02692585300591
Task_21307,1355,427,78,16,94,3.1658878504672896,28.395699834383496
Task_21308,1555,233,20,47,67,6.645299145299146,30.44113406394192
Task_21309,1570,474,30,27,57,3.305263157894737,31.48046987092826
Task_21310,769,724,170,135,305,1.0606896551724139,22.21750180043075
Task_21311,920,164,137,190,327,5.575757575757576,22.846295879318035
Task_21312,2494,116,158,138,296,21.316239316239315,47.00348195347803
Task_21313,2919,813,142,167,309,3.585995085995086,56.75816653176425
Task_21314,793,700,144,119,263,1.1312410841654779,22.358105785939742
Task_21315,1806,990,184,187,371,1.822401614530777,39.98377578113833
Task_21316,2996,93,33,17,50,31.872340425531913,51.784714483040375
Task_21317,2755,952,39,36,75,2.8908709338929697,51.68711790180884
Task_21318,2296,949,82,141,223,2.4168421052631577,46.97902280686375
Task_21319,1962,634,118,45,163,3.089763779527559,39.30828899599198
Task_21320,778,134,101,146,247,5.762962962962963,19.960822554862784
Task_21321,502,647,118,172,290,0.7746913580246914,17.820922897885932
Task_21322,2235,561,191,43,234,3.9768683274021353,43.91085274484146
Task_21323,629,839,74,152,226,0.7488095238095238,20.179962724238596
Task_21324,2364,631,34,63,97,3.740506329113924,45.47377274619674
Task_21325,1340,698,179,40,219,1.9170243204577968,30.106799823047098
Task_21326,676,759,45,105,150,0.8894736842105263,19.768126667272742
Task_21327,1413,373,56,85,141,3.77807486631016,30.31795542809088
Task_21328,792,832,89,67,156,0.9507803121248499,21.549997851615043
Task_21329,2754,908,130,92,222,3.0297029702970297,53.83896737484568
Task_21330,1467,529,170,152,322,2.767924528301887,32.90148160473003
Task_21331,2432,522,95,133,228,4.6500956022944555,47.77651190730251
Task_21332,2254,237,65,158,223,9.470588235294118,44.06984818599815
Task_21333,2899,169,168,111,279,17.05294117647059,53.761890533741685
Task_21334,2341,148,193,33,226,15.711409395973154,43.90448757942312
Task_21335,2047,207,108,189,297,9.841346153846153,40.94179364272545
Task_21336,1729,805,51,96,147,2.1451612903225805,37.002476037772354
Task_21337,2405,121,155,127,282,19.71311475409836,45.639771249307984
Task_21338,2684,81,184,46,230,32.73170731707317,48.37338135848597
Task_21339,2476,942,81,155,236,2.625662778366914,49.899883553241544
Task_21340,1487,702,197,53,250,2.1152204836415365,32.88400283444571
Task_21341,2535,156,90,147,237,16.146496815286625,47.868494531204874
Task_21342,921,257,167,105,272,3.5697674418604652,23.097014807740596
Task_21343,2296,114,136,184,320,19.965217391304346,44.03470495797342
Task_21344,2544,709,13,185,198,3.583098591549296,50.07189221408665
Task_21345,1386,677,94,44,138,2.0442477876106193,30.19667040705508
Task_21346,2260,723,132,136,268,3.1215469613259668,45.804890519230106
Task_21347,2668,1022,120,78,198,2.6080156402737047,52.50625114563755
Task_21348,2935,1013,146,189,335,2.8944773175542404,57.787378717175784
Task_21349,1004,649,153,113,266,1.5446153846153847,25.593044113067936
Task_21350,1253,800,78,184,262,1.564294631710362,30.227318464400792
Task_21351,780,613,173,115,288,1.270358306188925,21.986128674081744
Task_21352,2873,171,127,95,222,16.703488372093023,52.933036733636676
Task_21353,2093,555,170,140,310,3.764388489208633,42.82417386683672
Task_21354,2406,1000,200,53,253,2.4035964035964037,48.387350589717194
Task_21355,2797,828,113,149,262,3.37394451145959,54.63416014795566
Task_21356,678,564,81,178,259,1.2,20.280352871454237
Task_21357,1734,783,62,93,155,2.211734693877551,36.86181679347856
Task_21358,807,337,131,185,316,2.3875739644970415,21.868889370048663
Task_21359,2379,585,118,30,148,4.059726962457338,45.632345112234766
Task_21360,2038,359,138,116,254,5.661111111111111,41.03149607714667
Task_21361,759,855,46,132,178,0.8866822429906542,21.709689432108835
Task_21362,999,220,12,113,125,4.520361990950226,23.334390694992475
Task_21363,2025,546,104,94,198,3.7020109689213894,41.09103620346904
Task_21364,1475,565,139,152,291,2.606007067137809,33.00192963852693
Task_21365,1203,556,186,26,212,2.1597845601436267,27.418699372573226
Task_21366,1064,605,182,160,342,1.7557755775577557,26.846895464271757
Task_21367,786,700,124,179,303,1.1212553495007134,22.445715432608065
Task_21368,1108,418,167,187,354,2.6443914081145583,27.062850793893574
Task_21369,2980,668,70,111,181,4.45440956651719,56.56528784213925
Task_21370,2634,500,28,120,148,5.25748502994012,50.17412663878179
Task_21371,644,127,196,101,297,5.03125,17.97240517325012
Task_21372,546,235,189,193,382,2.3135593220338984,17.72537050656411
Task_21373,2712,536,96,92,188,5.050279329608938,51.854178388908245
Task_21374,1332,138,162,152,314,9.582733812949641,29.070186052933423
Task_21375,2574,830,122,11,133,3.0974729241877257,49.332794628675856
Task_21376,532,749,75,167,242,0.7093333333333334,18.61404994090155
Task_21377,1348,826,33,47,80,1.629987908101572,29.408445815746493
Task_21378,826,332,44,33,77,2.4804804804804803,19.203855921246962
Task_21379,2080,64,191,102,293,32.0,39.90716576584048
Task_21380,1667,915,194,170,364,1.8198689956331877,37.49176305777949
Task_21381,1017,992,81,90,171,1.0241691842900302,25.961581506087185
Task_21382,2502,542,23,71,94,4.607734806629834,47.47658343976795
Task_21383,2758,492,185,140,325,5.594320486815416,53.21795966882729
Task_21384,826,619,196,36,232,1.332258064516129,21.804043598159637
Task_21385,2726,529,56,104,160,5.143396226415095,51.86868701842598
Task_21386,1446,582,105,72,177,2.4802744425385934,31.350779363235564
Task_21387,2638,916,132,126,258,2.876772082878953,52.33870132165445
Task_21388,1595,108,93,33,126,14.63302752293578,30.975432987170468
Task_21389,2867,126,142,83,225,22.5748031496063,52.42126644711089
Task_21390,751,450,180,135,315,1.665188470066519,21.248243543775715
Task_21391,1871,762,40,148,188,2.4521625163826997,39.39689370253204
Task_21392,1349,749,193,163,356,1.7986666666666666,31.890895515346998
Task_21393,2648,982,68,180,248,2.693794506612411,52.85949373148326
Task_21394,2318,78,93,23,116,29.341772151898734,41.77202333177654
Task_21395,1522,67,46,198,244,22.38235294117647,31.139349833216162
Task_21396,1299,532,87,173,260,2.4371482176360226,30.01083948577993
Task_21397,892,710,164,88,252,1.2545710267229255,23.57611056477283
Task_21398,1183,749,73,154,227,1.5773333333333333,28.754414283601793
Task_21399,2031,513,198,57,255,3.9513618677042803,40.839144143396645
Task_21400,2125,350,86,165,251,6.054131054131054,42.47804263174174
Task_21401,1847,535,34,51,85,3.4458955223880596,36.70802262492667
Task_21402,1525,900,125,66,191,1.6925638179800222,33.78951369227725
Task_21403,1096,743,91,178,269,1.4731182795698925,27.493626943369417
Task_21404,1512,830,19,18,37,1.8194945848375452,31.13591531424449
Task_21405,901,334,128,149,277,2.68955223880597,23.117461204375587
Task_21406,1405,483,15,23,38,2.902892561983471,28.66842886212994
Task_21407,2034,691,165,155,320,2.939306358381503,42.38657894617131
Task_21408,1238,624,78,194,272,1.9808,29.54039413309674
Task_21409,2415,668,199,145,344,3.609865470852018,48.44251318214805
Task_21410,1888,977,46,139,185,1.9304703476482619,40.23853052219013
Task_21411,2407,582,138,73,211,4.128644939965695,46.93110613394208
Task_21412,2594,761,13,39,52,3.404199475065617,48.643673881343595
Task_21413,2522,417,159,188,347,6.033492822966507,49.40629191832907
Task_21414,2564,67,30,95,125,37.705882352941174,46.29175921615235
Task_21415,1423,405,28,67,95,3.5049261083743843,29.865419125513085
Task_21416,2798,199,58,10,68,13.99,49.60587851843101
Task_21417,1091,805,170,83,253,1.3535980148883375,27.066301738771177
Task_21418,1666,115,19,12,31,14.362068965517242,31.17709942075389
Task_21419,946,108,157,132,289,8.678899082568808,22.40807332574425
Task_21420,1212,916,62,123,185,1.321701199563795,29.35929707228961
Task_21421,757,491,170,123,293,1.5386178861788617,21.325465086678182
Task_21422,2792,195,118,25,143,14.244897959183673,50.72536603412312
Task_21423,1081,525,45,98,143,2.055133079847909,25.61034388117886
Task_21424,2969,726,180,46,226,4.083906464924347,56.01955212119364
Task_21425,2171,137,176,171,347,15.731884057971014,42.4649939669246
Task_21426,1406,65,164,99,263,21.303030303030305,29.259856716475223
Task_21427,2692,363,178,76,254,7.395604395604396,50.97067661414983
Task_21428,1354,725,49,10,59,1.8650137741046833,28.578559728115753
Task_21429,890,397,147,90,237,2.236180904522613,22.71229189707223
Task_21430,633,701,84,94,178,0.9017094017094017,19.122854747454685
Task_21431,2824,367,145,188,333,7.673913043478261,53.954150854264356
Task_21432,1559,552,181,33,214,2.819168173598553,33.09893576743921
Task_21433,2557,180,157,51,208,14.12707182320442,47.59747493244905
Task_21434,2035,449,97,187,284,4.522222222222222,41.54160409479844
Task_21435,2871,527,97,125,222,5.4375,54.65803106010261
Task_21436,2125,826,86,80,166,2.569528415961306,43.05039918706256
Task_21437,1790,366,67,19,86,4.877384196185286,34.819719038592005
Task_21438,879,289,177,79,256,3.0310344827586206,22.134622411523893
Task_21439,2983,400,89,146,235,7.438902743142145,56.1180625944524
Task_21440,1691,591,40,75,115,2.856418918918919,35.16967540433065
Task_21441,1431,828,189,36,225,1.7261761158021713,31.97321276487995
Task_21442,1588,637,183,116,299,2.489028213166144,35.00098008307162
Task_21443,2509,186,131,68,199,13.417112299465241,47.33389817999435
Task_21444,2396,680,66,167,233,3.518355359765051,47.83407639633708
Task_21445,2583,784,48,27,75,3.2904458598726114,48.46268628786922
Task_21446,2862,160,41,128,169,17.77639751552795,52.39393945989129
Task_21447,2523,705,109,149,258,3.5736543909348444,49.88830961470516
Task_21448,2520,359,181,127,308,7.0,48.9157785950556
Task_21449,2059,558,170,57,227,3.6833631484794274,41.29971792689699
Task_21450,679,152,54,78,132,4.437908496732026,17.53192450227701
Task_21451,2709,669,198,77,275,4.043283582089552,52.33312724173376
Task_21452,2237,441,107,147,254,5.0610859728506785,44.49526329210605
Task_21453,2706,591,92,28,120,4.570945945945946,50.641294866550616
Task_21454,1183,667,70,52,122,1.7709580838323353,27.110799796689097
Task_21455,1130,864,188,64,252,1.30635838150289,27.694918714788628
Task_21456,2534,479,35,72,107,5.279166666666667,47.88933794731838
Task_21457,710,555,141,82,223,1.276978417266187,20.108911066548828
Task_21458,1626,112,168,162,330,14.389380530973451,33.36324329112424
Task_21459,1691,633,190,137,327,2.667192429022082,36.77672051516614
Task_21460,1197,145,106,90,196,8.198630136986301,26.27583700661424
Task_21461,2843,329,160,152,312,8.615151515151515,53.976436925419215
Task_21462,1392,693,50,12,62,2.005763688760807,29.12002248540992
Task_21463,2816,998,65,55,120,2.818818818818819,53.92634970213697
Task_21464,911,383,17,39,56,2.3723958333333335,20.686826100463197
Task_21465,2741,742,140,163,303,3.6890982503364738,53.6817079805352
Task_21466,1285,961,114,187,301,1.3357588357588357,31.281805299884322
Task_21467,2100,535,147,165,312,3.917910447761194,42.91694906483304
Task_21468,875,762,129,162,291,1.146788990825688,24.045738603613
Task_21469,1734,302,150,176,326,5.7227722772277225,36.44540547509043
Task_21470,590,516,21,147,168,1.1411992263056092,17.922255992067267
Task_21471,539,277,161,67,228,1.9388489208633093,16.42965780768913
Task_21472,1955,660,131,186,317,2.957639939485628,41.069714497590375
Task_21473,759,705,121,43,164,1.075070821529745,20.531745441207033
Task_21474,2579,376,155,71,226,6.840848806366048,49.01898927684857
Task_21475,1040,978,108,162,270,1.062308478038815,27.179279622301507
Task_21476,1823,754,36,23,59,2.414569536423841,36.26363634062726
Task_21477,1373,710,76,69,145,1.9310829817158932,30.536198564939962
Task_21478,2992,617,76,139,215,4.841423948220065,56.967086353569535
Task_21479,2314,589,54,99,153,3.922033898305085,45.45888129636742
Task_21480,2575,232,13,106,119,11.051502145922747,48.192383878142266
Task_21481,2459,584,82,139,221,4.203418803418804,48.40204669826712
Task_21482,2192,760,108,147,255,2.8804204993429696,44.801342486055795
Task_21483,2893,874,54,166,220,3.3062857142857145,56.294249386106266
Task_21484,2258,835,175,62,237,2.700956937799043,45.38336889953956
Task_21485,569,265,20,97,117,2.1390977443609023,16.5308785475294
Task_21486,2924,515,74,172,246,5.666666666666667,55.743444537839515
Task_21487,1329,310,184,196,380,4.273311897106109,30.34110684670725
Task_21488,2852,472,20,101,121,6.029598308668076,53.352316987703425
Task_21489,556,123,71,104,175,4.483870967741935,16.081195198754017
Task_21490,1995,209,185,77,262,9.5,39.447902974034456
Task_21491,2359,468,68,87,155,5.029850746268656,45.61498625638868
Task_21492,1087,86,42,74,116,12.494252873563218,23.083398375678968
Task_21493,1898,90,196,15,211,20.857142857142858,36.009823617232634
Task_21494,2750,736,22,80,102,3.7313432835820897,52.133477595957224
Task_21495,2560,657,64,49,113,3.8905775075987843,48.45593301920468
Task_21496,2171,405,136,69,205,5.347290640394089,42.52766014674395
Task_21497,2380,579,167,77,244,4.103448275862069,46.69681981192192
Task_21498,1634,101,13,177,190,16.019607843137255,32.83564385380044
Task_21499,2784,293,23,68,91,9.46938775510204,51.01081760882562
Task_21500,2774,641,65,37,102,4.320872274143302,51.57680255260528
Task_21501,2039,757,85,106,191,2.6899736147757256,42.06687456195267
Task_21502,769,283,138,151,289,2.7077464788732395,20.923458292560838
Task_21503,914,697,48,87,135,1.3094555873925502,23.38167516144742
Task_21504,904,144,133,162,295,6.23448275862069,22.351559376629478
Task_21505,1556,941,36,165,201,1.6518046709129512,35.06710469895832
Task_21506,2313,320,44,44,88,7.205607476635514,43.11548283285555
Task_21507,2217,654,28,82,110,3.384732824427481,43.64765296120988
Task_21508,1473,685,78,13,91,2.1472303206997085,31.018747636343733
Task_21509,2967,925,55,75,130,3.2041036717062634,56.62792234175583
Task_21510,1516,444,105,105,210,3.406741573033708,32.83359901515586
Task_21511,842,87,46,52,98,9.568181818181818,18.73225517589617
Task_21512,2676,151,48,56,104,17.605263157894736,48.244147954081576
Task_21513,1865,853,102,111,213,2.1838407494145198,39.669129445927275
Task_21514,1773,227,129,57,186,7.776315789473684,35.352324120790506
Task_21515,2228,784,96,109,205,2.838216560509554,45.21867082717521
Task_21516,2033,667,118,182,300,3.0434131736526946,42.24470458181266
Task_21517,1546,388,146,171,317,3.974293059125964,33.707327500268775
Task_21518,1042,778,147,134,281,1.337612323491656,26.696484176869195
Task_21519,2480,709,36,73,109,3.492957746478873,47.85954917204165
Task_21520,2183,947,10,112,122,2.3027426160337554,44.32641010643838
Task_21521,681,729,177,48,225,0.9328767123287671,19.89263923521916
Task_21522,2973,924,198,58,256,3.214054054054054,57.05145258917141
Task_21523,1984,502,69,54,123,3.944333996023857,39.28203698341749
Task_21524,2783,281,76,34,110,9.868794326241135,50.71056172893986
Task_21525,2499,822,158,47,205,3.0364520048602675,48.79010020794322
Task_21526,2105,493,99,47,146,4.261133603238866,41.0054914163679
Task_21527,1789,779,190,47,237,2.2935897435897434,37.551210408317026
Task_21528,1096,825,154,25,179,1.3268765133171914,26.232866390194513
Task_21529,2084,515,152,79,231,4.038759689922481,41.81576813405882
Task_21530,1438,711,59,81,140,2.019662921348315,31.742936093172478
Task_21531,2576,213,54,10,64,12.037383177570094,46.1649484226294
Task_21532,2646,392,180,117,297,6.732824427480916,50.955947051709096
Task_21533,2241,901,54,168,222,2.484478935698448,46.059643462998764
Task_21534,1816,163,10,34,44,11.073170731707316,34.14418499810302
Task_21535,2192,391,46,47,93,5.591836734693878,41.563221568978555
Task_21536,2004,478,126,18,144,4.1837160751565765,39.0626679535739
Task_21537,2062,812,122,99,221,2.5362853628536284,42.666121767668834
Task_21538,1323,660,189,191,380,2.0015128593040847,31.350770895293635
Task_21539,1599,465,95,198,293,3.4313304721030042,34.79495453130335
Task_21540,2571,364,41,73,114,7.043835616438356,48.33864866157677
Task_21541,1109,701,81,82,163,1.5797720797720798,26.59486037074549
Task_21542,1732,989,79,174,253,1.7494949494949494,38.374400205741836
Task_21543,2718,283,123,116,239,9.570422535211268,51.45529191371613
Task_21544,2952,673,23,174,197,4.379821958456973,56.440223968253285
Task_21545,878,147,102,108,210,5.9324324324324325,21.44833885616393
Task_21546,2649,437,137,132,269,6.0479452054794525,51.0485036055044
Task_21547,2986,549,132,88,220,5.429090909090909,56.21115143657133
Task_21548,1272,929,184,131,315,1.367741935483871,30.93676478043454
Task_21549,1459,312,81,33,114,4.661341853035144,29.942391940138034
Task_21550,2882,877,80,45,125,3.28246013667426,54.343718819708975
Task_21551,2652,350,120,113,233,7.555555555555555,50.61468608027449
Task_21552,2526,365,77,19,96,6.901639344262295,46.64367196615388
Task_21553,2534,953,164,199,363,2.6561844863731654,51.386489685860546
Task_21554,2240,823,148,28,176,2.7184466019417477,44.359764007192275
Task_21555,2096,874,123,18,141,2.3954285714285715,41.7343060072423
Task_21556,2799,111,83,71,154,24.991071428571427,50.04370658951853
Task_21557,1648,107,154,162,316,15.25925925925926,33.58798789031221
Task_21558,724,765,120,43,163,0.9451697127937336,20.236614035408994
Task_21559,2698,553,191,95,286,4.870036101083032,52.195322001964456
Task_21560,504,942,44,48,92,0.5344644750795334,16.610636985391718
Task_21561,1385,753,162,31,193,1.836870026525199,30.875530765531803
Task_21562,855,976,91,91,182,0.8751279426816786,23.475490803865657
Task_21563,1060,749,68,123,191,1.4133333333333333,26.562801341198664
Task_21564,907,443,101,90,191,2.0427927927927927,22.917182260112742
Task_21565,892,342,85,96,181,2.6005830903790086,22.38682157641556
Task_21566,2579,458,137,78,215,5.618736383442266,49.38913761942353
Task_21567,2616,463,15,73,88,5.637931034482759,48.94721392596902
Task_21568,1600,934,107,97,204,1.7112299465240641,35.68113912475301
Task_21569,877,327,101,47,148,2.673780487804878,20.999834684040547
Task_21570,1509,512,179,32,211,2.9415204678362574,32.166535939683214
Task_21571,1878,802,78,178,256,2.3387297633872977,40.138792667111126
Task_21572,2756,874,49,127,176,3.149714285714286,53.71353695113677
Task_21573,2511,912,164,175,339,2.750273822562979,50.75072059280971
Task_21574,2457,910,37,40,77,2.6970362239297474,46.835402724703634
Task_21575,2907,609,145,106,251,4.7655737704918035,55.57102322170564
Task_21576,2230,958,99,96,195,2.3253388946819604,45.69993936557719
Task_21577,1904,293,92,65,157,6.476190476190476,37.51294049621366
Task_21578,1471,607,30,90,120,2.419407894736842,31.84465588727359
Task_21579,2259,583,43,33,76,3.868150684931507,42.684561414117674
Task_21580,1917,68,110,149,259,27.782608695652176,37.26099170283583
Task_21581,532,659,183,154,337,0.806060606060606,18.502802450200118
Task_21582,869,563,187,195,382,1.5407801418439717,23.83016637446849
Task_21583,2955,113,50,110,160,25.92105263157895,53.23169267359119
Task_21584,2886,458,22,122,144,6.287581699346405,53.96172474263361
Task_21585,809,885,152,180,332,0.9130925507900677,23.6029291467475
Task_21586,2976,837,84,58,142,3.551312649164678,56.06804663890616
Task_21587,1742,492,38,29,67,3.5334685598377282,34.21245171503927
Task_21588,711,725,64,168,232,0.9793388429752066,21.14878031431994
Task_21589,2198,576,199,165,364,3.8093587521663776,44.8336700870434
Task_21590,2051,107,113,163,276,18.99074074074074,39.74311782444948
Task_21591,711,456,41,180,221,1.5557986870897156,20.26293464752314
Task_21592,1051,201,133,110,243,5.202970297029703,24.837861433394824
Task_21593,2010,725,200,13,213,2.768595041322314,40.62109944847827
Task_21594,2610,811,180,150,330,3.2142857142857144,51.92599954922014
Task_21595,537,969,200,83,283,0.5536082474226804,19.064216909018377
Task_21596,1840,426,177,76,253,4.309133489461359,37.69343497759679
Task_21597,1336,679,159,96,255,1.964705882352941,30.936954092172105
Task_21598,1144,862,133,187,320,1.3256083429895713,28.82648057818616
Task_21599,1364,451,112,180,292,3.017699115044248,30.929632817228338
Task_21600,2191,417,130,109,239,5.241626794258373,43.565612684599735
Task_21601,2738,450,173,68,241,6.070953436807096,51.83923478865077
Task_21602,1908,628,150,162,312,3.0333863275039747,40.16684083861064
Task_21603,1151,831,178,126,304,1.3834134615384615,28.65181193816738
Task_21604,1852,93,16,17,33,19.70212765957447,33.45762831781345
Task_21605,2615,998,144,20,164,2.6176176176176176,50.700731860104405
Task_21606,1315,859,142,19,161,1.5290697674418605,29.435223456614754
Task_21607,2506,453,114,33,147,5.5198237885462555,47.23068470651143
Task_21608,1311,786,57,79,136,1.6658195679796697,30.002488083333002
Task_21609,2432,831,29,48,77,2.923076923076923,46.265278428450536
Task_21610,1610,319,15,141,156,5.03125,33.45795871565365
Task_21611,2749,506,117,159,276,5.422090729783037,52.92796827214952
Task_21612,1416,900,85,158,243,1.5715871254162042,32.908163526997555
Task_21613,1673,610,110,46,156,2.738134206219313,34.51176249233382
Task_21614,811,340,101,72,173,2.378299120234604,20.622325538040997
Task_21615,827,67,188,130,318,12.161764705882353,20.466262219757407
Task_21616,2577,291,84,44,128,8.825342465753424,47.76584599670465
Task_21617,1740,857,133,194,327,2.027972027972028,38.336513903782155
Task_21618,2147,669,171,165,336,3.2044776119402987,44.194009728400545
Task_21619,767,518,117,20,137,1.4778420038535645,19.657893022774736
Task_21620,2422,867,197,177,374,2.7903225806451615,49.360587934470175
Task_21621,1133,204,13,133,146,5.5268292682926825,25.503695747970827
Task_21622,2458,797,195,169,364,3.080200501253133,49.65500554258242
Task_21623,2792,875,172,61,233,3.1872146118721463,53.913755800755276
Task_21624,2004,1011,184,135,319,1.9802371541501975,42.876109558265796
Task_21625,1160,72,114,12,126,15.89041095890411,23.435617752701365
Task_21626,2784,568,190,10,200,4.8927943760984185,52.327889725297695
Task_21627,1799,646,75,83,158,2.7805255023183926,37.25761736367764
Task_21628,1884,711,194,71,265,2.646067415730337,39.2664533114429
Task_21629,2493,397,52,62,114,6.263819095477387,47.016733414284715
Task_21630,606,80,199,55,254,7.481481481481482,16.253834326556802
Task_21631,1828,370,196,165,361,4.92722371967655,38.299783556953564
Task_21632,714,551,27,122,149,1.2934782608695652,19.805126102372324
Task_21633,1811,655,168,185,353,2.760670731707317,38.93398781423938
Task_21634,1980,552,177,64,241,3.580470162748644,40.147745271810344
Task_21635,1213,800,20,68,88,1.5143570536828963,27.64009181564357
Task_21636,2661,958,58,174,232,2.7747653806047965,52.942045221079574
Task_21637,1391,902,129,103,232,1.5404208194905868,32.34218843993255
Task_21638,512,1012,167,90,257,0.5054294175715696,18.758337051875372
Task_21639,2024,670,60,41,101,3.0163934426229506,39.71342252176197
Task_21640,1252,114,85,85,170,10.88695652173913,26.450582460611333
Task_21641,823,951,189,180,369,0.8644957983193278,24.190681940026476
Task_21642,1427,945,130,108,238,1.5084566596194504,33.080367034294156
Task_21643,1040,275,69,94,163,3.7681159420289854,24.442233934547186
Task_21644,1013,676,97,104,201,1.4963072378138849,25.537139163115445
Task_21645,1260,1010,27,127,154,1.2462908011869436,29.821213477193027
Task_21646,2668,696,75,12,87,3.8278335724533714,49.91924722079579
Task_21647,814,226,186,106,292,3.5859030837004404,21.39571291862609
Task_21648,1983,518,35,13,48,3.820809248554913,37.84611135967278
Task_21649,1364,812,200,189,389,1.6777367773677736,32.497913751180015
Task_21650,1282,965,103,161,264,1.3271221532091098,31.041779869058658
Task_21651,605,906,105,38,143,0.6670341786108048,18.841933556428764
Task_21652,949,109,18,32,50,8.627272727272727,20.059025416734993
Task_21653,2851,545,126,106,232,5.221611721611722,54.39306584965377
Task_21654,2052,221,10,198,208,9.243243243243244,40.687651649246106
Task_21655,693,92,127,35,162,7.451612903225806,16.705908515185154
Task_21656,2032,553,159,71,230,3.667870036101083,40.9543899648869
Task_21657,2298,406,188,153,341,5.646191646191646,45.746950193463
Task_21658,1587,805,39,137,176,1.968982630272953,34.842626424829874
Task_21659,2420,113,35,51,86,21.228070175438596,43.74814922557212
Task_21660,2907,307,161,153,314,9.438311688311689,54.92151455436522
Task_21661,2136,425,37,127,164,5.014084507042254,42.318022222089965
Task_21662,2356,287,126,31,157,8.180555555555555,44.30677292195826
Task_21663,2406,239,161,39,200,10.025,45.3547305926154
Task_21664,1825,534,84,23,107,3.411214953271028,36.27179029341007
Task_21665,2464,1023,108,190,298,2.40625,50.18915865194856
Task_21666,2394,360,65,88,153,6.631578947368421,45.74923042886842
Task_21667,823,988,181,64,245,0.8321536905965622,23.215045592946932
Task_21668,1739,185,200,42,242,9.349462365591398,34.87484395666274
Task_21669,1605,335,127,117,244,4.776785714285714,34.05942381365684
Task_21670,2623,87,105,178,283,29.806818181818183,48.60830075309087
Task_21671,2165,976,37,75,112,2.21596724667349,43.8028756520989
Task_21672,1652,771,198,173,371,2.139896373056995,36.84186753236037
Task_21673,2085,466,102,85,187,4.464668094218416,41.454542056057576
Task_21674,2559,451,31,165,196,5.661504424778761,49.42457552262156
Task_21675,883,574,95,167,262,1.5356521739130435,23.578439264306315
Task_21676,1527,879,191,132,323,1.7352272727272726,34.90767189761863
Task_21677,2413,540,136,177,313,4.460258780036969,47.910932775848515
Task_21678,1332,968,30,126,156,1.3746130030959753,30.957689453353762
Task_21679,2857,243,11,190,201,11.709016393442623,53.442743720196944
Task_21680,847,483,161,34,195,1.75,21.51443791139347
Task_21681,1321,211,57,198,255,6.231132075471698,29.477137422849612
Task_21682,2255,952,102,192,294,2.366211962224554,46.6410173790066
Task_21683,2542,469,144,44,188,5.408510638297872,48.21775665515354
Task_21684,2206,657,54,87,141,3.3525835866261398,43.789008681270104
Task_21685,2434,815,131,42,173,2.982843137254902,47.51106013022075
Task_21686,2945,99,148,37,185,29.45,52.379086496964696
Task_21687,1763,967,66,14,80,1.8212809917355373,36.214658670791216
Task_21688,2484,600,80,124,204,4.1331114808652245,48.78519419381397
Task_21689,924,529,140,156,296,1.7433962264150944,24.179380647741898
Task_21690,1652,457,65,197,262,3.606986899563319,35.52232007971463
Task_21691,2522,1019,76,104,180,2.4725490196078432,50.39440245516145
Task_21692,2997,209,46,129,175,14.271428571428572,55.278989611463885
Task_21693,2683,679,65,141,206,3.945588235294118,52.21976736533505
Task_21694,1865,607,92,65,157,3.067434210526316,37.91364783992759
Task_21695,2272,93,105,48,153,24.170212765957448,41.374727769252225
Task_21696,1176,759,57,61,118,1.5473684210526315,27.125576648599438
Task_21697,2547,758,167,149,316,3.355731225296443,50.696855093264446
Task_21698,801,496,17,176,193,1.6116700201207244,21.63171606244588
Task_21699,1495,268,188,27,215,5.557620817843866,31.113189781280123
Task_21700,2674,580,20,189,209,4.602409638554217,51.70120816836636
Task_21701,2107,329,178,50,228,6.384848484848485,41.17166926646083
Task_21702,1361,410,125,109,234,3.3114355231143553,30.385838317868732
Task_21703,2108,119,36,31,67,17.566666666666666,38.43400519193947
Task_21704,1431,354,173,134,307,4.030985915492958,31.678342433230796
Task_21705,1162,409,123,198,321,2.8341463414634145,27.75616567265482
Task_21706,700,540,131,61,192,1.2939001848428835,19.517943155216845
Task_21707,1477,792,149,123,272,1.8625472887767969,33.61533869367141
Task_21708,1630,547,120,166,286,2.9744525547445257,35.39748777755282
Task_21709,780,208,72,68,140,3.7320574162679425,19.495695585452562
Task_21710,2416,931,36,45,81,2.592274678111588,46.68787886276345
Task_21711,560,114,184,47,231,4.869565217391305,15.485769452532367
Task_21712,1560,606,15,127,142,2.57001647446458,33.514778099765444
Task_21713,2127,124,158,46,204,17.016,40.160405110632574
Task_21714,572,452,59,80,139,1.2626931567328918,17.14974274050181
Task_21715,1010,522,177,56,233,1.9311663479923518,24.676098929924024
Task_21716,777,822,93,155,248,0.9441069258809235,22.602376624795294
Task_21717,1446,413,161,37,198,3.4927536231884058,30.808590413806048
Task_21718,2530,754,99,71,170,3.3509933774834435,49.015439900489724
Task_21719,2210,648,166,91,257,3.4052388289676427,44.514959762703235
Task_21720,667,816,121,108,229,0.8164014687882497,20.57276241335509
Task_21721,2866,277,154,96,250,10.309352517985612,53.81675335525039
Task_21722,1310,453,60,89,149,2.8854625550660793,29.006233123174216
Task_21723,578,630,98,121,219,0.9160063391442155,18.568301726571296
Task_21724,2235,290,55,66,121,7.680412371134021,42.665407996905074
Task_21725,1961,715,129,30,159,2.738826815642458,39.46062359433635
Task_21726,1955,994,176,152,328,1.964824120603015,42.11227789338097
Task_21727,2160,906,108,106,214,2.3814773980154356,44.50571111902247
Task_21728,1211,604,39,99,138,2.0016528925619834,27.84818068824356
Task_21729,1683,492,110,119,229,3.413793103448276,35.73634861700484
Task_21730,2623,837,83,129,212,3.1300715990453463,51.70450532115083
Task_21731,778,287,64,31,95,2.701388888888889,18.740038432428523
Task_21732,1872,677,58,99,157,2.7610619469026547,38.77855881523697
Task_21733,1117,964,168,78,246,1.1575129533678756,27.957862732475906
Task_21734,2374,419,72,133,205,5.652380952380953,46.47710547711086
Task_21735,2792,322,81,98,179,8.643962848297214,52.38924367009756
Task_21736,2110,489,111,182,293,4.3061224489795915,42.86728063086273
Task_21737,1204,214,189,53,242,5.6,26.803103907246623
Task_21738,1382,920,28,12,40,1.500542888165038,29.457778029428155
Task_21739,752,692,20,198,218,1.0851370851370852,21.443501151704382
Task_21740,1137,304,108,140,248,3.7278688524590162,26.608566606534414
Task_21741,2826,217,174,162,336,12.963302752293577,53.41669010835682
Task_21742,530,245,136,179,315,2.154471544715447,17.182329204368
Task_21743,1986,298,131,74,205,6.642140468227424,39.36425669007008
Task_21744,2428,450,162,143,305,5.383592017738359,47.7716507937453
Task_21745,1451,950,155,197,352,1.5257623554153523,34.120448834873564
Task_21746,1139,81,151,157,308,13.890243902439025,25.40508319096887
Task_21747,1874,887,41,116,157,2.1103603603603602,39.37182688743672
Task_21748,709,821,146,29,175,0.8625304136253041,20.269494200751073
Task_21749,1202,483,128,155,283,2.4834710743801653,28.389477696299185
Task_21750,1775,188,188,41,229,9.39153439153439,35.46992501022874
Task_21751,2891,886,195,21,216,3.2593010146561445,55.134754268933115
Task_21752,637,888,77,98,175,0.7165354330708661,20.205906051793118
Task_21753,2547,383,54,181,235,6.6328125,49.33291213441976
Task_21754,2863,708,182,62,244,4.038081805359662,54.60026312248933
Task_21755,1674,117,131,176,307,14.186440677966102,34.27409311313435
Task_21756,981,674,170,195,365,1.4533333333333334,25.847312837871257
Task_21757,1509,490,40,60,100,3.0733197556008145,31.316035027781144
Task_21758,1091,881,112,195,307,1.2369614512471656,27.915983134322037
Task_21759,2653,863,144,11,155,3.0706018518518516,50.71340516380721
Task_21760,1927,131,34,76,110,14.598484848484848,36.48353955710819
Task_21761,2038,805,71,174,245,2.5285359801488836,42.623899355775826
Task_21762,1832,904,130,131,261,2.0243093922651934,39.55067398630134
Task_21763,538,407,155,54,209,1.3186274509803921,16.688785675172827
Task_21764,1839,535,189,173,362,3.4309701492537314,39.02151267645414
Task_21765,1995,246,108,107,215,8.076923076923077,39.774868306743606
Task_21766,1521,843,155,130,285,1.802132701421801,34.53995213709398
Task_21767,2687,997,144,147,291,2.6923847695390783,53.54750743804715
Task_21768,1087,357,17,138,155,3.036312849162011,25.190979051136242
Task_21769,1856,774,10,112,122,2.3948387096774195,38.60578356844634
Task_21770,756,842,195,131,326,0.896797153024911,22.538666270164878
Task_21771,1152,316,159,166,325,3.634069400630915,27.270047718873045
Task_21772,1771,862,163,97,260,2.0521436848203938,38.43269638343942
Task_21773,1599,665,40,131,171,2.400900900900901,34.52223663765091
Task_21774,2563,367,68,81,149,6.9646739130434785,48.455582757841945
Task_21775,2929,338,16,40,56,8.640117994100295,52.60804950087373
Task_21776,960,890,48,139,187,1.0774410774410774,25.231242152515218
Task_21777,2404,181,59,89,148,13.208791208791208,45.016117747029234
Task_21778,1560,111,173,199,372,13.928571428571429,32.53037684937386
Task_21779,695,866,88,141,229,0.8016147635524798,21.22730853584635
Task_21780,1285,845,109,89,198,1.5189125295508275,30.12858440877468
Task_21781,1055,882,179,31,210,1.1947904869762174,26.163056463105733
Task_21782,997,1015,11,61,72,0.9812992125984252,24.39112541544488
Task_21783,2594,463,31,90,121,5.5905172413793105,49.19713149867781
Task_21784,1465,931,142,83,225,1.5718884120171674,33.254573674587455
Task_21785,1278,182,35,134,169,6.983606557377049,27.68919169429947
Task_21786,879,322,52,11,63,2.721362229102167,19.7963523174592
Task_21787,795,504,12,111,123,1.5742574257425743,20.89930680600503
Task_21788,653,276,200,30,230,2.357400722021661,17.96423410423441
Task_21789,2338,954,107,176,283,2.4481675392670157,47.88945588295769
Task_21790,1659,231,99,148,247,7.150862068965517,34.61944307213202
Task_21791,2452,497,143,188,331,4.923694779116466,48.487292746297804
Task_21792,1666,708,178,121,299,2.3497884344146684,36.46615385741174
Task_21793,1610,99,112,117,229,16.1,32.51325911796645
Task_21794,1726,849,118,190,308,2.030588235294118,37.99829257216038
Task_21795,2736,1023,125,73,198,2.671875,53.470568696640576
Task_21796,1956,977,50,160,210,2.0,41.74467664357203
Task_21797,1525,432,170,70,240,3.5219399538106235,32.57700908328854
Task_21798,643,311,180,136,316,2.0608974358974357,19.120747794639755
Task_21799,1090,88,182,31,213,12.247191011235955,23.462435200395504
Task_21800,2434,737,39,130,169,3.2981029810298104,47.97452210019882
Task_21801,2537,822,188,89,277,3.0826245443499394,50.28812654919475
Task_21802,1373,309,173,115,288,4.429032258064516,30.500153732319173
Task_21803,2906,745,140,38,178,3.89544235924933,54.725757690360815
Task_21804,2963,378,35,156,191,7.8179419525065965,55.533166344553756
Task_21805,2526,117,26,43,69,21.406779661016948,45.057748458572384
Task_21806,962,954,21,70,91,1.0073298429319373,24.1414113919688
Task_21807,2694,1012,40,136,176,2.6594274432379073,53.026993435372795
Task_21808,2159,1006,35,35,70,2.143992055610725,42.45954477082774
Task_21809,1812,801,45,169,214,2.2593516209476308,38.75697704901281
Task_21810,2903,295,90,81,171,9.807432432432432,53.57656683929894
Task_21811,1029,1017,153,80,233,1.0108055009823183,26.58556728104332
Task_21812,2809,346,115,45,160,8.095100864553315,51.62193154077563
Task_21813,1674,725,14,104,118,2.3057851239669422,35.54694992677066
Task_21814,640,292,140,157,297,2.1843003412969284,18.957932919955738
Task_21815,1314,920,195,79,274,1.4267100977198697,31.01827438710191
Task_21816,531,353,167,21,188,1.5,15.92425621552808
Task_21817,532,139,27,176,203,3.8,16.012616802059988
Task_21818,2964,665,99,108,207,4.45045045045045,56.45869722076304
Task_21819,1120,981,85,13,98,1.140529531568228,26.456831127572745
Task_21820,2009,419,61,89,150,4.783333333333333,39.9174321446686
Task_21821,725,67,112,114,226,10.661764705882353,18.4337717747205
Task_21822,741,221,107,26,133,3.3378378378378377,18.48165300224103
Task_21823,1665,831,68,186,254,2.001201923076923,36.848740466617976
Task_21824,2897,989,129,167,296,2.926262626262626,56.90225715407568
Task_21825,2504,802,103,111,214,3.1183063511830635,49.638388160358055
Task_21826,718,331,175,128,303,2.1626506024096384,20.300043272110152
Task_21827,2709,535,139,140,279,5.05410447761194,52.37410785939486
Task_21828,1767,374,194,181,375,4.712,37.43439809259679
Task_21829,708,607,170,16,186,1.1644736842105263,19.35969759062144
Task_21830,859,569,56,11,67,1.5070175438596491,20.18824254978842
Task_21831,1395,66,131,120,251,20.82089552238806,29.10521592796826
Task_21832,2660,571,94,49,143,4.65034965034965,50.18960808201094
Task_21833,723,998,28,59,87,0.7237237237237237,20.58101421169182
Task_21834,2969,1022,92,137,229,2.9022482893450636,57.87780958682732
Task_21835,2320,639,191,197,388,3.625,47.12066161384013
Task_21836,2619,748,72,63,135,3.4966622162883847,50.34126581353272
Task_21837,1678,907,54,170,224,1.8480176211453745,37.16932199024813
Task_21838,2024,66,41,82,123,30.208955223880597,37.80267232403265
Task_21839,2386,710,33,122,155,3.3558368495077358,46.96844284926258
Task_21840,1779,682,137,175,312,2.604685212298682,38.312423007372125
Task_21841,1009,245,66,199,265,4.1016260162601625,24.67654921770857
Task_21842,2991,868,194,41,235,3.4418872266973533,56.863268359150936
Task_21843,2694,440,65,143,208,6.108843537414966,51.63711569934043
Task_21844,2383,371,47,180,227,6.405913978494624,46.55183319419803
Task_21845,826,210,50,154,204,3.914691943127962,21.39490273099364
Task_21846,2063,296,45,101,146,6.946127946127946,40.40748053437912
Task_21847,1040,855,188,35,223,1.2149532710280373,25.85506639139076
Task_21848,1803,618,50,26,76,2.912762520193861,35.59143282968984
Task_21849,2734,686,115,52,167,3.97962154294032,52.042149900047995
Task_21850,551,232,95,87,182,2.3648068669527897,16.355598698389414
Task_21851,2278,883,151,169,320,2.576923076923077,46.8738067500071
Task_21852,927,69,121,200,321,13.242857142857142,22.143043510501695
Task_21853,1492,118,152,131,283,12.53781512605042,31.252070971729868
Task_21854,909,127,118,136,254,7.1015625,22.00094625409584
Task_21855,2589,509,58,42,100,5.076470588235294,48.170604419886324
Task_21856,2996,429,155,116,271,6.967441860465116,56.499364814265675
Task_21857,1720,146,82,76,158,11.700680272108844,33.73361580992063
Task_21858,611,90,87,43,130,6.714285714285714,15.05377780967101
Task_21859,2459,909,36,24,60,2.7021978021978024,46.832368761884545
Task_21860,1756,819,77,27,104,2.1414634146341465,36.08778526612888
Task_21861,527,339,57,69,126,1.55,15.959903245206553
Task_21862,840,537,174,99,273,1.5613382899628252,22.643066787050277
Task_21863,1879,836,137,115,252,2.2449223416965354,40.01960338174623
Task_21864,1508,424,126,137,263,3.548235294117647,32.92874369813797
Task_21865,2730,817,33,141,174,3.337408312958435,53.11590078039284
Task_21866,737,872,142,173,315,0.8442153493699885,22.321780975573557
Task_21867,2555,944,167,125,292,2.7037037037037037,51.26270261038417
Task_21868,2912,434,124,96,220,6.694252873563219,54.95099008299848
Task_21869,1568,865,178,127,305,1.8106235565819861,35.438771923969405
Task_21870,1656,553,192,59,251,2.9891696750902526,34.987719815266495
Task_21871,686,629,127,164,291,1.0888888888888888,20.580032167311515
Task_21872,2133,164,200,177,377,12.927272727272728,42.17838896301939
Task_21873,1604,175,165,132,297,9.113636363636363,33.35788672583343
Task_21874,2180,76,94,162,256,28.31168831168831,41.489196474350045
Task_21875,2562,901,40,69,109,2.8403547671840355,49.656692041531585
Task_21876,2193,667,115,115,230,3.282934131736527,44.365267130647595
Task_21877,1662,793,161,55,216,2.093198992443325,35.77143176479602
Task_21878,815,338,184,72,256,2.4041297935103243,21.146533563840503
Task_21879,1533,150,180,183,363,10.152317880794701,32.587634049462075
Task_21880,1613,371,37,18,55,4.336021505376344,31.544416534469477
Task_21881,2031,200,187,31,218,10.104477611940299,39.40467381131811
Task_21882,2170,237,101,176,277,9.117647058823529,42.88737394875775
Task_21883,1151,238,126,162,288,4.815899581589958,26.82306868173318
Task_21884,1688,304,128,33,161,5.534426229508196,33.83396218252599
Task_21885,1287,424,128,65,193,3.028235294117647,28.568223732792944
Task_21886,991,512,196,132,328,1.9317738791423003,25.30940887409304
Task_21887,2985,826,90,93,183,3.6094316807738815,56.955215878890016
Task_21888,2524,595,186,81,267,4.23489932885906,49.1732027588946
Task_21889,1931,589,188,195,383,3.272881355932203,40.7763483392499
Task_21890,2384,184,10,91,101,12.886486486486486,44.528365942379224
Task_21891,1423,218,20,122,142,6.497716894977169,30.011694953254032
Task_21892,1629,429,130,190,320,3.7883720930232556,35.19433088740441
Task_21893,2741,105,138,117,255,25.858490566037737,50.412070413551504
Task_21894,2588,352,119,152,271,7.331444759206799,49.83758662128346
Task_21895,1479,713,16,109,125,2.0714285714285716,32.45316256305727
Task_21896,2724,649,114,26,140,4.190769230769231,51.20387386068381
Task_21897,1985,553,145,145,290,3.583032490974729,41.02488712055044
Task_21898,1118,856,199,152,351,1.3045507584597433,28.45790290526881
Task_21899,1908,428,116,66,182,4.4475524475524475,38.14508246044107
Task_21900,1051,535,142,124,266,1.960820895522388,26.040287526320224
Task_21901,1927,224,138,125,263,8.564444444444444,38.86358981891224
Task_21902,1185,1021,43,97,140,1.159491193737769,28.691799330279668
Task_21903,2140,241,32,47,79,8.84297520661157,39.859596301816325
Task_21904,2856,150,198,199,397,18.91390728476821,53.61282907716576
Task_21905,1277,575,27,135,162,2.217013888888889,29.060284620744515
Task_21906,1641,139,76,96,172,11.721428571428572,33.2717518414389
Task_21907,2838,278,24,36,60,10.172043010752688,50.804522010766284
Task_21908,2789,732,150,136,286,3.8049113233287857,54.29434389771355
Task_21909,988,982,188,43,231,1.005086469989827,25.373842042668873
Task_21910,2428,377,55,61,116,6.423280423280423,45.78718384220599
Task_21911,1107,361,18,128,146,3.0580110497237567,25.518302353189664
Task_21912,1942,389,32,13,45,4.97948717948718,36.7807302831909
Task_21913,2581,520,25,123,148,4.953934740882917,49.41169883645469
Task_21914,1740,808,133,136,269,2.150803461063041,37.83745175827701
Task_21915,2649,208,97,141,238,12.674641148325358,50.13705418362341
Task_21916,2762,80,143,124,267,34.098765432098766,50.5959485336972
Task_21917,1859,441,58,109,167,4.205882352941177,38.02899516443151
Task_21918,1867,598,151,179,330,3.1168614357262103,39.52893736746926
Task_21919,1868,720,95,44,139,2.590846047156727,37.9619680536935
Task_21920,1015,245,116,20,136,4.126016260162602,22.712237831653837
Task_21921,2261,588,122,135,257,3.838709677419355,45.34323473585264
Task_21922,1970,867,198,70,268,2.269585253456221,41.119671938533536
Task_21923,2261,177,125,195,320,12.702247191011235,43.90224175115592
Task_21924,1099,693,100,52,152,1.5835734870317002,25.924264851964995
Task_21925,655,676,137,153,290,0.9675036927621861,20.277368544025173
Task_21926,2225,286,168,152,320,7.7526132404181185,44.09063682369509
Task_21927,581,117,169,174,343,4.923728813559322,17.241242915004527
Task_21928,2341,947,54,134,188,2.469409282700422,47.54724086409043
Task_21929,2320,768,95,100,195,3.0169050715214563,46.585044046847166
Task_21930,2581,104,104,106,210,24.580952380952382,47.67212280445147
Task_21931,2091,327,173,197,370,6.375,42.404126787037676
Task_21932,2581,76,143,22,165,33.51948051948052,46.27612729877415
Task_21933,2975,187,117,100,217,15.824468085106384,55.12135242793658
Task_21934,609,837,107,57,164,0.7267303102625299,18.87526194427303
Task_21935,2921,301,69,181,250,9.672185430463577,54.99554713695582
Task_21936,1694,444,200,186,386,3.8067415730337077,36.562856175970694
Task_21937,2047,504,35,165,200,4.0534653465346535,41.50339824121019
Task_21938,1640,562,27,66,93,2.9129662522202486,33.7831404142059
Task_21939,1830,259,131,160,291,7.038461538461538,37.63407132011047
Task_21940,1362,707,86,165,251,1.923728813559322,31.53770846298467
Task_21941,2560,617,36,157,193,4.142394822006472,49.92331689895973
Task_21942,679,688,176,116,292,0.9854862119013063,20.653791599335893
Task_21943,2410,399,39,109,148,6.025,46.25438288492371
Task_21944,1198,789,170,119,289,1.5164556962025317,29.213883905761858
Task_21945,1830,706,143,150,293,2.5884016973125883,39.07320944417838
Task_21946,1846,379,186,120,306,4.8578947368421055,38.30022981332436
Task_21947,2983,801,106,174,280,3.7194513715710724,57.61393390345419
Task_21948,2572,113,41,136,177,22.56140350877193,47.40558693628881
Task_21949,854,198,176,27,203,4.291457286432161,20.744797439617162
Task_21950,2238,436,160,177,337,5.121281464530893,44.912864635427184
Task_21951,2778,893,39,73,112,3.1073825503355703,53.22182832392125
Task_21952,2747,705,170,73,243,3.8909348441926346,52.85069580301831
Task_21953,1573,594,187,133,320,2.6436974789915966,34.747928336678534
Task_21954,1039,239,180,143,323,4.329166666666667,25.187072275031053
Task_21955,1638,980,86,109,195,1.6697247706422018,36.41151387069483
Task_21956,663,373,15,62,77,1.7727272727272727,17.110258540346113
Task_21957,2411,551,91,107,198,4.367753623188406,47.34282795915656
Task_21958,762,733,78,74,152,1.0381471389645776,20.86530992877975
Task_21959,1795,248,65,166,231,7.208835341365462,36.90605949266683
Task_21960,1969,459,97,56,153,4.280434782608696,39.00557530324199
Task_21961,1243,348,35,92,127,3.561604584527221,27.57747838919484
Task_21962,1396,721,119,33,152,1.9335180055401662,30.465088171083305
Task_21963,1515,946,63,101,164,1.5997888067581838,34.176116953780436
Task_21964,2136,795,170,196,366,2.6834170854271355,44.59588256732101
Task_21965,1213,162,100,42,142,7.441717791411043,25.415019495569187
Task_21966,1903,799,13,79,92,2.37875,38.869810725093295
Task_21967,1629,76,42,50,92,21.155844155844157,30.755873618425905
Task_21968,2786,364,185,78,263,7.632876712328767,52.56826819121148
Task_21969,1059,83,73,192,265,12.607142857142858,24.133231678434957
Task_21970,2319,258,18,61,79,8.953667953667953,42.944694435881786
Task_21971,2253,479,62,112,174,4.69375,44.522505542835994
Task_21972,2538,722,60,121,181,3.5103734439834025,49.73709551868015
Task_21973,2850,456,71,193,264,6.236323851203501,54.48625305088317
Task_21974,892,722,51,124,175,1.2337482710926695,23.624266632136898
Task_21975,708,873,137,25,162,0.8100686498855835,20.095415516433658
Task_21976,2510,374,192,160,352,6.693333333333333,49.05479628990266
Task_21977,1302,847,84,65,149,1.5353773584905661,29.683144285980585
Task_21978,2018,595,135,200,335,3.3859060402684564,41.964072898175814
Task_21979,2958,887,165,181,346,3.331081081081081,57.79569428008441
Task_21980,2800,784,69,79,148,3.56687898089172,53.55101633140066
Task_21981,2579,847,62,50,112,3.0412735849056602,49.26636639967694
Task_21982,1911,679,120,161,281,2.8102941176470586,40.23360378323533
Task_21983,2071,516,28,182,210,4.005802707930368,42.00327055187112
Task_21984,2535,725,104,38,142,3.4917355371900825,48.52375297414061
Task_21985,1743,978,153,63,216,1.780388151174668,37.597963426412925
Task_21986,2776,838,86,99,185,3.3087008343265794,53.80695663291743
Task_21987,1002,882,180,11,191,1.1347678369195924,25.0751639980756
Task_21988,2384,457,48,13,61,5.205240174672489,44.05463563819396
Task_21989,1764,894,164,40,204,1.970949720670391,37.36694519881727
Task_21990,2397,105,12,192,204,22.61320754716981,44.86265282766477
Task_21991,735,589,170,155,325,1.2457627118644068,21.39316232275795
Task_21992,2065,1009,105,35,140,2.0445544554455446,41.938670827932754
Task_21993,730,411,114,94,208,1.7718446601941749,20.19559664052033
Task_21994,2424,882,185,99,284,2.7451868629671576,48.90438181988802
Task_21995,1072,335,76,114,190,3.1904761904761907,25.508616157340033
Task_21996,1752,84,195,176,371,20.611764705882354,35.35401073386644
Task_21997,2710,391,80,57,137,6.913265306122449,50.50718283887564
Task_21998,2286,198,173,99,272,11.487437185929648,44.466899165720996
Task_21999,2572,779,124,173,297,3.2974358974358973,51.10847363431744
Task_22000,2438,279,134,78,212,8.707142857142857,46.539837339518385
Task_22001,1372,884,57,89,146,1.5502824858757063,31.319833980182086
Task_22002,1982,95,158,119,277,20.645833333333332,38.46714712316503
Task_22003,1987,191,45,17,62,10.348958333333334,37.055992730214776
Task_22004,1635,666,30,140,170,2.451274362818591,35.14647763948974
Task_22005,1839,532,190,116,306,3.450281425891182,38.67603037958444
Task_22006,701,483,29,13,42,1.4483471074380165,17.318724744280782
Task_22007,2164,146,12,118,130,14.72108843537415,40.78068436806767
Task_22008,1988,672,148,86,234,2.9539375928677565,40.84539116756675
Task_22009,2364,199,54,188,242,11.82,45.84043094206003
Task_22010,2016,312,101,21,122,6.440894568690096,38.694454531633404
Task_22011,1248,341,192,176,368,3.6491228070175437,29.077985538684363
Task_22012,1644,1003,193,148,341,1.6374501992031874,37.25109103494348
Task_22013,1292,509,181,134,315,2.533333333333333,30.00974567839242
Task_22014,2591,326,199,121,320,7.92354740061162,49.97129468696286
Task_22015,2192,337,154,112,266,6.485207100591716,43.44194965372049
Task_22016,1502,313,124,46,170,4.7834394904458595,31.014800751135628
Task_22017,950,495,128,37,165,1.9153225806451613,23.008513522408446
Task_22018,2669,989,54,53,107,2.695959595959596,51.3735214081889
Task_22019,2364,911,98,12,110,2.5921052631578947,46.01148524330131
Task_22020,670,237,63,176,239,2.8151260504201683,19.149164880137818
Task_22021,1365,786,184,24,208,1.7344345616264294,30.64798995207404
Task_22022,2781,485,157,13,170,5.722222222222222,51.66694041370986
Task_22023,1811,895,180,27,207,2.021205357142857,38.07374535852479
Task_22024,2722,839,41,117,158,3.2404761904761905,52.66401678538486
Task_22025,2999,265,89,186,275,11.274436090225564,56.13521326021405
Task_22026,2393,266,18,104,122,8.962546816479401,45.40657322473985
Task_22027,2415,974,41,172,213,2.476923076923077,48.86300832394906
Task_22028,1624,1007,189,26,215,1.6111111111111112,35.520961972344246
Task_22029,1362,519,119,33,152,2.6192307692307693,29.29372011545769
Task_22030,2506,153,64,194,258,16.272727272727273,47.58014254332803
Task_22031,1534,398,89,149,238,3.844611528822055,33.20126408961756
Task_22032,2413,151,32,155,187,15.875,45.543722392051926
Task_22033,2725,972,164,83,247,2.800616649537513,53.48621710401331
Task_22034,2868,423,154,47,201,6.764150943396227,53.33964600486541
Task_22035,2371,840,10,29,39,2.8192627824019025,45.085525849860296
Task_22036,2976,811,83,21,104,3.665024630541872,55.234478494312945
Task_22037,1294,539,189,183,372,2.3962962962962964,30.464623641228446
Task_22038,847,936,92,151,243,0.9039487726787621,23.955834223785885
Task_22039,2120,700,56,194,250,3.0242510699001426,43.677471441697755
Task_22040,2021,534,63,183,246,3.777570093457944,41.51983148739165
Task_22041,2024,832,191,85,276,2.4297719087635055,42.093907330417565
Task_22042,2612,280,58,44,102,9.295373665480428,47.72648344065556
Task_22043,2679,272,173,75,248,9.813186813186814,50.41521830687075
Task_22044,2121,967,186,49,235,2.1911157024793386,43.464661071335094
Task_22045,1987,798,80,157,237,2.4868585732165207,41.73335955576167
Task_22046,1142,604,189,37,226,1.887603305785124,26.72518567014173
Task_22047,2463,608,148,130,278,4.044334975369458,48.69310483755722
Task_22048,2871,234,103,195,298,12.217021276595744,54.07165322096049
Task_22049,1944,729,40,44,84,2.663013698630137,38.556949948078724
Task_22050,1785,1022,109,34,143,1.7448680351906158,37.562692607558034
Task_22051,1589,72,25,194,219,21.767123287671232,32.09727184641266
Task_22052,563,510,81,47,128,1.101761252446184,16.62248214050447
Task_22053,1043,708,39,57,96,1.471086036671368,24.588545809092853
Task_22054,2308,879,55,137,192,2.6227272727272726,46.871530950711694
Task_22055,1492,401,163,78,241,3.711442786069652,32.11821765267356
Task_22056,1941,896,80,19,99,2.1638795986622075,39.04988647219346
Task_22057,1287,725,168,128,296,1.7727272727272727,30.498844982217776
Task_22058,687,200,130,110,240,3.417910447761194,19.07532066389968
Task_22059,1235,66,88,12,100,18.432835820895523,24.1295036863112
Task_22060,898,758,190,88,278,1.1831357048748352,23.987919567579667
Task_22061,2198,88,47,87,134,24.696629213483146,40.77820046848612
Task_22062,2622,564,130,24,154,4.64070796460177,49.330040302307374
Task_22063,1565,865,198,45,243,1.8071593533487298,34.25388722302959
Task_22064,708,854,48,187,235,0.8280701754385965,21.49584834774464
Task_22065,2333,100,142,81,223,23.099009900990097,43.552929808606564
Task_22066,1939,847,82,135,217,2.286556603773585,40.96853238203624
Task_22067,1480,302,103,165,268,4.884488448844884,32.15192496919372
Task_22068,638,896,75,144,219,0.7112597547380156,20.610183988182108
Task_22069,549,802,102,128,230,0.6836861768368617,18.823902437996455
Task_22070,947,205,164,108,272,4.597087378640777,23.33774734438292
Task_22071,875,75,182,129,311,11.513157894736842,21.19012079143614
Task_22072,2052,651,157,36,193,3.147239263803681,41.12370678558798
Task_22073,1204,963,33,123,156,1.2489626556016598,28.831051864579432
Task_22074,1365,836,195,120,315,1.6308243727598566,32.15365560942052
Task_22075,1508,522,72,85,157,2.8833652007648185,32.28800880052379
Task_22076,2831,759,128,86,214,3.725,54.382989555481494
Task_22077,1169,906,118,154,272,1.288864388092613,29.04261469785534
Task_22078,2887,946,127,91,218,3.0485744456177404,56.00037569583435
Task_22079,2360,723,78,165,243,3.2596685082872927,47.44954135424973
Task_22080,2732,826,18,72,90,3.3035066505441355,51.838974664427234
Task_22081,2846,765,60,86,146,3.715404699738903,54.26672296000449
Task_22082,2550,548,67,85,152,4.644808743169399,48.820261201466515
Task_22083,1662,111,58,15,73,14.839285714285714,30.949318888878
Task_22084,1011,778,107,179,286,1.2978177150192554,26.24224662580829
Task_22085,1081,634,137,196,333,1.7023622047244094,27.218799878926415
Task_22086,1890,138,136,67,203,13.597122302158274,36.776287688389345
Task_22087,1604,934,68,88,156,1.7155080213903744,35.107325762363615
Task_22088,1424,706,44,78,122,2.014144271570014,31.36113759680619
Task_22089,640,871,47,50,97,0.7339449541284404,18.697672334700286
Task_22090,2616,704,139,135,274,3.7106382978723405,51.40990574194321
Task_22091,552,709,151,173,324,0.7774647887323943,18.95940088443586
Task_22092,953,518,160,166,326,1.836223506743738,24.767406941591418
Task_22093,2146,468,92,167,259,4.575692963752665,43.271799169494834
Task_22094,2785,678,101,60,161,4.101620029455081,52.57996168358446
Task_22095,1262,963,28,13,41,1.3091286307053942,27.728376212743672
Task_22096,2335,207,72,37,109,11.225961538461538,43.356494742035274
Task_22097,659,678,33,97,130,0.9705449189985272,19.357244044531488
Task_22098,1662,532,13,68,81,3.1181988742964353,33.950163679278994
Task_22099,2414,594,193,142,335,4.057142857142857,48.147064855131326
Task_22100,1761,103,68,178,246,16.932692307692307,35.12807256931494
Task_22101,2289,371,28,49,77,6.153225806451613,42.53324596781285
Task_22102,2782,656,156,194,350,4.2343987823439875,54.316283841247376
Task_22103,1976,382,137,177,314,5.1592689295039165,40.486484257348145
Task_22104,1860,235,195,48,243,7.88135593220339,36.953462443955694
Task_22105,520,525,145,71,216,0.9885931558935361,16.895602447513202
Task_22106,907,390,52,97,149,2.319693094629156,22.671199452265313
Task_22107,2207,482,59,174,233,4.569358178053831,44.25280088417711
Task_22108,1248,441,68,30,98,2.823529411764706,26.82907476670282
Task_22109,2635,127,67,45,112,20.5859375,47.12659688037778
Task_22110,2379,155,150,10,160,15.25,43.81586913508753
Task_22111,2297,567,109,107,216,4.044014084507042,45.62064311719035
Task_22112,837,325,119,65,184,2.567484662576687,20.8991400592413
Task_22113,2910,990,62,86,148,2.936427850655903,55.97156503964047
Task_22114,2036,85,174,79,253,23.674418604651162,38.858677723390194
Task_22115,978,246,118,52,170,3.9595141700404857,22.817813952367924
Task_22116,655,996,13,143,156,0.6569709127382146,20.593375253825027
Task_22117,508,465,132,68,200,1.090128755364807,16.31307512537666
Task_22118,1245,1003,106,167,273,1.2400398406374502,30.539719053411158
Task_22119,2605,246,137,18,155,10.54655870445344,47.80629445375434
Task_22120,2353,282,126,76,202,8.314487632508834,45.09525181579064
Task_22121,1197,730,63,128,191,1.637482900136799,28.74344750230199
Task_22122,2706,432,133,171,304,6.249422632794457,52.14904966181867
Task_22123,1487,698,97,87,184,2.127324749642346,32.60446556481056
Task_22124,1182,479,182,132,314,2.4625,28.16625409826997
Task_22125,820,972,153,139,292,0.8427543679342241,23.79245433860885
Task_22126,1521,302,29,151,180,5.01980198019802,32.24586385008672
Task_22127,551,934,183,172,355,0.5893048128342246,19.88862108508935
Task_22128,2602,225,60,122,182,11.513274336283185,49.103793343724845
Task_22129,2196,739,41,19,60,2.9675675675675675,41.90976962953875
Task_22130,779,859,35,39,74,0.9058139534883721,20.16941239926184
Task_22131,1563,991,200,140,340,1.5756048387096775,35.884746340135884
Task_22132,2314,572,97,110,207,4.038394415357766,45.89329521525227
Task_22133,823,178,186,34,220,4.597765363128492,20.091859322981204
Task_22134,1074,716,80,140,220,1.497907949790795,26.874090711786305
Task_22135,2988,572,112,162,274,5.214659685863874,56.9207989314894
Task_22136,2339,201,58,136,194,11.57920792079208,45.14053468372115
Task_22137,1067,427,59,139,198,2.4929906542056073,25.823729331537937
Task_22138,2231,858,81,62,143,2.5972060535506403,44.4408412423166
Task_22139,2742,648,64,11,75,4.224961479198767,50.35395872218931
Task_22140,1998,836,32,135,167,2.3870967741935485,41.404165560920255
Task_22141,757,161,56,189,245,4.672839506172839,20.028067478998512
Task_22142,1681,283,14,174,188,5.919014084507042,34.92335792333405
Task_22143,1901,367,121,45,166,5.165760869565218,37.50618334968203
Task_22144,1375,86,93,143,236,15.804597701149426,28.863463086290086
Task_22145,816,917,134,33,167,0.8888888888888888,22.11380884303497
Task_22146,2736,1004,136,147,283,2.7223880597014927,54.3097823928533
Task_22147,1630,586,12,101,113,2.7768313458262353,34.4136210149686
Task_22148,1113,226,200,66,266,4.903083700440528,25.47938841587693
Task_22149,2867,206,104,87,191,13.85024154589372,52.9996276423332
Task_22150,2177,159,151,115,266,13.60625,42.27216043565788
Task_22151,1862,839,107,148,255,2.216666666666667,39.82150327682945
Task_22152,1157,908,29,143,172,1.2728272827282727,28.29384822824673
Task_22153,1452,164,200,150,350,8.8,31.2795530587217
Task_22154,2973,596,79,128,207,4.9798994974874375,56.53926380609904
Task_22155,1547,913,35,161,196,1.6925601750547046,34.82971770816014
Task_22156,2262,252,67,91,158,8.940711462450594,43.44784374041539
Task_22157,1298,901,96,47,143,1.4390243902439024,29.509562613269576
Task_22158,1510,379,49,175,224,3.973684210526316,32.85609965005242
Task_22159,1463,991,112,71,183,1.4747983870967742,32.87915979887742
Task_22160,2898,530,41,20,61,5.4576271186440675,52.36962374910842
Task_22161,1259,466,12,192,204,2.69593147751606,28.938215288490838
Task_22162,2605,443,11,47,58,5.867117117117117,47.80712781757662
Task_22163,1906,174,143,44,187,10.891428571428571,36.90014782084954
Task_22164,2873,711,49,127,176,4.035112359550562,55.05424545946992
Task_22165,2878,862,22,12,34,3.3348783314020856,52.864699203121326
Task_22166,1774,621,55,129,184,2.852090032154341,37.382156897648784
Task_22167,1277,348,17,76,93,3.659025787965616,27.37705227258216
Task_22168,1285,596,58,65,123,2.152428810720268,28.692080198271736
Task_22169,2700,861,70,14,84,3.1322505800464038,50.87822028478553
Task_22170,2951,335,156,195,351,8.782738095238095,55.94423959413738
Task_22171,2857,502,130,35,165,5.679920477137177,53.212391954715095
Task_22172,2640,1008,133,127,260,2.616451932606541,52.667945399286474
Task_22173,1268,750,83,52,135,1.688415446071904,28.805426867639557
Task_22174,1160,690,55,182,237,1.678726483357453,28.350031535731855
Task_22175,808,328,16,143,159,2.4559270516717326,20.730722142333246
Task_22176,1251,348,144,41,185,3.5845272206303727,27.30119802123728
Task_22177,2951,1012,17,37,54,2.9131293188548866,55.099319891825594
Task_22178,847,267,19,130,149,3.16044776119403,21.112039728072986
Task_22179,2675,285,186,191,377,9.353146853146853,51.514682071537926
Task_22180,2751,515,55,54,109,5.3313953488372094,51.207884848629966
Task_22181,2004,987,132,120,252,2.02834008097166,42.477579851518875
Task_22182,1850,551,67,163,230,3.351449275362319,38.759087667709295
Task_22183,1942,581,85,60,145,3.336769759450172,38.962375099352805
Task_22184,2812,210,160,32,192,13.327014218009479,51.65779805757126
Task_22185,1562,856,111,67,178,1.822637106184364,34.0161140483729
Task_22186,1215,528,132,131,263,2.2967863894139886,28.611704610753268
Task_22187,2907,639,141,85,226,4.5421875,55.248564235678266
Task_22188,1950,992,54,98,152,1.9637462235649548,40.974998649365155
Task_22189,904,829,129,70,199,1.0891566265060242,23.740738369480777
Task_22190,2864,352,103,53,156,8.113314447592067,52.85682229968565
Task_22191,1421,747,23,84,107,1.8997326203208555,31.30978192600252
Task_22192,1468,371,40,104,144,3.946236559139785,31.255077589672045
Task_22193,2749,862,200,118,318,3.1853997682502895,54.18723324813368
Task_22194,796,776,109,32,141,1.0244530244530246,21.093656433731315
Task_22195,1281,623,19,20,39,2.0528846153846154,26.891063772569126
Task_22196,1916,358,96,148,244,5.337047353760446,39.15295388036476
Task_22197,867,378,54,143,197,2.287598944591029,22.509518296520596
Task_22198,2839,536,164,108,272,5.286778398510242,54.35722212473858
Task_22199,2301,174,10,62,72,13.148571428571428,42.1612857582851
Task_22200,1672,150,145,119,264,11.072847682119205,34.23804895680434
Task_22201,2309,723,109,193,302,3.1892265193370166,46.817897259327424
Task_22202,608,653,120,159,279,0.9296636085626911,19.431282797123888
Task_22203,2356,333,176,26,202,7.053892215568863,44.90052794564648
Task_22204,1948,648,197,30,227,3.0015408320493067,39.6269225682491
Task_22205,2034,64,70,186,256,31.29230769230769,39.18022603267432
Task_22206,2748,219,135,53,188,12.49090909090909,50.91614447821019
Task_22207,1922,271,122,151,273,7.0661764705882355,39.03559492692814
Task_22208,873,858,71,82,153,1.0162980209545984,23.117330747567987
Task_22209,1680,301,162,83,245,5.562913907284768,34.793498930441906
Task_22210,2060,731,82,111,193,2.814207650273224,42.37951875560055
Task_22211,924,213,200,146,346,4.317757009345795,23.39113206027588
Task_22212,2969,584,38,34,72,5.075213675213675,53.9421402308706
Task_22213,2855,1022,37,83,120,2.790811339198436,55.00098044908702
Task_22214,1077,264,154,71,225,4.064150943396227,24.88786755328701
Task_22215,1383,986,123,184,307,1.4012158054711246,32.90693031657352
Task_22216,1614,959,169,191,360,1.68125,36.78786708940962
Task_22217,1604,293,94,98,192,5.45578231292517,33.72856454006911
Task_22218,1781,439,61,104,165,4.047727272727273,36.85975546458023
Task_22219,690,936,169,194,363,0.736392742796158,22.00901662167909
Task_22220,862,253,182,83,265,3.393700787401575,21.794425022015712
Task_22221,1998,752,139,62,201,2.653386454183267,40.84228170228944
Task_22222,1413,824,73,126,199,1.7127272727272727,32.489830050557934
Task_22223,1517,236,43,43,86,6.40084388185654,30.272887787528806
Task_22224,1699,475,80,24,104,3.569327731092437,34.091961501586
Task_22225,2945,889,114,163,277,3.308988764044944,57.25860316672678
Task_22226,2638,288,195,128,323,9.1280276816609,50.60479699222168
Task_22227,669,245,123,178,301,2.7195121951219514,19.313793405950623
Task_22228,1594,288,63,176,239,5.515570934256055,33.92069627605701
Task_22229,1182,97,95,52,147,12.061224489795919,24.6293093765847
Task_22230,2506,589,161,148,309,4.247457627118644,49.479677974980554
Task_22231,2879,538,17,101,118,5.341372912801484,53.91749530764847
Task_22232,2435,432,76,76,152,5.6235565819861435,46.5097908991521
Task_22233,2114,564,33,99,132,3.741592920353982,42.12071323157528
Task_22234,938,489,126,96,222,1.9142857142857144,23.89129900786345
Task_22235,1874,987,137,184,321,1.8967611336032388,40.82229621009397
Task_22236,690,271,108,176,284,2.536764705882353,19.65019824162521
Task_22237,1342,316,161,40,201,4.233438485804417,28.846111677390482
Task_22238,744,226,136,53,189,3.2775330396475773,19.31080480088971
Task_22239,2219,982,123,115,238,2.2573753814852493,45.79866424363106
Task_22240,2428,116,189,20,209,20.752136752136753,44.77000752721535
Task_22241,1142,228,180,162,342,4.986899563318778,26.890238677946574
Task_22242,2325,494,61,124,185,4.696969696969697,45.71326406845291
Task_22243,1729,679,161,13,174,2.5426470588235293,35.77543913825876
Task_22244,1990,667,74,127,201,2.9790419161676644,41.16861312268462
Task_22245,2207,261,92,135,227,8.423664122137405,43.351094061160374
Task_22246,2601,200,128,137,265,12.940298507462687,49.43899696646391
Task_22247,2983,561,89,48,137,5.307829181494662,55.10448048729608
Task_22248,1958,206,22,81,103,9.458937198067632,37.8494959236124
Task_22249,2376,531,18,152,170,4.466165413533835,46.404620744716446
Task_22250,1360,441,153,126,279,3.076923076923077,30.696744552267997
Task_22251,1248,755,101,176,277,1.6507936507936507,29.959108517756324
Task_22252,742,627,127,85,212,1.1815286624203822,20.78578070989674
Task_22253,2742,686,177,21,198,3.9912663755458517,52.06346283810632
Task_22254,1990,761,68,166,234,2.611548556430446,41.659792182744475
Task_22255,2300,464,30,16,46,4.946236559139785,42.703017646899305
Task_22256,2902,896,105,121,226,3.2352285395763656,56.30776517588938
Task_22257,2785,408,147,119,266,6.809290953545232,53.07208813484518
Task_22258,2324,847,57,145,202,2.740566037735849,47.081863973385396
Task_22259,2479,72,46,171,217,33.95890410958904,45.977275988575826
Task_22260,1017,487,178,12,190,2.084016393442623,24.047655592341915
Task_22261,2470,489,152,173,325,5.040816326530612,48.697344275414196
Task_22262,2588,487,118,150,268,5.30327868852459,50.26824971950058
Task_22263,1979,423,140,181,321,4.6674528301886795,40.70532183366037
Task_22264,1752,757,194,48,242,2.311345646437995,36.928849578329455
Task_22265,2928,837,48,40,88,3.4940334128878283,54.552734594477066
Task_22266,1156,736,132,83,215,1.5685210312075983,27.708249866436603
Task_22267,1174,888,179,55,234,1.3205849268841394,28.413072538422465
Task_22268,2419,828,154,55,209,2.9179734620024127,47.84265539063304
Task_22269,1180,86,138,134,272,13.563218390804598,25.88986476761951
Task_22270,2581,236,89,110,199,10.890295358649789,48.96748964047246
Task_22271,1012,645,37,123,160,1.5665634674922602,24.947043716127677
Task_22272,669,795,52,35,87,0.8404522613065326,18.69678954991591
Task_22273,523,610,124,123,247,0.855973813420622,17.749843276876472
Task_22274,1142,529,50,68,118,2.1547169811320757,26.253264496593967
Task_22275,2247,907,170,40,210,2.4746696035242293,45.08775640819459
Task_22276,1130,204,129,96,225,5.512195121951219,26.017326462896524
Task_22277,2007,619,89,110,199,3.2370967741935486,41.16064558621672
Task_22278,1870,320,113,28,141,5.825545171339564,36.629121040880804
Task_22279,2075,312,82,147,229,6.6293929712460065,41.48381206722705
Task_22280,1622,381,105,162,267,4.2460732984293195,34.64854468045697
Task_22281,1162,252,87,92,179,4.592885375494071,26.16816024770399
Task_22282,2266,589,152,125,277,3.840677966101695,45.50107538947551
Task_22283,2945,848,166,110,276,3.4687868080094226,57.04779475885838
Task_22284,2762,968,58,65,123,2.850361197110423,53.25446748595667
Task_22285,2890,89,49,198,247,32.111111111111114,52.82669062424264
Task_22286,1701,365,42,98,140,4.647540983606557,34.901333983134606
Task_22287,2045,586,92,174,266,3.48381601362862,42.091562189514896
Task_22288,1090,466,133,63,196,2.3340471092077086,25.574823564806092
Task_22289,1147,940,85,197,282,1.2189160467587672,28.910050461474327
Task_22290,1731,746,163,24,187,2.317269076305221,36.197124934326446
Task_22291,1321,964,129,156,285,1.3689119170984456,31.723097834563465
Task_22292,2031,138,161,35,196,14.611510791366907,38.76287395763829
Task_22293,1408,870,118,77,195,1.6165327210103329,31.991049308954462
Task_22294,1744,138,66,38,104,12.546762589928058,33.197217571957076
Task_22295,1497,992,74,91,165,1.5075528700906344,33.936006384022434
Task_22296,2825,98,40,51,91,28.535353535353536,49.86530971510714
Task_22297,2456,417,22,147,169,5.875598086124402,47.28436621235584
Task_22298,729,324,184,67,251,2.243076923076923,19.687002513794003
Task_22299,2419,1009,53,183,236,2.395049504950495,49.31255336683281
Task_22300,1740,702,160,22,182,2.4751066856330013,36.027959924883575
Task_22301,515,102,79,148,227,5.0,15.464911953811944
Task_22302,2113,655,143,45,188,3.221036585365854,41.990234129680935
Task_22303,739,353,11,115,126,2.0875706214689265,19.68763881319056
Task_22304,1188,337,18,127,145,3.514792899408284,26.751337099273254
Task_22305,2335,446,112,187,299,5.223713646532438,46.324085584717295
Task_22306,2351,757,119,184,303,3.1015831134564644,47.58139231946004
Task_22307,2239,380,36,198,234,5.876640419947506,44.320075906351576
Task_22308,1085,550,118,135,253,1.969147005444646,26.583155211800655
Task_22309,2619,966,58,115,173,2.7083764219234747,51.8774702478245
Task_22310,2827,381,171,40,211,7.400523560209424,52.597438026019255
Task_22311,2317,604,91,52,143,3.8297520661157023,45.01056981021935
Task_22312,2550,733,89,103,192,3.474114441416894,50.07918786221946
Task_22313,2527,433,93,176,269,5.82258064516129,49.280948841940784
Task_22314,699,328,160,43,203,2.1246200607902734,18.71850226592745
Task_22315,1936,310,153,79,232,6.22508038585209,38.80769838984422
Task_22316,786,439,88,140,228,1.7863636363636364,21.415963836677907
Task_22317,2067,599,161,82,243,3.445,41.88178638354836
Task_22318,717,147,37,198,235,4.844594594594595,19.13731148499407
Task_22319,2547,805,186,122,308,3.160049627791563,50.76884559167619
Task_22320,2257,519,98,134,232,4.3403846153846155,44.95944981427914
Task_22321,629,128,124,81,205,4.875968992248062,17.04500050683701
Task_22322,1217,829,85,176,261,1.466265060240964,29.631170987175143
Task_22323,2298,845,67,117,184,2.7163120567375887,46.33123407922039
Task_22324,2500,383,171,136,307,6.510416666666667,48.68872784537922
Task_22325,999,642,126,188,314,1.5536547433903578,25.81834148560951
Task_22326,1266,223,65,67,132,5.651785714285714,27.27122273970096
Task_22327,2043,428,77,82,159,4.7622377622377625,40.43875359971181
Task_22328,2156,751,160,82,242,2.867021276595745,43.765631953025455
Task_22329,1062,453,76,169,245,2.33920704845815,26.066149986045485
Task_22330,2181,479,128,26,154,4.54375,42.10050505483224
Task_22331,951,303,107,152,259,3.1282894736842106,23.731624153874847
Task_22332,2595,125,135,43,178,20.595238095238095,47.20282762832133
Task_22333,1080,1004,53,141,194,1.0746268656716418,27.596496358710784
Task_22334,2892,83,187,133,320,34.42857142857143,52.9240621419734
Task_22335,2745,754,155,187,342,3.6357615894039736,53.99386119781203
Task_22336,1205,387,125,152,277,3.1056701030927836,28.100588058883975
Task_22337,699,68,125,145,270,10.130434782608695,18.261774895109294
Task_22338,2388,953,27,31,58,2.50314465408805,45.90173458464364
Task_22339,2342,404,65,114,179,5.782716049382716,45.59287440671934
Task_22340,2714,1001,178,65,243,2.708582834331337,53.21127746395274
Task_22341,1121,78,191,149,340,14.189873417721518,25.20715796575368
Task_22342,1179,187,104,139,243,6.2712765957446805,26.95657794595128
Task_22343,1459,911,116,98,214,1.599780701754386,33.391730749244424
Task_22344,1631,410,104,114,218,3.9683698296836982,34.59366012377409
Task_22345,1584,303,195,94,289,5.2105263157894735,33.73461545257313
Task_22346,2556,457,27,81,108,5.580786026200873,48.30803207500322
Task_22347,2951,272,91,178,269,10.80952380952381,55.373336766952086
Task_22348,2159,629,131,23,154,3.426984126984127,42.21150204927158
Task_22349,559,863,114,145,259,0.6469907407407407,19.328634352985265
Task_22350,548,542,102,157,259,1.0092081031307552,17.968024671110275
Task_22351,2396,458,20,44,64,5.22004357298475,44.4477841209873
Task_22352,666,229,124,76,200,2.8956521739130436,18.248060016266596
Task_22353,822,233,139,165,304,3.5128205128205128,21.685866596105615
Task_22354,2887,687,74,71,145,4.196220930232558,54.5248103042646
Task_22355,1778,586,82,143,225,3.028960817717206,37.64803281141743
Task_22356,2091,304,127,46,173,6.855737704918033,40.434791419398614
Task_22357,1336,1014,192,11,203,1.3162561576354679,30.789718618537986
Task_22358,856,532,107,155,262,1.6060037523452158,22.957395449802732
Task_22359,1212,672,17,17,34,1.8008915304606241,25.80854013434129
Task_22360,2841,527,77,88,165,5.380681818181818,53.6819450909202
Task_22361,2563,166,159,108,267,15.347305389221557,48.340356340515505
Task_22362,1840,113,143,150,293,16.140350877192983,36.6763902443983
Task_22363,1080,347,118,140,258,3.103448275862069,25.891534116651627
Task_22364,1556,1001,169,172,341,1.5528942115768463,35.85623465600481
Task_22365,649,211,183,37,220,3.061320754716981,17.650671523929425
Task_22366,1459,157,197,188,385,9.234177215189874,31.59074365790887
Task_22367,559,678,131,60,191,0.8232695139911634,17.751412346469753
Task_22368,2849,475,99,29,128,5.985294117647059,52.782563045185505
Task_22369,2133,189,44,41,85,11.226315789473684,40.053103533217055
Task_22370,1093,616,181,153,334,1.7714748784440844,27.294180627147338
Task_22371,2354,324,50,11,61,7.243076923076923,43.13439900057286
Task_22372,2815,712,106,19,125,3.9481065918653577,52.55838548095672
Task_22373,2075,276,60,83,143,7.490974729241877,40.40770136890084
Task_22374,2697,373,151,38,189,7.211229946524064,50.41571084641908
Task_22375,2143,837,142,149,291,2.5572792362768495,44.431148931279644
Task_22376,1482,367,148,152,300,4.0271739130434785,32.52222117992093
Task_22377,2290,612,108,124,232,3.735725938009788,45.74988541792312
Task_22378,1688,603,12,56,68,2.794701986754967,34.045171244825475
Task_22379,2570,69,194,149,343,36.714285714285715,47.860425723238194
Task_22380,991,416,40,71,111,2.3764988009592325,23.346790534883368
Task_22381,2578,771,12,16,28,3.339378238341969,47.942259560133415
Task_22382,2329,239,176,87,263,9.704166666666667,44.95869882019989
Task_22383,2759,754,78,71,149,3.6543046357615894,52.64095477901359
Task_22384,2130,760,110,83,193,2.7989487516425755,43.1505539100628
Task_22385,1609,623,172,40,212,2.578525641025641,34.101263551961175
Task_22386,1376,618,84,181,265,2.222940226171244,31.573189836433656
Task_22387,679,67,100,159,259,9.985294117647058,17.929433614104138
Task_22388,556,963,55,136,191,0.5767634854771784,19.357391354459807
Task_22389,2900,633,50,188,238,4.574132492113565,55.78789904230042
Task_22390,1914,526,98,10,108,3.6318785578747628,37.66598963940489
Task_22391,1875,544,63,42,105,3.4403669724770642,36.91648766729693
Task_22392,2836,214,140,134,274,13.190697674418605,53.24202800564658
Task_22393,2496,914,181,99,280,2.7278688524590162,50.1271596930383
Task_22394,651,83,133,113,246,7.75,17.432790884466442
Task_22395,1858,347,51,183,234,5.339080459770115,38.34836387743141
Task_22396,1092,430,15,144,159,2.5336426914153134,25.634335482064277
Task_22397,1324,313,84,185,269,4.2165605095541405,29.802821668612534
Task_22398,616,360,108,58,166,1.706371191135734,17.394943937839276
Task_22399,682,619,80,23,103,1.1,18.51367256662732
Task_22400,1427,567,184,136,320,2.512323943661972,32.35539299195882
Task_22401,1326,580,97,105,202,2.2822719449225475,30.243264196476574
Task_22402,2476,930,73,17,90,2.659505907626208,47.58832090695691
Task_22403,2008,745,119,119,238,2.6916890080428955,41.7217670833309
Task_22404,2405,650,170,123,293,3.69431643625192,47.96508784632241
Task_22405,816,341,135,162,297,2.3859649122807016,21.904631455688275
Task_22406,1474,682,96,100,196,2.158125915080527,32.90139734231725
Task_22407,2663,344,118,118,236,7.718840579710145,50.78900381673575
Task_22408,1223,575,51,21,72,2.123263888888889,26.197866932312355
Task_22409,717,810,77,76,153,0.8840937114673243,20.48990375378936
Task_22410,692,1020,115,116,231,0.6777668952007836,21.749732844541857
Task_22411,2514,137,123,15,138,18.217391304347824,45.62124656823795
Task_22412,1438,380,118,159,277,3.774278215223097,31.77482032053739
Task_22413,2056,182,38,59,97,11.234972677595628,38.94202414982289
Task_22414,2599,430,44,74,118,6.03016241299304,49.022280283364125
Task_22415,659,564,136,74,210,1.1663716814159293,19.224314647384357
Task_22416,2285,982,162,199,361,2.3245167853509665,47.52205478014175
Task_22417,1434,716,131,76,207,2.0,31.97405633895354
Task_22418,2139,276,169,110,279,7.722021660649819,42.44980825106627
Task_22419,2754,485,81,30,111,5.666666666666667,50.91778897442307
Task_22420,1008,265,180,74,254,3.789473684210526,24.01473632554554
Task_22421,2327,562,198,66,264,4.1332149200710475,45.773246735205156
Task_22422,806,722,35,110,145,1.1147994467496543,21.737948875436558
Task_22423,2960,190,190,197,387,15.497382198952879,55.708144699947354
Task_22424,748,190,22,157,179,3.9162303664921465,19.560262124951652
Task_22425,1411,816,127,75,202,1.7270501835985312,31.885515590702838
Task_22426,2438,720,69,88,157,3.381414701803051,47.66167778960081
Task_22427,2867,78,118,174,292,36.29113924050633,52.37589195507842
Task_22428,2857,93,29,190,219,30.393617021276597,52.08662588439673
Task_22429,2810,323,116,91,207,8.67283950617284,52.72481789182086
Task_22430,2706,781,84,10,94,3.4603580562659846,50.846039738146025
Task_22431,862,127,132,60,192,6.734375,20.457342401778188
Task_22432,1228,673,136,176,312,1.8219584569732938,29.558146154152357
Task_22433,1918,884,85,46,131,2.167231638418079,39.217512719156765
Task_22434,502,909,172,124,296,0.5516483516483517,18.626358638995782
Task_22435,1766,922,74,80,154,1.9133261105092092,37.569942528825514
Task_22436,2509,163,118,101,219,15.298780487804878,47.27885274662875
Task_22437,1734,592,189,124,313,2.9241146711635753,37.24652621205366
Task_22438,728,966,144,105,249,0.7528438469493278,22.06762525843004
Task_22439,2767,139,68,199,267,19.764285714285716,51.6200810531287
Task_22440,2268,755,78,165,243,3.0,46.09266853828425
Task_22441,836,233,103,93,196,3.572649572649573,21.249359412852844
Task_22442,1694,120,77,178,255,14.0,34.530922807000266
Task_22443,2920,529,11,125,136,5.509433962264151,54.74513917062736
Task_22444,967,762,128,54,182,1.2673656618610747,24.253890647963033
Task_22445,920,805,43,61,104,1.1414392059553349,22.98810980885521
Task_22446,1580,588,72,60,132,2.6825127334465195,33.269051823571004
Task_22447,2266,68,106,68,174,32.84057971014493,41.71290468247866
Task_22448,2376,390,47,75,122,6.076726342710997,45.405468910075456
Task_22449,581,370,97,87,184,1.5660377358490567,17.194241037285753
Task_22450,2223,631,13,88,101,3.517405063291139,43.60102448396387
Task_22451,2862,307,163,100,263,9.292207792207792,53.90243712068949
Task_22452,702,629,103,51,154,1.1142857142857143,19.326045772286548
Task_22453,699,128,129,157,286,5.4186046511627906,18.873992170808215
Task_22454,2162,798,95,31,126,2.7058823529411766,42.89155895360022
Task_22455,2721,291,139,169,308,9.318493150684931,51.920130437279795
Task_22456,1618,581,196,24,220,2.7800687285223367,34.07909352721055
Task_22457,650,579,170,84,254,1.1206896551724137,19.290606210893003
Task_22458,2194,904,193,56,249,2.4243093922651933,44.69678565173455
Task_22459,2490,1019,26,61,87,2.4411764705882355,48.37922128191863
Task_22460,967,202,179,143,322,4.763546798029557,23.919815441593883
Task_22461,702,447,124,27,151,1.5669642857142858,18.577194953657976
Task_22462,2905,390,52,182,234,7.429667519181586,55.02841953899556
Task_22463,872,64,83,88,171,13.415384615384616,20.271135105637057
Task_22464,1280,676,134,102,236,1.8906942392909896,29.9401408422803
Task_22465,2290,1002,143,107,250,2.2831505483549352,47.02838153909403
Task_22466,2372,314,109,95,204,7.53015873015873,45.8775677136216
Task_22467,1088,111,168,78,246,9.714285714285714,24.070517031159497
Task_22468,2442,439,75,80,155,5.55,46.78588259658407
Task_22469,1546,128,62,40,102,11.984496124031008,29.762615477451074
Task_22470,1066,263,102,87,189,4.037878787878788,24.72431299098594
Task_22471,1925,718,145,40,185,2.677329624478442,39.14879733842897
Task_22472,1597,627,188,186,374,2.5429936305732483,35.55278393438142
Task_22473,2800,362,156,114,270,7.7134986225895315,53.16502220386989
Task_22474,2122,225,93,180,273,9.389380530973451,42.18457007126562
Task_22475,619,924,129,55,184,0.6691891891891892,19.48971011993296
Task_22476,1167,859,149,168,317,1.3569767441860465,29.140230887536248
Task_22477,2381,717,51,15,66,3.316155988857939,44.81848047624521
Task_22478,1467,581,105,200,305,2.520618556701031,33.05904086131539
Task_22479,1160,67,26,108,134,17.058823529411764,24.347022061212133
Task_22480,2543,155,42,111,153,16.30128205128205,46.99988469170009
Task_22481,1966,104,30,74,104,18.723809523809525,36.74613406306758
Task_22482,1055,539,25,78,103,1.9537037037037037,24.701514809737663
Task_22483,2761,726,108,67,175,3.797799174690509,52.704045542261895
Task_22484,1820,590,145,88,233,3.0795262267343486,37.93683643012229
Task_22485,1822,565,102,44,146,3.2190812720848054,36.73977886126977
Task_22486,2146,973,135,147,282,2.2032854209445585,44.85907427345595
Task_22487,2039,417,149,168,317,4.87799043062201,41.59823580208139
Task_22488,2692,217,132,15,147,12.34862385321101,49.16545139574302
Task_22489,622,787,102,189,291,0.7893401015228426,20.19970126342877
Task_22490,1856,933,148,163,311,1.9871520342612419,40.29341520336683
Task_22491,1208,67,105,15,120,17.764705882352942,23.98217419972525
Task_22492,2790,232,155,87,242,11.974248927038627,52.119518970837845
Task_22493,2267,863,199,108,307,2.6238425925925926,46.489057183239105
Task_22494,2489,867,27,72,99,2.8675115207373274,48.22831392878398
Task_22495,805,748,91,28,119,1.074766355140187,20.964693371098118
Task_22496,1150,579,200,199,399,1.9827586206896552,28.455057911713293
Task_22497,1334,728,185,10,195,1.8299039780521262,29.844627761253623
Task_22498,1806,282,14,165,179,6.381625441696113,36.701275589020504
Task_22499,1723,886,40,60,100,1.9425028184892899,35.94634415158462
Task_22500,576,535,125,152,277,1.0746268656716418,18.465571305857065
Task_22501,2590,571,114,147,261,4.527972027972028,50.5345713718526
Task_22502,1281,251,84,74,158,5.083333333333333,27.616567951910486
Task_22503,2614,144,81,49,130,18.02758620689655,47.448618826132446
Task_22504,2547,483,148,37,185,5.262396694214876,48.26830724795974
Task_22505,1222,717,104,57,161,1.701949860724234,27.95378355687181
Task_22506,2994,127,26,48,74,23.390625,52.501067193931334
Task_22507,2429,430,45,119,164,5.635730858468677,46.93620471754144
Task_22508,1004,614,90,132,222,1.632520325203252,25.392115537765033
Task_22509,1699,79,127,23,150,21.2375,32.268617141386876
Task_22510,2194,389,195,193,388,5.625641025641026,44.31573114041902
Task_22511,1634,612,42,149,191,2.66557911908646,35.22625326014914
Task_22512,2593,552,184,150,334,4.688969258589512,50.85460518628495
Task_22513,1910,365,139,80,219,5.218579234972678,38.530731590417844
Task_22514,1218,624,24,103,127,1.9488,28.093575011598833
Task_22515,1882,284,187,91,278,6.603508771929825,38.23680572714302
Task_22516,2256,979,142,13,155,2.3020408163265307,44.76692550805416
Task_22517,500,806,65,165,230,0.6195786864931846,18.293300588817203
Task_22518,1740,657,141,83,224,2.6443768996960486,36.791422248968495
Task_22519,2683,381,105,97,202,7.023560209424084,51.08057861353911
Task_22520,1707,795,87,48,135,2.1444723618090453,35.603276612310474
Task_22521,1591,1011,106,195,301,1.5721343873517786,36.29531609124674
Task_22522,1092,107,132,29,161,10.11111111111111,23.20910441981121
Task_22523,2368,329,130,165,295,7.175757575757576,46.40671925283912
Task_22524,2215,881,37,74,111,2.5113378684807257,44.27619387460885
Task_22525,2216,399,13,15,28,5.54,41.067958874103944
Task_22526,2129,346,116,121,237,6.1354466858789625,42.35826887619594
Task_22527,1844,630,52,80,132,2.9223454833597464,38.02394742429039
Task_22528,1712,708,67,77,144,2.414668547249647,35.99898647962781
Task_22529,1744,191,173,108,281,9.083333333333334,35.897081052277365
Task_22530,2325,799,104,17,121,2.90625,44.97892906594142
Task_22531,976,828,114,74,188,1.1773220747889024,24.917182516853952
Task_22532,2636,837,101,138,239,3.1455847255369926,51.99174071499118
Task_22533,1092,316,167,85,252,3.444794952681388,25.598729205155763
Task_22534,1616,107,70,14,84,14.962962962962964,30.720517530168802
Task_22535,1096,353,62,75,137,3.096045197740113,25.11514646082991
Task_22536,583,853,90,83,173,0.6826697892271663,18.927877126793373
Task_22537,963,903,154,171,325,1.0652654867256637,25.98822384540566
Task_22538,2196,470,76,95,171,4.662420382165605,43.42349840353586
Task_22539,924,367,90,79,169,2.510869565217391,22.566991847164967
Task_22540,2613,1024,83,190,273,2.549268292682927,52.4944790172409
Task_22541,1987,672,181,170,351,2.9524517087667164,41.74409598979329
Task_22542,2236,628,79,41,120,3.5548489666136724,43.29262208804002
Task_22543,1957,264,15,45,60,7.384905660377359,36.918042378711995
Task_22544,2794,885,17,92,109,3.1534988713318284,53.55002993188224
Task_22545,919,954,60,31,91,0.962303664921466,23.213686522271768
Task_22546,1735,752,143,157,300,2.304116865869854,37.75400270871092
Task_22547,609,859,178,14,192,0.708139534883721,19.016218340693584
Task_22548,1385,852,132,131,263,1.6236811254396248,32.301987873772354
Task_22549,836,804,133,57,190,1.0385093167701864,22.46099819822686
Task_22550,2527,995,192,18,210,2.53714859437751,49.541885460397175
Task_22551,608,615,128,198,326,0.987012987012987,19.576448032317103
Task_22552,2684,235,157,79,236,11.372881355932204,50.379372969910456
Task_22553,1953,558,162,140,302,3.493738819320215,40.58081677115501
Task_22554,580,341,98,189,287,1.695906432748538,18.16687653899002
Task_22555,2965,141,19,127,146,20.880281690140844,53.47635620976232
Task_22556,2947,266,43,53,96,11.037453183520599,53.373865424299055
Task_22557,995,283,175,104,279,3.5035211267605635,24.3819478145904
Task_22558,2667,118,61,198,259,22.41176470588235,49.80684706607577
Task_22559,2042,148,87,114,201,13.704697986577182,39.78610764284224
Task_22560,935,360,24,86,110,2.590027700831025,22.43801188213041
Task_22561,790,238,91,154,245,3.305439330543933,20.964118428339862
Task_22562,522,207,114,126,240,2.5096153846153846,16.517246350314284
Task_22563,2512,700,104,124,228,3.5834522111269616,49.52642822677393
Task_22564,2475,372,88,130,218,6.6353887399463805,47.866056798532675
Task_22565,2961,466,136,193,329,6.340471092077088,56.44211425195741
Task_22566,2058,340,149,114,263,6.035190615835777,41.32206037394194
Task_22567,709,492,166,198,364,1.438133874239351,20.973039825978944
Task_22568,1589,621,118,116,234,2.554662379421222,34.67364320532572
Task_22569,2905,513,130,58,188,5.651750972762646,54.31766811043283
Task_22570,2768,901,82,121,203,3.0687361419068737,54.188907441396005
Task_22571,2719,170,54,13,67,15.900584795321638,48.25464986387871
Task_22572,2079,873,169,20,189,2.3787185354691074,41.99714054631422
Task_22573,2471,838,115,185,300,2.945172824791418,49.72444241285725
Task_22574,1866,501,10,191,201,3.7171314741035855,38.64349280331273
Task_22575,2667,380,135,19,154,7.0,49.265642332839484
Task_22576,2138,972,191,197,388,2.197327852004111,45.280234454390666
Task_22577,1978,283,25,45,70,6.964788732394366,37.25204899000081
Task_22578,1352,873,21,111,132,1.5469107551487413,30.936438428616906
Task_22579,1071,740,83,61,144,1.4453441295546559,25.574910856298988
Task_22580,853,299,85,114,199,2.8433333333333333,21.89044724202094
Task_22581,1989,746,75,118,193,2.6626506024096384,41.35568198088759
Task_22582,2470,639,82,64,146,3.859375,47.62556258748805
Task_22583,1725,693,149,53,202,2.4855907780979827,36.40949322393095
Task_22584,1685,942,27,112,139,1.7868504772004241,36.47571778834416
Task_22585,1521,630,65,44,109,2.410459587955626,31.74029514041499
Task_22586,2786,866,56,153,209,3.2133794694348325,54.50473042813751
Task_22587,1929,281,166,10,176,6.840425531914893,37.5714576680899
Task_22588,1771,849,129,160,289,2.083529411764706,38.58167256813622
Task_22589,563,629,104,135,239,0.8936507936507937,18.424252470693844
Task_22590,885,671,29,128,157,1.3169642857142858,22.975598916109963
Task_22591,2114,404,94,114,208,5.219753086419753,42.255943375021864
Task_22592,2167,188,86,96,182,11.465608465608465,42.06071416315426
Task_22593,1106,898,199,69,268,1.2302558398220245,27.44334185834138
Task_22594,1864,365,107,184,291,5.092896174863388,38.56521515686238
Task_22595,2112,401,75,180,255,5.253731343283582,42.575306858054226
Task_22596,2857,532,79,61,140,5.360225140712946,53.29041334598628
Task_22597,2061,895,19,96,115,2.3002232142857144,42.13034880550519
Task_22598,620,368,12,61,73,1.6802168021680217,16.335662518241204
Task_22599,2640,939,43,140,183,2.8085106382978724,51.95603632780533
Task_22600,2639,1013,52,50,102,2.6025641025641026,50.670515907243946
Task_22601,2232,260,200,120,320,8.551724137931034,44.062224558758174
Task_22602,1176,699,147,84,231,1.68,28.012477940685656
Task_22603,1753,764,57,111,168,2.291503267973856,37.38475610452219
Task_22604,2719,75,67,155,222,35.776315789473685,49.790162294655026
Task_22605,1783,933,196,24,220,1.9089935760171306,37.792718217311396
Task_22606,1457,671,147,83,230,2.168154761904762,32.37985406308637
Task_22607,2345,690,109,74,183,3.393632416787265,46.021526686353724
Task_22608,1641,1022,88,111,199,1.6041055718475072,36.5878392205199
Task_22609,1311,628,130,148,278,2.0842607313195547,30.53794649205945
Task_22610,1813,469,45,50,95,3.8574468085106384,35.84694877966704
Task_22611,2910,83,164,187,351,34.642857142857146,53.42509579558265
Task_22612,2868,382,10,159,169,7.488250652741514,53.73694041309048
Task_22613,1472,743,74,20,94,1.978494623655914,31.19390907235098
Task_22614,1693,426,53,173,226,3.9648711943793913,35.91875718460925
Task_22615,2687,677,46,137,183,3.9631268436578173,51.8939116904167
Task_22616,2620,824,59,151,210,3.175757575757576,51.74048750572911
Task_22617,2307,319,200,169,369,7.209375,45.747193044845666
Task_22618,2752,299,121,137,258,9.173333333333334,52.16650323734816
Task_22619,908,837,104,33,137,1.0835322195704058,23.07090194341184
Task_22620,1852,450,48,30,78,4.106430155210643,35.92779382430506
Task_22621,2673,878,61,123,184,3.0409556313993176,52.390716870776686
Task_22622,2814,875,107,99,206,3.212328767123288,54.71042883960589
Task_22623,1207,134,77,102,179,8.940740740740742,26.23919112189589
Task_22624,2406,272,46,174,220,8.813186813186814,46.51789237202837
Task_22625,1466,113,89,117,206,12.859649122807017,30.36387123095959
Task_22626,1447,551,162,194,356,2.621376811594203,32.86900102777123
Task_22627,972,907,76,193,269,1.0704845814977975,26.00370539853503
Task_22628,1235,255,199,142,341,4.82421875,28.41724950569349
Task_22629,996,204,70,104,174,4.8585365853658535,23.73483879965455
Task_22630,1615,803,105,61,166,2.0087064676616917,34.59691570295537
Task_22631,1698,319,36,72,108,5.30625,34.15813507809339
Task_22632,2787,725,163,163,326,3.8388429752066116,54.46041800712652
Task_22633,1723,119,82,184,266,14.358333333333333,34.99458545613033
Task_22634,604,467,109,96,205,1.2905982905982907,18.366608298689513
Task_22635,2576,680,112,149,261,3.7826725403817916,50.66238101243414
Task_22636,863,199,54,40,94,4.315,19.842341795395257
Task_22637,1242,86,182,121,303,14.275862068965518,26.98279877548283
Task_22638,2256,90,34,96,130,24.791208791208792,41.68856379357819
Task_22639,898,861,69,125,194,1.0417633410672853,24.244661147491367
Task_22640,2614,123,147,19,166,21.080645161290324,47.366048066820355
Task_22641,1686,981,152,63,215,1.7169042769857434,36.69950416435034
Task_22642,1147,836,102,130,232,1.3703703703703705,28.292309117666036
Task_22643,1566,121,54,14,68,12.836065573770492,29.663638080899347
Task_22644,950,712,13,69,82,1.332398316970547,23.215024847933403
Task_22645,926,787,62,199,261,1.1751269035532994,24.970161648529913
Task_22646,767,485,160,132,292,1.5781893004115226,21.47370319455854
Task_22647,1671,217,177,170,347,7.665137614678899,35.23991029980448
Task_22648,507,375,197,174,371,1.3484042553191489,17.434603352379167
Task_22649,1792,262,143,43,186,6.813688212927756,35.56906432696473
Task_22650,1371,783,181,144,325,1.7487244897959184,32.16423021736105
Task_22651,2542,893,46,194,240,2.843400447427293,50.79852452651204
Task_22652,1005,882,40,173,213,1.1381653454133636,26.082443670127958
Task_22653,2153,610,124,132,256,3.523731587561375,43.69376929164713
Task_22654,1985,366,137,159,296,5.408719346049046,40.46860141278607
Task_22655,2686,151,80,119,199,17.67105263157895,50.05166669491419
Task_22656,593,308,34,172,206,1.919093851132686,17.905474627726115
Task_22657,2566,851,107,184,291,3.011737089201878,51.22830889253341
Task_22658,2301,379,42,171,213,6.0552631578947365,45.16818254865547
Task_22659,1480,642,28,149,177,2.301710730948678,32.66747970399526
Task_22660,540,492,54,49,103,1.0953346855983772,15.73529799064415
Task_22661,1892,594,194,52,246,3.179831932773109,38.935229165001964
Task_22662,1433,445,25,20,45,3.213004484304933,28.839287919375767
Task_22663,2121,807,68,26,94,2.625,41.78022078466977
Task_22664,1343,659,153,122,275,2.0348484848484847,31.09003705472567
Task_22665,2520,250,41,38,79,10.0398406374502,45.890990041672325
Task_22666,1731,299,41,29,70,5.77,33.43097230080165
Task_22667,1112,335,151,165,316,3.3095238095238093,26.65705039077032
Task_22668,1629,337,80,125,205,4.819526627218935,34.408850544129265
Task_22669,632,799,169,142,311,0.79,20.416467901443376
Task_22670,2158,529,172,98,270,4.071698113207547,43.53189570763973
Task_22671,2852,505,142,167,309,5.636363636363637,54.71584514184053
Task_22672,2443,446,125,65,190,5.465324384787472,46.9100800069315
Task_22673,676,372,94,144,238,1.8123324396782843,19.579700228007635
Task_22674,1948,745,199,133,332,2.611260053619303,41.21545391064567
Task_22675,1564,719,121,71,192,2.172222222222222,33.89144781103302
Task_22676,750,400,143,12,155,1.8703241895261846,19.127971757059573
Task_22677,1905,658,17,180,197,2.890743550834598,39.65961651482983
Task_22678,1485,858,22,63,85,1.728754365541327,32.0628386337386
Task_22679,1656,811,77,178,255,2.039408866995074,36.640336160749115
Task_22680,2269,847,56,139,195,2.6757075471698113,46.17008780726786
Task_22681,1225,185,178,182,360,6.586021505376344,28.00907339683218
Task_22682,1172,830,136,105,241,1.4103489771359807,28.66670156577025
Task_22683,1244,306,92,12,104,4.052117263843648,26.303631913308067
Task_22684,2476,890,135,138,273,2.7789001122334454,49.77570867285058
Task_22685,2684,676,82,150,232,3.964549483013294,52.32357385106514
Task_22686,2730,331,45,153,198,8.22289156626506,51.684087557828924
Task_22687,2417,633,101,182,283,3.812302839116719,48.14271844692481
Task_22688,887,79,28,54,82,11.0875,19.36121516948361
Task_22689,2806,544,72,167,239,5.148623853211009,53.925264540788646
Task_22690,1156,163,73,42,115,7.048780487804878,24.353036087477822
Task_22691,2991,141,187,130,317,21.06338028169014,55.21120882811431
Task_22692,2452,562,69,146,215,4.355239786856128,48.23325423992163
Task_22693,2175,560,50,148,198,3.877005347593583,43.83493983485899
Task_22694,1841,271,111,113,224,6.768382352941177,37.47884859714406
Task_22695,827,396,175,107,282,2.0831234256926954,22.104808477188232
Task_22696,1157,169,143,176,319,6.805882352941176,26.565842687111594
Task_22697,2414,901,110,106,216,2.6762749445676275,48.52385079276331
Task_22698,1004,521,185,106,291,1.9233716475095786,25.338561275918362
Task_22699,2962,708,139,190,329,4.1777150916784205,57.231885859434705
Task_22700,2214,938,173,184,357,2.357827476038339,46.219937669452236
Task_22701,1485,953,55,93,148,1.5566037735849056,33.42302876558093
Task_22702,1500,150,183,136,319,9.933774834437086,31.800395263827095
Task_22703,605,795,65,157,222,0.7600502512562815,19.664149805682552
Task_22704,2878,237,122,31,153,12.092436974789916,52.32750411155454
Task_22705,1453,232,18,152,170,6.236051502145923,30.81586123620907
Task_22706,2158,272,70,28,98,7.904761904761905,40.703116224930476
Task_22707,2290,762,72,155,227,3.001310615989515,46.372651438581016
Task_22708,806,814,69,149,218,0.9889570552147239,22.845549126727366
Task_22709,1655,94,104,45,149,17.42105263157895,31.636202357364095
Task_22710,2649,903,20,158,178,2.9303097345132745,51.96104905806317
Task_22711,1207,152,170,30,200,7.888888888888889,25.945829046298268
Task_22712,2503,175,178,137,315,14.221590909090908,47.62655322098609
Task_22713,1391,470,111,185,296,2.9532908704883227,31.442732743219896
Task_22714,2102,583,32,194,226,3.5993150684931505,42.7958316446388
Task_22715,1492,997,62,150,212,1.4949899799599198,34.3482715411962
Task_22716,727,620,57,33,90,1.1706924315619969,19.08171693116826
Task_22717,2590,379,19,25,44,6.815789473684211,47.1124589176743
Task_22718,955,992,36,148,184,0.9617321248741189,25.243865196076484
Task_22719,2046,439,19,15,34,4.65,38.36639402128719
Task_22720,943,401,63,68,131,2.345771144278607,22.75688869679109
Task_22721,1571,340,76,142,218,4.607038123167156,33.59580104870294
Task_22722,1732,416,17,134,151,4.15347721822542,35.54355201567014
Task_22723,2618,513,16,130,146,5.093385214007782,49.91445131544318
Task_22724,684,489,78,99,177,1.3959183673469389,19.51965231318071
Task_22725,2854,886,67,67,134,3.217587373167982,54.52683724872244
Task_22726,742,855,121,12,133,0.866822429906542,20.440368213148265
Task_22727,722,486,91,139,230,1.482546201232033,20.548586332666503
Task_22728,1903,306,40,137,177,6.198697068403908,38.232972252644
Task_22729,1631,657,60,125,185,2.478723404255319,35.242186948428966
Task_22730,1433,597,34,22,56,2.3963210702341136,29.666328274337804
Task_22731,1672,689,34,22,56,2.4231884057971014,33.74004771548016
Task_22732,2667,746,175,115,290,3.570281124497992,52.393080291900084
Task_22733,2855,705,170,25,195,4.043909348441926,53.953721738103134
Task_22734,1331,436,169,115,284,3.045766590389016,30.228247983332135
Task_22735,2742,790,92,182,274,3.4664981036662454,53.82335928803596
Task_22736,802,100,80,67,147,7.9405940594059405,18.695362753657005
Task_22737,1061,505,185,105,290,2.0968379446640317,26.184828246720812
Task_22738,840,834,154,92,246,1.0059880239520957,23.229864620030142
Task_22739,1276,890,69,42,111,1.4320987654320987,28.76810183518774
Task_22740,830,547,182,56,238,1.5145985401459854,21.910971256012918
Task_22741,1391,351,73,161,234,3.9517045454545454,30.873397323783863
Task_22742,839,554,174,109,283,1.5117117117117118,22.754795101182584
Task_22743,2753,149,30,99,129,18.35333333333333,50.19663973550161
Task_22744,1776,333,196,14,210,5.317365269461078,35.62973785278531
Task_22745,896,405,170,140,310,2.206896551724138,23.399642431320657
Task_22746,2302,842,21,113,134,2.730723606168446,45.898280884214806
Task_22747,1096,718,40,100,140,1.5243393602225312,26.382353085936
Task_22748,2222,803,92,182,274,2.763681592039801,45.625763861357996
Task_22749,612,746,186,48,234,0.8192771084337349,18.836581210125953
Task_22750,2430,564,89,108,197,4.300884955752212,47.67275462500456
Task_22751,2280,167,165,112,277,13.571428571428571,43.96481909152161
Task_22752,2704,649,180,199,379,4.16,53.19666536994902
Task_22753,2516,733,65,33,98,3.4277929155313354,47.72438383139456
Task_22754,511,505,41,16,57,1.0098814229249011,14.686040779570803
Task_22755,1001,193,150,143,293,5.15979381443299,24.299923622355333
Task_22756,1775,449,110,77,187,3.9444444444444446,36.39741859569358
Task_22757,1804,1022,144,100,244,1.7634408602150538,39.33803557471259
Task_22758,2978,595,59,151,210,4.996644295302014,56.686416676007525
Task_22759,1461,618,96,50,146,2.360258481421648,31.336456091323765
Task_22760,848,812,136,136,272,1.0430504305043051,23.60299671073729
Task_22761,1106,135,118,92,210,8.132352941176471,24.75982844455872
Task_22762,864,296,176,145,321,2.909090909090909,22.60266295910831
Task_22763,2016,712,180,50,230,2.8274894810659186,40.97107117461526
Task_22764,1675,899,125,98,223,1.8611111111111112,36.8310596375071
Task_22765,2110,416,20,143,163,5.059952038369304,41.79880667724792
Task_22766,1699,620,66,21,87,2.7359098228663448,34.27486506815058
Task_22767,2292,708,36,106,142,3.232722143864598,45.3643232927873
Task_22768,1533,581,23,158,181,2.634020618556701,33.401226266659606
Task_22769,1210,90,10,134,144,13.296703296703297,25.321149116541637
Task_22770,1472,209,159,120,279,7.0095238095238095,31.689162035427895
Task_22771,2477,620,65,188,253,3.9887278582930756,49.05063584820369
Task_22772,2498,314,184,119,303,7.93015873015873,48.37949563854891
Task_22773,2094,799,48,121,169,2.6175,42.880279985452724
Task_22774,1216,846,66,190,256,1.435655253837072,29.726999187712327
Task_22775,875,645,115,100,215,1.3544891640866874,23.290795888356097
Task_22776,2385,1015,46,68,114,2.34744094488189,47.37346217405343
Task_22777,1950,967,76,30,106,2.0144628099173554,39.67094741509416
Task_22778,1392,1022,73,46,119,1.3607038123167154,31.090848308091935
Task_22779,1989,696,196,99,295,2.8536585365853657,41.47991514572177
Task_22780,1189,549,66,162,228,2.1618181818181816,28.276321702491654
Task_22781,1690,905,145,123,268,1.8653421633554084,37.323560900358835
Task_22782,1053,162,174,177,351,6.460122699386503,25.025082708500335
Task_22783,1168,296,169,153,322,3.9326599326599325,27.425064349974956
Task_22784,666,508,192,146,338,1.3084479371316307,20.164514858051426
Task_22785,1843,987,159,184,343,1.8653846153846154,40.43019974511021
Task_22786,2533,394,82,22,104,6.412658227848102,46.94937899542587
Task_22787,608,937,63,162,225,0.6481876332622601,20.30973921981584
Task_22788,851,438,81,174,255,1.938496583143508,22.697165582465953
Task_22789,2043,809,66,53,119,2.522222222222222,41.097201355723804
Task_22790,1087,769,143,65,208,1.4116883116883117,26.521556175331128
Task_22791,2738,775,186,64,250,3.5283505154639174,52.898932532580055
Task_22792,1152,691,14,18,32,1.6647398843930636,25.098678656114526
Task_22793,765,824,49,43,92,0.9272727272727272,20.496071674112518
Task_22794,2766,851,97,196,293,3.2464788732394365,54.447457589788904
Task_22795,780,317,33,30,63,2.452830188679245,18.49102609901937
Task_22796,2346,480,116,62,178,4.877338877338877,45.195929805021784
Task_22797,714,670,45,68,113,1.0640834575260805,19.657792318240297
Task_22798,2436,770,92,41,133,3.159533073929961,47.17828864000193
Task_22799,2520,864,66,98,164,2.913294797687861,49.85418951997738
Task_22800,2078,445,76,134,210,4.6591928251121075,41.912542241900795
Task_22801,1539,745,178,189,367,2.0630026809651474,34.97604975980261
Task_22802,2718,477,174,71,245,5.686192468619247,51.63834722619051
Task_22803,2052,877,102,55,157,2.337129840546697,41.666139456165574
Task_22804,2718,803,194,143,337,3.3805970149253732,53.6332451695823
Task_22805,2769,1017,197,88,285,2.7200392927308448,54.54384484913623
Task_22806,782,692,183,158,341,1.1284271284271283,22.498032624680718
Task_22807,580,219,60,45,105,2.6363636363636362,15.32700982612922
Task_22808,1660,638,18,151,169,2.5978090766823163,35.399390635114116
Task_22809,1145,355,68,96,164,3.216292134831461,26.5069969606224
Task_22810,1253,257,90,139,229,4.8565891472868215,28.24849152365914
Task_22811,1008,895,191,178,369,1.125,26.862901945915123
Task_22812,2931,218,37,170,207,13.383561643835616,54.529055200533726
Task_22813,2749,983,147,27,174,2.7936991869918697,52.99367914712237
Task_22814,2151,472,177,87,264,4.547568710359408,42.93739677230334
Task_22815,2386,183,190,144,334,12.967391304347826,46.1519037713027
Task_22816,2680,220,59,117,176,12.126696832579185,50.33449506946881
Task_22817,1580,703,172,197,369,2.2443181818181817,35.51514180911909
Task_22818,2157,99,131,97,228,21.57,41.07768834321313
Task_22819,1488,942,97,127,224,1.5779427359490987,34.02611418214768
Task_22820,2426,415,199,60,259,5.831730769230769,46.772353915188695
Task_22821,2521,165,59,161,220,15.186746987951807,47.700369799067296
Task_22822,1108,553,129,186,315,2.0,27.310938466299607
Task_22823,2567,808,42,109,151,3.173053152039555,50.05006735617505
Task_22824,2631,330,121,120,241,7.948640483383686,50.26018806703221
Task_22825,2815,558,128,52,180,5.035778175313059,52.96110084147858
Task_22826,2002,776,184,46,230,2.5765765765765765,40.875783487335276
Task_22827,2544,83,170,148,318,30.285714285714285,47.48201918911163
Task_22828,2984,242,95,78,173,12.279835390946502,54.83893173886376
Task_22829,2496,193,150,111,261,12.8659793814433,47.70230282664587
Task_22830,1428,706,94,114,208,2.01980198019802,32.35324429135184
Task_22831,2703,299,50,198,248,9.01,51.625627003169434
Task_22832,1937,717,82,195,277,2.6977715877437327,40.88890400469557
Task_22833,2909,111,142,105,247,25.973214285714285,53.03844128538876
Task_22834,1709,105,97,106,203,16.12264150943396,33.97072349070314
Task_22835,1649,581,87,193,280,2.8333333333333335,35.826727573200515
Task_22836,1918,1001,184,196,380,1.9141716566866267,41.846547854572954
Task_22837,1243,481,197,177,374,2.578838174273859,29.474591815920416
Task_22838,1675,769,99,112,211,2.175324675324675,36.39114151250167
Task_22839,582,584,143,81,224,0.9948717948717949,18.179498378563114
Task_22840,2734,542,41,62,103,5.0349907918968695,50.991729474115324
Task_22841,2742,616,120,101,221,4.4440842787682335,52.83771404325224
Task_22842,1808,376,54,176,230,4.795755968169761,37.58785418930312
Task_22843,667,616,127,33,160,1.0810372771474879,18.62880173799348
Task_22844,2077,71,103,26,129,28.84722222222222,37.96387676457575
Task_22845,971,622,19,73,92,1.5585874799357946,23.392739244388014
Task_22846,745,935,183,116,299,0.7959401709401709,22.53492843044731
Task_22847,1009,475,185,111,296,2.119747899159664,25.303178168207968
Task_22848,713,574,178,108,286,1.24,20.75346773170114
Task_22849,2868,408,86,192,278,7.012224938875305,54.58864288526741
Task_22850,1360,309,129,110,239,4.387096774193548,30.066422188263232
Task_22851,2082,202,96,130,226,10.25615763546798,41.1214438664382
Task_22852,1165,983,166,78,244,1.1839430894308942,28.76827954757664
Task_22853,1386,435,140,13,153,3.1788990825688073,29.250449873714683
Task_22854,847,103,82,179,261,8.14423076923077,20.828143902825374
Task_22855,566,664,66,102,168,0.8511278195488722,18.09649770411416
Task_22856,2552,417,35,17,52,6.105263157894737,46.6115649092761
Task_22857,2512,196,97,172,269,12.751269035532994,48.06544336000917
Task_22858,618,126,172,152,324,4.866141732283465,17.783488730310857
Task_22859,2959,142,185,178,363,20.692307692307693,55.015496289592114
Task_22860,2872,881,117,138,255,3.256235827664399,55.94104496327399
Task_22861,1941,677,144,155,299,2.8628318584070795,40.774840711075996
Task_22862,2907,192,194,24,218,15.062176165803109,53.227505920842084
Task_22863,1417,845,58,162,220,1.6749408983451537,32.79344696478253
Task_22864,1373,128,62,98,160,10.643410852713178,28.484649128742507
Task_22865,686,473,125,116,241,1.4472573839662448,19.875046303009885
Task_22866,2340,923,113,73,186,2.5324675324675323,46.679125574453735
Task_22867,1685,78,112,188,300,21.329113924050635,33.91824471618475
Task_22868,2330,906,108,177,285,2.5689084895259096,47.62351191895137
Task_22869,2449,72,126,102,228,33.54794520547945,45.39931821815356
Task_22870,1941,82,70,141,211,23.3855421686747,37.63188185935841
Task_22871,1596,136,129,126,255,11.64963503649635,32.92448210765291
Task_22872,2820,279,84,182,266,10.071428571428571,53.31886307971005
Task_22873,1942,508,170,181,351,3.8153241650294696,40.52843949094899
Task_22874,1799,711,20,39,59,2.526685393258427,35.728681455820954
Task_22875,2451,211,55,119,174,11.56132075471698,46.771942429553796
Task_22876,888,358,36,50,86,2.4735376044568245,20.80952615405738
Task_22877,2091,485,182,111,293,4.302469135802469,42.449564949131236
Task_22878,2350,959,199,158,357,2.4479166666666665,48.40232702877367
Task_22879,1810,562,184,99,283,3.2149200710479575,38.1685981204972
Task_22880,1644,1018,93,55,148,1.6133464180569186,35.752742664622374
Task_22881,1737,665,161,76,237,2.608108108108108,36.749266848160026
Task_22882,513,667,23,96,119,0.7679640718562875,16.870314639191793
Task_22883,2479,781,173,25,198,3.170076726342711,48.25033160234819
Task_22884,2685,488,56,197,253,5.49079754601227,51.967030113622336
Task_22885,1789,721,77,17,94,2.4778393351800556,36.11599060953469
Task_22886,664,222,171,84,255,2.977578475336323,18.520850040676976
Task_22887,1231,820,172,117,289,1.4993909866017052,29.830030707216164
Task_22888,1402,592,41,163,204,2.3642495784148396,31.567221720590112
Task_22889,1451,439,154,75,229,3.297727272727273,31.46628007841395
Task_22890,1129,106,99,179,278,10.551401869158878,25.281597881916284
Task_22891,2029,139,125,12,137,14.492857142857142,38.0394974844217
Task_22892,559,356,185,24,209,1.5658263305322129,16.558551716458208
Task_22893,2469,651,34,18,52,3.78680981595092,46.055107833485124
Task_22894,726,693,158,75,233,1.0461095100864553,20.751298315970526
Task_22895,2315,253,58,49,107,9.114173228346457,43.11016705872649
Task_22896,2201,870,14,189,203,2.5269804822043627,45.15758571154725
Task_22897,517,822,168,50,218,0.6281895504252734,17.892242781828173
Task_22898,1022,474,18,69,87,2.1515789473684213,23.56517841737794
Task_22899,2128,619,127,172,299,3.432258064516129,43.578758902815075
Task_22900,1268,975,41,109,150,1.2991803278688525,29.80620171746204
Task_22901,1686,433,48,196,244,3.8847926267281108,35.89887274738871
Task_22902,1320,759,109,113,222,1.736842105263158,30.77193478884749
Task_22903,2097,851,180,197,377,2.461267605633803,44.203999996982255
Task_22904,1509,1013,155,37,192,1.4881656804733727,33.65748558497588
Task_22905,680,152,194,168,362,4.444444444444445,19.126212554878375
Task_22906,2075,424,51,16,67,4.882352941176471,39.058017219966224
Task_22907,2582,197,179,179,358,13.04040404040404,49.653196342267115
Task_22908,2518,717,60,147,207,3.5069637883008355,49.74214626933491
Task_22909,1156,611,75,27,102,1.8888888888888888,25.9803579047488
Task_22910,1229,120,187,152,339,10.15702479338843,27.427364817867215
Task_22911,2515,563,180,112,292,4.459219858156028,49.40975507365005
Task_22912,536,449,68,46,114,1.191111111111111,15.869018629086652
Task_22913,2395,484,75,92,167,4.938144329896907,46.534501847811605
Task_22914,1657,339,123,170,293,4.873529411764705,35.19360540842141
Task_22915,2718,850,42,104,146,3.1938895417156288,52.58021328464195
Task_22916,1815,239,103,154,257,7.5625,37.164334653698816
Task_22917,2640,661,165,152,317,3.987915407854985,51.8727271757621
Task_22918,1750,846,162,154,316,2.0661157024793386,38.35249762999188
Task_22919,2222,751,135,135,270,2.9547872340425534,45.298391100940115
Task_22920,1182,231,160,42,202,5.094827586206897,26.029166669819926
Task_22921,850,661,61,119,180,1.283987915407855,22.68091786543988
Task_22922,2288,438,41,105,146,5.211845102505695,44.46061825552118
Task_22923,2397,472,192,44,236,5.067653276955602,46.189048575811704
Task_22924,2136,276,63,108,171,7.7111913357400725,41.84244409794682
Task_22925,2213,882,20,89,109,2.506228765571914,44.27220042967559
Task_22926,1647,762,160,86,246,2.1585845347313235,35.77958210424781
Task_22927,2408,637,169,44,213,3.774294670846395,46.78768641489436
Task_22928,1052,781,110,142,252,1.3452685421994885,26.745239910722958
Task_22929,1609,816,101,120,221,1.9694002447980417,35.54709459092788
Task_22930,2497,651,138,54,192,3.829754601226994,48.413142505260396
Task_22931,776,954,128,77,205,0.812565445026178,22.292516230536407
Task_22932,1907,775,179,41,220,2.457474226804124,39.329901022881394
Task_22933,2926,968,164,15,179,3.019607843137255,55.53532392670663
Task_22934,2030,237,74,45,119,8.529411764705882,38.67613066976238
Task_22935,1622,78,69,200,269,20.531645569620252,32.90230325722348
Task_22936,1529,435,188,123,311,3.506880733944954,33.49215941506925
Task_22937,894,674,41,19,60,1.3244444444444445,21.11147334513392
Task_22938,1369,851,163,97,260,1.6068075117370892,32.01561756787169
Task_22939,2815,82,26,169,195,33.91566265060241,51.24782794385882
Task_22940,1812,802,191,52,243,2.25653798256538,38.30691318978686
Task_22941,835,217,165,161,326,3.830275229357798,21.931169389261886
Task_22942,1199,122,27,188,215,9.747967479674797,26.449021341353568
Task_22943,2112,214,120,31,151,9.82325581395349,40.16089664230128
Task_22944,1423,718,37,14,51,1.9791376912378302,29.655843316979016
Task_22945,500,480,67,198,265,1.0395010395010396,17.184097446620598
Task_22946,1790,778,161,133,294,2.2978177150192556,38.6442916675016
Task_22947,1053,461,33,188,221,2.279220779220779,25.77826599870076
Task_22948,895,115,117,82,199,7.7155172413793105,21.145017713501392
Task_22949,1906,239,139,140,279,7.941666666666666,38.68051000872733
Task_22950,1915,285,108,92,200,6.695804195804196,38.457229770388146
Task_22951,2644,273,102,197,299,9.64963503649635,50.63860704292114
Task_22952,1184,618,160,114,274,1.9127625201938612,28.42745142315765
Task_22953,2319,844,199,80,279,2.744378698224852,46.80111727267559
Task_22954,2376,689,46,77,123,3.4434782608695653,46.374118348823124
Task_22955,2624,756,142,34,176,3.466314398943197,50.27335076405697
Task_22956,2014,924,24,129,153,2.1772972972972973,41.70000424919076
Task_22957,2307,386,47,129,176,5.961240310077519,44.938586400248106
Task_22958,1107,723,77,169,246,1.5290055248618784,27.5761938365889
Task_22959,2845,854,188,171,359,3.327485380116959,55.945701201271355
Task_22960,2682,809,46,101,147,3.311111111111111,51.90012096139453
Task_22961,2515,681,92,163,255,3.687683284457478,49.77031892995847
Task_22962,592,634,168,30,198,0.9322834645669291,18.07823540240278
Task_22963,1538,173,132,52,184,8.839080459770114,31.23916577862808
Task_22964,1567,197,192,128,320,7.914141414141414,33.387163847532186
Task_22965,2078,865,81,166,247,2.399538106235566,43.41895465329943
Task_22966,2041,857,80,180,260,2.378787878787879,42.91047955699032
Task_22967,1542,532,81,77,158,2.893058161350844,32.71740087202471
Task_22968,2047,433,99,175,274,4.716589861751152,41.59503288342583
Task_22969,2819,582,53,96,149,4.835334476843911,53.53940632414942
Task_22970,2081,676,15,113,128,3.073855243722304,42.09514067874236
Task_22971,1210,149,35,107,142,8.066666666666666,25.901258005587763
Task_22972,1074,852,82,45,127,1.2590855803048067,25.567524701715865
Task_22973,2171,215,99,153,252,10.050925925925926,42.67618015237588
Task_22974,1407,562,134,91,225,2.4991119005328595,31.3827067645416
Task_22975,1613,163,199,109,308,9.835365853658537,33.56468394661426
Task_22976,586,849,177,30,207,0.6894117647058824,18.859737831959134
Task_22977,1446,962,192,49,241,1.5015576323987538,32.777762088801914
Task_22978,1148,740,15,62,77,1.5492577597840755,25.919466412544278
Task_22979,2244,280,133,19,152,7.98576512455516,42.22361173398369
Task_22980,551,310,23,13,36,1.7717041800643087,14.39955691042583
Task_22981,2386,746,65,193,258,3.1941097724230256,48.03700391810449
Task_22982,1365,601,140,35,175,2.2674418604651163,29.939743039679417
Task_22983,1325,197,30,87,117,6.691919191919192,28.227330060284913
Task_22984,1261,881,21,64,85,1.4297052154195011,28.560631494403538
Task_22985,1153,522,33,18,51,2.204588910133843,24.807361675587856
Task_22986,2480,725,197,76,273,3.4159779614325068,48.86936752027699
Task_22987,2964,793,64,144,208,3.7329974811083124,57.04722622711463
Task_22988,1216,118,97,63,160,10.218487394957982,25.485568353719838
Task_22989,2662,441,156,159,315,6.02262443438914,51.51432437055782
Task_22990,1525,364,121,87,208,4.178082191780822,32.42857616901819
Task_22991,2196,517,115,190,305,4.239382239382239,44.38445396833206
Task_22992,723,297,190,95,285,2.4261744966442955,20.11300620513944
Task_22993,1918,215,148,191,339,8.87962962962963,39.127469884387516
Task_22994,1518,183,69,169,238,8.25,32.17796196448272
Task_22995,2719,279,104,77,181,9.710714285714285,50.58441443018697
Task_22996,2496,242,15,52,67,10.271604938271604,45.66178248613256
Task_22997,2775,282,123,103,226,9.80565371024735,52.27504234273507
Task_22998,866,512,15,196,211,1.6881091617933723,22.92587879962761
Task_22999,839,322,14,114,128,2.5975232198142413,21.31383958235781
Task_23000,1935,781,21,74,95,2.4744245524296673,39.20071994482158
Task_23001,755,587,55,104,159,1.284013605442177,20.684439744249765
Task_23002,1053,453,37,27,64,2.3193832599118944,23.15165065240127
Task_23003,2920,126,22,143,165,22.992125984251967,53.02963057459875
Task_23004,859,397,126,33,159,2.158291457286432,21.00459468447097
Task_23005,2886,183,75,192,267,15.684782608695652,53.954117831263346
Task_23006,2100,733,113,181,294,2.861035422343324,43.484852090985015
Task_23007,2343,166,32,164,196,14.029940119760479,44.65445396044054
Task_23008,2345,767,71,14,85,3.0533854166666665,44.95117118531357
Task_23009,1144,404,38,24,62,2.8246913580246913,24.436323042399874
Task_23010,1479,118,118,134,252,12.428571428571429,30.912253554217596
Task_23011,834,583,107,60,167,1.428082191780822,21.49517807126581
Task_23012,2972,410,178,153,331,7.231143552311435,56.3807354223174
Task_23013,2494,212,120,127,247,11.708920187793428,47.70218685605129
Task_23014,983,969,175,103,278,1.01340206185567,26.18795041004743
Task_23015,2607,580,175,166,341,4.487091222030981,51.22097845819815
Task_23016,2626,955,136,109,245,2.7468619246861925,52.18682319431789
Task_23017,2109,76,149,35,184,27.38961038961039,38.95353483136451
Task_23018,2272,330,110,45,155,6.86404833836858,43.048689628573186
Task_23019,1155,1014,83,118,201,1.1379310344827587,28.819933547151493
Task_23020,649,349,25,46,71,1.8542857142857143,16.494046489974306
Task_23021,2749,650,80,106,186,4.22273425499232,52.89966088280346
Task_23022,555,467,46,194,240,1.185897435897436,17.86805071070425
Task_23023,2238,1024,194,18,212,2.1834146341463416,45.06131535277982
Task_23024,989,972,102,100,202,1.0164439876670093,25.956181434501364
Task_23025,1906,450,14,104,118,4.226164079822617,38.351133387775604
Task_23026,2139,211,54,97,151,10.089622641509434,41.50739410361691
Task_23027,2798,437,172,136,308,6.3881278538812785,53.58833984711904
Task_23028,2647,921,80,160,240,2.870932754880694,52.59293940385928
Task_23029,2155,522,185,80,265,4.120458891013384,43.124568341624716
Task_23030,2827,897,161,113,274,3.148106904231626,55.32711639092253
Task_23031,1905,492,133,67,200,3.864097363083164,38.60291290348344
Task_23032,561,882,186,181,367,0.6353340883352209,19.930685073959253
Task_23033,1358,354,83,161,244,3.825352112676056,30.33285201342689
Task_23034,2863,460,58,117,175,6.210412147505423,54.15487978251824
Task_23035,957,373,191,29,220,2.5588235294117645,23.038173355107915
Task_23036,750,966,192,130,322,0.7755946225439504,22.818597865835187
Task_23037,644,674,96,85,181,0.9540740740740741,19.11151777369293
Task_23038,2917,568,12,13,25,5.126537785588752,52.644514403401416
Task_23039,1716,969,65,133,198,1.7690721649484535,37.74540060288586
Task_23040,2323,313,133,94,227,7.398089171974522,45.174078169837685
Task_23041,1805,304,38,35,73,5.918032786885246,34.60520231898794
Task_23042,1835,776,127,60,187,2.3616473616473614,38.191561260798245
Task_23043,1933,945,155,85,240,2.043340380549683,40.84174882147676
Task_23044,2695,556,152,18,170,4.838420107719928,50.42237437702244
Task_23045,2039,559,119,83,202,3.6410714285714287,41.1181507083737
Task_23046,610,546,30,177,207,1.1151736745886653,18.723632983811655
Task_23047,2111,574,126,97,223,3.671304347826087,42.74805970128432
Task_23048,1120,988,154,23,177,1.1324570273003034,27.12667753740205
Task_23049,2685,957,146,17,163,2.8027139874739038,51.580827624426
Task_23050,800,952,109,149,258,0.8394543546694648,23.27516089930457
Task_23051,696,727,113,48,161,0.9560439560439561,19.548008889063734
Task_23052,1887,177,99,71,170,10.601123595505618,36.60671552467613
Task_23053,2379,607,172,188,360,3.9128289473684212,47.81422861641553
Task_23054,1885,606,169,144,313,3.1054365733113674,39.711324034415064
Task_23055,1226,761,182,84,266,1.6089238845144358,29.155159824052543
Task_23056,2245,895,200,196,396,2.505580357142857,46.770480052193214
Task_23057,1253,621,137,28,165,2.014469453376206,28.14988008130297
Task_23058,761,741,165,163,328,1.0256064690026954,22.29682938862003
Task_23059,1206,826,150,97,247,1.4582829504232164,29.241938200947374
Task_23060,1461,871,103,36,139,1.6754587155963303,31.90566625800332
Task_23061,1645,840,106,100,206,1.9560047562425684,36.09525173172376
Task_23062,2856,458,76,68,144,6.222222222222222,53.180790885708376
Task_23063,1291,815,140,60,200,1.5821078431372548,29.783463724426696
Task_23064,1063,984,81,50,131,1.0791878172588834,26.027364906925158
Task_23065,1917,279,172,184,356,6.8464285714285715,39.40680555207447
Task_23066,590,146,30,162,192,4.01360544217687,16.83026943797419
Task_23067,1998,136,14,58,72,14.583941605839415,37.162487544283486
Task_23068,2632,731,73,152,225,3.5956284153005464,51.679612029156736
Task_23069,1349,551,33,53,86,2.443840579710145,28.93478875252009
Task_23070,1163,678,52,65,117,1.7128129602356406,26.975191493693377
Task_23071,1530,687,89,187,276,2.2238372093023258,34.27910431572948
Task_23072,740,624,191,42,233,1.184,20.47133700704839
Task_23073,2716,720,85,173,258,3.766990291262136,53.075411888759696
Task_23074,1849,399,37,64,101,4.6225,36.64786899341741
Task_23075,1998,1007,119,67,186,1.9821428571428572,41.47817849636579
Task_23076,2384,143,176,24,200,16.555555555555557,44.340906186481696
Task_23077,504,472,151,192,343,1.06553911205074,17.49360631372595
Task_23078,2331,807,127,177,304,2.88490099009901,47.41556588638256
Task_23079,2533,947,79,63,142,2.6719409282700424,49.561450235746385
Task_23080,504,1004,164,73,237,0.5014925373134328,18.44730082000585
Task_23081,1405,571,118,41,159,2.4562937062937062,30.16590805669502
Task_23082,2259,346,80,14,94,6.510086455331412,42.41916697750953
Task_23083,1625,103,185,59,244,15.625,32.40365061267585
Task_23084,2953,185,106,200,306,15.876344086021506,55.05667646547272
Task_23085,2483,760,193,26,219,3.2628120893561103,48.36461912323718
Task_23086,1017,625,188,128,316,1.6246006389776357,26.00082664022034
Task_23087,2182,297,29,87,116,7.322147651006712,42.06156654406539
Task_23088,1985,751,23,78,101,2.639627659574468,40.13599280150054
Task_23089,1205,529,72,105,177,2.2735849056603774,27.97602869925633
Task_23090,2909,305,12,35,47,9.506535947712418,51.998730646547706
Task_23091,1621,945,108,53,161,1.7135306553911205,35.08570780094224
Task_23092,650,912,14,58,72,0.7119386637458927,18.78363455474184
Task_23093,2736,910,88,17,105,3.0032930845225025,51.69279321778756
Task_23094,2256,720,89,61,150,3.128987517337032,44.28399201451262
Task_23095,529,763,106,125,231,0.6924083769633508,18.379139464149382
Task_23096,1138,988,64,109,173,1.1506572295247726,28.323597536471393
Task_23097,1137,910,95,59,154,1.2480790340285401,27.121918404054387
Task_23098,1617,681,166,73,239,2.370967741935484,34.85785564428471
Task_23099,2143,329,168,72,240,6.493939393939394,42.048110961712574
Task_23100,1487,98,137,65,202,15.02020202020202,29.898398316626686
Task_23101,2411,105,165,195,360,22.745283018867923,45.81395372262572
Task_23102,2604,257,168,40,208,10.093023255813954,48.62277263356996
Task_23103,1226,1008,19,51,70,1.2150644202180376,27.92792267553912
Task_23104,695,913,89,37,126,0.7603938730853391,20.015648601201786
Task_23105,1024,598,80,68,148,1.7095158597662772,24.577791765354927
Task_23106,2510,589,156,60,216,4.254237288135593,48.470985278397485
Task_23107,2110,316,10,122,132,6.65615141955836,41.25043766370617
Task_23108,1118,693,124,138,262,1.6109510086455332,27.58358840742714
Task_23109,2840,256,83,176,259,11.050583657587548,53.5159244759406
Task_23110,1246,939,119,103,222,1.325531914893617,30.11646492071073
Task_23111,1920,254,133,197,330,7.529411764705882,39.268627710185335
Task_23112,725,352,74,88,162,2.0538243626062322,19.443534016478996
Task_23113,1102,890,199,193,392,1.2368125701459034,28.498323745319265
Task_23114,1774,891,103,67,170,1.9887892376681615,37.443809593444755
Task_23115,1305,403,127,99,226,3.23019801980198,29.41176084741571
Task_23116,1601,307,141,120,261,5.1980519480519485,33.98424576602514
Task_23117,900,669,89,87,176,1.3432835820895523,23.169684598378478
Task_23118,1039,893,144,105,249,1.162192393736018,26.77701950444667
Task_23119,1172,309,125,54,179,3.7806451612903227,26.09762227453157
Task_23120,2229,678,62,58,120,3.2827687776141383,43.521675572795665
Task_23121,1258,123,28,35,63,10.14516129032258,25.071628974578047
Task_23122,2112,998,148,151,299,2.114114114114114,44.480513541281425
Task_23123,2731,212,134,198,332,12.821596244131456,51.93132475859752
Task_23124,2477,136,72,106,178,18.080291970802918,46.30403177082109
Task_23125,2769,889,60,138,198,3.1112359550561797,54.20515054036931
Task_23126,2001,192,89,24,113,10.367875647668393,38.22950586222411
Task_23127,1879,484,89,26,115,3.8742268041237113,37.10261553579201
Task_23128,1314,915,123,195,318,1.4344978165938864,31.659259892831198
Task_23129,2416,880,101,136,237,2.742338251986379,48.628577453297815
Task_23130,887,350,11,118,129,2.527065527065527,22.03631623971208
Task_23131,2712,402,52,181,233,6.729528535980148,52.008860100696666
Task_23132,1163,199,193,154,347,5.815,27.1480845148845
Task_23133,1036,473,140,197,337,2.1856540084388185,26.035141496432647
Task_23134,2227,964,184,184,368,2.3077720207253885,46.55648081299875
Task_23135,1193,854,36,48,84,1.3953216374269006,27.07578302084613
Task_23136,1441,961,11,15,26,1.497920997920998,30.487468727963915
Task_23137,2522,186,97,130,227,13.48663101604278,48.12852668620041
Task_23138,1953,767,61,181,242,2.54296875,41.156217149752706
Task_23139,1263,484,23,129,152,2.6041237113402063,28.476369496277815
Task_23140,2665,549,60,131,191,4.845454545454546,51.440659591530824
Task_23141,2724,899,130,12,142,3.026666666666667,51.90299341693673
Task_23142,1263,386,110,41,151,3.2635658914728682,27.29772532327547
Task_23143,1948,76,107,28,135,25.2987012987013,36.062671063035005
Task_23144,1218,201,143,105,248,6.02970297029703,27.48913370650938
Task_23145,2188,80,14,32,46,27.012345679012345,39.04598602703325
Task_23146,1182,923,85,158,243,1.2792207792207793,29.210185859923104
Task_23147,2705,468,67,113,180,5.767590618336887,51.548059407051596
Task_23148,1098,654,80,163,243,1.6763358778625954,27.22366547531462
Task_23149,652,769,50,81,131,0.8467532467532467,19.50791229345903
Task_23150,916,416,150,51,201,2.196642685851319,22.6627440335302
Task_23151,593,850,102,74,176,0.6968272620446534,18.892594371932578
Task_23152,2785,791,89,157,246,3.5164141414141414,54.307188622164176
Task_23153,2445,368,141,115,256,6.626016260162602,47.50767953317663
Task_23154,682,989,45,102,147,0.6888888888888889,20.768221174593922
Task_23155,1527,483,73,169,242,3.1549586776859506,33.49701970384073
Task_23156,534,222,196,142,338,2.3946188340807173,17.220688600207648
Task_23157,713,309,93,186,279,2.3,20.23971727350542
Task_23158,1002,705,47,95,142,1.4192634560906516,24.864160335861513
Task_23159,1627,488,14,121,135,3.32719836400818,34.172878003556995
Task_23160,741,893,111,89,200,0.8288590604026845,21.61883573845363
Task_23161,2134,546,148,169,317,3.9012797074954295,43.51877386194672
Task_23162,1702,355,59,128,187,4.780898876404494,35.53612759656853
Task_23163,1018,375,184,50,234,2.7074468085106385,24.12352163762304
Task_23164,2664,208,49,144,193,12.746411483253588,50.31255511826833
Task_23165,2508,820,29,83,112,3.0548112058465287,48.805190560436564
Task_23166,2540,392,118,19,137,6.463104325699746,47.28521458078993
Task_23167,1027,824,58,81,139,1.2448484848484849,25.453712555802102
Task_23168,1665,411,62,69,131,4.04126213592233,34.19723513968697
Task_23169,2421,728,189,167,356,3.3209876543209877,48.81309864287069
Task_23170,1239,77,145,69,214,15.884615384615385,25.891556391529857
Task_23171,2144,758,26,178,204,2.8247694334650855,43.89119667385412
Task_23172,1266,791,129,117,246,1.5984848484848484,30.129970522463395
Task_23173,861,815,44,183,227,1.0551470588235294,23.58974095474814
Task_23174,873,809,16,22,38,1.0777777777777777,21.340984414427265
Task_23175,1208,979,182,147,329,1.2326530612244897,30.102180141543712
Task_23176,1665,323,35,87,122,5.138888888888889,34.01917718233384
Task_23177,949,360,156,88,244,2.628808864265928,23.469686146319038
Task_23178,2322,169,10,121,131,13.658823529411764,43.513382892581
Task_23179,2676,303,30,156,186,8.802631578947368,50.59706453960316
Task_23180,1003,764,32,151,183,1.3111111111111111,25.416780019911812
Task_23181,726,467,42,40,82,1.5512820512820513,18.50024904270075
Task_23182,1267,884,16,162,178,1.431638418079096,29.895505999430203
Task_23183,2450,183,53,188,241,13.315217391304348,46.95388421311458
Task_23184,2040,150,97,108,205,13.509933774834437,39.78751412764026
Task_23185,605,692,64,181,245,0.873015873015873,19.45863436699182
Task_23186,2996,327,29,48,77,9.134146341463415,53.56407300546627
Task_23187,1579,511,185,139,324,3.083984375,34.60773553060495
Task_23188,534,820,112,141,253,0.6504263093788063,18.766861322608246
Task_23189,2955,707,184,108,292,4.173728813559322,56.830868637256934
Task_23190,1901,559,17,82,99,3.3946428571428573,37.9926654313727
Task_23191,864,1024,165,130,295,0.8429268292682927,24.65066425607266
Task_23192,2966,66,157,14,171,44.26865671641791,52.01002989031898
Task_23193,2928,722,46,25,71,4.049792531120332,53.70289660564497
Task_23194,1498,209,42,108,150,7.133333333333334,31.174112815826476
Task_23195,1148,215,196,66,262,5.314814814814815,25.976244886742354
Task_23196,2427,99,107,84,191,24.27,44.92501573467289
Task_23197,963,437,110,83,193,2.1986301369863015,23.654785388442345
Task_23198,1842,385,162,43,205,4.772020725388601,36.992282688290395
Task_23199,2834,534,47,174,221,5.297196261682243,54.18885763318402
Task_23200,2776,85,41,56,97,32.27906976744186,49.10152035459955
Task_23201,1142,842,40,177,217,1.3546856465005932,28.206342009790887
Task_23202,2631,898,13,185,198,2.9265850945494996,52.043546837734844
Task_23203,1903,335,188,173,361,5.663690476190476,39.38198315269886
Task_23204,2417,896,76,20,96,2.6945373467112597,46.62960365730688
Task_23205,759,298,40,94,134,2.5384615384615383,19.791430718187772
Task_23206,1434,309,27,166,193,4.625806451612903,31.152233679608486
Task_23207,984,813,86,39,125,1.2088452088452089,24.11626283598139
Task_23208,2796,840,196,18,214,3.32461355529132,53.33790900689218
Task_23209,2823,913,16,54,70,3.088621444201313,53.04165731101656
Task_23210,2797,156,86,130,216,17.81528662420382,51.88199092522151
Task_23211,2739,237,196,93,289,11.508403361344538,51.74272908748954
Task_23212,2954,537,198,68,266,5.4907063197026025,55.654968716892604
Task_23213,1854,875,13,199,212,2.1164383561643834,39.743814705549916
Task_23214,2644,139,124,82,206,18.885714285714286,48.93514602645982
Task_23215,1633,828,22,145,167,1.9698431845597104,35.54071705017742
Task_23216,2746,697,138,35,173,3.9340974212034383,52.09840938942137
Task_23217,2176,227,174,188,362,9.543859649122806,43.34577716836702
Task_23218,1272,553,54,68,122,2.296028880866426,28.34258199404302
Task_23219,1323,766,10,177,187,1.7249022164276402,30.74254799373247
Task_23220,1073,183,65,61,126,5.831521739130435,23.929905776342718
Task_23221,1566,933,105,37,142,1.676659528907923,33.8048679565616
Task_23222,1839,66,102,168,270,27.44776119402985,36.199947139143845
Task_23223,1264,1019,178,156,334,1.2392156862745098,31.149137821782954
Task_23224,1712,970,17,51,68,1.7631307929969104,35.51383554596286
Task_23225,1973,926,130,165,295,2.128371089536138,42.05642682719559
Task_23226,2630,73,165,185,350,35.54054054054054,48.890679562617684
Task_23227,2250,644,147,74,221,3.488372093023256,44.73789630610033
Task_23228,601,632,19,86,105,0.9494470774091627,17.756225723475367
Task_23229,2680,136,34,133,167,19.562043795620436,49.33835471978055
Task_23230,2513,294,98,157,255,8.51864406779661,48.399940345015295
Task_23231,1990,551,134,108,242,3.6050724637681157,40.827125660103995
Task_23232,2185,530,168,103,271,4.114877589453861,43.97113094113436
Task_23233,2584,537,44,183,227,4.802973977695167,50.243672049745875
Task_23234,2877,977,82,144,226,2.941717791411043,56.29106061004765
Task_23235,2954,773,108,191,299,3.8165374677002584,57.176827334465806
Task_23236,1147,265,64,135,199,4.31203007518797,26.537866803134545
Task_23237,2004,405,159,156,315,4.935960591133005,40.978615940215654
Task_23238,2948,562,10,182,192,5.236234458259325,55.916939579796455
Task_23239,1036,919,168,66,234,1.126086956521739,26.217546202082236
Task_23240,2154,125,50,52,102,17.095238095238095,39.78513650110242
Task_23241,669,461,72,152,224,1.448051948051948,19.67023131814612
Task_23242,1777,940,33,136,169,1.8884165781083952,38.2470404446796
Task_23243,2365,454,132,27,159,5.197802197802198,44.96287691879267
Task_23244,1433,924,30,71,101,1.5491891891891891,31.728848740741558
Task_23245,2303,975,141,169,310,2.3596311475409837,47.51166643154369
Task_23246,1319,704,76,65,141,1.8709219858156028,29.598328258327328
Task_23247,1705,656,163,56,219,2.5951293759512937,36.039281020364236
Task_23248,2791,297,29,37,66,9.365771812080537,50.192119546257885
Task_23249,2472,866,147,166,313,2.85121107266436,49.85863650264766
Task_23250,1363,518,48,141,189,2.626204238921002,30.701046773829173
Task_23251,2338,773,106,85,191,3.020671834625323,46.49899668758551
Task_23252,1935,331,103,51,154,5.828313253012048,37.9873071676256
Task_23253,2594,584,31,42,73,4.434188034188034,48.05211495866013
Task_23254,749,88,17,47,64,8.415730337078651,16.67634505655313
Task_23255,867,547,162,97,259,1.582116788321168,23.08416137841934
Task_23256,1669,427,48,76,124,3.899532710280374,34.40548647744408
Task_23257,1768,783,132,129,261,2.2551020408163267,38.156763588958796
Task_23258,642,790,30,179,209,0.8116308470290771,20.044426895264934
Task_23259,1809,324,31,155,186,5.5661538461538465,36.952378837120285
Task_23260,1835,297,127,166,293,6.157718120805369,37.861928094059984
Task_23261,1849,717,56,131,187,2.5752089136490253,39.02440946453127
Task_23262,1786,698,24,23,47,2.5550786838340485,35.44993292668777
Task_23263,2943,911,64,149,213,3.226973684210526,57.114841100708475
Task_23264,1580,826,137,65,202,1.9105199516324063,34.51246823751013
Task_23265,2418,905,181,60,241,2.6688741721854305,48.121084700140756
Task_23266,1497,572,160,177,337,2.612565445026178,33.616307934379705
Task_23267,1233,556,42,173,215,2.213644524236984,28.843523970579138
Task_23268,2802,780,36,22,58,3.587708066581306,51.888289644687084
Task_23269,1051,621,114,48,162,1.689710610932476,24.765035140590296
Task_23270,2343,933,49,89,138,2.5085653104925054,46.870904082627256
Task_23271,2884,910,42,129,171,3.1657519209659712,55.645624640505986
Task_23272,2391,232,153,178,331,10.261802575107296,46.60596863292818
Task_23273,567,483,101,30,131,1.171487603305785,16.628605240392343
Task_23274,764,398,23,142,165,1.9147869674185463,20.662326603152312
Task_23275,2250,579,184,15,199,3.8793103448275863,43.87977825452
Task_23276,2070,379,55,126,181,5.447368421052632,41.265966495532545
Task_23277,1142,892,195,194,389,1.2788353863381858,29.157384421844444
Task_23278,2562,908,17,35,52,2.8184818481848186,48.572790216771246
Task_23279,686,697,192,172,364,0.9828080229226361,21.19915119058467
Task_23280,986,737,83,125,208,1.3360433604336044,25.379956308309797
Task_23281,1464,754,139,120,259,1.9390728476821193,33.228061760032006
Task_23282,1022,265,133,172,305,3.8421052631578947,24.9664188390356
Task_23283,2625,301,136,165,301,8.69205298013245,50.400508594635674
Task_23284,2350,198,79,101,180,11.809045226130653,45.03161973082825
Task_23285,1843,65,33,127,160,27.924242424242426,35.239079402171285
Task_23286,2130,105,192,175,367,20.09433962264151,41.40048414030254
Task_23287,2366,521,145,50,195,4.532567049808429,45.751040666865606
Task_23288,1766,435,120,167,287,4.0504587155963305,37.19940798881945
Task_23289,915,781,155,192,347,1.170076726342711,25.034689538678606
Task_23290,2567,244,192,58,250,10.477551020408164,48.378469339557455
Task_23291,1432,244,110,89,199,5.844897959183673,30.587120653313395
Task_23292,1054,744,119,114,233,1.414765100671141,26.507474182795274
Task_23293,1371,310,47,194,241,4.408360128617363,30.426178303536528
Task_23294,2536,509,64,45,109,4.972549019607843,47.335039563535595
Task_23295,2470,918,81,199,280,2.687704026115343,49.99273017339156
Task_23296,2715,389,71,75,146,6.961538461538462,50.86805930892927
Task_23297,1361,450,87,55,142,3.0177383592017737,29.311761939407067
Task_23298,1556,938,116,117,233,1.6570820021299255,35.122748750445965
Task_23299,2003,502,108,70,178,3.982107355864811,39.889698850943546
Task_23300,1328,643,24,169,193,2.062111801242236,30.544657812182873
Task_23301,1999,900,132,98,230,2.218645948945616,41.99959353540256
Task_23302,1759,758,48,76,124,2.3175230566534912,36.87601249410181
Task_23303,581,281,126,34,160,2.0602836879432624,16.248083058973
Task_23304,2033,157,88,200,288,12.867088607594937,40.24899865859484
Task_23305,2588,680,171,62,233,3.8002936857562406,50.106054738948025
Task_23306,1880,193,27,147,174,9.690721649484535,37.56273740606156
Task_23307,2602,861,159,142,301,3.0185614849187936,51.81351851205602
Task_23308,2409,779,42,103,145,3.0884615384615386,47.491072890361664
Task_23309,1534,619,59,111,170,2.4741935483870967,33.46698675288768
Task_23310,1416,361,172,166,338,3.911602209944751,31.650436345928753
Task_23311,1823,452,53,157,210,4.024282560706402,37.96437600427411
Task_23312,2846,498,156,34,190,5.703406813627255,53.18485959848963
Task_23313,2061,128,81,182,263,15.976744186046512,40.324627840195156
Task_23314,701,1017,141,93,234,0.6886051080550099,21.79841008726646
Task_23315,2391,497,131,74,205,4.801204819277109,46.42967544687744
Task_23316,1796,1014,44,37,81,1.7694581280788177,37.21726871254411
Task_23317,653,549,172,91,263,1.1872727272727273,19.48771300599176
Task_23318,1329,758,42,164,206,1.7509881422924902,30.927689093776348
Task_23319,1374,944,130,167,297,1.453968253968254,32.56421368833627
Task_23320,954,937,105,78,183,1.0170575692963753,24.756067178051875
Task_23321,2400,204,89,90,179,11.707317073170731,45.50236925984483
Task_23322,2691,708,194,20,214,3.7954866008462624,51.31810169334735
Task_23323,2629,692,150,30,180,3.7936507936507935,50.16454031260735
Task_23324,1741,466,153,185,338,3.728051391862955,37.159499852718014
Task_23325,1117,951,196,26,222,1.1733193277310925,27.372849043751817
Task_23326,1552,480,54,138,192,3.226611226611227,33.64456237238857
Task_23327,2988,702,160,102,262,4.250355618776672,57.19374910937184
Task_23328,685,715,199,86,285,0.9567039106145251,20.52301965974425
Task_23329,961,915,58,129,187,1.0491266375545851,25.36064358564805
Task_23330,2953,99,112,187,299,29.53,54.02362043878975
Task_23331,615,405,73,129,202,1.5147783251231528,18.53879049237473
Task_23332,2547,181,171,19,190,13.994505494505495,46.95041421978208
Task_23333,2372,608,187,100,287,3.8949096880131364,47.24853183821755
Task_23334,1830,715,36,116,152,2.5558659217877095,38.0799364059479
Task_23335,1503,504,155,68,223,2.976237623762376,32.38238213763938
Task_23336,1281,894,165,193,358,1.4312849162011174,31.24860576082069
Task_23337,1575,332,107,98,205,4.72972972972973,33.37471931737114
Task_23338,1151,791,116,120,236,1.4532828282828283,28.212456645305327
Task_23339,1424,480,85,46,131,2.9604989604989607,30.126338453104314
Task_23340,2692,406,22,27,49,6.614250614250614,48.91956951146613
Task_23341,1519,194,92,17,109,7.78974358974359,30.35592884150847
Task_23342,996,859,112,142,254,1.158139534883721,26.067192947700022
Task_23343,1881,309,91,12,103,6.067741935483871,36.3436466220245
Task_23344,1368,723,143,33,176,1.8895027624309393,30.271579754606766
Task_23345,894,896,145,41,186,0.9966555183946488,23.39088696836836
Task_23346,1814,784,150,97,247,2.310828025477707,38.81224704753678
Task_23347,2337,691,71,83,154,3.3771676300578033,45.86323018761445
Task_23348,763,948,78,108,186,0.804004214963119,22.247993996248812
Task_23349,1682,999,29,122,151,1.682,36.6531812705103
Task_23350,1332,208,181,104,285,6.373205741626794,29.478905051650845
Task_23351,2224,544,176,190,366,4.080733944954129,45.18907721038682
Task_23352,1492,234,29,198,227,6.348936170212766,32.01463606596119
Task_23353,1870,450,121,46,167,4.146341463414634,37.300421885177315
Task_23354,842,558,31,81,112,1.5062611806797854,21.525900896808494
Task_23355,2583,141,132,87,219,18.190140845070424,48.084006101394486
Task_23356,1719,764,20,26,46,2.2470588235294118,34.60509805613737
Task_23357,1233,693,132,45,177,1.776657060518732,27.968839727693375
Task_23358,2835,892,163,164,327,3.1746920492721165,55.75185818877708
Task_23359,807,322,66,88,154,2.498452012383901,20.542354235909876
Task_23360,2213,560,86,98,184,3.944741532976827,43.9794893510718
Task_23361,1874,358,143,86,229,5.220055710306407,38.01313466330793
Task_23362,694,996,191,140,331,0.6960882647943831,22.171478283514844
Task_23363,807,869,69,41,110,0.9275862068965517,21.38093041484504
Task_23364,2443,126,107,163,270,19.236220472440944,46.27954089493232
Task_23365,1402,404,143,188,331,3.4617283950617286,31.56838453670389
Task_23366,2451,779,18,168,186,3.1423076923076922,48.53170230528068
Task_23367,2127,877,66,111,177,2.4225512528473803,43.673869670135765
Task_23368,2772,239,49,25,74,11.55,49.663229312587305
Task_23369,2931,812,145,191,336,3.6051660516605164,57.10201489212011
Task_23370,1779,542,175,164,339,3.276243093922652,37.97685486141499
Task_23371,2788,278,76,44,120,9.992831541218639,50.81506109973798
Task_23372,1642,776,108,26,134,2.113256113256113,34.48885398097046
Task_23373,2281,509,186,180,366,4.472549019607843,45.9647871207527
Task_23374,751,914,113,119,232,0.8207650273224044,22.22015215268638
Task_23375,1921,377,82,112,194,5.082010582010582,39.05615737878849
Task_23376,2821,611,197,147,344,4.609477124183006,54.69469238354069
Task_23377,1589,723,160,177,337,2.1947513812154695,35.54665173186122
Task_23378,2531,591,88,194,282,4.275337837837838,49.84731970311336
Task_23379,1922,330,81,143,224,5.806646525679758,39.107983669311295
Task_23380,1549,538,47,21,68,2.8738404452690167,31.229809044787757
Task_23381,2183,263,170,18,188,8.268939393939394,41.60401277464501
Task_23382,1026,684,197,86,283,1.4978102189781022,25.827433889905326
Task_23383,1229,312,11,181,192,3.926517571884984,27.899130651484015
Task_23384,2225,153,64,102,166,14.448051948051948,42.32437703529027
Task_23385,922,185,53,75,128,4.956989247311828,22.021645893438286
Task_23386,673,716,139,153,292,0.9386331938633193,20.705770556092098
Task_23387,2455,817,186,51,237,3.0012224938875307,48.45838605701662
Task_23388,1432,769,99,15,114,1.8597402597402597,30.793831805425725
Task_23389,2898,187,45,29,74,15.414893617021276,51.70236721535986
Task_23390,854,474,179,178,357,1.7978947368421052,23.2195867317197
Task_23391,1932,315,72,164,236,6.113924050632911,39.32381017036532
Task_23392,1426,468,68,174,242,3.0405117270788913,31.853116495461396
Task_23393,2147,688,63,174,237,3.11611030478955,43.94881525163702
Task_23394,680,106,174,97,271,6.355140186915888,18.078208371112876
Task_23395,2970,163,185,133,318,18.109756097560975,55.04044155703911
Task_23396,2941,527,199,127,326,5.570075757575758,56.21431927895446
Task_23397,815,809,133,156,289,1.0061728395061729,23.158319490769824
Task_23398,1080,371,136,173,309,2.903225806451613,26.246731984998913
Task_23399,1306,989,185,190,375,1.3191919191919192,32.03921712275156
Task_23400,2372,733,13,101,114,3.231607629427793,46.66948693009618
Task_23401,889,420,55,192,247,2.111638954869359,23.287193056585238
Task_23402,2436,93,116,166,282,25.914893617021278,45.706873796985384
Task_23403,2627,423,34,31,65,6.195754716981132,48.005014154402744
Task_23404,2247,100,27,48,75,22.247524752475247,40.46351498108469
Task_23405,1446,64,185,54,239,22.246153846153845,29.268110081844643
Task_23406,2252,707,172,145,317,3.1807909604519775,45.86188798921407
Task_23407,579,128,136,139,275,4.488372093023256,16.90914169042367
Task_23408,2512,549,35,171,206,4.567272727272727,49.04572998643797
Task_23409,561,360,144,17,161,1.554016620498615,15.891104521415487
Task_23410,1053,781,101,63,164,1.3465473145780051,25.735056226451515
Task_23411,2664,327,159,82,241,8.121951219512194,50.43269288385002
Task_23412,1525,383,198,189,387,3.9713541666666665,33.70075922708691
Task_23413,2292,767,181,141,322,2.984375,46.70068910902861
Task_23414,1002,676,188,35,223,1.480059084194978,24.709801218717235
Task_23415,2484,201,156,177,333,12.297029702970297,47.96137249943505
Task_23416,1862,741,146,166,312,2.509433962264151,39.798790283008444
Task_23417,2882,432,74,88,162,6.655889145496536,53.83311106332701
Task_23418,2939,738,20,183,203,3.976995940460081,56.364770382304954
Task_23419,639,489,57,121,178,1.3040816326530613,18.84838207414214
Task_23420,2228,363,116,144,260,6.1208791208791204,44.11857326172458
Task_23421,1619,607,43,96,139,2.6628289473684212,34.39460291308334
Task_23422,1357,230,174,41,215,5.874458874458875,28.852930785845228
Task_23423,2831,425,144,51,195,6.645539906103286,52.970543565663114
Task_23424,642,773,51,28,79,0.8294573643410853,17.961284757788288
Task_23425,505,737,11,26,37,0.6842818428184282,15.51309748063012
Task_23426,2991,395,27,57,84,7.553030303030303,54.316563112592775
Task_23427,2430,912,59,107,166,2.661555312157722,48.567944043992526
Task_23428,2688,527,33,68,101,5.090909090909091,50.389066702713194
Task_23429,605,565,86,102,188,1.068904593639576,18.50493119345379
Task_23430,1004,957,184,149,333,1.048016701461378,26.817436592705494
Task_23431,1066,201,163,103,266,5.2772277227722775,25.168035111513785
Task_23432,2458,783,165,33,198,3.135204081632653,47.992904276086044
Task_23433,1810,963,137,14,151,1.8775933609958506,37.617346237428585
Task_23434,528,560,164,91,255,0.9411764705882353,17.530128860015882
Task_23435,2003,314,131,181,312,6.358730158730158,40.6836141077065
Task_23436,2534,430,86,195,281,5.879350348027843,49.39389197897489
Task_23437,1354,752,137,12,149,1.798140770252324,29.79259671726021
Task_23438,2478,420,176,176,352,5.885985748218527,48.72482322256658
Task_23439,2353,701,99,67,166,3.3518518518518516,46.06695353051449
Task_23440,581,389,86,114,200,1.4897435897435898,17.827844007023568
Task_23441,2788,821,150,21,171,3.391727493917275,52.89120567515224
Task_23442,1401,94,108,64,172,14.74736842105263,28.263904874797447
Task_23443,1410,617,146,30,176,2.2815533980582523,30.612053860190812
Task_23444,1435,594,194,43,237,2.411764705882353,31.360287272980088
Task_23445,806,839,200,131,331,0.9595238095238096,23.340292981096628
Task_23446,1815,844,65,73,138,2.1479289940828403,37.95928776079704
Task_23447,1133,529,152,138,290,2.137735849056604,27.44848898599086
Task_23448,2264,468,152,102,254,4.8272921108742,44.9443103954433
Task_23449,1078,889,22,108,130,1.2112359550561798,26.488661651815836
Task_23450,1278,452,97,147,244,2.8211920529801326,29.330575125550013
Task_23451,1063,162,119,188,307,6.521472392638037,25.000558457256094
Task_23452,2137,802,187,137,324,2.6612702366127023,44.35783725344106
Task_23453,516,730,68,175,243,0.7058823529411765,18.304259424635784
Task_23454,2127,381,168,48,216,5.5680628272251305,41.55256691157988
Task_23455,1219,735,90,144,234,1.65625,29.246040996185354
Task_23456,1140,148,99,102,201,7.651006711409396,25.549198633181664
Task_23457,2121,970,91,41,132,2.184346035015448,42.73053891910117
Task_23458,2650,950,122,98,220,2.786540483701367,52.426018059938905
Task_23459,2748,921,149,91,240,2.980477223427332,53.81879213778668
Task_23460,2835,532,166,57,223,5.318949343339587,53.485488113591394
Task_23461,2313,861,146,115,261,2.683294663573086,47.014594017941214
Task_23462,2128,427,189,38,227,4.97196261682243,41.79241235865475
Task_23463,2370,163,27,13,40,14.451219512195122,42.63859753604556
Task_23464,2695,144,114,161,275,18.586206896551722,50.475704873994765
Task_23465,2445,240,65,35,100,10.145228215767634,45.008013059298655
Task_23466,2999,576,76,33,109,5.197573656845754,55.14037420295605
Task_23467,2897,463,122,85,207,6.243534482758621,54.43623900303516
Task_23468,1356,382,10,183,193,3.5404699738903394,30.142500087099616
Task_23469,2340,973,37,22,59,2.402464065708419,45.11240920292854
Task_23470,2096,644,167,178,345,3.2496124031007754,43.36703215861323
Task_23471,876,378,35,13,48,2.311345646437995,19.87922758072978
Task_23472,2779,611,165,98,263,4.540849673202614,53.595926797323365
Task_23473,2589,838,22,25,47,3.0858164481525625,48.6034140853126
Task_23474,1684,936,135,162,297,1.7972251867662754,37.51267015000245
Task_23475,1115,910,61,25,86,1.2239297475301867,25.992540092328237
Task_23476,1161,455,88,154,242,2.5460526315789473,27.485370928846994
Task_23477,964,702,76,176,252,1.3712660028449501,25.265305571735013
Task_23478,2288,268,70,162,232,8.50557620817844,44.78124569284796
Task_23479,1656,66,48,116,164,24.71641791044776,32.73484770604776
Task_23480,1718,1014,142,44,186,1.6926108374384237,36.7682100266566
Task_23481,2139,166,136,194,330,12.808383233532934,42.06452756942394
Task_23482,2998,321,18,152,170,9.31055900621118,55.54915125157186
Task_23483,1460,629,116,169,285,2.3174603174603177,32.963236709264336
Task_23484,1654,645,40,150,190,2.5603715170278636,35.631050380629794
Task_23485,1092,309,10,182,192,3.52258064516129,25.724530253406115
Task_23486,1276,831,155,93,248,1.5336538461538463,30.29183835757141
Task_23487,1848,770,126,53,179,2.396887159533074,38.31105584635436
Task_23488,1459,821,53,111,164,1.7749391727493917,32.95708496133145
Task_23489,1907,936,65,31,96,2.0352187833511204,38.721282904286696
Task_23490,2925,1018,12,181,193,2.8704612365063786,56.9947826848597
Task_23491,1479,879,27,142,169,1.6806818181818182,33.324083646211
Task_23492,2822,917,19,39,58,3.074074074074074,52.641591921326075
Task_23493,2322,383,160,166,326,6.046875,46.00206385717803
Task_23494,1750,286,51,102,153,6.097560975609756,35.600312693220275
Task_23495,906,824,183,51,234,1.0981818181818181,23.869218612709414
Task_23496,815,655,73,107,180,1.2423780487804879,22.06230157203912
Task_23497,731,379,55,62,117,1.9236842105263159,19.038279341959036
Task_23498,2090,224,56,86,142,9.28888888888889,40.518020318851775
Task_23499,1490,422,69,91,160,3.5224586288416075,31.81247532023956
Task_23500,1672,885,136,76,212,1.8871331828442437,36.29345676749016
Task_23501,1017,458,178,113,291,2.215686274509804,25.35668393453553
Task_23502,1232,660,48,132,180,1.8638426626323752,28.86309844093063
Task_23503,2207,893,97,54,151,2.4686800894854586,44.13174197976827
Task_23504,1246,274,134,127,261,4.530909090909091,28.272237455693666
Task_23505,1909,391,56,120,176,4.869897959183674,38.75287166817066
Task_23506,2395,875,140,143,283,2.7340182648401825,48.49779941917719
Task_23507,1632,765,186,51,237,2.1305483028720626,35.25711029510552
Task_23508,514,335,65,12,77,1.5297619047619047,14.11449639609087
Task_23509,1229,938,92,27,119,1.308839190628328,28.317223510789876
Task_23510,2768,274,121,151,272,10.065454545454546,52.412997214941434
Task_23511,1151,477,31,44,75,2.407949790794979,24.79277616186728
Task_23512,724,636,22,135,157,1.1365777080062793,20.218779122143
Task_23513,1753,1016,39,165,204,1.7236971484759096,38.43862937982025
Task_23514,2351,729,45,22,67,3.2205479452054795,44.519028457470675
Task_23515,1655,232,158,65,223,7.103004291845494,33.888263724397646
Task_23516,2023,64,102,164,266,31.123076923076923,38.98598942004035
Task_23517,1514,992,71,166,237,1.5246727089627392,34.815812805107406
Task_23518,523,727,28,25,53,0.7184065934065934,16.124426511135212
Task_23519,2279,846,22,22,44,2.690672963400236,43.64236907072262
Task_23520,663,870,75,80,155,0.7611940298507462,19.96063419125145
Task_23521,2789,77,128,117,245,35.756410256410255,50.85508513405503
Task_23522,1102,1009,176,18,194,1.0910891089108912,26.89583678939363
Task_23523,964,150,157,101,258,6.3841059602649,23.027599769676247
Task_23524,1148,626,55,92,147,1.8309409888357258,27.093104330699436
Task_23525,2622,288,119,30,149,9.07266435986159,48.51080538343346
Task_23526,2847,999,108,24,132,2.847,54.25872701754324
Task_23527,2877,392,175,190,365,7.320610687022901,55.02448414302605
Task_23528,905,137,132,61,193,6.557971014492754,21.234406332741834
Task_23529,1566,909,30,35,65,1.720879120879121,32.74563378815797
Task_23530,1133,282,175,96,271,4.003533568904594,26.535876867031032
Task_23531,1444,181,95,71,166,7.934065934065934,29.836791774033767
Task_23532,1328,470,188,199,387,2.819532908704883,30.87614969536243
Task_23533,1064,493,196,185,381,2.1538461538461537,26.72202874190334
Task_23534,2768,395,164,77,241,6.98989898989899,52.22672861853616
Task_23535,603,934,76,181,257,0.6449197860962567,20.429561989378282
Task_23536,2794,636,56,133,189,4.3861852433281,53.75949310861074
Task_23537,1101,724,100,185,285,1.5186206896551724,27.55397876776939
Task_23538,2180,580,46,191,237,3.7521514629948367,44.061363510453496
Task_23539,2989,343,34,129,163,8.688953488372093,55.48742464337855
Task_23540,2510,388,160,141,301,6.4524421593830334,48.84393261112649
Task_23541,1070,254,25,11,36,4.196078431372549,22.34194663368733
Task_23542,931,1006,36,51,87,0.9245283018867925,23.66300418140919
Task_23543,2611,783,103,128,231,3.330357142857143,51.37547332358755
Task_23544,2778,664,168,134,302,4.177443609022556,53.97403984244939
Task_23545,2972,162,193,152,345,18.233128834355828,55.21669209072626
Task_23546,1319,635,19,10,29,2.0738993710691824,27.538556216526203
Task_23547,1834,802,160,121,281,2.2839352428393522,39.340099975499406
Task_23548,1010,243,148,106,254,4.139344262295082,24.377116436496436
Task_23549,2411,994,56,88,144,2.423115577889447,48.103989040276026
Task_23550,977,95,156,165,321,10.177083333333334,22.955629089982153
Task_23551,1159,534,116,197,313,2.166355140186916,28.065998180468526
Task_23552,1629,831,130,167,297,1.9579326923076923,36.32209638747597
Task_23553,1497,679,82,133,215,2.2014705882352943,33.42990792021638
Task_23554,1761,608,182,137,319,2.8916256157635467,37.77063860560079
Task_23555,1613,93,113,78,191,17.159574468085108,31.948354342307706
Task_23556,1170,725,173,27,200,1.6115702479338843,27.372639851840407
Task_23557,1599,267,67,158,225,5.9664179104477615,33.83307236981361
Task_23558,2359,581,98,148,246,4.053264604810996,46.85627155246897
Task_23559,762,1001,38,38,76,0.7604790419161677,20.373472371111603
Task_23560,1687,278,105,24,129,6.046594982078853,33.591346541406224
Task_23561,2590,161,105,137,242,15.987654320987655,48.70317530064626
Task_23562,2831,116,91,47,138,24.196581196581196,50.50661038990565
Task_23563,2176,935,131,172,303,2.324786324786325,45.347473857209614
Task_23564,1333,431,89,109,198,3.0856481481481484,29.88736709669008
Task_23565,1493,458,57,122,179,3.252723311546841,32.37636611511686
Task_23566,610,625,76,186,262,0.9744408945686901,19.410920898246488
Task_23567,1810,795,198,35,233,2.2738693467336684,37.92570878398987
Task_23568,2183,439,33,45,78,4.961363636363636,41.11383298040297
Task_23569,2213,348,35,188,223,6.340974212034384,43.758213207600555
Task_23570,1126,178,89,34,123,6.290502793296089,24.061282002526436
Task_23571,1165,633,72,198,270,1.837539432176656,28.405462253709022
Task_23572,1654,377,145,124,269,4.375661375661376,35.09512134324269
Task_23573,1738,247,11,148,159,7.008064516129032,35.21388935046667
Task_23574,2549,500,63,45,108,5.087824351297405,47.50120523584699
Task_23575,708,256,164,164,328,2.754863813229572,20.06688291901666
Task_23576,2642,577,156,51,207,4.570934256055363,50.52669403452577
Task_23577,1972,791,71,160,231,2.48989898989899,41.45088712558352
Task_23578,2893,869,84,138,222,3.325287356321839,56.13475573677306
Task_23579,844,573,33,164,197,1.470383275261324,22.627259681227414
Task_23580,1193,957,197,13,210,1.245302713987474,28.352988612981488
Task_23581,2630,878,90,71,161,2.9920364050056882,50.89867508033953
Task_23582,1414,199,159,119,278,7.07,30.747586891174965
Task_23583,1522,644,185,198,383,2.3596899224806203,34.47639879826419
Task_23584,1831,797,121,58,179,2.2944862155388472,38.02161986669389
Task_23585,1832,354,23,80,103,5.16056338028169,36.47664701521777
Task_23586,2568,900,46,62,108,2.8501664816870145,49.55801239267718
Task_23587,2675,185,74,187,261,14.381720430107526,50.59335717691628
Task_23588,1862,767,157,154,311,2.4244791666666665,39.857991279115375
Task_23589,2323,797,76,93,169,2.911027568922306,46.39886892737474
Task_23590,1960,461,96,104,200,4.242424242424242,39.922109395684835
Task_23591,1623,235,66,157,223,6.877118644067797,34.09097362892777
Task_23592,2289,744,33,67,100,3.07248322147651,44.73958145072367
Task_23593,2469,620,71,96,167,3.975845410628019,48.25310434177487
Task_23594,2536,395,64,19,83,6.404040404040404,46.574375156986925
Task_23595,2149,868,162,77,239,2.472957422324511,43.92445569697338
Task_23596,1655,436,158,178,336,3.7871853546910756,35.682831970725445
Task_23597,2443,191,189,70,259,12.723958333333334,46.433959091339744
Task_23598,2979,126,136,159,295,23.456692913385826,54.82235043947336
Task_23599,1332,470,151,132,283,2.828025477707006,30.372516938049873
Task_23600,2919,272,107,193,300,10.692307692307692,54.98002104315233
Task_23601,2255,396,160,127,287,5.680100755667507,44.75206780420518
Task_23602,1543,840,33,155,188,1.834720570749108,34.489198088467624
Task_23603,1385,209,14,151,165,6.595238095238095,29.81759303553555
Task_23604,2224,306,146,160,306,7.244299674267101,44.09291414804712
Task_23605,2057,878,178,155,333,2.340159271899886,43.39455393342388
Task_23606,2275,648,168,80,248,3.505392912172573,45.348669439221226
Task_23607,2575,402,27,55,82,6.389578163771712,47.81746273350487
Task_23608,2139,494,172,69,241,4.321212121212121,42.47217456331522
Task_23609,1351,293,85,177,262,4.595238095238095,30.120369085423338
Task_23610,1855,906,83,167,250,2.0452039691289965,39.97815453871548
Task_23611,1966,221,17,84,101,8.855855855855856,38.0329018278322
Task_23612,743,932,182,152,334,0.7963558413719185,22.70448972111647
Task_23613,2543,732,85,86,171,3.469304229195089,49.38307093141267
Task_23614,1567,703,80,16,96,2.225852272727273,32.618648098428174
Task_23615,1547,567,143,84,227,2.7235915492957745,33.46650356136106
Task_23616,1616,834,37,170,207,1.9353293413173653,35.74422399392619
Task_23617,2961,327,176,152,328,9.027439024390244,55.90771497174387
Task_23618,2547,347,114,17,131,7.318965517241379,47.23917598791764
Task_23619,535,423,166,53,219,1.2617924528301887,16.77339744494832
Task_23620,1117,693,169,184,353,1.6095100864553313,28.045322721063087
Task_23621,815,913,198,102,300,0.8916849015317286,23.52115752653113
Task_23622,1351,980,124,17,141,1.3771661569826708,30.236618781294847
Task_23623,2861,218,15,46,61,13.06392694063927,51.06391556329161
Task_23624,543,663,183,103,286,0.8177710843373494,18.368736087421503
Task_23625,1677,177,71,142,213,9.42134831460674,34.227431309920384
Task_23626,1529,832,184,23,207,1.8355342136854742,33.40243259802903
Task_23627,2150,990,55,151,206,2.169525731584258,44.797343008160716
Task_23628,1984,483,56,61,117,4.099173553719008,39.11120798962918
Task_23629,954,957,173,186,359,0.9958246346555324,26.227284621972746
Task_23630,682,895,14,180,194,0.7611607142857143,20.998107420872717
Task_23631,2720,835,29,115,144,3.2535885167464116,52.5969548575855
Task_23632,513,952,93,15,108,0.5383001049317944,17.02063368550573
Task_23633,1490,683,76,96,172,2.1783625730994154,33.09508810977516
Task_23634,1245,760,30,180,210,1.636005256241787,29.671979801802262
Task_23635,1384,847,194,83,277,1.6320754716981132,31.97406696943926
Task_23636,1541,770,77,84,161,1.9987029831387808,33.57536089493411
Task_23637,1697,645,135,37,172,2.626934984520124,35.32319678234316
Task_23638,1921,142,168,156,324,13.433566433566433,38.456198960672346
Task_23639,1088,868,135,48,183,1.2520138089758344,26.285482267632542
Task_23640,924,416,123,121,244,2.2158273381294964,23.552170739639063
Task_23641,903,308,91,48,139,2.9223300970873787,21.340852140041665
Task_23642,562,784,179,35,214,0.7159235668789808,18.27196237361505
Task_23643,1183,106,167,95,262,11.05607476635514,25.92759325580458
Task_23644,1694,768,119,14,133,2.2028608582574774,35.15889963924213
Task_23645,2306,880,200,153,353,2.6174801362088536,47.43337834550086
Task_23646,2895,73,53,183,236,39.12162162162162,52.63420668752003
Task_23647,2855,746,32,97,129,3.821954484605087,54.543892494340646
Task_23648,2484,267,93,122,215,9.26865671641791,47.7115306116177
Task_23649,2690,697,98,93,191,3.853868194842407,52.0725823717574
Task_23650,2862,222,52,199,251,12.834080717488789,53.846097812885226
Task_23651,1983,704,162,141,303,2.8127659574468087,41.522407803457206
Task_23652,1518,123,58,143,201,12.241935483870968,31.45655825571758
Task_23653,1836,512,102,55,157,3.5789473684210527,37.09769556831855
Task_23654,1531,414,45,43,88,3.689156626506024,31.041380274561487
Task_23655,515,308,121,145,266,1.6666666666666667,16.861707178268126
Task_23656,1253,850,148,115,263,1.472385428907168,30.140467659175375
Task_23657,768,738,191,18,209,1.0392422192151556,20.835004230259752
Task_23658,2809,380,136,25,161,7.3727034120734904,51.751928720720514
Task_23659,1068,878,84,129,213,1.2150170648464165,27.055607265567744
Task_23660,2524,942,44,22,66,2.676564156945917,47.97374748538079
Task_23661,1753,285,80,130,210,6.129370629370629,36.225153679777854
Task_23662,2906,870,72,160,232,3.3363949483352466,56.500855057983586
Task_23663,859,194,13,61,74,4.4051282051282055,19.75376387664228
Task_23664,778,204,31,168,199,3.795121951219512,20.460650260775733
Task_23665,1711,620,109,31,140,2.755233494363929,35.109787221582344
Task_23666,1819,907,47,45,92,2.003303964757709,37.25645649912449
Task_23667,2201,221,126,199,325,9.914414414414415,43.567423069964576
Task_23668,766,704,29,101,130,1.0865248226950355,20.995917506025254
Task_23669,1955,650,70,101,171,3.003072196620584,40.19726430224912
Task_23670,1247,216,94,20,114,5.746543778801843,26.17371896797697
Task_23671,640,141,177,139,316,4.507042253521127,18.18718942574739
Task_23672,2273,312,31,150,181,7.261980830670926,44.16684076384439
Task_23673,895,917,113,179,292,0.9749455337690632,24.872623677771116
Task_23674,2222,387,71,143,214,5.72680412371134,44.02160104244245
Task_23675,2986,171,72,146,218,17.36046511627907,54.95356907921862
Task_23676,740,682,78,194,272,1.083455344070278,21.638868465476047
Task_23677,2658,77,95,143,238,34.07692307692308,48.8516607797498
Task_23678,1875,214,57,167,224,8.720930232558139,38.04997688123304
Task_23679,1277,231,147,92,239,5.504310344827586,28.365242782977933
Task_23680,2879,553,157,76,233,5.196750902527076,54.46131896668518
Task_23681,749,610,122,187,309,1.225859247135843,21.65493429355833
Task_23682,2608,373,141,156,297,6.973262032085562,50.34811292654374
Task_23683,2501,140,41,73,114,17.73758865248227,45.80856618340041
Task_23684,1117,906,22,55,77,1.2315325248070563,25.907977752455178
Task_23685,2171,956,107,47,154,2.2685475444096133,43.462860450728236
Task_23686,588,778,185,191,376,0.754813863928113,19.96708937552983
Task_23687,2538,957,141,75,216,2.6492693110647183,50.25380590442055
Task_23688,1982,695,141,151,292,2.8477011494252875,41.443397342714405
Task_23689,1170,602,12,59,71,1.9402985074626866,25.747628686563385
Task_23690,1866,905,196,185,381,2.0596026490066226,40.71253452229287
Task_23691,1682,73,75,14,89,22.72972972972973,31.148184934193818
Task_23692,2275,615,10,59,69,3.6931818181818183,43.27469686876148
Task_23693,529,1000,128,133,261,0.5284715284715285,19.25204989880345
Task_23694,2987,1020,109,72,181,2.9255631733594516,57.15665483526951
Task_23695,2736,853,66,50,116,3.2037470725995316,51.99434168670518
Task_23696,604,1022,45,40,85,0.5904203323558163,18.655305078876708
Task_23697,2033,249,69,16,85,8.132,38.322777338991614
Task_23698,1927,686,28,97,125,2.8049490538573507,39.56925702399007
Task_23699,1457,777,81,190,271,1.8727506426735219,33.44918011280724
Task_23700,669,890,193,119,312,0.7508417508417509,21.18793126361906
Task_23701,1545,606,108,183,291,2.545304777594728,34.284815054739965
Task_23702,1237,686,121,55,176,1.8005822416302766,28.35242474010751
Task_23703,2937,691,18,124,142,4.244219653179191,55.51467221359411
Task_23704,1357,270,133,46,179,5.007380073800738,28.63801160407567
Task_23705,2855,175,119,100,219,16.22159090909091,52.691843305088334
Task_23706,1677,606,63,144,207,2.7627677100494235,36.06750099624014
Task_23707,1133,545,104,155,259,2.0750915750915753,27.383883434855836
Task_23708,2506,113,183,13,196,21.982456140350877,45.845544142484975
Task_23709,692,854,177,67,244,0.8093567251461988,20.75428515536767
Task_23710,778,528,21,142,163,1.4706994328922496,21.019568741753126
Task_23711,2655,372,98,137,235,7.117962466487936,50.79493163152191
Task_23712,1460,137,81,185,266,10.579710144927537,31.001919878455023
Task_23713,2075,242,179,196,375,8.539094650205762,41.875907305142
Task_23714,2075,226,32,31,63,9.140969162995594,38.61765141249309
Task_23715,2041,272,145,60,205,7.476190476190476,39.95612670271675
Task_23716,1721,536,168,124,292,3.2048417132216014,36.769017576307355
Task_23717,1402,488,51,41,92,2.867075664621677,29.359499563986702
Task_23718,1972,552,113,56,169,3.566003616636528,39.52224696307046
Task_23719,2070,514,151,82,233,4.019417475728155,41.613848242127474
Task_23720,1332,709,158,165,323,1.876056338028169,31.351191179515826
Task_23721,959,240,172,76,248,3.979253112033195,23.128960449215054
Task_23722,2468,706,90,29,119,3.490806223479491,47.21003616551685
Task_23723,1431,601,63,100,163,2.377076411960133,31.72004805959942
Task_23724,2307,622,114,45,159,3.7030497592295344,44.569710018367665
Task_23725,2225,341,102,65,167,6.505847953216374,42.84973592888573
Task_23726,1699,257,14,90,104,6.5852713178294575,34.107237313000624
Task_23727,727,700,187,57,244,1.037089871611983,20.666790838756295
Task_23728,1241,287,53,75,128,4.309027777777778,27.41748171645723
Task_23729,2156,622,119,176,295,3.460674157303371,44.01953075602152
Task_23730,573,1020,19,62,81,0.5612144955925563,17.989526934503743
Task_23731,1632,725,29,118,147,2.2479338842975207,35.035173155303546
Task_23732,2419,96,32,152,184,24.938144329896907,44.79575955453334
Task_23733,2372,186,72,89,161,12.684491978609625,45.20406693972554
Task_23734,2379,309,11,97,108,7.674193548387096,45.205929473996264
Task_23735,2758,170,30,172,202,16.128654970760234,51.22101083247998
Task_23736,1027,744,138,98,236,1.378523489932886,26.073108532210835
Task_23737,2854,207,172,163,335,13.721153846153847,53.81512019811881
Task_23738,1186,497,34,37,71,2.3815261044176705,25.487256206595863
Task_23739,1945,751,179,163,342,2.586436170212766,41.27575665743954
Task_23740,2829,440,113,155,268,6.414965986394558,53.936458938669375
Task_23741,636,143,68,137,205,4.416666666666667,17.760607271042627
Task_23742,948,672,48,100,148,1.4086181277860328,23.967318250390424
Task_23743,1104,774,15,200,215,1.424516129032258,27.460662585000904
Task_23744,2888,1003,39,33,72,2.8764940239043826,53.97927018355858
Task_23745,2582,389,179,106,285,6.62051282051282,49.8630619371073
Task_23746,1052,741,156,87,243,1.417789757412399,26.221868496742005
Task_23747,809,598,19,137,156,1.350584307178631,21.51822601881658
Task_23748,2180,308,178,172,350,7.055016181229774,43.61998493492109
Task_23749,2700,227,182,163,345,11.842105263157896,51.508417392520904
Task_23750,2782,433,103,45,148,6.410138248847926,51.442334059547754
Task_23751,737,954,57,88,145,0.7717277486910995,21.38773691856633
Task_23752,2226,1021,170,181,351,2.1780821917808217,46.63694182600826
Task_23753,643,965,159,96,255,0.6656314699792961,20.912821874813893
Task_23754,2434,432,66,47,113,5.621247113163972,45.7857355455344
Task_23755,711,473,135,79,214,1.5,19.83233985246318
Task_23756,1549,430,160,146,306,3.593967517401392,33.80384688320355
Task_23757,1802,338,50,114,164,5.315634218289086,36.89433897283048
Task_23758,533,594,164,54,218,0.8957983193277311,17.2935946527561
Task_23759,882,688,40,165,205,1.2801161103047896,23.482192440809055
Task_23760,1580,176,173,27,200,8.926553672316384,31.822123560456728
Task_23761,662,983,136,67,203,0.6727642276422764,20.673958924117205
Task_23762,2887,490,14,40,54,5.879837067209776,52.49380117384928
Task_23763,855,774,13,25,38,1.103225806451613,20.981324195584712
Task_23764,855,884,180,134,314,0.9661016949152542,24.169952759131974
Task_23765,2809,796,96,71,167,3.5244667503136764,53.637315682871844
Task_23766,2949,714,145,10,155,4.124475524475525,54.92988525043382
Task_23767,1257,873,95,42,137,1.4382151029748285,28.80043089434824
Task_23768,2599,835,10,162,172,3.1088516746411483,51.0665076768116
Task_23769,2280,175,162,39,201,12.954545454545455,42.85956510870921
Task_23770,1208,146,162,54,216,8.217687074829932,26.21003498597494
Task_23771,2584,522,183,61,244,4.940726577437858,49.55064062187352
Task_23772,2049,795,123,184,307,2.5741206030150754,42.93403448570632
Task_23773,2141,440,174,134,308,4.854875283446712,43.19693333425736
Task_23774,1095,117,186,99,285,9.279661016949152,24.957301479745265
Task_23775,2300,111,76,18,94,20.535714285714285,41.500618443838384
Task_23776,1100,605,116,131,247,1.8151815181518152,26.95976375937762
Task_23777,2460,232,158,45,203,10.55793991416309,46.18625921850605
Task_23778,2084,184,71,68,139,11.264864864864865,40.04903313566983
Task_23779,2548,773,21,23,44,3.291989664082687,47.70625689526525
Task_23780,1646,495,101,17,118,3.318548387096774,33.24615290038521
Task_23781,1094,332,196,73,269,3.285285285285285,25.609115937483462
Task_23782,2038,540,172,78,250,3.767097966728281,41.246463910207275
Task_23783,1916,94,76,116,192,20.16842105263158,37.140114577204464
Task_23784,2687,767,68,160,228,3.4986979166666665,52.68479151148554
Task_23785,1438,149,64,164,228,9.586666666666666,30.549853330359582
Task_23786,1928,125,174,145,319,15.301587301587302,38.35141580079565
Task_23787,1140,211,44,177,221,5.377358490566038,26.290356324033453
Task_23788,2565,87,126,46,172,29.147727272727273,46.229618877725045
Task_23789,2541,713,195,138,333,3.5588235294117645,50.520581606365965
Task_23790,2477,253,167,13,180,9.751968503937007,46.13733659416025
Task_23791,1206,472,60,109,169,2.5496828752642706,27.77661371919707
Task_23792,1430,458,29,183,212,3.1154684095860565,31.68135632042318
Task_23793,787,66,40,35,75,11.746268656716419,16.69656173410729
Task_23794,909,604,14,134,148,1.5024793388429751,23.178569627056152
Task_23795,1173,729,80,57,137,1.606849315068493,27.258760593890255
Task_23796,2775,996,179,65,244,2.7833500501504513,54.16685929713424
Task_23797,991,193,133,63,196,5.108247422680412,23.241760693778854
Task_23798,2293,574,86,75,161,3.9878260869565216,44.68137490479321
Task_23799,1735,142,46,109,155,12.132867132867133,34.230498314942345
Task_23800,1625,86,98,42,140,18.67816091954023,31.074533068303285
Task_23801,1125,878,45,185,230,1.2798634812286689,28.06607510753943
Task_23802,1179,549,59,182,241,2.1436363636363636,28.237900639920525
Task_23803,1823,235,110,60,170,7.72457627118644,36.02701265383853
Task_23804,776,772,163,38,201,1.0038809831824063,21.289822873886408
Task_23805,1053,634,124,91,215,1.6582677165354331,25.94345842658276
Task_23806,555,380,116,61,177,1.4566929133858268,16.45986205365097
Task_23807,1766,943,96,40,136,1.8707627118644068,37.05189539194627
Task_23808,2605,970,95,109,204,2.682801235839341,51.78618870951271
Task_23809,1943,232,32,32,64,8.339055793991417,36.536387340406726
Task_23810,1273,888,19,73,92,1.4319460067491563,28.965607320176247
Task_23811,2812,729,47,157,204,3.852054794520548,54.36079886875683
Task_23812,2883,441,107,78,185,6.52262443438914,53.85934297252362
Task_23813,1766,392,145,28,173,4.493638676844784,35.563763334514476
Task_23814,1480,561,102,109,211,2.6334519572953736,32.644910688379305
Task_23815,1518,569,142,194,336,2.663157894736842,33.95981650457778
Task_23816,1623,909,29,12,41,1.7835164835164836,33.26889484568593
Task_23817,1056,890,67,34,101,1.1851851851851851,25.360514129035284
Task_23818,1729,489,83,75,158,3.5285714285714285,35.4977659972432
Task_23819,1348,400,14,114,128,3.361596009975062,29.615844501896305
Task_23820,2339,360,91,177,268,6.479224376731302,45.99816395390281
Task_23821,1809,73,78,171,249,24.445945945945947,35.75636323368091
Task_23822,2799,636,90,156,246,4.39403453689168,54.046749900173786
Task_23823,2433,552,61,120,181,4.399638336347197,47.53321376164562
Task_23824,2311,506,183,102,285,4.558185404339251,45.9506831976666
Task_23825,1208,425,154,77,231,2.835680751173709,27.593402499950837
Task_23826,1869,980,20,81,101,1.9051987767584098,38.93100398676527
Task_23827,1844,838,175,132,307,2.197854588796186,39.7441072210603
Task_23828,2718,654,51,131,182,4.149618320610687,52.460306902969656
Task_23829,587,610,137,113,250,0.9607201309328969,18.75690961816786
Task_23830,1602,336,108,116,224,4.753709198813056,33.92366702765036
Task_23831,2919,949,17,199,216,3.0726315789473686,56.75004134863945
Task_23832,1187,342,48,192,240,3.4606413994169096,27.686271140058423
Task_23833,1268,176,148,91,239,7.163841807909605,27.5677929170763
Task_23834,2792,928,177,76,253,3.005382131324004,54.359188781117325
Task_23835,846,127,165,183,348,6.609375,21.501902372580037
Task_23836,682,841,69,68,137,0.8099762470308789,19.994335184567245
Task_23837,2708,988,67,20,87,2.738119312436805,51.30579096727021
Task_23838,2597,730,153,172,325,3.5526675786593707,51.47506016214976
Task_23839,644,916,125,154,279,0.7022900763358778,20.910892558010776
Task_23840,2248,416,126,172,298,5.390887290167866,44.82263377174932
Task_23841,2091,596,197,131,328,3.5025125628140703,42.99059832754813
Task_23842,1549,646,41,73,114,2.394126738794436,33.06737521411902
Task_23843,2252,844,181,157,338,2.66508875739645,46.403581054900656
Task_23844,526,792,84,78,162,0.6633039092055486,17.689111848950503
Task_23845,817,660,199,18,217,1.2360060514372164,21.410925950865177
Task_23846,1327,594,20,159,179,2.230252100840336,30.057150209389608
Task_23847,1285,883,61,156,217,1.4536199095022624,30.714765481737434
Task_23848,2105,324,57,117,174,6.476923076923077,41.70806699857075
Task_23849,1987,654,116,119,235,3.033587786259542,41.08988017752768
Task_23850,1519,899,43,157,200,1.6877777777777778,34.33894347383839
Task_23851,2765,369,200,82,282,7.472972972972973,52.35900870142044
Task_23852,548,751,89,92,181,0.7287234042553191,18.066483976766246
Task_23853,1843,352,108,114,222,5.220963172804533,37.77649944890969
Task_23854,2326,759,113,77,190,3.0605263157894735,46.15360447517906
Task_23855,1309,902,195,21,216,1.449612403100775,30.119962408436447
Task_23856,720,782,56,14,70,0.9195402298850575,18.82975002120438
Task_23857,1820,336,10,116,126,5.400593471810089,36.732317115872455
Task_23858,1465,932,78,37,115,1.570203644158628,32.03767150255659
Task_23859,2614,93,64,134,198,27.80851063829787,48.12592314506701
Task_23860,1238,678,137,16,153,1.8232695139911634,27.654113133727467
Task_23861,1581,661,41,16,57,2.38821752265861,32.00265797978904
Task_23862,2202,824,146,24,170,2.669090909090909,43.66617601503285
Task_23863,2247,212,21,118,139,10.549295774647888,42.95586123571051
Task_23864,2668,496,52,106,158,5.368209255533199,50.851406014072865
Task_23865,2249,738,85,37,122,3.0433017591339646,43.84196362912872
Task_23866,782,102,19,28,47,7.592233009708738,17.338124185167572
Task_23867,1517,142,83,59,142,10.608391608391608,30.380858714915306
Task_23868,2780,999,63,182,245,2.78,54.99948554495737
Task_23869,2694,103,154,44,198,25.903846153846153,48.712411067854326
Task_23870,2682,207,67,84,151,12.89423076923077,49.73276757577795
Task_23871,1487,836,136,13,149,1.7765830346475509,32.126096077712354
Task_23872,1500,316,50,12,62,4.73186119873817,29.630842287166818
Task_23873,580,167,174,112,286,3.4523809523809526,17.19798973141693
Task_23874,948,381,111,21,132,2.481675392670157,22.198827983731917
Task_23875,2401,462,118,57,175,5.185745140388769,46.09301497605458
Task_23876,1872,535,138,112,250,3.4925373134328357,38.949803537401046
Task_23877,1061,95,47,83,130,11.052083333333334,22.813141020049084
Task_23878,1080,968,130,143,273,1.1145510835913313,27.74570785614905
Task_23879,2049,593,175,59,234,3.4494949494949494,41.26093891504505
Task_23880,2150,271,28,71,99,7.904411764705882,40.9522482896818
Task_23881,2269,525,199,68,267,4.313688212927756,44.77510318682855
Task_23882,660,83,188,12,200,7.857142857142857,16.47864247845222
Task_23883,2883,709,31,196,227,4.06056338028169,55.56794360594315
Task_23884,2860,918,157,94,251,3.1120783460282917,55.7286750743556
Task_23885,538,680,25,72,97,0.7900146842878121,16.77520474714788
Task_23886,732,337,185,92,277,2.165680473372781,20.26986161357223
Task_23887,1382,656,89,34,123,2.103500761035008,29.926162029338055
Task_23888,1421,788,36,147,183,1.8010139416983524,32.17994936172084
Task_23889,2019,958,42,50,92,2.105318039624609,40.71750234845159
Task_23890,2149,628,113,199,312,3.416534181240064,44.03797471419066
Task_23891,1992,86,146,105,251,22.896551724137932,38.48632719071153
Task_23892,696,228,105,190,295,3.039301310043668,19.675319332956793
Task_23893,1060,626,47,32,79,1.6905901116427433,23.993180384627976
Task_23894,1333,603,32,105,137,2.206953642384106,29.85857219214944
Task_23895,1647,343,175,151,326,4.787790697674419,35.169510466221354
Task_23896,1535,270,11,153,164,5.6642066420664205,32.31768864639695
Task_23897,2055,183,95,104,199,11.168478260869565,40.33269296827849
Task_23898,1210,904,190,105,295,1.3370165745856353,29.769531791731254
Task_23899,2160,746,33,178,211,2.891566265060241,44.145482702353036
Task_23900,701,1019,55,193,248,0.6872549019607843,22.178791727634177
Task_23901,2650,538,175,15,190,4.916512059369202,50.03062457240262
Task_23902,1756,490,148,145,293,3.576374745417515,37.212185980612865
Task_23903,1528,91,175,72,247,16.608695652173914,30.806866914184955
Task_23904,1740,328,127,157,284,5.288753799392097,36.41022793583492
Task_23905,2476,116,166,134,300,21.162393162393162,46.73253896475975
Task_23906,908,557,30,168,198,1.6272401433691757,23.63037497121886
Task_23907,1449,358,97,109,206,4.036211699164346,31.50791582049909
Task_23908,2657,999,20,11,31,2.657,49.87698747988346
Task_23909,2802,640,187,169,356,4.3712948517940715,54.57257192151932
Task_23910,2788,149,17,94,111,18.586666666666666,50.30186779889357
Task_23911,2031,374,121,76,197,5.416,40.29347908899849
Task_23912,2999,211,58,33,91,14.14622641509434,53.527333875635556
Task_23913,1280,677,18,59,77,1.887905604719764,27.700594826935532
Task_23914,1475,105,183,70,253,13.915094339622641,30.001869761075962
Task_23915,1054,189,87,144,231,5.5473684210526315,24.87605908123628
Task_23916,1695,452,69,67,136,3.7417218543046356,34.79706014015348
Task_23917,2223,869,127,22,149,2.5551724137931036,43.99360897994624
Task_23918,2307,618,148,59,207,3.726978998384491,45.3043603403485
Task_23919,1275,633,17,192,209,2.0110410094637223,29.674710239698573
Task_23920,730,816,130,25,155,0.8935128518971848,20.239077426926514
Task_23921,1487,744,32,137,169,1.9959731543624162,33.03559219444015
Task_23922,1405,541,175,62,237,2.592250922509225,30.94995822640067
Task_23923,541,806,40,57,97,0.6703841387856257,17.160729392484736
Task_23924,1030,1005,37,79,116,1.0238568588469186,25.839014433197132
Task_23925,1487,496,115,196,311,2.9919517102615694,33.12864233925815
Task_23926,2924,452,160,84,244,6.454746136865342,54.97374092540144
Task_23927,822,821,186,40,226,1.0,22.260674218853495
Task_23928,629,306,196,126,322,2.04885993485342,18.89586475543309
Task_23929,2903,428,154,70,224,6.766899766899767,54.30040405204013
Task_23930,2238,451,13,104,117,4.951327433628318,43.627028127642426
Task_23931,846,592,65,47,112,1.4266441821247893,20.961898553342124
Task_23932,1485,649,33,116,149,2.2846153846153845,32.47247565814478
Task_23933,1043,334,187,199,386,3.1134328358208956,25.927866251421097
Task_23934,2033,915,192,94,286,2.21943231441048,42.77273773167182
Task_23935,975,346,104,173,277,2.809798270893372,24.361499899225407
Task_23936,2539,146,88,178,266,17.272108843537413,47.9495950931883
Task_23937,1017,649,29,112,141,1.5646153846153845,24.966337737550088
Task_23938,2032,413,57,184,241,4.908212560386473,41.314013356057565
Task_23939,2526,136,62,161,223,18.437956204379564,47.56228426689165
Task_23940,2845,333,177,28,205,8.517964071856287,52.656006894239646
Task_23941,2106,724,182,199,381,2.9048275862068964,43.9701613099499
Task_23942,1827,918,32,111,143,1.9880304678998912,38.69948492682753
Task_23943,2608,808,37,159,196,3.223733003708282,51.31414488436776
Task_23944,2405,304,173,59,232,7.885245901639344,45.940432514038115
Task_23945,522,119,154,49,203,4.35,14.87394477778337
Task_23946,2536,163,121,24,145,15.463414634146341,46.330399884508005
Task_23947,1770,840,170,113,283,2.1046373365041617,38.44185893007848
Task_23948,2022,511,60,31,91,3.94921875,39.07278804433317
Task_23949,936,299,141,29,170,3.12,22.04278311236894
Task_23950,1750,316,69,71,140,5.520504731861199,35.24172665098868
Task_23951,2971,249,81,147,228,11.884,55.42712831086078
Task_23952,2286,438,157,28,185,5.207289293849659,43.93959977783683
Task_23953,963,145,190,62,252,6.595890410958904,22.551338507592828
Task_23954,2534,315,14,129,143,8.018987341772151,47.995183265043465
Task_23955,1659,699,46,191,237,2.37,36.18459708440214
Task_23956,543,405,183,112,295,1.3374384236453203,17.66467603500588
Task_23957,1487,571,41,184,225,2.5996503496503496,32.97269925186935
Task_23958,879,250,133,129,262,3.50199203187251,22.400428328441933
Task_23959,526,873,154,34,188,0.6018306636155606,17.974638168340594
Task_23960,932,971,88,171,259,0.9588477366255144,25.44529259952458
Task_23961,2014,499,177,114,291,4.028,41.270892507675434
Task_23962,2411,697,125,75,200,3.4541547277936964,47.3548354981088
Task_23963,1177,634,59,187,246,1.853543307086614,28.50201914977782
Task_23964,1346,613,151,134,285,2.192182410423453,31.05633972962677
Task_23965,1438,764,48,30,78,1.8797385620915033,30.36135046521184
Task_23966,2766,861,169,71,240,3.2088167053364267,53.597196589874365
Task_23967,1280,322,77,57,134,3.9628482972136223,27.65659648452036
Task_23968,2426,282,32,27,59,8.57243816254417,44.332024139033244
Task_23969,892,694,180,61,241,1.283453237410072,23.258222934519107
Task_23970,2385,140,35,64,99,16.914893617021278,43.67586273374227
Task_23971,1984,534,44,78,122,3.708411214953271,39.68864005031448
Task_23972,2401,646,122,92,214,3.7109737248840804,47.386862352886645
Task_23973,1604,823,181,135,316,1.9466019417475728,35.93982752484378
Task_23974,2703,371,131,81,212,7.266129032258065,51.028127868129
Task_23975,1607,574,176,64,240,2.794782608695652,34.306453976115
Task_23976,2909,699,137,101,238,4.155714285714286,55.82321838443048
Task_23977,1889,816,66,148,214,2.3121175030599757,40.115415129733144
Task_23978,1933,467,104,88,192,4.130341880341881,39.14775057807192
Task_23979,2932,814,40,35,75,3.5975460122699388,54.05574329127638
Task_23980,2133,714,27,82,109,2.983216783216783,42.50020493637938
Task_23981,1224,978,90,34,124,1.250255362614913,28.400264741791258
Task_23982,2446,289,48,198,246,8.434482758620689,47.452030344908344
Task_23983,2586,842,127,198,325,3.0676156583629894,51.690768500545516
Task_23984,2840,625,156,73,229,4.536741214057508,54.006632082611226
Task_23985,536,986,190,90,280,0.5430597771023303,19.150623241942153
Task_23986,2929,938,149,181,330,3.119275825346113,57.42374270154928
Task_23987,2347,688,43,154,197,3.4063860667634254,46.79285106599974
Task_23988,1683,525,96,82,178,3.199619771863118,35.1392434301461
Task_23989,1632,774,173,91,264,2.1058064516129034,35.78579044037641
Task_23990,2363,779,67,171,238,3.0294871794871794,47.650741553172594
Task_23991,852,345,80,184,264,2.46242774566474,22.497596363033466
Task_23992,2360,910,16,55,71,2.5905598243688255,45.74179785782646
Task_23993,2407,113,21,73,94,21.114035087719298,43.62098558835621
Task_23994,1444,626,165,122,287,2.303030303030303,32.640550149845716
Task_23995,557,93,43,39,82,5.925531914893617,13.93033015804482
Task_23996,1471,301,61,86,147,4.870860927152318,31.014724850138606
Task_23997,794,953,23,57,80,0.8322851153039832,21.302764806647893
Task_23998,1036,647,36,39,75,1.5987654320987654,23.478774118582006
Task_23999,927,504,158,197,355,1.8356435643564357,24.48807571218337
Task_24000,2190,347,155,44,199,6.293103448275862,42.334969889621405
Task_24001,1534,583,22,78,100,2.6267123287671232,32.33910260681072
Task_24002,762,437,147,13,160,1.7397260273972603,19.42435651717098
Task_24003,2677,926,157,87,244,2.887810140237325,52.61345261342769
Task_24004,2074,521,178,119,297,3.9731800766283527,42.32555338943101
Task_24005,1250,858,25,155,180,1.4551804423748544,29.61668194034959
Task_24006,2306,954,95,178,273,2.4146596858638745,47.4103692246098
Task_24007,1579,468,50,77,127,3.366737739872068,33.232004236539275
Task_24008,2617,931,104,56,160,2.8079399141630903,50.79804974853348
Task_24009,958,602,82,163,245,1.5887230514096187,24.787708108815426
Task_24010,574,946,38,127,165,0.6061246040126715,19.26800591233512
Task_24011,1642,586,150,81,231,2.7972742759795572,35.014939059812725
Task_24012,1921,723,128,16,144,2.653314917127072,38.61895292620027
Task_24013,1402,127,181,48,229,10.953125,28.870176301330016
Task_24014,2241,859,43,51,94,2.605813953488372,44.09659427089531
Task_24015,1168,288,182,78,260,4.041522491349481,26.711592756463943
Task_24016,529,154,98,131,229,3.412903225806452,16.111593697197648
Task_24017,2922,390,81,133,214,7.4731457800511505,55.06931402874667
Task_24018,2366,881,115,147,262,2.6825396825396823,47.96825732428757
Task_24019,1505,341,89,22,111,4.400584795321637,30.65861697262029
Task_24020,1824,939,98,198,296,1.9404255319148935,39.802607516636904
Task_24021,2708,611,136,67,203,4.42483660130719,51.7113882482162
Task_24022,1068,75,188,105,293,14.052631578947368,24.09534418476819
Task_24023,2005,987,113,118,231,2.029352226720648,42.39584649073652
Task_24024,2039,277,106,117,223,7.33453237410072,40.630572858035684
Task_24025,1166,764,128,91,219,1.5241830065359476,28.126603002977618
Task_24026,997,239,56,121,177,4.154166666666667,23.81023827153774
Task_24027,981,888,17,86,103,1.1034870641169854,24.47162830339522
Task_24028,1288,901,15,135,150,1.4279379157427938,30.03892075787949
Task_24029,2737,615,83,110,193,4.443181818181818,52.69595446237678
Task_24030,2536,500,165,74,239,5.06187624750499,48.88813984132142
Task_24031,1210,807,125,36,161,1.4975247524752475,27.844853871159696
Task_24032,647,472,55,146,201,1.3678646934460887,19.243896675386296
Task_24033,2882,570,85,22,107,5.047285464098073,53.11480519008463
Task_24034,2484,896,200,20,220,2.769230769230769,48.65588965673974
Task_24035,2245,728,14,123,137,3.0795610425240056,44.726270329013765
Task_24036,1681,602,174,23,197,2.7877280265339968,35.04616176139606
Task_24037,1617,899,136,120,256,1.7966666666666666,36.089724691441056
Task_24038,711,254,170,176,346,2.788235294117647,20.20651293212461
Task_24039,583,907,43,168,211,0.6420704845814978,19.610441024619465
Task_24040,995,920,108,37,145,1.0803474484256244,24.8083106015057
Task_24041,2770,454,57,23,80,6.087912087912088,50.63250999835139
Task_24042,2946,857,103,107,210,3.4335664335664338,56.79002686486825
Task_24043,2484,83,12,126,138,29.571428571428573,45.205803203553046
Task_24044,1173,446,24,111,135,2.6241610738255035,26.833399461819358
Task_24045,1852,128,12,11,23,14.356589147286822,34.092096918295034
Task_24046,1737,298,32,199,231,5.809364548494983,36.1244897966339
Task_24047,2958,757,157,151,308,3.9023746701846966,57.171647679706346
Task_24048,672,189,147,120,267,3.536842105263158,18.952304923944393
Task_24049,1737,398,92,113,205,4.353383458646617,36.249605002804415
Task_24050,1271,732,36,49,85,1.7339699863574352,28.005661856160998
Task_24051,710,655,193,24,217,1.0823170731707317,19.90029665610336
Task_24052,1544,608,104,85,189,2.535303776683087,33.36511600187453
Task_24053,1516,359,15,86,101,4.211111111111111,31.52212525432152
Task_24054,517,784,17,102,119,0.6585987261146496,17.253376761770614
Task_24055,2589,384,62,148,210,6.724675324675324,49.8086094181816
Task_24056,2589,249,51,155,206,10.356,49.396425738220984
Task_24057,2730,656,27,165,192,4.155251141552512,52.778997704669536
Task_24058,2961,647,180,153,333,4.569444444444445,56.98604406384023
Task_24059,2317,771,200,96,296,3.0012953367875648,46.94974268601723
Task_24060,1758,954,94,126,220,1.8408376963350785,38.42515993662573
Task_24061,843,809,173,22,195,1.0407407407407407,22.374158549040384
Task_24062,2339,699,120,37,157,3.3414285714285716,45.389625127978235
Task_24063,2021,427,146,157,303,4.72196261682243,41.2666930070617
Task_24064,2926,124,80,178,258,23.408,53.92989895803364
Task_24065,1181,256,172,34,206,4.595330739299611,26.129924009720906
Task_24066,2664,945,134,137,271,2.8160676532769555,52.915993485790445
Task_24067,1394,948,89,85,174,1.4689146469968388,31.91594685711087
Task_24068,886,379,144,137,281,2.331578947368421,23.023987740548268
Task_24069,2173,110,104,137,241,19.576576576576578,41.504538575725235
Task_24070,1949,273,119,143,262,7.113138686131387,39.40799632500038
Task_24071,2965,277,63,57,120,10.66546762589928,53.81995961912562
Task_24072,2137,476,115,199,314,4.480083857442348,43.37242457759849
Task_24073,2605,549,49,80,129,4.736363636363636,49.87301019245874
Task_24074,2906,370,63,121,184,7.83288409703504,54.44604403490684
Task_24075,802,246,139,75,214,3.2469635627530367,20.51097545462406
Task_24076,2842,658,161,80,241,4.312594840667678,54.329357163635365
Task_24077,789,362,58,151,209,2.1735537190082646,21.286064762086635
Task_24078,2562,1009,178,188,366,2.5366336633663367,52.002150173616066
Task_24079,1183,981,28,96,124,1.204684317718941,28.530072774583484
Task_24080,1529,149,133,84,217,10.193333333333333,31.503605090851682
Task_24081,2293,293,92,11,103,7.799319727891157,42.84030920035239
Task_24082,1517,187,82,162,244,8.069148936170214,32.44451767960633
Task_24083,2491,920,72,146,218,2.7046688382193267,49.997900960104666
Task_24084,2915,801,92,45,137,3.634663341645885,54.825596249863274
Task_24085,1638,756,177,40,217,2.163804491413474,34.999381529505705
Task_24086,2326,534,24,178,202,4.347663551401869,46.058254007842606
Task_24087,2891,777,128,83,211,3.7159383033419022,55.34306205166164
Task_24088,2901,870,195,181,376,3.330654420206659,56.974452608558124
Task_24089,2168,755,179,30,209,2.867724867724868,43.366783524627614
Task_24090,2730,800,133,123,256,3.4082397003745317,53.41954654379214
Task_24091,576,433,182,169,351,1.327188940092166,18.610372979513773
Task_24092,1142,877,17,85,102,1.3006833712984054,26.99993532061219
Task_24093,1921,162,187,11,198,11.785276073619633,37.164157616646904
Task_24094,696,282,22,99,121,2.4593639575971733,18.588694528609505
Task_24095,2618,573,197,122,319,4.560975609756097,51.209122641066834
Task_24096,1249,1024,94,59,153,1.2185365853658536,29.24845352991557
Task_24097,2253,520,119,70,189,4.324376199616123,44.121263873292946
Task_24098,1994,638,77,165,242,3.1205007824726136,41.37523335314133
Task_24099,2175,361,138,159,297,6.00828729281768,43.46221811638069
Task_24100,2485,305,103,56,159,8.120915032679738,46.68821166004628
Task_24101,2060,980,72,26,98,2.0998980632008153,41.39956635361969
Task_24102,2289,150,15,11,26,15.158940397350994,41.212828760983484
Task_24103,2638,295,96,109,205,8.912162162162161,50.12288892488382
Task_24104,554,781,134,110,244,0.7084398976982097,18.84571584428593
Task_24105,1771,598,163,28,191,2.956594323873122,36.45884168496023
Task_24106,1965,774,74,200,274,2.535483870967742,41.54412527640738
Task_24107,981,959,118,37,155,1.021875,24.65894961422627
Task_24108,1325,321,119,37,156,4.114906832298137,28.125575036062745
Task_24109,2558,1013,180,101,281,2.5226824457593686,51.44058663587102
Task_24110,652,116,134,79,213,5.572649572649572,17.32508360154719
Task_24111,1338,379,151,38,189,3.5210526315789474,28.934756105287914
Task_24112,2605,741,195,20,215,3.51078167115903,50.06438219875982
Task_24113,2366,459,122,83,205,5.143478260869565,45.98760037451871
Task_24114,2192,545,175,190,365,4.014652014652015,44.6810772943389
Task_24115,1117,546,59,127,186,2.0420475319926874,26.788330602485477
Task_24116,2773,112,191,116,307,24.539823008849556,51.22693500382143
Task_24117,1726,663,147,98,245,2.5993975903614457,37.001790208319036
Task_24118,1989,1000,110,145,255,1.9870129870129871,42.330438241110215
Task_24119,648,849,161,125,286,0.7623529411764706,20.670518396561945
Task_24120,1421,342,41,38,79,4.142857142857143,28.833588567250928
Task_24121,969,522,19,90,109,1.852772466539197,23.449707388488495
Task_24122,2497,780,196,149,345,3.1971830985915495,50.104577217619045
Task_24123,1213,847,82,50,132,1.4304245283018868,28.01254532150484
Task_24124,800,975,104,155,259,0.819672131147541,23.359509788149893
Task_24125,1789,434,177,158,335,4.11264367816092,37.763343357561645
Task_24126,1306,338,46,76,122,3.8525073746312684,28.283667304854898
Task_24127,2423,583,40,131,171,4.148972602739726,47.31345285518129
Task_24128,716,883,132,131,263,0.8099547511312217,21.743149729070968
Task_24129,2281,330,27,30,57,6.891238670694864,42.239747872679764
Task_24130,2534,476,51,190,241,5.312368972746331,49.51056018347777
Task_24131,1265,699,42,16,58,1.8071428571428572,27.117648387984033
Task_24132,680,876,35,182,217,0.7753705815279361,20.9534995404871
Task_24133,880,466,86,194,280,1.8843683083511777,23.324508461967813
Task_24134,1027,204,33,200,233,5.009756097560976,24.604132033222395
Task_24135,1370,461,112,150,262,2.965367965367965,30.877198760579585
Task_24136,1947,793,137,193,330,2.452141057934509,41.42865697836249
Task_24137,883,925,59,78,137,0.9535637149028078,23.62352156625536
Task_24138,2564,448,15,104,119,5.710467706013363,48.7498000186086
Task_24139,2230,258,16,137,153,8.61003861003861,42.908942837160886
Task_24140,757,836,100,151,251,0.9044205495818399,22.222746467950348
Task_24141,903,412,64,129,193,2.1864406779661016,23.117067753553922
Task_24142,2040,66,146,171,317,30.44776119402985,39.5573605204072
Task_24143,1962,774,182,18,200,2.5316129032258066,39.85476481247765
Task_24144,2912,367,193,35,228,7.913043478260869,53.978876707285856
Task_24145,2992,732,28,30,58,4.081855388813097,54.800175544467656
Task_24146,2892,104,19,93,112,27.542857142857144,51.48438565067292
Task_24147,872,358,145,88,233,2.4289693593314765,22.195670463733848
Task_24148,1008,642,17,110,127,1.567651632970451,24.668914626262065
Task_24149,1276,172,22,140,162,7.375722543352601,27.145805213585646
Task_24150,2168,464,169,111,280,4.662365591397849,43.54215603635644
Task_24151,1848,385,145,149,294,4.787564766839378,38.33994152950266
Task_24152,1931,406,77,43,120,4.744471744471745,37.73199467797527
Task_24153,2820,921,75,69,144,3.058568329718004,54.075984863967165
Task_24154,2024,452,105,52,157,4.467991169977925,39.88978141252741
Task_24155,2389,239,100,83,183,9.954166666666667,45.29869836162292
Task_24156,957,194,115,92,207,4.907692307692308,22.97682942841389
Task_24157,1064,601,93,193,286,1.7674418604651163,26.742346357717054
Task_24158,2098,949,107,162,269,2.208421052631579,43.98716655324358
Task_24159,1786,925,85,88,173,1.9287257019438444,38.147721957116005
Task_24160,2579,444,180,71,251,5.795505617977528,49.35725388556648
Task_24161,1084,757,104,146,250,1.4300791556728232,27.146663790932646
Task_24162,981,914,148,113,261,1.0721311475409836,25.926339541259043
Task_24163,757,198,79,171,250,3.8040201005025125,20.48811487930251
Task_24164,1867,908,63,82,145,2.053905390539054,39.22133462856478
Task_24165,1978,104,180,114,294,18.83809523809524,38.58761065566234
Task_24166,1261,214,50,25,75,5.865116279069768,25.683431029336052
Task_24167,2059,1006,80,66,146,2.044687189672294,42.26853506407165
Task_24168,1497,171,151,168,319,8.703488372093023,31.843840453919665
Task_24169,638,80,181,171,352,7.8765432098765435,17.76827542028473
Task_24170,1354,885,191,132,323,1.528216704288939,32.155829769549094
Task_24171,1859,965,69,113,182,1.9244306418219461,39.724861835300814
Task_24172,776,319,133,89,222,2.425,20.569306852176364
Task_24173,2253,493,169,169,338,4.560728744939271,45.32771145983707
Task_24174,1129,616,47,16,63,1.8298217179902756,24.697575658887104
Task_24175,2917,482,14,147,161,6.0393374741200825,54.718818702199684
Task_24176,1765,713,119,70,189,2.4719887955182074,37.00295466470491
Task_24177,1728,738,69,195,264,2.3382949932341,37.6143145773391
Task_24178,1992,552,165,27,192,3.602169981916817,39.79753588858233
Task_24179,1845,788,56,103,159,2.338403041825095,38.7257389966321
Task_24180,1343,345,191,31,222,3.8815028901734103,29.053030580616834
Task_24181,1421,85,41,94,135,16.523255813953487,28.634664221974088
Task_24182,965,740,126,112,238,1.302294197031039,25.106249519182327
Task_24183,1498,442,122,92,214,3.381489841986456,32.44057812298559
Task_24184,1833,662,18,200,218,2.764705882352941,38.69207238522002
Task_24185,1876,1009,180,92,272,1.8574257425742575,40.46588239099061
Task_24186,1925,892,166,39,205,2.1556550951847706,39.87942984876623
Task_24187,760,610,86,115,201,1.2438625204582652,21.264252344262825
Task_24188,1493,325,169,113,282,4.579754601226994,32.420546089440585
Task_24189,938,924,73,119,192,1.0140540540540541,25.054212760092426
Task_24190,1021,1017,55,186,241,1.0029469548133596,26.97574991172779
Task_24191,2783,648,97,37,134,4.288135593220339,52.21411740801768
Task_24192,2532,892,149,94,243,2.83538633818589,50.41402435019213
Task_24193,2913,769,177,136,313,3.7831168831168833,56.497152644294204
Task_24194,1963,369,133,174,307,5.305405405405406,40.202039566043844
Task_24195,1429,502,178,14,192,2.840954274353877,30.602966913892136
Task_24196,2914,456,97,26,123,6.3763676148796495,53.49769670413468
Task_24197,713,139,94,44,138,5.0928571428571425,17.45110197978843
Task_24198,668,840,166,149,315,0.7942925089179548,21.141842447303535
Task_24199,2017,185,162,159,321,10.844086021505376,40.29585644139147
Task_24200,2147,1019,29,19,48,2.104901960784314,41.97595757823925
Task_24201,2608,714,200,176,376,3.6475524475524477,51.834573796905694
Task_24202,2488,911,44,171,215,2.7280701754385963,49.83205087441494
Task_24203,1071,448,156,171,327,2.3853006681514475,26.427125314621225
Task_24204,2327,684,56,176,232,3.397080291970803,46.798474968318565
Task_24205,1506,610,10,52,62,2.46481178396072,31.145030327850762
Task_24206,1473,516,43,84,127,2.849129593810445,31.602355592473497
Task_24207,1178,247,127,142,269,4.75,27.165127757609927
Task_24208,2055,647,185,160,345,3.1712962962962963,42.7007316739369
Task_24209,951,914,43,145,188,1.039344262295082,25.060386115109697
Task_24210,2431,276,87,122,209,8.776173285198556,46.77576039019409
Task_24211,702,74,146,77,223,9.36,17.646854014833256
Task_24212,2111,119,178,190,368,17.591666666666665,41.47558587479054
Task_24213,697,165,75,75,150,4.198795180722891,17.875568076725774
Task_24214,2709,279,14,108,122,9.675,50.53431077959311
Task_24215,1908,103,111,139,250,18.346153846153847,37.33156153518641
Task_24216,2922,803,135,169,304,3.6343283582089554,56.754635991947964
Task_24217,1062,300,122,137,259,3.528239202657807,25.45488006907358
Task_24218,1953,525,113,28,141,3.7129277566539924,38.60945722623001
Task_24219,2266,277,69,127,196,8.151079136690647,44.233029905384285
Task_24220,2725,865,90,142,232,3.1466512702078524,53.5131969918877
Task_24221,1451,616,146,190,336,2.3517017828200975,33.040596276571044
Task_24222,1812,811,26,166,192,2.231527093596059,38.725418997824185
Task_24223,2481,114,76,112,188,21.57391304347826,46.32874103420528
Task_24224,1483,590,47,32,79,2.509306260575296,30.579527140242003
Task_24225,2216,928,86,56,142,2.385360602798708,44.38154414367131
Task_24226,1302,919,87,154,241,1.4152173913043478,31.08030905560358
Task_24227,1031,905,84,104,188,1.1379690949227372,26.39500413472308
Task_24228,1940,639,10,138,148,3.03125,39.62081937238887
Task_24229,2749,827,97,53,150,3.320048309178744,52.55509954411289
Task_24230,2297,729,135,90,225,3.1465753424657534,45.98383786480749
Task_24231,1248,1012,148,80,228,1.2319842053307009,30.049688991721908
Task_24232,2874,184,181,199,380,15.535135135135135,54.137871240784
Task_24233,2504,526,157,146,303,4.751423149905123,49.21629121205564
Task_24234,883,938,159,58,217,0.9403620873269436,23.872635103526587
Task_24235,730,295,38,182,220,2.4662162162162162,20.092394724468893
Task_24236,911,262,76,25,101,3.463878326996198,20.981774419206424
Task_24237,2802,649,17,195,212,4.310769230769231,53.9280811686144
Task_24238,1570,654,89,124,213,2.3969465648854964,34.43310356741388
Task_24239,1609,265,19,156,175,6.048872180451128,33.5525066922923
Task_24240,1033,213,173,32,205,4.827102803738318,23.639571664545127
Task_24241,1133,815,134,195,329,1.3884803921568627,28.530818989403
Task_24242,2497,114,56,67,123,21.713043478260868,45.47884628354769
Task_24243,1474,519,174,112,286,2.8346153846153848,32.75982631761823
Task_24244,2042,636,40,14,54,3.205651491365777,39.23483865128484
Task_24245,840,746,64,105,169,1.1244979919678715,22.63517878621101
Task_24246,1229,497,109,139,248,2.467871485943775,28.679872515153708
Task_24247,975,979,122,145,267,0.9948979591836735,26.17380953306875
Task_24248,2181,540,43,107,150,4.031423290203327,43.07372707398604
Task_24249,2838,1018,199,62,261,2.785083415112856,55.253426218128844
Task_24250,1772,345,49,59,108,5.121387283236994,35.18509171182256
Task_24251,2897,660,123,83,206,4.382753403933434,55.04537893106342
Task_24252,1176,551,10,19,29,2.130434782608696,24.98921980894872
Task_24253,2295,624,96,172,268,3.672,46.15257647714156
Task_24254,2292,241,20,144,164,9.47107438016529,44.14193884769349
Task_24255,1235,475,169,165,334,2.5945378151260505,29.131116403712614
Task_24256,1345,830,68,112,180,1.618531889290012,31.138428975543686
Task_24257,1930,732,168,130,298,2.6330150068212825,40.73196288986359
Task_24258,1817,171,137,75,212,10.563953488372093,35.96408962296631
Task_24259,2566,341,199,34,233,7.502923976608187,48.437187514837994
Task_24260,1607,585,175,149,324,2.742320819112628,35.29951355593507
Task_24261,2336,461,27,48,75,5.0562770562770565,43.56299256144462
Task_24262,2835,771,24,189,213,3.672279792746114,54.93761906918741
Task_24263,734,595,177,118,295,1.2315436241610738,21.20652577907138
Task_24264,1971,293,113,75,188,6.704081632653061,38.979268839017
Task_24265,980,169,12,68,80,5.764705882352941,21.70593585807208
Task_24266,527,549,140,54,194,0.9581818181818181,16.980506892781353
Task_24267,2152,562,27,45,72,3.822380106571936,40.92584591584291
Task_24268,2402,832,112,149,261,2.883553421368547,48.38388074694243
Task_24269,2812,875,108,50,158,3.2100456621004567,53.475837367479585
Task_24270,625,456,183,113,296,1.3676148796498906,19.106852651406747
Task_24271,2747,727,62,123,185,3.7733516483516483,53.137006029848045
Task_24272,1089,556,164,134,298,1.9551166965888689,26.866631904688006
Task_24273,1621,244,141,127,268,6.616326530612245,34.12722955293621
Task_24274,1600,512,144,149,293,3.1189083820662766,34.81831923727568
Task_24275,1334,759,94,106,200,1.7552631578947369,30.968096788173426
Task_24276,1040,567,66,200,266,1.8309859154929577,26.20030791651544
Task_24277,2556,984,13,142,155,2.5949238578680203,50.558169683051
Task_24278,654,324,79,93,172,2.0123076923076924,18.607342468640656
Task_24279,2960,645,146,157,303,4.58204334365325,56.834483654193434
Task_24280,2544,127,31,69,100,19.875,46.01138514366979
Task_24281,2482,524,165,160,325,4.727619047619048,48.981212185719166
Task_24282,1748,484,109,137,246,3.6041237113402063,36.84283498435009
Task_24283,1982,854,191,125,316,2.31812865497076,42.0107853820566
Task_24284,2872,705,53,61,114,4.067988668555241,53.911463061742644
Task_24285,1065,174,32,112,144,6.085714285714285,23.686871758190282
Task_24286,2630,983,13,64,77,2.6727642276422765,50.24913451045372
Task_24287,957,591,181,131,312,1.616554054054054,24.930991684367964
Task_24288,810,154,71,186,257,5.225806451612903,20.8690042696109
Task_24289,1757,707,177,103,280,2.481638418079096,37.79249434357343
Task_24290,1588,378,78,104,182,4.189973614775726,33.5811262158053
Task_24291,2575,649,76,187,263,3.9615384615384617,50.751279911458944
Task_24292,2384,935,173,135,308,2.547008547008547,48.611728793886414
Task_24293,580,1000,180,34,214,0.5794205794205795,19.305962500147984
Task_24294,905,665,58,76,134,1.3588588588588588,23.071554302115562
Task_24295,712,81,182,80,262,8.682926829268293,18.150382492758663
Task_24296,2846,716,88,105,193,3.9693165969316597,54.70174642487959
Task_24297,1893,806,148,97,245,2.345724907063197,40.12350202543301
Task_24298,2732,725,132,16,148,3.763085399449036,51.47980462935187
Task_24299,2879,585,47,135,182,4.912969283276451,54.650300748518
Task_24300,1298,240,124,187,311,5.385892116182573,29.292382791724567
Task_24301,1518,400,130,43,173,3.7855361596009973,31.693283679125184
Task_24302,1851,704,190,123,313,2.625531914893617,39.45015427065137
Task_24303,2576,500,43,169,212,5.141716566866267,49.9095169022141
Task_24304,536,389,28,158,186,1.3743589743589744,16.922729502817084
Task_24305,1417,867,174,119,293,1.6324884792626728,32.973210639226004
Task_24306,1067,227,176,95,271,4.6798245614035086,25.255937875058333
Task_24307,1381,848,170,51,221,1.6266195524146054,31.483515844800937
Task_24308,969,92,15,143,158,10.419354838709678,21.654577358232263
Task_24309,1305,1006,183,123,306,1.2959285004965244,31.61518126544739
Task_24310,1167,345,167,73,240,3.3728323699421967,26.674995626091185
Task_24311,1771,186,181,189,370,9.470588235294118,36.98612883412883
Task_24312,1196,447,41,84,125,2.669642857142857,26.990479211827815
Task_24313,1380,893,167,53,220,1.5436241610738255,31.632073008796073
Task_24314,1224,617,152,143,295,1.9805825242718447,29.19497854276672
Task_24315,2977,411,168,175,343,7.225728155339806,56.54954454764356
Task_24316,1615,576,27,80,107,2.79896013864818,33.77555537295172
Task_24317,1572,201,171,172,343,7.782178217821782,33.6033496843754
Task_24318,1142,961,196,87,283,1.187110187110187,28.501500221188525
Task_24319,904,138,181,112,293,6.503597122302159,22.176114819892685
Task_24320,1131,484,50,105,155,2.331958762886598,26.48647005303612
Task_24321,1448,766,119,129,248,1.8878748370273795,32.97558404749242
Task_24322,2246,520,41,58,99,4.310940499040307,43.04244424346913
Task_24323,1909,823,129,71,200,2.316747572815534,39.719696824272965
Task_24324,845,950,119,64,183,0.8885383806519453,22.988497887517365
Task_24325,1242,168,198,27,225,7.349112426035503,26.68069019937251
Task_24326,2836,666,128,168,296,4.251874062968516,54.921857777352976
Task_24327,1461,282,114,83,197,5.162544169611308,31.051083005691027
Task_24328,2276,272,179,114,293,8.336996336996338,44.66998634464358
Task_24329,598,228,159,78,237,2.611353711790393,17.404141382894988
Task_24330,1937,890,137,165,302,2.1739618406285075,41.40548308147829
Task_24331,2466,699,144,17,161,3.5228571428571427,47.17099279681713
Task_24332,1521,230,161,108,269,6.584415584415584,32.475053673451406
Task_24333,2993,126,89,45,134,23.566929133858267,53.05316089104462
Task_24334,733,585,11,54,65,1.2508532423208192,18.786941192774346
Task_24335,1816,70,102,141,243,25.577464788732396,35.61588133356915
Task_24336,1893,140,54,86,140,13.425531914893616,36.65850026562594
Task_24337,2465,247,162,32,194,9.939516129032258,46.32955590642823
Task_24338,2404,742,106,192,298,3.2355316285329745,48.36307064442898
Task_24339,2417,670,168,104,272,3.602086438152012,48.09590143125814
Task_24340,1429,190,71,71,142,7.481675392670157,29.868101803057844
Task_24341,584,800,61,162,223,0.7290886392009988,19.407068265160593
Task_24342,2312,388,127,96,223,5.943444730077121,45.31719910727893
Task_24343,1748,738,156,143,299,2.365358592692828,37.89116881089685
Task_24344,2841,493,21,63,84,5.751012145748988,52.389254038981996
Task_24345,2803,105,139,42,181,26.443396226415093,50.189741696000006
Task_24346,1801,384,103,166,269,4.677922077922078,37.50528568136126
Task_24347,1732,478,151,169,320,3.615866388308977,36.95082483024334
Task_24348,2266,102,85,102,187,22.0,42.536107056926966
Task_24349,2096,580,27,56,83,3.6075731497418246,40.814792451065024
Task_24350,2560,899,114,53,167,2.8444444444444446,49.96672427559536
Task_24351,955,205,138,150,288,4.635922330097087,23.597718887795363
Task_24352,1908,642,164,157,321,2.967340590979782,40.24417087518828
Task_24353,1585,753,17,183,200,2.1021220159151195,34.906030947539584
Task_24354,2254,455,133,160,293,4.942982456140351,45.00467825826998
Task_24355,1523,542,17,143,160,2.8047882136279925,32.706863421348935
Task_24356,2939,893,198,130,328,3.2874720357941833,57.357552787932356
Task_24357,1505,605,87,145,232,2.4834983498349836,33.33510443252979
Task_24358,946,664,19,49,68,1.4225563909774437,22.218528434246867
Task_24359,1574,575,49,193,242,2.732638888888889,34.60115511469505
Task_24360,1210,737,16,72,88,1.6395663956639566,27.50358904280419
Task_24361,2223,658,94,112,206,3.3732928679817906,44.78327141950843
Task_24362,1480,239,95,199,294,6.166666666666667,32.175142972849976
Task_24363,760,753,71,33,104,1.0079575596816976,20.15398381211783
Task_24364,2190,185,47,14,61,11.774193548387096,40.17677292134673
Task_24365,1177,413,84,120,204,2.842995169082126,27.411920927392455
Task_24366,821,343,17,52,69,2.386627906976744,19.478265289705348
Task_24367,2204,384,38,106,144,5.724675324675324,42.94498970044808
Task_24368,2659,762,102,16,118,3.4849279161205766,50.20294051438638
Task_24369,2926,337,18,152,170,8.65680473372781,54.466531654083134
Task_24370,595,325,116,196,312,1.8251533742331287,18.47602812233684
Task_24371,737,214,115,165,280,3.427906976744186,20.172265041209275
Task_24372,538,487,93,38,131,1.1024590163934427,16.312344323653303
Task_24373,2712,225,57,145,202,12.0,51.1779143212045
Task_24374,1252,896,168,44,212,1.3957636566332219,29.27544682617474
Task_24375,939,666,34,103,137,1.4077961019490255,23.687741229350724
Task_24376,2988,872,138,44,182,3.422680412371134,56.39794216914506
Task_24377,2680,344,19,104,123,7.768115942028985,50.24419256417232
Task_24378,623,169,150,69,219,3.664705882352941,17.18643000479366
Task_24379,2283,761,136,189,325,2.9960629921259843,46.623171863887904
Task_24380,1524,322,94,56,150,4.718266253869969,31.58175558234177
Task_24381,1186,834,60,185,245,1.4203592814371258,29.162887383688044
Task_24382,1315,465,198,65,263,2.8218884120171674,29.459184083244875
Task_24383,2397,636,112,186,298,3.7629513343799057,47.908935913087724
Task_24384,1865,558,39,126,165,3.336314847942755,38.486089369950854
Task_24385,1854,294,123,104,227,6.284745762711864,37.7637423648053
Task_24386,2684,262,128,79,207,10.20532319391635,50.350087428652465
Task_24387,740,882,124,200,324,0.8380520951302378,22.480363524272082
Task_24388,2276,844,59,124,183,2.693491124260355,46.00919292929234
Task_24389,2760,740,103,40,143,3.7246963562753037,52.11335342162673
Task_24390,1828,596,108,119,227,3.0619765494137354,38.352820740642834
Task_24391,1248,403,30,50,80,3.089108910891089,26.54046912935271
Task_24392,542,318,92,40,132,1.6990595611285266,15.755360234422055
Task_24393,2451,221,75,36,111,11.04054054054054,45.27241516175648
Task_24394,1881,810,72,83,155,2.3193588162762024,39.04783549364239
Task_24395,1181,503,12,122,134,2.3432539682539684,27.119872077650086
Task_24396,909,579,193,132,325,1.5672413793103448,24.16421317406586
Task_24397,669,553,63,190,253,1.2075812274368232,20.124284977980007
Task_24398,2004,734,35,41,76,2.726530612244898,39.14236158923513
Task_24399,2272,188,80,71,151,12.02116402116402,43.154800328836366
Task_24400,1098,514,141,195,336,2.1320388349514565,27.138131433237863
Task_24401,2966,188,120,73,193,15.693121693121693,54.45637071102019
Task_24402,2375,422,90,88,178,5.614657210401892,45.79897403068293
Task_24403,1400,760,64,130,194,1.8396846254927726,32.08254890640306
Task_24404,722,846,104,110,214,0.8524203069657615,21.464603320335147
Task_24405,2099,571,97,163,260,3.6695804195804196,42.8020977056361
Task_24406,1073,614,49,78,127,1.7447154471544715,25.722646152686476
Task_24407,1885,333,130,26,156,5.6437125748503,36.96781494606034
Task_24408,1233,164,44,107,151,7.472727272727273,26.40676005112365
Task_24409,2891,523,157,197,354,5.517175572519084,55.63852258282117
Task_24410,1155,339,13,37,50,3.3970588235294117,24.5772187699211
Task_24411,2632,502,33,65,98,5.2326043737574555,49.34331751131959
Task_24412,1210,851,68,192,260,1.42018779342723,29.66797610515707
Task_24413,935,414,64,146,210,2.253012048192771,23.731319605368558
Task_24414,2331,657,92,191,283,3.5425531914893615,46.94728645863793
Task_24415,1196,1005,10,43,53,1.1888667992047715,27.382494467159603
Task_24416,2129,769,157,153,310,2.764935064935065,44.08816905753745
Task_24417,1839,572,78,71,149,3.2094240837696337,37.49447982505411
Task_24418,500,922,154,130,284,0.5417118093174431,18.62034412292066
Task_24419,549,584,71,62,133,0.9384615384615385,17.043815988658668
Task_24420,909,739,131,157,288,1.2283783783783784,24.45104375552396
Task_24421,1387,684,29,172,201,2.024817518248175,31.645774266508578
Task_24422,2124,430,144,121,265,4.928074245939675,42.68249883752956
Task_24423,561,140,174,138,312,3.978723404255319,16.923117570487417
Task_24424,1889,579,70,81,151,3.2568965517241377,38.43961409985251
Task_24425,800,535,118,87,205,1.492537313432836,21.444079012412363
Task_24426,1621,267,184,132,316,6.048507462686567,34.43057327646587
Task_24427,1506,1001,167,141,308,1.5029940119760479,34.86970564330968
Task_24428,2039,297,141,149,290,6.842281879194631,41.04871401397143
Task_24429,2501,330,183,58,241,7.555891238670695,47.60145029071246
Task_24430,1296,764,98,174,272,1.6941176470588235,30.735963532115495
Task_24431,624,474,152,78,230,1.3136842105263158,18.52332033042408
Task_24432,2027,768,62,147,209,2.635890767230169,42.133100967657064
Task_24433,526,598,58,30,88,0.8781302170283807,15.842855344398155
Task_24434,2008,303,85,134,219,6.605263157894737,40.28448035933513
Task_24435,1516,411,18,51,69,3.679611650485437,30.657985979555118
Task_24436,1981,441,43,125,168,4.481900452488688,39.849101467068316
Task_24437,1039,355,45,107,152,2.918539325842697,24.39217348886307
Task_24438,1551,475,185,105,290,3.258403361344538,33.84703533622739
Task_24439,2396,291,83,102,185,8.205479452054794,46.049274035705174
Task_24440,2038,561,176,187,363,3.626334519572954,42.28011935362531
Task_24441,2045,526,47,199,246,3.8804554079696394,41.82015690946832
Task_24442,1469,163,151,77,228,8.957317073170731,30.55362050928669
Task_24443,521,622,153,117,270,0.8362760834670947,17.841780485586565
Task_24444,1551,931,22,187,209,1.6641630901287554,34.98569381432471
Task_24445,2760,416,23,80,103,6.618705035971223,51.36501878628
Task_24446,1780,316,126,151,277,5.615141955835962,36.96234993107234
Task_24447,1302,467,174,193,367,2.782051282051282,30.35614472227383
Task_24448,2020,861,34,162,196,2.34338747099768,42.17595541977539
Task_24449,1796,869,62,93,155,2.064367816091954,38.11211617733986
Task_24450,1844,82,100,102,202,22.216867469879517,35.90194058468855
Task_24451,1883,236,152,85,237,7.9451476793248945,37.76168534828968
Task_24452,2614,240,66,10,76,10.846473029045644,47.064843202983525
Task_24453,2041,261,142,10,152,7.790076335877862,39.04207411762996
Task_24454,1810,1003,83,66,149,1.802788844621514,38.24200225352295
Task_24455,2755,93,22,13,35,29.30851063829787,47.71471459540523
Task_24456,879,176,99,42,141,4.966101694915254,20.170239185972004
Task_24457,1413,159,130,108,238,8.83125,30.0917235147942
Task_24458,2927,534,119,45,164,5.471028037383178,54.33900487442199
Task_24459,2142,931,117,59,176,2.2982832618025753,43.356136089856285
Task_24460,2485,352,96,200,296,7.039660056657223,48.444206022104716
Task_24461,2419,247,63,175,238,9.754032258064516,46.808684981026666
Task_24462,1112,401,151,152,303,2.7661691542288556,26.790935329388926
Task_24463,1732,857,105,56,161,2.0186480186480185,36.55556151771819
Task_24464,2588,599,133,14,147,4.3133333333333335,48.815584862144185
Task_24465,2122,281,30,147,177,7.524822695035461,41.65598065892433
Task_24466,2078,516,148,194,342,4.019342359767892,42.68566089538754
Task_24467,1026,132,191,198,389,7.714285714285714,24.574883990969294
Task_24468,2681,465,195,85,280,5.753218884120171,51.35276672338524
Task_24469,2991,351,185,79,264,8.497159090909092,55.77746919436638
Task_24470,2436,751,127,104,231,3.2393617021276597,48.46732541986503
Task_24471,1338,440,146,15,161,3.0340136054421767,28.556758181827192
Task_24472,514,704,125,138,263,0.7290780141843972,18.0278351045704
Task_24473,1256,887,18,124,142,1.4144144144144144,29.40019567482214
Task_24474,2516,90,76,34,110,27.64835164835165,44.87270136740285
Task_24475,1722,479,99,37,136,3.5875,34.863118487392406
Task_24476,1953,755,45,110,155,2.5833333333333335,40.17316097837355
Task_24477,681,552,137,109,246,1.2314647377938517,19.99951709794256
Task_24478,2892,438,29,187,216,6.587699316628702,54.78044387213725
Task_24479,2894,651,112,149,261,4.438650306748467,55.60722695435601
Task_24480,2324,304,138,122,260,7.619672131147541,45.40410122670028
Task_24481,932,871,144,93,237,1.0688073394495412,24.810139121293677
Task_24482,2807,533,68,32,100,5.2565543071161045,51.82285069836482
Task_24483,1386,625,122,103,225,2.2140575079872202,31.411544554511938
Task_24484,1167,440,54,102,156,2.6462585034013606,26.886444518637585
Task_24485,920,995,23,70,93,0.9236947791164659,23.854178248904176
Task_24486,2484,379,85,146,231,6.536842105263158,48.14164575788677
Task_24487,2515,936,136,172,308,2.6840981856990394,50.74490722786182
Task_24488,2929,182,87,137,224,16.005464480874316,54.20727412382043
Task_24489,1328,210,141,33,174,6.293838862559242,28.078757989361424
Task_24490,2553,890,26,112,138,2.8653198653198655,50.06163144979865
Task_24491,1917,516,47,46,93,3.7079303675048356,37.62266897016395
Task_24492,2478,618,127,122,249,4.003231017770598,48.82001579830008
Task_24493,1671,364,158,74,232,4.578082191780822,34.72465051075417
Task_24494,2559,183,169,193,362,13.907608695652174,49.07938696431493
Task_24495,1698,926,118,34,152,1.831715210355987,35.889177997225126
Task_24496,529,722,132,51,183,0.7316735822959889,17.262189436725436
Task_24497,1101,526,69,161,230,2.0891840607210628,26.81720578287049
Task_24498,1764,1003,22,122,144,1.7569721115537849,37.902444489805234
Task_24499,986,134,57,42,99,7.303703703703704,21.001440377509212
Task_24500,2833,487,96,177,273,5.805327868852459,54.261690114374346
Task_24501,846,129,196,53,249,6.507692307692308,20.506914465256667
Task_24502,1732,456,76,19,95,3.789934354485777,34.385270400585746
Task_24503,1912,899,147,138,285,2.1244444444444444,40.9211729110278
Task_24504,705,787,198,63,261,0.8946700507614214,20.813693461607322
Task_24505,2429,248,118,145,263,9.755020080321286,46.91108479786141
Task_24506,1418,455,12,97,109,3.1096491228070176,30.51143363727337
Task_24507,816,390,160,101,261,2.0869565217391304,21.808361239568693
Task_24508,1786,914,176,161,337,1.951912568306011,39.23939467361941
Task_24509,2114,285,91,125,216,7.391608391608392,41.87342340373623
Task_24510,1717,848,57,118,175,2.022379269729093,37.240946257046666
Task_24511,697,654,34,121,155,1.0641221374045802,19.772933694207357
Task_24512,1074,946,111,61,172,1.1341077085533262,26.542255723232188
Task_24513,690,575,29,112,141,1.1979166666666667,19.470857930714818
Task_24514,2721,1008,152,31,183,2.696729435084242,52.615125012242174
Task_24515,2215,400,18,66,84,5.523690773067331,42.165920008511335
Task_24516,1133,850,133,27,160,1.3313748531139835,26.717882474551974
Task_24517,1567,146,146,98,244,10.65986394557823,32.37488887792044
Task_24518,628,397,65,87,152,1.5778894472361809,17.890795437748395
Task_24519,1754,682,94,100,194,2.568081991215227,37.35844372000432
Task_24520,1521,553,187,200,387,2.7454873646209386,34.19555743715447
Task_24521,1262,742,165,48,213,1.6985195154777928,28.976427902669993
Task_24522,2557,520,148,138,286,4.907869481765835,49.947755043295196
Task_24523,1358,567,126,197,323,2.390845070422535,31.365715343460835
Task_24524,1350,612,149,78,227,2.202283849918434,30.475282548071576
Task_24525,2777,359,97,176,273,7.713888888888889,52.919038130730634
Task_24526,1203,511,47,89,136,2.349609375,27.410053900321685
Task_24527,1553,304,114,22,136,5.091803278688524,31.54941793790888
Task_24528,2494,756,118,12,130,3.2945838837516512,47.82082317129283
Task_24529,948,400,190,164,354,2.3640897755610975,24.4401469839318
Task_24530,2616,927,153,181,334,2.8189655172413794,52.44762172319444
Task_24531,1843,1008,161,67,228,1.8265609514370664,39.36462264855789
Task_24532,2374,999,127,80,207,2.374,47.831584578643124
Task_24533,2729,632,191,198,389,4.311216429699842,53.58217624145656
Task_24534,1484,315,120,107,227,4.69620253164557,31.988509324552805
Task_24535,2438,247,155,155,310,9.830645161290322,47.276074750560326
Task_24536,1361,786,56,178,234,1.7293519695044473,31.81350850728859
Task_24537,1546,814,58,24,82,1.8969325153374232,32.43942188900676
Task_24538,2241,930,76,128,204,2.407089151450054,45.98937992841951
Task_24539,1970,888,32,110,142,2.2159730033745784,40.862667689217915
Task_24540,1171,729,198,27,225,1.604109589041096,27.51359848962775
Task_24541,1137,647,154,57,211,1.7546296296296295,26.89620526296173
Task_24542,2915,877,150,78,228,3.3200455580865604,56.10241946093467
Task_24543,2241,790,174,191,365,2.8331226295828067,46.231902884948816
Task_24544,1843,492,114,192,306,3.738336713995943,38.72333711464147
Task_24545,537,620,90,114,204,0.8647342995169082,17.808726892858775
Task_24546,2436,442,115,173,288,5.498871331828442,47.83949130435588
Task_24547,2304,948,27,69,96,2.42781875658588,45.51531100986224
Task_24548,1140,134,65,41,106,8.444444444444445,23.431266460645986
Task_24549,626,967,108,109,217,0.6466942148760331,20.46922069506182
Task_24550,914,359,116,93,209,2.5388888888888888,22.949028238166704
Task_24551,2888,618,141,102,243,4.665589660743134,55.25696352710963
Task_24552,1500,639,125,81,206,2.34375,32.819887237346855
Task_24553,1395,171,11,28,39,8.11046511627907,27.396972080627805
Task_24554,1082,845,183,62,245,1.2789598108747045,26.7935791517961
Task_24555,970,947,143,30,173,1.0232067510548524,24.71767277795146
Task_24556,827,871,39,88,127,0.948394495412844,22.36960943622316
Task_24557,2820,292,189,33,222,9.62457337883959,52.231187373175175
Task_24558,2868,140,85,131,216,20.340425531914892,52.84505272933172
Task_24559,522,747,124,180,304,0.6978609625668449,18.61421575475382
Task_24560,2296,647,163,31,194,3.54320987654321,44.97816188775361
Task_24561,1047,982,48,125,173,1.0651068158697863,26.760521092592853
Task_24562,1850,845,59,142,201,2.186761229314421,39.55255155937668
Task_24563,1716,104,132,10,142,16.34285714285714,32.80348103150002
Task_24564,1949,142,37,103,140,13.62937062937063,37.51884439456333
Task_24565,2766,663,137,10,147,4.1656626506024095,51.87230573307475
Task_24566,1050,245,31,45,76,4.2682926829268295,22.441481943098566
Task_24567,2127,560,142,16,158,3.7914438502673797,41.404771928800585
Task_24568,1727,706,131,84,215,2.442715700141443,36.699625288396064
Task_24569,1932,300,153,94,247,6.4186046511627906,39.03731645124133
Task_24570,1784,721,88,102,190,2.4709141274238227,37.86518773341209
Task_24571,2221,610,74,139,213,3.635024549918167,44.71896124394527
Task_24572,1755,746,94,149,243,2.3493975903614457,37.86725261529486
Task_24573,1778,952,29,11,40,1.8656873032528856,35.83380308439217
Task_24574,531,898,171,166,337,0.5906562847608454,19.36864977267736
Task_24575,1148,254,78,132,210,4.5019607843137255,26.564815849566262
Task_24576,2008,1020,129,178,307,1.9666993143976494,42.97640153130283
Task_24577,1226,428,50,12,62,2.8578088578088576,25.658397349430988
Task_24578,2596,515,86,15,101,5.0310077519379846,48.29216672716197
Task_24579,2658,1004,166,94,260,2.644776119402985,52.83680341145229
Task_24580,2171,846,191,111,302,2.563164108618654,44.896766392041094
Task_24581,1151,175,132,160,292,6.5397727272727275,26.23108504846307
Task_24582,1969,325,154,19,173,6.039877300613497,38.33913905039874
Task_24583,2125,728,80,53,133,2.914951989026063,42.43361177528298
Task_24584,2332,829,80,40,120,2.8096385542168676,45.438689934776896
Task_24585,2156,307,18,112,130,7.0,41.884776944689584
Task_24586,648,120,19,108,127,5.355371900826446,16.599312794678145
Task_24587,2019,1011,158,17,175,1.9950592885375493,41.323216291344714
Task_24588,796,317,22,190,212,2.50314465408805,21.139120307099365
Task_24589,1725,78,162,94,256,21.835443037974684,34.236639982769695
Task_24590,1894,750,70,23,93,2.5219707057256993,38.058605815693845
Task_24591,1822,812,41,185,226,2.241082410824108,39.03952588824702
Task_24592,1701,280,16,79,95,6.05338078291815,33.93981959060431
Task_24593,2475,618,51,59,110,3.998384491114701,47.220813171674145
Task_24594,616,557,57,110,167,1.103942652329749,18.49357337237451
Task_24595,2187,244,105,30,135,8.926530612244898,41.43439852864727
Task_24596,1191,688,138,18,156,1.7285921625544267,26.86835377817211
Task_24597,1866,258,169,185,354,7.204633204633205,38.52003205334105
Task_24598,2897,937,40,20,60,3.088486140724947,53.63134816644213
Task_24599,1874,534,147,32,179,3.502803738317757,37.68906165374748
Task_24600,2320,997,139,14,153,2.3246492985971945,45.78787022717279
Task_24601,2554,970,155,94,249,2.630278063851699,51.03316088749688
Task_24602,2849,367,71,101,172,7.741847826086956,53.55133921472734
Task_24603,2258,406,101,132,233,5.547911547911548,44.596439608129195
Task_24604,2491,1011,172,57,229,2.4614624505928853,49.573859325215984
Task_24605,1305,936,187,111,298,1.3927427961579508,31.368421618345593
Task_24606,1285,977,22,60,82,1.3139059304703475,29.099897449315076
Task_24607,2918,602,178,188,366,4.839137645107795,56.36134379809298
Task_24608,1040,912,11,61,72,1.1391018619934283,24.72399283037527
Task_24609,595,732,14,78,92,0.8117326057298773,17.955858102192295
Task_24610,1932,249,131,183,314,7.728,39.34784148025664
Task_24611,625,140,124,171,295,4.432624113475177,17.902943048007526
Task_24612,830,872,83,174,257,0.9507445589919816,23.538868227000464
Task_24613,859,504,131,199,330,1.700990099009901,23.288356181222678
Task_24614,2158,188,13,36,49,11.417989417989418,40.02400346004927
Task_24615,2740,931,98,124,222,2.939914163090129,53.850567546873755
Task_24616,1402,562,137,166,303,2.4902309058614565,31.911151184093868
Task_24617,2487,814,98,27,125,3.0515337423312885,47.9022383721541
Task_24618,1422,835,94,192,286,1.700956937799043,33.11228372475224
Task_24619,2313,579,182,78,260,3.9879310344827585,45.770261944547855
Task_24620,2601,460,188,69,257,5.642082429501085,49.747527175997625
Task_24621,535,838,96,156,252,0.6376638855780691,18.904313308869018
Task_24622,1945,532,33,21,54,3.649155722326454,37.608536718564544
Task_24623,929,465,153,24,177,1.9935622317596566,22.429490362245122
Task_24624,1212,481,18,135,153,2.5145228215767634,27.55035329938744
Task_24625,1279,490,70,30,100,2.604887983706721,27.54475410018965
Task_24626,2288,531,15,153,168,4.3007518796992485,45.072063878936184
Task_24627,1571,287,79,160,239,5.454861111111111,33.53300493233362
Task_24628,2001,413,119,44,163,4.833333333333333,39.248679234258496
Task_24629,1011,1022,76,179,255,0.9882697947214076,26.956248293421396
Task_24630,864,802,111,195,306,1.0759651307596514,24.048907952294247
Task_24631,2533,886,100,22,122,2.855693348365276,48.757478826644984
Task_24632,712,827,128,58,186,0.8599033816425121,20.485888081813783
Task_24633,1289,87,94,191,285,14.647727272727273,27.77013857287862
Task_24634,2537,716,61,115,176,3.5383542538354256,49.697153894255194
Task_24635,2203,427,155,166,321,5.147196261682243,44.24134273642121
Task_24636,2921,573,125,62,187,5.088850174216028,54.785421892407705
Task_24637,986,609,34,185,219,1.616393442622951,25.134237831699057
Task_24638,2846,748,199,26,225,3.7997329773030706,54.10448908532345
Task_24639,701,636,191,85,276,1.1004709576138147,20.390360423598825
Task_24640,1293,444,171,45,216,2.90561797752809,28.505470137085663
Task_24641,1847,695,128,112,240,2.653735632183908,39.01343947427484
Task_24642,530,478,56,119,175,1.1064718162839249,17.06063022194077
Task_24643,683,163,110,11,121,4.164634146341464,16.83133953480412
Task_24644,2633,677,51,141,192,3.883480825958702,51.428958680994235
Task_24645,2934,737,167,77,244,3.975609756097561,55.972726910445154
Task_24646,2868,621,106,138,244,4.610932475884244,55.007074347611955
Task_24647,858,613,101,106,207,1.3973941368078175,22.86685160934081
Task_24648,2292,763,76,34,110,3.0,44.512445584433266
Task_24649,647,176,192,87,279,3.6553672316384183,17.938589465288626
Task_24650,2001,626,155,58,213,3.1913875598086126,40.52291175645447
Task_24651,1984,745,42,95,137,2.6595174262734584,40.61186436435069
Task_24652,2307,638,158,52,210,3.6103286384976525,45.484566359944445
Task_24653,2205,315,142,131,273,6.977848101265823,43.63215128078853
Task_24654,1766,468,102,176,278,3.76545842217484,37.278013982543946
Task_24655,1370,393,30,118,148,3.4771573604060912,29.81960974965888
Task_24656,846,329,57,86,143,2.5636363636363635,21.22441291544378
Task_24657,1753,245,64,156,220,7.126016260162602,36.17032544441307
Task_24658,742,930,38,37,75,0.7969924812030075,19.857672842768693
Task_24659,700,160,78,100,178,4.3478260869565215,18.472365065417524
Task_24660,1830,622,96,14,110,2.937399678972713,36.62290620144076
Task_24661,2030,1014,39,59,98,2.0,41.208841906384826
Task_24662,954,597,187,173,360,1.5953177257525084,25.180097262621427
Task_24663,697,687,179,172,351,1.0130813953488371,21.21409321951535
Task_24664,2313,1006,125,137,262,2.2969215491559085,47.50337197282747
Task_24665,713,448,149,131,280,1.5879732739420935,20.44761771048812
Task_24666,514,341,30,164,194,1.5029239766081872,16.669238336511185
Task_24667,2396,556,137,68,205,4.301615798922801,46.6057656462392
Task_24668,1465,142,133,44,177,10.244755244755245,29.61110838816514
Task_24669,1897,644,53,37,90,2.9410852713178293,37.606561538919316
Task_24670,2113,946,141,84,225,2.2312565997888067,43.60915941648036
Task_24671,1089,211,50,50,100,5.136792452830188,23.624950175610213
Task_24672,1271,699,12,37,49,1.8157142857142856,27.432467616766747
Task_24673,1818,812,149,110,259,2.236162361623616,39.00252176531685
Task_24674,624,409,102,148,250,1.5219512195121951,18.806636834419766
Task_24675,2719,106,171,117,288,25.411214953271028,50.22194021464782
Task_24676,2792,191,89,24,113,14.541666666666666,50.70245321470466
Task_24677,1796,519,110,117,227,3.453846153846154,37.59930204172785
Task_24678,1792,447,73,92,165,4.0,36.97099743827388
Task_24679,1242,665,93,195,288,1.864864864864865,29.78658581878128
Task_24680,560,307,190,74,264,1.8181818181818181,17.11349032771896
Task_24681,2477,150,81,53,134,16.403973509933774,45.560574248850635
Task_24682,2693,1016,132,125,257,2.647984267453294,53.51632633897907
Task_24683,1769,584,163,44,207,3.023931623931624,36.473148677385105
Task_24684,1498,927,111,120,231,1.6142241379310345,34.16493652955602
Task_24685,2363,204,45,118,163,11.526829268292683,45.037701394729766
Task_24686,983,578,128,145,273,1.697754749568221,25.14691163912704
Task_24687,2990,420,49,14,63,7.102137767220903,53.5346418431236
Task_24688,915,80,116,24,140,11.296296296296296,19.923882039687182
Task_24689,2228,306,122,83,205,7.257328990228013,43.29471483237335
Task_24690,1134,102,200,94,294,11.009708737864077,25.300102533045944
Task_24691,1212,115,114,46,160,10.448275862068966,25.12579075471952
Task_24692,1967,750,190,65,255,2.6191744340878826,40.645345259899855
Task_24693,880,523,32,83,115,1.6793893129770991,22.17980812476263
Task_24694,2120,371,112,128,240,5.698924731182796,42.32304509690832
Task_24695,1987,519,21,58,79,3.8211538461538463,38.55531600321853
Task_24696,1150,129,180,57,237,8.846153846153847,25.239366048811878
Task_24697,1379,460,131,141,272,2.9913232104121477,31.048357204198936
Task_24698,2307,548,105,158,263,4.202185792349726,46.004940219073546
Task_24699,1663,260,158,141,299,6.371647509578544,35.00676693429913
Task_24700,1188,418,172,25,197,2.835322195704057,26.65587372166692
Task_24701,674,889,140,137,277,0.7573033707865169,21.1472635865731
Task_24702,1001,943,63,129,192,1.0603813559322033,26.125073005525405
Task_24703,2389,295,66,13,79,8.070945945945946,43.794008528823554
Task_24704,1415,622,38,153,191,2.2712680577849116,31.793913864453398
Task_24705,1775,90,96,94,190,19.505494505494507,34.88789119769351
Task_24706,2367,341,158,34,192,6.921052631578948,45.10486740097857
Task_24707,2809,675,178,31,209,4.155325443786983,53.25984472530061
Task_24708,1984,772,98,28,126,2.5666235446313066,39.8774282066125
Task_24709,1386,960,76,145,221,1.4422476586888657,32.57168782756476
Task_24710,1203,308,20,135,155,3.8932038834951457,26.905150434467178
Task_24711,558,776,106,131,237,0.7181467181467182,18.89287133868167
Task_24712,2020,329,187,163,350,6.121212121212121,41.14803471600471
Task_24713,2186,805,187,176,363,2.7121588089330024,45.37648382074818
Task_24714,1308,87,80,198,278,14.863636363636363,28.091994575616777
Task_24715,1285,309,59,79,138,4.145161290322581,28.052534052018817
Task_24716,547,643,112,134,246,0.8493788819875776,18.243760766305567
Task_24717,2611,982,101,145,246,2.6561546286876907,52.09062587162047
Task_24718,877,657,199,28,227,1.3328267477203648,22.670819530143223
Task_24719,2752,154,31,22,53,17.75483870967742,48.953644855185125
Task_24720,2813,992,157,21,178,2.8328298086606245,53.87691793752618
Task_24721,846,763,199,87,286,1.1073298429319371,23.134993679846968
Task_24722,690,221,185,24,209,3.108108108108108,18.19654222765334
Task_24723,1319,964,104,57,161,1.366839378238342,30.229653173179628
Task_24724,805,899,69,191,260,0.8944444444444445,23.348390610612203
Task_24725,931,158,32,171,203,5.855345911949685,22.431532239091528
Task_24726,2028,673,14,109,123,3.0089020771513355,41.06986624351345
Task_24727,1819,139,12,155,167,12.992857142857142,35.7969146467031
Task_24728,644,638,146,122,268,1.0078247261345852,19.775371353818674
Task_24729,2599,135,140,98,238,19.110294117647058,48.5254148632474
Task_24730,2572,927,43,170,213,2.771551724137931,51.202566052982945
Task_24731,616,314,179,110,289,1.9555555555555555,18.543533642723414
Task_24732,594,366,151,178,329,1.6185286103542234,18.62631909291913
Task_24733,2825,330,115,114,229,8.534743202416918,53.26545777315662
Task_24734,2227,324,176,47,223,6.852307692307693,42.96490852676061
Task_24735,2908,101,34,49,83,28.50980392156863,51.16404330615731
Task_24736,2389,1002,28,117,145,2.38185443668993,47.91772336369687
Task_24737,679,276,166,53,219,2.4512635379061374,18.611738257618622
Task_24738,2120,356,158,26,184,5.938375350140056,40.98538879179938
Task_24739,1505,465,174,24,198,3.2296137339055795,31.823616624415504
Task_24740,2147,601,34,172,206,3.5664451827242525,43.43138795852889
Task_24741,948,264,126,22,148,3.577358490566038,21.875706377803397
Task_24742,1244,353,31,46,77,3.5141242937853105,25.898394999737892
Task_24743,678,615,197,91,288,1.1006493506493507,20.138847425356797
Task_24744,1024,792,168,110,278,1.2912988650693569,26.354417839599744
Task_24745,633,161,57,72,129,3.9074074074074074,16.819398726784847
Task_24746,1423,416,164,87,251,3.4124700239808154,31.176354026224832
Task_24747,2328,109,41,74,115,21.163636363636364,42.681186852487485
Task_24748,1907,825,92,113,205,2.3087167070217918,40.29167874495352
Task_24749,1293,585,70,117,187,2.2064846416382253,29.765786423965277
Task_24750,2655,522,53,104,157,5.076481835564054,50.72230549939092
Task_24751,505,551,193,135,328,0.9148550724637681,17.665258790804533
Task_24752,2289,930,103,81,184,2.4586466165413534,45.93457490282184
Task_24753,1346,952,74,45,119,1.4123819517313747,30.085618838709223
Task_24754,1973,120,165,118,283,16.305785123966942,38.830221600109546
Task_24755,1601,614,134,146,280,2.603252032520325,35.09300543881641
Task_24756,2143,922,35,125,160,2.3217768147345614,43.7878369991131
Task_24757,1244,488,74,14,88,2.5439672801635993,26.714470883325266
Task_24758,2860,246,19,84,103,11.578947368421053,52.29845475110341
Task_24759,1202,680,68,167,235,1.765051395007342,28.916691986821178
Task_24760,1902,866,164,102,266,2.1937716262975777,40.52155774584666
Task_24761,723,672,48,86,134,1.074294205052006,20.140976672623513
Task_24762,881,780,107,112,219,1.1280409731113956,23.721797837437894
Task_24763,2419,887,153,198,351,2.724099099099099,49.30267228063241
Task_24764,1901,724,100,195,295,2.6220689655172413,40.32927356925858
Task_24765,984,677,49,181,230,1.4513274336283186,25.39756078894844
Task_24766,2568,215,81,162,243,11.88888888888889,49.019383840310674
Task_24767,1733,782,167,131,298,2.2132822477650063,37.76884282332464
Task_24768,853,353,200,39,239,2.4096045197740112,21.366121269259413
Task_24769,989,476,146,155,301,2.0733752620545074,25.076763140088275
Task_24770,732,691,95,30,125,1.0578034682080926,19.941824449016277
Task_24771,2104,568,169,48,217,3.6977152899824253,41.79678406502977
Task_24772,2254,905,195,53,248,2.487858719646799,45.66018101786213
Task_24773,805,1007,136,200,336,0.7986111111111112,23.997980864137002
Task_24774,699,115,35,99,134,6.025862068965517,17.451397281786928
Task_24775,1938,434,18,112,130,4.455172413793103,38.85733981872534
Task_24776,1249,845,190,170,360,1.4763593380614657,30.579386721302566
Task_24777,1107,504,189,110,299,2.1920792079207922,26.957833900128435
Task_24778,676,629,72,140,212,1.073015873015873,20.10857105195259
Task_24779,2129,376,200,133,333,5.647214854111406,42.90848805782474
Task_24780,878,654,153,84,237,1.3404580152671757,23.1523459827833
Task_24781,1788,401,122,190,312,4.447761194029851,37.58396122296407
Task_24782,746,428,143,127,270,1.7389277389277389,20.885563965930988
Task_24783,2269,827,57,94,151,2.7403381642512077,45.49241819078759
Task_24784,2737,918,58,91,149,2.9782372143634386,53.13199867999591
Task_24785,1337,168,107,67,174,7.911242603550296,28.13302776684938
Task_24786,1185,775,24,64,88,1.527061855670103,27.0989998861395
Task_24787,779,433,128,24,152,1.794930875576037,19.72463262206176
Task_24788,943,408,157,34,191,2.3056234718826407,22.790494515733275
Task_24789,2355,558,78,36,114,4.212880143112701,44.9812232982835
Task_24790,2081,67,105,197,302,30.602941176470587,40.09393260457557
Task_24791,2508,554,19,198,217,4.518918918918919,49.03859084158498
Task_24792,1987,720,83,120,203,2.7558945908460473,41.20809099111229
Task_24793,2428,307,24,105,129,7.883116883116883,46.28060614157474
Task_24794,2507,281,115,41,156,8.890070921985815,46.639989249265994
Task_24795,1075,488,106,60,166,2.198364008179959,25.062796218847463
Task_24796,1817,734,16,44,60,2.472108843537415,36.20773310448234
Task_24797,708,130,77,121,198,5.404580152671755,18.715367972267135
Task_24798,1172,1024,64,50,114,1.1434146341463414,27.6591195273238
Task_24799,2010,210,61,91,152,9.5260663507109,39.25529800441069
Task_24800,2752,392,58,192,250,7.002544529262087,52.68581103296734
Task_24801,1923,483,81,77,158,3.9731404958677685,38.593415460664
Task_24802,1815,642,25,86,111,2.822706065318818,37.288168364537334
Task_24803,1446,150,200,54,254,9.57615894039735,30.19477373931151
Task_24804,1587,722,119,93,212,2.195020746887967,34.75999158386657
Task_24805,651,213,194,28,222,3.042056074766355,17.646868346138707
Task_24806,2784,1009,163,188,351,2.756435643564356,55.45261893939772
Task_24807,1439,702,83,192,275,2.046941678520626,32.90114961231216
Task_24808,1472,835,63,179,242,1.7607655502392345,33.73131058872617
Task_24809,2610,814,112,52,164,3.2024539877300615,50.549495300528946
Task_24810,1545,988,36,165,201,1.5621840242669363,35.012875238461916
Task_24811,1659,969,146,40,186,1.7103092783505154,35.71030178752832
Task_24812,1404,97,23,22,45,14.326530612244898,26.940259449027746
Task_24813,781,103,110,42,152,7.509615384615385,18.12154702287284
Task_24814,1086,302,161,104,265,3.5841584158415842,25.81952479710074
Task_24815,1015,235,63,34,97,4.3008474576271185,22.325652223984168
Task_24816,971,962,13,111,124,1.008307372793354,25.07216480238134
Task_24817,591,449,25,14,39,1.3133333333333332,15.4775738451418
Task_24818,1426,486,101,125,226,2.9281314168377826,31.644084255072084
Task_24819,1499,137,58,124,182,10.86231884057971,30.95945358205906
Task_24820,1636,852,50,85,135,1.917936694021102,35.423540325909705
Task_24821,2054,943,18,12,30,2.1758474576271185,40.141191153988
Task_24822,725,927,194,161,355,0.78125,22.496173667534965
Task_24823,2757,957,197,179,376,2.8778705636743216,54.96197319023241
Task_24824,2208,878,180,159,339,2.5119453924914676,45.82003384851962
Task_24825,2984,461,68,50,118,6.458874458874459,54.677038035911075
Task_24826,1698,86,107,48,155,19.517241379310345,32.31884739530247
Task_24827,2210,140,47,89,136,15.673758865248226,41.57876394703513
Task_24828,2335,476,156,30,186,4.89517819706499,44.88821498636478
Task_24829,1258,970,130,200,330,1.2955715756951596,30.979964769026207
Task_24830,2823,394,86,110,196,7.146835443037975,53.339859535023805
Task_24831,1734,567,20,152,172,3.0528169014084505,36.48566641638904
Task_24832,1588,637,127,137,264,2.489028213166144,34.87401661794022
Task_24833,2745,405,22,67,89,6.761083743842365,50.66836528121555
Task_24834,2533,484,91,130,221,5.222680412371134,49.19594989381861
Task_24835,680,202,77,36,113,3.3497536945812807,17.31989118029075
Task_24836,534,454,186,125,311,1.1736263736263737,17.724781073647193
Task_24837,2822,689,149,89,238,4.089855072463768,54.20835000833788
Task_24838,920,974,165,132,297,0.9435897435897436,25.411207866041337
Task_24839,1318,411,72,51,123,3.1990291262135924,28.428984553953455
Task_24840,1347,747,50,46,96,1.8008021390374331,29.315390145291293
Task_24841,639,354,127,37,164,1.8,17.611028810246136
Task_24842,2121,176,185,132,317,11.983050847457626,41.583828819401184
Task_24843,1394,1011,19,70,89,1.3774703557312253,31.092632097176246
Task_24844,1844,809,147,54,201,2.276543209876543,38.60568890200181
Task_24845,1544,541,123,125,248,2.848708487084871,33.7854461712581
Task_24846,1874,746,37,94,131,2.5087014725568944,38.900446031474246
Task_24847,2451,795,96,13,109,3.079145728643216,47.026833247772295
Task_24848,509,406,176,46,222,1.2506142506142506,16.030177697257415
Task_24849,1821,340,83,120,203,5.340175953079179,37.365517714145305
Task_24850,989,466,140,11,151,2.1177730192719486,23.09980057457734
Task_24851,1113,420,66,35,101,2.643705463182898,24.6256446260761
Task_24852,1382,679,128,101,229,2.0323529411764705,31.53212419831686
Task_24853,1169,555,38,118,156,2.102517985611511,27.16607672194921
Task_24854,1675,915,136,186,322,1.8286026200873362,37.45268530470348
Task_24855,1897,602,89,22,111,3.145936981757877,37.69926571735551
Task_24856,1396,150,175,176,351,9.245033112582782,30.364372953947704
Task_24857,2055,951,169,96,265,2.158613445378151,43.220822947138345
Task_24858,2468,249,180,39,219,9.872,46.45701999436974
Task_24859,1350,726,130,93,223,1.8569463548830811,31.067716847626624
Task_24860,1504,904,142,144,286,1.661878453038674,34.47169813002882
Task_24861,1369,712,86,200,286,1.9200561009817672,31.873236643052497
Task_24862,1218,825,150,93,243,1.4745762711864407,29.320623079113883
Task_24863,2016,832,43,106,149,2.4201680672268906,41.40378082917761
Task_24864,1714,790,190,10,200,2.1668773704171933,36.0803879444826
Task_24865,1054,310,114,29,143,3.3890675241157555,23.768596329122165
Task_24866,1878,749,130,67,197,2.504,38.972897375808806
Task_24867,1058,987,136,16,152,1.0708502024291497,25.710623829248338
Task_24868,1356,93,179,50,229,14.425531914893616,27.691425862041857
Task_24869,577,514,12,36,48,1.120388349514563,15.873846083653168
Task_24870,2027,67,159,137,296,29.808823529411764,39.13484962288707
Task_24871,2029,558,110,68,178,3.629695885509839,40.48085521297487
Task_24872,2202,242,47,47,94,9.061728395061728,41.19645443796968
Task_24873,2961,282,24,51,75,10.462897526501767,53.04026384108632
Task_24874,1901,672,168,94,262,2.824665676077266,39.81382273242192
Task_24875,2103,501,22,39,61,4.1892430278884465,39.88134803735607
Task_24876,758,76,116,44,160,9.844155844155845,17.49877289389657
Task_24877,2227,340,97,116,213,6.530791788856305,43.79632956090143
Task_24878,1883,723,35,53,88,2.600828729281768,37.924577687349654
Task_24879,794,744,122,107,229,1.0657718120805368,22.2919175342399
Task_24880,2353,908,102,24,126,2.5885588558855885,46.0875276103288
Task_24881,1453,674,193,187,380,2.1525925925925926,33.447745084727636
Task_24882,1639,287,76,58,134,5.690972222222222,33.23561815145975
Task_24883,2461,185,78,117,195,13.231182795698924,46.81021780358333
Task_24884,869,832,63,104,167,1.043217286914766,23.349807140940538
Task_24885,1845,75,92,78,170,24.276315789473685,35.30494585980719
Task_24886,2945,624,36,167,203,4.712,56.102773738775255
Task_24887,1087,636,82,90,172,1.706436420722135,26.28301726608402
Task_24888,1685,109,169,57,226,15.318181818181818,33.32335119882807
Task_24889,1963,1011,52,108,160,1.9397233201581028,41.31517606923165
Task_24890,1863,798,195,153,348,2.3316645807259073,40.13594938100987
Task_24891,2202,966,61,99,160,2.277145811789038,44.894420222293085
Task_24892,1713,414,165,169,334,4.127710843373494,36.507644585014994
Task_24893,2547,227,185,73,258,11.171052631578947,48.16106791205748
Task_24894,2269,743,73,149,222,3.049731182795699,45.94900690018594
Task_24895,2882,1011,163,162,325,2.847826086956522,56.85658549480811
Task_24896,1602,883,63,73,136,1.8122171945701357,34.751138587833005
Task_24897,1055,611,59,175,234,1.723856209150327,26.412966040139178
Task_24898,1457,141,165,23,188,10.26056338028169,29.597991746457932
Task_24899,2204,773,199,109,308,2.847545219638243,45.21536438575473
Task_24900,1481,275,177,141,318,5.365942028985507,32.26734253391421
Task_24901,1391,317,33,66,99,4.3742138364779874,29.053425086069055
Task_24902,2285,501,146,155,301,4.551792828685259,45.67278028674837
Task_24903,629,311,116,38,154,2.016025641025641,17.07329466688011
Task_24904,2804,401,189,180,369,6.975124378109452,53.90298947732907
Task_24905,2904,782,37,59,96,3.7088122605363987,54.33534430895832
Task_24906,2563,139,172,81,253,18.307142857142857,47.82492812937218
Task_24907,628,276,73,49,122,2.267148014440433,16.864086253108542
Task_24908,2682,953,100,162,262,2.811320754716981,53.22228545505512
Task_24909,1630,661,85,154,239,2.4622356495468276,35.574047044198714
Task_24910,1221,695,136,189,325,1.7543103448275863,29.580053716628175
Task_24911,2065,575,199,174,373,3.5850694444444446,42.778133960412184
Task_24912,768,447,39,46,85,1.7142857142857142,19.084190939685218
Task_24913,2917,310,148,136,284,9.379421221864952,54.930163507145004
Task_24914,1893,164,175,199,374,11.472727272727273,38.412953355982786
Task_24915,2150,135,139,104,243,15.808823529411764,41.50045515562741
Task_24916,2579,540,82,33,115,4.767097966728281,48.39797138315124
Task_24917,821,682,43,45,88,1.2020497803806736,20.74274986991883
Task_24918,964,905,108,76,184,1.0640176600441502,24.74228349141717
Task_24919,980,386,175,178,353,2.5322997416020674,24.918066750215235
Task_24920,1796,327,178,56,234,5.475609756097561,36.49322980696435
Task_24921,981,1017,144,136,280,0.9636542239685658,26.42742477882615
Task_24922,757,221,42,10,52,3.40990990990991,17.57284528595497
Task_24923,2439,212,68,144,212,11.450704225352112,46.82319014378091
Task_24924,2969,224,46,72,118,13.195555555555556,54.07299857083274
Task_24925,2332,822,137,76,213,2.833535844471446,46.55874055548779
Task_24926,2355,839,44,191,235,2.8035714285714284,47.61914152129052
Task_24927,1535,703,126,40,166,2.180397727272727,32.826290672415944
Task_24928,2136,201,46,168,214,10.574257425742575,41.95302300306043
Task_24929,1848,580,24,191,215,3.180722891566265,38.713340299023045
Task_24930,1268,902,133,39,172,1.4042081949058693,29.270188943834043
Task_24931,2904,1021,140,126,266,2.8414872798434443,56.91773134104036
Task_24932,1772,127,39,47,86,13.84375,33.45640656792013
Task_24933,2721,828,191,27,218,3.2822677925211097,52.3325369758712
Task_24934,2933,328,62,21,83,8.914893617021276,52.74623783495613
Task_24935,1560,491,46,60,106,3.1707317073170733,32.14968694877691
Task_24936,2649,136,190,55,245,19.335766423357665,48.97259676981151
Task_24937,2627,115,114,48,162,22.646551724137932,47.44208885126076
Task_24938,1244,118,48,21,69,10.453781512605042,24.76804675128464
Task_24939,670,579,14,128,142,1.1551724137931034,19.2356006097922
Task_24940,1417,442,195,28,223,3.198645598194131,30.504067818276614
Task_24941,2492,516,59,38,97,4.820116054158607,46.67934203164524
Task_24942,2121,148,97,61,158,14.234899328859061,40.00850327951449
Task_24943,2354,866,33,74,107,2.7151095732410613,46.34467340544108
Task_24944,1572,86,168,173,341,18.06896551724138,32.40528814558001
Task_24945,2423,845,88,124,212,2.8640661938534278,48.51941267195995
Task_24946,2799,832,57,134,191,3.360144057623049,54.49509171592411
Task_24947,1340,544,153,84,237,2.458715596330275,30.161415747930217
Task_24948,1576,880,173,52,225,1.7888762769580022,34.72941866064135
Task_24949,2724,167,188,174,362,16.214285714285715,51.44026574584773
Task_24950,1351,759,88,46,134,1.7776315789473685,29.844101045087786
Task_24951,2493,464,45,15,60,5.361290322580645,45.733619381285905
Task_24952,2822,279,147,189,336,10.07857142857143,53.62891397775053
Task_24953,1609,573,130,115,245,2.803135888501742,34.887477575948004
Task_24954,2129,99,23,187,210,21.29,40.770731413546486
Task_24955,1980,321,106,156,262,6.149068322981367,40.08159861540725
Task_24956,1189,194,124,146,270,6.097435897435897,27.093816809953314
Task_24957,2603,138,88,97,185,18.72661870503597,48.295629129461766
Task_24958,1628,208,121,199,320,7.7894736842105265,34.44899482953334
Task_24959,651,769,126,17,143,0.8454545454545455,18.599771044656304
Task_24960,2381,567,35,54,89,4.191901408450704,45.3012103104123
Task_24961,705,868,21,196,217,0.8112773302646721,21.293831470447802
Task_24962,2982,426,46,104,150,6.983606557377049,55.39712623708643
Task_24963,1881,630,30,124,154,2.9809825673534074,38.66868071653219
Task_24964,2317,618,84,199,283,3.74313408723748,46.58363716398315
Task_24965,2800,811,15,101,116,3.4482758620689653,53.65027489269922
Task_24966,1044,739,13,84,97,1.4108108108108108,25.046639117745542
Task_24967,2421,169,166,36,202,14.241176470588234,45.2273441428062
Task_24968,2737,391,96,25,121,6.982142857142857,50.41978329257023
Task_24969,1413,234,149,78,227,6.012765957446809,30.252129003855988
Task_24970,1329,238,133,82,215,5.560669456066946,28.90532080500086
Task_24971,1059,803,12,90,102,1.3171641791044777,25.6135784496408
Task_24972,810,960,45,122,167,0.8428720083246618,22.730927177228917
Task_24973,2258,729,81,34,115,3.0931506849315067,43.90950667415177
Task_24974,2219,625,61,124,185,3.5447284345047922,44.45283351468428
Task_24975,1111,470,179,116,295,2.358811040339703,26.904862257914733
Task_24976,2905,379,102,154,256,7.644736842105263,54.87951529480273
Task_24977,2252,1017,199,52,251,2.212180746561886,45.98450610798928
Task_24978,1222,860,85,101,186,1.4192799070847852,29.2100783369123
Task_24979,1518,143,110,162,272,10.541666666666666,31.887310631211886
Task_24980,1296,493,41,185,226,2.623481781376518,29.708623684619266
Task_24981,833,737,175,12,187,1.1287262872628727,21.81555676431621
Task_24982,2199,426,175,36,211,5.149882903981265,42.81315825076672
Task_24983,2604,109,100,102,202,23.672727272727272,48.03881873348379
Task_24984,1496,559,57,83,140,2.6714285714285713,32.1978617837248
Task_24985,1351,714,181,147,328,1.8895104895104895,31.66389835095964
Task_24986,1837,553,11,52,63,3.315884476534296,36.21741142480523
Task_24987,1268,388,114,34,148,3.2596401028277633,27.41060133606899
Task_24988,1466,197,148,70,218,7.404040404040404,30.823859025869606
Task_24989,2829,705,51,118,169,4.007082152974505,54.29665655190767
Task_24990,2286,126,152,113,265,18.0,43.712719132328374
Task_24991,1659,141,39,54,93,11.683098591549296,32.193870978836756
Task_24992,2876,195,125,165,290,14.673469387755102,53.85316971119766
Task_24993,1351,802,197,72,269,1.6824408468244085,31.151314973524716
Task_24994,723,469,32,25,57,1.5382978723404255,18.090646261243027
Task_24995,1087,813,152,75,227,1.3353808353808354,26.832387606389293
Task_24996,708,484,12,153,165,1.4597938144329896,19.89440329686107
Task_24997,1410,864,68,194,262,1.630057803468208,32.945423850572986
Task_24998,2809,551,179,11,190,5.088768115942029,52.61681268705707
Task_24999,2257,679,71,13,84,3.3191176470588237,43.306472387026055
Task_25000,1361,336,185,20,205,4.0385756676557865,29.032162365105943
Task_25001,1439,69,16,68,84,20.557142857142857,28.011621846744447
Task_25002,727,983,141,123,264,0.7388211382113821,22.182586159146524
Task_25003,1546,359,19,42,61,4.294444444444444,30.695175062515762
Task_25004,529,127,60,44,104,4.1328125,13.693409423539327
Task_25005,1385,212,83,51,134,6.502347417840376,28.886416415766245
Task_25006,2842,477,168,171,339,5.945606694560669,54.60731198139231
Task_25007,1934,323,106,169,275,5.969135802469136,39.438543462147656
Task_25008,1017,186,80,17,97,5.438502673796791,22.41892983155581
Task_25009,1520,403,87,60,147,3.762376237623762,31.64046135865441
Task_25010,619,320,160,86,246,1.928348909657321,18.11693556171611
Task_25011,2789,888,196,59,255,3.137232845894263,54.006208109503234
Task_25012,1808,1011,33,32,65,1.7865612648221343,36.91197476171781
Task_25013,2880,489,160,157,317,5.877551020408164,55.12839599061969
Task_25014,2363,835,79,25,104,2.826555023923445,45.75137033923932
Task_25015,2627,671,76,91,167,3.9092261904761907,50.758876506224915
Task_25016,986,192,165,88,253,5.108808290155441,23.628264803269257
Task_25017,1005,392,176,59,235,2.5572519083969465,24.100597552777998
Task_25018,1911,597,95,173,268,3.1956521739130435,40.00448322343343
Task_25019,2057,115,47,169,216,17.732758620689655,39.79909795248434
Task_25020,1361,105,11,150,161,12.839622641509434,27.920771104266226
Task_25021,881,448,167,163,330,1.9621380846325167,23.421655097665653
Task_25022,1846,885,161,137,298,2.0835214446952595,39.88894415401591
Task_25023,507,800,114,78,192,0.6329588014981273,17.721826018002087
Task_25024,1404,828,125,52,177,1.6936067551266587,31.43215508358625
Task_25025,2245,574,177,161,338,3.9043478260869566,45.44852662957013
Task_25026,1857,98,50,179,229,18.757575757575758,36.52117221330578
Task_25027,1472,455,108,122,230,3.2280701754385963,32.287341512267936
Task_25028,2824,913,190,172,362,3.089715536105033,55.812764235003705
Task_25029,665,656,179,193,372,1.0121765601217656,20.736592584884225
Task_25030,1807,251,33,35,68,7.170634920634921,34.48705694399081
Task_25031,2340,133,165,54,219,17.46268656716418,43.93179139232908
Task_25032,2385,503,102,193,295,4.732142857142857,47.291030595318865
Task_25033,1067,720,120,141,261,1.4798890429958391,26.83028345381347
Task_25034,2654,420,12,124,136,6.304038004750594,50.176442904811985
Task_25035,1083,181,47,93,140,5.950549450549451,24.00450979618555
Task_25036,1846,785,105,93,198,2.3486005089058524,38.99668493688093
Task_25037,1595,514,181,114,295,3.0970873786407767,34.703207490283276
Task_25038,2274,556,70,109,179,4.082585278276481,45.016214335286186
Task_25039,832,996,103,28,131,0.8345035105315948,22.351313427532816
Task_25040,1056,229,80,123,203,4.591304347826087,24.978982533321098
Task_25041,1976,180,159,128,287,10.917127071823204,39.201387886996805
Task_25042,1830,240,177,179,356,7.593360995850622,37.887712842894096
Task_25043,2147,336,159,95,254,6.370919881305638,42.61970852058595
Task_25044,616,211,166,35,201,2.9056603773584904,17.035332128486104
Task_25045,1812,1001,149,120,269,1.8083832335329342,39.555066894448025
Task_25046,2225,969,178,81,259,2.2938144329896906,45.574950934750916
Task_25047,1485,444,92,124,216,3.337078651685393,32.475360209081224
Task_25048,1670,520,34,46,80,3.2053742802303264,33.519220025120795
Task_25049,2944,388,72,129,201,7.5681233933161955,55.369492871028875
Task_25050,1326,321,180,60,240,4.118012422360248,28.975561114038353
Task_25051,683,148,111,62,173,4.583892617449664,17.656350696612922
Task_25052,1683,468,30,65,95,3.588486140724947,34.180341923505296
Task_25053,1293,551,136,62,198,2.342391304347826,29.032240391884354
Task_25054,1439,174,185,147,332,8.222857142857142,30.94443793110676
Task_25055,963,363,189,112,301,2.6456043956043955,24.24476395147053
Task_25056,1291,885,183,157,340,1.4571106094808126,31.24524842234642
Task_25057,2366,86,177,170,347,27.195402298850574,44.87928232403334
Task_25058,2765,683,144,109,253,4.042397660818714,53.57088954658237
Task_25059,1270,989,20,28,48,1.2828282828282829,28.240694199076994
Task_25060,1106,566,124,10,134,1.9506172839506173,25.237016125226287
Task_25061,796,218,16,94,110,3.634703196347032,19.851118670086535
Task_25062,2301,640,86,114,200,3.5897035881435255,45.895946352275956
Task_25063,1950,852,49,38,87,2.2860492379835873,39.11690656685475
Task_25064,1023,263,200,127,327,3.875,25.00880286542046
Task_25065,621,556,158,14,172,1.1149012567324954,17.725966676736213
Task_25066,1414,161,152,78,230,8.728395061728396,29.7702561608848
Task_25067,1092,868,15,124,139,1.2566168009205985,26.718058453347897
Task_25068,921,843,60,29,89,1.0912322274881516,22.813920854360106
Task_25069,1676,331,73,196,269,5.048192771084337,35.52456881848557
Task_25070,1558,632,19,17,36,2.4612954186413902,31.205492791060465
Task_25071,2021,197,64,119,183,10.207070707070708,39.87027672190668
Task_25072,2834,146,58,97,155,19.27891156462585,51.63207794085059
Task_25073,1271,512,25,35,60,2.4775828460038984,26.787571579305084
Task_25074,1347,507,129,136,265,2.6515748031496065,30.65176409132813
Task_25075,1760,891,58,64,122,1.9730941704035874,37.07407376154521
Task_25076,925,221,21,133,154,4.166666666666667,22.18004008683692
Task_25077,1585,188,57,146,203,8.386243386243386,33.26571294089374
Task_25078,1998,525,116,63,179,3.7984790874524714,39.86168290559553
Task_25079,1508,67,30,25,55,22.176470588235293,27.95834940889118
Task_25080,1921,218,90,168,258,8.771689497716896,38.83645597574047
Task_25081,1884,276,184,152,336,6.8014440433212995,38.73776594153165
Task_25082,1783,122,99,133,232,14.495934959349594,35.64347593406034
Task_25083,1362,1020,136,28,164,1.3339862879529873,31.10787994298387
Task_25084,2263,313,167,130,297,7.207006369426751,44.64913691319715
Task_25085,1048,873,183,200,383,1.1990846681922196,27.600903001208454
Task_25086,1581,916,72,32,104,1.7241003271537623,33.58083879577615
Task_25087,2890,905,44,50,94,3.1898454746136866,54.33132631061932
Task_25088,2163,417,132,46,178,5.1746411483253585,41.868354275551155
Task_25089,1991,509,200,147,347,3.903921568627451,41.23952702410808
Task_25090,2123,929,75,64,139,2.282795698924731,43.02167021184288
Task_25091,1781,802,63,182,245,2.2179327521793275,38.555565130650216
Task_25092,2848,948,83,134,217,3.0010537407797684,55.646898354848126
Task_25093,931,172,178,29,207,5.381502890173411,21.696958340259517
Task_25094,2514,637,197,162,359,3.9404388714733543,50.00491074613861
Task_25095,1655,249,97,16,113,6.62,32.70252653498303
Task_25096,2121,371,128,20,148,5.701612903225806,40.641598857536785
Task_25097,666,134,74,161,235,4.933333333333334,18.295081100564655
Task_25098,681,65,125,149,274,10.318181818181818,18.04285640579657
Task_25099,1267,937,36,48,84,1.3507462686567164,28.56786358431367
Task_25100,2087,999,118,68,186,2.087,42.86546783887062
Task_25101,756,704,165,155,320,1.0723404255319149,22.03885613067942
Task_25102,2758,972,66,162,228,2.8345323741007196,54.45532819606592
Task_25103,1197,904,36,95,131,1.3226519337016576,28.59341325328356
Task_25104,1618,129,43,138,181,12.446153846153846,32.61298502258544
Task_25105,1251,894,103,189,292,1.3977653631284916,30.469882315637232
Task_25106,2108,116,117,58,175,18.017094017094017,39.804826213864835
Task_25107,2258,793,108,129,237,2.8438287153652393,45.84283750922831
Task_25108,2435,882,138,75,213,2.757644394110985,48.37405533235412
Task_25109,2938,271,81,60,141,10.801470588235293,53.64584208071913
Task_25110,2481,961,48,182,230,2.579002079002079,50.07054316161696
Task_25111,1697,618,105,159,264,2.741518578352181,36.57289998144804
Task_25112,1379,302,183,97,280,4.551155115511551,30.54304242096664
Task_25113,684,683,106,148,254,1.0,20.52341437453613
Task_25114,999,530,87,78,165,1.88135593220339,24.334787915816936
Task_25115,1955,434,65,159,224,4.494252873563219,40.017062829286964
Task_25116,2748,541,96,121,217,5.070110701107011,52.756517493906664
Task_25117,2863,550,144,55,199,5.19600725952813,53.949818494799395
Task_25118,2961,200,34,167,201,14.73134328358209,54.904784572921876
Task_25119,515,698,141,33,174,0.7367668097281831,16.776540652583183
Task_25120,746,393,174,14,188,1.8934010152284264,19.389899975412646
Task_25121,970,661,69,62,131,1.4652567975830815,23.867656809254346
Task_25122,1692,585,19,139,158,2.887372013651877,35.54916232386945
Task_25123,655,101,10,110,120,6.421568627450981,16.46317153827079
Task_25124,968,529,167,23,190,1.8264150943396227,23.483808503170224
Task_25125,2367,830,32,188,220,2.848375451263538,47.73508378354535
Task_25126,2906,89,47,104,151,32.28888888888889,51.98076938302737
Task_25127,1588,986,41,90,131,1.6089159067882473,35.00536512511136
Task_25128,940,495,194,56,250,1.8951612903225807,23.55985518360274
Task_25129,2795,403,28,67,95,6.9183168316831685,51.569249523513854
Task_25130,1778,517,144,79,223,3.4324324324324325,36.94140049851912
Task_25131,2839,357,61,149,210,7.930167597765363,53.67375174438979
Task_25132,1117,886,137,188,325,1.2593010146561443,28.431562666392093
Task_25133,1586,216,36,166,202,7.308755760368664,33.243631597895295
Task_25134,2252,192,91,139,230,11.66839378238342,43.7997308542319
Task_25135,1326,208,42,165,207,6.344497607655502,29.135688776442866
Task_25136,1411,534,137,163,300,2.6373831775700936,31.947568255617398
Task_25137,1228,635,28,128,156,1.930817610062893,28.39303220632891
Task_25138,1764,787,23,167,190,2.238578680203046,37.92640759465652
Task_25139,1002,486,119,193,312,2.0574948665297743,25.419265420896835
Task_25140,2105,915,191,88,279,2.2980349344978164,43.6768717031228
Task_25141,1683,794,127,89,216,2.116981132075472,36.395479429140046
Task_25142,866,842,151,41,192,1.0272835112692764,22.902075418765317
Task_25143,1015,204,49,29,78,4.951219512195122,21.89782905541036
Task_25144,1746,532,101,153,254,3.275797373358349,37.02341050743885
Task_25145,1113,145,125,150,275,7.623287671232877,25.523959460510795
Task_25146,974,540,192,161,353,1.8003696857670979,25.283110505734317
Task_25147,2254,225,10,30,40,9.973451327433628,41.22905141253218
Task_25148,867,230,106,12,118,3.7532467532467533,20.178079010354008
Task_25149,967,143,160,111,271,6.715277777777778,23.127900012171633
Task_25150,2215,1009,78,57,135,2.1930693069306932,44.63228526043309
Task_25151,730,93,192,77,269,7.76595744680851,18.343773413123333
Task_25152,1640,72,145,100,245,22.465753424657535,32.81450799906702
Task_25153,2025,119,19,85,104,16.875,38.009328017872164
Task_25154,2097,977,155,86,241,2.144171779141104,43.55673941597029
Task_25155,2665,342,82,79,161,7.769679300291545,49.94658337993159
Task_25156,2300,650,163,191,354,3.533026113671275,46.6766483656398
Task_25157,1868,662,163,93,256,2.8174962292609353,39.22141492711
Task_25158,1961,236,11,15,26,8.274261603375528,36.407839366921685
Task_25159,2238,465,45,37,82,4.802575107296137,42.40964394121993
Task_25160,1436,965,95,128,223,1.4865424430641823,33.32087438530383
Task_25161,2897,148,117,64,181,19.44295302013423,52.492001235838934
Task_25162,1961,917,80,59,139,2.136165577342048,40.28722804932782
Task_25163,1857,346,139,86,225,5.351585014409222,37.686463195272225
Task_25164,1021,867,114,128,242,1.1762672811059909,26.41347370372766
Task_25165,1316,616,23,191,214,2.1329011345218802,30.450345962377142
Task_25166,1511,903,38,14,52,1.6714601769911503,31.642339280254742
Task_25167,915,495,81,175,256,1.844758064516129,23.895131551947042
Task_25168,732,906,81,74,155,0.8070562293274531,21.004371622283493
Task_25169,1265,154,151,195,346,8.161290322580646,28.321031307909234
Task_25170,975,330,33,12,45,2.945619335347432,21.307225743817984
Task_25171,2873,330,176,194,370,8.6797583081571,54.77735592719116
Task_25172,2456,780,139,195,334,3.144686299615877,49.47288369006035
Task_25173,1976,288,100,68,168,6.837370242214533,38.71000733982333
Task_25174,1501,144,125,200,325,10.351724137931035,31.947726430161623
Task_25175,1671,330,176,86,262,5.04833836858006,34.85831656423847
Task_25176,2555,950,48,112,160,2.6866456361724502,50.46651511350489
Task_25177,2140,619,174,16,190,3.4516129032258065,42.2142508962337
Task_25178,1286,103,176,197,373,12.365384615384615,28.1984730597931
Task_25179,2272,812,142,101,243,2.7945879458794587,46.110122072629736
Task_25180,728,358,81,95,176,2.0278551532033426,19.821407259953848
Task_25181,1881,95,101,78,179,19.59375,35.8884757583428
Task_25182,2716,304,19,15,34,8.904918032786885,48.51227613897913
Task_25183,1361,465,138,181,319,2.9206008583690988,31.049786036463022
Task_25184,602,403,52,147,199,1.49009900990099,18.382495296390875
Task_25185,1506,937,10,122,132,1.605543710021322,33.65431735692695
Task_25186,1096,120,118,103,221,9.057851239669422,24.731259210733242
Task_25187,2995,394,45,135,180,7.582278481012659,55.80229874027585
Task_25188,862,648,48,23,71,1.3281972265023112,20.81343774764188
Task_25189,2434,522,86,92,178,4.653919694072658,47.204026315987186
Task_25190,1963,655,63,11,74,2.9923780487804876,38.017192623555836
Task_25191,2724,611,140,28,168,4.450980392156863,51.28835251760308
Task_25192,2043,676,93,190,283,3.017725258493353,42.47848009603387
Task_25193,1960,486,76,97,173,4.024640657084189,39.93010432133281
Task_25194,2696,899,79,55,134,2.9955555555555557,52.00396045809774
Task_25195,2486,712,106,51,157,3.4866760168302946,47.96983215687347
Task_25196,2820,903,18,161,179,3.1194690265486726,54.67315751693655
Task_25197,2285,316,156,66,222,7.208201892744479,44.11274255778323
Task_25198,2880,509,11,140,151,5.647058823529412,54.09502188711637
Task_25199,2303,262,161,107,268,8.756653992395437,44.93798158075523
Task_25200,893,285,170,113,283,3.1223776223776225,22.80731819663984
Task_25201,2955,460,112,57,169,6.40997830802603,54.71144962054041
Task_25202,1681,693,38,145,183,2.422190201729107,35.9992745605876
Task_25203,1056,990,121,152,273,1.0655903128153381,27.468799724145388
Task_25204,2337,477,152,141,293,4.889121338912134,46.36194384276865
Task_25205,2104,238,69,196,265,8.803347280334728,41.94518381139471
Task_25206,1679,831,46,104,150,2.0180288461538463,36.05166529896359
Task_25207,2388,90,94,140,234,26.24175824175824,44.7781218643764
Task_25208,1957,366,196,160,356,5.332425068119891,40.297534907447684
Task_25209,705,827,196,198,394,0.8514492753623188,22.076789315728135
Task_25210,2368,915,31,159,190,2.5851528384279474,47.823040668514636
Task_25211,508,998,91,49,140,0.5085085085085085,17.553001602309994
Task_25212,1085,320,109,58,167,3.38006230529595,24.675608297015458
Task_25213,2707,592,25,173,198,4.564924114671164,52.25725916988259
Task_25214,2850,430,160,174,334,6.612529002320185,54.56103075252671
Task_25215,1948,859,120,139,259,2.2651162790697676,41.25128272572964
Task_25216,2826,488,183,154,337,5.779141104294479,54.35602391171756
Task_25217,2698,396,194,120,314,6.795969773299748,51.87313657858832
Task_25218,1880,939,125,29,154,2.0,38.83530663629083
Task_25219,520,451,102,157,259,1.1504424778761062,17.30638149255139
Task_25220,1152,676,196,11,207,1.7016248153618907,26.84718903712408
Task_25221,1584,246,124,130,254,6.412955465587045,33.49095859455483
Task_25222,2284,633,165,153,318,3.6025236593059935,46.151508888503194
Task_25223,1574,625,43,128,171,2.5143769968051117,33.99768411004869
Task_25224,1452,967,171,78,249,1.5,33.266463190118316
Task_25225,1833,610,35,157,192,3.0,38.40356353814865
Task_25226,2947,307,173,47,220,9.568181818181818,54.277540773248056
Task_25227,2768,833,183,192,375,3.3189448441247,54.76271503451869
Task_25228,1326,322,51,160,211,4.105263157894737,29.714530887792098
Task_25229,2799,701,28,107,135,3.9871794871794872,53.381257738309024
Task_25230,2850,433,127,182,309,6.566820276497696,54.47002723765346
Task_25231,2431,68,150,56,206,35.231884057971016,44.50028421487434
Task_25232,1792,393,72,91,163,4.548223350253807,36.64858721706985
Task_25233,2710,703,89,194,283,3.8494318181818183,53.0625990532342
Task_25234,2886,97,19,27,46,29.448979591836736,50.18437337113543
Task_25235,2814,456,145,28,173,6.157549234135668,52.35857890802103
Task_25236,2704,814,104,110,214,3.3177914110429447,52.843241119180846
Task_25237,2765,555,95,139,234,4.973021582733813,53.191057851051795
Task_25238,2415,162,183,120,303,14.815950920245399,46.198724328699264
Task_25239,1699,714,152,149,301,2.3762237762237763,37.05772102273253
Task_25240,2504,244,149,52,201,10.220408163265306,47.25317533883132
Task_25241,2517,101,45,92,137,24.676470588235293,45.90556837599473
Task_25242,1282,315,85,150,235,4.056962025316456,28.940702191757826
Task_25243,2250,759,136,185,321,2.960526315789474,46.07021715959994
Task_25244,1130,307,137,148,285,3.668831168831169,26.686171678274906
Task_25245,1894,446,72,77,149,4.237136465324385,38.06736650577295
Task_25246,1793,453,133,74,207,3.949339207048458,36.83084492135669
Task_25247,2034,674,176,11,187,3.013333333333333,40.69141226427882
Task_25248,1222,396,116,75,191,3.0780856423173804,27.531684763610937
Task_25249,1581,467,38,188,226,3.378205128205128,34.14206743052814
Task_25250,1339,724,53,30,83,1.846896551724138,28.96728282569722
Task_25251,1091,492,37,175,212,2.212981744421907,26.389963614802625
Task_25252,1419,615,118,53,171,2.3035714285714284,30.971752254688493
Task_25253,2140,795,152,31,183,2.6884422110552766,42.74391746330508
Task_25254,2656,486,165,17,182,5.453798767967146,49.680686170945705
Task_25255,2521,836,120,104,224,3.01194743130227,50.04910397756195
Task_25256,1891,1019,81,75,156,1.853921568627451,39.752006075359404
Task_25257,1019,788,46,63,109,1.291508238276299,24.713813704486057
Task_25258,2452,788,23,134,157,3.1077313054499367,48.32959508189226
Task_25259,2915,85,179,150,329,33.895348837209305,53.36893600190135
Task_25260,925,635,147,28,175,1.4544025157232705,23.035290122531478
Task_25261,2909,857,170,100,270,3.3904428904428903,56.46394596208719
Task_25262,2858,759,142,38,180,3.7605263157894737,54.024575726682656
Task_25263,1137,77,21,24,45,14.576923076923077,22.443485946515654
Task_25264,2677,174,147,56,203,15.297142857142857,49.49246363675684
Task_25265,2530,1021,176,124,300,2.475538160469667,51.14112467738246
Task_25266,1442,814,180,147,327,1.7693251533742331,33.39891296753286
Task_25267,2771,889,124,186,310,3.113483146067416,54.68400780193241
Task_25268,2419,76,87,34,121,31.415584415584416,43.19721116725291
Task_25269,2851,173,139,168,307,16.385057471264368,53.134391398809136
Task_25270,1734,504,106,126,232,3.4336633663366336,36.60572484662614
Task_25271,1222,886,73,116,189,1.3776775648252537,29.51308871280681
Task_25272,1924,679,23,169,192,2.8294117647058825,40.1462923410853
Task_25273,2815,168,41,52,93,16.65680473372781,50.70570470918083
Task_25274,2510,505,21,123,144,4.9604743083003955,48.17522993503186
Task_25275,2830,613,65,109,174,4.609120521172638,54.08170654203039
Task_25276,1266,128,56,57,113,9.813953488372093,25.973554932952002
Task_25277,2539,526,93,132,225,4.817836812144212,49.510326199573996
Task_25278,2805,631,196,108,304,4.438291139240507,54.26763923418341
Task_25279,1941,475,109,16,125,4.0777310924369745,38.03505867456693
Task_25280,2204,504,107,68,175,4.364356435643565,43.17857195850639
Task_25281,2628,457,35,59,94,5.737991266375546,48.91692699193249
Task_25282,855,255,121,43,164,3.33984375,20.685413847572473
Task_25283,802,297,19,76,95,2.6912751677852347,19.721595466478103
Task_25284,1945,864,37,58,95,2.2485549132947975,39.398193662296215
Task_25285,506,587,18,197,215,0.8605442176870748,17.258257404771232
Task_25286,1461,688,142,152,294,2.1204644412191582,33.179294992424765
Task_25287,2761,260,190,195,385,10.578544061302683,52.824621441199895
Task_25288,2413,773,158,186,344,3.1175710594315245,48.80156094478975
Task_25289,2949,347,168,162,330,8.474137931034482,55.81125497348751
Task_25290,2506,224,36,31,67,11.137777777777778,45.37031184369331
Task_25291,1084,531,153,21,174,2.037593984962406,25.139795292304555
Task_25292,1366,287,167,142,309,4.743055555555555,30.450738292113726
Task_25293,2690,410,68,129,197,6.545012165450122,51.40132529709527
Task_25294,2553,274,156,150,306,9.283636363636363,49.1665849217682
Task_25295,1924,669,173,198,371,2.8716417910447762,40.867973842820454
Task_25296,2942,372,79,17,96,7.887399463806971,53.27088621917212
Task_25297,799,517,193,181,374,1.5424710424710424,22.521696640723857
Task_25298,2826,667,126,145,271,4.230538922155689,54.62024906746026
Task_25299,1195,836,59,25,84,1.4277180406212664,26.94358730969523
Task_25300,1512,690,62,79,141,2.1881331403762663,32.831581710838265
Task_25301,2727,853,36,195,231,3.193208430913349,53.54011936100063
Task_25302,2945,343,124,11,135,8.561046511627907,53.61640296678356
Task_25303,1439,117,10,199,209,12.194915254237289,30.142088738049463
Task_25304,1409,600,159,47,206,2.344425956738769,30.832334889269646
Task_25305,2165,506,26,166,192,4.270216962524655,43.3548721516666
Task_25306,1230,526,61,143,204,2.333965844402277,28.722571300833113
Task_25307,929,514,27,127,154,1.803883495145631,23.233501808964096
Task_25308,1395,254,154,46,200,5.470588235294118,29.460927510500923
Task_25309,652,942,139,25,164,0.6914103923647932,19.844459192276883
Task_25310,1499,691,12,101,113,2.1661849710982657,32.668132711170045
Task_25311,1055,455,144,118,262,2.31359649122807,25.825325987325147
Task_25312,1468,316,180,107,287,4.630914826498422,32.00923232812885
Task_25313,2070,379,73,85,158,5.447368421052632,40.73166030033939
Task_25314,2072,93,50,69,119,22.04255319148936,38.4865311338379
Task_25315,1790,1003,22,118,140,1.7828685258964143,38.27770338980962
Task_25316,831,826,191,133,324,1.0048367593712213,23.58845891991938
Task_25317,2454,367,50,127,177,6.668478260869565,47.31596329249866
Task_25318,1512,150,75,181,256,10.013245033112582,31.924579330887596
Task_25319,1255,613,145,161,306,2.043973941368078,29.749388587138213
Task_25320,2170,968,200,170,370,2.239422084623323,45.65417221929107
Task_25321,1765,298,97,183,280,5.903010033444816,36.748633368016165
Task_25322,1738,455,131,70,201,3.81140350877193,35.84618147583807
Task_25323,1671,631,55,187,242,2.643987341772152,36.30255103323319
Task_25324,1023,91,33,71,104,11.119565217391305,21.826476357927277
Task_25325,534,716,10,14,24,0.7447698744769874,15.574223243338364
Task_25326,582,346,136,122,258,1.6772334293948126,17.97144082452425
Task_25327,2752,518,17,127,144,5.302504816955684,52.01180483923125
Task_25328,2903,310,129,12,141,9.334405144694534,52.828667670445206
Task_25329,552,693,10,104,114,0.7953890489913544,17.5813304822048
Task_25330,1923,756,185,100,285,2.5402906208718625,40.59362496847634
Task_25331,2283,797,142,39,181,2.8609022556390977,44.96816677050904
Task_25332,1972,663,199,189,388,2.9698795180722892,41.67281465004955
Task_25333,2511,200,24,71,95,12.492537313432836,46.384848948257655
Task_25334,2927,627,180,118,298,4.660828025477707,56.17470856115782
Task_25335,2479,998,75,138,213,2.4814814814814814,50.02576136422778
Task_25336,1392,313,70,85,155,4.43312101910828,29.78872952679923
Task_25337,2235,555,169,173,342,4.01978417266187,45.26526722579124
Task_25338,1600,517,44,173,217,3.088803088803089,34.54045464922292
Task_25339,1842,873,101,133,234,2.1075514874141876,39.493893659722204
Task_25340,1699,418,168,181,349,4.054892601431981,36.384210779952696
Task_25341,943,679,156,110,266,1.386764705882353,24.690113744917877
Task_25342,1623,825,34,139,173,1.9648910411622276,35.56834717633368
Task_25343,1099,660,153,110,263,1.6626323751891074,27.143354638778646
Task_25344,2268,1000,135,40,175,2.265734265734266,45.48334319839065
Task_25345,1193,168,79,73,152,7.059171597633136,25.649637704800487
Task_25346,2689,255,59,75,134,10.50390625,50.012981732184436
Task_25347,504,954,161,40,201,0.5277486910994764,17.982424488251386
Task_25348,2277,71,121,42,163,31.625,41.3888261684125
Task_25349,1399,703,91,163,254,1.9872159090909092,32.12913483785509
Task_25350,822,1012,60,196,256,0.8114511352418559,23.957539700643867
Task_25351,2001,186,86,21,107,10.70053475935829,38.04410864777133
Task_25352,1194,620,152,64,216,1.922705314009662,27.802159825227147
Task_25353,605,789,180,74,254,0.7658227848101266,19.29072826498129
Task_25354,1906,755,11,161,172,2.5211640211640214,39.83535878148631
Task_25355,1073,805,60,151,211,1.3312655086848635,27.101015158694754
Task_25356,2696,966,136,74,210,2.7880041365046537,52.764431567797764
Task_25357,1419,117,168,20,188,12.025423728813559,28.818276584028666
Task_25358,2875,483,188,172,360,5.940082644628099,55.245437340491186
Task_25359,1808,86,99,58,157,20.7816091954023,34.34836620419124
Task_25360,2078,811,189,112,301,2.5591133004926108,43.310911008000424
Task_25361,2768,866,64,117,181,3.192618223760092,53.82753488365359
Task_25362,1310,902,57,100,157,1.4507198228128462,30.49344440054765
Task_25363,2436,194,19,33,52,12.492307692307692,44.41063951398183
Task_25364,1027,669,14,17,31,1.5328358208955224,23.02848794129173
Task_25365,2861,1020,15,177,192,2.802154750244858,56.01682943216756
Task_25366,2908,956,72,64,136,3.038662486938349,55.579003216276476
Task_25367,2404,832,148,175,323,2.885954381752701,48.73311998485653
Task_25368,2332,955,135,101,236,2.4393305439330546,47.4757192950946
Task_25369,1575,253,132,172,304,6.200787401574803,33.659983242021255
Task_25370,2537,149,90,127,217,16.913333333333334,47.71213417244278
Task_25371,767,813,186,39,225,0.9422604422604423,21.473176420525636
Task_25372,908,294,11,26,37,3.077966101694915,20.138015126918862
Task_25373,2609,869,129,115,244,2.9988505747126437,51.65298966469877
Task_25374,854,184,67,200,267,4.616216216216216,21.876718214604367
Task_25375,1927,629,40,19,59,3.0587301587301585,37.28944431150497
Task_25376,1206,1002,124,86,210,1.2023928215353938,29.30221450836388
Task_25377,2112,864,107,77,184,2.4416184971098267,42.88281011145205
Task_25378,2230,84,34,30,64,26.235294117647058,39.91133666258374
Task_25379,990,837,178,68,246,1.1813842482100239,25.396103533959888
Task_25380,2359,297,74,113,187,7.916107382550336,45.68540608310269
Task_25381,1683,887,157,112,269,1.8952702702702702,37.14507467083806
Task_25382,904,238,18,135,153,3.782426778242678,21.897326517657916
Task_25383,2313,850,195,176,371,2.717978848413631,47.565415306850866
Task_25384,1188,369,180,28,208,3.210810810810811,26.579188784677044
Task_25385,2380,208,183,148,331,11.38755980861244,46.29596622738804
Task_25386,1159,962,155,73,228,1.2035306334371756,28.41715888728136
Task_25387,983,988,116,48,164,0.993933265925177,25.10772140930195
Task_25388,1884,83,49,117,166,22.428571428571427,36.384063110011674
Task_25389,2700,253,100,33,133,10.62992125984252,49.58417675369929
Task_25390,914,502,43,22,65,1.8170974155069584,21.090518229281145
Task_25391,801,501,101,120,221,1.595617529880478,21.753671881834297
Task_25392,2472,343,146,41,187,7.186046511627907,46.70013588934853
Task_25393,2138,531,52,21,73,4.018796992481203,40.542104939501606
Task_25394,2033,594,26,62,88,3.4168067226890755,39.912888424945265
Task_25395,1037,633,171,191,362,1.635646687697161,26.64218831178843
Task_25396,1925,832,117,166,283,2.310924369747899,40.950429892126685
Task_25397,747,972,14,123,137,0.7677286742034943,21.695140644349816
Task_25398,1749,585,137,161,298,2.984641638225256,37.44861903677069
Task_25399,2979,827,139,102,241,3.597826086956522,57.351038726750154
Task_25400,2990,263,70,165,235,11.325757575757576,55.87505106285161
Task_25401,1403,268,44,104,148,5.215613382899628,29.884321783902454
Task_25402,995,854,117,185,302,1.1637426900584795,26.31523762555942
Task_25403,1088,686,58,131,189,1.5836972343522562,26.849315063731808
Task_25404,2107,818,96,127,223,2.572649572649573,43.51553472358355
Task_25405,2604,1011,78,33,111,2.5731225296442686,50.2727246881059
Task_25406,1563,331,14,143,157,4.707831325301205,32.76184456698901
Task_25407,2292,206,197,197,394,11.072463768115941,45.2546266741659
Task_25408,1507,88,133,129,262,16.93258426966292,31.00304753709463
Task_25409,1050,993,139,184,323,1.056338028169014,27.663944487239505
Task_25410,2831,480,54,10,64,5.885654885654886,51.127952341880736
Task_25411,671,701,11,187,198,0.9558404558404558,20.193936963615318
Task_25412,2313,930,122,190,312,2.484425349087003,47.569732822781326
Task_25413,1851,644,88,121,209,2.869767441860465,38.809736136915525
Task_25414,2536,609,125,53,178,4.157377049180328,48.69727320458859
Task_25415,1109,695,70,171,241,1.5933908045977012,27.54140702102139
Task_25416,1293,541,55,41,96,2.385608856088561,27.73857185427154
Task_25417,554,211,92,179,271,2.6132075471698113,17.330453324227776
Task_25418,2331,881,136,180,316,2.642857142857143,47.705441329271046
Task_25419,1663,1018,198,38,236,1.631992149165849,36.325767703271474
Task_25420,2560,722,125,188,313,3.540802213001383,50.8330905104527
Task_25421,2380,954,111,198,309,2.492146596858639,48.70443338966417
Task_25422,2534,196,137,17,154,12.862944162436548,46.460275060604225
Task_25423,732,698,65,147,212,1.0472103004291846,21.22726682646649
Task_25424,1850,819,123,156,279,2.2560975609756095,39.68891730702689
Task_25425,2861,709,115,198,313,4.029577464788733,55.57476777313218
Task_25426,1889,577,101,150,251,3.2681660899653977,39.412382706571655
Task_25427,1246,586,128,104,232,2.122657580919932,29.105268945407577
Task_25428,2212,177,199,170,369,12.426966292134832,43.31349888962196
Task_25429,2747,746,12,120,132,3.677376171352075,52.72142770290099
Task_25430,1719,329,113,23,136,5.209090909090909,34.26599357333179
Task_25431,2964,606,54,25,79,4.883031301482702,53.98329615589762
Task_25432,1210,667,174,176,350,1.811377245508982,29.425598782508967
Task_25433,1379,726,152,44,196,1.8968363136176065,30.691546911399126
Task_25434,2760,737,139,166,305,3.7398373983739837,53.98033645050739
Task_25435,2649,593,193,172,365,4.459595959595959,52.04459342165251
Task_25436,990,593,153,102,255,1.6666666666666667,25.160411178697995
Task_25437,1426,851,55,73,128,1.6737089201877935,32.076564582158575
Task_25438,1607,687,14,86,100,2.3357558139534884,33.95892765570635
Task_25439,640,885,187,137,324,0.7223476297968398,20.929684961317076
Task_25440,1302,714,107,116,223,1.8209790209790209,30.369016650747053
Task_25441,1619,212,16,58,74,7.60093896713615,31.650319607868692
Task_25442,2522,575,146,54,200,4.378472222222222,48.60339608848731
Task_25443,1135,298,62,199,261,3.7959866220735785,26.830383354430296
Task_25444,1821,881,185,158,343,2.064625850340136,39.713972484820125
Task_25445,2949,795,103,188,291,3.7047738693467336,57.12647844799229
Task_25446,1552,718,121,112,233,2.1585535465924894,34.38090357074224
Task_25447,2189,83,147,80,227,26.05952380952381,41.16436577575518
Task_25448,1382,225,119,165,284,6.115044247787611,30.413303416596605
Task_25449,2435,503,170,143,313,4.8313492063492065,48.09043952500624
Task_25450,1217,158,61,148,209,7.654088050314465,27.031251397726972
Task_25451,2740,113,150,109,259,24.035087719298247,50.61524405076323
Task_25452,2967,730,59,176,235,4.0588235294117645,57.09119939806241
Task_25453,2400,777,56,95,151,3.0848329048843186,47.45070493232607
Task_25454,2685,817,32,77,109,3.28239608801956,51.49824443921265
Task_25455,2682,515,155,52,207,5.1976744186046515,51.01631440151262
Task_25456,2030,750,190,117,307,2.70306258322237,42.39400197309775
Task_25457,1915,695,10,20,30,2.7514367816091956,37.157570055476576
Task_25458,1210,755,83,130,213,1.6005291005291005,29.054851250242198
Task_25459,768,736,75,111,186,1.0420624151967435,21.616804914806725
Task_25460,2020,296,105,161,266,6.801346801346801,40.65431159335275
Task_25461,804,503,19,121,140,1.5952380952380953,21.121432585672512
Task_25462,1787,143,31,90,121,12.409722222222221,34.74210299029593
Task_25463,1396,96,75,95,170,14.391752577319588,28.710632994781278
Task_25464,2211,529,195,167,362,4.1716981132075475,44.88355354585095
Task_25465,2897,581,16,50,66,4.97766323024055,52.9725524930526
Task_25466,714,861,154,159,313,0.8283062645011601,21.893821214010444
Task_25467,2541,979,109,157,266,2.592857142857143,51.07973421684583
Task_25468,1661,680,192,120,312,2.4390602055800295,36.35644828361229
Task_25469,1402,285,177,183,360,4.9020979020979025,31.303105415895235
Task_25470,2606,67,86,78,164,38.3235294117647,47.17638621946864
Task_25471,880,1017,52,147,199,0.8644400785854617,24.557022687767255
Task_25472,1912,380,113,93,206,5.018372703412074,38.79209951682162
Task_25473,608,334,199,122,321,1.8149253731343284,18.642171208993634
Task_25474,1006,172,144,145,289,5.815028901734104,23.923482093844125
Task_25475,1400,897,157,76,233,1.55902004454343,32.08668868397225
Task_25476,2281,873,145,188,333,2.6098398169336385,46.976566411591854
Task_25477,1783,535,85,86,171,3.326492537313433,36.72375210337788
Task_25478,2118,614,74,147,221,3.44390243902439,43.14819028542763
Task_25479,2513,266,117,130,247,9.411985018726591,48.21021486477944
Task_25480,2833,196,57,121,178,14.380710659898478,52.603495023958224
Task_25481,2442,665,16,78,94,3.6666666666666665,46.914603467915136
Task_25482,2361,562,182,107,289,4.19360568383659,46.94714399121644
Task_25483,1464,885,64,43,107,1.652370203160271,31.546966870273554
Task_25484,1387,830,16,190,206,1.6690734055354994,32.05817710206321
Task_25485,1914,547,36,189,225,3.4927007299270074,39.662049684802504
Task_25486,1723,567,92,52,144,3.033450704225352,35.55989788455097
Task_25487,1083,878,58,98,156,1.2320819112627985,26.72896742017357
Task_25488,2153,197,89,195,284,10.873737373737374,42.6132006351671
Task_25489,2342,589,80,38,118,3.9694915254237286,44.8812440990343
Task_25490,1146,761,119,155,274,1.5039370078740157,28.288271057463305
Task_25491,2640,624,188,149,337,4.224,51.84096272909513
Task_25492,2339,746,106,58,164,3.1311914323962515,45.95001529344043
Task_25493,539,578,149,10,159,0.9309153713298791,16.488600266813425
Task_25494,886,237,167,51,218,3.722689075630252,21.688951485801926
Task_25495,859,169,65,84,149,5.052941176470588,20.57582099942837
Task_25496,1854,631,79,171,250,2.9335443037974684,39.185518233541146
Task_25497,2353,779,178,79,257,3.0166666666666666,47.02804444635837
Task_25498,622,589,16,113,129,1.0542372881355933,18.344421903950373
Task_25499,881,888,188,70,258,0.9910011248593926,23.93917071274974
Task_25500,2400,420,18,103,121,5.7007125890736345,46.02417918889726
Task_25501,2466,496,182,104,286,4.961770623742455,48.379743162418755
Task_25502,723,562,175,117,292,1.2841918294849024,20.945845809216106
Task_25503,671,681,58,173,231,0.9838709677419355,20.384773875424926
Task_25504,1123,474,61,128,189,2.3642105263157895,26.748396263537305
Task_25505,1262,158,149,169,318,7.937106918238993,28.158553852876604
Task_25506,2946,800,76,88,164,3.6779026217228465,56.19388658367176
Task_25507,1215,290,135,138,273,4.175257731958763,27.905507707083718
Task_25508,2602,758,43,116,159,3.4281949934123848,50.50735514884534
Task_25509,1716,927,51,20,71,1.8491379310344827,34.9351731323412
Task_25510,2517,616,160,152,312,4.079416531604538,49.759235699978035
Task_25511,2991,194,97,193,290,15.338461538461539,55.71576040596776
Task_25512,1815,979,54,166,220,1.8520408163265305,39.53999779811465
Task_25513,2898,489,56,39,95,5.914285714285715,52.955620302293305
Task_25514,2329,311,176,14,190,7.464743589743589,44.198964592065856
Task_25515,1013,759,129,163,292,1.3328947368421054,26.27019361157271
Task_25516,1926,819,196,100,296,2.348780487804878,40.887558567314926
Task_25517,574,859,31,46,77,0.6674418604651163,17.17783500580526
Task_25518,1194,734,156,30,186,1.6244897959183673,27.648604325391734
Task_25519,2017,809,193,60,253,2.4901234567901236,41.521770549235804
Task_25520,1973,433,137,40,177,4.546082949308755,38.92027255952808
Task_25521,1531,179,121,35,156,8.505555555555556,30.681020647531483
Task_25522,1932,425,59,130,189,4.535211267605634,39.42610075951846
Task_25523,1011,320,101,192,293,3.149532710280374,24.9472146023235
Task_25524,811,258,193,147,340,3.1312741312741315,21.730137443713204
Task_25525,2004,690,102,183,285,2.9001447178002895,41.791534750864244
Task_25526,1219,782,59,23,82,1.5568326947637292,27.185556666528953
Task_25527,777,739,72,134,206,1.05,22.0226957465255
Task_25528,2432,381,161,176,337,6.366492146596858,47.800022430876595
Task_25529,1936,957,32,80,112,2.020876826722338,40.18297776046893
Task_25530,1925,716,186,42,228,2.684797768479777,39.46192029534961
Task_25531,1592,532,95,34,129,2.9868667917448404,33.06768924223086
Task_25532,1459,142,47,170,217,10.202797202797203,30.753688980451255
Task_25533,2931,331,13,114,127,8.828313253012048,54.28898262868301
Task_25534,2451,634,53,116,169,3.8598425196850394,48.05542996894689
Task_25535,2204,522,93,199,292,4.21414913957935,44.593689208617626
Task_25536,1476,174,163,79,242,8.434285714285714,30.80365773063259
Task_25537,1557,77,153,103,256,19.96153846153846,31.58988812349536
Task_25538,1231,91,146,188,334,13.380434782608695,27.11584208082017
Task_25539,1829,481,113,42,155,3.7946058091286305,36.571297621888384
Task_25540,2472,145,127,114,241,16.931506849315067,46.728900588978924
Task_25541,942,362,37,40,77,2.5950413223140494,21.11957103345088
Task_25542,928,603,46,81,127,1.5364238410596027,23.176499064429702
Task_25543,1750,161,132,86,218,10.802469135802468,35.104163115155
Task_25544,2564,215,135,177,312,11.87037037037037,49.18551951506032
Task_25545,2303,461,20,193,213,4.984848484848484,45.46801359549537
Task_25546,2993,946,19,171,190,3.160506863780359,57.78637838702674
Task_25547,1256,631,114,190,304,1.9873417721518987,29.854997733022074
Task_25548,2798,137,96,20,116,20.27536231884058,49.87994513358669
Task_25549,1817,165,196,77,273,10.94578313253012,36.261473601048614
Task_25550,2104,918,56,143,199,2.2894450489662677,43.80105954402322
Task_25551,1481,868,106,92,198,1.7042577675489068,33.42191364253127
Task_25552,2634,350,187,131,318,7.504273504273504,50.739450433102014
Task_25553,1994,289,146,172,318,6.875862068965517,40.469670620302615
Task_25554,1192,505,111,119,230,2.355731225296443,28.008873835982314
Task_25555,1924,326,196,181,377,5.883792048929664,39.767797322717506
Task_25556,2500,192,37,106,143,12.953367875647668,46.95054562352923
Task_25557,2978,754,181,18,199,3.9443708609271524,55.88308248542092
Task_25558,1513,516,53,98,151,2.9264990328820115,32.586727031953146
Task_25559,684,934,179,15,194,0.7315508021390374,20.302504544082762
Task_25560,949,187,34,70,104,5.047872340425532,21.830083854843526
Task_25561,2911,685,53,144,197,4.243440233236152,55.85854916994354
Task_25562,1000,946,39,103,142,1.0559662090813093,25.414773954386146
Task_25563,691,345,115,183,298,1.9971098265895955,19.97549993909809
Task_25564,2834,612,182,96,278,4.623164763458401,54.555139231764436
Task_25565,2793,747,72,161,233,3.733957219251337,54.329796998689936
Task_25566,2885,550,111,134,245,5.235934664246824,55.04718879173837
Task_25567,2980,265,25,42,67,11.203007518796992,53.042466536600365
Task_25568,1036,861,150,24,174,1.2018561484918793,25.48527231794159
Task_25569,2486,965,145,158,303,2.5734989648033126,50.332757823878715
Task_25570,2780,897,65,52,117,3.0957683741648108,53.038935793791005
Task_25571,1772,443,195,134,329,3.990990990990991,37.46104653300009
Task_25572,649,143,74,194,268,4.506944444444445,18.363054012222786
Task_25573,770,831,54,103,157,0.9254807692307693,21.652821640758216
Task_25574,1207,1011,28,153,181,1.1926877470355732,29.36335809945349
Task_25575,2433,478,63,23,86,5.079331941544885,45.42029575973808
Task_25576,673,761,158,25,183,0.8832020997375328,19.387011243434536
Task_25577,1125,183,110,179,289,6.114130434782608,26.105337922907196
Task_25578,2315,478,86,140,226,4.832985386221294,45.75552711964735
Task_25579,2044,75,172,176,348,26.894736842105264,39.72718411245958
Task_25580,2099,579,84,28,112,3.6189655172413793,40.82880729889093
Task_25581,1128,982,134,16,150,1.1475076297049847,26.868449906326102
Task_25582,713,779,102,23,125,0.9141025641025641,19.813372111588226
Task_25583,1175,109,68,31,99,10.681818181818182,23.89085570569095
Task_25584,2452,292,169,119,288,8.368600682593856,47.507639501242785
Task_25585,2152,498,80,58,138,4.312625250501002,41.985913785996125
Task_25586,2202,855,88,120,208,2.572429906542056,45.02519415133978
Task_25587,1599,199,49,138,187,7.995,33.408833712093134
Task_25588,672,738,181,117,298,0.9093369418132612,20.732107885333132
Task_25589,2246,95,183,197,380,23.395833333333332,43.1901894218995
Task_25590,2822,303,72,147,219,9.282894736842104,53.25333786134223
Task_25591,1019,918,93,65,158,1.1088139281828073,25.396319697867725
Task_25592,2403,815,180,15,195,2.9448529411764706,47.029269058999965
Task_25593,1384,596,115,189,304,2.318257956448911,31.771116389825156
Task_25594,1959,198,184,118,302,9.844221105527637,39.48350612692759
Task_25595,2060,783,193,183,376,2.627551020408163,43.38030024396776
Task_25596,2048,562,144,27,171,3.6376554174067497,40.41652149226506
Task_25597,1985,231,173,164,337,8.556034482758621,40.19598403379998
Task_25598,1515,817,114,195,309,1.852078239608802,34.567480867099796
Task_25599,1592,223,11,200,211,7.107142857142857,33.447012214858795
Task_25600,1690,769,44,25,69,2.1948051948051948,34.254625260072125
Task_25601,1339,558,195,94,289,2.395348837209302,30.676795492616435
Task_25602,1800,914,32,195,227,1.9672131147540983,39.05491256445742
Task_25603,2648,721,32,144,176,3.667590027700831,51.429033576012166
Task_25604,738,894,12,13,25,0.8245810055865922,19.378793389636375
Task_25605,1404,559,166,122,288,2.507142857142857,31.801278622641842
Task_25606,1171,523,140,47,187,2.234732824427481,26.695817756066493
Task_25607,2467,953,15,38,53,2.5859538784067087,47.32680041354973
Task_25608,1364,481,197,35,232,2.8298755186721993,29.87196510235242
Task_25609,2568,726,44,92,136,3.53232462173315,49.75779450630816
Task_25610,2624,318,61,25,86,8.225705329153605,47.88826323299611
Task_25611,1489,453,176,26,202,3.2797356828193833,31.57597880418071
Task_25612,1099,989,154,67,221,1.11010101010101,27.37756419156804
Task_25613,1842,451,99,153,252,4.075221238938053,38.27721519556432
Task_25614,1807,452,165,52,217,3.988962472406181,37.006737634813575
Task_25615,1781,748,190,193,383,2.3778371161548733,38.89708668881505
Task_25616,2696,915,133,152,285,2.943231441048035,53.41442447006815
Task_25617,2113,161,13,180,193,13.04320987654321,41.063705893150875
Task_25618,2177,361,50,142,192,6.013812154696133,43.185173253424075
Task_25619,2207,911,36,105,141,2.419956140350877,44.637849509235785
Task_25620,2593,144,53,53,106,17.882758620689657,46.92719166332839
Task_25621,2879,982,51,30,81,2.928789420142421,54.24338661068716
Task_25622,1793,394,87,195,282,4.539240506329114,37.52094790688085
Task_25623,1394,733,117,83,200,1.8991825613079019,31.440199128745643
Task_25624,563,1015,97,151,248,0.5541338582677166,19.796526380935664
Task_25625,1608,106,117,110,227,15.02803738317757,32.476686394585094
Task_25626,2424,754,73,38,111,3.2105960264900664,46.63816542713491
Task_25627,734,833,140,186,326,0.8800959232613909,22.230739967864693
Task_25628,1929,735,45,157,202,2.620923913043478,40.332574423699675
Task_25629,1180,202,112,78,190,5.812807881773399,26.28083357693244
Task_25630,3000,137,11,93,104,21.73913043478261,53.660390104211615
Task_25631,1012,828,117,35,152,1.220747889022919,24.682981288990252
Task_25632,2410,999,78,56,134,2.41,47.76712240882688
Task_25633,2494,569,138,23,161,4.375438596491228,47.38691517353694
Task_25634,585,360,78,56,134,1.6204986149584488,16.870620494249923
Task_25635,2395,610,13,99,112,3.9198036006546646,46.54504406054402
Task_25636,1975,220,189,25,214,8.936651583710407,38.51149709172572
Task_25637,2729,693,105,13,118,3.9322766570605188,51.11140659455673
Task_25638,874,701,77,162,239,1.245014245014245,23.683345173277804
Task_25639,1346,104,111,20,131,12.81904761904762,26.892786384668995
Task_25640,2774,398,17,126,143,6.9523809523809526,51.959784279548764
Task_25641,865,264,83,144,227,3.2641509433962264,22.143011716996238
Task_25642,1403,506,17,70,87,2.767258382642998,29.675037430419795
Task_25643,1746,122,75,196,271,14.195121951219512,35.466232959208234
Task_25644,2511,294,145,113,258,8.511864406779662,48.303430918222155
Task_25645,910,228,56,62,118,3.9737991266375547,21.379971797627547
Task_25646,1982,955,183,39,222,2.073221757322176,41.05527818591879
Task_25647,1250,423,67,153,220,2.94811320754717,28.794389504373196
Task_25648,868,558,113,129,242,1.552772808586762,23.07099897905196
Task_25649,1957,882,64,77,141,2.216308040770102,40.40258366040917
Task_25650,556,714,11,54,65,0.7776223776223776,16.50028637619932
Task_25651,2663,646,37,23,60,4.115919629057187,49.22802665579715
Task_25652,2787,153,118,197,315,18.0974025974026,52.16786833107457
Task_25653,510,362,168,12,180,1.4049586776859504,15.373833377663033
Task_25654,1463,521,22,46,68,2.8026819923371646,29.91158089820436
Task_25655,1384,469,195,44,239,2.9446808510638296,30.157780399072934
Task_25656,1253,713,55,196,251,1.7549019607843137,29.978426491955243
Task_25657,1744,144,52,19,71,12.027586206896551,32.7963483361346
Task_25658,1803,877,147,170,317,2.0535307517084282,39.316722585523216
Task_25659,1180,758,181,51,232,1.5546772068511199,28.048380635845643
Task_25660,903,79,58,162,220,11.2875,21.438887979984997
Task_25661,2560,218,148,70,218,11.689497716894977,48.109085591960145
Task_25662,2943,413,174,188,362,7.108695652173913,56.122894728989344
Task_25663,1860,456,142,24,166,4.070021881838074,37.12365821647339
Task_25664,2551,486,64,17,81,5.238193018480493,47.16452654724475
Task_25665,675,986,173,40,213,0.6838905775075987,20.74731257660586
Task_25666,2790,352,101,35,136,7.903682719546742,51.342701306423315
Task_25667,1089,628,70,51,121,1.7313195548489666,25.435843910450743
Task_25668,2503,604,151,150,301,4.137190082644628,49.446832536992225
Task_25669,2580,512,112,34,146,5.029239766081871,48.61669334644666
Task_25670,897,472,135,103,238,1.8964059196617336,23.247700735657315
Task_25671,1419,234,172,47,219,6.038297872340426,29.865787457047237
Task_25672,1734,459,101,151,252,3.7695652173913046,36.58883051194249
Task_25673,2056,976,76,120,196,2.104401228249744,43.15321895633688
Task_25674,2064,662,136,193,329,3.1131221719457014,42.866805635907156
Task_25675,2291,636,148,168,316,3.596546310832025,46.284843049884124
Task_25676,1286,1008,46,166,212,1.2745292368681864,30.945040723054614
Task_25677,2194,301,87,96,183,7.264900662251655,42.81084037281835
Task_25678,2932,548,133,121,254,5.340619307832423,55.806446929010576
Task_25679,574,384,185,185,370,1.490909090909091,18.532187374732228
Task_25680,1488,621,129,114,243,2.392282958199357,33.11169159831319
Task_25681,2514,808,21,103,124,3.107540173053152,49.11952830957042
Task_25682,2280,415,116,186,302,5.480769230769231,45.36430274624922
Task_25683,1894,361,170,66,236,5.232044198895028,38.14300575860617
Task_25684,1335,1022,159,123,282,1.3049853372434017,32.05714094341554
Task_25685,1633,660,141,139,280,2.470499243570348,35.73391293471371
Task_25686,2020,253,56,94,150,7.952755905511811,39.68257431847952
Task_25687,1302,753,27,70,97,1.726790450928382,29.026477612709765
Task_25688,636,943,199,125,324,0.673728813559322,21.057023087655626
Task_25689,2148,498,77,35,112,4.304609218436874,41.42067223441767
Task_25690,2083,725,66,146,212,2.869146005509642,42.89221241606244
Task_25691,582,336,166,129,295,1.7270029673590503,18.11692564752364
Task_25692,1261,588,123,113,236,2.140916808149406,29.380295266601053
Task_25693,602,126,133,12,145,4.74015748031496,15.612632711160522
Task_25694,1187,808,111,65,176,1.4672435105067985,27.915566443914074
Task_25695,699,881,13,85,98,0.7925170068027211,20.15820732892381
Task_25696,2616,314,18,47,65,8.304761904761905,47.50101184890016
Task_25697,1764,990,103,175,278,1.7800201816347123,38.86803243414024
Task_25698,1706,335,121,12,133,5.0773809523809526,34.0168460614719
Task_25699,1715,867,76,165,241,1.9758064516129032,37.67959945929809
Task_25700,2656,740,146,196,342,3.5843454790823213,52.55302100545608
Task_25701,2536,957,67,134,201,2.6471816283924845,50.72744783180524
Task_25702,616,164,157,78,235,3.7333333333333334,17.232117533651458
Task_25703,1163,87,161,118,279,13.215909090909092,25.60388758292142
Task_25704,2055,538,67,135,202,3.8126159554730985,41.79647146365712
Task_25705,2262,996,72,75,147,2.2688064192577735,45.62578982883321
Task_25706,2232,73,129,164,293,30.16216216216216,42.37428971964289
Task_25707,705,992,163,93,256,0.7099697885196374,21.86643484888208
Task_25708,2881,838,189,158,347,3.433849821215733,56.39273792733659
Task_25709,2233,762,39,149,188,2.926605504587156,45.1332132788741
Task_25710,2213,372,155,123,278,5.932975871313673,43.96161236360157
Task_25711,2079,636,59,107,166,3.2637362637362637,42.14181026636159
Task_25712,1872,422,22,119,141,4.425531914893617,37.76491262789728
Task_25713,1144,198,118,141,259,5.748743718592965,26.45973998872222
Task_25714,1068,366,31,35,66,2.9100817438692097,23.16522028481616
Task_25715,2132,222,137,81,218,9.560538116591928,41.50316324006458
Task_25716,2150,170,180,10,190,12.573099415204679,40.71595099879263
Task_25717,1861,552,156,179,335,3.365280289330922,39.310914883978526
Task_25718,1607,960,135,157,292,1.672216441207076,36.32372426259794
Task_25719,2991,420,153,14,167,7.104513064133017,54.77295907419164
Task_25720,985,520,128,158,286,1.890595009596929,25.088300611492247
Task_25721,1157,197,135,116,251,5.843434343434343,26.58745119243203
Task_25722,1102,299,106,171,277,3.6733333333333333,26.21499883402471
Task_25723,2114,644,52,190,242,3.277519379844961,43.37528420439079
Task_25724,2447,561,21,20,41,4.354092526690391,45.19090851370263
Task_25725,2860,870,96,159,255,3.283582089552239,55.80006637266079
Task_25726,2590,664,108,117,225,3.8947368421052633,50.62432533403116
Task_25727,805,186,57,153,210,4.304812834224599,21.109903902713658
Task_25728,2552,435,13,149,162,5.853211009174312,48.838521024299475
Task_25729,1048,784,191,103,294,1.3350318471337579,26.823303052782077
Task_25730,1057,677,93,113,206,1.5589970501474926,26.36523351156303
Task_25731,942,209,51,42,93,4.485714285714286,21.185622948731353
Task_25732,742,748,135,186,321,0.9906542056074766,22.070908721312605
Task_25733,1199,590,96,186,282,2.0287648054145517,28.771906823820675
Task_25734,1500,754,45,82,127,1.9867549668874172,32.784568500422715
Task_25735,974,884,47,93,140,1.1005649717514123,24.815899989789752
Task_25736,2802,1006,87,42,129,2.7825223435948363,53.59826566301404
Task_25737,976,828,122,194,316,1.1773220747889024,26.009962675174943
Task_25738,2027,722,107,28,135,2.8035961272475793,40.417763270927644
Task_25739,958,901,189,133,322,1.0620842572062084,25.833583860754285
Task_25740,1547,728,129,30,159,2.122085048010974,32.94312682290037
Task_25741,1033,117,139,51,190,8.754237288135593,23.016877611715852
Task_25742,1547,382,164,38,202,4.039164490861618,32.33975697537975
Task_25743,2690,602,88,185,273,4.461028192371476,52.34664996742635
Task_25744,2913,66,99,136,235,43.47761194029851,52.78121491845965
Task_25745,2527,522,51,176,227,4.831739961759082,49.464936494642124
Task_25746,2709,866,141,76,217,3.124567474048443,52.687770886392435
Task_25747,2188,738,162,54,216,2.9607577807848444,43.90096014424108
Task_25748,1256,334,51,19,70,3.7492537313432837,25.77639964439834
Task_25749,1721,795,189,175,364,2.1620603015075375,37.98124259242407
Task_25750,2082,455,29,53,82,4.565789473684211,40.18095461325721
Task_25751,588,572,99,145,244,1.0261780104712042,18.62952212358158
Task_25752,1480,513,126,102,228,2.8793774319066148,32.559776739630614
Task_25753,865,410,135,84,219,2.104622871046229,22.138938658953865
Task_25754,830,239,90,187,277,3.4583333333333335,21.7918982895889
Task_25755,732,806,153,76,229,0.9070631970260223,21.253120237601085
Task_25756,1841,995,160,97,257,1.8483935742971886,39.94180984573861
Task_25757,741,610,93,145,238,1.2127659574468086,21.250586620535916
Task_25758,2795,287,85,155,240,9.70486111111111,52.79590568962118
Task_25759,2959,252,152,163,315,11.695652173913043,55.56085509399128
Task_25760,2524,836,40,191,231,3.015531660692951,50.2681398093815
Task_25761,1534,215,129,39,168,7.101851851851852,31.1498794677878
Task_25762,766,950,112,189,301,0.8054679284963197,22.998703673908082
Task_25763,2419,391,55,85,140,6.170918367346939,46.28885089529968
Task_25764,1327,664,119,103,222,1.9954887218045112,30.58550296144077
Task_25765,2472,994,101,166,267,2.4844221105527637,50.0507418443536
Task_25766,2874,642,46,165,211,4.469673405909798,55.09421019927123
Task_25767,1436,944,15,30,45,1.5195767195767196,30.771780420213943
Task_25768,1580,686,160,105,265,2.2998544395924307,34.85838744951402
Task_25769,1844,797,41,94,135,2.31077694235589,38.54165487673537
Task_25770,2342,819,35,48,83,2.8560975609756096,45.22229558818708
Task_25771,1682,1013,12,124,136,1.6587771203155819,36.6465422889497
Task_25772,1109,683,185,44,229,1.621345029239766,26.44658215166788
Task_25773,2853,467,10,100,110,6.096153846153846,53.25431351434502
Task_25774,2584,555,18,37,55,4.64748201438849,47.81529232421058
Task_25775,2228,619,178,110,288,3.5935483870967744,45.02203324702606
Task_25776,2365,325,80,155,235,7.254601226993865,46.187795535393235
Task_25777,1929,793,148,85,233,2.429471032745592,40.27320292797898
Task_25778,833,262,147,167,314,3.167300380228137,22.002987187120567
Task_25779,732,849,190,26,216,0.8611764705882353,20.94659917558174
Task_25780,2574,103,144,72,216,24.75,47.16355749990421
Task_25781,2432,558,83,89,172,4.350626118067979,47.29724175760558
Task_25782,2313,511,181,33,214,4.517578125,44.90663259639873
Task_25783,1324,966,155,105,260,1.3691830403309204,31.589395258691535
Task_25784,1476,648,52,118,170,2.274268104776579,32.66468607612287
Task_25785,2912,662,15,35,50,4.392156862745098,53.38872856822078
Task_25786,656,681,92,166,258,0.9618768328445748,20.22029627416967
Task_25787,1447,141,180,31,211,10.190140845070422,29.707654733981812
Task_25788,536,818,99,147,246,0.6544566544566545,18.772183408792294
Task_25789,2792,605,159,181,340,4.6072607260726075,54.24806656495408
Task_25790,1534,192,48,24,72,7.948186528497409,30.215377664114484
Task_25791,1213,308,142,119,261,3.925566343042071,27.851134373424035
Task_25792,1191,667,140,45,185,1.782934131736527,27.30655981678859
Task_25793,2204,547,117,83,200,4.021897810218978,43.6835928601657
Task_25794,2746,660,72,102,174,4.154311649016641,52.891794358848735
Task_25795,2538,468,34,73,107,5.411513859275053,47.952574085403675
Task_25796,1006,268,30,173,203,3.7397769516728623,24.306156464472007
Task_25797,1332,275,137,44,181,4.826086956521739,28.266554394559197
Task_25798,2716,282,10,46,56,9.597173144876326,49.00696387040576
Task_25799,1610,878,14,155,169,1.8316268486916951,35.43059380605266
Task_25800,2820,472,91,30,121,5.961945031712474,52.07112522207519
Task_25801,933,206,191,75,266,4.507246376811594,22.680506158008054
Task_25802,632,221,40,70,110,2.8468468468468466,16.956389671346006
Task_25803,1963,469,43,152,195,4.176595744680851,40.00395403855623
Task_25804,751,551,19,158,177,1.3605072463768115,20.71321002722662
Task_25805,1971,265,157,82,239,7.409774436090226,39.25131358189916
Task_25806,2696,719,41,45,86,3.7444444444444445,50.44678286644259
Task_25807,1687,679,25,49,74,2.4808823529411765,34.0204306065832
Task_25808,622,324,94,196,290,1.9138461538461538,18.88448562029886
Task_25809,996,889,195,46,241,1.1191011235955055,25.269240580198698
Task_25810,2706,538,36,157,193,5.020408163265306,51.982498480920874
Task_25811,2085,499,26,39,65,4.17,39.605580707456895
Task_25812,1196,735,179,143,322,1.625,29.22758514902631
Task_25813,1692,156,183,87,270,10.777070063694268,34.40970275142684
Task_25814,1459,168,18,10,28,8.633136094674557,28.307903823682892
Task_25815,1289,399,55,106,161,3.2225,28.72597112670844
Task_25816,1290,259,42,173,215,4.961538461538462,28.79103388339843
Task_25817,1748,185,54,103,157,9.397849462365592,35.054366356936
Task_25818,665,870,147,56,203,0.7634902411021814,20.16228213907284
Task_25819,2608,100,174,61,235,25.821782178217823,47.7667403213454
Task_25820,1622,343,17,57,74,4.715116279069767,32.08833387974497
Task_25821,2977,148,114,73,187,19.97986577181208,53.91094647560433
Task_25822,884,596,37,179,216,1.4807370184254607,23.423233181535682
Task_25823,1191,520,24,51,75,2.285988483685221,25.823851855727238
Task_25824,1503,94,155,128,283,15.821052631578947,30.9820032941158
Task_25825,1314,470,143,95,238,2.789808917197452,29.80239722086389
Task_25826,1673,141,119,65,184,11.78169014084507,33.13780886333972
Task_25827,1236,504,86,86,172,2.4475247524752475,28.08502728428019
Task_25828,1693,453,43,162,205,3.7290748898678414,35.738574252689794
Task_25829,2134,223,111,43,154,9.526785714285714,40.50268146380893
Task_25830,932,674,103,182,285,1.3807407407407408,24.691519886646688
Task_25831,2319,392,135,178,313,5.900763358778626,45.94345381988757
Task_25832,1047,536,112,97,209,1.9497206703910615,25.717210144284223
Task_25833,2534,714,200,94,294,3.5440559440559443,50.117025454936424
Task_25834,1687,586,176,164,340,2.8739352640545146,36.6636401066144
Task_25835,2109,548,65,176,241,3.841530054644809,42.92234641631999
Task_25836,790,65,85,42,127,11.969696969696969,17.517974726831994
Task_25837,986,467,153,92,245,2.106837606837607,24.5555124450072
Task_25838,747,587,170,152,322,1.2704081632653061,21.590173646014396
Task_25839,1505,803,140,129,269,1.8718905472636815,34.08845317134162
Task_25840,1500,626,142,70,212,2.3923444976076556,32.66866097643606
Task_25841,1036,223,17,34,51,4.625,22.2052421330956
Task_25842,2491,252,104,110,214,9.845849802371541,47.63329562525953
Task_25843,1989,225,118,176,294,8.800884955752212,40.060914374265934
Task_25844,1679,753,14,15,29,2.226790450928382,33.68476422052547
Task_25845,1944,312,58,24,82,6.210862619808307,37.14101675498648
Task_25846,2238,954,119,127,246,2.343455497382199,46.0662368035483
Task_25847,1224,826,57,166,223,1.4800483675937122,29.675106528177746
Task_25848,2982,992,110,132,242,3.003021148036254,57.96392252251358
Task_25849,2935,435,61,128,189,6.731651376146789,55.303034338910386
Task_25850,2424,588,106,199,305,4.115449915110356,48.23466617320285
Task_25851,1686,643,137,154,291,2.6180124223602483,36.59160117960791
Task_25852,967,719,126,154,280,1.3430555555555554,25.350050884344583
Task_25853,1463,910,191,91,282,1.605927552140505,33.59881223621017
Task_25854,1074,398,185,14,199,2.691729323308271,24.685736618026848
Task_25855,851,559,139,62,201,1.519642857142857,22.05671391632176
Task_25856,1464,393,73,123,196,3.715736040609137,31.937290448957082
Task_25857,2161,704,10,39,49,3.0652482269503545,41.45721110246851
Task_25858,777,698,194,164,358,1.111587982832618,22.522852013245245
Task_25859,2757,949,104,159,263,2.9021052631578947,54.39837165316197
Task_25860,1398,758,28,151,179,1.841897233201581,31.74266814377162
Task_25861,1870,884,95,54,149,2.1129943502824857,38.837962856526005
Task_25862,2634,93,43,26,69,28.02127659574468,46.33831854394052
Task_25863,1919,759,17,129,146,2.525,39.596430924885766
Task_25864,1673,473,43,46,89,3.529535864978903,33.52254520938606
Task_25865,2423,310,167,29,196,7.790996784565916,45.90869737911996
Task_25866,912,657,13,158,171,1.3860182370820668,23.629421975002344
Task_25867,1949,671,53,75,128,2.900297619047619,39.85147077902972
Task_25868,964,373,193,135,328,2.5775401069518717,24.44785916634756
Task_25869,1578,323,18,144,162,4.87037037037037,32.96453214863385
Task_25870,2886,707,37,140,177,4.076271186440678,55.10834827665375
Task_25871,2362,104,31,70,101,22.495238095238093,42.91981235480849
Task_25872,519,439,182,197,379,1.1795454545454545,17.85264002125088
Task_25873,1290,1022,61,93,154,1.2609970674486803,30.397795161264614
Task_25874,2050,664,173,66,239,3.082706766917293,41.59681613808119
Task_25875,888,630,129,121,250,1.4072900158478605,23.610653685236812
Task_25876,1313,414,113,60,173,3.163855421686747,28.68209312004659
Task_25877,1178,247,108,178,286,4.75,27.29452023746096
Task_25878,1726,888,187,47,234,1.9415073115860517,36.87910017922727
Task_25879,2299,758,22,200,222,3.028985507246377,46.38858373823379
Task_25880,1132,920,30,175,205,1.229098805646037,28.171580080323295
Task_25881,1416,516,91,41,132,2.738878143133462,30.14230680676482
Task_25882,2254,510,110,179,289,4.410958904109589,45.192027378386335
Task_25883,1051,842,194,110,304,1.246737841043891,27.023253840512478
Task_25884,2994,127,186,179,365,23.390625,55.38168041646162
Task_25885,2899,701,19,36,55,4.12962962962963,53.25098479452816
Task_25886,1242,364,78,135,213,3.4027397260273973,28.429439770547294
Task_25887,1283,737,164,98,262,1.7384823848238482,30.27891281189646
Task_25888,2429,301,36,141,177,8.043046357615895,46.53835592369015
Task_25889,1377,377,19,49,68,3.642857142857143,28.168177037692473
Task_25890,2616,431,15,72,87,6.055555555555555,48.77188086053755
Task_25891,1446,456,147,39,186,3.164113785557987,30.704738926243106
Task_25892,2516,150,146,194,340,16.662251655629138,47.99070552859995
Task_25893,960,833,88,99,187,1.1510791366906474,24.992948417180273
Task_25894,1423,691,106,181,287,2.05635838150289,32.59770685683494
Task_25895,2085,666,60,148,208,3.125937031484258,42.72869082106818
Task_25896,1772,565,38,27,65,3.1307420494699647,34.89286351985532
Task_25897,1151,374,172,186,358,3.0693333333333332,27.61950277679414
Task_25898,2622,676,187,176,363,3.8729689807976366,51.87764518805839
Task_25899,1592,709,126,30,156,2.2422535211267607,33.58310514174699
Task_25900,1207,823,44,143,187,1.4648058252427185,28.94020980403541
Task_25901,2806,115,146,162,308,24.189655172413794,51.99361717366818
Task_25902,818,792,129,92,221,1.0315258511979823,22.666332423584837
Task_25903,948,470,95,175,270,2.0127388535031847,24.368623830512306
Task_25904,684,1018,200,96,296,0.6712463199214916,21.910894841183886
Task_25905,2219,483,192,49,241,4.5847107438016526,43.52005927921224
Task_25906,1706,273,160,118,278,6.226277372262774,35.60277150081682
Task_25907,2223,315,57,139,196,7.034810126582278,43.74014461341209
Task_25908,906,196,179,129,308,4.598984771573604,22.80724190934914
Task_25909,1193,416,29,37,66,2.8609112709832134,25.31180215130549
Task_25910,2126,766,93,51,144,2.771838331160365,42.54574804572135
Task_25911,1893,180,197,84,281,10.458563535911603,37.62241605354151
Task_25912,1132,452,41,32,73,2.498896247240618,24.43827236255891
Task_25913,2298,445,126,100,226,5.1524663677130045,45.27866029528219
Task_25914,2022,162,45,26,71,12.404907975460123,37.52268618178185
Task_25915,1258,811,66,121,187,1.5492610837438423,29.864941624579377
Task_25916,1472,332,130,47,177,4.42042042042042,30.66210073107686
Task_25917,2192,153,96,11,107,14.233766233766234,40.49959053987681
Task_25918,2731,815,133,45,178,3.346813725490196,52.0969254409309
Task_25919,2477,97,148,61,209,25.275510204081634,45.452110011058245
Task_25920,2370,1024,46,162,208,2.3121951219512193,48.29023817678433
Task_25921,2201,724,72,200,272,3.035862068965517,45.11223766949443
Task_25922,2358,570,100,109,209,4.129597197898423,46.56753338976932
Task_25923,2525,1019,76,96,172,2.4754901960784315,50.541724930615175
Task_25924,2596,696,12,192,204,3.7245337159253946,50.83789665619714
Task_25925,1536,286,159,18,177,5.351916376306621,31.249037984208233
Task_25926,2679,421,73,85,158,6.348341232227488,50.50707141646064
Task_25927,1094,811,164,170,334,1.3472906403940887,27.91433213909883
Task_25928,863,543,167,59,226,1.5863970588235294,22.271387909903027
Task_25929,2328,352,100,122,222,6.594900849858357,45.4600391597215
Task_25930,803,291,138,128,266,2.75,21.349352555836628
Task_25931,2230,249,81,127,208,8.92,43.60002160683703
Task_25932,2434,119,196,188,384,20.283333333333335,46.62606349036259
Task_25933,1876,791,117,86,203,2.3686868686868685,39.30423269501903
Task_25934,2596,125,195,151,346,20.603174603174605,48.994762729653566
Task_25935,751,448,35,133,168,1.6726057906458798,20.421381398570087
Task_25936,761,363,47,92,139,2.090659340659341,19.995648485970005
Task_25937,1286,983,157,149,306,1.306910569105691,31.30617584665501
Task_25938,1044,889,196,65,261,1.1730337078651685,26.490380825890398
Task_25939,694,270,19,186,205,2.5608856088560885,19.34925158140473
Task_25940,573,414,131,137,268,1.380722891566265,18.054586654335083
Task_25941,893,759,109,194,303,1.175,24.422592361019113
Task_25942,1557,995,178,137,315,1.5632530120481927,35.684991551554454
Task_25943,1878,510,22,128,150,3.675146771037182,38.16636918222972
Task_25944,2454,344,25,199,224,7.113043478260869,47.59644836379284
Task_25945,1635,259,64,63,127,6.288461538461538,33.109996984970685
Task_25946,2414,203,185,140,325,11.833333333333334,46.77413522226775
Task_25947,1826,226,99,50,149,8.044052863436123,35.74540818798214
Task_25948,2789,953,108,129,237,2.9234800838574424,54.75678487450642
Task_25949,2798,335,74,148,222,8.327380952380953,53.00591427011451
Task_25950,2368,652,35,155,190,3.6263399693721285,46.98616308260986
Task_25951,1612,906,44,104,148,1.7772877618522602,35.20720924533907
Task_25952,1674,344,39,193,232,4.852173913043479,35.25019184590878
Task_25953,2765,665,44,22,66,4.151651651651652,50.92155594861302
Task_25954,1066,764,184,62,246,1.3934640522875816,26.288990997413748
Task_25955,2877,517,61,32,93,5.554054054054054,52.71192278853874
Task_25956,2628,875,54,163,217,3.0,52.08059359727823
Task_25957,714,95,106,176,282,7.4375,18.667202792453903
Task_25958,1823,553,35,139,174,3.2906137184115525,37.895848542105895
Task_25959,2106,81,200,200,400,25.682926829268293,41.036397170279464
Task_25960,1697,477,20,198,218,3.5502092050209204,35.95683310467616
Task_25961,899,273,190,188,378,3.281021897810219,23.4012055677249
Task_25962,2411,512,108,13,121,4.699805068226121,45.51883913930855
Task_25963,1908,580,80,166,246,3.2839931153184163,39.85096221146025
Task_25964,2324,420,89,136,225,5.520190023752969,45.69648395090908
Task_25965,2434,298,49,108,157,8.14046822742475,46.47690685127731
Task_25966,890,812,150,175,325,1.0947109471094711,24.548115518544005
Task_25967,2835,423,179,31,210,6.686320754716981,52.86192524088745
Task_25968,1069,522,104,166,270,2.043977055449331,26.364123540184575
Task_25969,1237,697,50,168,218,1.7722063037249283,29.516166027897764
Task_25970,2178,996,27,43,70,2.184553660982949,42.7250416293605
Task_25971,555,92,13,106,119,5.967741935483871,14.885515306259835
Task_25972,505,881,155,55,210,0.572562358276644,17.876291778954826
Task_25973,2056,763,93,120,213,2.6910994764397906,42.53929385989708
Task_25974,2324,352,30,60,90,6.5835694050991505,43.67820294227337
Task_25975,1894,239,11,18,29,7.891666666666667,35.312269613073134
Task_25976,1934,81,21,174,195,23.585365853658537,37.372868987146795
Task_25977,2211,184,60,45,105,11.95135135135135,40.93763939966646
Task_25978,1220,165,113,78,191,7.349397590361446,26.55909671553626
Task_25979,2020,790,116,113,229,2.553729456384324,42.003327976299
Task_25980,1728,410,54,86,140,4.204379562043796,35.41853665568808
Task_25981,2496,730,19,123,142,3.414500683994528,48.65708133028078
Task_25982,740,118,122,179,301,6.218487394957983,19.574251565075333
Task_25983,1331,766,106,127,233,1.7353324641460235,31.03807739937659
Task_25984,1408,832,77,139,216,1.6902761104441777,32.530077826694736
Task_25985,1872,500,125,98,223,3.7365269461077846,38.69940024812775
Task_25986,1477,559,115,113,228,2.6375,32.673591497562406
Task_25987,1820,456,65,162,227,3.982494529540481,37.969224409243694
Task_25988,2830,414,59,143,202,6.819277108433735,53.70559265159195
Task_25989,1382,107,41,105,146,12.796296296296296,28.100480388970436
Task_25990,2623,529,91,133,224,4.949056603773585,50.78422088734862
Task_25991,1446,414,158,69,227,3.4843373493975904,31.183315974628243
Task_25992,1024,759,111,35,146,1.3473684210526315,24.77034680154532
Task_25993,1429,390,153,184,337,3.6547314578005117,31.971763378670882
Task_25994,644,283,91,48,139,2.267605633802817,17.16581662658575
Task_25995,1301,807,81,156,237,1.6101485148514851,30.854478170767425
Task_25996,1100,382,95,15,110,2.8720626631853787,24.37642836158675
Task_25997,2839,796,82,102,184,3.562107904642409,54.69311598336649
Task_25998,1277,177,71,148,219,7.174157303370786,27.953541214082133
Task_25999,1620,398,154,178,332,4.06015037593985,34.988442489044836
Task_26000,1752,311,138,53,191,5.615384615384615,35.5641175472193
Task_26001,883,707,11,75,86,1.247175141242938,22.168097180558032
Task_26002,533,758,185,154,339,0.7022397891963109,18.93463114413442
Task_26003,1393,880,123,34,157,1.5811577752553916,30.94988498571614
Task_26004,1762,946,32,95,127,1.8606124604012673,37.718484563521066
Task_26005,2625,1022,10,103,113,2.565982404692082,51.54421995056509
Task_26006,1713,772,143,18,161,2.216041397153946,35.44536733457708
Task_26007,2642,538,160,153,313,4.901669758812616,51.49522538064637
Task_26008,2070,641,130,145,275,3.2242990654205608,42.58190300744394
Task_26009,1813,703,138,73,211,2.575284090909091,37.90520381305274
Task_26010,1621,1000,110,10,120,1.6193806193806193,34.51381688389164
Task_26011,1626,748,174,82,256,2.170894526034713,35.42319547472794
Task_26012,2267,983,193,44,237,2.303861788617886,45.74645640369022
Task_26013,1669,746,11,111,122,2.2342704149933064,35.554395190451075
Task_26014,2983,623,98,151,249,4.780448717948718,56.89027937538216
Task_26015,531,103,35,120,155,5.105769230769231,14.7950239299738
Task_26016,1614,164,79,174,253,9.781818181818181,33.56870256315431
Task_26017,2283,749,45,150,195,3.044,45.94257998397108
Task_26018,1280,827,199,31,230,1.5458937198067633,29.60296084832908
Task_26019,1901,596,72,11,83,3.184254606365159,37.40547590865955
Task_26020,918,284,26,79,105,3.221052631578947,21.737465494885928
Task_26021,2984,507,177,182,359,5.874015748031496,57.05948203642995
Task_26022,2953,461,154,156,310,6.391774891774892,56.15915463891863
Task_26023,1877,833,187,175,362,2.2505995203836933,40.56229339747622
Task_26024,2893,971,82,179,261,2.9763374485596708,56.734921076683264
Task_26025,1379,70,156,177,333,19.422535211267604,29.23916484495619
Task_26026,727,896,193,185,378,0.810479375696767,22.555083786557727
Task_26027,2008,210,40,188,228,9.516587677725118,40.03745281321742
Task_26028,2305,805,160,53,213,2.859801488833747,45.998035653976736
Task_26029,1949,716,55,12,67,2.7182705718270572,37.93693599268026
Task_26030,518,733,178,182,360,0.7057220708446866,18.75544245553665
Task_26031,672,316,29,163,192,2.1198738170347005,19.11687926337592
Task_26032,1063,747,33,105,138,1.4211229946524064,25.899976471890582
Task_26033,874,800,48,80,128,1.0911360799001248,23.126466882608412
Task_26034,637,509,79,120,199,1.2490196078431373,19.096277017832744
Task_26035,1403,70,181,171,352,19.760563380281692,29.69138815118646
Task_26036,2042,230,117,48,165,8.83982683982684,39.398037487085524
Task_26037,2485,155,37,57,94,15.929487179487179,45.27080916926021
Task_26038,2766,658,40,163,203,4.197268588770865,53.373654604146886
Task_26039,1650,794,131,146,277,2.0754716981132075,36.41864776700381
Task_26040,1773,898,89,200,289,1.9721913236929922,38.864285038984264
Task_26041,1524,430,30,197,227,3.5359628770301623,33.167852859960476
Task_26042,2954,425,54,13,67,6.934272300469484,52.913362297450135
Task_26043,1744,448,52,104,156,3.884187082405345,36.058002947129
Task_26044,841,945,57,18,75,0.8890063424947146,21.211983226947645
Task_26045,1595,367,133,156,289,4.334239130434782,34.26616570397528
Task_26046,2058,135,58,75,133,15.132352941176471,39.04351530997013
Task_26047,2638,735,140,19,159,3.5842391304347827,49.993723854488714
Task_26048,2078,664,45,182,227,3.124812030075188,42.61916235686347
Task_26049,1491,881,136,29,165,1.6904761904761905,32.765902612781765
Task_26050,1404,491,105,149,254,2.8536585365853657,31.473032405487576
Task_26051,2165,84,149,102,251,25.470588235294116,41.179511163505865
Task_26052,2901,1022,104,30,134,2.835777126099707,55.25542102071979
Task_26053,2290,873,140,194,334,2.620137299771167,47.13247169071764
Task_26054,586,795,132,27,159,0.7361809045226131,17.913881337238866
Task_26055,893,396,55,131,186,2.2493702770780857,22.780376107613023
Task_26056,1914,668,24,188,212,2.8609865470852016,40.01803662487073
Task_26057,1894,261,41,99,140,7.229007633587786,37.57148094229429
Task_26058,691,689,177,49,226,1.0014492753623188,19.82499387374344
Task_26059,2322,985,142,166,308,2.3549695740365113,47.830475005085
Task_26060,1090,610,153,97,250,1.7839607201309329,26.800864774112814
Task_26061,2400,223,162,42,204,10.714285714285714,45.245958104157715
Task_26062,2347,613,159,98,257,3.8224755700325734,46.733628113141556
Task_26063,972,562,121,141,262,1.7264653641207814,24.86732084551117
Task_26064,1147,229,134,199,333,4.98695652173913,26.986301720782933
Task_26065,1992,489,96,164,260,4.0653061224489795,40.87699680346786
Task_26066,1888,950,89,192,281,1.9852786540483702,40.80043661614308
Task_26067,679,684,73,168,241,0.9912408759124087,20.56813406794356
Task_26068,1472,851,138,141,279,1.727699530516432,33.76410795871565
Task_26069,1746,262,157,124,281,6.638783269961977,36.21927449238932
Task_26070,2558,105,74,38,112,24.132075471698112,45.80171009534536
Task_26071,1569,273,182,31,213,5.726277372262774,32.34697715152005
Task_26072,2178,69,175,147,322,31.114285714285714,41.632808321244276
Task_26073,1497,178,141,192,333,8.363128491620111,31.929320106326774
Task_26074,1509,909,85,39,124,1.6582417582417583,32.61520698065383
Task_26075,559,1022,118,39,157,0.5464320625610948,18.444705970962357
Task_26076,2138,156,35,198,233,13.617834394904458,41.63786378606097
Task_26077,2716,324,196,71,267,8.356923076923078,51.19318635546364
Task_26078,2034,323,130,24,154,6.277777777777778,39.23577578807748
Task_26079,1385,438,84,133,217,3.154897494305239,30.861001184655574
Task_26080,621,378,115,155,270,1.6385224274406331,18.791571752527577
Task_26081,2507,819,28,49,77,3.0573170731707315,47.417868225364536
Task_26082,1792,998,37,14,51,1.7937937937937938,36.373245813573355
Task_26083,1442,450,119,136,255,3.197339246119734,31.929764267118813
Task_26084,1347,209,98,119,217,6.414285714285715,29.44869551755514
Task_26085,1691,610,181,61,242,2.76759410801964,35.681023977473835
Task_26086,1476,799,60,168,228,1.845,33.616922227172324
Task_26087,1495,74,20,79,99,19.933333333333334,29.075833224518046
Task_26088,1556,216,18,114,132,7.170506912442396,32.1017035874627
Task_26089,1078,512,177,129,306,2.101364522417154,26.583246771943447
Task_26090,2152,748,102,130,232,2.8731642189586113,44.001457831490065
Task_26091,517,719,97,146,243,0.7180555555555556,18.142480449475183
Task_26092,2493,512,63,197,260,4.859649122807017,49.00598513366062
Task_26093,1384,631,100,177,277,2.189873417721519,31.741496335264557
Task_26094,735,918,177,102,279,0.7997823721436343,22.201361560549042
Task_26095,1708,363,10,192,202,4.6923076923076925,35.70338421128325
Task_26096,1320,553,24,137,161,2.3826714801444044,29.64221929694311
Task_26097,923,150,101,27,128,6.112582781456954,20.840275077490567
Task_26098,1846,891,163,140,303,2.069506726457399,39.93455043905
Task_26099,1984,816,121,40,161,2.4283965728274173,40.12657063414887
Task_26100,889,1002,48,162,210,0.8863409770687937,24.68797616648214
Task_26101,1519,742,137,122,259,2.0444145356662182,34.06488227414548
Task_26102,2987,127,40,78,118,23.3359375,53.301923785400454
Task_26103,943,160,121,23,144,5.857142857142857,21.14104199803571
Task_26104,2405,309,103,104,207,7.758064516129032,46.436923315996374
Task_26105,1736,521,110,56,166,3.3256704980842913,35.72763007896551
Task_26106,1306,214,60,164,224,6.074418604651163,29.03064018597755
Task_26107,1630,976,174,24,198,1.668372569089048,35.401403250941186
Task_26108,2366,849,88,180,268,2.783529411764706,47.96329045107217
Task_26109,2921,611,154,92,246,4.772875816993464,55.655370733412376
Task_26110,1364,826,38,113,151,1.649334945586457,31.036435993467872
Task_26111,1608,111,67,104,171,14.357142857142858,32.102999139540564
Task_26112,1380,525,78,185,263,2.623574144486692,31.4245630084671
Task_26113,2141,634,93,146,239,3.3716535433070867,43.63548066457965
Task_26114,2188,535,185,172,357,4.082089552238806,44.523367389929966
Task_26115,1633,553,196,13,209,2.9476534296028882,34.091012278868654
Task_26116,1172,464,105,80,185,2.520430107526882,26.86736270481587
Task_26117,2470,301,167,28,195,8.178807947019868,46.569322607950824
Task_26118,531,471,19,104,123,1.125,16.445535760959235
Task_26119,2970,148,55,64,119,19.93288590604027,53.19867490394639
Task_26120,2417,193,180,175,355,12.458762886597938,46.97303703177089
Task_26121,2283,270,159,193,352,8.424354243542435,45.15522238834772
Task_26122,1098,618,162,68,230,1.7738287560581583,26.350308814764816
Task_26123,626,149,191,192,383,4.173333333333333,18.404091177630505
Task_26124,2219,920,194,29,223,2.409337676438654,44.755128873943114
Task_26125,1439,1004,118,77,195,1.4318407960199004,32.841833411239115
Task_26126,693,689,128,162,290,1.0043478260869565,20.86734045078894
Task_26127,1047,960,111,13,124,1.0894901144640998,25.39035686955255
Task_26128,1356,758,98,82,180,1.7865612648221343,30.662123321484255
Task_26129,1045,287,119,124,243,3.6284722222222223,25.05248443309487
Task_26130,2010,709,148,182,330,2.8309859154929575,42.147585596742445
Task_26131,1542,490,17,69,86,3.140529531568228,31.846584136621043
Task_26132,2618,650,120,175,295,4.021505376344086,51.42394775686309
Task_26133,2203,653,195,169,364,3.3685015290519877,45.162597019283304
Task_26134,1546,785,72,141,213,1.9669211195928753,34.574148308236815
Task_26135,2499,209,111,166,277,11.9,47.96164799186666
Task_26136,2851,347,32,128,160,8.192528735632184,53.172447359373656
Task_26137,2879,782,104,134,238,3.676883780332056,55.65850981592458
Task_26138,2371,291,49,200,249,8.11986301369863,46.32735282976501
Task_26139,2163,584,197,83,280,3.6974358974358976,43.51268407690399
Task_26140,2546,191,175,41,216,13.260416666666666,47.57145041372229
Task_26141,837,126,101,58,159,6.590551181102362,19.594393537897208
Task_26142,1179,626,19,172,191,1.8803827751196172,28.06464315253197
Task_26143,2505,746,163,190,353,3.353413654618474,50.22061325054634
Task_26144,576,363,25,160,185,1.5824175824175823,17.553296251479704
Task_26145,1776,715,53,134,187,2.4804469273743015,37.87728729465557
Task_26146,2921,1011,119,170,289,2.8863636363636362,57.32409964548177
Task_26147,972,485,133,89,222,2.0,24.195623610036808
Task_26148,2928,512,30,99,129,5.707602339181286,54.86938937582619
Task_26149,587,754,173,161,334,0.7774834437086092,19.680472010057716
Task_26150,2406,792,188,135,323,3.034047919293821,48.58086058461254
Task_26151,1670,596,20,119,139,2.797319932998325,35.10752540096985
Task_26152,508,840,140,28,168,0.6040428061831153,17.26695903916368
Task_26153,2381,705,11,88,99,3.3725212464589234,46.156840267971575
Task_26154,1171,156,135,14,149,7.45859872611465,24.724403728628275
Task_26155,730,290,166,168,334,2.508591065292096,20.55721209633568
Task_26156,2423,1013,28,118,146,2.3895463510848125,48.46161418075126
Task_26157,1223,837,106,138,244,1.4594272076372314,29.558392154651404
Task_26158,1537,89,185,22,207,17.07777777777778,30.384840143697602
Task_26159,1925,590,113,19,132,3.257191201353638,38.196972320809174
Task_26160,2253,424,83,61,144,5.301176470588235,43.33392402911725
Task_26161,701,1002,55,37,92,0.6989032901296112,20.28166599562149
Task_26162,1098,90,172,128,300,12.065934065934066,24.782519989333625
Task_26163,2311,1021,47,39,86,2.261252446183953,45.30737751834976
Task_26164,1244,719,14,67,81,1.7277777777777779,27.900688636451346
Task_26165,1767,487,192,21,213,3.6209016393442623,36.058685820673794
Task_26166,2115,627,133,22,155,3.3678343949044587,41.52129146020126
Task_26167,1419,996,193,137,330,1.423269809428285,33.54320055867961
Task_26168,965,330,41,189,230,2.915407854984894,23.97604601717971
Task_26169,1979,496,94,22,116,3.9818913480885314,38.795624205035125
Task_26170,1523,381,124,47,171,3.986910994764398,31.57868659707402
Task_26171,1300,618,60,20,80,2.10016155088853,27.648244419368293
Task_26172,1788,840,11,34,45,2.126040428061831,35.963767730861896
Task_26173,1601,897,142,74,216,1.7828507795100224,35.21662827078165
Task_26174,1055,545,195,57,252,1.9322344322344323,25.473761317870412
Task_26175,937,718,166,12,178,1.3031988873435327,23.256697215497265
Task_26176,2317,696,108,50,158,3.3242467718794835,45.07146444807558
Task_26177,667,285,130,27,157,2.332167832167832,17.544245318011413
Task_26178,670,564,133,79,212,1.1858407079646018,19.474090240301994
Task_26179,2340,626,124,117,241,3.7320574162679425,46.61644017086877
Task_26180,1069,509,152,170,322,2.096078431372549,26.563553653830855
Task_26181,2461,774,96,117,213,3.1754838709677418,48.926416035796244
Task_26182,2266,81,146,35,181,27.634146341463413,41.46994634332662
Task_26183,1811,885,163,114,277,2.044018058690745,39.206005020849496
Task_26184,542,975,64,10,74,0.555327868852459,16.661947873853457
Task_26185,2552,450,98,128,226,5.658536585365853,49.370171223416015
Task_26186,1935,373,140,82,222,5.17379679144385,38.97098494015889
Task_26187,1226,310,75,189,264,3.942122186495177,28.315433551442286
Task_26188,2491,120,51,22,73,20.58677685950413,44.413273860127525
Task_26189,1298,278,141,80,221,4.652329749103942,28.573081715127756
Task_26190,2675,128,159,22,181,20.73643410852713,48.48072518728509
Task_26191,2821,863,86,97,183,3.2650462962962963,54.593977843273244
Task_26192,2034,293,66,112,178,6.918367346938775,40.33776704435337
Task_26193,1490,256,67,133,200,5.797665369649805,31.923533225886477
Task_26194,836,361,20,135,155,2.3093922651933703,21.271447387939286
Task_26195,2270,545,30,153,183,4.157509157509158,44.903856042434235
Task_26196,1919,457,170,197,367,4.189956331877729,40.096417647644536
Task_26197,1524,795,98,166,264,1.914572864321608,34.41018556547729
Task_26198,726,364,72,138,210,1.989041095890411,20.253650383265153
Task_26199,1129,352,53,93,146,3.198300283286119,25.967320109077637
Task_26200,2035,519,192,95,287,3.9134615384615383,41.59330714060468
Task_26201,787,694,123,120,243,1.1323741007194246,22.15578327764291
Task_26202,652,97,91,197,288,6.653061224489796,17.73055977027192
Task_26203,895,431,117,55,172,2.071759259259259,22.21075928316201
Task_26204,573,201,191,157,348,2.8366336633663365,17.834852433432705
Task_26205,2644,996,192,85,277,2.6519558676028083,52.43420611815711
Task_26206,2304,774,68,175,243,2.972903225806452,46.72875063702347
Task_26207,2202,652,55,193,248,3.3721286370597245,44.81464075514219
Task_26208,1857,761,180,33,213,2.437007874015748,38.47031737854174
Task_26209,1699,672,59,193,252,2.524517087667162,36.92452636651152
Task_26210,1766,917,143,100,243,1.9237472766884531,38.41872490102143
Task_26211,1509,156,84,84,168,9.611464968152866,30.841542818868774
Task_26212,2246,1011,103,194,297,2.219367588932806,46.69846799732716
Task_26213,750,963,34,146,180,0.7780082987551867,21.92712175598722
Task_26214,1591,971,91,38,129,1.6368312757201646,34.37527636992983
Task_26215,1225,845,136,173,309,1.4479905437352245,29.95916701386524
Task_26216,1698,275,151,97,248,6.1521739130434785,35.35079661262301
Task_26217,1560,470,19,166,185,3.3121019108280256,33.443903193237475
Task_26218,2174,959,167,99,266,2.2645833333333334,45.101936808391706
Task_26219,619,316,96,151,247,1.9526813880126184,18.520974248137033
Task_26220,2318,204,25,13,38,11.307317073170731,41.95485984615555
Task_26221,2409,357,164,52,216,6.729050279329609,46.21631184208721
Task_26222,1890,879,21,91,112,2.147727272727273,39.24223647587119
Task_26223,1038,248,190,56,246,4.168674698795181,24.300951078187026
Task_26224,1517,549,200,56,256,2.7581818181818183,32.89220272914889
Task_26225,1536,653,175,171,346,2.3486238532110093,34.51999001483844
Task_26226,1724,258,68,67,135,6.656370656370656,34.62074095047808
Task_26227,2694,973,27,147,174,2.7659137577002055,53.0355128201881
Task_26228,1109,899,189,161,350,1.2322222222222223,28.40090877243686
Task_26229,1922,327,150,163,313,5.859756097560975,39.424687206353404
Task_26230,1368,772,179,110,289,1.7697283311772316,31.87038648680196
Task_26231,1580,265,14,186,200,5.93984962406015,33.37451387026233
Task_26232,2464,112,37,108,145,21.805309734513273,45.14083820334658
Task_26233,1533,130,156,105,261,11.702290076335878,31.835136210303602
Task_26234,2506,260,91,66,157,9.601532567049809,46.830588895935385
Task_26235,1296,650,182,198,380,1.9907834101382489,30.902151928877355
Task_26236,1534,874,119,17,136,1.7531428571428571,32.863706858934584
Task_26237,1971,582,82,96,178,3.3807890222984565,40.26308896892954
Task_26238,1247,747,177,10,187,1.6671122994652405,28.438380317411074
Task_26239,811,926,157,150,307,0.8748651564185544,23.599864486439614
Task_26240,1392,244,100,186,286,5.681632653061224,30.676986251741443
Task_26241,2189,355,167,60,227,6.148876404494382,42.679131421375
Task_26242,2961,420,164,199,363,7.033254156769596,56.45177240787363
Task_26243,2956,863,86,78,164,3.4212962962962963,56.36653564647104
Task_26244,1080,771,110,99,209,1.3989637305699483,26.85823595505917
Task_26245,2632,531,107,115,222,4.947368421052632,50.84850290711097
Task_26246,1440,572,102,139,241,2.513089005235602,32.22531358126759
Task_26247,2167,996,144,141,285,2.1735205616850553,45.26812190416613
Task_26248,923,277,66,168,234,3.320143884892086,23.237906840875286
Task_26249,1541,393,128,196,324,3.9111675126903553,33.712581619301105
Task_26250,669,486,69,112,181,1.373716632443532,19.30799270253201
Task_26251,1299,729,94,17,111,1.7794520547945205,28.56736869718711
Task_26252,598,733,72,141,213,0.8147138964577657,19.275897307622383
Task_26253,1266,324,59,56,115,3.8953846153846152,27.258074674200568
Task_26254,1119,829,137,190,327,1.3481927710843373,28.364013548049034
Task_26255,998,76,26,31,57,12.96103896103896,20.350303371875786
Task_26256,2596,643,138,29,167,4.031055900621118,49.43534577873854
Task_26257,1286,965,63,126,189,1.3312629399585922,30.80918692202431
Task_26258,1335,184,59,160,219,7.216216216216216,29.191444873143467
Task_26259,1446,741,154,180,334,1.9487870619946093,33.328382189522735
Task_26260,2410,890,169,119,288,2.7048260381593714,48.769685893053385
Task_26261,817,474,48,140,188,1.72,21.889081623813464
Task_26262,1746,592,40,159,199,2.9443507588532882,36.98648302771902
Task_26263,2522,591,137,122,259,4.260135135135135,49.47596690168999
Task_26264,555,205,18,184,202,2.6941747572815533,16.91951934512673
Task_26265,2699,684,91,36,127,3.9401459854014598,50.90600353496296
Task_26266,1462,163,119,74,193,8.914634146341463,30.290193136267508
Task_26267,2133,558,123,79,202,3.815742397137746,42.59809398963698
Task_26268,2740,654,138,96,234,4.183206106870229,53.00182286062813
Task_26269,1449,98,41,171,212,14.636363636363637,29.942812039464737
Task_26270,2509,840,32,29,61,2.9833531510107014,47.487502053591925
Task_26271,1278,724,185,185,370,1.7627586206896553,30.770240699384203
Task_26272,838,384,81,100,181,2.1766233766233767,21.692718286873912
Task_26273,2151,739,36,158,194,2.906756756756757,43.836073447391534
Task_26274,2212,123,145,166,311,17.838709677419356,42.801793721019486
Task_26275,618,902,19,45,64,0.6843853820598007,18.070698439925174
Task_26276,948,731,85,174,259,1.2950819672131149,25.00313163930403
Task_26277,586,348,178,106,284,1.679083094555874,18.134743015971605
Task_26278,737,922,16,32,48,0.7984832069339112,19.802408729900254
Task_26279,2086,530,64,51,115,3.928436911487759,40.77474563084899
Task_26280,1199,572,53,167,220,2.0924956369982546,28.525202884927822
Task_26281,1278,122,194,161,355,10.390243902439025,28.291143216518325
Task_26282,1969,74,118,104,222,26.253333333333334,37.90717538920523
Task_26283,2826,1013,199,177,376,2.78698224852071,56.22722795040784
Task_26284,592,415,66,71,137,1.4230769230769231,17.205366188792336
Task_26285,1333,122,94,173,267,10.83739837398374,28.863469965691106
Task_26286,2236,435,174,109,283,5.128440366972477,44.53488824435417
Task_26287,2501,696,123,64,187,3.588235294117647,48.56338992380302
Task_26288,1524,290,58,21,79,5.237113402061856,30.093545074788427
Task_26289,1777,630,36,110,146,2.8161648177496037,36.99039073163012
Task_26290,2584,164,69,110,179,15.66060606060606,48.19380225556512
Task_26291,1244,960,168,36,204,1.2944849115504682,29.335668245637475
Task_26292,2304,709,107,170,277,3.2450704225352114,46.54825575950358
Task_26293,1758,108,156,110,266,16.128440366972477,35.03544238284173
Task_26294,1569,842,58,168,226,1.8612099644128113,35.24169332523442
Task_26295,1790,611,115,13,128,2.9248366013071894,36.27873975097659
Task_26296,2290,907,135,185,320,2.5220264317180616,47.16228911946146
Task_26297,2315,644,145,87,232,3.5891472868217056,45.938729769051044
Task_26298,1816,760,91,168,259,2.3863337713534825,38.942791484409675
Task_26299,587,361,103,138,241,1.6215469613259668,18.04459718890543
Task_26300,972,1005,69,49,118,0.9662027833001988,24.592469700576114
Task_26301,2574,174,200,102,302,14.708571428571428,48.64539234249264
Task_26302,2279,697,175,99,274,3.2650429799426934,45.982069079861304
Task_26303,1395,983,174,166,340,1.4176829268292683,33.21018307543821
Task_26304,1109,223,96,55,151,4.950892857142857,24.675868320344076
Task_26305,2587,244,145,105,250,10.559183673469388,49.275212078773585
Task_26306,1963,449,37,63,100,4.362222222222222,38.58032877390878
Task_26307,1194,312,91,126,217,3.8146964856230032,27.424999457148346
Task_26308,2261,635,142,124,266,3.5550314465408803,45.51668521226845
Task_26309,679,929,171,83,254,0.7301075268817204,20.970356689966863
Task_26310,2052,907,71,156,227,2.2599118942731278,43.05638837183991
Task_26311,1901,157,78,71,149,12.031645569620252,36.76423460535797
Task_26312,2327,337,151,163,314,6.884615384615385,45.86823543147408
Task_26313,1987,754,96,195,291,2.6317880794701987,41.82040483106682
Task_26314,2182,545,113,26,139,3.9963369963369964,42.27359034426406
Task_26315,2702,806,111,180,291,3.34820322180917,53.236090316531225
Task_26316,923,718,19,110,129,1.2837273991655076,23.596751103943188
Task_26317,1093,500,196,70,266,2.1816367265469063,26.071707139406076
Task_26318,2827,565,143,57,200,4.9946996466431095,53.361517873391584
Task_26319,1527,164,165,169,334,9.254545454545454,32.41784336792407
Task_26320,2197,629,158,196,354,3.4873015873015873,44.986248121551114
Task_26321,2919,295,59,147,206,9.861486486486486,54.727396420738636
Task_26322,2010,577,37,100,137,3.4775086505190314,40.470756957996706
Task_26323,2955,462,164,78,242,6.382289416846652,55.47551073297911
Task_26324,945,236,161,96,257,3.9873417721518987,23.349361735625155
Task_26325,2268,550,95,88,183,4.116152450090744,44.55062100342781
Task_26326,840,529,50,52,102,1.5849056603773586,20.91350804709528
Task_26327,1093,169,27,123,150,6.429411764705883,24.230784452166187
Task_26328,2111,779,85,83,168,2.7064102564102566,42.640181529176374
Task_26329,1226,701,182,80,262,1.7464387464387465,28.953058692688433
Task_26330,1059,165,43,179,222,6.379518072289157,24.58593166583073
Task_26331,2181,710,73,125,198,3.067510548523207,44.30796254167584
Task_26332,2508,373,129,137,266,6.705882352941177,48.59847433290644
Task_26333,2268,681,192,129,321,3.3255131964809386,46.02802637971013
Task_26334,1613,977,147,183,330,1.6492842535787322,36.68092621686051
Task_26335,515,933,173,64,237,0.5513918629550322,18.260280872459532
Task_26336,2400,1019,62,169,231,2.3529411764705883,48.957708977112624
Task_26337,1267,828,134,97,231,1.5283474065138722,30.168115799910783
Task_26338,2424,488,54,86,140,4.957055214723926,46.687059439045726
Task_26339,2413,542,21,91,112,4.443830570902394,46.46589419064065
Task_26340,744,947,138,65,203,0.7848101265822784,21.67465254538463
Task_26341,835,629,167,20,187,1.3253968253968254,21.536901538421244
Task_26342,2384,946,46,105,151,2.5174234424498416,47.59484532521168
Task_26343,1795,243,15,99,114,7.35655737704918,35.9131747706852
Task_26344,1712,134,50,130,180,12.681481481481482,34.23013578647836
Task_26345,593,265,11,174,185,2.2293233082706765,17.52446422061997
Task_26346,2258,546,56,94,150,4.127970749542961,44.419235680634756
Task_26347,2165,575,125,135,260,3.7586805555555554,43.79520918354624
Task_26348,1344,239,28,51,79,5.6,27.485906962267993
Task_26349,2346,250,54,152,206,9.346613545816734,45.519518661056736
Task_26350,1980,989,172,125,297,2.0,42.31361787831987
Task_26351,999,596,141,104,245,1.6733668341708543,25.27015806872552
Task_26352,1933,1007,175,130,305,1.9176587301587302,41.66810783469433
Task_26353,1782,175,125,188,313,10.125,36.31974010340636
Task_26354,566,485,16,179,195,1.1646090534979423,17.800760395574915
Task_26355,1367,407,24,108,132,3.3504901960784315,29.811172660028067
Task_26356,2957,644,172,74,246,4.584496124031007,56.048295001143636
Task_26357,2126,301,168,193,361,7.039735099337748,42.822469392604944
Task_26358,625,374,195,180,375,1.6666666666666667,19.35216745348568
Task_26359,1776,906,124,175,299,1.9581036383682469,38.90532005279698
Task_26360,1202,140,26,118,144,8.52482269503546,25.7350589727628
Task_26361,1387,113,99,125,224,12.166666666666666,29.207172603072266
Task_26362,666,898,51,64,115,0.7408231368186874,19.661023356480037
Task_26363,1561,527,83,121,204,2.956439393939394,33.859806814485545
Task_26364,1403,364,50,51,101,3.8438356164383563,29.340045779700773
Task_26365,1148,739,199,76,275,1.5513513513513513,27.792769123407666
Task_26366,2204,298,86,104,190,7.37123745819398,43.17484650380779
Task_26367,2839,992,92,103,195,2.8590130916414904,55.52098608740525
Task_26368,2472,683,112,30,142,3.6140350877192984,47.37778246493048
Task_26369,1008,150,108,23,131,6.675496688741722,22.06229218698121
Task_26370,2356,914,195,139,334,2.574863387978142,48.22559583299309
Task_26371,1318,940,198,169,367,1.4006376195536663,31.982824805854236
Task_26372,724,586,78,86,164,1.233390119250426,20.16727505707469
Task_26373,1629,729,19,137,156,2.2315068493150685,34.991050459804406
Task_26374,1441,255,172,199,371,5.62890625,31.89107936473917
Task_26375,1984,613,104,130,234,3.231270358306189,40.92470448202017
Task_26376,2639,724,20,123,143,3.64,50.91133070257181
Task_26377,516,574,128,193,321,0.8973913043478261,17.975725779532112
Task_26378,1263,369,19,94,113,3.4135135135135135,27.88294149775578
Task_26379,1958,451,37,126,163,4.331858407079646,39.52139172867586
Task_26380,1034,785,22,60,82,1.3155216284987277,24.527832945491824
Task_26381,979,335,87,103,190,2.9136904761904763,23.89193698858952
Task_26382,1062,997,131,63,194,1.0641282565130261,26.7017764936322
Task_26383,1586,343,95,200,295,4.6104651162790695,34.20691658756204
Task_26384,2253,509,177,70,247,4.41764705882353,44.37936264637225
Task_26385,879,970,74,165,239,0.9052523171987642,24.61055931696389
Task_26386,1892,717,41,23,64,2.635097493036212,37.25433885956009
Task_26387,979,286,17,49,66,3.4111498257839723,21.586314264439796
Task_26388,688,597,90,71,161,1.1505016722408026,19.214957096777255
Task_26389,1642,180,51,170,221,9.07182320441989,33.83061175578385
Task_26390,1343,924,14,173,187,1.451891891891892,31.509665817479473
Task_26391,621,297,190,118,308,2.0838926174496644,18.665905980428082
Task_26392,777,511,56,140,196,1.517578125,21.455290729179463
Task_26393,1627,991,131,50,181,1.6401209677419355,35.27465316069447
Task_26394,1867,958,44,54,98,1.9468196037539103,38.468395765981626
Task_26395,768,381,47,199,246,2.0104712041884816,21.146900910099763
Task_26396,2772,549,34,119,153,5.04,52.500462954710656
Task_26397,1818,67,148,10,158,26.735294117647058,33.85145087132488
Task_26398,2160,80,13,144,157,26.666666666666668,40.297955754624816
Task_26399,687,697,64,170,234,0.9842406876790831,20.693830396191437
Task_26400,2426,167,37,170,207,14.44047619047619,46.07387193783013
Task_26401,2959,446,64,159,223,6.619686800894854,55.94488179150674
Task_26402,2349,718,53,194,247,3.267037552155772,47.359181728314105
Task_26403,2555,211,190,51,241,12.05188679245283,48.056480169267296
Task_26404,905,596,60,186,246,1.5159128978224456,24.0092585876918
Task_26405,2061,852,179,36,215,2.4161781946072685,41.9952995562833
Task_26406,2423,192,192,31,223,12.55440414507772,45.687212130272066
Task_26407,1003,611,60,64,124,1.6388888888888888,24.203631532056022
Task_26408,2561,1022,53,199,252,2.5034213098729228,51.69890884509838
Task_26409,2454,876,77,161,238,2.798175598631699,49.38524477509993
Task_26410,2161,874,159,83,242,2.4697142857142858,44.22089562793557
Task_26411,622,454,159,103,262,1.367032967032967,18.885223377407005
Task_26412,1864,781,87,14,101,2.3836317135549874,37.526730072912116
Task_26413,2750,634,166,33,199,4.330708661417323,52.152278581620855
Task_26414,1998,782,169,80,249,2.5517241379310347,41.386311751820955
Task_26415,2459,718,140,156,296,3.420027816411683,49.097021428004155
Task_26416,2158,134,38,23,61,15.985185185185186,39.20990871126437
Task_26417,1437,89,130,140,270,15.966666666666667,29.977887828484622
Task_26418,598,1024,96,92,188,0.5834146341463414,20.030013867686957
Task_26419,1771,71,167,139,306,24.59722222222222,35.20157890547841
Task_26420,2516,929,194,137,331,2.7053763440860217,50.79126303681998
Task_26421,2450,503,152,109,261,4.861111111111111,48.0437045048256
Task_26422,1044,407,56,156,212,2.5588235294117645,25.488381724601144
Task_26423,622,522,105,83,188,1.1892925430210326,18.405703739670017
Task_26424,2846,810,198,82,280,3.5092478421701605,55.05355237371299
Task_26425,949,780,113,170,283,1.2151088348271446,25.208377688326312
Task_26426,1434,685,133,154,287,2.0903790087463556,32.71362985211035
Task_26427,2531,148,50,71,121,16.986577181208055,46.387345146231326
Task_26428,1069,637,85,86,171,1.6755485893416928,25.72806680952294
Task_26429,2143,969,192,185,377,2.209278350515464,45.28296534472298
Task_26430,1797,310,159,66,225,5.778135048231511,36.38929404670281
Task_26431,2785,638,137,31,168,4.358372456964006,52.37685939327238
Task_26432,2488,779,197,65,262,3.18974358974359,49.02160330585184
Task_26433,2371,853,140,79,219,2.7763466042154565,47.373671620964394
Task_26434,603,499,181,73,254,1.206,18.29349057679248
Task_26435,1642,745,62,24,86,2.201072386058981,33.72736803381239
Task_26436,2653,504,197,174,371,5.253465346534654,51.851806008860876
Task_26437,2839,475,115,102,217,5.964285714285714,53.90226957266026
Task_26438,2799,238,37,53,90,11.711297071129707,50.843886589671406
Task_26439,1495,76,35,182,217,19.415584415584416,30.61518823331839
Task_26440,1373,428,94,145,239,3.2004662004662006,30.792394204973817
Task_26441,2653,540,112,146,258,4.903881700554528,51.417681959828634
Task_26442,2601,965,186,76,262,2.6925465838509317,51.48867936592129
Task_26443,2770,133,66,164,230,20.671641791044777,51.39023423964528
Task_26444,1691,925,176,188,364,1.826133909287257,37.929511462134045
Task_26445,1577,122,145,77,222,12.821138211382113,31.93151836459137
Task_26446,562,832,38,96,134,0.6746698679471789,18.405752744621516
Task_26447,2090,628,110,81,191,3.3227344992050876,42.06010700131606
Task_26448,1421,859,101,138,239,1.6523255813953488,32.79621640554637
Task_26449,1684,520,50,115,165,3.232245681381958,35.66063229747933
Task_26450,546,863,168,115,283,0.6319444444444444,19.188528427178777
Task_26451,2497,814,98,65,163,3.063803680981595,48.69560245698725
Task_26452,1113,360,38,186,224,3.0831024930747923,26.381918946894974
Task_26453,781,721,101,114,215,1.0817174515235457,21.954216329071375
Task_26454,1188,210,185,173,358,5.630331753554502,27.64267579579773
Task_26455,1752,203,14,96,110,8.588235294117647,34.9930978980911
Task_26456,1005,224,63,88,151,4.466666666666667,23.35218316485937
Task_26457,1800,389,167,123,290,4.615384615384615,37.53739946545965
Task_26458,2460,943,20,118,138,2.6059322033898304,48.70176820166777
Task_26459,1040,575,54,20,74,1.8055555555555556,23.070488670881744
Task_26460,871,89,75,18,93,9.677777777777777,18.792116530781403
Task_26461,1028,869,24,21,45,1.181609195402299,24.085397365452973
Task_26462,1909,384,115,126,241,4.958441558441558,39.02921462693778
Task_26463,2548,759,103,184,287,3.3526315789473684,50.63644361562168
Task_26464,2795,597,133,169,302,4.673913043478261,54.08114268711304
Task_26465,1898,301,120,54,174,6.28476821192053,37.64032295444119
Task_26466,1215,210,193,31,224,5.758293838862559,26.586877098517025
Task_26467,755,309,108,119,227,2.435483870967742,20.459280517940496
Task_26468,770,863,67,135,202,0.8912037037037037,22.33975042428591
Task_26469,2162,163,181,66,247,13.182926829268293,41.505727744057005
Task_26470,2587,494,178,37,215,5.226262626262626,49.20645051640431
Task_26471,975,102,167,84,251,9.466019417475728,22.40956783652295
Task_26472,2197,526,147,132,279,4.16888045540797,44.22689981388449
Task_26473,1199,295,125,146,271,4.050675675675675,27.671755061746556
Task_26474,696,721,139,196,335,0.96398891966759,21.33204368748944
Task_26475,2366,874,135,112,247,2.704,47.827478959085944
Task_26476,2629,905,93,167,260,2.901766004415011,52.342786448102224
Task_26477,2805,190,170,19,189,14.68586387434555,51.269888714626696
Task_26478,2141,473,122,138,260,4.5168776371308015,43.093268654947366
Task_26479,1532,470,27,97,124,3.2526539278131636,32.602930766242416
Task_26480,1362,792,36,187,223,1.7175283732660782,31.6618577354063
Task_26481,2634,435,96,144,240,6.041284403669724,50.7442530047521
Task_26482,635,770,116,88,204,0.8236057068741893,19.524479028613563
Task_26483,1456,226,45,46,91,6.41409691629956,29.262590792034413
Task_26484,1739,232,25,179,204,7.463519313304721,35.785140231253756
Task_26485,746,769,98,67,165,0.9688311688311688,20.959647969605452
Task_26486,2428,812,54,95,149,2.986469864698647,48.0272613430289
Task_26487,1771,236,25,55,80,7.472573839662447,34.4350390822952
Task_26488,1226,752,47,31,78,1.6281540504648075,26.934813778321086
Task_26489,848,355,88,122,210,2.3820224719101124,22.02422755217155
Task_26490,2647,533,43,29,72,4.956928838951311,48.72847567154031
Task_26491,2733,457,99,40,139,5.967248908296943,50.72476857799425
Task_26492,2653,665,134,150,284,3.9834834834834836,51.93964973064927
Task_26493,1710,546,151,43,194,3.126142595978062,35.369877419283
Task_26494,2056,425,180,107,287,4.826291079812207,41.66868857279025
Task_26495,1353,370,20,33,53,3.646900269541779,27.745033563334903
Task_26496,1665,372,117,96,213,4.463806970509383,34.98300407102944
Task_26497,2357,838,92,35,127,2.8092967818831944,46.06078354763898
Task_26498,2453,688,15,156,171,3.560232220609579,48.19179694211008
Task_26499,2019,1019,46,55,101,1.9794117647058824,41.137215594599645
Task_26500,1788,785,168,36,204,2.2748091603053435,37.411356737780274
Task_26501,1493,197,145,174,319,7.540404040404041,32.28212729238438
Task_26502,2650,758,103,48,151,3.4914361001317524,50.45144389292778
Task_26503,2627,591,128,181,309,4.4375,51.450606807777795
Task_26504,2167,366,196,49,245,5.9046321525885554,42.33261609333004
Task_26505,2802,318,27,89,116,8.783699059561128,51.95796547905757
Task_26506,802,851,26,67,93,0.9413145539906104,21.491285572789167
Task_26507,1008,409,102,119,221,2.4585365853658536,24.752699898170885
Task_26508,1838,997,158,181,339,1.8416833667334669,40.35958742130541
Task_26509,1497,649,38,143,181,2.3030769230769232,32.93513484188111
Task_26510,2534,741,122,139,261,3.4150943396226414,50.17487438651265
Task_26511,2694,233,31,147,178,11.512820512820513,50.51784616927026
Task_26512,621,602,125,45,170,1.0298507462686568,17.902041971859703
Task_26513,1362,943,183,42,225,1.4427966101694916,31.23370138344502
Task_26514,572,639,24,65,89,0.89375,17.046177613436218
Task_26515,2283,216,87,75,162,10.52073732718894,43.328799054238054
Task_26516,510,386,184,158,342,1.317829457364341,17.35019084202344
Task_26517,2613,330,87,127,214,7.8942598187311175,49.87260852018574
Task_26518,2894,483,61,19,80,5.979338842975206,52.451577351903204
Task_26519,1983,333,96,75,171,5.937125748502994,39.116744888265465
Task_26520,2625,520,192,148,340,5.038387715930902,51.282409193558884
Task_26521,2281,698,80,94,174,3.263233190271817,45.568413596738175
Task_26522,2575,824,144,153,297,3.121212121212121,51.26791305095143
Task_26523,2071,284,134,129,263,7.266666666666667,41.358651570757154
Task_26524,1077,481,40,154,194,2.2344398340248963,26.01422765587192
Task_26525,2526,144,165,14,179,17.420689655172414,46.256293144769806
Task_26526,1344,947,155,123,278,1.4177215189873418,31.94799370710837
Task_26527,1836,883,192,82,274,2.076923076923077,39.25216790997772
Task_26528,1388,368,58,81,139,3.761517615176152,29.86129817462516
Task_26529,1023,325,33,19,52,3.138036809815951,22.153790144861517
Task_26530,2538,813,190,68,258,3.117936117936118,49.906176753206076
Task_26531,771,923,158,196,354,0.8344155844155844,23.227607897631753
Task_26532,2238,219,199,104,303,10.172727272727272,43.90571193073617
Task_26533,1358,639,12,22,34,2.121875,28.27216046819335
Task_26534,2955,187,143,117,260,15.71808510638298,55.0244960769699
Task_26535,1079,104,119,185,304,10.276190476190477,24.610931242173677
Task_26536,703,133,127,27,154,5.246268656716418,17.237753116438608
Task_26537,2561,459,86,53,139,5.567391304347826,48.34303229901923
Task_26538,1798,381,132,125,257,4.706806282722513,37.33382965608279
Task_26539,1221,90,116,65,181,13.417582417582418,25.47960980049334
Task_26540,2302,118,129,154,283,19.34453781512605,44.0274633469618
Task_26541,715,494,64,196,260,1.4444444444444444,20.72922593843006
Task_26542,1221,785,107,143,250,1.5534351145038168,29.425249674058207
Task_26543,1620,833,120,149,269,1.9424460431654675,36.03314209387895
Task_26544,956,999,138,24,162,0.956,24.511523366301926
Task_26545,1787,116,105,186,291,15.273504273504274,35.931469936570444
Task_26546,1667,560,98,135,233,2.971479500891266,35.754032699581785
Task_26547,2224,766,121,28,149,2.8996088657105608,43.719619450555854
Task_26548,2698,636,89,69,158,4.235478806907379,51.13209932246324
Task_26549,1097,606,171,68,239,1.8072487644151565,26.346309073787324
Task_26550,1469,292,174,66,240,5.013651877133106,31.210589381016643
Task_26551,532,579,76,194,270,0.9172413793103448,18.084038364245085
Task_26552,742,864,191,162,353,0.8578034682080925,22.53984080344964
Task_26553,1069,342,176,102,278,3.116618075801749,25.73589629177775
Task_26554,1492,724,191,160,351,2.057931034482759,34.05137108687308
Task_26555,2326,540,74,171,245,4.299445471349353,46.349945867014874
Task_26556,772,348,138,24,162,2.2120343839541547,19.450002635734503
Task_26557,2705,780,142,22,164,3.463508322663252,51.57788534828495
Task_26558,1698,973,96,181,277,1.7433264887063655,37.826524275204555
Task_26559,1153,432,163,28,191,2.6628175519630486,26.14975183903947
Task_26560,1508,347,141,60,201,4.333333333333333,31.76338120876194
Task_26561,2411,348,173,180,353,6.908309455587393,47.43486089509863
Task_26562,2932,212,41,28,69,13.765258215962442,52.05935166165997
Task_26563,1358,204,115,89,204,6.624390243902439,29.300520735918184
Task_26564,1937,257,89,94,183,7.507751937984496,38.49130997868297
Task_26565,2108,376,19,67,86,5.591511936339523,40.47727777253215
Task_26566,871,540,149,145,294,1.609981515711645,23.34944502228593
Task_26567,683,842,166,121,287,0.8102016607354685,21.187092200490763
Task_26568,2791,335,77,155,232,8.306547619047619,52.94462487297631
Task_26569,1765,629,65,92,157,2.8015873015873014,36.84131921603841
Task_26570,2873,909,109,100,209,3.157142857142857,55.781550836067744
Task_26571,2220,685,163,59,222,3.2361516034985423,44.20568705093556
Task_26572,1111,515,14,111,125,2.1531007751937983,26.093022255885057
Task_26573,2300,421,99,31,130,5.450236966824645,43.81631601555474
Task_26574,2155,153,176,197,373,13.993506493506494,42.468620142546285
Task_26575,1780,506,124,171,295,3.510848126232742,37.69025863305247
Task_26576,513,898,126,16,142,0.5706340378197998,17.18065039058718
Task_26577,2959,377,189,85,274,7.828042328042328,55.43226969961268
Task_26578,2598,964,57,185,242,2.6922279792746115,52.02776896412067
Task_26579,2915,526,72,133,205,5.531309297912713,55.38984288984434
Task_26580,987,333,78,160,238,2.9550898203592815,24.445466577587638
Task_26581,1136,486,79,72,151,2.3326488706365502,26.062052873532043
Task_26582,1079,884,79,185,264,1.2192090395480226,27.649622001036885
Task_26583,676,487,165,141,306,1.3852459016393444,20.090019756538055
Task_26584,835,284,90,96,186,2.9298245614035086,21.373364254637153
Task_26585,1256,227,176,55,231,5.508771929824562,27.604280198074516
Task_26586,599,610,158,98,256,0.9803600654664485,18.959617912874446
Task_26587,1355,971,153,82,235,1.3940329218106995,31.66348904847298
Task_26588,2108,181,113,196,309,11.582417582417582,41.509743095357614
Task_26589,643,663,22,186,208,0.9683734939759037,19.606461780694755
Task_26590,1159,317,81,74,155,3.6446540880503147,25.946977629556816
Task_26591,1780,75,199,33,232,23.42105263157895,34.167271129125766
Task_26592,2092,939,137,130,267,2.225531914893617,43.805043296575654
Task_26593,1545,684,29,24,53,2.2554744525547443,31.767913365504544
Task_26594,1608,849,29,198,227,1.891764705882353,35.816285413297614
Task_26595,2909,228,16,146,162,12.703056768558952,53.654473590055524
Task_26596,2272,560,130,49,179,4.049910873440285,44.144594537316415
Task_26597,2207,987,187,21,208,2.233805668016194,44.575326228464284
Task_26598,1947,666,150,95,245,2.91904047976012,40.47583181276149
Task_26599,1299,805,25,84,109,1.6116625310173698,29.570609801111228
Task_26600,2277,771,178,31,209,2.949481865284974,45.135076945052646
Task_26601,1161,116,96,62,158,9.923076923076923,24.621909013143604
Task_26602,1802,136,107,77,184,13.153284671532846,35.19041181034429
Task_26603,700,520,121,138,259,1.3435700575815739,20.38456855113734
Task_26604,2741,275,187,35,222,9.931159420289855,50.92458601989954
Task_26605,2650,973,37,176,213,2.7207392197125255,52.59728765999367
Task_26606,2029,213,128,16,144,9.481308411214954,38.656157533527214
Task_26607,2345,1000,150,49,199,2.3426573426573425,46.95477101341632
Task_26608,2110,239,175,165,340,8.791666666666666,42.214711212591105
Task_26609,2330,391,145,160,305,5.9438775510204085,46.05174736122077
Task_26610,2710,791,198,95,293,3.4217171717171717,53.17198103572579
Task_26611,1173,299,117,106,223,3.91,26.99886445123971
Task_26612,1278,535,130,187,317,2.3843283582089554,29.956680907228346
Task_26613,1173,404,158,52,210,2.8962962962962964,26.787773271568273
Task_26614,1963,974,57,60,117,2.013333333333333,40.31150106521283
Task_26615,1569,767,165,171,336,2.04296875,35.35380264942277
Task_26616,1156,140,111,66,177,8.198581560283689,24.822040754381305
Task_26617,1737,434,142,176,318,3.9931034482758623,36.89012734570118
Task_26618,1319,395,126,18,144,3.330808080808081,27.95483661261748
Task_26619,2390,967,96,95,191,2.46900826446281,48.243334046042115
Task_26620,1985,746,19,162,181,2.6572958500669346,40.96842447487766
Task_26621,2188,712,68,85,153,3.0687237026647964,43.6064740966849
Task_26622,2156,632,111,133,244,3.406003159557662,43.75825182454104
Task_26623,2281,710,135,95,230,3.208157524613221,45.837158811956876
Task_26624,2028,588,42,49,91,3.443123938879457,39.60957758666951
Task_26625,2251,425,18,151,169,5.284037558685446,44.076928261339845
Task_26626,1346,441,41,75,116,3.0452488687782804,29.21971859996856
Task_26627,2616,464,65,12,77,5.625806451612903,47.811454672470624
Task_26628,1971,402,107,141,248,4.890818858560794,40.12266694546404
Task_26629,1522,816,17,101,118,1.8629130966952265,33.30145060290849
Task_26630,687,382,42,146,188,1.793733681462141,19.455359913209204
Task_26631,1575,748,118,62,180,2.102803738317757,33.84868319694694
Task_26632,2634,676,17,126,143,3.8906942392909896,50.64217155979005
Task_26633,1740,800,55,179,234,2.1722846441947565,37.876473600657434
Task_26634,729,117,62,183,245,6.177966101694915,19.23804992639761
Task_26635,1623,454,102,189,291,3.5670329670329672,35.04735414414763
Task_26636,2336,622,158,160,318,3.749598715890851,46.950488938120905
Task_26637,1005,575,63,128,191,1.7447916666666667,25.21941351013208
Task_26638,1071,299,145,131,276,3.57,25.66173682350357
Task_26639,1470,659,145,135,280,2.227272727272727,33.143171516254505
Task_26640,1513,877,173,179,352,1.7232346241457859,34.87923320109592
Task_26641,1540,96,186,136,322,15.876288659793815,31.751418999114772
Task_26642,2787,735,155,123,278,3.786684782608696,54.21701840819778
Task_26643,2263,757,197,63,260,2.9854881266490767,45.35500221851307
Task_26644,957,574,129,65,194,1.6643478260869564,23.826184565802077
Task_26645,1435,642,56,100,156,2.2317262830482116,31.762072670045924
Task_26646,2458,213,84,102,186,11.485981308411215,46.739436975417824
Task_26647,1549,885,158,47,205,1.7483069977426637,33.923835817572126
Task_26648,1221,528,186,175,361,2.3081285444234405,29.21289473633132
Task_26649,2044,627,108,160,268,3.254777070063694,42.11637400770102
Task_26650,1086,314,122,166,288,3.447619047619048,26.053127991642217
Task_26651,2311,378,111,169,280,6.097625329815304,45.60846978132864
Task_26652,2111,600,66,182,248,3.512479201331115,43.15683861122443
Task_26653,1416,182,18,39,57,7.737704918032787,28.18801597790224
Task_26654,2280,382,35,99,134,5.953002610966058,44.10391773952748
Task_26655,593,419,97,157,254,1.411904761904762,18.376632586483428
Task_26656,2289,391,107,126,233,5.839285714285714,45.02867109900638
Task_26657,2935,771,175,117,292,3.801813471502591,56.72948966033175
Task_26658,503,666,99,78,177,0.7541229385307346,16.78706269586822
Task_26659,1520,679,117,181,298,2.235294117647059,34.146251038251236
Task_26660,2898,1014,141,116,257,2.8551724137931034,56.74558862164192
Task_26661,2090,923,15,121,136,2.261904761904762,42.87643476514702
Task_26662,1335,249,168,183,351,5.34,30.082125892145957
Task_26663,2227,719,145,82,227,3.0930555555555554,44.722310106557984
Task_26664,2753,894,42,108,150,3.075977653631285,53.25244523346512
Task_26665,516,490,133,42,175,1.0509164969450102,16.08573698946902
Task_26666,1951,740,56,164,220,2.6329284750337383,40.94665250576114
Task_26667,1483,690,37,35,72,2.14616497829233,30.74054340102509
Task_26668,1488,406,132,113,245,3.656019656019656,32.43812466862235
Task_26669,2728,241,73,68,141,11.272727272727273,50.388070352492115
Task_26670,1317,1002,161,74,235,1.313060817547358,31.095960690170696
Task_26671,2076,777,91,26,117,2.6683804627249357,41.17040167542127
Task_26672,733,961,159,134,293,0.761954261954262,22.408051416034453
Task_26673,2201,770,47,43,90,2.85473411154345,42.82430258546026
Task_26674,822,825,193,64,257,0.9951573849878934,22.77367938177956
Task_26675,698,368,29,185,214,1.89159891598916,19.82423320334253
Task_26676,2179,771,187,29,216,2.8225388601036268,43.62432326413765
Task_26677,2218,592,67,89,156,3.740303541315346,43.82581780090438
Task_26678,2289,773,60,141,201,2.9573643410852712,46.254611093877195
Task_26679,1410,355,14,17,31,3.960674157303371,28.108127167831892
Task_26680,2611,636,131,27,158,4.0989010989010985,49.437642436532265
Task_26681,623,435,44,20,64,1.4288990825688073,16.035293669199103
Task_26682,1627,425,39,101,140,3.81924882629108,33.910031603131635
Task_26683,2430,696,12,132,144,3.486370157819225,47.55705539357778
Task_26684,2286,508,40,42,82,4.491159135559921,43.300292717796104
Task_26685,1421,478,73,44,117,2.9665970772442587,29.86424302648845
Task_26686,2583,482,105,44,149,5.3478260869565215,48.49806571110199
Task_26687,2311,85,25,172,197,26.872093023255815,43.40619611910662
Task_26688,1732,83,97,67,164,20.61904761904762,33.396568025439194
Task_26689,2359,771,194,115,309,3.055699481865285,47.677968386435055
Task_26690,1295,366,149,140,289,3.5286103542234333,29.493488474118063
Task_26691,2793,902,188,151,339,3.0930232558139537,55.15269004502782
Task_26692,822,171,179,46,225,4.77906976744186,19.995977001338684
Task_26693,1409,383,28,70,98,3.6692708333333335,29.572870246116608
Task_26694,1159,327,91,17,108,3.533536585365854,24.997605466593345
Task_26695,1824,500,99,172,271,3.6407185628742513,38.26270892398544
Task_26696,2716,609,80,167,247,4.452459016393442,52.74484578570915
Task_26697,1310,626,43,175,218,2.0893141945773523,30.298648300986347
Task_26698,1194,937,97,27,124,1.2729211087420043,27.750834237802707
Task_26699,1605,358,121,165,286,4.47075208913649,34.394637076222025
Task_26700,1521,355,36,81,117,4.272471910112359,31.74097947087642
Task_26701,2584,871,36,145,181,2.963302752293578,50.853368868776805
Task_26702,2398,367,82,131,213,6.516304347826087,46.68284944736823
Task_26703,2624,651,163,54,217,4.024539877300613,50.53732444634778
Task_26704,1288,951,116,183,299,1.3529411764705883,31.2834910267841
Task_26705,1681,395,65,72,137,4.244949494949495,34.43314727143361
Task_26706,2828,357,94,27,121,7.899441340782123,51.85344439038539
Task_26707,1001,748,61,150,211,1.3364485981308412,25.78204834376835
Task_26708,2653,703,163,78,241,3.768465909090909,51.462779387325355
Task_26709,2168,103,76,143,219,20.846153846153847,41.39309873909226
Task_26710,837,665,99,23,122,1.2567567567567568,21.16738643473825
Task_26711,2688,938,145,189,334,2.862619808306709,53.63461096718199
Task_26712,2236,921,167,11,178,2.4251626898047722,44.47705665659672
Task_26713,612,429,26,75,101,1.4232558139534883,17.168537051287874
Task_26714,2242,756,132,154,286,2.961690885072655,45.73088015771757
Task_26715,1776,639,24,121,145,2.775,37.079056591966754
Task_26716,1179,278,192,70,262,4.225806451612903,26.702946517374965
Task_26717,2588,246,130,142,272,10.477732793522268,49.45190183798468
Task_26718,843,440,67,51,118,1.91156462585034,20.91241729272599
Task_26719,1468,893,119,87,206,1.6420581655480984,33.17286341364541
Task_26720,2868,954,65,67,132,3.0031413612565445,54.97322754367352
Task_26721,2932,803,101,189,290,3.646766169154229,56.879286923765356
Task_26722,581,394,153,188,341,1.4708860759493672,18.536872429124358
Task_26723,2507,362,40,47,87,6.90633608815427,46.28636594724457
Task_26724,1208,132,149,112,261,9.082706766917294,26.7373915556111
Task_26725,717,1011,159,181,340,0.708498023715415,22.675453697095264
Task_26726,1228,694,27,62,89,1.766906474820144,27.46832128699849
Task_26727,2566,367,196,27,223,6.9728260869565215,48.42046157643648
Task_26728,2082,479,171,55,226,4.3375,41.47784517202486
Task_26729,530,738,36,186,222,0.7171853856562923,18.280060580431513
Task_26730,896,428,141,124,265,2.0885780885780885,23.245967895489496
Task_26731,1418,249,23,119,142,5.672,30.152040905523208
Task_26732,1772,182,120,176,296,9.683060109289617,36.318272488459066
Task_26733,521,583,90,78,168,0.8921232876712328,16.837439901890345
Task_26734,2315,446,66,166,232,5.178970917225951,45.797421791743865
Task_26735,2909,314,94,15,109,9.234920634920634,52.777260184309796
Task_26736,2499,937,107,133,240,2.6641791044776117,50.13084134553733
Task_26737,1371,239,171,171,342,5.7125,30.558412129892705
Task_26738,1089,919,160,74,234,1.183695652173913,27.244983218710292
Task_26739,996,800,189,136,325,1.243445692883895,26.154446754975876
Task_26740,1414,422,69,154,223,3.342789598108747,31.400860213741847
Task_26741,1559,508,55,85,140,3.06286836935167,33.05562730508883
Task_26742,2932,441,150,146,296,6.633484162895928,55.6829642272578
Task_26743,940,303,40,142,182,3.0921052631578947,23.0260889682072
Task_26744,627,795,200,41,241,0.7876884422110553,19.27212856751607
Task_26745,634,634,19,15,34,0.9984251968503937,16.81174346337642
Task_26746,578,224,128,164,292,2.568888888888889,17.746982342921395
Task_26747,2873,969,97,88,185,2.961855670103093,55.4634743161046
Task_26748,2113,243,85,26,111,8.65983606557377,39.928810576133266
Task_26749,874,939,160,85,245,0.9297872340425531,24.022354249240536
Task_26750,2357,906,127,55,182,2.5986769570011026,46.79793978144273
Task_26751,1313,337,193,59,252,3.8846153846153846,28.872903963348495
Task_26752,2637,447,62,170,232,5.886160714285714,50.90838207248163
Task_26753,1482,715,77,115,192,2.069832402234637,33.20819635926773
Task_26754,648,230,15,28,43,2.8051948051948052,15.975585055154651
Task_26755,2936,496,161,85,246,5.907444668008048,55.337443612752345
Task_26756,2490,367,34,174,208,6.766304347826087,48.114232992467976
Task_26757,772,739,184,35,219,1.0432432432432432,21.23513857033779
Task_26758,2199,575,184,137,321,3.8177083333333335,44.61147693997319
Task_26759,1065,778,195,26,221,1.3671373555840822,25.968536635031214
Task_26760,676,323,45,139,184,2.0864197530864197,18.9165474339144
Task_26761,2953,217,93,47,140,13.545871559633028,53.54100804379028
Task_26762,996,885,78,60,138,1.1241534988713318,24.834382654491836
Task_26763,1734,746,110,19,129,2.321285140562249,35.66288496467941
Task_26764,2869,380,116,122,238,7.530183727034121,54.18529856121813
Task_26765,2460,872,11,88,99,2.8178694158075603,47.93232941074044
Task_26766,723,976,170,130,300,0.7400204708290685,22.270103843048997
Task_26767,2331,866,119,86,205,2.688581314878893,46.756429136013075
Task_26768,2257,86,20,109,129,25.942528735632184,41.583166065726026
Task_26769,2481,646,103,180,283,3.8346213292117466,49.1946333170495
Task_26770,2455,348,90,55,145,7.034383954154728,46.43930462262853
Task_26771,2595,732,36,156,192,3.540245566166439,50.835696383298824
Task_26772,2118,440,37,34,71,4.802721088435374,39.99840477437551
Task_26773,576,953,192,61,253,0.6037735849056604,19.38836539721946
Task_26774,2121,787,108,160,268,2.6916243654822334,43.83874341443194
Task_26775,1533,688,172,59,231,2.2249637155297535,33.37367308712482
Task_26776,2711,963,189,81,270,2.8122406639004147,53.307221014439854
Task_26777,566,171,20,57,77,3.2906976744186047,14.795910166905273
Task_26778,924,674,45,177,222,1.3688888888888888,24.23019786900561
Task_26779,2515,918,112,64,176,2.736670293797606,49.29709966168959
Task_26780,1341,175,56,190,246,7.619318181818182,29.16491195802857
Task_26781,1099,479,139,11,150,2.2895833333333333,24.86737635536612
Task_26782,708,614,40,155,195,1.1512195121951219,20.439265233198814
Task_26783,2592,883,119,30,149,2.932126696832579,49.961485166801275
Task_26784,708,520,115,131,246,1.3589251439539347,20.442375814088916
Task_26785,2545,966,186,142,328,2.6318510858324715,51.36004038562663
Task_26786,2485,641,110,131,241,3.870716510903427,48.981013108930256
Task_26787,818,469,120,177,297,1.7404255319148936,22.348738485806603
Task_26788,1857,1009,107,181,288,1.8386138613861387,40.46807322348001
Task_26789,2632,901,162,125,287,2.917960088691796,52.325983734665954
Task_26790,2585,839,34,138,172,3.0773809523809526,50.847901571093225
Task_26791,1629,785,196,11,207,2.072519083969466,34.753778385842345
Task_26792,1853,872,169,100,269,2.122565864833906,39.774445009908824
Task_26793,2500,784,40,72,112,3.1847133757961785,48.41878437550656
Task_26794,2200,574,143,107,250,3.8260869565217392,44.260153671592235
Task_26795,533,288,128,67,195,1.8442906574394464,16.219100072284967
Task_26796,2514,664,114,45,159,3.780451127819549,47.98125343854242
Task_26797,1058,159,117,81,198,6.6125,24.01119953365648
Task_26798,2216,176,79,174,253,12.519774011299434,42.99238805256744
Task_26799,679,750,149,127,276,0.9041278295605859,20.79846266549283
Task_26800,2821,901,174,65,239,3.1274944567627494,54.576426912237785
Task_26801,1814,678,99,46,145,2.6715758468335786,37.005400179101095
Task_26802,1625,882,159,180,339,1.840317100792752,36.62569768973102
Task_26803,2560,727,125,159,284,3.5164835164835164,50.67563457429475
Task_26804,1309,642,69,42,111,2.035769828926905,28.552010856795096
Task_26805,2599,542,138,157,295,4.786372007366483,50.751979611460435
Task_26806,1463,150,79,174,253,9.688741721854305,31.112410960283736
Task_26807,2910,312,162,98,260,9.297124600638977,54.66598871784856
Task_26808,1095,574,153,52,205,1.9043478260869566,26.06638317281235
Task_26809,2326,896,33,28,61,2.593088071348941,44.75468352672396
Task_26810,2486,568,194,12,206,4.3690685413005275,47.6465900879783
Task_26811,2565,454,177,52,229,5.637362637362638,49.06500137239641
Task_26812,1336,819,188,49,237,1.6292682926829267,30.57208298087239
Task_26813,2720,257,191,10,201,10.542635658914728,50.27176530264
Task_26814,1069,1010,94,140,234,1.0573689416419387,27.62340021676115
Task_26815,1833,745,161,53,214,2.4571045576407506,38.337128473909274
Task_26816,2749,691,199,157,356,3.972543352601156,53.87737947889809
Task_26817,1636,384,188,26,214,4.249350649350649,33.734420065497595
Task_26818,1564,458,86,105,191,3.4074074074074074,33.59446776779635
Task_26819,646,182,137,22,159,3.530054644808743,16.930267510924253
Task_26820,1034,813,131,133,264,1.2702702702702702,26.548577482648852
Task_26821,938,898,180,108,288,1.0433815350389322,25.32619618796011
Task_26822,2059,941,183,137,320,2.185774946921444,43.53748445696218
Task_26823,2041,236,85,113,198,8.611814345991561,40.44487327066433
Task_26824,788,760,51,91,142,1.0354796320630748,21.55728980504369
Task_26825,533,204,125,182,307,2.6,17.065151263367902
Task_26826,1776,750,28,31,59,2.3648468708388815,35.52314040175765
Task_26827,1245,985,176,144,320,1.2626774847870184,30.679377401308894
Task_26828,1266,431,52,193,245,2.9305555555555554,29.29196765998647
Task_26829,1512,475,183,70,253,3.176470588235294,32.567067810626426
Task_26830,2100,326,193,49,242,6.422018348623853,41.125125793784825
Task_26831,1418,887,186,128,314,1.5968468468468469,33.158984728656975
Task_26832,1585,984,114,88,202,1.6091370558375635,35.2948838065098
Task_26833,2552,1006,112,184,296,2.5342601787487586,51.51297525814575
Task_26834,1922,173,75,99,174,11.045977011494253,37.82375066337118
Task_26835,809,430,39,48,87,1.877030162412993,19.699803254769062
Task_26836,1712,437,169,128,297,3.9086757990867578,36.33910208591909
Task_26837,2478,697,68,68,136,3.5501432664756445,47.977081357789075
Task_26838,1803,440,168,83,251,4.08843537414966,37.222362585997345
Task_26839,2387,279,52,25,77,8.525,43.65741147085232
Task_26840,1853,520,69,78,147,3.5566218809980805,37.72992361719928
Task_26841,653,528,146,198,344,1.2344045368620038,20.053660287315278
Task_26842,2660,946,37,102,139,2.808870116156283,51.907025059566614
Task_26843,716,551,157,75,232,1.2971014492753623,20.151736004711676
Task_26844,1563,677,60,173,233,2.3053097345132745,34.644397991673145
Task_26845,603,78,78,57,135,7.632911392405063,15.367181588678692
Task_26846,957,736,184,200,384,1.2985074626865671,25.728954261197998
Task_26847,2130,513,185,187,372,4.143968871595331,43.62428727613801
Task_26848,1203,966,193,45,238,1.2440537745604965,28.793575999820046
Task_26849,1044,938,58,62,120,1.1118210862619808,25.56273601819434
Task_26850,1133,623,14,144,158,1.8157051282051282,26.890387256289483
Task_26851,2950,333,11,76,87,8.832335329341317,53.689780861124376
Task_26852,2060,182,153,62,215,11.256830601092895,40.07077431057166
Task_26853,2202,133,177,130,307,16.432835820895523,42.625312049082275
Task_26854,2209,293,191,99,290,7.51360544217687,43.63442123445858
Task_26855,1840,744,125,161,286,2.469798657718121,39.335146406807745
Task_26856,2766,728,33,53,86,3.794238683127572,51.93542739875759
Task_26857,1618,782,200,51,251,2.0664112388250317,35.151422594420175
Task_26858,1826,461,79,124,203,3.9523809523809526,37.92176642825334
Task_26859,1027,728,144,23,167,1.4087791495198903,24.774845844938568
Task_26860,821,85,199,144,343,9.546511627906977,20.589956078806043
Task_26861,2321,215,183,139,322,10.74537037037037,45.33794499913339
Task_26862,2185,715,151,16,167,3.0516759776536313,42.96155939195396
Task_26863,2459,313,107,113,220,7.8312101910828025,47.37644806102577
Task_26864,1869,921,14,19,33,2.027114967462039,37.09914468817692
Task_26865,2531,507,156,39,195,4.982283464566929,48.21865330968186
Task_26866,1082,670,192,37,229,1.6125186289120714,26.011406935032365
Task_26867,1176,662,63,22,85,1.7737556561085972,26.072211473526863
Task_26868,503,980,12,73,85,0.5127420998980632,17.00324576662368
Task_26869,2321,741,124,133,257,3.128032345013477,46.77379989286399
Task_26870,2555,823,189,56,245,3.1007281553398056,50.14545816357523
Task_26871,1923,955,92,32,124,2.0115062761506275,39.50724084646781
Task_26872,2792,161,48,100,148,17.234567901234566,51.055012532838795
Task_26873,1389,185,87,15,102,7.467741935483871,28.107578493347646
Task_26874,2827,127,44,43,87,22.0859375,50.04257506365834
Task_26875,1284,267,150,72,222,4.791044776119403,28.176996807214795
Task_26876,1768,634,173,44,217,2.784251968503937,36.659901893799656
Task_26877,831,786,122,19,141,1.0559085133418042,21.437955142487784
Task_26878,1035,963,198,36,234,1.0736514522821576,26.156821477421133
Task_26879,1410,391,166,184,350,3.5969387755102042,31.732947925532372
Task_26880,1083,319,82,194,276,3.384375,26.10129072082509
Task_26881,601,700,93,105,198,0.8573466476462197,19.135496774676195
Task_26882,2983,592,140,124,264,5.03035413153457,56.805120738241385
Task_26883,2571,719,100,144,244,3.5708333333333333,50.62239474346742
Task_26884,577,512,59,183,242,1.124756335282651,18.39175046138084
Task_26885,570,535,169,23,192,1.0634328358208955,17.204989782977695
Task_26886,2341,811,104,21,125,2.8830049261083746,45.49100914467697
Task_26887,604,311,17,136,153,1.935897435897436,17.357217193074842
Task_26888,1448,781,190,151,341,1.8516624040920715,33.47369266607996
Task_26889,1818,729,81,112,193,2.4904109589041097,38.55240403553636
Task_26890,2576,217,26,134,160,11.81651376146789,48.35894620211972
Task_26891,1548,574,33,140,173,2.692173913043478,33.61670507531749
Task_26892,2295,697,94,32,126,3.2879656160458453,44.71209590103039
Task_26893,1076,499,149,123,272,2.152,26.348707701343272
Task_26894,1555,342,21,175,196,4.533527696793003,33.14078287542781
Task_26895,1951,457,86,198,284,4.259825327510917,40.27235003314066
Task_26896,1193,315,52,176,228,3.7753164556962027,27.662394207575343
Task_26897,2524,868,15,87,102,2.904487917146145,49.08924244696576
Task_26898,2023,636,144,173,317,3.1758241758241756,42.05208071665103
Task_26899,2211,763,145,30,175,2.893979057591623,43.85074325771105
Task_26900,2604,140,117,56,173,18.46808510638298,47.84050436812521
Task_26901,2272,793,129,159,288,2.861460957178841,46.338476065514335
Task_26902,2479,852,16,164,180,2.906213364595545,49.108515522589734
Task_26903,1408,701,194,78,272,2.005698005698006,31.874950074575313
Task_26904,1746,249,174,139,313,6.984,36.34007318360917
Task_26905,2262,551,168,117,285,4.0978260869565215,45.341038491467636
Task_26906,1623,957,191,96,287,1.6941544885177453,36.479599877399835
Task_26907,986,707,149,29,178,1.3926553672316384,24.169865036091988
Task_26908,2754,529,69,64,133,5.19622641509434,51.80908184596097
Task_26909,1452,913,41,125,166,1.588621444201313,32.91915184814675
Task_26910,886,131,85,156,241,6.712121212121212,21.667038892946977
Task_26911,734,689,157,41,198,1.063768115942029,20.36176258594893
Task_26912,740,581,195,98,293,1.2714776632302405,21.25409311687843
Task_26913,972,956,30,154,184,1.0156739811912225,25.394922864380835
Task_26914,735,247,103,59,162,2.963709677419355,18.781577249182913
Task_26915,1949,842,142,36,178,2.3119810201660735,39.84081137541032
Task_26916,1601,282,77,154,231,5.657243816254417,33.94066701824627
Task_26917,1128,427,40,50,90,2.635514018691589,24.83406569333231
Task_26918,2745,177,20,14,34,15.42134831460674,48.465529993293664
Task_26919,1233,489,164,126,290,2.516326530612245,28.88819735357175
Task_26920,2159,813,40,174,214,2.652334152334152,44.311670926551095
Task_26921,1964,101,72,72,144,19.254901960784313,37.08907220269338
Task_26922,648,534,158,194,352,1.2112149532710281,20.023357075533838
Task_26923,2269,852,135,44,179,2.660023446658851,44.926300591599734
Task_26924,1994,577,164,44,208,3.449826989619377,40.018545943238706
Task_26925,2743,222,68,128,196,12.300448430493274,51.567280966475145
Task_26926,2358,786,183,119,302,2.9961880559085134,47.68348822397471
Task_26927,1554,513,143,113,256,3.0233463035019454,33.87367791417309
Task_26928,2063,819,179,20,199,2.515853658536585,41.65019505411638
Task_26929,2029,882,103,72,175,2.2978482446206114,41.62815683467789
Task_26930,1141,326,94,41,135,3.489296636085627,25.251156204819736
Task_26931,2938,367,164,179,343,7.983695652173913,55.789507086166886
Task_26932,1449,228,44,95,139,6.327510917030568,30.454703111467154
Task_26933,1290,281,16,96,112,4.574468085106383,27.93994294782073
Task_26934,2969,670,50,119,169,4.424739195230998,56.39824551307667
Task_26935,1946,796,46,21,67,2.4416562107904642,38.31121944116821
Task_26936,2357,671,188,170,358,3.5074404761904763,47.633057721509054
Task_26937,1160,721,11,134,145,1.6066481994459834,27.55746989775514
Task_26938,730,700,153,136,289,1.0413694721825963,21.4633876350961
Task_26939,2222,335,15,155,170,6.613095238095238,43.39787505673623
Task_26940,2160,102,13,22,35,20.97087378640777,38.817875413859696
Task_26941,790,1013,84,138,222,0.7790927021696252,23.167551916303
Task_26942,2291,991,13,13,26,2.309475806451613,44.12356402500362
Task_26943,2562,822,120,25,145,3.1130012150668285,49.278230027468304
Task_26944,2651,285,170,47,217,9.26923076923077,49.50568628872739
Task_26945,1927,664,96,106,202,2.8977443609022555,40.056068218350276
Task_26946,625,517,176,37,213,1.2065637065637065,18.249782282163174
Task_26947,1900,72,103,15,118,26.027397260273972,34.858528883247864
Task_26948,2810,160,51,79,130,17.453416149068325,51.23211380179592
Task_26949,656,147,17,186,203,4.4324324324324325,17.906796232391354
Task_26950,2987,735,45,16,61,4.0584239130434785,54.44882497197826
Task_26951,724,416,168,142,310,1.73621103117506,20.70199169236635
Task_26952,2675,591,122,15,137,4.518581081081081,50.12847519223302
Task_26953,952,326,135,190,325,2.91131498470948,24.17480860703016
Task_26954,2350,533,118,134,252,4.400749063670412,46.553022337725
Task_26955,1225,486,16,38,54,2.515400410677618,26.17236697369888
Task_26956,2217,274,163,188,351,8.061818181818182,44.11445256167559
Task_26957,2938,816,171,126,297,3.5960832313341493,56.95444003340551
Task_26958,581,533,58,96,154,1.0880149812734083,17.667518083846392
Task_26959,2227,331,52,178,230,6.707831325301205,44.07948247765396
Task_26960,2751,830,84,31,115,3.3104693140794224,52.023547151489986
Task_26961,2540,252,143,30,173,10.039525691699605,47.36872232453408
Task_26962,1578,101,154,108,262,15.470588235294118,32.165383772004795
Task_26963,1158,749,140,179,319,1.544,28.679087914645518
Task_26964,2279,508,127,125,252,4.477406679764243,45.33547964153136
Task_26965,2935,628,71,110,181,4.666136724960254,55.71019677329835
Task_26966,1331,296,37,158,195,4.481481481481482,29.456987077683205
Task_26967,1627,748,138,110,248,2.172229639519359,35.72733337533054
Task_26968,2349,802,68,148,216,2.925280199252802,47.36816727006982
Task_26969,1923,176,153,197,350,10.864406779661017,38.7046290657797
Task_26970,649,473,78,94,172,1.369198312236287,18.943538307628927
Task_26971,1357,808,109,29,138,1.6773794808405438,30.074332088103947
Task_26972,2752,630,131,189,320,4.361331220285262,53.61589941476635
Task_26973,704,955,183,107,290,0.7364016736401674,21.83297949049771
Task_26974,2514,710,74,109,183,3.5358649789029535,49.31433687196301
Task_26975,1543,759,193,171,364,2.030263157894737,35.04316501314067
Task_26976,1706,467,86,193,279,3.6452991452991452,36.39653577150213
Task_26977,632,904,109,144,253,0.6983425414364641,20.55932342623497
Task_26978,2277,324,186,17,203,7.006153846153846,43.43670420561322
Task_26979,2404,440,23,40,63,5.45124716553288,44.62226989603388
Task_26980,2822,641,91,172,263,4.395638629283489,54.527020084241265
Task_26981,936,882,118,143,261,1.0600226500566252,25.165930011742656
Task_26982,2684,831,73,126,199,3.2259615384615383,52.6625426787661
Task_26983,955,725,28,183,211,1.315426997245179,24.888509778303412
Task_26984,1491,754,90,155,245,1.9748344370860926,33.693261147012365
Task_26985,1510,694,138,27,165,2.172661870503597,32.42877723330315
Task_26986,1946,536,17,197,214,3.623836126629423,40.02478548965419
Task_26987,803,637,33,75,108,1.2586206896551724,21.011561909607252
Task_26988,2014,109,23,25,48,18.30909090909091,36.77924035844298
Task_26989,1214,386,103,108,211,3.136950904392765,27.87781913849638
Task_26990,1840,511,26,90,116,3.59375,37.38091399450516
Task_26991,2503,324,146,120,266,7.701538461538462,48.32786779127764
Task_26992,572,870,109,154,263,0.6567164179104478,19.58744665367431
Task_26993,840,458,14,19,33,1.8300653594771241,19.355528772229576
Task_26994,1515,626,150,164,314,2.416267942583732,33.94828264428648
Task_26995,1724,830,165,98,263,2.0746089049338146,37.57305181258677
Task_26996,2916,915,53,93,146,3.183406113537118,56.045797735471616
Task_26997,1145,882,38,112,150,1.2967157417893544,27.575621536946617
Task_26998,1564,950,97,18,115,1.6445846477392219,33.33309179906235
Task_26999,1313,765,146,118,264,1.7140992167101827,30.876332353134007
Task_27000,1816,941,166,176,342,1.9278131634819533,39.8432177906951
Task_27001,2616,355,51,175,226,7.348314606741573,50.31753052143429
Task_27002,1487,269,128,140,268,5.507407407407407,32.11502002449576
Task_27003,1999,683,12,120,132,2.922514619883041,40.674206677064575
Task_27004,698,1017,69,120,189,0.6856581532416502,21.750338973827308
Task_27005,2382,731,133,132,265,3.2540983606557377,47.74328045013298
Task_27006,2587,839,126,84,210,3.079761904761905,50.718076769292104
Task_27007,2796,931,117,197,314,3.0,55.24568520582039
Task_27008,971,864,22,12,34,1.1225433526011561,22.75111436842128
Task_27009,2427,75,33,163,196,31.93421052631579,45.07346035758024
Task_27010,1993,248,116,184,300,8.004016064257028,40.24641637077142
Task_27011,876,831,183,125,308,1.0528846153846154,24.251562252245822
Task_27012,1980,218,25,56,81,9.04109589041096,37.77210002672984
Task_27013,2014,305,108,73,181,6.5816993464052285,39.47628126991743
Task_27014,2287,456,146,152,298,5.00437636761488,45.541066702917284
Task_27015,1968,827,97,176,273,2.3768115942028984,41.609388114148
Task_27016,1117,183,36,37,73,6.070652173913044,23.589040702800137
Task_27017,982,932,82,106,188,1.052518756698821,25.67436745435654
Task_27018,2455,669,27,94,121,3.6641791044776117,47.75105958945562
Task_27019,1031,121,148,150,298,8.450819672131148,24.12747072164309
Task_27020,2988,209,78,107,185,14.228571428571428,55.181518805918934
Task_27021,1839,830,104,132,236,2.2129963898916967,39.31994975687945
Task_27022,2146,875,30,46,76,2.449771689497717,41.82548499598733
Task_27023,1778,837,57,115,172,2.1217183770883055,38.14900816707328
Task_27024,2679,154,72,44,116,17.283870967741937,48.187752898580925
Task_27025,2268,495,170,76,246,4.57258064516129,44.659209103502086
Task_27026,2445,780,166,46,212,3.1306017925736236,47.82544326806524
Task_27027,2315,446,13,167,180,5.178970917225951,45.31971932959871
Task_27028,2039,123,13,62,75,16.443548387096776,37.682086970569
Task_27029,1022,611,136,131,267,1.6699346405228759,25.819922098110492
Task_27030,2644,708,174,136,310,3.7291960507757405,52.02979321547667
Task_27031,2924,645,14,65,79,4.526315789473684,54.01027770812103
Task_27032,1500,363,59,114,173,4.1208791208791204,32.24894515947442
Task_27033,1311,224,133,60,193,5.826666666666667,28.200568343538208
Task_27034,1231,487,10,144,154,2.5225409836065573,27.92116187278637
Task_27035,784,399,178,148,326,1.96,21.692286865342055
Task_27036,1346,395,51,96,147,3.398989898989899,29.64636556194073
Task_27037,2117,471,125,51,176,4.485169491525424,41.56542124601814
Task_27038,579,624,133,110,243,0.9264,18.648042787772148
Task_27039,2684,266,160,122,282,10.05243445692884,51.05868547964487
Task_27040,2492,483,87,182,269,5.148760330578512,48.79549415294238
Task_27041,1600,693,180,93,273,2.3054755043227666,35.15021206046345
Task_27042,1026,1021,197,30,227,1.0039138943248533,26.11946506141108
Task_27043,2960,889,11,30,41,3.3258426966292136,54.6210572356388
Task_27044,629,169,61,88,149,3.7,16.959650391648587
Task_27045,2987,271,143,152,295,10.981617647058824,55.96842189611558
Task_27046,1361,856,20,173,193,1.588098016336056,31.63497774828188
Task_27047,2755,320,35,67,102,8.582554517133957,50.71920504903259
Task_27048,1348,579,197,100,297,2.3241379310344827,30.98566720710589
Task_27049,2119,790,167,45,212,2.678887484197219,42.65776152961593
Task_27050,1410,787,80,43,123,1.7893401015228427,30.777585455204285
Task_27051,2847,226,64,125,189,12.541850220264317,53.16846806845561
Task_27052,2555,336,66,147,213,7.5816023738872405,49.11487475355856
Task_27053,2079,527,157,172,329,3.9375,42.645800373295835
Task_27054,1204,80,10,112,122,14.864197530864198,24.990985844292272
Task_27055,1083,293,116,90,206,3.683673469387755,25.291452674640144
Task_27056,1823,96,182,16,198,18.79381443298969,34.763708434454564
Task_27057,1511,998,191,50,241,1.5125125125125125,33.908176888627416
Task_27058,2454,354,119,63,182,6.912676056338028,46.53698361978869
Task_27059,1723,576,161,108,269,2.9861351819757367,36.80008698622448
Task_27060,2478,972,33,137,170,2.5467625899280577,49.46086529607527
Task_27061,2109,504,181,186,367,4.176237623762376,43.238980867723946
Task_27062,1796,632,83,94,177,2.8372827804107423,37.46639886907321
Task_27063,2709,372,116,10,126,7.262734584450402,49.94067069656688
Task_27064,1069,413,179,104,283,2.582125603864734,25.98813454418547
Task_27065,1872,357,72,38,110,5.229050279329609,36.570819450642006
Task_27066,1541,103,30,28,58,14.817307692307692,29.399071593446337
Task_27067,655,950,166,24,190,0.6887486855941115,20.125601162228538
Task_27068,2510,406,85,132,217,6.167076167076167,48.55931482972442
Task_27069,2094,668,162,59,221,3.1300448430493275,42.151858910050834
Task_27070,2397,303,66,72,138,7.884868421052632,45.42405392630099
Task_27071,2103,154,118,122,240,13.567741935483872,40.94415263542273
Task_27072,556,152,82,158,240,3.633986928104575,16.71772999237881
Task_27073,2181,488,39,52,91,4.460122699386503,41.95714509390384
Task_27074,1373,678,190,107,297,2.0220913107511045,31.7017213043074
Task_27075,790,446,61,24,85,1.767337807606264,19.273006159319728
Task_27076,2404,542,53,80,133,4.427255985267035,46.6172746858556
Task_27077,2787,693,116,23,139,4.015850144092219,52.306504492896416
Task_27078,1873,300,103,68,171,6.222591362126246,37.117532669837935
Task_27079,2027,168,142,182,324,11.994082840236686,40.318368978435124
Task_27080,2552,572,30,180,210,4.453752181500873,49.795503737264056
Task_27081,1345,529,143,136,279,2.5377358490566038,30.75258935981613
Task_27082,1657,786,183,74,257,2.1054637865311308,35.95201155949306
Task_27083,1393,347,184,121,305,4.002873563218391,31.026400854380544
Task_27084,2250,669,136,88,224,3.3582089552238807,44.955836424097676
Task_27085,2975,922,152,65,217,3.2231852654387865,56.98321587227139
Task_27086,681,850,50,112,162,0.800235017626322,20.467207185363808
Task_27087,1375,380,116,133,249,3.608923884514436,30.61375786837483
Task_27088,2151,77,49,83,132,27.576923076923077,39.96964891045039
Task_27089,882,889,179,16,195,0.9910112359550561,23.29299972038761
Task_27090,2008,522,107,32,139,3.8393881453154877,39.48815737896596
Task_27091,636,306,185,175,360,2.0716612377850163,19.24964272580694
Task_27092,1991,843,62,183,245,2.359004739336493,42.012084866920425
Task_27093,1669,461,177,135,312,3.6125541125541125,35.813342874513914
Task_27094,2790,373,13,37,50,7.459893048128342,50.553448684660644
Task_27095,2040,132,63,142,205,15.338345864661655,39.72093227170269
Task_27096,2407,740,135,199,334,3.2483130904183537,48.57682254603611
Task_27097,2239,854,83,66,149,2.6187134502923977,44.57604561791505
Task_27098,1020,662,163,39,202,1.5384615384615385,24.80898477562148
Task_27099,1646,109,146,25,171,14.963636363636363,31.973943223541443
Task_27100,2754,646,133,168,301,4.256568778979907,53.58206319712563
Task_27101,1161,853,122,10,132,1.3594847775175645,27.00046464760823
Task_27102,2543,770,122,12,134,3.298313878080415,48.648507730218704
Task_27103,2262,291,30,131,161,7.7465753424657535,43.6840182583508
Task_27104,2489,206,169,76,245,12.02415458937198,47.154252700662205
Task_27105,1215,1005,160,30,190,1.2077534791252484,28.99059493820276
Task_27106,1539,900,51,43,94,1.7081021087680355,32.78959597932069
Task_27107,1301,704,48,106,154,1.845390070921986,29.768724664665978
Task_27108,2499,402,184,39,223,6.200992555831266,47.495133914720526
Task_27109,961,511,53,77,130,1.876953125,23.573272331829884
Task_27110,1462,525,34,39,73,2.779467680608365,29.86884403533548
Task_27111,1503,366,40,18,58,4.0953678474114446,29.769529884629367
Task_27112,1441,512,104,115,219,2.8089668615984404,31.917654850308093
Task_27113,2049,668,199,154,353,3.062780269058296,42.699108821513676
Task_27114,2133,690,29,32,61,3.0868306801736614,41.01160718900866
Task_27115,1789,81,175,156,331,21.817073170731707,35.693277381205554
Task_27116,981,298,70,58,128,3.280936454849498,22.95744544064624
Task_27117,2635,397,77,146,223,6.6206030150753765,50.633497035721625
Task_27118,2495,176,33,122,155,14.096045197740112,46.30475571361549
Task_27119,1808,353,193,89,282,5.107344632768362,37.27244427008437
Task_27120,2483,743,194,176,370,3.3373655913978495,49.918756183735866
Task_27121,1103,806,56,55,111,1.3667905824039652,25.97288623324687
Task_27122,2234,143,16,53,69,15.51388888888889,41.0820592228088
Task_27123,2416,475,119,143,262,5.07563025210084,47.469228217037745
Task_27124,1534,565,126,155,281,2.7102473498233217,33.89551901576984
Task_27125,2979,616,82,93,175,4.828200972447326,56.32363870511393
Task_27126,1711,348,95,41,136,4.902578796561604,34.33637637056767
Task_27127,681,161,15,38,53,4.203703703703703,16.53475664110663
Task_27128,2888,416,99,123,222,6.925659472422062,54.53796700332043
Task_27129,2692,186,37,42,79,14.39572192513369,48.65804310407891
Task_27130,997,169,99,102,201,5.864705882352941,23.403996535262877
Task_27131,1656,872,104,52,156,1.8969072164948453,35.37993676180679
Task_27132,2163,573,147,123,270,3.768292682926829,43.78466131807684
Task_27133,618,194,70,122,192,3.169230769230769,17.822372899297424
Task_27134,2414,836,96,117,213,2.884109916367981,48.376130164494974
Task_27135,2960,239,200,57,257,12.333333333333334,54.61003453332163
Task_27136,1924,742,129,194,323,2.58950201884253,40.87471985464378
Task_27137,2041,202,116,167,283,10.054187192118226,40.7325400524971
Task_27138,2334,534,85,72,157,4.3626168224299064,45.13163684022228
Task_27139,1979,246,100,151,251,8.012145748987853,39.74883777526748
Task_27140,959,917,41,171,212,1.0446623093681917,25.37173670141455
Task_27141,954,269,22,143,165,3.533333333333333,23.128784916362054
Task_27142,1725,743,56,30,86,2.318548387096774,35.13400192766524
Task_27143,1692,807,21,144,165,2.094059405940594,36.5252222786624
Task_27144,1872,800,27,19,46,2.337078651685393,36.90989529439727
Task_27145,2864,128,198,128,326,22.2015503875969,53.09042571617643
Task_27146,1134,101,162,197,359,11.117647058823529,25.758498449621708
Task_27147,2417,249,139,67,206,9.668,45.91298450586868
Task_27148,834,515,110,23,133,1.6162790697674418,20.890195297669596
Task_27149,1998,259,112,128,240,7.684615384615385,40.01207450599123
Task_27150,2093,567,126,68,194,3.6848591549295775,41.791341787401734
Task_27151,521,834,91,117,208,0.6239520958083832,18.47725053189435
Task_27152,2091,569,65,22,87,3.668421052631579,40.30248330736322
Task_27153,2081,337,23,161,184,6.15680473372781,41.31460964556697
Task_27154,690,441,175,145,320,1.5610859728506787,20.262474488588584
Task_27155,1379,643,131,154,285,2.141304347826087,31.70219324121743
Task_27156,1060,386,126,158,284,2.739018087855297,25.84352827397299
Task_27157,1092,923,132,63,195,1.1818181818181819,27.03276791447729
Task_27158,2743,974,38,138,176,2.8133333333333335,53.68791142467614
Task_27159,2581,756,17,44,61,3.4095112285336855,48.319141049642745
Task_27160,1159,315,115,200,315,3.6677215189873418,27.382251736243216
Task_27161,1659,437,23,109,132,3.787671232876712,34.58324235048854
Task_27162,1318,664,99,89,188,1.981954887218045,30.03960127564743
Task_27163,2241,155,158,121,279,14.365384615384615,43.29804181544775
Task_27164,635,721,188,74,262,0.8795013850415513,19.585713077313205
Task_27165,2501,394,86,65,151,6.331645569620253,47.19971429503551
Task_27166,1078,793,103,186,289,1.3576826196473553,27.425642739019462
Task_27167,873,562,123,121,244,1.5506216696269983,23.159935388293615
Task_27168,2092,267,200,96,296,7.8059701492537314,41.75495297986571
Task_27169,2583,251,145,186,331,10.25,49.72196716478567
Task_27170,2646,762,20,38,58,3.467889908256881,49.46135775088777
Task_27171,1665,971,31,93,124,1.712962962962963,36.219868993091914
Task_27172,962,748,166,164,330,1.2843791722296396,25.549241820492885
Task_27173,879,523,152,167,319,1.6774809160305344,23.56792851833751
Task_27174,1507,347,146,18,164,4.330459770114943,31.036551158021407
Task_27175,2671,490,74,114,188,5.439918533604888,51.27310916268459
Task_27176,608,752,132,164,296,0.8074369189907038,19.82423603531456
Task_27177,945,301,28,46,74,3.129139072847682,21.006074874969467
Task_27178,2115,275,79,178,257,7.663043478260869,42.19819437739458
Task_27179,695,990,181,127,308,0.7013118062563067,22.0319554526576
Task_27180,2843,425,82,34,116,6.673708920187793,52.198643505268215
Task_27181,633,325,56,188,244,1.9417177914110428,18.917447711574706
Task_27182,1729,962,156,159,315,1.7954309449636552,38.38321392692766
Task_27183,2923,249,55,36,91,11.692,52.493744936149795
Task_27184,1477,705,138,182,320,2.092067988668555,33.64698949605148
Task_27185,1196,170,130,111,241,6.994152046783626,26.657875890030407
Task_27186,2165,186,96,109,205,11.577540106951872,42.394801338914554
Task_27187,1080,275,197,66,263,3.9130434782608696,25.10867971560282
Task_27188,2791,392,178,35,213,7.10178117048346,52.08153406226873
Task_27189,1135,848,190,142,332,1.336866902237927,28.62860166577207
Task_27190,1452,949,190,171,361,1.528421052631579,34.13564455264728
Task_27191,1642,959,80,157,237,1.7104166666666667,36.75464642433528
Task_27192,2923,591,18,71,89,4.9375,54.12826720281189
Task_27193,1475,373,55,44,99,3.943850267379679,30.01919824000591
Task_27194,1115,87,68,24,92,12.670454545454545,22.591558802881394
Task_27195,1887,547,24,179,203,3.4434306569343067,39.154687315416176
Task_27196,1159,390,131,68,199,2.9641943734015346,26.4670090702413
Task_27197,2853,733,85,114,199,3.8869209809264307,54.93429912683689
Task_27198,1050,475,163,147,310,2.2058823529411766,26.068066963378836
Task_27199,2829,220,35,37,72,12.800904977375566,50.53835457071907
Task_27200,1592,540,19,109,128,2.942698706099815,33.84874172071867
Task_27201,1119,397,96,161,257,2.8115577889447234,26.747677527901967
Task_27202,2725,382,197,162,359,7.114882506527415,52.51773996002809
Task_27203,1325,474,118,153,271,2.789473684210526,30.25108531516013
Task_27204,2089,734,134,124,258,2.8421768707482995,43.0679233332246
Task_27205,1818,574,138,110,248,3.161739130434783,38.2064180780387
Task_27206,2666,710,20,107,127,3.749648382559775,51.23296778046932
Task_27207,2371,1005,168,134,302,2.356858846918489,48.59527861832182
Task_27208,610,343,53,147,200,1.7732558139534884,18.349896527128482
Task_27209,2758,629,109,178,287,4.377777777777778,53.54288358732168
Task_27210,1960,945,37,157,194,2.0718816067653276,41.46259227357693
Task_27211,1370,222,145,200,345,6.143497757847534,30.539513375934433
Task_27212,2765,985,32,108,140,2.8042596348884383,53.74117573097303
Task_27213,2510,691,86,99,185,3.6271676300578033,49.13035636724871
Task_27214,1253,444,36,120,156,2.8157303370786515,28.148996548679595
Task_27215,2459,389,13,29,42,6.305128205128205,45.16606851271799
Task_27216,670,157,146,86,232,4.2405063291139244,18.123066495345522
Task_27217,1577,236,129,193,322,6.654008438818566,33.74420172134554
Task_27218,1943,378,49,200,249,5.12664907651715,39.85277582904193
Task_27219,2596,675,17,157,174,3.8402366863905324,50.45904838453953
Task_27220,1989,705,154,143,297,2.81728045325779,41.59647818888844
Task_27221,1584,503,33,108,141,3.142857142857143,33.53252046347512
Task_27222,568,756,165,10,175,0.750330250990753,17.666383658816752
Task_27223,2513,320,198,113,311,7.8286604361370715,48.66474901206272
Task_27224,1718,932,118,152,270,1.8413719185423365,37.90265781833133
Task_27225,1674,315,29,168,197,5.2974683544303796,34.988136675463515
Task_27226,2094,805,29,11,40,2.598014888337469,40.38282024359008
Task_27227,1793,502,199,103,302,3.5646123260437377,37.81519481383737
Task_27228,590,778,122,125,247,0.7573812580231065,19.320613594390718
Task_27229,2513,592,181,69,250,4.237774030354132,48.74812117664113
Task_27230,1583,1005,163,163,326,1.573558648111332,36.215706802664144
Task_27231,1596,210,79,31,110,7.563981042654029,31.705532742641566
Task_27232,2690,264,158,173,331,10.150943396226415,51.4417673579091
Task_27233,2074,494,198,131,329,4.18989898989899,42.40092145886583
Task_27234,2464,977,119,75,194,2.5194274028629855,49.04239181208126
Task_27235,2337,116,146,165,311,19.974358974358974,44.64133927779877
Task_27236,1117,569,151,27,178,1.9596491228070176,25.75067222373203
Task_27237,1086,611,63,142,205,1.7745098039215685,26.698167283589424
Task_27238,867,956,58,42,100,0.9059561128526645,22.37807582367778
Task_27239,2349,993,130,84,214,2.36317907444668,47.445664256257146
Task_27240,1812,410,121,197,318,4.408759124087592,38.030264419148224
Task_27241,2348,964,95,121,216,2.433160621761658,47.76660969078237
Task_27242,1769,901,105,77,182,1.9611973392461197,37.554220134301346
Task_27243,2294,807,22,189,211,2.839108910891089,46.397253020865385
Task_27244,1874,241,44,21,65,7.743801652892562,35.40386362435513
Task_27245,1780,787,52,125,177,2.2588832487309647,37.962951893186805
Task_27246,1388,371,177,154,331,3.7311827956989245,31.190733431146388
Task_27247,1408,499,196,70,266,2.816,31.055417210917465
Task_27248,2483,93,38,195,233,26.414893617021278,46.28438226906892
Task_27249,2884,675,163,143,306,4.266272189349112,55.719146260681875
Task_27250,1594,976,130,124,254,1.631525076765609,35.947712640432314
Task_27251,2795,570,128,44,172,4.89492119089317,52.441193835467544
Task_27252,2765,183,159,96,255,15.027173913043478,51.7394481647022
Task_27253,2539,708,110,30,140,3.5811001410437235,48.51046639079152
Task_27254,758,944,41,44,85,0.8021164021164021,20.62228039536273
Task_27255,1360,625,91,151,242,2.1725239616613417,31.196009734989374
Task_27256,2201,755,105,161,266,2.9113756613756614,44.9983432068581
Task_27257,2267,599,123,103,226,3.7783333333333333,45.28656391697938
Task_27258,1811,630,169,145,314,2.8700475435816166,38.6209683480217
Task_27259,1658,383,129,44,173,4.317708333333333,33.8437107050375
Task_27260,2941,536,107,174,281,5.476722532588455,56.10954721452432
Task_27261,2899,1014,59,103,162,2.8561576354679805,56.18819973129041
Task_27262,1940,617,37,25,62,3.1391585760517797,37.72269890332119
Task_27263,1658,321,88,146,234,5.149068322981367,34.86829362610526
Task_27264,2080,454,111,127,238,4.571428571428571,41.95106707833897
Task_27265,1795,965,192,91,283,1.8581780538302277,39.04836317674758
Task_27266,2180,383,106,106,212,5.677083333333333,43.15361288521757
Task_27267,2266,822,124,115,239,2.753341433778858,46.04884349361905
Task_27268,2798,277,122,126,248,10.06474820143885,52.75330074238881
Task_27269,517,340,60,199,259,1.5161290322580645,17.144837122143556
Task_27270,1361,664,114,146,260,2.0466165413533837,31.35833440442804
Task_27271,1077,795,80,75,155,1.3530150753768844,26.131381566956843
Task_27272,1912,391,109,46,155,4.877551020408164,37.59125390960872
Task_27273,2137,783,35,35,70,2.725765306122449,41.41558236294397
Task_27274,2629,110,150,159,309,23.684684684684683,49.0120126914074
Task_27275,2704,581,19,39,58,4.646048109965636,49.71168911942963
Task_27276,2744,463,200,157,357,5.913793103448276,53.07080973980383
Task_27277,1068,186,151,179,330,5.711229946524064,25.6988476958128
Task_27278,2008,563,70,135,205,3.5602836879432624,41.16351370409787
Task_27279,1659,917,188,143,331,1.8071895424836601,37.182898918446924
Task_27280,815,733,194,102,296,1.1103542234332424,22.8629731139098
Task_27281,2096,897,105,73,178,2.334075723830735,42.64775483049884
Task_27282,2250,347,19,88,107,6.4655172413793105,43.07012810955663
Task_27283,2635,601,145,195,340,4.377076411960133,51.76945630945943
Task_27284,1327,628,61,200,261,2.109697933227345,30.91894443878482
Task_27285,1516,655,164,134,298,2.3109756097560976,33.938900745202076
Task_27286,1423,241,148,138,286,5.880165289256198,31.08601695542697
Task_27287,1659,567,128,127,255,2.920774647887324,35.722972868968036
Task_27288,925,209,71,108,179,4.404761904761905,22.53017114283777
Task_27289,2021,631,176,112,288,3.1977848101265822,41.78450750168556
Task_27290,1964,650,101,120,221,3.0168970814132106,40.651364433641284
Task_27291,2949,867,182,159,341,3.3974654377880182,57.53559036781345
Task_27292,2656,78,193,24,217,33.620253164556964,47.829051129243794
Task_27293,1777,278,59,113,172,6.369175627240144,36.3401498414354
Task_27294,2178,621,84,81,165,3.5016077170418005,43.29201051804916
Task_27295,2498,109,176,140,316,22.70909090909091,46.942046645049594
Task_27296,1680,264,65,66,131,6.339622641509434,33.930177422946066
Task_27297,1831,193,176,120,296,9.438144329896907,37.37846942089506
Task_27298,893,845,197,128,325,1.0555555555555556,24.645261225630037
Task_27299,647,1007,171,53,224,0.6418650793650794,20.641080205690418
Task_27300,628,520,22,146,168,1.2053742802303262,18.53552306244697
Task_27301,2251,218,45,96,141,10.278538812785389,43.113143374316536
Task_27302,2262,496,16,195,211,4.551307847082495,44.90881962083023
Task_27303,2229,339,20,159,179,6.555882352941176,43.51303015823837
Task_27304,2145,659,110,41,151,3.25,42.128497408808016
Task_27305,1188,209,113,14,127,5.6571428571428575,25.2812359387934
Task_27306,1409,338,28,141,169,4.156342182890856,30.52286222480279
Task_27307,1499,428,79,102,181,3.4941724941724943,32.32662737093311
Task_27308,2509,286,123,45,168,8.742160278745645,46.79994896227749
Task_27309,2237,324,156,96,252,6.883076923076923,44.0465742833076
Task_27310,2926,89,182,27,209,32.51111111111111,52.29111493153775
Task_27311,2986,259,164,161,325,11.484615384615385,56.056139531432166
Task_27312,1423,855,33,77,110,1.6623831775700935,31.652216382123125
Task_27313,1782,922,24,97,121,1.9306608884073673,37.91859059975982
Task_27314,2893,857,104,118,222,3.371794871794872,56.02048218257994
Task_27315,2934,990,88,22,110,2.9606458123107973,55.30906401012243
Task_27316,1792,733,144,45,189,2.44141689373297,37.1653908826151
Task_27317,1723,322,110,179,289,5.3343653250774,36.17617517328505
Task_27318,1461,557,80,179,259,2.618279569892473,32.77769793735822
Task_27319,2465,560,97,70,167,4.393939393939394,47.40102587414163
Task_27320,2126,744,157,103,260,2.8536912751677854,43.66364921815521
Task_27321,1748,282,23,101,124,6.176678445229682,35.42490667978709
Task_27322,1661,517,126,198,324,3.2065637065637067,36.01149351436569
Task_27323,2201,350,29,181,210,6.27065527065527,43.517783996783656
Task_27324,2891,767,126,157,283,3.7643229166666665,56.0378885577663
Task_27325,1559,487,85,83,168,3.194672131147541,32.97821718942989
Task_27326,1433,633,127,189,316,2.2602523659305995,32.717181342030294
Task_27327,1879,135,33,121,154,13.816176470588236,36.33588117759276
Task_27328,1905,868,34,32,66,2.192174913693901,37.98901341053176
Task_27329,2218,251,21,62,83,8.801587301587302,41.63460491546426
Task_27330,2113,189,98,106,204,11.121052631578948,41.40059426392382
Task_27331,2277,1018,27,184,211,2.2345436702649657,46.85019578302635
Task_27332,2650,769,156,183,339,3.4415584415584415,52.51670217936438
Task_27333,2011,82,77,101,178,24.228915662650603,38.409313273595366
Task_27334,2827,848,161,48,209,3.32979976442874,54.09642593393357
Task_27335,2941,532,94,193,287,5.51782363977486,56.23528280866345
Task_27336,561,801,102,103,205,0.699501246882793,18.825706121380225
Task_27337,1001,187,94,144,238,5.324468085106383,24.216495693731122
Task_27338,1533,761,25,23,48,2.0118110236220472,31.64414677034152
Task_27339,534,659,53,126,179,0.8090909090909091,17.660641805395183
Task_27340,1171,297,193,47,240,3.9295302013422817,26.253422251537543
Task_27341,2186,514,138,106,244,4.244660194174758,43.8184503037858
Task_27342,2168,726,31,97,128,2.9821182943603852,43.67472505647746
Task_27343,1335,980,67,112,179,1.3608562691131498,31.3792851413247
Task_27344,2704,660,186,34,220,4.090771558245083,51.60244432760863
Task_27345,887,110,174,113,287,7.990990990990991,21.459566848238193
Task_27346,1128,849,71,176,247,1.3270588235294118,28.306747743611197
Task_27347,2651,856,168,27,195,3.093348891481914,51.207566961802854
Task_27348,1942,73,48,87,135,26.243243243243242,36.660785501794294
Task_27349,2840,594,38,43,81,4.773109243697479,52.3787221600384
Task_27350,2565,889,16,130,146,2.8820224719101124,50.26490428432553
Task_27351,1704,833,47,16,63,2.0431654676258995,34.48267978282076
Task_27352,995,187,134,125,259,5.292553191489362,24.104827899544713
Task_27353,2578,652,20,48,68,3.9479326186830015,48.052189436727815
Task_27354,711,356,157,13,170,1.9915966386554622,18.49300789250161
Task_27355,1777,126,99,153,252,13.992125984251969,35.70340368252463
Task_27356,1304,411,78,11,89,3.1650485436893203,27.44902254058039
Task_27357,2572,311,175,84,259,8.243589743589743,48.99585040569664
Task_27358,1197,113,180,171,351,10.5,26.857626234265226
Task_27359,1628,162,128,45,173,9.987730061349692,32.3484350770943
Task_27360,2455,264,75,96,171,9.264150943396226,46.86786897292694
Task_27361,2259,288,96,149,245,7.8166089965397925,44.345537798189035
Task_27362,2112,622,181,104,285,3.390048154093098,43.172065390629676
Task_27363,2978,1018,68,150,218,2.9224730127576053,58.02213479687101
Task_27364,2218,834,124,105,229,2.6562874251497006,45.26613404490198
Task_27365,2381,757,122,108,230,3.1411609498680737,47.61622819869459
Task_27366,1746,551,104,100,204,3.1630434782608696,36.78057304804341
Task_27367,2118,177,45,197,242,11.898876404494382,41.29592535735923
Task_27368,2818,617,55,57,112,4.559870550161812,52.591551046689744
Task_27369,1287,465,188,70,258,2.7618025751072963,28.996253806950318
Task_27370,1262,244,130,92,222,5.151020408163265,28.0962240941053
Task_27371,2891,863,71,182,253,3.346064814814815,56.36813135912721
Task_27372,2362,781,21,98,119,3.020460358056266,46.507681727273386
Task_27373,1117,296,55,120,175,3.760942760942761,26.0012025046356
Task_27374,1764,318,38,182,220,5.529780564263323,36.51700178168766
Task_27375,2107,793,107,29,136,2.6536523929471034,41.95864187879011
Task_27376,1475,639,164,111,275,2.3046875,33.10204095017525
Task_27377,516,433,20,143,163,1.1889400921658986,16.490486866563355
Task_27378,1470,395,94,90,184,3.712121212121212,31.530048129365415
Task_27379,2169,95,104,86,190,22.59375,40.79265873288075
Task_27380,1519,906,191,163,354,1.6747519294377067,35.04992050010426
Task_27381,1804,868,185,164,349,2.0759493670886076,39.43998422849794
Task_27382,2489,180,114,129,243,13.751381215469614,47.09752095795116
Task_27383,1948,904,133,199,332,2.152486187845304,41.80842031912011
Task_27384,1974,199,69,109,178,9.87,39.06103641468925
Task_27385,1746,873,42,30,72,1.997711670480549,35.502306504172545
Task_27386,2897,796,58,32,90,3.6348808030112925,53.86186180330708
Task_27387,671,192,75,169,244,3.476683937823834,19.02901605080345
Task_27388,826,137,132,88,220,5.9855072463768115,20.407865446357288
Task_27389,1343,127,115,90,205,10.4921875,28.43471896969092
Task_27390,1103,909,70,32,102,1.212087912087912,26.102917023607628
Task_27391,911,819,49,20,69,1.1109756097560977,21.931985820869453
Task_27392,589,791,174,159,333,0.7436868686868687,19.74106420393369
Task_27393,1302,868,111,155,266,1.4982738780207134,31.05596754311814
Task_27394,719,382,110,30,140,1.877284595300261,18.66445532836465
Task_27395,2892,79,146,95,241,36.15,52.485891654815056
Task_27396,1283,693,100,32,132,1.8487031700288183,28.59277216407548
Task_27397,1092,389,190,46,236,2.8,25.27399265267233
Task_27398,2917,327,47,91,138,8.893292682926829,53.93300184685493
Task_27399,1196,845,17,115,132,1.41371158392435,28.28401666579074
Task_27400,2955,104,108,48,156,28.142857142857142,52.36508403593505
Task_27401,746,887,88,52,140,0.8400900900900901,20.945692728508977
Task_27402,1976,313,28,183,211,6.292993630573249,39.84195634775163
Task_27403,1156,669,58,167,225,1.7253731343283583,28.14105790367338
Task_27404,1632,155,91,62,153,10.461538461538462,32.289801146964656
Task_27405,828,952,44,170,214,0.8688352570828961,23.47176176916445
Task_27406,1018,615,110,159,269,1.6525974025974026,25.81910500135761
Task_27407,932,900,185,48,233,1.0344062153163152,24.308473562875935
Task_27408,1259,489,189,68,257,2.5693877551020408,28.625380133545324
Task_27409,2211,130,97,165,262,16.87786259541985,42.62122439940713
Task_27410,1124,584,79,101,180,1.9213675213675214,26.877229532038402
Task_27411,1585,405,112,153,265,3.9039408866995076,34.11861201183253
Task_27412,510,97,196,47,243,5.204081632653061,14.445463735748435
Task_27413,1088,561,120,194,314,1.9359430604982206,27.026515157330405
Task_27414,843,673,86,80,166,1.2507418397626113,22.17082616202964
Task_27415,1194,339,153,81,234,3.511764705882353,27.151056874569363
Task_27416,2020,603,175,106,281,3.3443708609271523,41.639879802821355
Task_27417,870,743,74,13,87,1.1693548387096775,21.7197299223611
Task_27418,1768,509,166,120,286,3.466666666666667,37.3945028592962
Task_27419,2772,214,33,87,120,12.893023255813954,51.09814281068537
Task_27420,2950,587,41,81,122,5.017006802721088,55.14892049042415
Task_27421,1383,216,90,43,133,6.373271889400922,28.647671552870975
Task_27422,2199,194,122,103,225,11.276923076923078,42.76781645176973
Task_27423,2023,841,114,109,223,2.4026128266033253,42.17723666852795
Task_27424,1915,727,70,132,202,2.6304945054945055,40.18936718741826
Task_27425,2029,992,153,182,335,2.0433031218529707,43.35426298167575
Task_27426,2086,829,189,50,239,2.513253012048193,42.4868020614765
Task_27427,2254,419,172,136,308,5.366666666666666,44.91971636942128
Task_27428,1177,739,54,163,217,1.5905405405405406,28.628521780504446
Task_27429,1805,1019,192,183,375,1.7696078431372548,40.0566702615692
Task_27430,1227,746,79,33,112,1.642570281124498,27.653347482920875
Task_27431,2435,691,110,179,289,3.51878612716763,48.633889483042445
Task_27432,1676,507,26,129,155,3.2992125984251968,35.08131277484631
Task_27433,2858,870,74,106,180,3.2812858783008036,55.24987323620638
Task_27434,1456,930,99,20,119,1.5639097744360901,31.613461631135493
Task_27435,720,184,161,184,345,3.891891891891892,19.97304163315574
Task_27436,2233,828,69,103,172,2.6936067551266585,45.27457569538634
Task_27437,2988,925,120,165,285,3.226781857451404,58.091700621064625
Task_27438,2298,206,91,151,242,11.101449275362318,44.64610154819434
Task_27439,1958,881,15,121,136,2.2199546485260773,40.654041103361656
Task_27440,565,1019,184,90,274,0.553921568627451,19.684236779188737
Task_27441,1234,502,10,94,104,2.4532803180914513,27.60487352261219
Task_27442,765,464,179,43,222,1.6451612903225807,20.275700664607026
Task_27443,1474,121,97,31,128,12.081967213114755,29.37197733707494
Task_27444,2411,98,34,169,203,24.353535353535353,45.004618829979826
Task_27445,1980,885,62,137,199,2.234762979683973,41.69396230853523
Task_27446,2363,582,36,90,126,4.0531732418524875,46.02763586997526
Task_27447,1157,745,38,137,175,1.5509383378016086,27.890921339099773
Task_27448,1400,701,105,125,230,1.9943019943019944,31.925601361381894
Task_27449,1730,464,164,66,230,3.7204301075268815,35.85503804253018
Task_27450,1407,246,65,24,89,5.696356275303644,28.474175434246614
Task_27451,2649,927,95,186,281,2.8545258620689653,52.80912164448444
Task_27452,1006,621,160,162,322,1.617363344051447,25.891031308568074
Task_27453,1466,880,173,154,327,1.6640181611804767,33.9945174105396
Task_27454,2741,599,164,97,261,4.568333333333333,52.975637295266466
Task_27455,1156,816,27,171,198,1.4149326805385556,28.269670081982667
Task_27456,1155,632,167,20,187,1.8246445497630333,26.58802798085703
Task_27457,1230,993,200,137,337,1.2374245472837022,30.515539623552375
Task_27458,2980,713,174,92,266,4.173669467787115,57.004544082587124
Task_27459,2181,312,58,90,148,6.968051118210862,42.341359859713734
Task_27460,891,221,159,103,262,4.013513513513513,22.455426984755196
Task_27461,2384,750,158,40,198,3.174434087882823,46.713010882257
Task_27462,834,77,124,11,135,10.692307692307692,18.4844108862503
Task_27463,2191,126,178,195,373,17.251968503937007,42.82450006964314
Task_27464,2127,463,200,131,331,4.584051724137931,43.14911832672012
Task_27465,1655,592,29,128,157,2.790893760539629,35.025157888842145
Task_27466,2169,469,111,93,204,4.614893617021276,43.139884041074616
Task_27467,535,589,128,126,254,0.9067796610169492,17.918415555370114
Task_27468,898,695,19,170,189,1.2902298850574712,23.656225691303405
Task_27469,2418,898,193,64,257,2.689655172413793,48.24587806239713
Task_27470,1809,540,199,183,382,3.343807763401109,38.66717932657038
Task_27471,1130,785,53,162,215,1.4376590330788803,27.95943322467573
Task_27472,1164,718,74,77,151,1.6189151599443672,27.318174911190113
Task_27473,2347,528,43,191,234,4.4366729678638945,46.50556001605728
Task_27474,2822,126,99,191,290,22.22047244094488,52.37742171936166
Task_27475,1185,741,115,32,147,1.5970350404312668,27.24129473193337
Task_27476,2524,341,29,15,44,7.380116959064328,45.756977284790885
Task_27477,2870,854,168,198,366,3.3567251461988303,56.41293886809137
Task_27478,2701,267,189,16,205,10.078358208955224,50.0052603508245
Task_27479,536,915,94,138,232,0.5851528384279476,19.10136155425984
Task_27480,1965,277,36,129,165,7.068345323741007,39.153925805865725
Task_27481,2058,606,118,26,144,3.3904448105436575,40.55789612590141
Task_27482,2228,954,30,65,95,2.3329842931937175,44.33998079710028
Task_27483,1342,680,150,171,321,1.9706314243759178,31.418923547848205
Task_27484,945,397,80,125,205,2.3743718592964824,23.781738180396143
Task_27485,1403,1013,190,80,270,1.383629191321499,32.70712716393081
Task_27486,1460,906,113,192,305,1.609702315325248,33.93670590114729
Task_27487,1702,99,169,94,263,17.02,34.07790164202675
Task_27488,2952,125,190,58,248,23.428571428571427,53.64961152740454
Task_27489,583,997,170,48,218,0.5841683366733467,19.367998036600802
Task_27490,1058,221,129,32,161,4.7657657657657655,23.596460585431178
Task_27491,2950,876,181,54,235,3.363740022805017,56.49209194095903
Task_27492,2856,966,16,115,131,2.953464322647363,55.08238505030996
Task_27493,684,1017,89,54,143,0.6719056974459725,20.557653536608388
Task_27494,950,516,48,172,220,1.8375241779497098,24.368015482813536
Task_27495,1705,817,127,115,242,2.084352078239609,37.15850520720845
Task_27496,683,418,123,77,200,1.630071599045346,19.124732098469686
Task_27497,2508,630,135,198,333,3.974643423137876,49.82325615533824
Task_27498,2032,244,72,45,117,8.293877551020408,38.72794088969953
Task_27499,1416,472,83,183,266,2.9936575052854124,31.760293851021927
Task_27500,1121,171,89,182,271,6.517441860465116,25.75825239400521
Task_27501,2872,75,149,63,212,37.78947368421053,51.512986990888095
Task_27502,2888,890,108,27,135,3.2413019079685745,54.568549428564715
Task_27503,1966,611,10,164,174,3.212418300653595,40.35304552783092
Task_27504,1372,601,109,125,234,2.2790697674418605,31.18744511797586
Task_27505,596,725,52,155,207,0.8209366391184573,19.186393995118948
Task_27506,2254,742,18,148,166,3.0336473755047106,45.130594584957656
Task_27507,2114,261,91,47,138,8.068702290076336,40.3147620877367
Task_27508,1236,530,108,139,247,2.327683615819209,28.890101353921665
Task_27509,2524,337,108,170,278,7.4674556213017755,48.83203190114617
Task_27510,1698,193,174,181,355,8.75257731958763,35.63485139878411
Task_27511,805,582,164,94,258,1.3807890222984562,22.087767746964975
Task_27512,2935,753,57,67,124,3.8925729442970822,55.3546878856279
Task_27513,1311,567,157,32,189,2.308098591549296,29.075652608819937
Task_27514,1740,721,85,72,157,2.409972299168975,36.314999671124454
Task_27515,2134,836,40,178,218,2.5495818399044206,44.01134623839473
Task_27516,2126,235,116,146,262,9.008474576271187,42.07339701783563
Task_27517,2842,944,142,131,273,3.0074074074074075,55.733697704513396
Task_27518,855,249,126,119,245,3.42,21.92665816957945
Task_27519,2506,507,129,121,250,4.933070866141732,48.911201561455066
Task_27520,2625,170,173,152,325,15.350877192982455,49.63289998847484
Task_27521,2446,404,72,180,252,6.0395061728395065,47.847727829092115
Task_27522,656,850,95,130,225,0.7708578143360753,20.59632534395385
Task_27523,2274,645,151,22,173,3.5201238390092877,44.368161759642184
Task_27524,1231,257,183,175,358,4.771317829457364,28.485776969388812
Task_27525,2834,728,148,180,328,3.887517146776406,55.24836266025303
Task_27526,1624,484,90,67,157,3.3484536082474228,33.65135961471148
Task_27527,2882,726,95,44,139,3.9642365887207704,54.04364834033992
Task_27528,2731,418,122,111,233,6.5178997613365155,52.09038020237085
Task_27529,2903,422,124,97,221,6.862884160756501,54.78464533145828
Task_27530,2724,437,69,100,169,6.219178082191781,51.67066389644298
Task_27531,1808,533,23,107,130,3.385767790262172,37.23122580225726
Task_27532,1435,947,155,189,344,1.5137130801687764,33.80982416677748
Task_27533,2827,511,98,57,155,5.521484375,52.71684484940479
Task_27534,1766,156,154,103,257,11.248407643312103,35.72169836288411
Task_27535,1347,529,31,66,97,2.5415094339622644,29.047159695854702
Task_27536,1843,773,26,29,55,2.3811369509043927,36.74501342348977
Task_27537,2089,699,97,78,175,2.9842857142857144,42.16516581487366
Task_27538,2334,170,119,108,227,13.649122807017545,44.53743455375218
Task_27539,993,875,51,186,237,1.1335616438356164,26.19653030478486
Task_27540,2292,253,95,30,125,9.023622047244094,43.13134920486912
Task_27541,872,126,38,123,161,6.866141732283465,20.553212353295844
Task_27542,1677,699,181,69,250,2.395714285714286,35.844917327428185
Task_27543,1994,804,155,78,233,2.4770186335403728,41.3041079506876
Task_27544,1676,478,73,17,90,3.498956158663883,33.49479038163093
Task_27545,1450,615,191,147,338,2.353896103896104,32.96760401973702
Task_27546,2842,202,110,136,246,14.0,53.16429125898966
Task_27547,1331,448,133,200,333,2.964365256124722,30.61188245313063
Task_27548,582,657,166,88,254,0.8844984802431611,18.5690424463032
Task_27549,2527,416,136,97,233,6.059952038369304,48.86851695802738
Task_27550,2975,452,95,64,159,6.567328918322295,54.96578974762747
Task_27551,1173,728,161,21,182,1.6090534979423867,27.10779506023283
Task_27552,1967,280,65,86,151,7.0,38.71928376466675
Task_27553,625,941,83,182,265,0.6634819532908705,20.73452945254449
Task_27554,1057,378,200,133,333,2.7889182058047495,25.954749638880795
Task_27555,1090,647,164,61,225,1.6820987654320987,26.205865824516085
Task_27556,2674,865,41,71,112,3.087759815242494,51.421889555044224
Task_27557,1510,651,136,107,243,2.315950920245399,33.54387611649286
Task_27558,2016,1021,171,102,273,1.9726027397260273,42.84163764258748
Task_27559,1566,911,73,70,143,1.7171052631578947,34.177384926833994
Task_27560,938,421,128,197,325,2.2227488151658767,24.26599843109005
Task_27561,730,627,169,152,321,1.1624203821656052,21.45076001347752
Task_27562,2935,133,143,192,335,21.902985074626866,54.38368262700316
Task_27563,1077,661,13,145,158,1.6268882175226587,26.124036289897457
Task_27564,1204,531,150,111,261,2.263157894736842,28.40863777801796
Task_27565,1248,562,51,187,238,2.216696269982238,29.406343384931912
Task_27566,867,317,122,31,153,2.7264150943396226,20.820967579179406
Task_27567,2790,96,141,61,202,28.762886597938145,50.322128597523225
Task_27568,1328,792,133,109,242,1.6746532156368221,31.085583146503684
Task_27569,2283,121,139,26,165,18.71311475409836,42.33670544461223
Task_27570,2934,841,164,152,316,3.4845605700712587,57.093378283148034
Task_27571,658,928,111,186,297,0.7082884822389667,21.297818081567183
Task_27572,1086,944,63,161,224,1.1492063492063491,27.7576007105819
Task_27573,2288,984,60,124,184,2.3228426395939086,46.62231774827281
Task_27574,708,331,154,61,215,2.1325301204819276,19.11818088066438
Task_27575,964,290,52,23,75,3.3127147766323026,21.1934974690996
Task_27576,1984,798,106,94,200,2.4831038798498124,41.24387705101988
Task_27577,2737,670,84,38,122,4.078986587183309,51.373298557982054
Task_27578,2096,686,63,51,114,3.0509461426491993,41.43964785079868
Task_27579,1551,646,80,94,174,2.3972179289026276,33.84230230632495
Task_27580,2320,291,144,120,264,7.945205479452055,45.31064059321884
Task_27581,593,842,124,64,188,0.7034400948991696,18.954652589036254
Task_27582,2683,885,99,150,249,3.028216704288939,52.95111053917498
Task_27583,2333,816,104,47,151,2.8555691554467564,45.60136615045895
Task_27584,2519,798,47,175,222,3.1526908635794744,50.043736040792886
Task_27585,1166,212,185,97,282,5.474178403755869,26.881964449581925
Task_27586,2290,217,71,117,188,10.504587155963304,44.30961847330199
Task_27587,1840,202,121,164,285,9.064039408866995,37.56432869881214
Task_27588,2127,509,111,184,295,4.170588235294118,43.212536285470414
Task_27589,1723,173,109,22,131,9.902298850574713,33.41958902250851
Task_27590,1180,963,85,24,109,1.2240663900414939,27.439983359506886
Task_27591,836,674,46,79,125,1.2385185185185186,21.822010813585422
Task_27592,1048,810,191,104,295,1.2922318125770653,26.858292230159183
Task_27593,2558,256,91,82,173,9.95330739299611,48.15996666436831
Task_27594,1669,619,47,144,191,2.6919354838709677,35.831969469751805
Task_27595,2786,374,21,197,218,7.429333333333333,52.852081498699185
Task_27596,1392,131,24,197,221,10.545454545454545,29.583121547198363
Task_27597,885,125,172,124,296,7.023809523809524,21.80242785782822
Task_27598,2078,332,151,88,239,6.24024024024024,41.21324820898375
Task_27599,2232,238,50,169,219,9.338912133891213,43.78826524169099
Task_27600,2480,933,106,133,239,2.6552462526766596,49.81278051521398
Task_27601,1752,75,55,61,116,23.05263157894737,33.2337898479478
Task_27602,1304,563,185,115,300,2.3120567375886525,30.274198181710066
Task_27603,847,103,121,181,302,8.14423076923077,20.957720119749364
Task_27604,2933,155,103,36,139,18.80128205128205,52.4943617340741
Task_27605,1366,561,71,97,168,2.4306049822064058,30.615926655155345
Task_27606,906,468,118,69,187,1.931769722814499,22.57943589078703
Task_27607,2196,860,153,47,200,2.5505226480836236,44.08566208051601
Task_27608,2369,597,68,15,83,3.9615384615384617,44.757408425544156
Task_27609,1994,533,106,135,241,3.7340823970037453,40.86825993607187
Task_27610,513,877,109,72,181,0.5842824601366743,17.70783142520901
Task_27611,2496,113,108,175,283,21.894736842105264,46.98334539416629
Task_27612,1589,707,68,174,242,2.244350282485876,35.18631218088093
Task_27613,1348,941,179,174,353,1.4309978768577494,32.40557399028879
Task_27614,959,959,138,139,277,0.9989583333333333,25.874223313988
Task_27615,928,279,196,74,270,3.3142857142857145,22.868365301712547
Task_27616,1357,1020,77,21,98,1.3290891283055828,30.388631835193376
Task_27617,628,309,51,35,86,2.0258064516129033,16.438103911329016
Task_27618,892,852,50,178,228,1.0457209847596718,24.383605581124908
Task_27619,1748,722,57,105,162,2.4177040110650068,37.046303751865075
Task_27620,1104,118,130,162,292,9.277310924369749,25.234656977076934
Task_27621,1600,243,120,132,252,6.557377049180328,33.72718046045909
Task_27622,1356,666,65,149,214,2.032983508245877,31.207784725347484
Task_27623,1769,883,23,162,185,2.001131221719457,38.159872194960535
Task_27624,2657,779,194,194,388,3.4064102564102563,52.896020463349
Task_27625,1917,528,32,11,43,3.623818525519849,36.76349543547315
Task_27626,1516,613,113,68,181,2.469055374592834,32.5474829548249
Task_27627,2977,966,164,115,279,3.078593588417787,57.9452987296911
Task_27628,2852,427,69,147,216,6.663551401869159,54.13280926308508
Task_27629,1544,597,117,177,294,2.5819397993311037,34.24542238831598
Task_27630,2539,558,138,182,320,4.542039355992844,50.00259124785813
Task_27631,1319,383,39,141,180,3.4348958333333335,29.268821230149474
Task_27632,2614,785,14,62,76,3.3256997455470736,49.30332866438889
Task_27633,1987,606,126,163,289,3.2734761120263594,41.24636357210662
Task_27634,2847,86,10,60,70,32.724137931034484,49.8097351684257
Task_27635,1470,449,140,128,268,3.2666666666666666,32.416619607228
Task_27636,1361,401,164,173,337,3.3855721393034828,30.915037541195442
Task_27637,1207,987,124,182,306,1.2216599190283401,30.058737832948136
Task_27638,1699,559,145,13,158,3.0339285714285715,34.6416772464263
Task_27639,1065,353,38,64,102,3.0084745762711864,24.07505480558895
Task_27640,1830,497,84,119,203,3.674698795180723,38.00957987630384
Task_27641,902,746,172,33,205,1.2074966532797857,23.297320159818682
Task_27642,1837,935,163,143,306,1.9626068376068375,39.94670654620051
Task_27643,1744,646,148,55,203,2.6955177743431222,36.552015269415875
Task_27644,1665,647,134,187,321,2.5694444444444446,36.45513602753747
Task_27645,1546,1016,124,157,281,1.52015732546706,35.45184138374985
Task_27646,670,914,93,74,167,0.73224043715847,20.28507651923849
Task_27647,2996,387,163,109,272,7.721649484536083,56.35256772013461
Task_27648,1865,558,125,143,268,3.336314847942755,39.038528808017595
Task_27649,1871,775,63,105,168,2.411082474226804,39.249025170041115
Task_27650,707,664,182,30,212,1.063157894736842,19.943791456353775
Task_27651,1101,652,24,103,127,1.6860643185298623,26.319186046712264
Task_27652,963,828,14,164,178,1.1616405307599518,24.955107663755587
Task_27653,661,292,62,150,212,2.255972696245734,19.024548229822003
Task_27654,1238,496,122,186,308,2.4909456740442657,29.158519970201635
Task_27655,1732,356,47,43,90,4.851540616246498,34.07999409736896
Task_27656,2489,186,148,92,240,13.310160427807487,47.52045359757248
Task_27657,2581,662,180,159,339,3.8929110105580693,51.05081160222619
Task_27658,1934,98,76,184,260,19.535353535353536,37.88457719952263
Task_27659,951,125,110,88,198,7.5476190476190474,22.181920401867217
Task_27660,2105,645,159,81,240,3.2585139318885448,42.57415479305135
Task_27661,873,780,83,87,170,1.117797695262484,22.93099002680476
Task_27662,2912,485,92,163,255,5.991769547325103,55.428777758600376
Task_27663,675,391,126,112,238,1.721938775510204,19.479568968098885
Task_27664,2003,89,156,97,253,22.255555555555556,38.74216206269637
Task_27665,1160,955,115,81,196,1.213389121338912,28.298084439794497
Task_27666,1910,738,162,24,186,2.584573748308525,38.90968210948872
Task_27667,891,414,156,48,204,2.146987951807229,22.047448166474776
Task_27668,1379,553,94,81,175,2.4891696750902526,30.50144364627482
Task_27669,1696,931,157,88,245,1.8197424892703862,37.09249500262557
Task_27670,615,775,186,161,347,0.7925257731958762,20.263057075091815
Task_27671,2128,487,119,180,299,4.360655737704918,43.16991166589852
Task_27672,640,603,15,12,27,1.0596026490066226,16.818327215295056
Task_27673,1773,208,169,156,325,8.483253588516746,36.697675251556426
Task_27674,813,592,63,19,82,1.3709949409780775,19.961381890961366
Task_27675,521,819,188,67,255,0.6353658536585366,18.14917957245616
Task_27676,632,700,121,147,268,0.9015691868758916,19.892442417525114
Task_27677,1173,621,146,14,160,1.8858520900321543,26.49794692786944
Task_27678,2350,948,51,150,201,2.476290832455216,47.84914885083155
Task_27679,1443,181,125,123,248,7.928571428571429,30.63658605612726
Task_27680,2026,346,56,39,95,5.838616714697406,38.68468724878167
Task_27681,2331,535,177,110,287,4.348880597014926,46.38116294660392
Task_27682,1157,600,28,29,57,1.9251247920133112,25.338414433843756
Task_27683,1538,979,195,182,377,1.5693877551020408,35.67969892121558
Task_27684,1193,868,27,92,119,1.3728423475258917,28.178721187196086
Task_27685,605,589,25,25,50,1.0254237288135593,16.67090155871571
Task_27686,1759,974,59,160,219,1.804102564102564,38.619308356982565
Task_27687,2667,300,93,59,152,8.86046511627907,49.50681492394949
Task_27688,2686,822,34,16,50,3.2636695018226,50.05387744546545
Task_27689,1848,450,186,77,263,4.097560975609756,37.94682099450523
Task_27690,2535,783,78,96,174,3.233418367346939,49.97040162214763
Task_27691,2559,432,176,11,187,5.909930715935335,48.22950718331442
Task_27692,2125,142,35,129,164,14.86013986013986,40.73327808140214
Task_27693,2647,836,154,25,179,3.162485065710872,50.816929345870875
Task_27694,672,493,89,50,139,1.360323886639676,18.31400237404385
Task_27695,690,996,107,145,252,0.6920762286860582,21.77359339239933
Task_27696,2156,275,154,65,219,7.811594202898551,41.93857158256167
Task_27697,2423,686,137,63,200,3.526928675400291,47.395741269988235
Task_27698,2561,84,75,131,206,30.129411764705882,47.37745475132741
Task_27699,1712,460,27,29,56,3.713665943600868,33.683080291487876
Task_27700,2775,251,58,184,242,11.011904761904763,52.50610934738979
Task_27701,2792,307,194,106,300,9.064935064935066,52.9711782267953
Task_27702,1570,981,123,137,260,1.5987780040733197,35.62899794119002
Task_27703,2401,790,170,76,246,3.0353982300884956,47.7004129408892
Task_27704,1131,116,134,28,162,9.666666666666666,23.991641905223688
Task_27705,838,131,155,124,279,6.348484848484849,21.00685747425231
Task_27706,1483,528,151,81,232,2.8034026465028354,32.318793703145765
Task_27707,1988,100,35,16,51,19.683168316831683,36.177528856171314
Task_27708,2169,619,148,122,270,3.4983870967741937,44.024091535619334
Task_27709,1730,173,153,105,258,9.942528735632184,35.14046055558497
Task_27710,2488,561,118,195,313,4.427046263345196,49.19213389015024
Task_27711,1839,916,104,76,180,2.005452562704471,38.69951372206766
Task_27712,2690,116,56,66,122,22.99145299145299,48.50270467327169
Task_27713,2307,582,118,87,205,3.9571183533447685,45.493666375396856
Task_27714,520,327,177,67,244,1.5853658536585367,16.343040857511724
Task_27715,1824,282,30,164,194,6.445229681978798,37.22860742649537
Task_27716,2692,833,10,49,59,3.2278177458033572,50.40684193517427
Task_27717,1086,495,124,28,152,2.189516129032258,24.80990472506969
Task_27718,1878,570,151,131,282,3.2889667250437826,39.32790367584252
Task_27719,1860,482,113,145,258,3.8509316770186337,38.67524072087212
Task_27720,1583,946,147,29,176,1.6715945089757127,34.37582780890414
Task_27721,1321,220,178,13,191,5.97737556561086,27.98887914687022
Task_27722,1359,697,136,73,209,1.9469914040114613,30.68593064521737
Task_27723,962,518,157,120,277,1.8535645472061657,24.62162126657728
Task_27724,607,695,161,151,312,0.8721264367816092,19.67747816776537
Task_27725,2532,1023,164,132,296,2.47265625,51.172745384592794
Task_27726,894,496,31,43,74,1.7987927565392354,20.848559281698737
Task_27727,2300,505,15,164,179,4.545454545454546,45.250750565587396
Task_27728,1595,652,20,61,81,2.442572741194487,33.01668492038768
Task_27729,2165,125,57,26,83,17.182539682539684,39.531377966491725
Task_27730,1863,402,188,81,269,4.622828784119107,38.09725796995033
Task_27731,1556,779,37,14,51,1.994871794871795,31.95294574563428
Task_27732,879,746,178,74,252,1.176706827309237,23.46298828904879
Task_27733,2793,73,52,102,154,37.74324324324324,50.07337598933875
Task_27734,631,666,27,192,219,0.9460269865067467,19.54844548520146
Task_27735,2140,524,169,69,238,4.076190476190476,42.57063689633909
Task_27736,964,460,17,103,120,2.0911062906724514,23.349498132859896
Task_27737,1523,373,37,181,218,4.072192513368984,32.88327000781658
Task_27738,2959,270,47,147,194,10.918819188191883,55.1100097057192
Task_27739,2014,737,76,30,106,2.7289972899728996,39.967565124219554
Task_27740,1320,857,57,165,222,1.5384615384615385,31.285659247266434
Task_27741,2009,749,197,90,287,2.6786666666666665,41.76367326021159
Task_27742,1802,410,176,70,246,4.384428223844282,36.916800377657665
Task_27743,683,679,103,179,282,1.0044117647058823,20.666821128039263
Task_27744,870,781,155,78,233,1.1125319693094629,23.34574621714272
Task_27745,737,781,24,159,183,0.9424552429667519,21.174442587613296
Task_27746,1723,980,32,30,62,1.7563710499490317,35.48162857489555
Task_27747,1129,559,13,168,181,2.0160714285714287,26.90918277721727
Task_27748,1048,783,146,12,158,1.336734693877551,25.04328505745865
Task_27749,2999,824,65,79,144,3.6351515151515152,56.82098342024856
Task_27750,1850,709,177,105,282,2.6056338028169015,39.28387671225889
Task_27751,2732,790,69,178,247,3.4538558786346396,53.581356084760245
Task_27752,1994,824,64,142,206,2.416969696969697,41.764449876686065
Task_27753,2693,683,124,169,293,3.9371345029239766,52.698663840513824
Task_27754,661,369,10,178,188,1.7864864864864864,19.0383373588611
Task_27755,2441,884,64,108,172,2.75819209039548,48.75959956628154
Task_27756,766,601,176,20,196,1.2724252491694352,20.415983655246855
Task_27757,1392,371,13,138,151,3.7419354838709675,30.147826357729766
Task_27758,2013,994,27,155,182,2.023115577889447,42.24002298574401
Task_27759,2765,845,14,71,85,3.268321513002364,52.44884497396516
Task_27760,1641,958,138,47,185,1.7111574556830031,35.3841390678645
Task_27761,817,588,17,136,153,1.3870967741935485,21.493583327059834
Task_27762,672,233,13,138,151,2.871794871794872,18.31592046791366
Task_27763,1343,347,29,17,46,3.8591954022988504,27.106320528050123
Task_27764,2358,826,136,120,256,2.8512696493349456,47.60292806868977
Task_27765,1632,910,128,192,320,1.7914379802414928,36.75557532711791
Task_27766,1817,746,37,178,215,2.43239625167336,38.70196070744395
Task_27767,622,200,148,125,273,3.0945273631840795,18.220053666710854
Task_27768,1421,687,196,161,357,2.065406976744186,32.8397138098245
Task_27769,2725,408,81,28,109,6.662591687041565,50.17438429832588
Task_27770,2707,903,163,118,281,2.9944690265486726,53.48333423509562
Task_27771,2470,343,63,38,101,7.180232558139535,45.78064665715319
Task_27772,2783,735,60,59,119,3.78125,52.48354854693593
Task_27773,1378,467,125,126,251,2.9444444444444446,30.938123673511086
Task_27774,1026,318,52,164,216,3.2163009404388716,24.959663404348387
Task_27775,1195,432,143,192,335,2.759815242494226,28.405845980352144
Task_27776,515,207,14,153,167,2.4759615384615383,15.973012453998109
Task_27777,988,416,63,115,178,2.369304556354916,24.204948860573158
Task_27778,614,355,114,131,245,1.7247191011235956,18.460582017760423
Task_27779,2323,459,98,179,277,5.05,46.079477632187825
Task_27780,2324,871,74,187,261,2.665137614678899,47.457487686908856
Task_27781,1763,591,166,130,296,2.9780405405405403,37.634797393832926
Task_27782,1522,365,166,170,336,4.158469945355192,33.33715458055544
Task_27783,616,490,39,65,104,1.2545824847250509,17.350895817628714
Task_27784,1991,686,195,167,362,2.898107714701601,41.89663880717258
Task_27785,1022,865,16,47,63,1.1801385681293302,24.209383833668735
Task_27786,2690,783,69,43,112,3.431122448979592,50.88335162665419
Task_27787,2150,663,99,83,182,3.2379518072289155,42.91888917507388
Task_27788,2111,654,176,66,242,3.2229007633587785,42.54500482161024
Task_27789,1049,696,128,107,235,1.5050215208034434,26.30352316744064
Task_27790,1627,714,130,59,189,2.2755244755244757,34.72462136030423
Task_27791,1459,257,175,186,361,5.655038759689923,32.11822134077579
Task_27792,2190,172,88,90,178,12.658959537572255,41.69537104958774
Task_27793,1123,706,47,88,135,1.5884016973125885,26.675772998894555
Task_27794,1906,183,119,101,220,10.358695652173912,38.00200659429989
Task_27795,1074,989,36,195,231,1.084848484848485,27.531315480367628
Task_27796,989,376,75,72,147,2.623342175066313,23.460432065572956
Task_27797,1657,564,58,51,109,2.932743362831858,34.02947143729293
Task_27798,2868,128,197,153,350,22.232558139534884,53.2982056649908
Task_27799,1934,732,80,134,214,2.6384720327421554,40.54988873118666
Task_27800,683,547,175,29,204,1.2463503649635037,19.169555251113646
Task_27801,2111,350,93,141,234,6.014245014245014,42.214703136519084
Task_27802,2328,304,135,100,235,7.632786885245902,45.32241939570031
Task_27803,2000,134,39,63,102,14.814814814814815,37.48388472469971
Task_27804,1694,296,107,69,176,5.703703703703703,34.30641502894051
Task_27805,563,480,46,162,208,1.1704781704781704,17.84084431883674
Task_27806,1692,538,164,119,283,3.1391465677179964,36.268289294856885
Task_27807,1595,878,200,130,330,1.8145620022753128,36.024059764097366
Task_27808,793,348,20,65,85,2.2722063037249285,19.530429993422462
Task_27809,1622,391,51,93,144,4.137755102040816,33.910389515747084
Task_27810,1746,997,173,13,186,1.749498997995992,37.01406904818861
Task_27811,2738,958,172,153,325,2.855057351407716,54.39604137198171
Task_27812,1336,208,68,197,265,6.392344497607655,29.710459364013285
Task_27813,590,131,157,124,281,4.46969696969697,17.111484765502375
Task_27814,1104,954,132,194,326,1.156020942408377,28.473307411326317
Task_27815,1042,757,60,124,184,1.3746701846965699,26.104373362485358
Task_27816,683,125,116,189,305,5.420634920634921,18.75923613497815
Task_27817,516,628,161,174,335,0.8203497615262321,18.157685526696813
Task_27818,2969,639,94,33,127,4.6390625,55.178783284129885
Task_27819,2415,301,181,83,264,7.996688741721854,46.49995212597532
Task_27820,1217,488,103,154,257,2.488752556237219,28.524063661173372
Task_27821,2576,367,163,105,268,7.0,49.61616487709106
Task_27822,2268,914,145,182,327,2.4786885245901638,46.862670270255386
Task_27823,644,1000,32,49,81,0.6433566433566433,19.26974876922769
Task_27824,2501,233,152,86,238,10.688034188034187,47.52913640273752
Task_27825,1416,176,24,86,110,8.0,28.86865587657364
Task_27826,1319,452,97,150,247,2.911699779249448,29.997442681221116
Task_27827,619,293,124,164,288,2.1054421768707483,18.59882941156173
Task_27828,949,314,67,62,129,3.0126984126984127,22.481263262517725
Task_27829,900,209,43,102,145,4.285714285714286,21.780836315985226
Task_27830,1030,718,19,17,36,1.4325452016689848,23.070652923730734
Task_27831,743,885,107,42,149,0.8386004514672686,20.633212825948203
Task_27832,2110,164,51,20,71,12.787878787878787,38.69510688527796
Task_27833,1879,172,165,167,332,10.861271676300579,37.91828507543142
Task_27834,842,1022,63,14,77,0.823069403714565,21.556002291399654
Task_27835,1807,937,149,82,231,1.9264392324093818,38.766786352680924
Task_27836,1897,234,63,130,193,8.072340425531914,38.246031268980715
Task_27837,2428,927,173,73,246,2.6163793103448274,48.50680617430911
Task_27838,1898,941,151,30,181,2.0148619957537157,39.36439940382521
Task_27839,879,816,128,53,181,1.0758873929008568,23.03945215285836
Task_27840,1872,348,184,121,305,5.363896848137536,38.60631550815176
Task_27841,2196,894,95,116,211,2.453631284916201,45.110000833469115
Task_27842,1663,853,184,10,194,1.9473067915690867,35.44155350471515
Task_27843,2466,503,90,61,151,4.892857142857143,46.94064278940928
Task_27844,2436,312,186,195,381,7.782747603833866,47.855133299886745
Task_27845,1287,886,113,66,179,1.4509582863585118,29.699219645802952
Task_27846,1948,928,74,95,169,2.0968783638320776,40.937364887758406
Task_27847,512,675,146,76,222,0.757396449704142,17.291723555759138
Task_27848,1500,855,39,88,127,1.7523364485981308,33.115354700784756
Task_27849,2817,841,76,148,224,3.3456057007125892,54.957305974344926
Task_27850,1078,878,90,176,266,1.2263936291240045,27.52928588328737
Task_27851,1012,819,178,120,298,1.2341463414634146,26.321685584570247
Task_27852,2522,762,138,35,173,3.3053735255570116,48.75495054707247
Task_27853,2071,776,37,199,236,2.6653796653796653,42.945131922891484
Task_27854,2183,194,152,42,194,11.194871794871794,41.64932670412072
Task_27855,1250,710,187,72,259,1.7580872011251758,29.20586279021282
Task_27856,1971,686,50,86,136,2.868995633187773,40.218046060032805
Task_27857,1412,465,190,40,230,3.0300429184549356,30.56439718653401
Task_27858,807,448,162,74,236,1.7973273942093542,21.339361676053773
Task_27859,2984,484,117,92,209,6.152577319587629,56.07566108312067
Task_27860,2586,385,171,16,187,6.699481865284974,48.47555264771503
Task_27861,1374,615,110,54,164,2.2305194805194803,30.30751871114788
Task_27862,1339,890,115,95,210,1.5028058361391694,31.34199338214582
Task_27863,582,600,94,86,180,0.9683860232945092,17.923157435499295
Task_27864,2523,1023,107,143,250,2.4638671875,50.83891863008787
Task_27865,2052,133,47,132,179,15.313432835820896,39.471795954870444
Task_27866,2960,342,52,119,171,8.629737609329446,55.15982097352646
Task_27867,1434,738,163,91,254,1.9404600811907984,32.491778560069484
Task_27868,1738,495,178,92,270,3.504032258064516,36.661107804971756
Task_27869,2753,252,188,74,262,10.881422924901186,51.57969027185619
Task_27870,2112,306,124,15,139,6.879478827361564,40.24413310521379
Task_27871,2110,621,44,49,93,3.392282958199357,41.08753390813332
Task_27872,700,419,193,92,285,1.6666666666666667,20.044925523005762
Task_27873,1523,284,113,136,249,5.343859649122807,32.64328845539304
Task_27874,2169,934,139,125,264,2.3197860962566845,44.98876491365785
Task_27875,2625,267,160,65,225,9.794776119402986,49.349426398382754
Task_27876,2792,190,112,10,122,14.61780104712042,50.61175577995107
Task_27877,2515,89,174,173,347,27.944444444444443,47.28479031121674
Task_27878,2337,834,116,44,160,2.798802395209581,45.74776705537453
Task_27879,2287,668,93,63,156,3.4185351270553066,44.782309398835416
Task_27880,2972,183,155,164,319,16.152173913043477,55.35905730923205
Task_27881,2774,774,72,47,119,3.5793548387096776,52.2494184575581
Task_27882,1438,607,137,27,164,2.3651315789473686,30.983722452337243
Task_27883,1947,407,175,165,340,4.772058823529412,40.209039100578686
Task_27884,1596,251,64,153,217,6.333333333333333,33.692884341876386
Task_27885,1443,266,162,37,199,5.404494382022472,30.283320932599192
Task_27886,1120,509,36,194,230,2.196078431372549,27.00042157929383
Task_27887,1164,156,59,106,165,7.414012738853503,25.774501157393
Task_27888,919,593,178,42,220,1.5471380471380471,23.10406577320767
Task_27889,2982,872,156,186,342,3.415807560137457,58.11823655870737
Task_27890,1667,212,74,68,142,7.826291079812207,33.531690719696186
Task_27891,2600,533,12,63,75,4.868913857677903,48.27717672377566
Task_27892,704,692,70,95,165,1.0158730158730158,20.408125504608755
Task_27893,2345,79,187,32,219,29.3125,43.08192323337595
Task_27894,2396,754,155,200,355,3.1735099337748345,48.542680160206054
Task_27895,2137,842,129,15,144,2.534994068801898,42.41168533236563
Task_27896,2985,575,172,179,351,5.182291666666667,57.254910944076606
Task_27897,1257,1015,106,23,129,1.2372047244094488,29.09442836958897
Task_27898,2378,248,192,115,307,9.550200803212851,46.259642178514355
Task_27899,2040,419,47,45,92,4.857142857142857,39.21638522952009
Task_27900,2338,528,162,142,304,4.4196597353497165,46.59308881817679
Task_27901,1019,557,120,52,172,1.8261648745519714,24.582011241152372
Task_27902,929,574,16,79,95,1.6156521739130434,22.683714851382433
Task_27903,691,495,108,91,199,1.3931451612903225,19.65076451337077
Task_27904,1789,335,174,120,294,5.324404761904762,37.19930292596409
Task_27905,975,338,29,18,47,2.8761061946902653,21.265125369361943
Task_27906,1123,934,185,194,379,1.2010695187165776,28.951357454394238
Task_27907,1158,519,15,32,47,2.226923076923077,25.028476230497223
Task_27908,666,748,180,35,215,0.8891855807743658,19.619552517994197
Task_27909,585,374,197,199,396,1.56,18.81254204265896
Task_27910,763,626,59,53,112,1.2169059011164274,20.032913538538764
Task_27911,2166,271,156,181,337,7.963235294117647,43.22441679505101
Task_27912,2017,607,96,74,170,3.317434210526316,40.55891864933529
Task_27913,1732,782,189,91,280,2.212005108556833,37.46711215388385
Task_27914,1585,398,44,22,66,3.9724310776942358,31.3851656550992
Task_27915,1228,578,133,63,196,2.1208981001727114,28.111690623502906
Task_27916,931,540,122,143,265,1.7208872458410351,24.165828467831982
Task_27917,1693,280,141,64,205,6.02491103202847,34.55787068220149
Task_27918,1103,219,137,58,195,5.013636363636364,24.916623117817895
Task_27919,1002,952,143,94,237,1.0514165792235046,26.197043302579075
Task_27920,1372,328,104,45,149,4.170212765957447,28.804308066908153
Task_27921,932,250,41,109,150,3.7131474103585655,22.37597324080619
Task_27922,2882,937,96,156,252,3.0724946695095947,56.34050598570182
Task_27923,1110,652,42,122,164,1.6998468606431854,26.76237749827139
Task_27924,2854,351,185,94,279,8.107954545454545,53.93726768250681
Task_27925,1110,416,140,114,254,2.661870503597122,26.53043301189094
Task_27926,2154,975,117,25,142,2.206967213114754,43.18121302313087
Task_27927,1514,677,138,106,244,2.2330383480825957,33.691635064855376
Task_27928,2081,169,191,184,375,12.241176470588234,41.40159090155083
Task_27929,2503,440,125,63,188,5.675736961451247,47.772071318438606
Task_27930,2548,1000,77,132,209,2.5454545454545454,51.08846210745767
Task_27931,2189,179,147,75,222,12.161111111111111,41.934525797291805
Task_27932,874,282,81,175,256,3.088339222614841,22.570110929886496
Task_27933,1193,132,180,193,373,8.969924812030076,27.12475492067131
Task_27934,875,693,102,61,163,1.260806916426513,22.470339938165864
Task_27935,2650,160,117,11,128,16.459627329192546,48.12165717912359
Task_27936,2993,963,114,31,145,3.104771784232365,56.61257017780806
Task_27937,2748,442,74,75,149,6.203160270880361,51.57319525917322
Task_27938,709,217,78,190,268,3.2522935779816513,19.853375213177053
Task_27939,1099,643,93,48,141,1.7065217391304348,25.624264205105487
Task_27940,1209,986,60,128,188,1.2249240121580547,29.542903330619296
Task_27941,2738,403,54,136,190,6.7772277227722775,52.14180866115233
Task_27942,1709,828,159,57,216,2.0615199034981906,36.554072119848904
Task_27943,1765,647,80,89,169,2.7237654320987654,36.95484857553403
Task_27944,2215,135,41,54,95,16.28676470588235,40.797415664017144
Task_27945,812,395,22,68,90,2.0505050505050506,20.055570345139657
Task_27946,2958,827,91,130,221,3.572463768115942,57.01848372255768
Task_27947,2669,414,179,89,268,6.4313253012048195,51.03394823559332
Task_27948,718,980,172,123,295,0.7319062181447502,22.213275038595
Task_27949,1194,406,39,34,73,2.9336609336609336,25.27407433953093
Task_27950,2220,902,129,162,291,2.4584717607973423,45.87309793200554
Task_27951,2396,716,170,41,211,3.3417015341701535,46.850860737359824
Task_27952,2835,605,188,93,281,4.678217821782178,54.46879646368361
Task_27953,1290,855,66,197,263,1.5070093457943925,31.000505416934303
Task_27954,1911,840,182,157,339,2.272294887039239,40.992765398976545
Task_27955,638,174,180,65,245,3.645714285714286,17.547456075130828
Task_27956,2595,248,88,51,139,10.421686746987952,48.08149312031765
Task_27957,1291,777,70,161,231,1.6593830334190232,30.619848450473295
Task_27958,1194,717,18,72,90,1.6629526462395543,27.156415797334816
Task_27959,1035,1021,73,182,255,1.012720156555773,27.267536524006474
Task_27960,1707,73,24,184,208,23.06756756756757,33.85920539486009
Task_27961,1462,634,196,188,384,2.3023622047244094,33.48462880710688
Task_27962,2463,484,192,105,297,5.078350515463917,48.3444577772784
Task_27963,1127,518,82,168,250,2.1714836223506744,27.27506329989818
Task_27964,1370,779,130,90,220,1.7564102564102564,31.422818350247823
Task_27965,2501,630,177,73,250,3.9635499207606975,48.748202483825175
Task_27966,1672,133,173,125,298,12.477611940298507,34.23242289667922
Task_27967,2919,949,152,152,304,3.0726315789473686,57.1399843488897
Task_27968,1293,82,198,47,245,15.578313253012048,26.65283262974077
Task_27969,644,377,36,29,65,1.7037037037037037,16.473872443359507
Task_27970,728,376,32,182,214,1.9310344827586208,20.318358542534433
Task_27971,1363,697,39,79,118,1.9527220630372493,30.349846491664422
Task_27972,2222,496,44,42,86,4.470824949698189,42.284676352981336
Task_27973,2914,632,195,50,245,4.60347551342812,55.009449910841276
Task_27974,1430,863,155,31,186,1.6550925925925926,31.761455842304713
Task_27975,1806,920,168,85,253,1.9609120521172638,38.810180567928825
Task_27976,2084,65,42,18,60,31.575757575757574,36.589962930202226
Task_27977,1685,676,14,46,60,2.488921713441654,33.98203056434591
Task_27978,1678,698,170,83,253,2.400572246065808,36.06856666722983
Task_27979,1144,845,30,150,180,1.3522458628841607,27.900985656385576
Task_27980,2125,712,57,156,213,2.9803646563814867,43.57191586610467
Task_27981,1473,692,18,81,99,2.1255411255411256,31.631033367160594
Task_27982,898,404,64,51,115,2.217283950617284,21.56920887346891
Task_27983,1275,283,110,28,138,4.48943661971831,27.071562622488567
Task_27984,581,594,104,182,286,0.9764705882352941,18.875679463103232
Task_27985,2090,358,55,128,183,5.821727019498607,41.52468965854825
Task_27986,2965,329,118,151,269,8.984848484848484,55.71060466449992
Task_27987,2079,657,114,62,176,3.1595744680851063,41.53810079052847
Task_27988,2797,355,162,46,208,7.856741573033708,52.00964065464495
Task_27989,1106,435,115,37,152,2.536697247706422,24.982802099118867
Task_27990,1011,150,160,31,191,6.695364238410596,22.79577191730876
Task_27991,2514,595,181,193,374,4.218120805369128,49.98441941637452
Task_27992,2835,850,129,188,317,3.3313748531139837,55.6103339805746
Task_27993,2257,153,114,134,248,14.655844155844155,43.42045976120051
Task_27994,2440,651,139,25,164,3.7423312883435584,46.981361797203505
Task_27995,2065,107,37,137,174,19.12037037037037,39.43469224308239
Task_27996,2963,684,192,76,268,4.3255474452554745,56.36813766781379
Task_27997,2714,506,110,186,296,5.353057199211046,52.50357873741431
Task_27998,1022,249,74,125,199,4.088,24.4985123738396
Task_27999,1116,481,73,152,225,2.315352697095436,26.882948238867495
Task_28000,1076,864,141,104,245,1.2439306358381503,27.212814556442154
Task_28001,863,281,146,138,284,3.0602836879432624,22.361265464911
Task_28002,1869,937,182,110,292,1.992537313432836,40.34852130030796
Task_28003,2523,835,189,125,314,3.0179425837320575,50.51407956758059
Task_28004,2451,296,92,103,195,8.252525252525253,47.14081029342831
Task_28005,2551,77,75,106,181,32.705128205128204,46.83449118726575
Task_28006,1232,798,96,89,185,1.541927409261577,28.985559695692306
Task_28007,2887,370,187,118,305,7.781671159029649,54.73222444292793
Task_28008,882,113,27,86,113,7.7368421052631575,20.114704423371744
Task_28009,2368,976,66,116,182,2.4237461617195497,47.83052771325407
Task_28010,1826,184,189,195,384,9.87027027027027,37.61504134595827
Task_28011,892,608,47,36,83,1.464696223316913,21.521170581466418
Task_28012,583,937,75,136,211,0.6215351812366737,19.908767077381874
Task_28013,2990,152,14,39,53,19.54248366013072,52.692720113477016
Task_28014,689,400,64,71,135,1.7182044887780548,18.74676542333259
Task_28015,1146,999,132,79,211,1.146,28.358702829680823
Task_28016,1429,840,181,73,254,1.699167657550535,32.434100746791124
Task_28017,1641,447,76,26,102,3.6629464285714284,33.11593148820082
Task_28018,2782,706,69,108,177,3.934936350777935,53.508728064854346
Task_28019,881,133,199,61,260,6.574626865671642,21.097269138105762
Task_28020,1402,892,146,46,192,1.5699888017917134,31.555967437962607
Task_28021,1650,669,187,12,199,2.462686567164179,34.694396896705335
Task_28022,2296,264,44,194,238,8.664150943396226,44.84051038483451
Task_28023,534,952,108,64,172,0.5603357817418678,18.242302048155427
Task_28024,1314,296,188,121,309,4.424242424242424,29.62778873704019
Task_28025,734,842,188,119,307,0.8706998813760379,22.074717338249584
Task_28026,2400,779,78,144,222,3.076923076923077,48.133721495587224
Task_28027,2955,71,159,185,344,41.041666666666664,53.96289062915801
Task_28028,698,187,81,139,220,3.7127659574468086,19.376353021779355
Task_28029,1423,474,98,19,117,2.9957894736842103,29.659030854971817
Task_28030,2893,1017,68,199,267,2.841846758349705,56.96466843673999
Task_28031,2333,574,188,138,326,4.057391304347826,46.754240524203645
Task_28032,2416,370,19,160,179,6.512129380053908,46.5768617850498
Task_28033,2779,339,98,144,242,8.173529411764706,52.685617413057514
Task_28034,1500,261,74,96,170,5.7251908396946565,31.77095289309088
Task_28035,2589,253,99,161,260,10.192913385826772,49.46923363695004
Task_28036,2366,898,48,156,204,2.631813125695217,47.89644345944077
Task_28037,1351,215,167,62,229,6.25462962962963,28.997058150023346
Task_28038,756,743,164,32,196,1.0161290322580645,20.863235666314218
Task_28039,1275,692,23,66,89,1.8398268398268398,28.345647736910035
Task_28040,1863,105,200,148,348,17.57547169811321,37.079568876752525
Task_28041,2986,70,22,159,181,42.056338028169016,53.51422222577011
Task_28042,1230,268,146,13,159,4.5724907063197024,26.287368992088872
Task_28043,1282,526,130,40,170,2.4326375711574952,28.228319287150345
Task_28044,1569,161,94,56,150,9.685185185185185,31.475179126012346
Task_28045,916,790,176,144,320,1.1580278128950696,24.886366214161907
Task_28046,546,243,86,37,123,2.237704918032787,15.384016112429721
Task_28047,1371,511,131,154,285,2.677734375,31.160887996103284
Task_28048,2033,579,53,86,139,3.5051724137931033,40.79362628521681
Task_28049,1816,165,155,187,342,10.939759036144578,37.04116975674224
Task_28050,1424,146,53,174,227,9.687074829931973,30.3156857517744
Task_28051,2821,1021,134,176,310,2.76027397260274,55.87400576693648
Task_28052,2224,69,72,90,162,31.771428571428572,41.261782443126826
Task_28053,2685,236,144,152,296,11.329113924050633,51.069260380997584
Task_28054,711,244,188,91,279,2.9020408163265308,19.60126707466445
Task_28055,734,514,84,116,200,1.4252427184466019,20.623954215927725
Task_28056,1134,583,26,129,155,1.9417808219178083,26.738795292667145
Task_28057,2756,958,126,60,186,2.8738269030239834,53.25114316202621
Task_28058,2647,769,147,179,326,3.4376623376623376,52.40471974402228
Task_28059,2278,747,87,30,117,3.0454545454545454,44.299371871953035
Task_28060,1301,826,137,28,165,1.573155985489722,29.546971136825846
Task_28061,835,800,17,196,213,1.042446941323346,23.03641457242256
Task_28062,801,697,19,40,59,1.1475644699140402,20.080305935230175
Task_28063,2902,102,61,180,241,28.174757281553397,53.02993666498791
Task_28064,1856,488,125,126,251,3.7955010224948875,38.57171342506409
Task_28065,2213,579,147,33,180,3.81551724137931,43.21135250329536
Task_28066,1939,858,198,17,215,2.2572759022118745,39.846222410105064
Task_28067,2797,776,66,176,242,3.5997425997425996,54.54276497922058
Task_28068,2440,207,187,184,371,11.73076923076923,47.472308464216496
Task_28069,576,514,152,139,291,1.1184466019417476,18.429826114258958
Task_28070,1256,195,105,167,272,6.408163265306122,28.20741678701927
Task_28071,2175,346,37,183,220,6.268011527377522,43.120134572962684
Task_28072,576,815,117,135,252,0.7058823529411765,19.372005834882952
Task_28073,1569,652,200,10,210,2.4027565084226645,33.39723300159813
Task_28074,2244,66,48,39,87,33.492537313432834,39.931481273610835
Task_28075,2603,263,52,52,104,9.859848484848484,47.96049758914183
Task_28076,1380,362,28,173,201,3.8016528925619837,30.51793570507165
Task_28077,931,562,36,195,231,1.6536412078152753,24.166442782082743
Task_28078,615,473,150,33,183,1.2974683544303798,17.5682915933688
Task_28079,2957,684,58,70,128,4.316788321167883,55.683721676693985
Task_28080,2145,75,125,93,218,28.223684210526315,40.58222780311848
Task_28081,1339,356,17,127,144,3.750700280112045,29.123919839306797
Task_28082,542,249,111,99,210,2.168,16.779459606353623
Task_28083,2284,740,64,36,100,3.0823211875843457,44.02812849490666
Task_28084,717,635,61,112,173,1.1273584905660377,20.48754026786035
Task_28085,906,507,36,46,82,1.7834645669291338,21.453186776679342
Task_28086,2674,551,154,94,248,4.844202898550725,51.60872262015929
Task_28087,587,611,93,177,270,0.9591503267973857,19.0718029933197
Task_28088,2720,392,22,130,152,6.921119592875318,51.11226513617046
Task_28089,2461,145,27,132,159,16.856164383561644,45.74406186986943
Task_28090,2150,589,81,178,259,3.6440677966101696,43.76433564407847
Task_28091,2327,144,181,150,331,16.048275862068966,44.91443412513154
Task_28092,1465,133,154,148,302,10.932835820895523,31.02489478311009
Task_28093,1537,936,25,149,174,1.64034151547492,34.58333496081965
Task_28094,1082,835,116,53,169,1.2942583732057416,26.286658024546906
Task_28095,1189,77,77,103,180,15.243589743589743,25.474431567759947
Task_28096,688,334,47,130,177,2.053731343283582,19.138769463247993
Task_28097,2227,140,173,171,344,15.794326241134751,43.35706554069287
Task_28098,1239,253,113,171,284,4.877952755905512,28.25931196573474
Task_28099,885,412,176,124,300,2.142857142857143,23.179163199341957
Task_28100,1429,928,63,180,243,1.5382131324004307,33.31900826939495
Task_28101,1314,635,80,71,151,2.0660377358490565,29.305603605614024
Task_28102,1386,107,101,28,129,12.833333333333334,27.67738043869828
Task_28103,522,442,106,128,234,1.1783295711060948,17.154802116318844
Task_28104,642,483,129,73,202,1.3264462809917354,18.612540825254488
Task_28105,2331,322,129,38,167,7.21671826625387,44.2136437139342
Task_28106,2527,334,66,14,80,7.543283582089552,46.29697693948574
Task_28107,1836,1008,110,157,267,1.819623389494549,40.00234860382702
Task_28108,2924,682,157,82,239,4.281112737920937,55.700250728049845
Task_28109,2485,273,157,16,173,9.069343065693431,46.3866723749824
Task_28110,500,874,60,10,70,0.5714285714285714,15.64981876495834
Task_28111,1825,134,118,84,202,13.518518518518519,35.94151578247491
Task_28112,2917,441,184,94,278,6.599547511312217,55.232653484710376
Task_28113,1555,577,144,176,320,2.690311418685121,34.472415786885456
Task_28114,1667,688,43,199,242,2.4194484760522497,36.29048823112617
Task_28115,554,583,63,182,245,0.9486301369863014,18.309458903626812
Task_28116,2266,471,26,144,170,4.8008474576271185,44.52504804460997
Task_28117,745,782,35,187,222,0.9514687100893997,21.697120739442052
Task_28118,1142,235,128,161,289,4.838983050847458,26.67375515982377
Task_28119,2682,853,179,184,363,3.1405152224824358,53.39702259252923
Task_28120,1204,721,52,84,136,1.667590027700831,28.10241878123014
Task_28121,573,837,172,22,194,0.6837708830548926,18.532597620970414
Task_28122,1832,909,90,191,281,2.013186813186813,39.79358158862358
Task_28123,2476,151,156,31,187,16.289473684210527,45.82297452538692
Task_28124,1126,110,19,57,76,10.144144144144144,23.12878242568806
Task_28125,790,761,89,138,227,1.036745406824147,22.307947865875107
Task_28126,1187,161,118,183,301,7.327160493827161,26.91740969192223
Task_28127,877,193,144,61,205,4.520618556701031,21.402715112811972
Task_28128,739,79,152,70,222,9.2375,18.152451819290345
Task_28129,1399,590,74,32,106,2.3671742808798646,29.771836975939124
Task_28130,1480,196,39,42,81,7.5126903553299496,29.608786095400124
Task_28131,1877,461,183,86,269,4.062770562770563,38.57599623584769
Task_28132,2161,465,48,135,183,4.6373390557939915,42.973571804654455
Task_28133,2769,66,200,26,226,41.32835820895522,49.537288010159564
Task_28134,2977,415,145,192,337,7.15625,56.560818058905454
Task_28135,1757,425,149,137,286,4.124413145539906,36.97624030194673
Task_28136,2028,458,63,78,141,4.4183006535947715,40.26174466397763
Task_28137,1443,782,140,22,162,1.842911877394636,31.429841070847058
Task_28138,824,194,94,192,286,4.225641025641026,21.556709879633843
Task_28139,949,147,41,165,206,6.412162162162162,22.620134230361646
Task_28140,1488,508,180,32,212,2.923379174852652,31.825908680970315
Task_28141,2089,175,32,189,221,11.869318181818182,40.741362734034915
Task_28142,2560,735,117,171,288,3.4782608695652173,50.73645888926188
Task_28143,2105,971,135,99,234,2.1656378600823047,43.901642439684146
Task_28144,2667,1010,185,153,338,2.6379821958456975,53.491716696066135
Task_28145,2218,340,177,60,237,6.504398826979473,43.13249343939558
Task_28146,1986,208,47,15,62,9.502392344497608,36.889261598884225
Task_28147,1590,500,46,13,59,3.1736526946107784,31.5855981704984
Task_28148,2957,526,112,161,273,5.611005692599621,56.27536979379744
Task_28149,2627,543,98,68,166,4.829044117647059,49.9196447815684
Task_28150,1392,821,32,181,213,1.6934306569343065,32.204149023996706
Task_28151,506,100,112,161,273,5.00990099009901,15.441253130119614
Task_28152,2216,275,194,129,323,8.028985507246377,43.88949627980605
Task_28153,2666,204,138,43,181,13.004878048780487,49.09006531621313
Task_28154,2833,571,35,78,113,4.9527972027972025,53.247600427351166
Task_28155,2473,779,35,142,177,3.1705128205128204,48.80508757878463
Task_28156,1751,914,21,144,165,1.9136612021857924,37.793037511178554
Task_28157,803,328,172,167,339,2.440729483282675,21.85419883025089
Task_28158,2950,930,12,160,172,3.1686358754027926,56.92263385770763
Task_28159,1732,173,156,158,314,9.954022988505747,35.50209348324347
Task_28160,2645,778,52,135,187,3.3953786906290118,51.8428494326897
Task_28161,2104,120,174,195,369,17.388429752066116,41.391680927768924
Task_28162,2031,733,31,117,148,2.7670299727520438,41.35903958848422
Task_28163,1360,513,107,45,152,2.6459143968871595,29.171291906203738
Task_28164,2307,505,174,52,226,4.559288537549407,45.132705825213584
Task_28165,540,221,186,71,257,2.4324324324324325,16.407232013263815
Task_28166,1816,502,85,67,152,3.610337972166998,36.701976693534625
Task_28167,2608,547,35,108,143,4.759124087591241,49.889120450955154
Task_28168,1838,377,83,50,133,4.862433862433862,36.4337921836896
Task_28169,2819,428,85,135,220,6.571095571095571,53.54012879465603
Task_28170,2755,1020,183,138,321,2.6983349657198823,54.8188361540449
Task_28171,2671,509,54,110,164,5.237254901960784,51.1699832466723
Task_28172,533,468,156,88,244,1.1364605543710022,17.153625823075643
Task_28173,1592,349,176,184,360,4.548571428571429,34.52089191015039
Task_28174,2680,590,186,121,307,4.534686971235194,52.189760096493444
Task_28175,1906,745,27,105,132,2.5549597855227884,39.40690971675956
Task_28176,2671,69,133,108,241,38.15714285714286,48.920025934254845
Task_28177,2269,990,102,32,134,2.289606458123108,45.13313170303263
Task_28178,2626,454,51,109,160,5.771428571428571,50.086444379793114
Task_28179,2804,923,40,193,233,3.034632034632035,54.988923965662856
Task_28180,2863,958,35,53,88,2.9854014598540144,54.1867664710642
Task_28181,1268,640,78,180,258,1.9781591263650546,29.98190430373579
Task_28182,1794,577,83,42,125,3.1038062283737022,36.13123836784755
Task_28183,1729,957,54,75,129,1.8048016701461378,37.155281918743626
Task_28184,2651,900,37,70,107,2.942286348501665,51.01713263842527
Task_28185,2438,365,36,50,86,6.66120218579235,45.352418321444816
Task_28186,2316,311,56,109,165,7.423076923076923,44.937558986199484
Task_28187,720,177,98,68,166,4.044943820224719,18.25774759557108
Task_28188,2114,93,190,89,279,22.48936170212766,40.438915139849335
Task_28189,2017,139,83,121,204,14.407142857142857,39.34497337753311
Task_28190,876,898,48,90,138,0.9744160177975528,23.332209183997023
Task_28191,2904,205,94,137,231,14.097087378640778,54.17313071728494
Task_28192,1634,773,125,97,222,2.111111111111111,35.81358605315985
Task_28193,1295,176,103,37,140,7.31638418079096,26.756626800484977
Task_28194,2845,819,103,74,177,3.4695121951219514,54.31812053506787
Task_28195,1266,856,58,167,225,1.4772462077012836,30.4288826847427
Task_28196,2669,770,90,10,100,3.461738002594034,50.28348293280911
Task_28197,2407,69,177,94,271,34.385714285714286,44.94857223232844
Task_28198,934,683,58,173,231,1.3654970760233918,24.616126583753005
Task_28199,1874,166,28,143,171,11.221556886227544,36.84039820496729
Task_28200,2587,338,135,10,145,7.631268436578171,48.03127207928775
Task_28201,1397,872,164,109,273,1.600229095074456,32.56703995139333
Task_28202,1584,867,159,149,308,1.8248847926267282,35.74427357800599
Task_28203,1263,394,89,37,126,3.19746835443038,27.285038839816238
Task_28204,2471,177,189,142,331,13.882022471910112,47.186734004365995
Task_28205,1474,560,84,20,104,2.627450980392157,30.574078052309158
Task_28206,1051,122,152,71,223,8.544715447154472,23.617055775861406
Task_28207,1603,950,110,170,280,1.6855941114616193,36.19428009406882
Task_28208,2935,126,153,124,277,23.11023622047244,53.99740961841085
Task_28209,620,968,158,126,284,0.6398348813209495,20.67937910758403
Task_28210,1939,295,176,17,193,6.550675675675675,37.94800023432852
Task_28211,845,802,137,62,199,1.0523038605230386,22.663548789885557
Task_28212,1835,431,155,21,176,4.247685185185185,36.62166622775218
Task_28213,1452,687,94,101,195,2.11046511627907,32.596441592966386
Task_28214,2105,270,77,189,266,7.767527675276753,42.07442734831419
Task_28215,1471,926,133,10,143,1.586839266450917,32.101205492386136
Task_28216,1468,464,23,131,154,3.156989247311828,31.669539741277987
Task_28217,2514,121,115,146,261,20.60655737704918,47.287950240451686
Task_28218,1724,826,38,30,68,2.0846432889963724,34.97441452536576
Task_28219,2549,245,32,177,209,10.361788617886178,48.638981786205626
Task_28220,1577,738,143,130,273,2.1339648173207038,35.046037525867085
Task_28221,1383,570,39,107,146,2.4220665499124343,30.557622165947038
Task_28222,2922,619,82,39,121,4.712903225806452,54.05999990561843
Task_28223,1190,954,188,37,225,1.2460732984293195,28.560830864772637
Task_28224,816,488,49,23,72,1.6687116564417177,19.560010637170965
Task_28225,1288,240,13,90,103,5.344398340248962,27.571725075631075
Task_28226,2737,451,181,137,318,6.0553097345132745,52.715543444775314
Task_28227,660,892,14,184,198,0.7390817469204927,20.665156638713736
Task_28228,2956,648,135,124,259,4.554699537750385,56.534003796759634
Task_28229,1602,794,69,169,238,2.0150943396226415,35.63762109596547
Task_28230,1383,582,152,125,277,2.37221269296741,31.49583975112641
Task_28231,1203,484,122,162,284,2.4804123711340207,28.423232416200033
Task_28232,2990,514,53,105,158,5.805825242718447,56.006220527765315
Task_28233,1426,69,66,170,236,20.37142857142857,29.591833042370137
Task_28234,1511,118,189,74,263,12.697478991596638,30.995404898730744
Task_28235,824,688,163,152,315,1.1959361393323658,23.101892731582595
Task_28236,1937,302,116,188,304,6.3927392739273925,39.573435232108146
Task_28237,1610,853,33,55,88,1.8852459016393444,34.04386293124622
Task_28238,2969,500,199,167,366,5.926147704590818,56.80875261231002
Task_28239,2118,92,148,73,221,22.774193548387096,39.92979672334932
Task_28240,2984,208,132,101,233,14.277511961722489,55.32098990824485
Task_28241,1934,624,198,81,279,3.0944,39.97539612940583
Task_28242,1272,778,97,30,127,1.6328626444159178,28.63302589475094
Task_28243,2386,391,109,181,290,6.086734693877551,46.900991255806254
Task_28244,2770,309,36,82,118,8.935483870967742,51.380761628814675
Task_28245,1312,144,91,141,232,9.048275862068966,28.502866447250444
Task_28246,1745,369,137,67,204,4.716216216216216,35.691203053829646
Task_28247,602,480,122,23,145,1.2515592515592515,17.147636374832434
Task_28248,2954,961,26,187,213,3.0706860706860706,57.41424006228087
Task_28249,2709,1002,168,90,258,2.7008973080757728,53.51464358353248
Task_28250,2581,138,48,174,222,18.568345323741006,48.43596972100375
Task_28251,1003,510,136,62,198,1.9628180039138943,24.311919868127145
Task_28252,878,474,142,37,179,1.848421052631579,21.7444097902378
Task_28253,651,177,74,94,168,3.657303370786517,17.459042725465995
Task_28254,1277,230,92,51,143,5.528138528138528,27.343094748810476
Task_28255,1828,532,46,179,225,3.4296435272045027,38.263449018537415
Task_28256,1951,541,157,144,301,3.5996309963099633,40.49649815994436
Task_28257,539,561,164,50,214,0.9590747330960854,17.151238938546722
Task_28258,2665,107,49,21,70,24.675925925925927,46.94421313981429
Task_28259,1514,320,12,18,30,4.716510903426792,29.5880247431847
Task_28260,2574,567,45,122,167,4.53169014084507,49.61791924450102
Task_28261,2603,198,146,133,279,13.080402010050252,49.566505188947986
Task_28262,516,617,119,40,159,0.8349514563106796,16.251597840641246
Task_28263,878,337,184,186,370,2.5976331360946747,23.23668641355404
Task_28264,1234,604,16,56,72,2.0396694214876034,26.94684172362227
Task_28265,2239,391,51,105,156,5.711734693877551,43.73359680263021
Task_28266,946,506,142,118,260,1.8658777120315582,24.251165912702064
Task_28267,1047,122,36,195,231,8.512195121951219,24.13634269031023
Task_28268,1585,734,130,54,184,2.1564625850340136,34.00739993565693
Task_28269,2064,977,17,184,201,2.1104294478527605,43.19903813610466
Task_28270,2091,730,54,188,242,2.86046511627907,43.26786806883081
Task_28271,698,858,17,59,76,0.8125727590221188,19.082831295769306
Task_28272,2639,333,193,107,300,7.901197604790419,50.64392376651896
Task_28273,2407,310,172,130,302,7.739549839228296,46.93830049528898
Task_28274,761,948,36,162,198,0.8018967334035827,22.323537722845817
Task_28275,2393,998,183,53,236,2.3953953953953953,48.09849267062696
Task_28276,2394,535,150,164,314,4.4664179104477615,47.579516348232026
Task_28277,610,353,157,63,220,1.7231638418079096,17.722225755333394
Task_28278,570,609,151,158,309,0.9344262295081968,18.826849495519333
Task_28279,1514,80,27,122,149,18.691358024691358,30.129568298295442
Task_28280,2517,109,174,76,250,22.881818181818183,46.46303052876556
Task_28281,816,283,57,192,249,2.8732394366197185,21.7048993681082
Task_28282,2257,897,106,167,273,2.5133630289532296,46.369981393564046
Task_28283,2626,804,40,127,167,3.262111801242236,51.21124410234764
Task_28284,2902,573,154,18,172,5.055749128919861,53.88744542511967
Task_28285,2144,509,153,89,242,4.203921568627451,42.91604470998242
Task_28286,646,821,57,55,112,0.7858880778588808,18.864487467641776
Task_28287,1772,1024,134,60,194,1.728780487804878,38.03267542811225
Task_28288,1236,451,174,83,257,2.734513274336283,28.310359765554264
Task_28289,1926,88,174,10,184,21.640449438202246,36.14949767944517
Task_28290,1508,421,141,58,199,3.5734597156398102,32.00298666729038
Task_28291,1988,373,166,118,284,5.315508021390374,40.42499869599725
Task_28292,1397,810,85,119,204,1.7225647348951911,32.1254264851001
Task_28293,1902,618,191,57,248,3.0726978998384493,39.098051736646035
Task_28294,2772,916,165,66,231,3.0229007633587788,53.78963204987141
Task_28295,592,1015,124,86,210,0.5826771653543307,19.810281957179182
Task_28296,767,829,52,189,241,0.9240963855421687,22.416407754185816
Task_28297,1534,201,32,11,43,7.594059405940594,29.619877216407478
Task_28298,799,134,45,191,236,5.9185185185185185,20.30485513315207
Task_28299,513,247,132,53,185,2.068548387096774,15.605974863494565
Task_28300,2859,783,130,33,163,3.6466836734693877,54.0361409629997
Task_28301,1362,830,98,95,193,1.6389891696750902,31.484787113494907
Task_28302,1234,793,199,135,334,1.5541561712846348,30.022924241724095
Task_28303,1703,888,92,134,226,1.9156355455568055,37.381046659521076
Task_28304,2800,370,194,33,227,7.547169811320755,52.20905887346353
Task_28305,546,445,98,170,268,1.2242152466367713,17.731573167384692
Task_28306,2603,393,133,17,150,6.606598984771574,48.288118550987924
Task_28307,2417,79,46,29,75,30.2125,42.7275579096632
Task_28308,2053,525,81,63,144,3.903041825095057,40.61890999776641
Task_28309,1518,280,12,199,211,5.402135231316726,32.47384546653017
Task_28310,2170,451,23,96,119,4.800884955752212,42.586820738474636
Task_28311,1396,887,143,82,225,1.572072072072072,32.03330434482253
Task_28312,2463,737,126,156,282,3.33739837398374,49.15710778296816
Task_28313,889,875,25,107,132,1.014840182648402,23.502195162877417
Task_28314,2264,435,20,123,143,5.192660550458716,44.04954487164341
Task_28315,735,584,127,73,200,1.2564102564102564,20.351096050040265
Task_28316,970,598,167,161,328,1.6193656093489148,25.27478151369672
Task_28317,2039,944,154,180,334,2.157671957671958,43.35603034972311
Task_28318,1526,203,154,155,309,7.480392156862745,32.706403972347296
Task_28319,2979,436,200,187,387,6.816933638443936,56.88049393380351
Task_28320,2595,917,70,78,148,2.826797385620915,50.732353168683865
Task_28321,1034,484,172,18,190,2.131958762886598,24.19218218544489
Task_28322,1856,401,61,146,207,4.616915422885572,38.25021244347446
Task_28323,2218,689,83,27,110,3.214492753623188,42.99216098041759
Task_28324,553,640,146,187,333,0.8627145085803433,18.799308558376556
Task_28325,1295,924,86,102,188,1.4,30.665999634398407
Task_28326,2954,766,129,16,145,3.851368970013038,55.19764406675631
Task_28327,2735,508,72,155,227,5.373280943025541,52.61307939460803
Task_28328,1073,1013,26,174,200,1.0581854043392505,27.45486046597439
Task_28329,1163,805,101,147,248,1.4429280397022333,28.539693072335638
Task_28330,2749,829,46,58,104,3.3120481927710843,52.03995144554989
Task_28331,2472,697,141,128,269,3.541547277936963,49.07400413700501
Task_28332,1773,342,39,113,152,5.169096209912537,35.98296237949186
Task_28333,2280,248,24,61,85,9.156626506024097,42.56430070973659
Task_28334,648,666,57,32,89,0.9715142428785607,18.0152848002573
Task_28335,2378,531,24,12,36,4.469924812030075,43.93912464907303
Task_28336,1220,241,92,117,209,5.041322314049586,27.578769240115218
Task_28337,2957,133,190,48,238,22.067164179104477,53.433741649756406
Task_28338,1843,778,163,142,305,2.3658536585365852,39.5467182236548
Task_28339,1372,1024,47,166,213,1.3385365853658537,32.433726246208884
Task_28340,981,803,143,46,189,1.2201492537313432,24.549866499123066
Task_28341,1903,960,18,24,42,1.9802289281997918,38.0536936442607
Task_28342,2135,620,92,29,121,3.4380032206119164,41.77320839159886
Task_28343,529,230,59,61,120,2.29004329004329,15.261677332608487
Task_28344,2781,300,98,18,116,9.23920265780731,50.52805142052423
Task_28345,1521,388,186,68,254,3.910025706940874,32.4361787463296
Task_28346,1521,573,159,151,310,2.6498257839721253,33.83969909387422
Task_28347,1205,810,164,14,178,1.4858199753390875,27.72939064367729
Task_28348,2118,685,95,81,176,3.087463556851312,42.5136440593402
Task_28349,1155,462,92,161,253,2.4946004319654427,27.53026731149104
Task_28350,991,636,130,67,197,1.555729984301413,24.553350009951988
Task_28351,680,660,163,148,311,1.0287443267776097,20.66417670943099
Task_28352,943,811,89,104,193,1.1613300492610839,24.760877229571076
Task_28353,1931,1011,142,44,186,1.908102766798419,40.14502568532544
Task_28354,777,616,179,121,300,1.2593192868719612,21.996960904309955
Task_28355,2587,539,159,56,215,4.79074074074074,49.61782327977582
Task_28356,713,586,189,27,216,1.2146507666098807,19.748807624414976
Task_28357,1164,701,157,157,314,1.6581196581196582,28.599356290159744
Task_28358,2010,895,163,124,287,2.2433035714285716,42.45004303269511
Task_28359,665,82,87,79,166,8.012048192771084,16.84391295602291
Task_28360,960,940,149,144,293,1.0201912858661,25.87233077085268
Task_28361,2905,913,78,133,211,3.1783369803063457,56.489230253370664
Task_28362,2530,279,17,25,42,9.035714285714286,45.789310864036445
Task_28363,621,533,153,40,193,1.1629213483146068,18.140123815785525
Task_28364,2207,295,153,182,335,7.456081081081081,43.949037546968505
Task_28365,2624,624,91,136,227,4.1984,51.12198748857612
Task_28366,1300,790,159,151,310,1.6434892541087232,31.0038135895976
Task_28367,1138,879,165,151,316,1.2931818181818182,28.661677316390737
Task_28368,805,546,143,21,164,1.4716636197440585,20.719980150176525
Task_28369,2616,494,127,68,195,5.284848484848485,49.8423810006805
Task_28370,2151,119,103,175,278,17.925,41.67722410131793
Task_28371,1313,141,21,107,128,9.246478873239436,27.445806430889302
Task_28372,2095,108,172,101,273,19.220183486238533,40.350874893100176
Task_28373,1102,169,29,117,146,6.482352941176471,24.393521053984216
Task_28374,1343,843,156,71,227,1.5912322274881516,30.919315639179178
Task_28375,558,645,110,12,122,0.8637770897832817,16.7301580500497
Task_28376,1914,266,128,99,227,7.168539325842697,38.59335441579792
Task_28377,1629,918,154,44,198,1.7725788900979325,35.2480294325053
Task_28378,2156,719,200,33,233,2.9944444444444445,43.16548283361616
Task_28379,751,755,66,197,263,0.9933862433862434,22.057371440721727
Task_28380,2881,88,79,68,147,32.37078651685393,51.263054774502656
Task_28381,725,538,116,105,221,1.3450834879406308,20.616828647434332
Task_28382,974,218,24,180,204,4.447488584474886,23.650323120268272
Task_28383,1674,496,104,163,267,3.3682092555331993,35.84237116579946
Task_28384,2982,1015,30,185,215,2.9350393700787403,58.032689125603355
Task_28385,2956,627,77,160,237,4.707006369426751,56.54654688313647
Task_28386,611,676,48,94,142,0.9025110782865583,18.56972348810047
Task_28387,2020,768,89,101,190,2.626788036410923,41.769609098006924
Task_28388,2852,181,197,89,286,15.67032967032967,52.86094603668738
Task_28389,1252,522,101,84,185,2.3938814531548758,28.306907391843396
Task_28390,2820,307,173,36,209,9.155844155844155,52.225877042028124
Task_28391,2009,286,84,163,247,7.0,40.41055472916631
Task_28392,1836,979,158,136,294,1.873469387755102,40.003220184709356
Task_28393,1756,282,184,183,367,6.204946996466431,36.92033719176548
Task_28394,723,504,176,193,369,1.4316831683168316,21.24733124369016
Task_28395,2387,764,24,145,169,3.1202614379084967,47.37088569903387
Task_28396,1668,850,89,61,150,1.9600470035252644,35.37489269903514
Task_28397,1005,436,19,151,170,2.2997711670480547,24.403588904620594
Task_28398,656,78,51,196,247,8.30379746835443,17.6901425204287
Task_28399,855,204,179,194,373,4.170731707317073,22.46329064798954
Task_28400,2874,90,32,39,71,31.582417582417584,49.98311598822706
Task_28401,2164,451,26,127,153,4.787610619469026,42.57878876037833
Task_28402,1607,670,18,39,57,2.3949329359165423,32.62332884046087
Task_28403,723,120,16,142,158,5.975206611570248,18.05830013071859
Task_28404,2760,982,157,145,302,2.807731434384537,54.70418816885687
Task_28405,711,122,156,37,193,5.780487804878049,17.856903218645446
Task_28406,1741,426,92,70,162,4.07728337236534,35.44057403118982
Task_28407,2777,861,18,109,127,3.2215777262180976,53.46301985288398
Task_28408,2554,223,17,153,170,11.401785714285714,48.136905361823146
Task_28409,1225,458,105,35,140,2.6688453159041394,26.90954909170613
Task_28410,2765,1005,57,39,96,2.7485089463220675,52.48371410404343
Task_28411,2708,688,38,76,114,3.93033381712627,51.57056379888456
Task_28412,2565,418,113,139,252,6.121718377088306,49.59007712676563
Task_28413,691,936,101,28,129,0.7374599786552828,19.93553152473288
Task_28414,1545,182,156,186,342,8.442622950819672,32.9589373655898
Task_28415,2600,360,75,110,185,7.202216066481994,49.61152313308508
Task_28416,2972,70,106,173,279,41.859154929577464,53.90606121522924
Task_28417,2485,720,162,200,362,3.4466019417475726,49.877151912072804
Task_28418,2251,388,20,123,143,5.786632390745501,43.689431635309724
Task_28419,1254,710,21,178,199,1.7637130801687764,29.545950116430657
Task_28420,1553,673,66,142,208,2.3041543026706233,34.31002424213412
Task_28421,1449,203,48,93,141,7.102941176470588,30.455619525571706
Task_28422,969,648,179,123,302,1.4930662557781202,25.212496652933847
Task_28423,1923,541,100,88,188,3.547970479704797,39.164376111496125
Task_28424,991,789,69,147,216,1.2544303797468355,25.66335839436675
Task_28425,1701,526,20,113,133,3.227703984819734,35.42666093705662
Task_28426,1022,210,48,152,200,4.843601895734597,24.402263785496604
Task_28427,2204,143,84,69,153,15.305555555555555,41.200771239414046
Task_28428,2085,721,60,117,177,2.8878116343490303,42.53467833632264
Task_28429,2629,165,67,28,95,15.837349397590362,47.39272265290034
Task_28430,965,279,79,150,229,3.4464285714285716,23.86745368424
Task_28431,2133,854,185,130,315,2.4947368421052634,44.406105807582
Task_28432,2948,87,10,42,52,33.5,51.13831379736518
Task_28433,2174,426,60,58,118,5.091334894613583,41.85727257736112
Task_28434,979,310,196,136,332,3.147909967845659,24.502562387803604
Task_28435,2788,809,107,195,302,3.4419753086419753,54.679604845774975
Task_28436,588,411,64,185,249,1.4271844660194175,18.393962015478518
Task_28437,2860,758,92,115,207,3.7681159420289854,55.191815042546324
Task_28438,2126,797,21,81,102,2.664160401002506,42.42299194530659
Task_28439,1402,830,55,155,210,1.687123947051745,32.45798083797158
Task_28440,2411,377,57,116,173,6.378306878306878,46.714398511802266
Task_28441,2212,228,46,185,231,9.65938864628821,43.35757501558419
Task_28442,1709,721,110,116,226,2.3670360110803323,36.85161678528369
Task_28443,2811,544,149,96,245,5.157798165137614,53.82401522772258
Task_28444,1539,131,110,75,185,11.659090909090908,31.004722919368973
Task_28445,2965,898,152,46,198,3.2981090100111237,56.37124974903271
Task_28446,1695,720,90,151,241,2.350901525658807,36.7948890889755
Task_28447,714,907,28,147,175,0.7863436123348018,21.30174859141144
Task_28448,1019,96,56,124,180,10.505154639175258,22.804493429274554
Task_28449,2238,525,132,131,263,4.254752851711027,44.79926705641387
Task_28450,914,224,129,120,249,4.062222222222222,22.7950585586067
Task_28451,1118,171,96,107,203,6.5,25.315846696257676
Task_28452,770,632,145,115,260,1.216429699842022,21.729469551403813
Task_28453,2571,198,191,183,374,12.919597989949748,49.56289452383405
Task_28454,536,149,198,180,378,3.5733333333333333,16.945762291025144
Task_28455,1389,748,25,38,63,1.8544726301735648,29.478696778075047
Task_28456,2382,266,90,126,216,8.92134831460674,46.04359396206803
Task_28457,1501,536,68,126,194,2.7951582867783986,32.96911454401401
Task_28458,1023,163,30,57,87,6.237804878048781,22.26569422802214
Task_28459,2307,410,105,111,216,5.613138686131387,45.27758620987464
Task_28460,587,318,76,18,94,1.8401253918495297,15.81073572372074
Task_28461,2573,711,137,70,207,3.6137640449438204,49.90906145246756
Task_28462,2531,516,170,94,264,4.895551257253385,49.304010620425764
Task_28463,1589,85,137,116,253,18.476744186046513,32.18528146262298
Task_28464,1540,783,157,179,336,1.9642857142857142,34.95595520522607
Task_28465,1940,381,148,15,163,5.0785340314136125,38.02359319960794
Task_28466,2008,642,106,79,185,3.1228615863141522,40.6575210905367
Task_28467,1181,242,80,55,135,4.860082304526749,25.908343397006224
Task_28468,1708,758,107,76,183,2.2503293807641636,36.14248720087378
Task_28469,996,341,121,72,193,2.912280701754386,23.73300939056645
Task_28470,1427,317,192,46,238,4.487421383647798,30.349036593593592
Task_28471,1868,780,147,182,329,2.3918053777208708,40.115835340337085
Task_28472,2505,417,17,29,46,5.992822966507177,45.94564575719915
Task_28473,1656,839,69,170,239,1.9714285714285715,36.63926576789499
Task_28474,2893,118,136,93,229,24.310924369747898,52.93437209647698
Task_28475,2476,585,132,128,260,4.225255972696246,48.74167838997263
Task_28476,2014,119,167,158,325,16.783333333333335,39.70891119481541
Task_28477,2231,487,71,177,248,4.57172131147541,44.693176422935295
Task_28478,2616,805,173,139,312,3.2456575682382134,51.90497756263411
Task_28479,2195,799,87,120,207,2.74375,44.72362972877383
Task_28480,1357,315,63,165,228,4.294303797468355,30.197781639538615
Task_28481,533,984,55,86,141,0.5411167512690356,18.31104078911207
Task_28482,1929,929,54,37,91,2.074193548387097,38.99607857608533
Task_28483,827,993,140,173,313,0.8319919517102615,24.112736245665577
Task_28484,2126,204,78,26,104,10.370731707317074,39.95227726263992
Task_28485,2143,654,41,157,198,3.2717557251908396,43.46208679368643
Task_28486,2368,510,163,157,320,4.634050880626223,47.104340235864186
Task_28487,2981,130,179,128,307,22.755725190839694,54.87143976240308
Task_28488,2404,753,147,116,263,3.1883289124668437,48.128487977671966
Task_28489,2973,125,141,55,196,23.595238095238095,53.76448106843591
Task_28490,500,561,90,65,155,0.8896797153024911,16.113293858147127
Task_28491,994,323,132,126,258,3.067901234567901,24.433562389787564
Task_28492,2783,342,117,172,289,8.113702623906706,52.99820175055371
Task_28493,1563,731,48,32,80,2.1352459016393444,32.52602392260294
Task_28494,2001,849,192,158,350,2.3541176470588234,42.497849175753956
Task_28495,2635,640,180,110,290,4.110764430577223,51.54363647081639
Task_28496,2421,316,19,101,120,7.6372239747634065,45.9711170871536
Task_28497,2760,304,190,157,347,9.049180327868852,52.74118422207621
Task_28498,687,685,132,157,289,1.001457725947522,20.748071027411893
Task_28499,848,787,107,153,260,1.0761421319796953,23.48007650267148
Task_28500,1543,991,114,66,180,1.5554435483870968,34.10923657690646
Task_28501,666,703,39,47,86,0.9460227272727273,18.394536134449194
Task_28502,1981,881,45,39,84,2.246031746031746,39.596273542099205
Task_28503,1598,479,121,72,193,3.3291666666666666,33.70024444367456
Task_28504,2939,720,128,56,184,4.076282940360611,55.44525842119169
Task_28505,2569,174,90,90,180,14.68,47.699110894316334
Task_28506,1535,390,54,182,236,3.925831202046036,33.34990779234732
Task_28507,2089,766,38,41,79,2.723598435462842,40.72554044718608
Task_28508,1315,650,58,101,159,2.0199692780337943,29.891171967614756
Task_28509,1711,67,155,79,234,25.16176470588235,33.56335321791164
Task_28510,979,525,156,186,342,1.861216730038023,25.302404585182074
Task_28511,2889,511,98,159,257,5.642578125,55.08894010846401
Task_28512,623,556,64,80,144,1.118491921005386,18.28066139944299
Task_28513,588,537,27,194,221,1.0929368029739777,18.420453720023414
Task_28514,1521,1002,166,50,216,1.5164506480558324,33.96636767414373
Task_28515,1250,496,40,195,235,2.515090543259557,29.045091616491124
Task_28516,677,723,142,147,289,0.9350828729281768,20.76848898641626
Task_28517,2677,458,13,183,196,5.832244008714597,51.36234940528942
Task_28518,2368,791,99,195,294,2.98989898989899,47.93463325071034
Task_28519,1663,549,45,25,70,3.0236363636363635,33.09887800951206
Task_28520,689,595,56,139,195,1.1560402684563758,20.227806493931286
Task_28521,1765,305,50,104,154,5.76797385620915,35.90341921632426
Task_28522,2198,643,83,81,164,3.4130434782608696,43.66751752656594
Task_28523,927,100,168,120,288,9.178217821782178,22.061356115213744
Task_28524,1039,918,146,193,339,1.130576713819369,27.381816276252867
Task_28525,1768,764,190,104,294,2.311111111111111,38.20953425348909
Task_28526,646,340,116,28,144,1.8944281524926687,17.370254552568493
Task_28527,1266,781,177,141,318,1.618925831202046,30.458584719112213
Task_28528,912,97,69,37,106,9.306122448979592,19.55660497642986
Task_28529,1210,173,165,16,181,6.954022988505747,25.664029246265926
Task_28530,536,107,192,112,304,4.962962962962963,15.983316021951213
Task_28531,1281,512,185,114,299,2.497076023391813,29.74362130167761
Task_28532,610,723,60,112,172,0.8425414364640884,19.117115445703877
Task_28533,2798,527,66,104,170,5.299242424242424,53.147840387449634
Task_28534,2822,589,124,48,172,4.783050847457627,52.954034633413976
Task_28535,783,418,150,130,280,1.8687350835322196,21.5025830136217
Task_28536,1183,1013,25,200,225,1.1666666666666667,29.44784120805002
Task_28537,2193,227,140,73,213,9.618421052631579,42.36727401751107
Task_28538,2466,458,81,59,140,5.372549019607843,46.81128094076383
Task_28539,1778,639,128,178,306,2.778125,38.13894116014861
Task_28540,2676,232,28,80,108,11.484978540772532,49.444679275698576
Task_28541,1458,690,156,110,266,2.109985528219971,32.95025692385517
Task_28542,2226,697,94,164,258,3.189111747851003,45.264295680436106
Task_28543,1622,899,48,130,178,1.8022222222222222,35.773632483792966
Task_28544,1141,71,110,132,242,15.847222222222221,25.04708370073605
Task_28545,1288,525,44,116,160,2.4486692015209126,28.96959892105895
Task_28546,2586,91,68,15,83,28.108695652173914,45.6191673338798
Task_28547,698,408,63,190,253,1.706601466992665,20.206870160840968
Task_28548,707,373,131,37,168,1.8903743315508021,18.6524999610503
Task_28549,2462,562,67,116,183,4.373001776198934,48.02178855907372
Task_28550,2270,760,194,51,245,2.9829172141918527,45.38481821770373
Task_28551,560,916,102,19,121,0.6106870229007634,17.716069065126163
Task_28552,871,997,186,66,252,0.872745490981964,24.05665741923705
Task_28553,657,362,199,32,231,1.8099173553719008,18.29809685038687
Task_28554,2598,274,108,187,295,9.447272727272727,49.88249380415808
Task_28555,2398,529,148,187,335,4.524528301886792,47.751963980312816
Task_28556,2776,777,150,83,233,3.5681233933161955,53.620325984418685
Task_28557,2566,465,200,190,390,5.506437768240343,50.456908618398245
Task_28558,2643,341,163,38,201,7.728070175438597,49.53667538530359
Task_28559,1828,650,131,170,301,2.8079877112135176,38.9311768462757
Task_28560,2166,417,176,106,282,5.181818181818182,43.35939120902443
Task_28561,2437,603,109,135,244,4.03476821192053,48.11953544044189
Task_28562,900,870,69,63,132,1.0332950631458093,23.42193773954948
Task_28563,2305,937,199,78,277,2.4573560767590616,46.845083294657876
Task_28564,2783,628,162,83,245,4.424483306836248,53.31372760041884
Task_28565,1977,325,188,55,243,6.064417177914111,39.38806791475392
Task_28566,2962,518,65,93,158,5.707129094412331,55.47847847403796
Task_28567,676,653,89,180,269,1.033639143730887,20.41835845827524
Task_28568,2855,986,92,42,134,2.8926038500506586,54.4840058767268
Task_28569,2772,288,23,168,191,9.591695501730104,52.282986636829236
Task_28570,895,852,141,66,207,1.0492379835873389,23.675135964811677
Task_28571,2195,277,102,104,206,7.89568345323741,43.00065344624403
Task_28572,1013,458,95,156,251,2.206971677559913,25.246254380212218
Task_28573,1625,683,57,13,70,2.375730994152047,32.71214913746566
Task_28574,1338,235,117,12,129,5.669491525423729,27.859172034536073
Task_28575,966,275,38,44,82,3.5,21.641418842853287
Task_28576,1705,878,124,58,182,1.9397042093287826,36.294413871315804
Task_28577,2978,617,13,29,42,4.818770226537217,54.123448211877296
Task_28578,2978,640,171,87,258,4.645865834633385,56.54399223771161
Task_28579,705,681,103,138,241,1.033724340175953,20.79509805809211
Task_28580,1504,97,17,88,105,15.346938775510203,29.49876640817628
Task_28581,1328,521,14,140,154,2.5440613026819925,29.59862161369385
Task_28582,2925,990,164,168,332,2.951564076690212,57.512812150790204
Task_28583,1739,351,43,82,125,4.940340909090909,35.31019038038962
Task_28584,1371,618,23,50,73,2.2148626817447497,28.934630745251777
Task_28585,2815,216,199,166,365,12.972350230414747,53.375550258774695
Task_28586,2712,151,72,28,100,17.842105263157894,48.649901076899084
Task_28587,1614,409,119,198,317,3.9365853658536585,34.8907530695927
Task_28588,1225,820,193,199,392,1.4920828258221681,30.319400682874356
Task_28589,1336,647,20,61,81,2.0617283950617282,28.898845953305436
Task_28590,851,111,158,126,284,7.598214285714286,20.879707517483947
Task_28591,2812,950,160,22,182,2.956887486855941,53.78797389672971
Task_28592,1938,109,102,19,121,17.618181818181817,36.08808783224462
Task_28593,923,514,106,29,135,1.7922330097087378,22.32812914871563
Task_28594,2711,488,131,152,283,5.543967280163599,52.28919440748134
Task_28595,2355,478,43,49,92,4.916492693110647,44.51251408251835
Task_28596,1075,128,163,90,253,8.333333333333334,24.436546069315273
Task_28597,2236,1008,124,25,149,2.21605550049554,44.63765355701122
Task_28598,2157,905,110,27,137,2.380794701986755,43.03780696557558
Task_28599,1860,492,40,138,178,3.7728194726166326,38.167071001688925
Task_28600,2506,77,44,110,154,32.12820512820513,45.5678907389792
Task_28601,2350,525,54,181,235,4.467680608365019,46.67874658635332
Task_28602,703,599,25,79,104,1.1716666666666666,19.321703761153948
Task_28603,2801,334,30,27,57,8.361194029850747,50.497378489132196
Task_28604,1204,652,124,138,262,1.8437978560490047,28.83145418794373
Task_28605,758,636,156,113,269,1.1899529042386185,21.630626315874988
Task_28606,1127,777,37,139,176,1.448586118251928,27.37205983787678
Task_28607,522,772,136,16,152,0.6752910737386805,16.948448242017538
Task_28608,859,650,70,104,174,1.3195084485407067,22.940792196637783
Task_28609,730,360,94,155,249,2.0221606648199444,20.461783695268203
Task_28610,1281,287,48,44,92,4.447916666666667,26.808197927459148
Task_28611,1807,894,125,117,242,2.018994413407821,39.017277180448474
Task_28612,638,808,46,51,97,0.788627935723115,18.587766664426265
Task_28613,1450,644,111,152,263,2.248062015503876,32.72775739171258
Task_28614,2579,331,200,139,339,7.768072289156627,49.910786913779
Task_28615,1994,650,194,73,267,3.0629800307219663,40.8580848046388
Task_28616,1186,199,108,119,227,5.93,26.9189632040442
Task_28617,2593,1023,139,115,254,2.5322265625,51.92521951156832
Task_28618,1353,70,57,49,106,19.056338028169016,26.22256570182395
Task_28619,1487,730,75,39,114,2.0341997264021887,31.74422316861157
Task_28620,1232,417,185,103,288,2.9473684210526314,28.60138701074349
Task_28621,1733,942,83,166,249,1.8377518557794275,38.150905197934
Task_28622,2601,104,125,122,247,24.771428571428572,48.17659512992984
Task_28623,2626,122,126,187,313,21.349593495934958,49.35042670104641
Task_28624,2381,965,103,81,184,2.4648033126293996,47.50149319010595
Task_28625,1283,74,31,63,94,17.106666666666666,25.621072823866793
Task_28626,1781,286,156,93,249,6.205574912891986,36.6000974935832
Task_28627,1760,651,124,65,189,2.6993865030674846,36.72656699754052
Task_28628,938,152,35,164,199,6.130718954248366,22.473171646319827
Task_28629,2826,163,196,84,280,17.23170731707317,52.32430784512249
Task_28630,1715,236,116,193,309,7.236286919831223,35.8655047137458
Task_28631,2532,589,36,183,219,4.291525423728814,49.5459962377435
Task_28632,1896,646,102,134,236,2.930448222565688,39.649883861861575
Task_28633,533,987,164,105,269,0.5394736842105263,19.24933790581854
Task_28634,2715,783,115,31,146,3.4630102040816326,51.61254157132861
Task_28635,2649,726,132,92,224,3.6437414030261346,51.61299376825105
Task_28636,1378,736,128,46,174,1.869742198100407,30.544040297437807
Task_28637,1570,363,20,148,168,4.313186813186813,33.09643644348292
Task_28638,506,161,70,41,111,3.123456790123457,13.982944054072858
Task_28639,2706,935,67,97,164,2.891025641025641,53.06759279102897
Task_28640,2681,811,137,16,153,3.3017241379310347,50.92984859568488
Task_28641,2642,372,94,158,252,7.083109919571045,50.76654601613627
Task_28642,2608,929,175,198,373,2.804301075268817,52.527797171955434
Task_28643,1822,848,55,158,213,2.1460541813898706,39.19982245201415
Task_28644,2247,862,188,200,388,2.603707995365006,46.668978377939915
Task_28645,609,80,61,66,127,7.518518518518518,15.398679495706475
Task_28646,2659,1021,54,60,114,2.601761252446184,51.49729754845887
Task_28647,1127,744,141,200,341,1.512751677852349,28.30239613283122
Task_28648,662,892,153,102,255,0.7413213885778276,20.780063194203738
Task_28649,1301,965,47,172,219,1.3467908902691512,31.161726671442256
Task_28650,930,732,92,73,165,1.2687585266030013,23.748310959919394
Task_28651,2404,523,71,75,146,4.587786259541985,46.38421888589065
Task_28652,2528,758,189,167,356,3.3306982872200264,50.60252539243663
Task_28653,1971,987,145,83,228,1.9949392712550607,41.4988690571928
Task_28654,2963,460,23,42,65,6.427331887201736,53.5268597322864
Task_28655,2884,236,168,195,363,12.168776371308017,54.57773905678963
Task_28656,2812,889,44,129,173,3.1595505617977526,54.57468923606148
Task_28657,1536,927,119,199,318,1.6551724137931034,35.27499794781328
Task_28658,2083,472,163,177,340,4.4038054968287526,42.58966807524395
Task_28659,1030,320,44,179,223,3.208722741433022,24.926763760590067
Task_28660,1019,246,140,79,219,4.125506072874494,24.03917345569884
Task_28661,1508,442,30,92,122,3.404063205417607,32.025923759678044
Task_28662,2754,187,88,111,199,14.648936170212766,51.60318481039338
Task_28663,1792,667,178,194,372,2.682634730538922,38.76955633755204
Task_28664,775,71,109,166,275,10.76388888888889,19.519917636094068
Task_28665,1785,117,121,72,193,15.127118644067796,34.993480600928656
Task_28666,2984,477,115,139,254,6.2426778242677825,56.425138974175844
Task_28667,1159,1013,119,71,190,1.1429980276134122,28.36239882881064
Task_28668,1184,733,19,140,159,1.6130790190735695,27.95711112716795
Task_28669,1723,302,156,84,240,5.686468646864687,35.45530429936362
Task_28670,2783,148,186,46,232,18.677852348993287,50.84835783536235
Task_28671,1022,486,124,152,276,2.0985626283367558,25.51351803381166
Task_28672,2556,599,79,75,154,4.26,48.96157412484326
Task_28673,604,218,169,113,282,2.7579908675799087,18.018153004052778
Task_28674,1856,803,94,31,125,2.308457711442786,38.02943514187279
Task_28675,1635,582,72,10,82,2.804459691252144,33.15176503333735
Task_28676,2816,904,141,64,205,3.1116022099447513,54.33670320202399
Task_28677,2986,517,105,112,217,5.764478764478764,56.381070162788454
Task_28678,1047,662,175,59,234,1.579185520361991,25.59228466703308
Task_28679,2727,610,33,93,126,4.463175122749591,52.005423857926054
Task_28680,2275,243,151,197,348,9.323770491803279,44.91895792133601
Task_28681,500,283,144,153,297,1.7605633802816902,16.696847650818594
Task_28682,715,845,95,178,273,0.8451536643026005,21.77842947208285
Task_28683,513,283,161,161,322,1.806338028169014,17.040173048040128
Task_28684,507,404,190,58,248,1.2518518518518518,16.28729407098521
Task_28685,609,64,165,72,237,9.36923076923077,16.247522892894555
Task_28686,547,833,172,198,370,0.6558752997601919,19.6238552216125
Task_28687,1682,215,184,56,240,7.787037037037037,34.331075214535694
Task_28688,509,767,40,12,52,0.6627604166666666,15.725486043161707
Task_28689,1392,388,109,128,237,3.5784061696658096,30.84709466022814
Task_28690,1524,925,136,198,334,1.6457883369330453,35.14928872985613
Task_28691,1622,889,98,105,203,1.8224719101123596,35.89092720551809
Task_28692,1461,736,165,106,271,1.98236092265943,33.157996310859474
Task_28693,2825,446,11,198,209,6.319910514541387,53.692080815938205
Task_28694,1991,168,148,75,223,11.781065088757396,38.834006117971064
Task_28695,2915,159,62,44,106,18.21875,51.59900379068145
Task_28696,2670,176,144,160,304,15.084745762711865,50.22610928270998
Task_28697,1205,903,69,94,163,1.3329646017699115,28.986111789773144
Task_28698,1073,995,120,196,316,1.0773092369477912,28.004301417251792
Task_28699,1404,467,141,82,223,3.0,30.875676129935425
Task_28700,2593,381,122,92,214,6.787958115183246,49.56907901174787
Task_28701,2113,142,98,71,169,14.776223776223777,39.99249479452218
Task_28702,1433,107,138,127,265,13.268518518518519,29.927668334383103
Task_28703,850,760,83,181,264,1.1169513797634691,23.500288372963336
Task_28704,2965,571,136,70,206,5.183566433566433,55.66748460138484
Task_28705,1090,768,93,137,230,1.4174252275682704,27.288535767122426
Task_28706,2019,346,55,49,104,5.818443804034582,38.71187632448948
Task_28707,982,221,175,146,321,4.423423423423423,24.22143598305279
Task_28708,1962,1024,108,171,279,1.9141463414634146,42.12338400585618
Task_28709,2434,211,174,141,315,11.481132075471699,47.07793462143443
Task_28710,2872,161,56,197,253,17.728395061728396,53.4200606402529
Task_28711,2454,266,17,42,59,9.191011235955056,44.72496376171694
Task_28712,1420,666,127,158,285,2.128935532233883,32.4293602099924
Task_28713,2771,328,114,161,275,8.422492401215806,52.680706838568994
Task_28714,2631,255,71,17,88,10.27734375,47.785649436668336
Task_28715,1006,916,71,132,203,1.0970556161395857,26.17326602106012
Task_28716,2020,934,126,177,303,2.160427807486631,42.87972318947436
Task_28717,2327,421,114,148,262,5.514218009478673,45.891792198254656
Task_28718,770,960,71,17,88,0.8012486992715921,20.905769247356073
Task_28719,1881,552,166,17,183,3.4014466546112114,37.62683668959111
Task_28720,1483,503,78,28,106,2.9424603174603177,30.809536401686472
Task_28721,529,201,48,100,148,2.618811881188119,15.957039703740001
Task_28722,2738,807,64,37,101,3.3886138613861387,51.4898788051143
Task_28723,1738,806,194,150,344,2.15365551425031,38.15808302261588
Task_28724,2172,425,179,72,251,5.098591549295775,42.87491983901766
Task_28725,1391,827,140,75,215,1.679951690821256,31.671704512884777
Task_28726,2525,565,179,117,296,4.46113074204947,49.59986133676995
Task_28727,1639,97,152,73,225,16.724489795918366,32.35484366743956
Task_28728,662,595,73,191,264,1.110738255033557,20.10535056252321
Task_28729,2801,165,132,118,250,16.873493975903614,52.05677929631708
Task_28730,840,219,93,114,207,3.8181818181818183,21.523543749212262
Task_28731,886,163,190,93,283,5.402439024390244,21.88084947225521
Task_28732,647,880,103,58,161,0.7343927355278093,19.344881827399412
Task_28733,2647,436,78,129,207,6.05720823798627,50.86043483331875
Task_28734,880,99,145,15,160,8.8,19.604737905428248
Task_28735,2729,499,27,28,55,5.458,49.88583104009617
Task_28736,1767,666,134,186,320,2.649175412293853,38.12434374335651
Task_28737,926,577,63,92,155,1.602076124567474,23.379082715363428
Task_28738,2438,629,85,124,209,3.86984126984127,48.09140210911593
Task_28739,1719,735,164,65,229,2.3355978260869565,36.552527282481556
Task_28740,708,949,118,163,281,0.7452631578947368,21.90207161302165
Task_28741,766,994,33,133,166,0.7698492462311558,22.228495314375554
Task_28742,1273,834,26,126,152,1.524550898203593,29.623735164624605
Task_28743,1313,1013,85,119,204,1.294871794871795,31.331805979051477
Task_28744,2186,777,124,69,193,2.809768637532134,43.89356388559637
Task_28745,2499,101,184,184,368,24.5,47.22199029948586
Task_28746,2037,310,54,143,197,6.54983922829582,40.79272531999069
Task_28747,1399,974,195,188,383,1.4348717948717948,33.4717382671052
Task_28748,1142,787,142,54,196,1.4492385786802031,27.36359550392355
Task_28749,1200,128,117,80,197,9.30232558139535,26.01589746480732
Task_28750,1636,381,124,142,266,4.282722513089006,34.83622143009929
Task_28751,1888,165,27,87,114,11.373493975903614,36.4061693377792
Task_28752,1254,605,155,67,222,2.0693069306930694,28.75118576350801
Task_28753,1876,530,159,101,260,3.5329566854990584,39.026186857473085
Task_28754,1354,521,82,194,276,2.5938697318007664,31.033785724486382
Task_28755,2091,338,115,184,299,6.168141592920354,42.102155034488256
Task_28756,1111,848,101,162,263,1.3085983510011778,27.95451790380928
Task_28757,2668,716,64,72,136,3.7210599721059974,51.0958960291166
Task_28758,2123,266,17,110,127,7.951310861423221,41.149559244610906
Task_28759,1940,505,183,179,362,3.83399209486166,40.53383966418912
Task_28760,666,1005,97,180,277,0.6620278330019881,21.63126457079529
Task_28761,2785,675,92,162,254,4.1198224852071,54.02203804461943
Task_28762,1207,222,82,109,191,5.4125560538116595,27.2303225844208
Task_28763,2329,699,70,58,128,3.327142857142857,45.57298380947383
Task_28764,1778,123,137,10,147,14.338709677419354,34.08861830136559
Task_28765,527,845,193,114,307,0.6229314420803782,18.993443620107445
Task_28766,2287,915,135,25,160,2.4967248908296944,45.1824689552811
Task_28767,626,297,163,36,199,2.1006711409395975,17.458210203525983
Task_28768,2975,676,73,141,214,4.394387001477105,56.87311537139815
Task_28769,589,870,13,176,189,0.6762342135476463,19.58995271284792
Task_28770,2102,355,161,104,265,5.904494382022472,42.06256675969225
Task_28771,1119,166,158,165,323,6.700598802395209,25.906603676825984
Task_28772,2270,678,56,92,148,3.3431516936671577,45.008128718627155
Task_28773,1041,542,96,119,215,1.9171270718232045,25.719537014940318
Task_28774,705,593,193,121,314,1.1868686868686869,20.87224949492151
Task_28775,1450,425,33,132,165,3.403755868544601,31.540796260296286
Task_28776,636,506,163,130,293,1.2544378698224852,19.386476707609663
Task_28777,1662,961,186,149,335,1.7276507276507276,37.380456063456855
Task_28778,997,851,173,117,290,1.17018779342723,26.183870269589267
Task_28779,2308,85,78,27,105,26.837209302325583,41.51795697032738
Task_28780,2467,857,96,66,162,2.875291375291375,48.244859352925204
Task_28781,1503,85,196,183,379,17.476744186046513,31.502933206639923
Task_28782,2029,291,120,184,304,6.948630136986301,40.98436466512583
Task_28783,1434,953,83,142,225,1.5031446540880504,33.25948956320118
Task_28784,647,782,136,180,316,0.8263090676883781,20.632392742993456
Task_28785,2393,603,134,172,306,3.9619205298013247,47.756396792749676
Task_28786,1791,414,19,51,70,4.31566265060241,35.02094127643995
Task_28787,1702,80,11,128,139,21.012345679012345,32.933611728604305
Task_28788,2576,915,69,147,216,2.8122270742358078,51.31613302569803
Task_28789,1244,568,10,197,207,2.186291739894552,29.042842659198
Task_28790,1484,921,142,145,287,1.6095444685466378,34.21352199288591
Task_28791,1820,943,113,53,166,1.9279661016949152,38.39763254194737
Task_28792,2218,90,103,106,209,24.373626373626372,41.91265292939391
Task_28793,2839,236,46,63,109,11.978902953586498,51.80889581241919
Task_28794,1961,998,96,186,282,1.962962962962963,42.11515217687884
Task_28795,1945,547,80,48,128,3.5492700729927007,38.74413704971753
Task_28796,2057,583,49,179,228,3.5222602739726026,42.19142385076203
Task_28797,1029,586,41,137,178,1.7529812606473594,25.291107320920634
Task_28798,1826,642,175,133,308,2.839813374805599,38.85165797516923
Task_28799,2738,316,171,80,251,8.637223974763407,51.60481189564786
Task_28800,2537,757,187,12,199,3.346965699208443,49.02139148545995
Task_28801,2474,1004,76,25,101,2.4616915422885572,48.07303812022295
Task_28802,2925,646,55,11,66,4.520865533230293,53.16942496955783
Task_28803,2640,143,25,133,158,18.333333333333332,48.55729462524707
Task_28804,2842,461,134,107,241,6.151515151515151,54.019353069333725
Task_28805,831,505,15,142,157,1.6422924901185771,21.71879411477741
Task_28806,2698,508,150,51,201,5.300589390962672,51.16427387799041
Task_28807,1917,265,192,84,276,7.206766917293233,38.5572090622285
Task_28808,594,654,168,52,220,0.9068702290076336,18.506095425151113
Task_28809,597,234,167,193,360,2.5404255319148934,18.42856908494173
Task_28810,1579,410,72,171,243,3.8418491484184916,34.09400129901787
Task_28811,738,136,161,167,328,5.386861313868613,19.801945796584835
Task_28812,1872,896,151,69,220,2.0869565217391304,39.41366756574785
Task_28813,962,134,114,154,268,7.125925925925926,22.96448899441857
Task_28814,2482,751,188,46,234,3.300531914893617,48.41965826596532
Task_28815,2364,168,94,182,276,13.988165680473372,45.51455630321886
Task_28816,1561,621,133,16,149,2.509646302250804,32.62052485631253
Task_28817,1360,273,23,54,77,4.963503649635037,27.807493401989873
Task_28818,528,765,18,15,33,0.6892950391644909,15.756073233700844
Task_28819,1166,807,134,168,302,1.443069306930693,28.867595501292655
Task_28820,2967,210,84,160,244,14.061611374407583,55.24425679380306
Task_28821,1623,947,164,32,196,1.7120253164556962,35.25379309758709
Task_28822,2547,623,48,71,119,4.081730769230769,48.80149271652065
Task_28823,1579,949,54,119,173,1.6621052631578948,35.341373092972056
Task_28824,1747,123,75,41,116,14.088709677419354,33.34164562046603
Task_28825,908,705,79,97,176,1.2861189801699717,23.764212848690047
Task_28826,2014,671,10,151,161,2.9970238095238093,40.9893472005879
Task_28827,2722,235,108,81,189,11.533898305084746,50.708417729591
Task_28828,2996,330,56,176,232,9.051359516616314,56.23294206742972
Task_28829,789,946,33,45,78,0.8331573389651531,20.715138836814372
Task_28830,1462,253,54,97,151,5.755905511811024,30.965697928708405
Task_28831,2250,296,42,160,202,7.575757575757576,44.01427805376321
Task_28832,1627,404,136,99,235,4.017283950617284,34.55082024090844
Task_28833,1678,731,11,68,79,2.2923497267759565,34.51100217748364
Task_28834,527,280,179,190,369,1.8754448398576513,17.506280694354853
Task_28835,1715,940,117,10,127,1.822529224229543,35.98342868615728
Task_28836,2360,464,112,200,312,5.075268817204301,46.85599843995309
Task_28837,509,375,37,69,106,1.3537234042553192,15.341293505327599
Task_28838,1650,407,113,34,147,4.044117647058823,33.53538191972313
Task_28839,1962,358,198,96,294,5.465181058495822,40.000497583702945
Task_28840,1921,261,36,151,187,7.3320610687022905,38.56878719874422
Task_28841,1301,674,107,120,227,1.9274074074074075,30.252352734156293
Task_28842,1618,634,159,21,180,2.548031496062992,33.83943473836676
Task_28843,863,323,110,183,293,2.6635802469135803,22.603208622924342
Task_28844,2316,839,86,195,281,2.757142857142857,47.24281767079057
Task_28845,1561,675,198,45,243,2.309171597633136,33.59819982152875
Task_28846,965,83,173,135,308,11.488095238095237,22.66653462286472
Task_28847,1908,254,25,169,194,7.482352941176471,38.47358210688289
Task_28848,2753,750,12,177,189,3.66577896138482,53.378890706953776
Task_28849,1143,194,17,168,185,5.861538461538461,25.80029429721705
Task_28850,1892,488,133,26,159,3.869120654396728,37.59700790240126
Task_28851,947,179,115,38,153,5.261111111111111,21.44170317047977
Task_28852,1589,574,61,137,198,2.763478260869565,34.5223270869778
Task_28853,1499,79,197,106,303,18.7375,30.946231333177916
Task_28854,1739,464,90,27,117,3.739784946236559,34.852531712815555
Task_28855,2111,1009,96,28,124,2.09009900990099,42.58779068384967
Task_28856,865,486,160,139,299,1.7761806981519508,23.09931819295562
Task_28857,1979,755,114,25,139,2.617724867724868,39.69876201631575
Task_28858,2697,331,139,132,271,8.123493975903614,51.46025626364902
Task_28859,2711,485,13,129,142,5.578189300411522,51.36981844197252
Task_28860,2317,331,18,193,211,6.978915662650603,45.2435240808602
Task_28861,1074,864,111,77,188,1.2416184971098265,26.544249455435935
Task_28862,2242,930,154,128,282,2.4081632653061225,46.218578994265634
Task_28863,634,954,72,176,248,0.6638743455497382,20.92053292064728
Task_28864,2411,680,97,65,162,3.5403817914831133,46.79428805659965
Task_28865,1792,100,104,106,210,17.742574257425744,35.27573835055008
Task_28866,2511,317,196,192,388,7.89622641509434,49.085583487047565
Task_28867,1526,729,181,191,372,2.0904109589041098,34.745662384224595
Task_28868,2808,223,114,172,286,12.535714285714286,52.94565065095461
Task_28869,1535,972,100,165,265,1.5775950668037,35.08074160703437
Task_28870,604,837,52,150,202,0.720763723150358,19.767965358307666
Task_28871,1810,892,24,156,180,2.0268756998880177,38.70108385920805
Task_28872,1300,277,20,138,158,4.676258992805756,28.354090948956237
Task_28873,694,541,129,164,293,1.2804428044280443,20.494704633844403
Task_28874,511,225,27,82,109,2.2610619469026547,15.278271326045603
Task_28875,2300,791,179,91,270,2.904040404040404,46.44887926515677
Task_28876,2112,303,167,84,251,6.947368421052632,41.65872357989878
Task_28877,2806,752,85,107,192,3.7264276228419653,54.20789820461439
Task_28878,1169,730,40,74,114,1.5991792065663475,27.357156058696933
Task_28879,970,206,123,151,274,4.685990338164252,23.776314571988877
Task_28880,628,311,117,127,244,2.0128205128205128,18.545861272563275
Task_28881,2990,172,121,131,252,17.283236994219653,55.027376403563835
Task_28882,1337,212,175,53,228,6.276995305164319,28.832943829837337
Task_28883,2145,119,41,150,191,17.875,41.1635210692935
Task_28884,1417,486,86,193,279,2.909650924024641,31.882210268479856
Task_28885,2543,804,113,79,192,3.1590062111801243,49.82169016487677
Task_28886,789,938,18,151,169,0.8402555910543131,22.345368394107414
Task_28887,667,485,199,167,366,1.3724279835390947,20.25685406425242
Task_28888,2150,330,191,103,294,6.495468277945619,42.86702840572892
Task_28889,1356,894,33,73,106,1.5150837988826815,30.486611402705922
Task_28890,1040,764,37,110,147,1.3594771241830066,25.670458455807353
Task_28891,798,519,197,139,336,1.5346153846153847,22.279272147963336
Task_28892,2242,855,92,190,282,2.619158878504673,46.15300101348566
Task_28893,1079,629,46,41,87,1.7126984126984126,24.532749971430373
Task_28894,2568,461,126,56,182,5.558441558441558,48.73128257071277
Task_28895,918,902,12,76,88,1.0166112956810631,23.342464789643355
Task_28896,1342,672,91,186,277,1.9940564635958395,31.26688887823641
Task_28897,663,588,22,45,67,1.1256366723259763,17.4557719832552
Task_28898,1752,297,89,192,281,5.879194630872483,36.57353356276848
Task_28899,1295,939,57,200,257,1.377659574468085,31.295672558601364
Task_28900,1479,974,56,33,89,1.5169230769230768,31.959013341660977
Task_28901,2235,234,119,38,157,9.51063829787234,42.227628498784306
Task_28902,2037,969,11,56,67,2.1,40.71605054101382
Task_28903,944,196,124,162,286,4.791878172588833,23.356209418902637
Task_28904,516,130,83,165,248,3.9389312977099236,15.889973012741741
Task_28905,1410,75,70,81,151,18.55263157894737,28.35210437874889
Task_28906,2493,647,173,68,241,3.8472222222222223,48.593727628764206
Task_28907,901,402,75,37,112,2.235732009925558,21.404261277560547
Task_28908,710,286,117,107,224,2.4738675958188154,19.64300447853208
Task_28909,2513,578,118,22,140,4.3402417962003454,47.60888349617965
Task_28910,778,537,139,141,280,1.446096654275093,21.74369043240309
Task_28911,2405,391,25,188,213,6.135204081632653,46.9134109261421
Task_28912,2504,897,63,98,161,2.7884187082405347,49.500065164320915
Task_28913,2803,303,91,34,125,9.220394736842104,51.300219422187894
Task_28914,1222,984,131,27,158,1.2406091370558376,28.483104399769886
Task_28915,2293,96,150,109,259,23.63917525773196,43.25033884628487
Task_28916,2384,921,129,86,215,2.585683297180043,47.81299565720253
Task_28917,1174,980,74,116,190,1.1967380224260957,29.048162571743337
Task_28918,2488,544,132,91,223,4.565137614678899,48.43346302373816
Task_28919,1651,891,39,33,72,1.850896860986547,34.02871987646528
Task_28920,2412,422,69,106,175,5.702127659574468,46.84219151161502
Task_28921,2949,762,12,129,141,3.865006553079948,55.95628881129138
Task_28922,553,197,178,36,214,2.792929292929293,16.105612185272573
Task_28923,2490,742,193,62,255,3.351278600269179,48.84840493740571
Task_28924,2771,498,196,59,255,5.55310621242485,52.48322230922046
Task_28925,1190,179,191,19,210,6.611111111111111,25.652446776861492
Task_28926,1477,173,187,170,357,8.488505747126437,31.691555119804416
Task_28927,981,929,82,28,110,1.0548387096774194,24.24186531574095
Task_28928,2432,151,138,175,313,16.0,46.522192077680806
Task_28929,1194,737,61,145,206,1.6178861788617886,28.810222035942683
Task_28930,2168,944,119,154,273,2.2941798941798943,45.08713429082317
Task_28931,2054,605,12,162,174,3.3894389438943895,41.72479798083944
Task_28932,1764,251,97,137,234,7.0,36.296197201379584
Task_28933,1074,546,196,84,280,1.963436928702011,26.14967099400565
Task_28934,1126,506,41,160,201,2.2209072978303745,26.908947255970485
Task_28935,1383,885,114,164,278,1.5609480812641083,32.459425576886396
Task_28936,2233,1019,112,166,278,2.18921568627451,46.390650728054304
Task_28937,2581,814,172,69,241,3.1668711656441717,50.48583320776302
Task_28938,2412,236,81,185,266,10.177215189873417,46.77370321207172
Task_28939,2027,167,123,21,144,12.06547619047619,38.2721497696273
Task_28940,1975,370,185,146,331,5.32345013477089,40.462308602879084
Task_28941,2594,370,191,53,244,6.991913746630728,49.319224087215304
Task_28942,2256,158,103,96,199,14.18867924528302,43.178235299626124
Task_28943,1799,473,84,72,156,3.7953586497890295,36.461216472308166
Task_28944,2407,772,167,145,312,3.1138421733505823,48.49903961462283
Task_28945,1924,820,66,104,170,2.343483556638246,40.23141651031482
Task_28946,1600,1000,76,177,253,1.5984015984015985,36.32860474128757
Task_28947,1123,181,196,34,230,6.170329670329671,24.8728176892773
Task_28948,2162,744,27,10,37,2.902013422818792,41.22588237600443
Task_28949,1856,222,136,55,191,8.32286995515695,36.88197700982681
Task_28950,1475,516,51,95,146,2.852998065764023,32.03331389603317
Task_28951,2397,342,41,36,77,6.988338192419825,44.07170635116882
Task_28952,989,574,94,45,139,1.72,23.55402650821588
Task_28953,2549,529,91,194,285,4.809433962264151,49.97692491042728
Task_28954,2002,472,182,100,282,4.232558139534884,40.933195680405376
Task_28955,697,664,127,43,170,1.0481203007518798,19.339049104441724
Task_28956,2457,67,68,190,258,36.13235294117647,45.81378559374343
Task_28957,1280,825,60,28,88,1.549636803874092,28.2747281871693
Task_28958,1933,325,64,112,176,5.929447852760736,38.87150054127175
Task_28959,1818,167,51,131,182,10.821428571428571,36.22798046095438
Task_28960,537,780,155,24,179,0.6875800256081946,17.5224593839926
Task_28961,2114,542,12,160,172,3.8931860036832413,42.45668032035596
Task_28962,2009,151,131,54,185,13.217105263157896,38.597012021928364
Task_28963,2437,704,163,53,216,3.4567375886524823,47.78542552605928
Task_28964,1436,621,165,186,351,2.3086816720257235,32.88045159801972
Task_28965,2450,317,169,28,197,7.70440251572327,46.31775753497079
Task_28966,1545,145,131,11,142,10.582191780821917,30.542060271804477
Task_28967,962,424,83,106,189,2.263529411764706,23.93568645130399
Task_28968,781,347,10,144,154,2.2442528735632186,20.356735180778372
Task_28969,604,427,151,107,258,1.411214953271028,18.49678552410012
Task_28970,1522,588,22,179,201,2.5840407470288627,33.421959166827776
Task_28971,1326,214,28,177,205,6.167441860465116,29.192825407517812
Task_28972,2476,794,127,58,185,3.1144654088050316,48.30597366401832
Task_28973,2326,252,87,161,248,9.193675889328063,45.26273114346378
Task_28974,1132,747,68,102,170,1.5133689839572193,27.414902615389703
Task_28975,760,764,14,17,31,0.9934640522875817,19.312649900247923
Task_28976,1849,86,34,38,72,21.25287356321839,33.999557833936365
Task_28977,2917,186,133,156,289,15.598930481283423,54.65493078796353
Task_28978,992,74,19,79,98,13.226666666666667,21.179446792729518
Task_28979,1360,579,33,179,212,2.3448275862068964,30.956248602858903
Task_28980,1943,750,17,171,188,2.5872170439414113,40.45905772654055
Task_28981,2861,712,17,54,71,4.012622720897616,52.95180046592851
Task_28982,2526,917,156,184,340,2.7516339869281046,51.02171808254565
Task_28983,1443,887,105,81,186,1.625,32.43988657065527
Task_28984,528,690,135,44,179,0.76410998552822,16.890120506656128
Task_28985,1112,530,193,23,216,2.0941619585687383,25.89536727370233
Task_28986,1692,682,198,106,304,2.4773060029282576,36.79716381606652
Task_28987,1510,97,37,24,61,15.408163265306122,28.614420066221783
Task_28988,1700,909,133,141,274,1.8681318681318682,37.547875007638915
Task_28989,1486,884,168,71,239,1.6790960451977401,33.388540526608644
Task_28990,1596,357,41,93,134,4.4581005586592175,33.21833193762978
Task_28991,833,321,104,139,243,2.5869565217391304,21.83252812546969
Task_28992,2143,338,154,77,231,6.321533923303835,42.10264867072044
Task_28993,1261,980,10,145,155,1.2854230377166156,29.84849070695425
Task_28994,2142,328,75,132,207,6.51063829787234,42.52019161081903
Task_28995,1952,805,69,53,122,2.4218362282878414,39.72105674246314
Task_28996,928,276,39,86,125,3.3501805054151625,22.239744441962074
Task_28997,2466,338,138,27,165,7.274336283185841,46.418409636769496
Task_28998,1236,441,198,191,389,2.7963800904977374,29.325238550377204
Task_28999,1626,1018,57,67,124,1.5956820412168793,35.44838076099955
Task_29000,2943,410,84,141,225,7.160583941605839,55.47380424795093
Task_29001,2439,199,57,28,85,12.195,44.58521820922642
Task_29002,757,570,114,169,283,1.3257443082311733,21.596411356232718
Task_29003,527,598,84,115,199,0.8797996661101837,17.54674280404608
Task_29004,2257,405,150,174,324,5.559113300492611,45.04903584095368
Task_29005,1644,965,68,63,131,1.7018633540372672,35.577055683956985
Task_29006,1771,306,166,132,298,5.768729641693811,36.8532088041366
Task_29007,2684,736,47,188,235,3.6417910447761193,52.54036447891438
Task_29008,600,913,87,100,187,0.6564551422319475,19.74530657837933
Task_29009,2843,125,180,193,373,22.563492063492063,53.06526168973331
Task_29010,2175,209,87,187,274,10.357142857142858,42.87218770725121
Task_29011,1993,998,38,23,61,1.994994994994995,39.72126651557078
Task_29012,2218,236,133,96,229,9.358649789029537,43.33190412810101
Task_29013,2069,323,45,53,98,6.385802469135802,39.649392476067675
Task_29014,1321,564,107,177,284,2.338053097345133,30.565304083666675
Task_29015,1823,671,22,126,148,2.712797619047619,37.81267315522351
Task_29016,2758,382,195,78,273,7.201044386422977,52.23133804524937
Task_29017,546,320,76,17,93,1.7009345794392523,15.183978346261798
Task_29018,2259,357,19,127,146,6.310055865921788,43.7335985367396
Task_29019,2484,864,57,169,226,2.871676300578035,49.81347680129457
Task_29020,1015,251,181,21,202,4.027777777777778,23.348094940862016
Task_29021,2984,494,30,27,57,6.028282828282828,53.929065829771965
Task_29022,1111,423,179,105,284,2.6202830188679247,26.690497508644018
Task_29023,2615,343,95,123,218,7.601744186046512,50.02269459500757
Task_29024,1134,494,37,10,47,2.290909090909091,24.28722782640837
Task_29025,1368,876,60,140,200,1.5598631698973775,31.938675943009695
Task_29026,1820,491,28,77,105,3.6991869918699187,36.61986601256803
Task_29027,1764,412,127,141,268,4.271186440677966,36.96972458636513
Task_29028,1613,708,80,173,253,2.2750352609308884,35.62279621395378
Task_29029,2213,709,141,166,307,3.1169014084507043,45.23610985097465
Task_29030,695,621,28,66,94,1.117363344051447,18.945749376947052
Task_29031,2693,971,166,95,261,2.7705761316872426,53.321917718198556
Task_29032,1213,747,13,86,99,1.6216577540106951,27.84021185600788
Task_29033,1382,664,59,194,253,2.0781954887218044,31.884424181269676
Task_29034,1520,998,65,136,201,1.5215215215215214,34.72232510176317
Task_29035,711,726,39,35,74,0.9779917469050894,18.75520991986362
Task_29036,629,331,110,83,193,1.894578313253012,18.035410658420812
Task_29037,1919,887,192,178,370,2.161036036036036,41.436467605694425
Task_29038,661,86,173,189,362,7.597701149425287,18.23727080773212
Task_29039,1048,959,41,10,51,1.0916666666666666,24.545112221403837
Task_29040,2488,352,109,200,309,7.048158640226629,48.497401268512455
Task_29041,1547,448,163,152,315,3.44543429844098,33.87917672160329
Task_29042,2952,456,18,15,33,6.459518599562363,52.750150741192954
Task_29043,1564,342,65,183,248,4.559766763848397,33.67409866061374
Task_29044,1063,132,122,88,210,7.992481203007519,24.015576830236665
Task_29045,2734,856,175,46,221,3.190198366394399,52.68314268232127
Task_29046,2742,971,26,75,101,2.8209876543209877,52.73226828326728
Task_29047,1843,832,150,159,309,2.2124849939975992,39.75815489200367
Task_29048,1774,339,56,170,226,5.2176470588235295,36.90083553885563
Task_29049,1981,656,197,171,368,3.015220700152207,41.67681018310663
Task_29050,931,944,21,71,92,0.9851851851851852,23.838161983878603
Task_29051,919,734,114,129,243,1.2503401360544217,24.350085374408696
Task_29052,1825,900,146,115,261,2.025527192008879,39.40385929663318
Task_29053,1277,878,67,190,257,1.452787258248009,30.79685229063227
Task_29054,2383,101,70,23,93,23.362745098039216,42.93567420709798
Task_29055,2225,501,10,48,58,4.432270916334661,42.00459655951992
Task_29056,2090,979,66,138,204,2.13265306122449,43.74822394752775
Task_29057,839,650,181,176,357,1.2887864823348694,23.435940543023033
Task_29058,1973,405,10,11,21,4.859605911330049,37.13021225054449
Task_29059,2987,315,189,98,287,9.45253164556962,56.015892470288954
Task_29060,1585,226,198,110,308,6.9823788546255505,33.65041100800581
Task_29061,1057,730,88,125,213,1.4459644322845417,26.454614252240365
Task_29062,1256,810,47,25,72,1.5487053020961776,27.519683180111358
Task_29063,1648,841,189,17,206,1.9572446555819478,35.14203356137253
Task_29064,2108,1006,17,125,142,2.0933465739821253,43.3322029865044
Task_29065,2845,72,100,173,273,38.97260273972603,51.90246399679548
Task_29066,1446,409,120,168,288,3.526829268292683,32.05757686316399
Task_29067,592,545,32,25,57,1.0842490842490842,16.329757627485503
Task_29068,1943,919,30,90,120,2.1119565217391303,40.296260329238784
Task_29069,1734,634,135,14,149,2.730708661417323,35.398352772740246
Task_29070,2204,774,170,193,363,2.8438709677419354,45.58952181073719
Task_29071,2685,226,43,55,98,11.82819383259912,49.08572280731456
Task_29072,1160,919,79,50,129,1.2608695652173914,27.467597271781642
Task_29073,2439,623,84,14,98,3.9086538461538463,46.083360352394585
Task_29074,1947,798,80,126,206,2.436795994993742,40.914474956049354
Task_29075,1446,141,55,84,139,10.183098591549296,29.578538436952005
Task_29076,2417,477,132,37,169,5.056485355648536,46.052343717466364
Task_29077,1771,416,95,28,123,4.247002398081535,35.38704826753181
Task_29078,1640,348,109,157,266,4.699140401146132,34.8136153774011
Task_29079,858,177,72,58,130,4.820224719101123,20.15374849026487
Task_29080,2321,821,40,94,134,2.82360097323601,46.173043342019774
Task_29081,1555,365,180,29,209,4.248633879781421,32.423324670980094
Task_29082,2836,292,175,163,338,9.679180887372013,53.8681624251678
Task_29083,2142,689,75,121,196,3.1043478260869564,43.61835100531675
Task_29084,2231,660,150,113,263,3.3751891074130107,45.090873333639415
Task_29085,1979,515,97,187,284,3.8352713178294575,40.86708319164884
Task_29086,1868,665,29,35,64,2.804804804804805,36.751746878826914
Task_29087,968,1002,171,13,184,0.9651046859421735,24.777735711003512
Task_29088,1055,847,173,90,263,1.2441037735849056,26.72290535714949
Task_29089,2030,939,64,106,170,2.1595744680851063,42.29001696248121
Task_29090,984,735,98,153,251,1.3369565217391304,25.550762433296956
Task_29091,2447,515,62,45,107,4.742248062015504,45.893275867374776
Task_29092,1444,144,132,36,168,9.958620689655172,29.27534049031979
Task_29093,2414,208,52,174,226,11.55023923444976,46.5674091428138
Task_29094,858,623,117,30,147,1.375,21.674885577998424
Task_29095,2420,570,64,15,79,4.2381786339754814,45.06393372739513
Task_29096,1925,612,42,166,208,3.1402936378466557,39.93638623744818
Task_29097,2642,376,127,24,151,7.007957559681698,49.04339179728742
Task_29098,2707,488,111,177,288,5.5357873210633946,52.28505490422682
Task_29099,2307,180,134,171,305,12.74585635359116,44.56733381705633
Task_29100,1375,603,102,125,227,2.2764900662251657,31.209675451233977
Task_29101,2670,780,80,123,203,3.418693982074264,52.2945230826575
Task_29102,1978,345,169,39,208,5.716763005780347,38.995347820375926
Task_29103,1073,587,97,183,280,1.8248299319727892,26.724604345550144
Task_29104,877,765,29,81,110,1.1449086161879896,22.688869222951656
Task_29105,770,954,48,105,153,0.806282722513089,21.97376271670862
Task_29106,1875,375,80,177,257,4.986702127659575,38.73592108601765
Task_29107,1621,608,75,191,266,2.6617405582922826,35.529812747675486
Task_29108,1858,90,58,22,80,20.417582417582416,34.21599071406582
Task_29109,543,149,170,54,224,3.62,15.83269146607721
Task_29110,1125,635,196,32,228,1.7688679245283019,26.537928434322883
Task_29111,2569,796,80,186,266,3.223337515683814,51.120962623222134
Task_29112,575,732,31,13,44,0.7844474761255116,16.373963469640636
Task_29113,1201,887,193,27,220,1.3524774774774775,28.465997284973266
Task_29114,1752,168,48,63,111,10.366863905325443,34.109128369072984
Task_29115,2791,184,36,90,126,15.086486486486486,51.31422673845159
Task_29116,2802,807,150,60,210,3.467821782178218,53.7586986436091
Task_29117,1587,540,132,68,200,2.933456561922366,33.72258164975905
Task_29118,1342,377,143,68,211,3.5502645502645502,29.37477315026585
Task_29119,2183,560,68,63,131,3.89126559714795,42.85576164304202
Task_29120,1324,169,107,182,289,7.788235294117647,29.073042337297093
Task_29121,2037,743,61,140,201,2.7379032258064515,42.166918890835035
Task_29122,2977,197,112,187,299,15.035353535353535,55.633392053459424
Task_29123,983,453,62,186,248,2.1651982378854626,24.843961643435364
Task_29124,2576,542,53,166,219,4.7440147329650095,50.22825737734968
Task_29125,2031,96,93,35,128,20.938144329896907,37.65330919553487
Task_29126,2349,600,28,159,187,3.908485856905158,46.498305456204804
Task_29127,1165,715,200,59,259,1.6270949720670391,27.759651525956546
Task_29128,2536,137,77,174,251,18.3768115942029,47.908995184133566
Task_29129,2766,359,128,164,292,7.683333333333334,52.78938697684375
Task_29130,2771,501,27,19,46,5.5199203187251,50.2008605597426
Task_29131,2180,530,117,72,189,4.105461393596987,43.028953608405835
Task_29132,707,743,59,95,154,0.9502688172043011,20.35328354454377
Task_29133,2587,156,161,172,333,16.477707006369428,49.10638546944431
Task_29134,2528,882,120,98,218,2.8629671574178936,50.271412928386574
Task_29135,2107,630,31,92,123,3.3391442155309035,42.131402403400465
Task_29136,2289,654,134,169,303,3.4946564885496185,46.25295354900385
Task_29137,1923,459,87,38,125,4.180434782608696,37.87877549470208
Task_29138,2834,294,109,135,244,9.60677966101695,53.37901824674024
Task_29139,1469,599,61,142,203,2.4483333333333333,32.7305068903172
Task_29140,2399,229,144,95,239,10.430434782608696,46.15653448712113
Task_29141,629,997,86,164,250,0.6302605210420842,20.907159595558696
Task_29142,838,659,152,66,218,1.2696969696969698,22.261407881518775
Task_29143,781,172,19,13,32,4.514450867052023,17.592449234641048
Task_29144,2422,493,148,132,280,4.902834008097166,47.68748557001942
Task_29145,1919,260,134,78,212,7.352490421455939,38.26995368576201
Task_29146,915,525,67,138,205,1.7395437262357414,23.710062705006212
Task_29147,1584,419,131,68,199,3.7714285714285714,33.28516532115446
Task_29148,2355,193,156,28,184,12.139175257731958,44.20783455844932
Task_29149,766,754,81,71,152,1.014569536423841,20.835955690501567
Task_29150,1192,238,27,14,41,4.98744769874477,24.30033604845526
Task_29151,2015,363,29,190,219,5.535714285714286,40.67261699213804
Task_29152,1721,291,66,30,96,5.8938356164383565,33.78899977376309
Task_29153,971,691,79,190,269,1.403179190751445,25.43674333025856
Task_29154,1084,618,45,129,174,1.751211631663974,26.336402288672033
Task_29155,1709,140,70,95,165,12.120567375886525,34.23513049070212
Task_29156,2933,892,182,51,233,3.284434490481523,56.2489614099743
Task_29157,1269,756,66,134,200,1.676354029062087,30.008932395682393
Task_29158,1744,850,122,115,237,2.0493537015276146,37.85665833065421
Task_29159,2042,496,196,141,337,4.1086519114688125,41.9514583300323
Task_29160,2163,751,77,76,153,2.8763297872340425,43.20640002933761
Task_29161,2170,238,85,89,174,9.07949790794979,42.09182312135358
Task_29162,2705,218,183,144,327,12.351598173515981,51.44305133942055
Task_29163,1530,401,16,184,200,3.8059701492537314,32.9511365164044
Task_29164,1608,649,70,113,183,2.473846153846154,34.786260036434314
Task_29165,1404,671,162,139,301,2.0892857142857144,32.23581828441626
Task_29166,1651,283,147,129,276,5.813380281690141,34.77468499173548
Task_29167,2382,354,56,133,189,6.709859154929577,46.32017346989699
Task_29168,718,103,165,195,360,6.903846153846154,19.212884249623645
Task_29169,2180,994,200,200,400,2.190954773869347,46.072713263449394
Task_29170,575,680,156,41,197,0.8443465491923642,17.865699988282444
Task_29171,542,937,21,29,50,0.5778251599147122,16.813987182351777
Task_29172,2751,1005,94,16,110,2.734592445328032,52.496801248407564
Task_29173,2120,668,159,147,306,3.1689088191330343,43.60160128422611
Task_29174,2750,966,135,199,334,2.843846949327818,54.71916954135268
Task_29175,2706,223,92,97,189,12.080357142857142,50.88160768181112
Task_29176,1739,367,59,70,129,4.725543478260869,35.30894360184458
Task_29177,2064,707,94,14,108,2.9152542372881354,40.678864309429684
Task_29178,1286,453,117,73,190,2.8325991189427313,28.66472234556159
Task_29179,2619,342,163,70,233,7.635568513119534,49.55777623587286
Task_29180,1229,1008,169,112,281,1.218037661050545,30.25707039379505
Task_29181,2636,971,62,56,118,2.711934156378601,50.93731092843348
Task_29182,1196,928,121,101,222,1.28740581270183,29.23554609505074
Task_29183,2710,345,177,167,344,7.832369942196531,52.094434306885056
Task_29184,2388,553,14,180,194,4.310469314079422,47.06717480328269
Task_29185,2738,170,172,153,325,16.01169590643275,51.416454857178536
Task_29186,750,565,48,109,157,1.325088339222615,20.57066747270613
Task_29187,807,64,189,30,219,12.415384615384616,18.82770796902371
Task_29188,2814,473,41,154,195,5.936708860759493,53.489476149167196
Task_29189,2891,302,59,56,115,9.541254125412541,52.87852839951145
Task_29190,1525,129,26,41,67,11.73076923076923,29.303054922013757
Task_29191,502,362,137,113,250,1.3829201101928374,16.65206392411973
Task_29192,1157,953,79,47,126,1.2127882599580713,27.377578337643303
Task_29193,2555,552,162,144,306,4.620253164556962,50.11790848533051
Task_29194,2938,486,44,63,107,6.032854209445585,54.17922918540248
Task_29195,2424,411,89,119,208,5.883495145631068,47.147821792885075
Task_29196,1413,498,178,196,374,2.8316633266533064,32.24741692657411
Task_29197,1884,645,103,99,202,2.91640866873065,39.23733177476684
Task_29198,672,578,26,55,81,1.160621761658031,18.32061584588976
Task_29199,2482,377,183,97,280,6.5661375661375665,48.23861276619803
Task_29200,1941,303,113,85,198,6.384868421052632,38.736570491797366
Task_29201,2020,482,114,104,218,4.182194616977226,40.967684194137334
Task_29202,2289,768,161,45,206,2.976592977893368,45.25504364383655
Task_29203,1853,789,98,17,115,2.3455696202531646,37.4523839599072
Task_29204,622,354,126,55,181,1.7521126760563381,17.577208131932775
Task_29205,1888,536,72,169,241,3.515828677839851,39.37628967082557
Task_29206,1921,349,127,129,256,5.488571428571428,39.17558475875678
Task_29207,2227,681,93,133,226,3.2653958944281527,45.068248886106005
Task_29208,1178,661,149,193,342,1.7794561933534743,28.87547758846179
Task_29209,625,325,184,81,265,1.9171779141104295,18.246908500765297
Task_29210,2335,187,125,51,176,12.420212765957446,44.19763366234802
Task_29211,1138,296,170,149,319,3.8316498316498318,26.931386746416862
Task_29212,2079,536,71,58,129,3.8715083798882683,41.00376810019857
Task_29213,1043,867,98,77,175,1.2016129032258065,26.02283403863953
Task_29214,1297,548,149,147,296,2.3624772313296902,30.145113911278443
Task_29215,882,479,127,105,232,1.8375,23.00810402979576
Task_29216,555,256,159,121,280,2.159533073929961,17.36987914079336
Task_29217,827,648,192,10,202,1.2742681047765794,21.57206358680069
Task_29218,2989,779,55,102,157,3.832051282051282,56.81639765967268
Task_29219,813,186,187,73,260,4.347593582887701,20.914380709798234
Task_29220,645,649,85,67,152,0.9923076923076923,18.623501802055145
Task_29221,1827,337,30,186,216,5.405325443786983,37.59312265089932
Task_29222,1412,846,35,134,169,1.667060212514758,32.13675667146957
Task_29223,1565,617,180,149,329,2.5323624595469254,34.75753202414133
Task_29224,2791,453,184,64,248,6.147577092511013,52.69911719830873
Task_29225,1646,839,166,16,182,1.9595238095238094,34.86920824253025
Task_29226,1551,220,91,122,213,7.018099547511312,32.73074126102437
Task_29227,976,867,42,53,95,1.1244239631336406,24.038539438237297
Task_29228,1408,363,22,122,144,3.868131868131868,30.26247427599081
Task_29229,2908,539,174,83,257,5.385185185185185,55.06181953526046
Task_29230,2730,275,82,190,272,9.891304347826088,51.96561703212068
Task_29231,2752,830,160,118,278,3.3116726835138386,53.954136916797346
Task_29232,2969,903,64,162,226,3.28429203539823,57.579415808444274
Task_29233,1885,669,66,45,111,2.8134328358208953,37.689165743479386
Task_29234,2391,811,99,79,178,2.9445812807881775,47.184355017745
Task_29235,2642,725,30,68,98,3.6391184573002753,50.21101305242066
Task_29236,981,529,56,73,129,1.850943396226415,23.934557694620796
Task_29237,1877,524,134,167,301,3.5752380952380953,39.304470362448086
Task_29238,2295,519,74,115,189,4.413461538461538,45.43046944457007
Task_29239,690,929,54,143,197,0.7419354838709677,21.245113913995496
Task_29240,2946,804,21,59,80,3.6596273291925465,54.79602410846531
Task_29241,504,85,168,114,282,5.8604651162790695,15.30058441778965
Task_29242,2824,670,66,47,113,4.208643815201192,52.72641071663265
Task_29243,1821,157,67,150,217,11.525316455696203,36.60277345956628
Task_29244,642,804,102,44,146,0.7975155279503106,18.841935474357996
Task_29245,1351,953,10,73,83,1.4161425576519917,30.26619836840024
Task_29246,2392,587,78,143,221,4.068027210884353,47.39475863600984
Task_29247,802,467,125,136,261,1.7136752136752136,21.8668481947855
Task_29248,1333,621,152,88,240,2.143086816720257,30.353298047687414
Task_29249,1585,133,190,140,330,11.828358208955224,33.02879853221661
Task_29250,2677,952,128,143,271,2.809024134312697,53.152643847857554
Task_29251,1378,377,166,188,354,3.6455026455026456,31.20541038785483
Task_29252,1269,371,97,153,250,3.411290322580645,28.965247020886924
Task_29253,972,618,76,93,169,1.5702746365105007,24.399748949819486
Task_29254,1641,665,58,171,229,2.463963963963964,35.847890014250005
Task_29255,597,152,43,141,184,3.9019607843137254,16.789032972644215
Task_29256,1528,421,51,192,243,3.6208530805687205,33.42204051178768
Task_29257,1467,824,32,100,132,1.778181818181818,32.68548882016043
Task_29258,2559,611,55,28,83,4.181372549019608,47.88737361036152
Task_29259,625,818,46,53,99,0.7631257631257631,18.336680747779468
Task_29260,2611,87,167,109,276,29.670454545454547,48.28739800713976
Task_29261,2762,720,10,16,26,3.8307905686546464,50.68063130054984
Task_29262,1046,490,197,44,241,2.130346232179226,24.88258293608962
Task_29263,1583,404,160,158,318,3.908641975308642,34.329941043810024
Task_29264,2824,740,169,74,243,3.8110661268556005,54.23244400848537
Task_29265,2976,405,32,189,221,7.330049261083744,56.02386389348658
Task_29266,795,781,64,147,211,1.0166240409207161,22.475971262360172
Task_29267,2677,699,65,79,144,3.8242857142857143,51.32576372570791
Task_29268,1856,511,29,188,217,3.625,38.623737768410294
Task_29269,2374,825,120,105,225,2.87409200968523,47.69159011940203
Task_29270,2481,545,122,32,154,4.543956043956044,47.10827457539142
Task_29271,2688,116,56,123,179,22.974358974358974,49.41076739341568
Task_29272,2087,500,54,170,224,4.16566866267465,42.36900406305286
Task_29273,1801,965,74,10,84,1.8643892339544514,37.02186661628957
Task_29274,1588,760,180,116,296,2.0867279894875166,35.37207123411418
Task_29275,2060,98,102,135,237,20.80808080808081,39.58047536973167
Task_29276,1531,134,185,100,285,11.34074074074074,31.92150764299348
Task_29277,1216,668,46,14,60,1.8176382660687593,26.17519855327581
Task_29278,2109,194,124,102,226,10.815384615384616,41.350474832769585
Task_29279,2681,128,74,162,236,20.782945736434108,49.98834357924532
Task_29280,984,554,175,52,227,1.772972972972973,24.335326516319938
Task_29281,2504,818,200,126,326,3.057387057387057,50.215334188396035
Task_29282,1841,839,167,100,267,2.191666666666667,39.47250034422409
Task_29283,2575,1024,36,191,227,2.5121951219512195,51.64170748035263
Task_29284,1713,912,46,146,192,1.8762322015334063,37.43524483117915
Task_29285,1960,243,109,153,262,8.032786885245901,39.490403346099384
Task_29286,1258,338,154,137,291,3.7109144542772863,28.822199902958506
Task_29287,1603,671,147,41,188,2.3854166666666665,34.004219792824365
Task_29288,1309,377,139,151,290,3.462962962962963,29.771062593607834
Task_29289,1638,218,141,95,236,7.47945205479452,34.08407572186449
Task_29290,1684,568,75,13,88,2.959578207381371,33.95191025463818
Task_29291,2913,415,99,159,258,7.002403846153846,55.14527931784471
Task_29292,1547,442,26,150,176,3.492099322799097,33.11897646549483
Task_29293,2417,886,43,58,101,2.7249154453213076,46.97345703619112
Task_29294,2226,602,134,96,230,3.691542288557214,44.67814812228911
Task_29295,1194,423,87,146,233,2.8160377358490565,27.84279064184355
Task_29296,832,815,112,67,179,1.0196078431372548,22.23259706549466
Task_29297,516,465,151,73,224,1.1072961373390557,16.6026472684898
Task_29298,1197,729,20,108,128,1.6397260273972603,28.174559011950283
Task_29299,2523,381,142,197,339,6.604712041884817,49.27958204505078
Task_29300,2601,901,41,10,51,2.8835920177383594,48.89598576954263
Task_29301,2802,207,95,105,200,13.471153846153847,52.370849421889154
Task_29302,1526,522,47,131,178,2.9177820267686423,33.00232300449786
Task_29303,1825,584,53,190,243,3.1196581196581197,38.613409525980245
Task_29304,2255,364,44,116,160,6.178082191780822,43.755036990066024
Task_29305,2593,275,21,89,110,9.394927536231885,48.33062913411718
Task_29306,815,97,129,91,220,8.316326530612244,19.748888889903736
Task_29307,2740,649,133,51,184,4.2153846153846155,52.023797676564975
Task_29308,1513,495,146,137,283,3.0504032258064515,33.32439281330992
Task_29309,1368,361,179,77,256,3.7790055248618786,30.032442762703592
Task_29310,590,592,168,194,362,0.9949409780775716,19.37644914585161
Task_29311,941,958,199,137,336,0.9812304483837331,25.869366774671935
Task_29312,2710,532,96,13,109,5.084427767354597,50.294880000333535
Task_29313,2993,926,40,96,136,3.228694714131607,57.18305839931369
Task_29314,2923,931,125,92,217,3.1362660944206007,56.56629774001964
Task_29315,659,523,162,88,250,1.2576335877862594,19.313172316925648
Task_29316,1979,568,135,105,240,3.4780316344463973,40.69350590606239
Task_29317,944,923,113,146,259,1.0216450216450217,25.41591268727724
Task_29318,1391,751,179,173,352,1.8497340425531914,32.559109503943574
Task_29319,2997,940,126,26,152,3.1849096705632305,56.471454351672016
Task_29320,1332,740,99,185,284,1.7975708502024292,31.302997069572314
Task_29321,2640,702,57,98,155,3.755334281650071,51.03764001040787
Task_29322,2152,178,169,146,315,12.022346368715084,42.11326465691031
Task_29323,766,547,181,93,274,1.397810218978102,21.42207206819259
Task_29324,1039,826,134,167,301,1.256348246674728,26.8535773414191
Task_29325,1310,667,119,81,200,1.9610778443113772,29.87105524015843
Task_29326,2022,538,96,48,144,3.75139146567718,39.86865245046935
Task_29327,913,260,171,102,273,3.4980842911877397,22.980576920427534
Task_29328,2394,809,140,143,283,2.9555555555555557,48.27547003376282
Task_29329,2049,726,182,192,374,2.8184319119669876,43.031683661049954
Task_29330,1866,129,66,64,130,14.353846153846154,35.864821358162686
Task_29331,1827,769,42,83,125,2.3727272727272726,37.995031903057864
Task_29332,2183,488,86,53,139,4.4642126789366054,42.45346099980413
Task_29333,2488,456,35,175,210,5.444201312910285,48.38909314851967
Task_29334,2209,645,184,138,322,3.4195046439628483,44.99762750979642
Task_29335,1519,248,97,77,174,6.100401606425703,31.620480462388755
Task_29336,1515,935,152,40,192,1.6185897435897436,33.511827328089886
Task_29337,2220,800,127,120,247,2.7715355805243447,45.294595999478894
Task_29338,1829,476,147,21,168,3.8343815513626835,36.60166796554592
Task_29339,1527,152,66,192,258,9.980392156862745,32.162185669676084
Task_29340,2783,973,141,140,281,2.8572895277207393,54.938594867840756
Task_29341,1395,132,141,14,155,10.488721804511279,28.059662273245507
Task_29342,1277,154,52,88,140,8.238709677419354,27.033097205857246
Task_29343,2506,213,117,24,141,11.710280373831775,46.26518357625047
Task_29344,2433,502,116,75,191,4.836978131212724,47.03980497766693
Task_29345,2671,807,142,200,342,3.3056930693069306,53.007267483029636
Task_29346,2073,897,144,146,290,2.3084632516703785,43.500293611400515
Task_29347,1360,368,87,180,267,3.6856368563685638,30.496251366617077
Task_29348,827,624,16,133,149,1.3232,21.844356531739436
Task_29349,1877,315,171,111,282,5.939873417721519,38.456750050107175
Task_29350,1032,565,66,129,195,1.823321554770318,25.643295014873377
Task_29351,887,696,47,151,198,1.272596843615495,23.58727272547881
Task_29352,1835,570,174,132,306,3.213660245183888,38.756625633012696
Task_29353,1608,921,75,111,186,1.7440347071583515,35.679454584596506
Task_29354,2955,954,160,175,335,3.094240837696335,57.89951582343836
Task_29355,1779,343,177,197,374,5.171511627906977,37.54112542501199
Task_29356,982,677,38,122,160,1.448377581120944,24.481551283053097
Task_29357,623,437,42,157,199,1.4223744292237444,18.601815135866975
Task_29358,1125,651,134,51,185,1.7254601226993864,26.489950589080603
Task_29359,2961,610,137,144,281,4.846153846153846,56.620335805392564
Task_29360,2268,80,46,78,124,28.0,41.66345549450366
Task_29361,711,130,102,99,201,5.427480916030534,18.61488786421269
Task_29362,1404,321,54,197,251,4.3602484472049685,31.142434483619898
Task_29363,2597,146,186,105,291,17.666666666666668,48.85203019734209
Task_29364,2471,81,127,52,179,30.134146341463413,44.96110984588673
Task_29365,1460,832,66,83,149,1.7527010804321728,32.46486130179333
Task_29366,1810,451,40,161,201,4.004424778761062,37.56331987358877
Task_29367,770,241,85,32,117,3.1818181818181817,18.80267236962761
Task_29368,599,1016,118,69,187,0.5889872173058014,19.652943709398105
Task_29369,2050,720,146,113,259,2.8432732316227463,42.39458406682321
Task_29370,867,335,10,53,63,2.580357142857143,20.163763670729438
Task_29371,1139,265,87,49,136,4.2819548872180455,25.001559182783627
Task_29372,1254,266,75,197,272,4.696629213483146,28.660176445401106
Task_29373,521,432,58,169,227,1.2032332563510393,17.25655230558743
Task_29374,1676,900,141,20,161,1.86015538290788,35.32392727390493
Task_29375,2586,692,189,11,200,3.7316017316017316,49.59076517898472
Task_29376,2071,510,28,19,47,4.052837573385519,39.158923695047605
Task_29377,2139,919,73,14,87,2.325,42.20201153698503
Task_29378,2428,792,114,123,237,3.0617906683480456,48.52420626133762
Task_29379,659,466,55,125,180,1.411134903640257,19.113007205907962
Task_29380,1546,954,120,87,207,1.618848167539267,34.60263359000859
Task_29381,2298,635,193,72,265,3.6132075471698113,45.60595581969346
Task_29382,2822,94,170,41,211,29.705263157894738,50.583159340848205
Task_29383,2359,600,141,29,170,3.925124792013311,45.52853722536045
Task_29384,2376,1022,132,190,322,2.3225806451612905,48.89964619328725
Task_29385,608,394,111,136,247,1.539240506329114,18.475316781865086
Task_29386,2145,267,103,161,264,8.003731343283581,42.520025412676056
Task_29387,1494,287,137,143,280,5.1875,32.34493652942116
Task_29388,1629,806,189,149,338,2.0185873605947955,36.40265913157341
Task_29389,1570,949,61,136,197,1.6526315789473685,35.37231257003652
Task_29390,944,738,99,100,199,1.277401894451962,24.550513564199594
Task_29391,719,667,106,193,299,1.0763473053892216,21.29913517527685
Task_29392,2855,797,27,115,142,3.5776942355889725,54.604076758940344
Task_29393,1018,432,161,144,305,2.351039260969977,25.398996151863447
Task_29394,2051,329,133,46,179,6.215151515151515,39.809210324649634
Task_29395,2484,872,77,105,182,2.845360824742268,49.33126498182444
Task_29396,1502,251,96,121,217,5.9603174603174605,32.085611596303295
Task_29397,1215,594,85,150,235,2.042016806722689,28.76766679888648
Task_29398,2895,401,178,193,371,7.201492537313433,55.37100850381402
Task_29399,2443,224,109,179,288,10.857777777777779,47.20450798903122
Task_29400,1212,749,55,121,176,1.616,28.836795424861524
Task_29401,1287,670,162,193,355,1.9180327868852458,30.702034913621258
Task_29402,2367,877,17,176,193,2.6958997722095672,47.64091310768982
Task_29403,2639,908,104,55,159,2.903190319031903,51.06624983199194
Task_29404,2338,246,191,132,323,9.465587044534413,45.71734596745667
Task_29405,891,946,190,87,277,0.9408658922914467,24.4811030885777
Task_29406,1668,525,36,69,105,3.171102661596958,34.19505870851725
Task_29407,2942,445,152,134,286,6.596412556053812,55.79181591124611
Task_29408,2826,309,94,13,107,9.116129032258064,51.4342422572623
Task_29409,1265,455,173,97,270,2.7741228070175437,29.188135617643567
Task_29410,2396,460,84,49,133,5.197396963123644,45.53214310052764
Task_29411,576,211,57,136,193,2.7169811320754715,17.34437697649926
Task_29412,2743,443,85,66,151,6.177927927927928,51.18429453871059
Task_29413,1610,656,165,173,338,2.450532724505327,35.66833221881059
Task_29414,1328,224,173,17,190,5.902222222222222,28.022903049723705
Task_29415,1255,228,172,106,278,5.4803493449781655,28.304420214434234
Task_29416,2616,739,159,57,216,3.535135135135135,50.64469160116977
Task_29417,2414,435,62,109,171,5.536697247706422,46.77699106475672
Task_29418,2615,949,57,41,98,2.7526315789473683,49.94029829518454
Task_29419,1685,137,112,13,125,12.210144927536232,32.54758147321436
Task_29420,1862,540,122,190,312,3.4417744916820703,39.201130437574996
Task_29421,1171,629,165,122,287,1.8587301587301588,28.32623492152926
Task_29422,1885,89,164,26,190,20.944444444444443,35.84784381908283
Task_29423,2033,597,195,127,322,3.399665551839465,42.04234625419217
Task_29424,2480,402,181,42,223,6.153846153846154,47.222918854316354
Task_29425,2137,387,26,81,107,5.507731958762887,41.41397121724304
Task_29426,2948,743,66,144,210,3.9623655913978495,56.63971006860911
Task_29427,564,527,70,129,199,1.0681818181818181,17.957530327726413
Task_29428,1775,779,114,25,139,2.2756410256410255,36.54195282810272
Task_29429,503,718,11,37,48,0.6995827538247567,15.613844210415749
Task_29430,1602,535,53,42,95,2.9888059701492535,32.632683427122075
Task_29431,1549,1023,199,36,235,1.5126953125,34.503587033002766
Task_29432,1789,693,30,29,59,2.577809798270893,35.60408009489836
Task_29433,2732,387,13,114,127,7.041237113402062,51.33265194008367
Task_29434,2242,932,102,44,146,2.403001071811361,44.54367611893752
Task_29435,1205,323,124,19,143,3.7191358024691357,25.949120192796673
Task_29436,1717,714,48,29,77,2.4013986013986015,34.55350236982844
Task_29437,850,615,141,126,267,1.37987012987013,23.04611817650007
Task_29438,1755,984,40,64,104,1.781725888324873,36.96991853596803
Task_29439,2688,260,30,133,163,10.298850574712644,50.45108104644314
Task_29440,961,736,79,200,279,1.3039348710990502,25.467208849680265
Task_29441,2467,825,19,124,143,2.986682808716707,48.5053047323699
Task_29442,1426,368,137,198,335,3.86449864498645,31.864721280069052
Task_29443,2443,583,111,36,147,4.183219178082192,46.646587857925674
Task_29444,1627,810,42,17,59,2.0061652281134403,33.09811229721685
Task_29445,1857,529,139,165,304,3.5037735849056606,39.014306663799516
Task_29446,1323,851,88,189,277,1.5528169014084507,31.452440378603303
Task_29447,1452,533,33,161,194,2.7191011235955056,32.16074757172295
Task_29448,595,754,15,177,192,0.7880794701986755,19.186062771736978
Task_29449,1294,797,156,12,168,1.6215538847117794,29.095414811428387
Task_29450,2872,428,115,27,142,6.694638694638694,52.8282592113651
Task_29451,1135,866,76,12,88,1.309111880046136,26.233196588164173
Task_29452,2492,281,179,72,251,8.836879432624114,47.44928686404125
Task_29453,541,67,140,171,311,7.955882352941177,16.024281481800973
Task_29454,1629,770,164,130,294,2.11284046692607,36.064296549081035
Task_29455,2475,1011,190,118,308,2.4456521739130435,50.26564955054297
Task_29456,1167,345,24,120,144,3.3728323699421967,26.462480435806995
Task_29457,1175,255,37,170,207,4.58984375,26.926271293889613
Task_29458,928,289,53,77,130,3.2,22.346223834622588
Task_29459,620,582,121,131,252,1.0634648370497428,19.172455359098667
Task_29460,1022,485,98,130,228,2.102880658436214,25.275697937737277
Task_29461,1117,917,153,155,308,1.2167755991285403,28.38531976114605
Task_29462,915,132,121,24,145,6.879699248120301,20.5568062728332
Task_29463,1032,465,193,89,282,2.2145922746781115,25.35292661961472
Task_29464,797,104,71,118,189,7.59047619047619,19.6128111638556
Task_29465,1063,752,154,180,334,1.4116865869853918,27.226854106968773
Task_29466,1166,840,99,46,145,1.3864447086801426,27.230952648916944
Task_29467,1920,855,165,21,186,2.2429906542056073,39.383431591707684
Task_29468,1140,236,109,161,270,4.810126582278481,26.559925114130635
Task_29469,723,524,149,61,210,1.3771428571428572,19.909018626346903
Task_29470,1369,520,65,190,255,2.6276391554702494,31.20051646663394
Task_29471,1554,577,48,173,221,2.688581314878893,34.12930483796777
Task_29472,1089,864,140,60,200,1.2589595375722544,26.725858276511847
Task_29473,1492,164,75,142,217,9.042424242424243,31.45214182197815
Task_29474,804,261,63,37,100,3.068702290076336,19.127358843846107
Task_29475,2686,686,103,178,281,3.9097525473071326,52.556390137917525
Task_29476,2284,185,21,25,46,12.279569892473118,41.77774424258033
Task_29477,1020,82,171,114,285,12.289156626506024,23.379000966112716
Task_29478,1074,917,109,195,304,1.1699346405228759,27.785725345791665
Task_29479,2652,66,14,113,127,39.582089552238806,47.61619551107841
Task_29480,1024,196,19,116,135,5.197969543147208,23.571486575693484
Task_29481,1293,593,188,199,387,2.176767676767677,30.709351031656638
Task_29482,2828,118,176,154,330,23.764705882352942,52.51352010959132
Task_29483,1418,616,99,64,163,2.298217179902755,30.95243218897495
Task_29484,2022,519,163,157,320,3.8884615384615384,41.65523889585874
Task_29485,662,698,10,194,204,0.9470672389127325,20.07938753269232
Task_29486,924,945,124,172,296,0.9767441860465116,25.426494868580942
Task_29487,1133,311,50,29,79,3.6314102564102564,24.20726970152022
Task_29488,1428,681,147,36,183,2.093841642228739,31.110418186994167
Task_29489,1464,632,89,60,149,2.3127962085308056,31.5099008828843
Task_29490,1299,620,115,23,138,2.0917874396135265,28.50241605169131
Task_29491,1928,690,88,21,109,2.790159189580318,38.41079142440857
Task_29492,502,307,101,98,199,1.62987012987013,16.28541612223648
Task_29493,1159,938,177,180,357,1.2342917997870075,29.373358244927164
Task_29494,1457,796,84,84,168,1.8281053952321205,32.35099031947708
Task_29495,2543,498,134,139,273,5.096192384769539,49.597925666089985
Task_29496,2508,813,69,80,149,3.081081081081081,49.038834489718916
Task_29497,1135,489,170,181,351,2.316326530612245,27.692350065270627
Task_29498,2860,882,169,196,365,3.2389580973952437,56.33483860758444
Task_29499,548,903,144,74,218,0.6061946902654868,18.82585820414703
Task_29500,1691,773,36,134,170,2.1847545219638245,36.32721520511984
Task_29501,1100,710,61,83,144,1.5471167369901546,26.33401211696429
Task_29502,2145,374,99,51,150,5.72,41.45194038676258
Task_29503,682,430,177,171,348,1.5823665893271461,20.26571871681189
Task_29504,1940,122,56,11,67,15.772357723577235,35.60182108271126
Task_29505,692,984,183,84,267,0.7025380710659899,21.498416342263695
Task_29506,1925,370,37,50,87,5.188679245283019,37.22281865232059
Task_29507,1114,325,89,123,212,3.4171779141104293,26.165825741526874
Task_29508,1456,147,64,139,203,9.837837837837839,30.65948783274432
Task_29509,1278,919,186,149,335,1.3891304347826088,31.110366883468526
Task_29510,624,370,74,192,266,1.6819407008086253,18.981901250580858
Task_29511,1151,331,78,50,128,3.466867469879518,25.55606694806347
Task_29512,1052,231,117,173,290,4.5344827586206895,25.260695990789845
Task_29513,2013,446,173,51,224,4.503355704697986,40.22381260502376
Task_29514,2074,277,181,121,302,7.460431654676259,41.54570952160464
Task_29515,2685,739,61,175,236,3.6283783783783785,52.62872725202175
Task_29516,2438,921,187,187,374,2.644251626898048,49.79742450416202
Task_29517,674,166,98,195,293,4.0359281437125745,18.810334868137147
Task_29518,1857,247,143,71,214,7.487903225806452,37.10506437415649
Task_29519,1393,838,116,23,139,1.6603098927294397,30.6756372468258
Task_29520,1541,908,129,125,254,1.6952695269526952,34.89831850577804
Task_29521,830,380,14,170,184,2.1784776902887137,21.62459553465088
Task_29522,1112,799,119,197,316,1.39,28.092809840881888
Task_29523,2520,621,68,109,177,4.051446945337621,49.09162297805017
Task_29524,768,295,169,153,322,2.5945945945945947,21.097947245459007
Task_29525,834,626,91,74,165,1.3301435406698565,21.953960496188206
Task_29526,2251,137,81,112,193,16.31159420289855,43.02310031730144
Task_29527,2224,688,179,154,333,3.227866473149492,45.44386209987645
Task_29528,2774,328,113,177,290,8.43161094224924,52.81921196439074
Task_29529,1241,986,190,57,247,1.2573454913880446,29.743675588552733
Task_29530,2354,793,84,46,130,2.9647355163727958,45.81088202482875
Task_29531,1817,904,105,42,147,2.007734806629834,37.708820071242336
Task_29532,2078,194,87,109,196,10.656410256410256,40.7460920039799
Task_29533,1111,499,138,85,223,2.222,26.351473630478072
Task_29534,1192,396,153,182,335,3.0025188916876573,28.22906181289328
Task_29535,895,505,110,73,183,1.7687747035573123,22.41698644658585
Task_29536,2157,262,161,194,355,8.201520912547528,43.1504051220351
Task_29537,2322,786,22,10,32,2.9504447268106735,43.90063280826672
Task_29538,2077,441,160,34,194,4.699095022624435,40.8562046541991
Task_29539,1693,388,39,138,177,4.352185089974293,35.18451402733168
Task_29540,1830,418,133,45,178,4.3675417661097855,36.56754961195702
Task_29541,2302,927,183,149,332,2.480603448275862,47.41611569608673
Task_29542,2559,365,42,189,231,6.991803278688525,49.31048969608236
Task_29543,637,505,174,140,314,1.2588932806324111,19.525757384340967
Task_29544,1061,951,106,53,159,1.1144957983193278,26.119937735014773
Task_29545,1889,627,21,11,32,3.0079617834394905,36.55225082830393
Task_29546,664,577,17,51,68,1.1487889273356402,17.75904339777641
Task_29547,1937,204,160,122,282,9.448780487804878,39.02802196261229
Task_29548,2487,944,154,69,223,2.6317460317460317,49.321837065786106
Task_29549,1148,667,108,162,270,1.718562874251497,28.049054103696836
Task_29550,1140,565,99,169,268,2.0141342756183747,27.620166799373404
Task_29551,1715,452,175,129,304,3.7858719646799117,36.46777076182351
Task_29552,1326,325,43,29,72,4.067484662576687,27.14806721346186
Task_29553,2389,273,149,54,203,8.718978102189782,45.5100483214045
Task_29554,2461,968,134,120,254,2.539731682146543,49.66939605693282
Task_29555,2487,650,86,53,139,3.8202764976958523,47.784102486781116
Task_29556,2460,721,98,103,201,3.407202216066482,48.63036076913604
Task_29557,728,895,158,113,271,0.8125,21.980038484254674
Task_29558,1521,462,82,119,201,3.285097192224622,33.04256266576087
Task_29559,1492,363,67,41,108,4.0989010989010985,30.49977761705965
Task_29560,2317,678,129,18,147,3.4123711340206184,44.68153099004479
Task_29561,1403,803,164,50,214,1.7450248756218905,31.459510566442844
Task_29562,1798,915,63,140,203,1.962882096069869,38.925907359067516
Task_29563,2698,99,89,29,118,26.98,48.057720709106455
Task_29564,1904,589,116,11,127,3.227118644067797,37.883969035378506
Task_29565,1718,114,199,191,390,14.939130434782609,35.27091205322778
Task_29566,1890,1002,162,167,329,1.884346959122632,41.13356378281376
Task_29567,987,269,19,158,177,3.6555555555555554,23.63137095554995
Task_29568,1060,369,99,17,116,2.864864864864865,23.564143141057315
Task_29569,1794,773,104,192,296,2.317829457364341,38.787552658858466
Task_29570,2718,517,150,17,167,5.2471042471042475,50.70363719973326
Task_29571,830,353,134,152,286,2.3446327683615817,22.100029506888195
Task_29572,2819,827,38,31,69,3.404589371980676,52.31581655468875
Task_29573,2038,219,132,60,192,9.263636363636364,39.65880599776106
Task_29574,2805,793,144,105,249,3.5327455919395465,54.52783050221675
Task_29575,2950,446,167,196,363,6.599552572706935,56.35967392678257
Task_29576,2934,501,15,30,45,5.844621513944223,53.08521242776721
Task_29577,1474,270,169,62,231,5.439114391143911,31.139182043989422
Task_29578,2399,572,32,119,151,4.18673647469459,46.68762454565924
Task_29579,1311,629,56,198,254,2.080952380952381,30.66487655858229
Task_29580,958,794,180,70,250,1.2050314465408805,24.772956006156605
Task_29581,2375,470,181,11,192,5.042462845010616,45.504278537636786
Task_29582,887,158,62,185,247,5.578616352201258,22.05472070559121
Task_29583,1421,67,22,153,175,20.897058823529413,29.08639062803353
Task_29584,2936,792,169,22,191,3.7023959646910467,55.47656105985734
Task_29585,2812,974,103,132,235,2.884102564102564,55.182216283268325
Task_29586,747,840,43,138,181,0.8882282996432818,21.45908510409925
Task_29587,2250,447,165,133,298,5.022321428571429,44.89833061811197
Task_29588,2076,86,29,153,182,23.862068965517242,39.46404113644791
Task_29589,2588,483,150,123,273,5.347107438016529,50.23821399509908
Task_29590,2467,321,41,152,193,7.661490683229814,47.4785264174022
Task_29591,2816,338,152,112,264,8.306784660766962,53.305700933619185
Task_29592,2512,606,46,193,239,4.13838550247117,49.41363002963004
Task_29593,1655,436,109,134,243,3.7871853546910756,35.19917523512786
Task_29594,1211,849,78,94,172,1.4247058823529413,29.019015383344684
Task_29595,693,590,24,187,211,1.1725888324873097,20.294426341317337
Task_29596,2467,191,96,139,235,12.848958333333334,47.19754623513486
Task_29597,1482,903,169,190,359,1.6393805309734513,34.51644312482037
Task_29598,2162,490,156,38,194,4.403258655804481,42.385719716034075
Task_29599,1003,915,87,84,171,1.0949781659388647,25.29912367448732
Task_29600,1951,163,171,147,318,11.896341463414634,38.994626640470436
Task_29601,988,846,110,74,184,1.166469893742621,24.98173353849076
Task_29602,2770,71,150,69,219,38.47222222222222,49.876727520856655
Task_29603,653,483,116,42,158,1.3491735537190082,17.987670570154474
Task_29604,1331,705,28,138,166,1.885269121813031,30.445741305688625
Task_29605,2478,607,67,155,222,4.0756578947368425,48.83394687851788
Task_29606,1401,317,90,38,128,4.40566037735849,29.385967301195436
Task_29607,1381,218,69,164,233,6.30593607305936,30.26307652269652
Task_29608,848,618,13,87,100,1.369951534733441,21.65295764618301
Task_29609,1727,106,92,175,267,16.14018691588785,34.67259745579259
Task_29610,599,1016,102,166,268,0.5889872173058014,20.50259975594995
Task_29611,1367,366,35,67,102,3.7247956403269753,28.919630306444617
Task_29612,2468,118,122,30,152,20.73949579831933,44.936621510124745
Task_29613,2638,120,146,77,223,21.801652892561982,48.61888172289863
Task_29614,1897,364,124,140,264,5.197260273972603,38.89777770789735
Task_29615,1469,197,184,199,383,7.41919191919192,32.22842891887624
Task_29616,1630,953,43,95,138,1.7085953878406708,35.613513391040634
Task_29617,620,490,124,180,304,1.2627291242362526,19.223463633691647
Task_29618,2969,859,171,84,255,3.452325581395349,57.03611660723043
Task_29619,841,635,36,21,57,1.3223270440251573,20.40114580502436
Task_29620,2767,978,95,52,147,2.82635342185904,53.39301246268327
Task_29621,2599,823,189,15,204,3.154126213592233,50.200244582442195
Task_29622,1539,102,179,90,269,14.941747572815533,31.47981793619613
Task_29623,501,93,80,31,111,5.329787234042553,13.294442120172803
Task_29624,1156,730,14,138,152,1.5813953488372092,27.471584235368315
Task_29625,2818,466,193,126,319,6.034261241970022,54.03527308510386
Task_29626,1791,83,113,13,126,21.321428571428573,33.5267134964215
Task_29627,2113,797,120,172,292,2.6478696741854635,43.8690448510163
Task_29628,2521,941,199,49,248,2.6762208067940554,49.7807628242719
Task_29629,2358,707,53,192,245,3.330508474576271,47.45517165926048
Task_29630,2754,259,14,29,43,10.592307692307692,49.372525855415226
Task_29631,511,730,163,184,347,0.6990424076607387,18.572960205154526
Task_29632,2875,784,190,19,209,3.662420382165605,54.41634443071805
Task_29633,1513,203,187,173,360,7.416666666666667,32.75743783605162
Task_29634,1880,445,37,184,221,4.2152466367713,38.78337749808456
Task_29635,2295,990,77,139,216,2.315842583249243,47.08985227599618
Task_29636,2568,687,199,104,303,3.7325581395348837,50.681127264864834
Task_29637,2949,226,64,128,192,12.991189427312776,54.82418028650104
Task_29638,787,789,36,169,205,0.9962025316455696,22.253597610839922
Task_29639,1445,641,121,21,142,2.250778816199377,30.861394045157876
Task_29640,2049,905,153,148,301,2.26158940397351,43.19743808209828
Task_29641,2277,177,147,125,272,12.792134831460674,43.83567877042831
Task_29642,1399,804,175,10,185,1.737888198757764,30.915688160678638
Task_29643,1859,437,51,148,199,4.244292237442922,38.44919883547655
Task_29644,734,132,23,36,59,5.518796992481203,16.868029245565314
Task_29645,1503,535,198,55,253,2.8041044776119404,32.611357718347115
Task_29646,1938,837,11,160,171,2.3126491646778042,40.46580651310399
Task_29647,2744,964,190,132,322,2.8435233160621762,54.46554713594569
Task_29648,1562,701,119,135,254,2.225071225071225,34.614565699969205
Task_29649,1962,159,44,13,57,12.2625,36.4446734651596
Task_29650,1007,688,17,112,129,1.4615384615384615,24.820296263702748
Task_29651,1685,880,31,42,73,1.9125993189557322,34.582884532927245
Task_29652,2599,608,131,167,298,4.267651888341543,50.991305422699405
Task_29653,2176,398,45,108,153,5.453634085213032,42.52601753398002
Task_29654,1731,943,162,66,228,1.833686440677966,37.364725240277096
Task_29655,1468,668,45,88,133,2.194319880418535,32.06356885579719
Task_29656,764,541,14,19,33,1.4095940959409594,18.38695304893412
Task_29657,2285,973,31,130,161,2.345995893223819,46.22864670339317
Task_29658,1676,535,168,125,293,3.126865671641791,36.05931805288244
Task_29659,2849,533,17,32,49,5.335205992509363,51.8263343291658
Task_29660,1569,362,10,18,28,4.322314049586777,30.582434455965696
Task_29661,2965,436,124,175,299,6.784897025171625,56.24470687399914
Task_29662,524,629,169,21,190,0.8317460317460318,16.779858480305624
Task_29663,1900,553,54,178,232,3.4296028880866425,39.62503636710754
Task_29664,2408,609,84,74,158,3.9475409836065576,46.612800055169366
Task_29665,3000,444,85,121,206,6.741573033707865,56.37419191112841
Task_29666,1222,300,21,38,59,4.059800664451827,25.38700314106245
Task_29667,1667,439,195,155,350,3.7886363636363636,35.91177196097891
Task_29668,795,563,135,168,303,1.4095744680851063,22.23709761789978
Task_29669,893,269,196,111,307,3.3074074074074074,22.860435852557334
Task_29670,1575,190,85,58,143,8.24607329842932,31.9210856711844
Task_29671,1662,846,81,50,131,1.962219598583235,35.15186555985932
Task_29672,2639,1004,64,19,83,2.625870646766169,50.1406652804073
Task_29673,2224,435,35,140,175,5.10091743119266,43.8713896212715
Task_29674,2019,700,80,74,154,2.8801711840228243,40.75419382110302
Task_29675,2519,384,163,70,233,6.542857142857143,48.1178714693981
Task_29676,1866,401,33,154,187,4.641791044776119,38.212589214572155
Task_29677,592,925,149,108,257,0.6393088552915767,19.954909154467405
Task_29678,1525,703,140,196,336,2.1661931818181817,34.49372027722112
Task_29679,1822,618,37,143,180,2.9434571890145396,37.992399524399794
Task_29680,1555,632,76,134,210,2.456556082148499,34.22609792402407
Task_29681,1387,713,73,65,138,1.942577030812325,30.692935789541792
Task_29682,2394,421,62,57,119,5.672985781990521,45.28204984583298
Task_29683,885,919,15,112,127,0.9619565217391305,23.664726254500653
Task_29684,2852,938,146,123,269,3.03727369542066,55.84364714066297
Task_29685,1234,834,107,173,280,1.4778443113772455,29.951424349968104
Task_29686,849,452,167,55,222,1.8741721854304636,21.85676596545648
Task_29687,1032,620,52,119,171,1.6618357487922706,25.527646810376012
Task_29688,1839,307,130,89,219,5.970779220779221,37.32518067519556
Task_29689,2301,438,52,79,131,5.241457858769932,44.63584006796297
Task_29690,1733,937,15,134,149,1.847547974413646,37.32097677026933
Task_29691,1667,217,139,133,272,7.646788990825688,34.7844798558044
Task_29692,645,724,133,37,170,0.8896551724137931,18.810964316008434
Task_29693,1875,76,170,59,229,24.350649350649352,35.96287700254533
Task_29694,1717,237,131,165,296,7.214285714285714,35.80101506602076
Task_29695,1144,852,91,131,222,1.3411488862837047,28.31291922285609
Task_29696,2940,421,50,141,191,6.966824644549763,55.452016798941266
Task_29697,1367,995,116,138,254,1.3724899598393574,32.38196222170105
Task_29698,1767,668,162,49,211,2.6412556053811658,36.81442822725146
Task_29699,2757,673,159,137,296,4.0905044510385755,53.64732463912966
Task_29700,2626,540,25,81,106,4.853974121996303,49.6021583318622
Task_29701,2651,837,163,65,228,3.163484486873508,51.63278350082758
Task_29702,839,139,103,17,120,5.992857142857143,19.03872262120458
Task_29703,1843,581,182,89,271,3.1666666666666665,38.50981750900706
Task_29704,842,580,17,29,46,1.4492254733218588,20.134811455019896
Task_29705,909,382,10,161,171,2.373368146214099,22.74420150989705
Task_29706,1543,1017,195,147,342,1.5157170923379175,35.66767049217871
Task_29707,1342,574,25,12,37,2.333913043478261,27.708779156135645
Task_29708,2638,957,163,131,294,2.7536534446764094,52.636316433814635
Task_29709,1872,307,124,128,252,6.077922077922078,38.24036747997045
Task_29710,2207,950,107,139,246,2.3207150368033647,45.58013794908178
Task_29711,1776,350,10,43,53,5.05982905982906,34.400574345479264
Task_29712,885,109,183,52,235,8.045454545454545,20.77402491940884
Task_29713,2640,847,73,52,125,3.1132075471698113,50.838623493565485
Task_29714,1103,358,80,43,123,3.0724233983286906,24.568151837276062
Task_29715,2997,890,142,187,329,3.3636363636363638,58.355231389090115
Task_29716,1297,282,92,167,259,4.58303886925795,29.23215920864951
Task_29717,1479,507,186,123,309,2.911417322834646,32.920813182547
Task_29718,2302,321,81,117,198,7.149068322981367,44.931725308096894
Task_29719,1196,518,27,108,135,2.304431599229287,27.4183894427303
Task_29720,1156,902,182,165,347,1.2801771871539314,29.17838858496353
Task_29721,749,174,62,98,160,4.28,18.852549351957588
Task_29722,1342,395,135,84,219,3.388888888888889,29.63912934279917
Task_29723,991,354,100,12,112,2.7915492957746477,22.533818091744198
Task_29724,585,701,146,32,178,0.8333333333333334,17.80883547924557
Task_29725,892,626,93,61,154,1.4226475279106858,22.435596392508398
Task_29726,2749,936,103,102,205,2.933831376734258,53.88602324412873
Task_29727,1097,664,45,94,139,1.649624060150376,26.253150427943694
Task_29728,1455,773,114,200,314,1.87984496124031,33.509823109394944
Task_29729,2122,78,188,164,352,26.860759493670887,40.96236878820372
Task_29730,2562,672,80,131,211,3.8068350668647843,50.29086947496423
Task_29731,888,744,51,48,99,1.1919463087248323,22.076043465783727
Task_29732,2797,802,90,167,257,3.4831880448318806,54.60558979832597
Task_29733,1734,521,97,143,240,3.32183908045977,36.74442987426034
Task_29734,2894,916,123,122,245,3.1559432933478737,56.33072014267365
Task_29735,1369,649,126,118,244,2.106153846153846,31.32500946773294
Task_29736,2807,320,143,78,221,8.744548286604362,52.559267758165475
Task_29737,1196,1004,46,77,123,1.190049751243781,28.583355289507665
Task_29738,1712,114,93,122,215,14.88695652173913,34.364993518190296
Task_29739,2865,663,87,174,261,4.3147590361445785,55.2312335006688
Task_29740,1273,206,78,60,138,6.14975845410628,27.128697890912377
Task_29741,928,877,150,119,269,1.0569476082004556,25.033261387867697
Task_29742,2331,888,82,25,107,2.622047244094488,45.40718196522038
Task_29743,2934,90,150,144,294,32.24175824175824,53.58532243245471
Task_29744,2562,607,98,151,249,4.213815789473684,50.17176668693488
Task_29745,1932,221,67,121,188,8.702702702702704,38.67251808101518
Task_29746,832,882,159,178,337,0.942242355605889,23.975057299471914
Task_29747,1812,277,76,163,239,6.517985611510792,37.32032210913939
Task_29748,2966,239,47,124,171,12.358333333333333,54.767429103939726
Task_29749,2177,162,113,71,184,13.355828220858896,41.254260248693065
Task_29750,879,119,148,164,312,7.325,21.803785454694278
Task_29751,1411,443,22,143,165,3.1779279279279278,30.918792976710197
Task_29752,2551,1009,108,185,293,2.5257425742574258,51.49441759051391
Task_29753,1921,293,60,145,205,6.534013605442177,38.9084819335805
Task_29754,1673,82,110,138,248,20.156626506024097,33.481941522647915
Task_29755,2666,743,32,184,216,3.5833333333333335,52.17502654525941
Task_29756,2822,640,173,57,230,4.402496099843994,53.657397503457254
Task_29757,832,1010,170,139,309,0.8229475766567754,24.176606059073716
Task_29758,984,999,162,83,245,0.984,25.93062778049213
Task_29759,2263,438,56,107,163,5.1548974943052395,44.41379440750472
Task_29760,2813,695,94,129,223,4.041666666666667,54.34711527215206
Task_29761,1129,702,103,115,218,1.6059743954480796,27.55380955855138
Task_29762,1518,121,42,115,157,12.442622950819672,30.60854377554328
Task_29763,1016,384,136,24,160,2.638961038961039,23.38199035566262
Task_29764,2466,1016,18,77,95,2.424778761061947,48.33060059574942
Task_29765,2114,314,111,56,167,6.711111111111111,41.014229864966374
Task_29766,2572,539,63,84,147,4.762962962962963,49.19142402434454
Task_29767,2467,414,77,163,240,5.944578313253012,48.133017776763445
Task_29768,872,799,145,168,313,1.09,24.1583330646578
Task_29769,2756,615,21,26,47,4.474025974025974,50.56556176427085
Task_29770,2697,947,74,28,102,2.8449367088607596,51.444649001178824
Task_29771,1448,249,174,189,363,5.792,31.930382812409466
Task_29772,725,728,78,188,266,0.9945130315500685,21.570506393264527
Task_29773,2751,653,92,75,167,4.206422018348624,52.367582097847155
Task_29774,2851,590,127,118,245,4.824027072758037,54.61390279811625
Task_29775,1174,650,184,90,274,1.803379416282642,28.168979623573993
Task_29776,1614,307,185,72,257,5.240259740259741,33.685403646137196
Task_29777,1223,594,41,69,110,2.0554621848739494,27.48482348573354
Task_29778,776,360,158,102,260,2.149584487534626,21.077560126776305
Task_29779,1145,218,54,132,186,5.228310502283105,26.185358581165605
Task_29780,950,916,24,177,201,1.0359869138495092,25.22516382295333
Task_29781,952,842,129,87,216,1.129300118623962,24.743566204490378
Task_29782,1033,433,162,73,235,2.380184331797235,24.813115752093818
Task_29783,1876,378,37,58,95,4.949868073878628,36.766470741902516
Task_29784,2692,528,16,124,140,5.088846880907372,51.08432828328205
Task_29785,2309,720,41,139,180,3.20249653259362,46.01011410236876
Task_29786,1466,232,34,190,224,6.291845493562231,31.558608230069154
Task_29787,1260,758,159,194,353,1.6600790513833992,30.52746513194944
Task_29788,2652,466,171,194,365,5.6788008565310495,51.71465561595446
Task_29789,2304,279,80,21,101,8.228571428571428,42.99463118564973
Task_29790,520,814,92,179,271,0.6380368098159509,18.722713224177202
Task_29791,1085,179,181,182,363,6.027777777777778,25.563258573157423
Task_29792,526,346,181,26,207,1.515850144092219,16.022874680688037
Task_29793,2897,854,142,37,179,3.3883040935672515,54.915766991228274
Task_29794,1191,461,36,42,78,2.5779220779220777,25.466000604638264
Task_29795,1010,190,43,38,81,5.287958115183246,22.461598456712494
Task_29796,2474,101,118,188,306,24.254901960784313,46.55570541264685
Task_29797,1506,523,144,119,263,2.8740458015267176,33.18571470637523
Task_29798,1015,353,164,171,335,2.867231638418079,25.27511263264721
Task_29799,1001,692,128,148,276,1.4444444444444444,25.75003987279688
Task_29800,1856,596,29,138,167,3.1088777219430486,38.40792415034402
Task_29801,2844,583,13,122,135,4.86986301369863,53.76076282054405
Task_29802,1379,533,71,92,163,2.5823970037453186,30.60043441615312
Task_29803,2055,380,26,122,148,5.393700787401575,40.62131660377281
Task_29804,1965,83,108,183,291,23.392857142857142,38.33561467838947
Task_29805,2514,644,72,111,183,3.8976744186046512,49.10375570106117
Task_29806,585,453,108,90,198,1.2885462555066078,17.797523070814698
Task_29807,1201,857,139,157,296,1.3997668997668997,29.534040664962262
Task_29808,865,115,56,21,77,7.456896551724138,18.686080156759843
Task_29809,1510,68,67,29,96,21.884057971014492,28.33778698150365
Task_29810,1417,521,30,165,195,2.71455938697318,31.572198415684152
Task_29811,611,1006,63,65,128,0.6067527308838133,19.751901106484212
Task_29812,2168,386,148,73,221,5.602067183462532,42.558990883741956
Task_29813,2051,589,78,131,209,3.476271186440678,41.92934550334396
Task_29814,2660,760,29,108,137,3.495400788436268,51.37225598024324
Task_29815,1818,268,19,38,57,6.758364312267658,34.764778558618666
Task_29816,1862,449,81,162,243,4.137777777777778,38.66195585173078
Task_29817,1384,251,190,120,310,5.492063492063492,30.586017089164827
Task_29818,2815,503,132,180,312,5.5853174603174605,54.15615327998878
Task_29819,2331,852,131,107,238,2.7327080890973034,47.15627730425058
Task_29820,2532,468,85,20,105,5.398720682302772,47.0439876006462
Task_29821,1491,80,83,13,96,18.40740740740741,28.358177904945336
Task_29822,2973,150,115,78,193,19.688741721854306,54.07301845041862
Task_29823,725,421,137,181,318,1.7180094786729858,20.826744782478738
Task_29824,2550,95,28,90,118,26.5625,46.15450772458096
Task_29825,1349,503,190,46,236,2.6765873015873014,29.703267623653232
Task_29826,2057,752,50,21,71,2.731739707835325,39.99209152011019
Task_29827,2423,929,83,138,221,2.6053763440860216,48.876908517964445
Task_29828,1639,753,90,107,197,2.173740053050398,35.748042004097734
Task_29829,2137,624,152,106,258,3.4192,43.455567578735234
Task_29830,1444,424,78,76,154,3.3976470588235292,30.799861211223742
Task_29831,2247,936,165,195,360,2.398078975453575,46.76627063011224
Task_29832,2834,334,121,102,223,8.459701492537313,53.3770727741437
Task_29833,2089,378,102,36,138,5.511873350923483,40.28601244499952
Task_29834,2138,724,163,44,207,2.9489655172413793,42.75825264512023
Task_29835,1037,359,22,69,91,2.8805555555555555,23.50767011233451
Task_29836,2249,616,166,169,335,3.6450567260940034,45.643434334930156
Task_29837,1360,266,144,102,246,5.093632958801498,29.942876728143265
Task_29838,1508,694,66,184,250,2.1697841726618705,33.91376372683683
Task_29839,2327,444,140,194,334,5.229213483146068,46.358954570286734
Task_29840,1715,392,91,162,253,4.363867684478372,36.14191878905067
Task_29841,1104,627,127,169,296,1.7579617834394905,27.354899490164176
Task_29842,2800,569,21,152,173,4.912280701754386,53.37676318603923
Task_29843,1403,605,111,75,186,2.315181518151815,30.886702782982496
Task_29844,650,652,112,134,246,0.9954058192955589,19.88147598461018
Task_29845,2134,326,145,60,205,6.525993883792049,41.61239835949229
Task_29846,1876,518,133,188,321,3.6146435452793835,39.3904597703921
Task_29847,2754,997,178,105,283,2.7595190380761525,54.51163191210426
Task_29848,2249,385,192,65,257,5.8264248704663215,43.954631235682115
Task_29849,2370,995,63,94,157,2.3795180722891565,47.6204788483633
Task_29850,1953,437,88,99,187,4.458904109589041,39.58383551546052
Task_29851,716,490,45,108,153,1.4582484725050917,19.59953837024629
Task_29852,2845,161,149,123,272,17.561728395061728,52.83808855509533
Task_29853,939,287,106,109,215,3.2604166666666665,23.228639097127346
Task_29854,744,917,170,14,184,0.8104575163398693,20.889430044841443
Task_29855,1846,528,100,30,130,3.489603024574669,36.983226552696486
Task_29856,2055,608,80,170,250,3.374384236453202,42.291370568280804
Task_29857,623,596,184,181,365,1.0435510887772195,19.854694074617196
Task_29858,799,219,105,59,164,3.631818181818182,19.8802291614485
Task_29859,1282,87,140,109,249,14.568181818181818,27.32186146044309
Task_29860,2530,726,118,26,144,3.4800550206327374,48.412765790769726
Task_29861,1545,444,54,142,196,3.4719101123595504,33.44283710068689
Task_29862,2445,166,92,101,193,14.640718562874252,46.22400697359249
Task_29863,1671,953,143,187,330,1.751572327044025,37.531409721659145
Task_29864,1917,800,63,81,144,2.393258426966292,39.59397516963312
Task_29865,2764,893,177,97,274,3.0917225950783,54.32649893817422
Task_29866,2625,179,158,200,358,14.583333333333334,49.8610752997667
Task_29867,1912,213,67,162,229,8.934579439252337,38.60920615837718
Task_29868,910,850,118,186,304,1.0693301997649824,24.904588621201615
Task_29869,2176,454,15,116,131,4.782417582417582,42.77839761900776
Task_29870,1530,972,51,126,177,1.5724563206577595,34.56549511664841
Task_29871,1756,118,32,12,44,14.756302521008404,32.66726648863106
Task_29872,2429,611,116,61,177,3.968954248366013,46.8875503863913
Task_29873,1404,890,175,45,220,1.5757575757575757,31.67336481124376
Task_29874,2813,1013,142,183,325,2.774161735700197,55.800148754158634
Task_29875,2076,431,70,141,211,4.805555555555555,41.85245654202347
Task_29876,828,368,95,103,198,2.2439024390243905,21.717703882379197
Task_29877,1055,510,22,97,119,2.064579256360078,24.979547731433474
Task_29878,1812,569,91,74,165,3.1789473684210527,37.2956616843588
Task_29879,1796,340,169,165,334,5.266862170087976,37.57287358208344
Task_29880,1212,850,23,188,211,1.4242068155111633,29.416494284532604
Task_29881,537,108,31,171,202,4.926605504587156,15.666203116529624
Task_29882,2526,411,50,179,229,6.131067961165049,49.09420602953321
Task_29883,1309,292,156,160,316,4.467576791808874,29.62421036983626
Task_29884,2693,620,86,85,171,4.336553945249597,51.379446300385496
Task_29885,2825,187,11,42,53,15.02659574468085,50.56952639144195
Task_29886,2826,423,34,123,157,6.665094339622642,53.003806036978496
Task_29887,883,1002,44,163,207,0.8803589232303091,24.455993725616963
Task_29888,711,646,83,73,156,1.0989180834621328,19.694345739948186
Task_29889,835,82,140,197,337,10.060240963855422,20.835518430765106
Task_29890,1086,582,191,49,240,1.862778730703259,25.89035472370355
Task_29891,1367,903,44,71,115,1.5121681415929205,30.88829100806937
Task_29892,2250,79,176,93,269,28.125,42.51876570616715
Task_29893,846,925,158,76,234,0.9136069114470843,23.447584548784516
Task_29894,1253,675,185,25,210,1.8535502958579881,28.551389744736188
Task_29895,722,171,141,36,177,4.1976744186046515,18.01930314760268
Task_29896,1542,471,29,167,196,3.266949152542373,33.400015012260184
Task_29897,2075,984,31,138,169,2.1065989847715736,43.096335942779625
Task_29898,2052,707,62,157,219,2.8983050847457625,42.397666890324146
Task_29899,1144,385,184,43,227,2.9637305699481864,26.047693820550677
Task_29900,2640,112,194,186,380,23.36283185840708,49.56734625888948
Task_29901,2878,362,164,53,217,7.928374655647383,53.66321298849254
Task_29902,2279,954,152,70,222,2.386387434554974,46.07966722197151
Task_29903,2861,394,45,81,126,7.243037974683545,53.1907299607392
Task_29904,1405,527,100,104,204,2.6609848484848486,31.311325576645373
Task_29905,2693,285,192,41,233,9.416083916083917,50.24010929320034
Task_29906,2978,820,91,176,267,3.6272838002436054,57.58810441603243
Task_29907,1830,181,121,28,149,10.054945054945055,35.35029934401305
Task_29908,801,1021,193,115,308,0.7837573385518591,23.711532162037784
Task_29909,2640,661,94,177,271,3.987915407854985,51.78583954614282
Task_29910,874,968,157,99,256,0.9019607843137255,24.41619766041563
Task_29911,2422,928,69,17,86,2.6071044133476855,46.63534712401975
Task_29912,2080,470,73,97,170,4.416135881104034,41.63983446109416
Task_29913,1476,1019,20,142,162,1.4470588235294117,33.438836563802305
Task_29914,1376,123,171,57,228,11.096774193548388,28.75964782111912
Task_29915,2344,340,198,18,216,6.873900293255132,44.58335138815835
Task_29916,676,890,70,123,193,0.7586980920314254,20.92090821026328
Task_29917,2246,578,62,151,213,3.8791018998272886,45.0270338000513
Task_29918,549,1021,147,182,329,0.5371819960861057,19.986117894508528
Task_29919,841,827,162,175,337,1.0157004830917875,23.880961383362166
Task_29920,1975,471,98,50,148,4.184322033898305,38.920786250442376
Task_29921,1373,461,116,137,253,2.9718614718614718,30.86506455936164
Task_29922,1854,67,146,103,249,27.264705882352942,36.168973345124456
Task_29923,2496,98,78,165,243,25.21212121212121,46.58724614345359
Task_29924,722,306,198,136,334,2.3517915309446256,20.435076840141498
Task_29925,519,340,29,138,167,1.5219941348973607,16.39866903384942
Task_29926,2032,869,35,48,83,2.335632183908046,40.466802343551834
Task_29927,2597,747,43,188,231,3.47192513368984,51.14204364655077
Task_29928,1743,892,21,195,216,1.9518477043673013,37.9745791711413
Task_29929,2939,739,110,61,171,3.9716216216216216,55.32124056839408
Task_29930,1962,201,72,185,257,9.712871287128714,39.51786235599403
Task_29931,1429,572,40,11,51,2.493891797556719,29.29420333947751
Task_29932,761,871,79,22,101,0.8727064220183486,20.644408558429443
Task_29933,2191,522,57,158,215,4.189292543021033,44.02743838020774
Task_29934,1879,993,182,164,346,1.8903420523138832,41.003522434599105
Task_29935,966,489,56,75,131,1.9714285714285715,23.569939138312616
Task_29936,2968,582,196,79,275,5.090909090909091,56.226258194364014
Task_29937,2403,878,101,123,224,2.733788395904437,48.3386966127793
Task_29938,1717,123,28,76,104,13.846774193548388,33.009130670041856
Task_29939,1291,731,23,157,180,1.7636612021857923,30.018638643256747
Task_29940,634,826,46,94,140,0.7666263603385731,19.34399856113095
Task_29941,2971,119,184,78,262,24.758333333333333,54.05817858454668
Task_29942,1048,200,62,150,212,5.213930348258707,24.83392949367408
Task_29943,2754,974,97,198,295,2.8246153846153845,54.653970618604205
Task_29944,2418,770,130,188,318,3.1361867704280155,48.75710347319373
Task_29945,1874,145,81,75,156,12.835616438356164,36.20522085302538
Task_29946,1824,929,16,148,164,1.961290322580645,38.94095739630429
Task_29947,1169,721,145,153,298,1.6191135734072022,28.662816292864505
Task_29948,667,1012,117,26,143,0.6584402764067128,20.08959687525905
Task_29949,502,946,128,156,284,0.5300950369588173,18.79503427970682
Task_29950,902,544,51,45,96,1.655045871559633,21.58577456894389
Task_29951,2065,203,95,140,235,10.122549019607844,40.929460592685366
Task_29952,1857,1022,119,127,246,1.81524926686217,40.23996640323821
Task_29953,1669,882,138,196,334,1.8901472253680633,37.32379416043893
Task_29954,589,645,177,188,365,0.9117647058823529,19.535496513402986
Task_29955,1295,810,41,193,234,1.596794081381011,30.718195571201175
Task_29956,1468,1011,49,114,163,1.4505928853754941,33.52906407239441
Task_29957,1195,823,139,95,234,1.450242718446602,28.935083492067083
Task_29958,1650,248,187,45,232,6.626506024096385,33.579224219093334
Task_29959,541,850,100,172,272,0.63572267920094,19.076730227793906
Task_29960,938,576,56,120,176,1.6256499133448874,23.956727999358304
Task_29961,2269,210,181,42,223,10.753554502369669,43.21297029492621
Task_29962,2028,899,191,32,223,2.2533333333333334,41.654427503964826
Task_29963,2475,534,155,70,225,4.626168224299065,47.87534539240945
Task_29964,521,871,151,57,208,0.5974770642201835,18.04826156640709
Task_29965,2934,354,114,135,249,8.264788732394367,55.193485873191605
Task_29966,735,730,67,125,192,1.0054719562243501,21.233068451044037
Task_29967,1631,413,107,39,146,3.9396135265700485,33.22797035236936
Task_29968,647,396,199,31,230,1.6297229219143576,18.237409781504418
Task_29969,913,441,142,182,324,2.065610859728507,23.906916315659146
Task_29970,2650,261,84,16,100,10.114503816793894,48.23913823357037
Task_29971,787,730,175,149,324,1.076607387140903,22.619729035316656
Task_29972,622,852,113,22,135,0.7291910902696366,18.705489836238115
Task_29973,1164,356,112,60,172,3.2605042016806722,26.13413614900251
Task_29974,1165,607,146,97,243,1.9161184210526316,27.96114236890706
Task_29975,1345,529,200,124,324,2.5377358490566038,30.937816578320433
Task_29976,2317,236,17,52,69,9.776371308016877,42.76355301899548
Task_29977,2810,948,129,105,234,2.9610115911485773,55.02523224446738
Task_29978,1955,702,138,151,289,2.7809388335704126,41.024160467730376
Task_29979,2545,473,94,113,207,5.3691983122362865,49.2966772296897
Task_29980,2602,568,151,80,231,4.572934973637961,50.1963331948792
Task_29981,874,441,69,123,192,1.9773755656108598,22.72973232740671
Task_29982,2281,769,93,168,261,2.9623376623376623,46.409302031901255
Task_29983,523,182,54,98,152,2.8579234972677594,15.684857003626595
Task_29984,2221,703,81,14,95,3.1548295454545454,42.89390069261378
Task_29985,1983,240,175,12,187,8.228215767634854,38.47201685827415
Task_29986,1608,817,118,48,166,1.9657701711491442,34.345934553602596
Task_29987,1994,483,111,29,140,4.119834710743802,39.16638223486586
Task_29988,2384,642,98,120,218,3.707620528771384,47.278641287594944
Task_29989,1925,528,189,143,332,3.6389413988657844,40.18171968911218
Task_29990,2969,1018,47,128,175,2.9136408243375858,57.5162854684992
Task_29991,1112,439,191,117,308,2.5272727272727273,26.88279200427485
Task_29992,1714,595,125,200,325,2.8758389261744965,37.1047502333933
Task_29993,1749,169,162,163,325,10.288235294117648,35.90976149428982
Task_29994,812,988,174,66,240,0.8210313447927199,23.03138464639339
Task_29995,1776,110,25,81,106,16.0,33.84512887016317
Task_29996,2364,487,128,34,162,4.844262295081967,45.1636353958617
Task_29997,2792,90,27,125,152,30.681318681318682,50.20801822903076
Task_29998,2312,515,148,55,203,4.48062015503876,45.13108250761956
Task_29999,1432,502,108,183,291,2.8469184890656063,32.16772793316867
Task_30000,2951,516,57,176,233,5.707930367504836,56.14829581926478
Task_30001,2317,156,62,147,209,14.757961783439491,44.35911027656193
Task_30002,2858,721,34,159,193,3.958448753462604,54.99505060612359
Task_30003,1138,80,100,139,239,14.049382716049383,25.046265640503183
Task_30004,2087,96,92,144,236,21.515463917525775,40.0065585809568
Task_30005,2658,819,43,19,62,3.2414634146341466,49.516010850258034
Task_30006,2685,316,172,111,283,8.470031545741325,51.24161634444071
Task_30007,2955,852,35,22,57,3.4642438452520516,54.570622359351034
Task_30008,2672,707,82,13,95,3.774011299435028,50.07081649909764
Task_30009,522,167,153,145,298,3.107142857142857,16.385844010759474
Task_30010,2891,330,181,99,280,8.734138972809667,54.502335551813964
Task_30011,1905,637,32,69,101,2.9858934169278997,38.316481937097016
Task_30012,749,802,122,147,269,0.9327521793275217,22.063463194795958
Task_30013,1903,773,63,200,263,2.458656330749354,40.50535906898654
Task_30014,2786,896,77,158,235,3.1059085841694536,54.69042983239481
Task_30015,1089,332,49,87,136,3.27027027027027,25.124358010986693
Task_30016,1546,386,184,52,236,3.994832041343669,32.74911731069366
Task_30017,1692,497,136,185,321,3.397590361445783,36.40614527599878
Task_30018,1838,183,157,73,230,9.98913043478261,36.682536787675765
Task_30019,2197,280,99,191,290,7.818505338078292,43.55063656277324
Task_30020,1530,745,124,24,148,2.0509383378016084,32.612559785660565
Task_30021,974,372,54,170,224,2.611260053619303,24.344556490725576
Task_30022,622,598,54,197,251,1.0383973288814692,19.431109923110522
Task_30023,2469,956,67,200,267,2.579937304075235,50.056841088741415
Task_30024,1594,398,48,141,189,3.9949874686716793,33.974744275176135
Task_30025,1121,201,158,66,224,5.5495049504950495,25.329930339749424
Task_30026,1566,943,152,117,269,1.6588983050847457,35.4589794441872
Task_30027,2909,775,117,132,249,3.7487113402061856,56.1583799942048
Task_30028,2713,785,159,23,182,3.4516539440203564,51.72259189242188
Task_30029,2611,419,136,70,206,6.216666666666667,49.568331616469244
Task_30030,1419,436,108,29,137,3.2471395881006866,29.938537822518274
Task_30031,1236,200,150,161,311,6.149253731343284,28.135741417672744
Task_30032,1659,159,31,82,113,10.36875,32.76814271204477
Task_30033,2713,457,19,191,210,5.923580786026201,51.92821558203164
Task_30034,1184,508,130,165,295,2.326129666011788,28.252054686926567
Task_30035,1932,109,119,84,203,17.563636363636363,37.247607429711586
Task_30036,644,648,88,111,199,0.9922958397534669,19.51629719771894
Task_30037,2482,64,91,170,261,38.184615384615384,46.140993906322905
Task_30038,2984,961,37,128,165,3.101871101871102,57.49376194679082
Task_30039,1837,634,127,169,296,2.8929133858267715,38.99939651293774
Task_30040,965,466,44,103,147,2.0663811563169165,23.612600293376158
Task_30041,2203,275,124,161,285,7.981884057971015,43.55966204988372
Task_30042,2074,175,111,147,258,11.784090909090908,40.617557452894296
Task_30043,1151,428,86,114,200,2.682983682983683,27.016042223297102
Task_30044,2011,225,153,39,192,8.898230088495575,39.027563428078054
Task_30045,677,877,162,98,260,0.7710706150341685,21.064425061501776
Task_30046,1003,468,111,101,212,2.138592750533049,24.79292421032466
Task_30047,826,190,141,185,326,4.324607329842932,21.74037718248688
Task_30048,728,776,132,39,171,0.9369369369369369,20.284389845559485
Task_30049,2557,712,138,135,273,3.5862552594670407,50.49605693295433
Task_30050,1598,715,127,123,250,2.2318435754189943,35.19295589433247
Task_30051,1167,764,169,63,232,1.5254901960784313,27.872461368472575
Task_30052,2906,823,147,27,174,3.5266990291262137,54.98052429106506
Task_30053,1589,999,142,163,305,1.589,36.19753931837973
Task_30054,1795,897,24,140,164,1.9988864142538976,38.44983208231843
Task_30055,2656,103,196,35,231,25.53846153846154,48.30495274285973
Task_30056,1335,467,182,81,263,2.8525641025641026,29.922447004943987
Task_30057,1465,690,77,69,146,2.1201157742402317,31.895354141238858
Task_30058,500,679,81,46,127,0.7352941176470589,16.13041351557087
Task_30059,1294,99,14,105,119,12.94,26.48553261001084
Task_30060,2251,307,40,72,112,7.308441558441558,42.93704604182593
Task_30061,2165,628,48,167,215,3.4419713831478536,43.930606233784225
Task_30062,2484,940,141,134,275,2.6397449521785337,50.061723998535946
Task_30063,1993,262,93,180,273,7.577946768060836,40.28058370902295
Task_30064,2594,74,38,111,149,34.586666666666666,46.968026537265395
Task_30065,973,406,158,150,308,2.3906633906633905,24.626902855785904
Task_30066,1496,270,22,68,90,5.520295202952029,30.466647102691017
Task_30067,2306,754,117,82,199,3.0543046357615893,45.9575215375192
Task_30068,1998,90,91,99,190,21.956043956043956,38.326026342638016
Task_30069,1052,627,41,76,117,1.6751592356687899,25.15608591616429
Task_30070,1123,785,114,128,242,1.4287531806615776,27.789002216919354
Task_30071,2522,650,143,67,210,3.8740399385560678,48.92107602119188
Task_30072,2045,216,161,14,175,9.423963133640553,39.24006077365441
Task_30073,1760,890,183,114,297,1.9753086419753085,38.50360393360703
Task_30074,1556,384,159,116,275,4.041558441558442,33.58267320723845
Task_30075,1930,983,51,107,158,1.9613821138211383,40.72365032966639
Task_30076,1677,580,151,108,259,2.8864027538726336,36.039200770359194
Task_30077,1108,940,90,114,204,1.177470775770457,27.867451981552563
Task_30078,1777,955,89,10,99,1.858786610878661,36.66982281333467
Task_30079,2261,183,185,28,213,12.28804347826087,42.935070390727816
Task_30080,1342,692,165,52,217,1.9365079365079365,30.400967529103585
Task_30081,2018,579,40,53,93,3.4793103448275864,39.73090965720167
Task_30082,2883,116,162,113,275,24.641025641025642,52.99045721754959
Task_30083,608,688,190,149,339,0.8824383164005806,19.79040955344912
Task_30084,2235,247,181,113,294,9.012096774193548,43.93513885314385
Task_30085,2793,287,57,84,141,9.697916666666666,51.83050705192101
Task_30086,2006,451,141,192,333,4.438053097345133,41.29355030340001
Task_30087,2876,346,84,142,226,8.288184438040346,54.20239015556306
Task_30088,701,861,95,41,136,0.8132250580046404,19.9918307157721
Task_30089,973,694,42,34,76,1.4,22.618243481182002
Task_30090,2573,715,176,137,313,3.5935754189944134,50.94218680161115
Task_30091,2496,997,197,138,335,2.501002004008016,50.7058490128025
Task_30092,1708,71,136,12,148,23.72222222222222,32.10756681170696
Task_30093,948,694,156,169,325,1.3640287769784172,25.175332971870635
Task_30094,2842,740,195,57,252,3.835357624831309,54.390281104697635
Task_30095,506,1001,58,66,124,0.5049900199600799,17.56092414716076
Task_30096,1409,294,108,107,215,4.776271186440678,30.67887185393676
Task_30097,2046,480,76,52,128,4.253638253638254,40.435958688514
Task_30098,983,998,81,66,147,0.983983983983984,25.18896542469369
Task_30099,1724,574,128,79,207,2.9982608695652173,36.194833272675226
Task_30100,2713,296,47,99,146,9.134680134680135,50.71818869085857
Task_30101,2446,922,131,176,307,2.6500541711809316,49.60921240635823
Task_30102,1154,814,92,181,273,1.4159509202453988,28.669070174749816
Task_30103,584,466,18,150,168,1.2505353319057815,17.623772627168574
Task_30104,1409,810,70,125,195,1.7373612823674476,32.3768904052719
Task_30105,621,713,42,88,130,0.8697478991596639,18.62916504871643
Task_30106,1271,227,126,34,160,5.574561403508772,26.9719917861742
Task_30107,1413,670,81,47,128,2.105812220566319,30.641663441808827
Task_30108,1731,368,189,132,321,4.691056910569106,36.5300048012327
Task_30109,2215,749,158,88,246,2.953333333333333,44.75220412286458
Task_30110,2000,134,138,144,282,14.814814814814815,39.35742841870967
Task_30111,1670,142,181,104,285,11.678321678321678,34.2502763465307
Task_30112,1437,893,16,33,49,1.6073825503355705,30.683254689847633
Task_30113,1463,971,196,84,280,1.5051440329218106,33.59591637005018
Task_30114,2640,833,91,27,118,3.1654676258992804,50.28561236724979
Task_30115,2950,151,96,38,134,19.407894736842106,52.815494160955865
Task_30116,2741,638,157,52,209,4.289514866979656,52.353808984680654
Task_30117,2662,670,198,166,364,3.9672131147540983,52.4820677288324
Task_30118,893,386,21,183,204,2.3074935400516794,22.857778331432996
Task_30119,778,274,200,36,236,2.829090909090909,19.953909443153677
Task_30120,1743,454,154,185,339,3.830769230769231,37.15721001571935
Task_30121,743,679,55,42,97,1.0926470588235293,19.500033055022868
Task_30122,2264,499,110,57,167,4.528,43.92078750718661
Task_30123,2995,796,102,67,169,3.7578419071518194,56.48772837849373
Task_30124,2639,569,28,41,69,4.629824561403509,48.66888802116526
Task_30125,1450,926,104,23,127,1.564185544768069,31.818211602043075
Task_30126,1012,106,24,180,204,9.457943925233645,23.14449669551963
Task_30127,2722,808,93,123,216,3.3646477132262054,53.24960889315333
Task_30128,1868,541,87,86,173,3.4464944649446494,38.179348446285765
Task_30129,2714,815,189,76,265,3.325980392156863,52.823405686174
Task_30130,927,755,47,121,168,1.2261904761904763,23.976706686937565
Task_30131,769,812,122,144,266,0.9458794587945879,22.396645874156793
Task_30132,997,205,156,85,241,4.839805825242719,23.678851159918224
Task_30133,2676,321,27,72,99,8.31055900621118,49.42976731112869
Task_30134,2869,94,108,160,268,30.2,52.40346280761268
Task_30135,941,209,183,124,307,4.480952380952381,23.437902648667407
Task_30136,982,578,131,83,214,1.6960276338514682,24.484988813118317
Task_30137,1001,1006,82,83,165,0.9940417080436942,25.845320746168174
Task_30138,2319,756,158,47,205,3.0634081902245707,45.73139817404168
Task_30139,582,554,96,43,139,1.0486486486486486,17.016821113361335
Task_30140,1620,974,154,75,229,1.6615384615384616,35.8197569252975
Task_30141,1403,400,107,71,178,3.4987531172069826,30.076147928368652
Task_30142,1393,87,100,20,120,15.829545454545455,27.17885032076359
Task_30143,2365,488,186,103,289,4.83640081799591,46.76702888633087
Task_30144,1307,915,73,60,133,1.4268558951965065,29.96076841069039
Task_30145,2024,908,181,113,294,2.2266226622662266,42.727789696193234
Task_30146,1052,320,40,104,144,3.277258566978193,24.50984997102434
Task_30147,2120,401,51,20,71,5.27363184079602,39.672138011965295
Task_30148,939,839,71,43,114,1.1178571428571429,23.388247311142678
Task_30149,1598,556,106,159,265,2.8689407540394973,34.814309511701175
Task_30150,2985,238,39,183,222,12.489539748953975,55.54031377405219
Task_30151,1242,1019,82,84,166,1.2176470588235293,29.59165321354727
Task_30152,2083,389,74,73,147,5.341025641025641,40.826895866452894
Task_30153,553,985,34,62,96,0.5608519269776876,17.772756858572983
Task_30154,1862,320,102,49,151,5.8006230529595015,36.63745551190828
Task_30155,965,107,122,90,212,8.935185185185185,22.21005104547358
Task_30156,700,949,155,143,298,0.7368421052631579,21.832315966874432
Task_30157,2440,316,192,196,388,7.697160883280757,47.965249013355844
Task_30158,2484,107,165,24,189,23.0,45.38262063686585
Task_30159,2007,965,53,89,142,2.077639751552795,41.6578964704537
Task_30160,1619,800,92,53,145,2.0212234706616727,34.73409951885538
Task_30161,2392,106,104,116,220,22.35514018691589,44.774983792330886
Task_30162,2485,108,183,193,376,22.798165137614678,47.08011287411591
Task_30163,1915,612,129,56,185,3.1239804241435563,38.93380707551477
Task_30164,2485,985,56,41,97,2.520283975659229,48.011652248532386
Task_30165,2985,288,178,101,279,10.328719723183392,55.852384419723286
Task_30166,2603,691,49,72,121,3.7615606936416186,49.94455948377166
Task_30167,1125,257,196,164,360,4.3604651162790695,26.803681050290077
Task_30168,2404,537,10,100,110,4.4684014869888475,46.37283733468943
Task_30169,1680,642,98,168,266,2.6127527216174182,36.4151901268014
Task_30170,2745,839,130,200,330,3.267857142857143,54.22603741291632
Task_30171,2508,984,10,100,110,2.5461928934010154,49.427548723320506
Task_30172,1535,989,26,119,145,1.5505050505050506,34.30664135049377
Task_30173,2748,417,170,111,281,6.574162679425838,52.57242526384736
Task_30174,779,611,166,172,338,1.272875816993464,22.272984946794107
Task_30175,2963,485,162,68,230,6.096707818930041,55.466015501970226
Task_30176,1782,175,79,84,163,10.125,35.318806909239186
Task_30177,2840,293,80,110,190,9.65986394557823,53.30620080851367
Task_30178,2328,1012,72,128,200,2.2981243830207303,47.594096439687455
Task_30179,1828,961,63,133,196,1.9002079002079002,39.50243648695024
Task_30180,2410,1006,83,29,112,2.393247269116187,47.096475685405174
Task_30181,627,1015,28,50,78,0.6171259842519685,18.70711315538527
Task_30182,990,289,102,60,162,3.413793103448276,22.952073604193217
Task_30183,2146,824,96,142,238,2.601212121212121,44.241780217030026
Task_30184,693,323,133,100,233,2.138888888888889,19.52270478903585
Task_30185,2141,716,185,120,305,2.9860529986052997,44.04113296498855
Task_30186,2243,756,94,105,199,2.963011889035667,45.36656827829739
Task_30187,2066,701,83,30,113,2.943019943019943,40.782373641146144
Task_30188,1441,444,53,192,245,3.238202247191011,32.10162378727333
Task_30189,2243,134,69,60,129,16.614814814814814,41.73088845744875
Task_30190,2993,936,80,48,128,3.1942369263607255,56.5702558665382
Task_30191,2427,482,29,76,105,5.024844720496894,46.210216342658185
Task_30192,2989,611,114,195,309,4.883986928104576,57.26793188904029
Task_30193,1399,1004,199,34,233,1.3920398009950248,32.05608443803627
Task_30194,2473,244,129,80,209,10.093877551020409,46.96751485778009
Task_30195,2810,120,38,192,230,23.223140495867767,51.85637052489111
Task_30196,1020,738,164,129,293,1.3802435723951285,26.242643328630653
Task_30197,621,175,91,129,220,3.528409090909091,17.550947567898714
Task_30198,1512,206,177,200,377,7.304347826086956,32.86876916806763
Task_30199,2061,401,61,171,232,5.126865671641791,41.64337595302954
Task_30200,2805,960,192,41,233,2.9188345473465143,54.19495368654045
Task_30201,1300,118,12,120,132,10.92436974789916,27.001788251033275
Task_30202,825,983,142,47,189,0.8384146341463414,22.69408045759309
Task_30203,625,967,23,82,105,0.6456611570247934,19.402271398103867
Task_30204,695,575,143,43,186,1.2065972222222223,19.245577552709207
Task_30205,2775,160,106,69,175,17.236024844720497,50.707866466883985
Task_30206,2876,1024,145,34,179,2.805853658536585,55.10375724304719
Task_30207,677,813,124,163,287,0.8316953316953317,21.04790433548175
Task_30208,2502,148,186,31,217,16.79194630872483,46.40372957104412
Task_30209,1855,672,59,195,254,2.7563150074294205,39.407415219992
Task_30210,2967,801,157,19,176,3.699501246882793,55.594526282553225
Task_30211,1360,866,83,151,234,1.5686274509803921,31.87080739382202
Task_30212,2574,140,72,78,150,18.25531914893617,47.33075093474363
Task_30213,2164,283,62,132,194,7.619718309859155,42.64665291185431
Task_30214,1578,592,16,35,51,2.661045531197302,32.02065513793597
Task_30215,2662,123,198,11,209,21.467741935483872,48.60387935414098
Task_30216,1181,877,50,83,133,1.3451025056947608,28.248174815924028
Task_30217,2488,846,110,110,220,2.937426210153483,49.54832725393974
Task_30218,1152,254,163,167,330,4.517647058823529,27.089460536765667
Task_30219,2711,775,12,80,92,3.493556701030928,51.57417870635921
Task_30220,1069,489,85,25,110,2.1816326530612247,24.179314022189462
Task_30221,2031,732,90,128,218,2.770804911323329,42.01769639070403
Task_30222,1799,725,176,111,287,2.4779614325068873,38.55742312929262
Task_30223,2037,162,37,194,231,12.496932515337424,40.05190840447822
Task_30224,1256,230,150,39,189,5.437229437229437,27.077497504541693
Task_30225,1742,306,133,130,263,5.6742671009771986,36.233996547679176
Task_30226,1650,232,188,137,325,7.081545064377682,34.81458187320798
Task_30227,2059,497,42,152,194,4.134538152610442,41.60904742719941
Task_30228,1935,990,87,44,131,1.9525731584258326,39.79374670664252
Task_30229,2116,169,109,87,196,12.447058823529412,40.84045665205246
Task_30230,1348,297,138,99,237,4.523489932885906,29.797079534545087
Task_30231,1359,548,196,161,357,2.4754098360655736,31.422281366514742
Task_30232,586,456,35,179,214,1.2822757111597374,18.15780223473109
Task_30233,1628,662,23,154,177,2.455505279034691,35.136802531139544
Task_30234,845,499,191,66,257,1.69,22.06905293735174
Task_30235,2028,957,144,137,281,2.116910229645094,42.92025409446308
Task_30236,625,222,99,63,162,2.802690582959641,17.028663778828072
Task_30237,1242,988,159,23,182,1.255813953488372,29.032791561404434
Task_30238,563,150,190,69,259,3.728476821192053,16.252721206619558
Task_30239,2094,108,82,167,249,19.211009174311926,40.381881263598636
Task_30240,2704,932,91,85,176,2.8981779206859595,52.59750310463696
Task_30241,1588,277,127,28,155,5.712230215827338,32.08687471286991
Task_30242,2550,662,88,93,181,3.8461538461538463,49.511564873568254
Task_30243,1335,926,175,24,199,1.4401294498381878,30.57981608870024
Task_30244,2491,131,173,173,346,18.87121212121212,47.40465775099912
Task_30245,800,299,132,73,205,2.6666666666666665,20.565259187827216
Task_30246,1158,259,67,130,197,4.453846153846154,26.669558068460116
Task_30247,1527,753,166,197,363,2.0251989389920424,34.80459408417175
Task_30248,2572,833,10,39,49,3.0839328537170263,48.37324724970767
Task_30249,2099,548,97,127,224,3.8233151183970855,42.513915504901625
Task_30250,1487,250,36,57,93,5.924302788844622,30.201037276733587
Task_30251,864,346,170,18,188,2.489913544668588,21.027265301208413
Task_30252,2252,706,66,136,202,3.185289957567185,45.44988050102105
Task_30253,1593,220,141,187,328,7.208144796380091,33.95832151911112
Task_30254,2481,67,94,59,153,36.48529411764706,44.704149891941654
Task_30255,1154,321,43,169,212,3.5838509316770186,26.826680012709076
Task_30256,2930,447,104,42,146,6.540178571428571,53.90877422644315
Task_30257,2904,767,119,172,291,3.78125,56.301883099296184
Task_30258,2996,209,55,31,86,14.266666666666667,53.458176128456614
Task_30259,2503,676,17,40,57,3.6971935007385524,46.90341563324008
Task_30260,2826,222,120,174,294,12.672645739910314,53.26493752390653
Task_30261,1566,128,114,161,275,12.13953488372093,32.47748352676871
Task_30262,2743,529,171,54,225,5.175471698113207,52.067727090892085
Task_30263,1585,839,74,118,192,1.8869047619047619,35.23660342077597
Task_30264,1208,170,25,16,41,7.064327485380117,24.366044909172913
Task_30265,854,984,130,72,202,0.867005076142132,23.541743393165234
Task_30266,1383,790,188,57,245,1.7484197218710493,31.39157226852664
Task_30267,740,515,68,153,221,1.434108527131783,20.94596267423746
Task_30268,949,895,133,41,174,1.0591517857142858,24.21761523916288
Task_30269,1920,79,151,80,231,24.0,36.93509432349675
Task_30270,2683,786,104,24,128,3.409148665819568,51.068793024172884
Task_30271,1456,740,110,28,138,1.9649122807017543,31.387945009437246
Task_30272,1995,859,161,52,213,2.3197674418604652,41.248892706068794
Task_30273,2424,608,128,64,192,3.980295566502463,47.13393265689336
Task_30274,2020,734,85,175,260,2.748299319727891,42.105963204859655
Task_30275,2014,149,142,187,329,13.426666666666666,40.025218376573335
Task_30276,2125,184,43,69,112,11.486486486486486,40.3734791624619
Task_30277,1589,565,198,173,371,2.8074204946996466,35.19846371839785
Task_30278,1661,756,66,115,181,2.1941875825627477,35.93659367506651
Task_30279,2836,255,15,139,154,11.078125,52.565785977962086
Task_30280,2574,758,185,121,306,3.391304347826087,51.0384740372751
Task_30281,789,943,158,70,228,0.8358050847457628,22.487294815262214
Task_30282,2074,870,53,126,179,2.381171067738232,42.89042258856489
Task_30283,1807,844,181,62,243,2.1384615384615384,38.29283613401288
Task_30284,2381,1021,119,100,219,2.3297455968688845,48.379613078602254
Task_30285,2624,625,170,46,216,4.1916932907348246,50.189509177616465
Task_30286,1205,234,134,58,192,5.127659574468085,26.565440948804596
Task_30287,638,796,100,194,294,0.8005018820577164,20.485994169371267
Task_30288,1540,125,46,176,222,12.222222222222221,31.865876170385032
Task_30289,2608,111,109,57,166,23.285714285714285,47.41863245281983
Task_30290,2483,781,118,184,302,3.1751918158567776,49.74342266240311
Task_30291,2004,309,48,17,65,6.464516129032258,37.5041130964652
Task_30292,1846,634,56,128,184,2.9070866141732283,38.56192534252171
Task_30293,1425,180,93,57,150,7.87292817679558,29.29468601941738
Task_30294,997,704,41,135,176,1.4141843971631205,25.056823673043095
Task_30295,1048,808,40,144,184,1.2954264524103831,26.168500332784202
Task_30296,2967,620,189,174,363,4.777777777777778,57.160899747583606
Task_30297,1863,923,45,118,163,2.0162337662337664,39.4672920188003
Task_30298,1086,959,79,179,258,1.13125,27.978076259730937
Task_30299,997,299,58,139,197,3.3233333333333333,24.301990738887778
Task_30300,2650,652,71,139,210,4.058192955589586,51.62823713413068
Task_30301,870,476,147,43,190,1.8238993710691824,21.82106737632655
Task_30302,2300,504,47,197,244,4.554455445544554,45.774946547059095
Task_30303,1440,978,148,81,229,1.4708886618998978,32.978333604709924
Task_30304,1142,384,170,47,217,2.966233766233766,25.972468707737885
Task_30305,879,463,64,90,154,1.894396551724138,22.189513499303022
Task_30306,1962,845,116,113,229,2.3191489361702127,41.256129388036335
Task_30307,1554,726,146,156,302,2.137551581843191,34.81305038470634
Task_30308,1132,550,95,81,176,2.0544464609800364,26.474031455499773
Task_30309,819,892,182,89,271,0.9171332586786114,23.184820766162726
Task_30310,1317,713,149,12,161,1.8445378151260505,29.125008567410905
Task_30311,1805,692,81,96,177,2.6046176046176046,37.987142963278494
Task_30312,886,797,165,70,235,1.1102756892230576,23.50420306845815
Task_30313,957,1003,112,46,158,0.953187250996016,24.485331558661652
Task_30314,952,497,131,148,279,1.9116465863453815,24.447554257084857
Task_30315,1425,209,172,89,261,6.785714285714286,30.633066472045186
Task_30316,1859,797,147,90,237,2.3295739348370925,39.312021196440796
Task_30317,2002,257,158,28,186,7.75968992248062,38.84223963473187
Task_30318,2510,181,161,141,302,13.791208791208792,47.73962723024011
Task_30319,2680,587,95,25,120,4.557823129251701,50.185755394175345
Task_30320,910,662,135,34,169,1.3725490196078431,22.76392200198174
Task_30321,2619,709,174,86,260,3.6887323943661974,51.07420624067394
Task_30322,2381,339,107,145,252,7.002941176470588,46.42328870785773
Task_30323,1722,312,190,69,259,5.501597444089457,35.36021218181447
Task_30324,976,227,111,65,176,4.280701754385965,22.751504592508507
Task_30325,765,576,154,190,344,1.3258232235701906,22.047479828861782
Task_30326,1850,103,79,68,147,17.78846153846154,35.26150149026122
Task_30327,2079,674,18,82,100,3.08,41.292621443779595
Task_30328,2769,666,107,84,191,4.151424287856072,52.968577779511754
Task_30329,509,546,144,153,297,0.9305301645338209,17.60411512851192
Task_30330,1958,146,79,134,213,13.319727891156463,38.59973853789261
Task_30331,533,898,113,41,154,0.592880978865406,17.675851363694377
Task_30332,1374,609,142,165,307,2.2524590163934426,31.631844912502775
Task_30333,2233,154,121,134,255,14.406451612903226,43.07830470205068
Task_30334,2495,127,114,132,246,19.4921875,46.922298056746506
Task_30335,1445,394,99,140,239,3.6582278481012658,31.733311715930792
Task_30336,2849,778,48,170,218,3.657252888318357,55.256586886074665
Task_30337,2907,754,55,147,202,3.8503311258278146,56.029303952034155
Task_30338,889,759,101,135,236,1.1697368421052632,23.970762658371715
Task_30339,1811,193,84,169,253,9.335051546391753,36.98946760391555
Task_30340,2142,796,125,89,214,2.687578419071518,43.6646448468013
Task_30341,1805,65,34,140,174,27.348484848484848,35.126843169633624
Task_30342,2945,176,77,168,245,16.638418079096045,54.45271957038878
Task_30343,576,442,148,199,347,1.3002257336343115,18.612806168155867
Task_30344,2456,979,24,106,130,2.5061224489795917,48.84103479260801
Task_30345,867,335,173,61,234,2.580357142857143,21.731246838022106
Task_30346,1158,826,198,197,395,1.400241837968561,29.26143108375336
Task_30347,1995,376,127,145,272,5.291777188328912,40.53113249348626
Task_30348,2387,686,120,23,143,3.4745269286754,45.9980319691306
Task_30349,2572,616,198,183,381,4.168557536466775,50.98671514544454
Task_30350,2595,208,75,137,212,12.416267942583731,49.273858736975576
Task_30351,1578,213,138,104,242,7.373831775700935,33.18696592127845
Task_30352,946,799,199,155,354,1.1825,25.558908904682692
Task_30353,2011,725,49,102,151,2.7699724517906334,41.116476062887116
Task_30354,2013,913,199,55,254,2.202407002188184,41.87786595594675
Task_30355,1899,794,83,189,272,2.388679245283019,40.457665343742235
Task_30356,1819,798,186,49,235,2.276595744680851,38.153009741459215
Task_30357,1082,367,15,97,112,2.9402173913043477,25.004245976465512
Task_30358,2262,243,191,134,325,9.270491803278688,44.51756659126405
Task_30359,1815,230,199,11,210,7.857142857142857,35.91983332661271
Task_30360,1929,700,158,68,226,2.7517831669044224,39.759763226749136
Task_30361,1415,538,185,128,313,2.6252319109461966,32.030797813931734
Task_30362,2634,393,88,178,266,6.685279187817259,50.73873852262673
Task_30363,1358,391,151,145,296,3.4642857142857144,30.609620687316667
Task_30364,692,710,23,170,193,0.9732770745428974,20.56386552395625
Task_30365,1505,684,195,39,234,2.197080291970803,32.70742804143192
Task_30366,2150,671,47,165,212,3.199404761904762,43.73932787426359
Task_30367,865,247,191,131,322,3.4879032258064515,22.44270083579318
Task_30368,2538,864,117,162,279,2.9341040462427745,50.73901963329854
Task_30369,2149,360,160,12,172,5.9529085872576175,41.40062641239147
Task_30370,1014,431,86,121,207,2.3472222222222223,24.89916589081317
Task_30371,1610,676,133,108,241,2.3781388478581977,35.198511826028245
Task_30372,1541,379,84,179,263,4.0552631578947365,33.414723629258624
Task_30373,656,459,82,32,114,1.4260869565217391,17.675286869779878
Task_30374,2227,861,151,44,195,2.5835266821345706,44.54304263266774
Task_30375,1474,185,51,46,97,7.924731182795699,29.501433003943486
Task_30376,775,398,137,10,147,1.9423558897243107,19.50954120619546
Task_30377,2939,315,140,74,214,9.300632911392405,54.532467869329054
Task_30378,1503,546,46,136,182,2.7477148080438756,32.72267066698601
Task_30379,2954,934,104,173,277,3.1593582887700533,57.55677747259394
Task_30380,2735,1014,54,88,142,2.6945812807881775,53.285397691692765
Task_30381,1427,850,47,44,91,1.6768507638072856,30.820371549755126
Task_30382,2582,612,179,133,312,4.212071778140293,50.74807349586555
Task_30383,2020,554,172,38,210,3.6396396396396398,40.4141697004749
Task_30384,907,291,18,110,128,3.106164383561644,22.20949983606546
Task_30385,2957,698,69,22,91,4.23032904148784,54.6058468258795
Task_30386,1052,631,37,41,78,1.6645569620253164,23.799187391421682
Task_30387,2641,537,51,178,229,4.908921933085502,51.33015477281919
Task_30388,1358,557,38,48,86,2.4336917562724016,28.828841650165618
Task_30389,2054,84,80,30,110,24.16470588235294,37.58281175700842
Task_30390,1209,431,57,107,164,2.798611111111111,27.77229680206234
Task_30391,2973,836,193,114,307,3.5519713261648747,57.599320139753424
Task_30392,1934,867,182,160,342,2.228110599078341,41.4592604221223
Task_30393,1241,662,10,19,29,1.8717948717948718,26.365745290265227
Task_30394,1670,971,97,33,130,1.7181069958847737,35.578375677411785
Task_30395,536,495,163,85,248,1.0806451612903225,17.21348116232091
Task_30396,2897,191,125,161,286,15.088541666666666,54.192536107750925
Task_30397,1318,940,180,193,373,1.4006376195536663,32.04504877012812
Task_30398,1713,284,113,97,210,6.010526315789473,35.4473787433018
Task_30399,2376,290,184,146,330,8.164948453608247,46.52800041438553
Task_30400,1631,472,40,95,135,3.448202959830867,34.153812183678674
Task_30401,747,721,58,129,187,1.0346260387811634,21.369483028673045
Task_30402,1540,898,115,61,176,1.7130144605116797,33.70435090795116
Task_30403,2530,471,70,28,98,5.360169491525424,47.25614226216544
Task_30404,2745,448,38,199,237,6.11358574610245,52.5705364092351
Task_30405,2073,777,33,115,148,2.66452442159383,42.171903533714506
Task_30406,990,748,146,117,263,1.321762349799733,25.673559090382863
Task_30407,2807,783,83,133,216,3.580357142857143,54.473984333140464
Task_30408,1153,193,189,167,356,5.943298969072165,27.01785583336198
Task_30409,2018,685,153,87,240,2.941690962099125,41.39982961366815
Task_30410,2351,722,124,31,155,3.251728907330567,45.633860674743595
Task_30411,1691,740,157,42,199,2.282051282051282,35.699478110959205
Task_30412,2034,376,191,177,368,5.395225464190982,41.62773901925987
Task_30413,684,112,32,48,80,6.053097345132743,16.16616400548203
Task_30414,1824,767,165,16,181,2.375,37.460301949636694
Task_30415,2365,402,132,126,258,5.86848635235732,46.38028847756053
Task_30416,2697,533,178,18,196,5.050561797752809,50.71503499156551
Task_30417,1499,80,12,94,106,18.506172839506174,29.483762942204265
Task_30418,2802,699,186,186,372,4.002857142857143,54.856856724710404
Task_30419,2191,796,96,18,114,2.749058971141782,42.832433272212675
Task_30420,2765,783,33,196,229,3.5267857142857144,53.95376310540843
Task_30421,2339,841,54,30,84,2.7779097387173395,45.155851175676624
Task_30422,2943,905,28,153,181,3.248344370860927,56.69195810166807
Task_30423,2142,777,62,53,115,2.7532133676092543,42.504712192136864
Task_30424,2737,946,50,141,191,2.8901795142555438,53.91066155337507
Task_30425,1968,627,107,65,172,3.1337579617834397,39.80751396961234
Task_30426,815,823,23,86,109,0.9890776699029126,21.891720024208055
Task_30427,975,67,196,120,316,14.338235294117647,22.756011829582462
Task_30428,2273,234,109,28,137,9.672340425531916,42.71631267039985
Task_30429,2227,906,65,53,118,2.4553472987872107,44.30646103284991
Task_30430,1497,267,107,101,208,5.585820895522388,31.938668252173887
Task_30431,2716,67,88,38,126,39.94117647058823,47.81265577850356
Task_30432,833,739,34,68,102,1.1256756756756756,21.54317238323087
Task_30433,2601,304,76,114,190,8.527868852459017,49.58342167302872
Task_30434,1935,368,97,153,250,5.2439024390243905,39.49177340299941
Task_30435,2181,192,113,39,152,11.300518134715025,41.20020062169481
Task_30436,1989,943,49,63,112,2.106991525423729,40.78305584829641
Task_30437,2612,717,96,49,145,3.637883008356546,49.91822010703723
Task_30438,2993,309,94,84,178,9.654838709677419,55.16796300962014
Task_30439,2137,623,11,95,106,3.4246794871794872,42.320847506259774
Task_30440,1502,968,68,150,218,1.5500515995872033,34.437397799010505
Task_30441,1165,309,164,160,324,3.7580645161290325,27.439481018554428
Task_30442,1408,237,147,147,294,5.915966386554622,30.884459584647363
Task_30443,1824,388,150,179,329,4.688946015424165,38.17173829240293
Task_30444,543,161,197,75,272,3.3518518518518516,16.145907341323127
Task_30445,777,620,95,75,170,1.251207729468599,20.888391518627483
Task_30446,1166,332,99,148,247,3.5015015015015014,27.167172679828436
Task_30447,2924,108,37,73,110,26.825688073394495,51.89087036070794
Task_30448,1638,534,40,57,97,3.061682242990654,33.497757926082386
Task_30449,842,773,160,140,300,1.0878552971576227,23.502885368898692
Task_30450,2465,421,50,60,110,5.841232227488152,46.44567163341827
Task_30451,2727,400,47,191,238,6.800498753117207,52.157304489329874
Task_30452,1161,581,176,21,197,1.9948453608247423,26.688425020447152
Task_30453,2845,505,24,29,53,5.622529644268774,51.8029611767445
Task_30454,2795,513,130,150,280,5.437743190661479,53.68377257112983
Task_30455,551,87,144,49,193,6.261363636363637,14.808133647319488
Task_30456,1027,171,95,23,118,5.97093023255814,22.323978257760164
Task_30457,1677,419,42,10,52,3.992857142857143,32.766353375458216
Task_30458,798,787,38,51,89,1.0126903553299493,20.85600351491733
Task_30459,2201,130,81,31,112,16.801526717557252,40.41984166052724
Task_30460,881,748,40,178,218,1.1762349799732976,23.744007313277223
Task_30461,980,457,94,66,160,2.1397379912663754,23.391135743293493
Task_30462,2452,252,83,122,205,9.691699604743082,47.04772200016662
Task_30463,962,364,178,147,325,2.6356164383561644,24.39160991668803
Task_30464,911,203,69,199,268,4.465686274509804,22.999469744159303
Task_30465,1660,754,160,81,241,2.198675496688742,35.871637117632964
Task_30466,2717,503,126,35,161,5.390873015873016,50.77469340622175
Task_30467,2495,704,50,70,120,3.5390070921985815,48.20896146471629
Task_30468,1609,263,120,66,186,6.09469696969697,32.93143569718902
Task_30469,1480,551,98,80,178,2.681159420289855,31.95850217409704
Task_30470,2199,733,142,136,278,2.9959128065395095,44.91506446423415
Task_30471,2065,105,25,186,211,19.4811320754717,39.733146553556914
Task_30472,616,106,172,42,214,5.757009345794392,16.141875637952015
Task_30473,2431,123,96,43,139,19.60483870967742,44.36214450574936
Task_30474,1998,800,92,150,242,2.49438202247191,41.876381682271195
Task_30475,1485,561,164,29,193,2.6423487544483986,31.868892746755776
Task_30476,2954,851,165,112,277,3.467136150234742,57.20725086243971
Task_30477,1225,990,100,24,124,1.2361251261352169,28.349560876504995
Task_30478,1228,950,127,126,253,1.2912723449001051,29.987119997000843
Task_30479,1742,468,16,157,173,3.7142857142857144,36.29231865916918
Task_30480,2263,596,186,26,212,3.7906197654941374,44.33057856848499
Task_30481,2128,363,168,85,253,5.846153846153846,42.143805409604234
Task_30482,2946,705,79,130,209,4.172804532577904,56.47084448271391
Task_30483,1122,730,126,152,278,1.5348837209302326,27.82536941488449
Task_30484,1911,229,52,99,151,8.308695652173913,37.913435650876735
Task_30485,2520,435,107,10,117,5.779816513761468,46.98572319563548
Task_30486,2936,607,185,183,368,4.828947368421052,56.66409594892624
Task_30487,2370,825,12,142,154,2.8692493946731235,47.0199654553826
Task_30488,1026,478,39,16,55,2.1419624217119,22.642479087221677
Task_30489,2838,738,123,101,224,3.8403247631935047,54.75877019016483
Task_30490,2111,273,169,17,186,7.704379562043796,40.40767545983488
Task_30491,1137,419,189,65,254,2.7071428571428573,26.455383693885185
Task_30492,1850,996,137,164,301,1.855566700100301,40.35045786007504
Task_30493,1317,600,87,134,221,2.1913477537437602,30.276423237871843
Task_30494,1945,162,169,101,270,11.932515337423313,38.61203449946398
Task_30495,1823,658,78,116,194,2.7663125948406675,38.446421832225816
Task_30496,973,442,111,68,179,2.1963882618510158,23.400091247947
Task_30497,2702,816,100,134,234,3.307221542227662,52.943155757148894
Task_30498,1231,747,38,132,170,1.6457219251336899,28.94239002559942
Task_30499,2993,461,143,133,276,6.478354978354979,56.60534643287517
Task_30500,813,266,130,133,263,3.044943820224719,21.42025897502343
Task_30501,1313,603,171,198,369,2.173841059602649,30.97481379151297
Task_30502,1067,548,96,139,235,1.9435336976320583,26.26946523842788
Task_30503,1009,225,161,131,292,4.464601769911504,24.508690822647793
Task_30504,1455,404,164,47,211,3.5925925925925926,30.962120962920675
Task_30505,2646,425,159,42,201,6.211267605633803,49.82681448304826
Task_30506,1347,1002,169,146,315,1.3429710867397806,32.394273494012936
Task_30507,1590,73,127,51,178,21.486486486486488,30.906035350845443
Task_30508,1639,941,51,175,226,1.7399150743099787,36.69668154697674
Task_30509,1421,470,193,32,225,3.0169851380042463,30.703354548647734
Task_30510,700,729,79,96,175,0.958904109589041,20.603050192957117
Task_30511,2879,443,121,171,292,6.4842342342342345,54.86935723248225
Task_30512,1581,423,134,127,261,3.7287735849056602,34.05713502845254
Task_30513,2718,452,120,195,315,6.0,52.48959794530318
Task_30514,607,953,14,184,198,0.6362683438155137,20.15490989790415
Task_30515,2249,550,115,117,232,4.081669691470054,44.89312685939442
Task_30516,1394,200,104,48,152,6.935323383084577,28.733696646602983
Task_30517,1628,525,34,70,104,3.0950570342205324,33.56020949758767
Task_30518,675,852,40,98,138,0.7913247362250879,20.046923781264454
Task_30519,2965,518,39,54,93,5.7129094412331405,54.513445206500315
Task_30520,2755,664,58,57,115,4.142857142857143,51.849064363901995
Task_30521,579,347,148,117,265,1.6637931034482758,17.951359527277578
Task_30522,780,613,27,102,129,1.270358306188925,21.05786228987054
Task_30523,2900,189,48,13,61,15.263157894736842,51.50261896869457
Task_30524,2639,168,17,106,123,15.615384615384615,48.199317745276765
Task_30525,2231,546,171,152,323,4.078610603290676,45.05679290389378
Task_30526,2052,625,64,95,159,3.2779552715654954,41.461322389873196
Task_30527,1404,355,10,40,50,3.943820224719101,28.490702474347824
Task_30528,1753,137,122,68,190,12.702898550724637,34.56228312962311
Task_30529,2120,351,129,116,245,6.0227272727272725,42.261382851082004
Task_30530,2442,978,166,145,311,2.49438202247191,49.69302199129203
Task_30531,1577,862,24,87,111,1.8273464658169176,34.208366251543474
Task_30532,1478,918,165,109,274,1.6082698585418933,33.99777491383807
Task_30533,1447,142,184,50,234,10.118881118881118,29.837578036677836
Task_30534,1323,838,185,199,384,1.5768772348033373,31.891918586147302
Task_30535,1489,601,128,70,198,2.473421926910299,32.35290918353479
Task_30536,1920,929,119,80,199,2.064516129032258,40.38342176705141
Task_30537,1690,350,41,115,156,4.814814814814815,34.753015624057845
Task_30538,1358,198,12,96,108,6.824120603015075,28.732671219226035
Task_30539,1638,148,67,46,113,10.993288590604028,31.72683567922196
Task_30540,2465,604,119,86,205,4.074380165289257,48.054458274474406
Task_30541,1410,497,180,47,227,2.8313253012048194,30.61841040323672
Task_30542,2105,637,196,16,212,3.299373040752351,41.827240032163445
Task_30543,2188,637,147,171,318,3.4294670846394983,44.67009535382859
Task_30544,2374,656,189,86,275,3.6133942161339423,47.093621221471516
Task_30545,1972,701,184,171,355,2.809116809116809,41.61709288468467
Task_30546,1073,862,85,47,132,1.243337195828505,25.732778481298023
Task_30547,2237,876,117,48,165,2.5507411630558723,44.57702696661277
Task_30548,2796,456,73,156,229,6.1181619256017505,53.41953817543462
Task_30549,2533,555,172,166,338,4.555755395683454,49.95564518486206
Task_30550,1733,341,48,127,175,5.067251461988304,35.86540376018923
Task_30551,2200,239,117,115,232,9.166666666666666,43.07639838295663
Task_30552,2815,330,173,14,187,8.50453172205438,51.90762715357173
Task_30553,983,878,143,92,235,1.118316268486917,25.579047331747645
Task_30554,1660,825,174,43,217,2.009685230024213,35.55602539290615
Task_30555,1558,739,77,142,219,2.1054054054054054,34.648287435296375
Task_30556,827,461,76,18,94,1.79004329004329,20.05837657675084
Task_30557,1265,717,123,121,244,1.7618384401114207,29.880803207114564
Task_30558,2820,129,61,16,77,21.692307692307693,49.503285659587995
Task_30559,505,887,65,129,194,0.5686936936936937,18.31396850949609
Task_30560,1397,872,31,102,133,1.600229095074456,31.73234764066807
Task_30561,1191,355,38,79,117,3.345505617977528,26.543846058906762
Task_30562,2196,640,133,189,322,3.425897035881435,44.85069448124225
Task_30563,2815,971,128,93,221,2.896090534979424,55.03478446000929
Task_30564,1412,545,33,196,229,2.586080586080586,31.774290012093058
Task_30565,1218,647,168,155,323,1.8796296296296295,29.337443019687555
Task_30566,2248,583,180,24,204,3.8493150684931505,43.989843065219056
Task_30567,909,930,194,165,359,0.9763694951664876,25.416111593317424
Task_30568,644,635,47,149,196,1.0125786163522013,19.43519122923983
Task_30569,784,391,133,18,151,2.0,19.488679466484097
Task_30570,1905,630,120,150,270,3.0190174326465926,39.9187420378174
Task_30571,2976,1014,167,157,324,2.9320197044334977,58.34375024095419
Task_30572,556,933,168,17,185,0.5952890792291221,18.258871270952387
Task_30573,2676,329,122,113,235,8.10909090909091,50.931107476237536
Task_30574,2593,214,161,15,176,12.06046511627907,47.79342658815949
Task_30575,602,643,77,13,90,0.9347826086956522,17.28421503397882
Task_30576,1462,243,51,60,111,5.991803278688525,29.9957475891842
Task_30577,2041,222,100,41,141,9.152466367713005,38.99633341118034
Task_30578,2495,462,56,164,220,5.388768898488121,48.67764065184477
Task_30579,1772,721,148,78,226,2.4542936288088644,37.49611985357615
Task_30580,1881,431,163,161,324,4.354166666666667,39.16450939803803
Task_30581,2976,626,19,41,60,4.746411483253588,54.18008201347343
Task_30582,1018,406,116,94,210,2.501228501228501,24.759654406329727
Task_30583,2716,76,146,127,273,35.27272727272727,49.84827572958448
Task_30584,2687,606,169,189,358,4.42668863261944,52.68124832297516
Task_30585,1855,342,102,66,168,5.408163265306122,36.954178976934024
Task_30586,1706,538,89,106,195,3.165120593692022,36.11408238803386
Task_30587,932,620,119,121,240,1.500805152979066,24.256970165151277
Task_30588,2406,816,123,148,271,2.944920440636475,48.44076347295695
Task_30589,2783,136,86,60,146,20.313868613138688,50.25271099049187
Task_30590,569,771,118,156,274,0.7370466321243523,19.11774950602391
Task_30591,2890,384,93,116,209,7.5064935064935066,54.50354857158005
Task_30592,1232,184,94,104,198,6.65945945945946,27.355186528289803
Task_30593,1872,717,157,180,337,2.6072423398328692,40.01526690012624
Task_30594,524,226,149,85,234,2.3083700440528636,16.248650838804224
Task_30595,1202,738,102,122,224,1.6265223274695535,28.859487711428557
Task_30596,2658,191,14,184,198,13.84375,50.065397274969236
Task_30597,722,431,147,21,168,1.6712962962962963,18.936053901324723
Task_30598,1453,432,77,99,176,3.355658198614319,31.591733005735552
Task_30599,2336,520,161,136,297,4.483685220729367,46.49540689525926
Task_30600,2769,746,151,98,249,3.7068273092369477,53.80251496824494
Task_30601,765,117,119,142,261,6.483050847457627,19.718953958930488
Task_30602,1596,951,20,47,67,1.6764705882352942,33.38674681125595
Task_30603,2087,904,90,108,198,2.306077348066298,43.322843815757075
Task_30604,1081,131,153,144,297,8.18939393939394,24.942972010108758
Task_30605,1413,856,47,138,185,1.6487747957993,32.33719966974973
Task_30606,2221,175,164,65,229,12.619318181818182,42.43467822006718
Task_30607,2413,386,137,139,276,6.235142118863049,47.18690566037753
Task_30608,500,270,176,74,250,1.845018450184502,15.984411488358608
Task_30609,1128,635,195,57,252,1.7735849056603774,26.901026402552613
Task_30610,1343,848,107,68,175,1.5818610129564192,30.605808819164974
Task_30611,1868,412,46,179,225,4.523002421307506,38.511693444873124
Task_30612,2774,829,188,98,286,3.342168674698795,54.3095926608598
Task_30613,1863,372,154,45,199,4.994638069705094,37.21630830744331
Task_30614,917,118,198,137,335,7.705882352941177,22.45021641286915
Task_30615,699,852,193,174,367,0.8194607268464243,21.893710076094578
Task_30616,1992,780,95,14,109,2.5505761843790014,39.75507518408
Task_30617,1008,817,108,191,299,1.2322738386308068,26.360698970996655
Task_30618,761,187,148,180,328,4.047872340425532,20.804148152123993
Task_30619,2870,284,51,122,173,10.070175438596491,53.69731493364075
Task_30620,2539,911,56,119,175,2.7839912280701755,50.46337204971818
Task_30621,1258,73,74,97,171,17.0,26.466810178298797
Task_30622,1163,824,165,69,234,1.4096969696969697,27.975335627796042
Task_30623,1067,198,124,48,172,5.36180904522613,23.952337134827513
Task_30624,1554,138,13,99,112,11.179856115107913,31.00287482868624
Task_30625,2570,238,110,115,225,10.753138075313808,48.88602094034354
Task_30626,2406,987,136,72,208,2.435222672064777,48.16333184637261
Task_30627,1968,686,175,155,330,2.8646288209606987,41.37050523878326
Task_30628,2248,674,163,57,220,3.33037037037037,44.628540418716135
Task_30629,1613,93,77,58,135,17.159574468085108,31.272679453865607
Task_30630,672,718,60,176,236,0.9346314325452016,20.537034829294292
Task_30631,2777,168,192,46,238,16.431952662721894,50.963172485699516
Task_30632,717,902,67,42,109,0.7940199335548173,20.057158255861854
Task_30633,2871,855,146,197,343,3.3539719626168223,56.3267919893342
Task_30634,1071,800,74,37,111,1.3370786516853932,25.34272350156718
Task_30635,1375,177,104,98,202,7.724719101123595,29.229613105271227
Task_30636,2528,67,18,24,42,37.1764705882353,43.73250607109272
Task_30637,1814,275,75,86,161,6.572463768115942,36.36540486319931
Task_30638,2227,683,168,123,291,3.2558479532163744,45.240893039264
Task_30639,1052,939,95,51,146,1.1191489361702127,25.98967425257955
Task_30640,1754,361,105,61,166,4.845303867403315,35.39783850152913
Task_30641,1787,956,120,41,161,1.8672936259143156,37.43710249791376
Task_30642,682,800,136,154,290,0.8514357053682896,21.09567459491559
Task_30643,2158,270,40,121,161,7.96309963099631,41.923982859360045
Task_30644,1251,147,142,74,216,8.452702702702704,26.94464930335397
Task_30645,2541,574,103,129,232,4.419130434782609,49.6111443853873
Task_30646,2077,225,112,98,210,9.190265486725664,40.96106579646671
Task_30647,1676,674,44,196,240,2.482962962962963,36.37578527739517
Task_30648,1783,945,198,103,301,1.8847780126849893,39.040925282904816
Task_30649,2050,997,13,185,198,2.0541082164328657,43.1454808026734
Task_30650,2330,680,168,26,194,3.42143906020558,45.576406108001514
Task_30651,519,559,98,111,209,0.9267857142857143,17.358505126233002
Task_30652,1365,877,24,104,128,1.5546697038724373,31.320947050204044
Task_30653,2053,1014,12,199,211,2.0226600985221674,43.271005131507515
Task_30654,787,486,131,61,192,1.6160164271047228,20.756608272333636
Task_30655,2086,162,23,98,121,12.797546012269938,39.57750940201719
Task_30656,2412,907,170,195,365,2.656387665198238,49.31290886770057
Task_30657,1429,1021,178,73,251,1.398238747553816,32.94291511814961
Task_30658,1055,285,41,104,145,3.6888111888111887,24.484410293466855
Task_30659,1836,748,118,39,157,2.451268357810414,37.52219947467334
Task_30660,515,804,41,157,198,0.639751552795031,18.104569928613284
Task_30661,2879,399,132,176,308,7.1975,54.802250665368206
Task_30662,1531,583,86,27,113,2.6215753424657535,31.965456466495368
Task_30663,1470,892,80,182,262,1.6461366181410975,33.970531739549166
Task_30664,2488,155,148,73,221,15.948717948717949,46.469839999041376
Task_30665,2022,573,31,86,117,3.5226480836236935,40.4370742847681
Task_30666,1281,896,29,200,229,1.4280936454849498,30.68303837690713
Task_30667,2440,528,123,150,273,4.612476370510397,48.080063901026335
Task_30668,2495,918,148,34,182,2.7149075081610445,48.75228428060952
Task_30669,1855,784,141,24,165,2.3630573248407645,38.161130414764976
Task_30670,819,590,144,104,248,1.385786802030457,22.35950921002069
Task_30671,2370,313,146,84,230,7.547770700636943,45.6779716983477
Task_30672,1376,435,108,41,149,3.1559633027522938,29.254435579499738
Task_30673,1699,275,21,90,111,6.155797101449275,34.24075610158126
Task_30674,949,454,149,143,292,2.085714285714286,24.316244057915497
Task_30675,1660,461,174,90,264,3.593073593073593,35.22378143174842
Task_30676,510,682,101,116,217,0.746705710102489,17.58272976338978
Task_30677,1077,450,17,12,29,2.388026607538803,23.103512124207203
Task_30678,1673,677,55,133,188,2.467551622418879,36.118678082532135
Task_30679,1288,379,29,62,91,3.389473684210526,27.477258996969407
Task_30680,2823,763,151,147,298,3.695026178010471,55.00095636919948
Task_30681,2657,624,49,143,192,4.2512,51.60867642126172
Task_30682,1868,127,153,145,298,14.59375,37.306887715313536
Task_30683,1629,940,40,175,215,1.7311370882040382,36.30203225400984
Task_30684,2263,856,133,152,285,2.6406067677946323,46.369158182893614
Task_30685,2196,531,71,106,177,4.12781954887218,43.67445870869477
Task_30686,1736,635,198,195,393,2.729559748427673,37.87820270402088
Task_30687,798,900,17,37,54,0.8856825749167592,20.784707188003775
Task_30688,1887,121,129,87,216,15.467213114754099,36.96818484456028
Task_30689,2108,97,120,125,245,21.510204081632654,40.31817359753485
Task_30690,1213,907,17,51,68,1.3359030837004404,27.416501745329754
Task_30691,2321,338,45,97,142,6.846607669616519,44.67179920905742
Task_30692,1849,679,85,115,200,2.7191176470588236,38.86636184395097
Task_30693,1615,955,160,67,227,1.6893305439330544,35.57383534198255
Task_30694,1329,476,100,35,135,2.7861635220125787,28.624610737922723
Task_30695,656,261,30,60,90,2.50381679389313,17.00346820900813
Task_30696,2433,638,109,106,215,3.807511737089202,47.99408658384274
Task_30697,2597,619,103,14,117,4.188709677419355,48.76409256185258
Task_30698,1751,137,131,75,206,12.68840579710145,34.70375982075248
Task_30699,1858,995,41,67,108,1.8654618473895583,38.770318350503516
Task_30700,966,624,104,126,230,1.5456,24.77015970774683
Task_30701,1566,370,157,128,285,4.2210242587601075,33.75808070086289
Task_30702,1450,520,20,20,40,2.783109404990403,29.24635049755842
Task_30703,2921,787,79,39,118,3.7068527918781724,54.62071092575933
Task_30704,2689,311,64,183,247,8.618589743589743,51.35862907368196
Task_30705,1951,494,62,87,149,3.9414141414141413,39.23957733985053
Task_30706,750,114,158,31,189,6.521739130434782,18.31495283349655
Task_30707,2072,367,150,74,224,5.630434782608695,41.042223142601046
Task_30708,1956,462,83,163,246,4.224622030237581,40.15659626196114
Task_30709,2049,600,159,144,303,3.409317803660566,42.24451094858045
Task_30710,1706,403,159,53,212,4.2227722772277225,35.23394436546951
Task_30711,1074,831,104,121,225,1.2908653846153846,27.044755532772225
Task_30712,1368,725,138,195,333,1.884297520661157,32.06037578546347
Task_30713,2859,133,116,178,294,21.33582089552239,52.98172936959318
Task_30714,2558,603,90,110,200,4.235099337748345,49.85007843812263
Task_30715,1808,412,169,80,249,4.37772397094431,37.20572508315268
Task_30716,2641,717,197,85,282,3.6782729805013927,51.53494829811235
Task_30717,1165,883,194,190,384,1.3178733031674208,29.505001974468826
Task_30718,697,630,51,99,150,1.1045958795562598,19.78963531949974
Task_30719,651,582,93,148,241,1.1166380789022299,19.728855251103315
Task_30720,1869,692,62,89,151,2.696969696969697,38.578081941148106
Task_30721,2066,968,169,147,316,2.132094943240454,43.729036451906175
Task_30722,2409,653,69,77,146,3.68348623853211,46.88220992785735
Task_30723,2998,223,66,102,168,13.383928571428571,55.24622732783817
Task_30724,2987,230,140,73,213,12.930735930735931,54.91939058550732
Task_30725,1322,649,40,40,80,2.0338461538461536,28.392145177237552
Task_30726,1334,1017,39,143,182,1.3104125736738703,31.388819060788943
Task_30727,1366,727,108,162,270,1.8763736263736264,31.702606014323298
Task_30728,2035,130,137,65,202,15.534351145038167,39.035781561424265
Task_30729,1716,130,120,113,233,13.099236641221374,34.60155855335872
Task_30730,1389,234,177,73,250,5.910638297872341,29.86027199574566
Task_30731,1973,108,23,181,204,18.10091743119266,38.328191044739945
Task_30732,1094,475,177,102,279,2.2983193277310923,26.558889065284443
Task_30733,1320,506,157,109,266,2.603550295857988,30.18607773741162
Task_30734,1106,69,19,58,77,15.8,22.31332246282389
Task_30735,740,854,37,175,212,0.8654970760233918,21.77062870980956
Task_30736,1972,921,14,154,168,2.13882863340564,41.29435129507798
Task_30737,2816,356,103,198,301,7.8879551820728295,53.660481760117534
Task_30738,2617,179,59,125,184,14.53888888888889,48.711564616461885
Task_30739,1043,463,91,169,260,2.247844827586207,25.775618179653247
Task_30740,984,436,114,122,236,2.251716247139588,24.53029005630256
Task_30741,1817,670,126,88,214,2.7078986587183307,38.05549963275045
Task_30742,2273,654,122,157,279,3.4702290076335878,45.87377340966818
Task_30743,1754,475,98,81,179,3.6848739495798317,36.023425346226574
Task_30744,2449,379,94,165,259,6.4447368421052635,47.778420655195674
Task_30745,815,663,109,145,254,1.2274096385542168,22.55539442202659
Task_30746,1091,124,144,25,169,8.728,23.472724695224713
Task_30747,2819,125,26,56,82,22.373015873015873,50.15587022931198
Task_30748,2212,206,39,174,213,10.68599033816425,43.15461631939854
Task_30749,1674,855,115,29,144,1.955607476635514,35.30670263774538
Task_30750,2022,162,28,147,175,12.404907975460123,39.37533415550595
Task_30751,1971,700,60,129,189,2.81169757489301,40.889495542515604
Task_30752,1346,501,179,131,310,2.681274900398406,30.81246961157674
Task_30753,839,546,199,132,331,1.5338208409506398,22.979898401612644
Task_30754,2258,637,81,55,136,3.5391849529780566,44.187179026972444
Task_30755,2289,511,155,80,235,4.470703125,45.075623620838236
Task_30756,1301,325,43,129,172,3.9907975460122698,28.85390114930063
Task_30757,2669,703,149,84,233,3.7911931818181817,51.69302651375628
Task_30758,2549,150,162,61,223,16.880794701986755,47.398828658563026
Task_30759,1700,946,100,17,117,1.7951425554382259,35.512191874456754
Task_30760,690,852,47,128,175,0.8089097303634232,20.718849758831944
Task_30761,2534,740,89,162,251,3.4197031039136303,50.200173167994876
Task_30762,1749,941,176,158,334,1.856687898089172,38.71908917576455
Task_30763,1667,119,185,148,333,13.891666666666667,34.27145477425662
Task_30764,2482,348,163,51,214,7.111747851002866,47.27592168573431
Task_30765,2613,240,77,197,274,10.842323651452283,50.03982508658399
Task_30766,1080,258,13,190,203,4.1698841698841695,25.482399232301443
Task_30767,1133,416,110,32,142,2.7170263788968825,25.323310064733253
Task_30768,1741,293,194,11,205,5.921768707482993,34.94767676358567
Task_30769,2040,904,99,45,144,2.25414364640884,41.17865559059873
Task_30770,1313,703,25,121,146,1.8650568181818181,29.920821614879618
Task_30771,2969,92,49,69,118,31.9247311827957,52.585588520062515
Task_30772,2758,561,132,176,308,4.907473309608541,53.417130894573724
Task_30773,1812,592,152,151,303,3.0556492411467118,38.476260090714895
Task_30774,2354,401,145,148,293,5.855721393034826,46.392920628443996
Task_30775,1500,899,11,182,193,1.6666666666666667,34.03188633785786
Task_30776,647,130,35,193,228,4.938931297709924,17.844224127995016
Task_30777,1107,648,46,138,184,1.7057010785824345,26.77816852117432
Task_30778,953,698,69,135,204,1.363376251788269,24.779813209369383
Task_30779,859,950,140,84,224,0.9032597266035752,23.71477784654945
Task_30780,1286,367,35,157,192,3.494565217391304,28.971510054234752
Task_30781,2946,893,97,52,149,3.295302013422819,55.89528513522069
Task_30782,1020,198,60,133,193,5.125628140703518,24.323882534219422
Task_30783,2730,953,52,29,81,2.861635220125786,51.781155840851426
Task_30784,2174,871,129,45,174,2.493119266055046,43.54189142093899
Task_30785,828,900,187,56,243,0.9189789123196448,23.073962750457124
Task_30786,2238,158,114,32,146,14.075471698113208,41.71078662373926
Task_30787,749,236,87,104,191,3.160337552742616,19.952465529372258
Task_30788,567,354,162,156,318,1.5971830985915494,18.079627614684178
Task_30789,1790,310,37,45,82,5.755627009646302,34.77445501050298
Task_30790,1495,69,161,88,249,21.357142857142858,30.419501216814933
Task_30791,2609,266,129,195,324,9.771535580524345,50.169707577817555
Task_30792,1490,906,54,105,159,1.6427783902976847,33.45824107782229
Task_30793,2498,559,134,108,242,4.460714285714285,48.896545753651374
Task_30794,2813,305,41,92,133,9.19281045751634,52.295246648059276
Task_30795,2145,123,77,134,211,17.298387096774192,41.3782347609578
Task_30796,1956,238,197,18,215,8.184100418410042,38.08976593330605
Task_30797,1339,795,73,141,214,1.6821608040201006,31.316873064244145
Task_30798,2762,733,162,65,227,3.7629427792915533,53.05976087672085
Task_30799,2445,96,30,62,92,25.20618556701031,43.94580485500901
Task_30800,1523,265,43,79,122,5.725563909774436,31.530158257921244
Task_30801,618,850,34,87,121,0.7262044653349001,18.975181402935124
Task_30802,2101,474,59,180,239,4.423157894736842,42.58488320287798
Task_30803,2254,677,164,193,357,3.3244837758112094,46.04973394653643
Task_30804,2992,109,182,124,306,27.2,54.63902373072738
Task_30805,1809,383,73,53,126,4.7109375,36.27213758088775
Task_30806,587,587,22,98,120,0.9982993197278912,17.608740025015766
Task_30807,1735,175,173,156,329,9.857954545454545,35.603598633032384
Task_30808,888,684,143,73,216,1.2963503649635038,23.174383883178155
Task_30809,508,638,13,67,80,0.7949921752738655,16.037873954794623
Task_30810,700,297,152,34,186,2.348993288590604,18.437227870653064
Task_30811,2339,772,111,64,175,3.0258732212160413,46.14492295860262
Task_30812,1539,648,27,13,40,2.3713405238828966,31.102417745914227
Task_30813,1497,932,99,114,213,1.6045016077170418,34.076370774867215
Task_30814,2225,675,191,31,222,3.2914201183431953,44.06817937607409
Task_30815,1845,757,17,102,119,2.4340369393139842,38.22663200169479
Task_30816,2376,462,73,51,124,5.1317494600431965,45.34861547717878
Task_30817,569,91,147,65,212,6.184782608695652,15.584872839926069
Task_30818,965,892,16,155,171,1.0806270996640537,24.943906354759363
Task_30819,1837,302,191,125,316,6.0627062706270625,37.954087420407
Task_30820,1758,507,38,114,152,3.4606299212598426,36.28083225881743
Task_30821,1050,699,182,136,318,1.5,26.745288892824604
Task_30822,1003,370,58,125,183,2.7035040431266846,24.359327987337327
Task_30823,1176,662,12,144,156,1.7737556561085972,27.630777847310394
Task_30824,2002,988,35,113,148,2.024266936299292,41.68330362954339
Task_30825,1653,642,28,21,49,2.5707620528771384,33.18464316495625
Task_30826,1277,960,140,85,225,1.3288241415192508,30.389172324054687
Task_30827,2717,879,60,166,226,3.0875,53.517148783774815
Task_30828,1862,295,120,174,294,6.29054054054054,38.29821510355824
Task_30829,1087,458,29,111,140,2.3681917211328978,25.51078401580456
Task_30830,906,713,136,180,316,1.26890756302521,24.5000256891438
Task_30831,1852,615,64,195,259,3.0064935064935066,39.17645598601972
Task_30832,1141,215,113,123,236,5.282407407407407,26.294823520142916
Task_30833,1079,263,103,77,180,4.087121212121212,24.607045441755727
Task_30834,1522,361,71,71,142,4.204419889502763,31.791457310082354
Task_30835,1607,874,157,16,173,1.8365714285714285,34.421370588699936
Task_30836,1230,320,58,93,151,3.8317757009345796,27.418024593196453
Task_30837,716,742,136,51,187,0.9636608344549125,20.486011365136267
Task_30838,1061,860,169,150,319,1.232288037166086,27.363708811482596
Task_30839,2901,930,97,189,286,3.1160042964554244,56.79213459973803
Task_30840,1705,536,139,86,225,3.175046554934823,35.893922796543926
Task_30841,1271,424,47,107,154,2.9905882352941178,28.342209192207136
Task_30842,2242,960,112,60,172,2.3329864724245577,45.10636983877316
Task_30843,2165,155,177,35,212,13.878205128205128,41.09841977484022
Task_30844,1802,487,102,149,251,3.692622950819672,37.747383722916695
Task_30845,1924,830,66,159,225,2.3152827918170877,40.77932100927748
Task_30846,2692,961,119,27,146,2.7983367983367984,51.752364512583206
Task_30847,2445,431,70,68,138,5.659722222222222,46.56908794542159
Task_30848,1901,814,90,110,200,2.3325153374233127,40.10710883505002
Task_30849,526,406,141,75,216,1.2923832923832923,16.619832639157412
Task_30850,2481,267,146,176,322,9.257462686567164,48.11357580303898
Task_30851,2706,777,53,191,244,3.4781491002570695,53.18239925873149
Task_30852,1316,693,31,45,76,1.8962536023054755,28.076120261743657
Task_30853,2342,507,190,53,243,4.610236220472441,45.77613124445975
Task_30854,983,120,21,93,114,8.12396694214876,21.781816972630526
Task_30855,1395,237,167,128,295,5.861344537815126,30.655758536718412
Task_30856,2556,584,64,96,160,4.369230769230769,49.35917757771131
Task_30857,904,682,119,79,198,1.3235724743777453,23.46955996305721
Task_30858,1336,597,143,195,338,2.234113712374582,31.17613922494945
Task_30859,1581,227,69,157,226,6.934210526315789,33.41160722291609
Task_30860,839,495,85,169,254,1.6915322580645162,22.60437486354525
Task_30861,1401,303,77,165,242,4.608552631578948,30.914910458080996
Task_30862,1930,953,77,163,240,2.0230607966457024,41.33411023338333
Task_30863,1135,182,173,133,306,6.202185792349726,26.25052839772825
Task_30864,1503,153,151,83,234,9.75974025974026,31.175694055383804
Task_30865,763,217,73,61,134,3.5,19.1797306911316
Task_30866,689,363,175,122,297,1.8928571428571428,19.90684673309262
Task_30867,2821,641,108,107,215,4.394080996884735,54.150299161499184
Task_30868,1637,435,78,21,99,3.7545871559633026,32.90532110483323
Task_30869,2352,179,187,144,331,13.066666666666666,45.35063659391898
Task_30870,1584,407,38,14,52,3.8823529411764706,31.242299240333903
Task_30871,2742,747,110,157,267,3.665775401069519,53.54226533642975
Task_30872,1035,640,10,196,206,1.6146645865834632,25.939093155958755
Task_30873,1907,976,152,40,192,1.9518935516888434,39.83372240976447
Task_30874,1620,183,188,95,283,8.804347826086957,33.753317693886736
Task_30875,2019,384,46,174,220,5.244155844155844,40.77964085739878
Task_30876,1338,470,63,139,202,2.840764331210191,30.240669391261807
Task_30877,2673,596,80,39,119,4.477386934673367,50.07036050603972
Task_30878,2764,802,87,89,176,3.4420921544209215,53.20962062446362
Task_30879,2665,672,43,29,72,3.959881129271917,49.45718889660143
Task_30880,925,80,170,24,194,11.419753086419753,20.63313572746571
Task_30881,1365,731,71,35,106,1.8647540983606556,29.616823069036727
Task_30882,2033,247,20,186,206,8.19758064516129,40.434528509008
Task_30883,2475,953,22,109,131,2.5943396226415096,49.00174950088166
Task_30884,1939,527,152,62,214,3.672348484848485,39.256954373962536
Task_30885,2860,270,12,36,48,10.55350553505535,51.103303523093615
Task_30886,1714,615,180,118,298,2.7824675324675323,36.925834515361196
Task_30887,2458,118,104,146,250,20.65546218487395,46.32095550992454
Task_30888,2016,891,19,96,115,2.2600896860986546,41.40485420288654
Task_30889,2813,457,116,61,177,6.141921397379913,52.47102579161099
Task_30890,2960,819,102,23,125,3.6097560975609757,55.374495442627364
Task_30891,1597,414,13,32,45,3.8481927710843373,31.644729073169987
Task_30892,2095,615,67,164,231,3.4009740259740258,42.84748784101242
Task_30893,1080,623,24,191,215,1.7307692307692308,26.672377485646262
Task_30894,2185,95,159,36,195,22.760416666666668,40.537474180913634
Task_30895,2474,1024,60,83,143,2.4136585365853658,49.11731182962199
Task_30896,2871,700,58,59,117,4.095577746077033,53.82369768527611
Task_30897,2611,874,21,43,64,2.984,49.209666091746875
Task_30898,1055,873,146,19,165,1.2070938215102975,25.610622213383355
Task_30899,2543,718,152,135,287,3.536856745479833,50.35630741263609
Task_30900,1262,941,48,200,248,1.3397027600849256,30.71407636076594
Task_30901,1228,99,86,65,151,12.28,25.308629396637556
Task_30902,1969,827,133,50,183,2.3780193236714977,40.19574431470127
Task_30903,2086,672,175,161,336,3.099554234769688,43.23139529652874
Task_30904,1996,988,53,49,102,2.018200202224469,40.375495139928056
Task_30905,2964,872,192,113,305,3.395189003436426,57.559259229092824
Task_30906,2298,882,45,93,138,2.6024915062287657,45.95448255242391
Task_30907,1139,803,113,17,130,1.4166666666666667,26.34693108965931
Task_30908,624,447,10,12,22,1.3928571428571428,15.87788787817567
Task_30909,1835,989,70,14,84,1.8535353535353536,37.57071052878191
Task_30910,1867,362,108,109,217,5.143250688705234,38.15931904139469
Task_30911,1412,1019,139,90,229,1.384313725490196,32.818634640072105
Task_30912,623,917,122,126,248,0.6786492374727668,20.42969713964624
Task_30913,2238,411,131,95,226,5.432038834951456,44.18246270927227
Task_30914,1854,868,146,125,271,2.1334867663981587,39.82349569979258
Task_30915,523,697,180,39,219,0.7492836676217765,17.12665507942228
Task_30916,857,909,56,175,231,0.9417582417582417,24.027940297767277
Task_30917,876,304,113,25,138,2.8721311475409834,20.805028042161638
Task_30918,2118,239,81,163,244,8.825,42.00915925455523
Task_30919,2030,305,199,64,263,6.633986928104576,40.23233101945852
Task_30920,1068,957,200,101,301,1.11482254697286,27.586150676487488
Task_30921,2367,967,80,47,127,2.4452479338842976,46.533521302843376
Task_30922,2667,612,62,148,210,4.350734094616639,51.784481139322885
Task_30923,1077,794,110,179,289,1.3547169811320754,27.40264080325544
Task_30924,1697,870,109,144,253,1.9483352468427095,37.28883131557232
Task_30925,1449,897,67,101,168,1.6135857461024499,32.91763471873869
Task_30926,1236,315,81,36,117,3.911392405063291,26.395627595120057
Task_30927,1707,371,173,133,306,4.588709677419355,36.093995876703666
Task_30928,647,670,148,167,315,0.9642324888226528,20.265264514841743
Task_30929,929,375,139,93,232,2.470744680851064,23.340912191724488
Task_30930,2706,905,170,76,246,2.986754966887417,52.892999204003765
Task_30931,570,500,160,130,290,1.1377245508982037,18.350556390968844
Task_30932,840,565,180,190,370,1.4840989399293287,23.31577497239812
Task_30933,828,331,71,63,134,2.4939759036144578,20.667689965505975
Task_30934,2318,987,96,44,140,2.3461538461538463,45.901006323509385
Task_30935,634,250,148,86,234,2.5258964143426295,18.07610388377486
Task_30936,1161,376,148,29,177,3.079575596816976,25.899419905666164
Task_30937,2820,854,137,104,241,3.2982456140350878,54.91954319264556
Task_30938,934,709,152,111,263,1.315492957746479,24.644452583851205
Task_30939,2104,431,149,96,245,4.87037037037037,42.2660366562252
Task_30940,2137,320,193,98,291,6.657320872274143,42.6099508105059
Task_30941,2914,1019,51,86,137,2.8568627450980393,56.18487917255186
Task_30942,1783,1009,118,127,245,1.7653465346534654,39.00899304423035
Task_30943,1662,828,163,110,273,2.004825090470446,36.64387745777269
Task_30944,1446,110,194,25,219,13.027027027027026,29.26290291226697
Task_30945,1563,807,87,187,274,1.9344059405940595,35.135892533927326
Task_30946,1949,638,118,42,160,3.0500782472613457,38.994504235830654
Task_30947,2264,672,173,82,255,3.364041604754829,45.286618621794275
Task_30948,620,228,79,155,234,2.7074235807860263,18.27945026944759
Task_30949,1531,926,112,170,282,1.651564185544768,34.987900005622855
Task_30950,547,167,108,83,191,3.255952380952381,15.996969113262615
Task_30951,2033,1019,104,18,122,1.9931372549019608,41.0434488591737
Task_30952,500,227,125,158,283,2.192982456140351,16.475471893842837
Task_30953,2769,815,130,178,308,3.3933823529411766,54.399551972696806
Task_30954,1821,224,17,169,186,8.093333333333334,36.71848141594691
Task_30955,2064,775,178,95,273,2.6597938144329896,42.79727800718032
Task_30956,1850,552,27,105,132,3.3453887884267632,37.91259086007713
Task_30957,2138,644,176,109,285,3.314728682170543,43.66067237034139
Task_30958,2648,739,140,122,262,3.5783783783783782,51.95409551897844
Task_30959,1633,295,34,37,71,5.516891891891892,31.907312919185717
Task_30960,1159,315,28,159,187,3.6677215189873418,26.74889861756756
Task_30961,2192,247,69,12,81,8.838709677419354,40.89140164551704
Task_30962,2628,106,168,164,332,24.560747663551403,49.05902633242204
Task_30963,625,187,176,16,192,3.324468085106383,17.05320377031426
Task_30964,556,314,79,126,205,1.765079365079365,17.356914717365157
Task_30965,1894,525,130,165,295,3.6007604562737643,39.54683688958986
Task_30966,1304,690,60,77,137,1.8871201157742403,29.47114389271641
Task_30967,2728,375,130,27,157,7.25531914893617,50.43669519152215
Task_30968,1852,926,155,160,315,1.9978425026968716,40.22189833466603
Task_30969,943,844,60,195,255,1.1159763313609468,25.29479708273905
Task_30970,662,145,120,51,171,4.534246575342466,17.109830960866258
Task_30971,1613,214,55,95,150,7.502325581395349,33.153035073702995
Task_30972,1125,829,50,58,108,1.355421686746988,26.387309032652443
Task_30973,617,520,172,170,342,1.1842610364683301,19.44988684259599
Task_30974,2429,920,112,135,247,2.6373507057546144,49.003068581188835
Task_30975,1228,297,29,102,131,4.120805369127517,27.240597608806322
Task_30976,1415,359,141,82,223,3.9305555555555554,30.70336862751634
Task_30977,2806,342,165,178,343,8.180758017492712,53.6141667476233
Task_30978,864,218,43,54,97,3.9452054794520546,20.2691207492388
Task_30979,2417,1018,52,103,155,2.3719332679097156,48.5044825647855
Task_30980,2376,268,169,14,183,8.83271375464684,44.58631945578987
Task_30981,2611,761,87,94,181,3.426509186351706,50.75804283050358
Task_30982,560,72,35,150,185,7.671232876712328,15.630680394902265
Task_30983,1930,411,198,126,324,4.684466019417476,39.82376970659846
Task_30984,1983,136,88,74,162,14.474452554744525,37.84869124698831
Task_30985,1210,648,88,112,200,1.8644067796610169,28.61607309860163
Task_30986,2407,833,197,118,315,2.886091127098321,48.66416883379552
Task_30987,1107,203,168,152,320,5.426470588235294,26.13742050713105
Task_30988,1670,428,119,82,201,3.8927738927738926,34.86201985992704
Task_30989,1875,564,107,164,271,3.3185840707964602,39.26019336359381
Task_30990,2262,794,129,28,157,2.8452830188679243,44.42253528188608
Task_30991,2780,456,116,53,169,6.083150984682713,52.022184441528395
Task_30992,2436,829,198,191,389,2.9349397590361446,49.55165192210425
Task_30993,806,980,49,163,212,0.8216106014271152,23.33033143498599
Task_30994,500,823,164,26,190,0.6067961165048543,17.409619459456223
Task_30995,1135,635,98,60,158,1.7845911949685536,26.314962428122783
Task_30996,837,208,131,179,310,4.0047846889952154,21.886741564600495
Task_30997,701,964,85,182,267,0.7264248704663212,21.93477445881594
Task_30998,1946,507,131,48,179,3.8307086614173227,38.74752004396705
Task_30999,639,896,83,123,206,0.7123745819397993,20.440638683628176
Task_31000,2410,387,142,131,273,6.211340206185567,47.11751913943514
Task_31001,1196,708,177,130,307,1.68688293370945,29.05691144623974
Task_31002,1881,352,21,54,75,5.328611898016997,36.24150027303053
Task_31003,1266,1010,134,127,261,1.2522255192878338,30.781452707116387
Task_31004,1401,331,198,98,296,4.219879518072289,31.029691938371325
Task_31005,1634,861,44,116,160,1.8955916473317866,35.50017173107062
Task_31006,2642,671,146,132,278,3.931547619047619,51.7310009699656
Task_31007,1051,637,155,32,187,1.6473354231974922,25.154072222735554
Task_31008,1889,439,107,151,258,4.293181818181818,39.00484983751873
Task_31009,2764,442,86,127,213,6.239277652370204,52.66740628002464
Task_31010,1482,687,38,121,159,2.1540697674418605,32.54886598564742
Task_31011,808,986,56,17,73,0.8186423505572442,20.827786983083357
Task_31012,1647,372,120,170,290,4.415549597855228,35.130156479129404
Task_31013,2827,594,109,152,261,4.751260504201681,54.3685972902941
Task_31014,1708,571,22,131,153,2.986013986013986,35.67714090563346
Task_31015,1997,189,84,22,106,10.510526315789473,37.91970553468904
Task_31016,1353,402,164,172,336,3.357320099255583,30.785682646947667
Task_31017,2160,712,140,192,332,3.02945301542777,44.55677608383538
Task_31018,2802,99,10,30,40,28.02,48.858854445072495
Task_31019,2554,921,131,47,178,2.770065075921909,49.667541835953024
Task_31020,2982,366,65,111,176,8.125340599455042,55.59894073680604
Task_31021,1757,253,34,15,49,6.917322834645669,33.43337809852154
Task_31022,1486,403,109,70,179,3.6782178217821784,31.39346933469386
Task_31023,1696,949,165,45,210,1.7852631578947369,36.44185834785717
Task_31024,2492,270,86,83,169,9.195571955719558,47.00806531198325
Task_31025,2402,921,140,70,210,2.6052060737527114,47.87176890902095
Task_31026,1980,879,79,177,256,2.25,41.993534928245715
Task_31027,1009,270,138,133,271,3.7232472324723247,24.567041024703943
Task_31028,626,115,41,144,185,5.396551724137931,16.947109903476427
Task_31029,2341,69,143,112,255,33.44285714285714,43.828497957853195
Task_31030,2396,843,31,173,204,2.838862559241706,48.13673851540542
Task_31031,2857,361,116,114,230,7.892265193370166,53.88302752350861
Task_31032,1984,979,69,41,110,2.024489795918367,40.266405089509085
Task_31033,2604,851,139,127,266,3.056338028169014,51.63415913595486
Task_31034,527,970,199,88,287,0.5427394438722966,18.926129199711955
Task_31035,847,75,197,102,299,11.144736842105264,20.658099734576254
Task_31036,1117,926,156,168,324,1.2049622437971952,28.545514035337103
Task_31037,2915,253,81,98,179,11.476377952755906,54.083564626554534
Task_31038,966,399,25,31,56,2.415,21.652152268597074
Task_31039,974,79,185,116,301,12.175,22.72724440317612
Task_31040,855,894,96,122,218,0.9553072625698324,23.812985989166332
Task_31041,2343,421,106,115,221,5.552132701421801,45.91183522031596
Task_31042,1792,922,112,166,278,1.9414951245937162,39.100751351311054
Task_31043,637,128,145,68,213,4.937984496124031,17.008715407923326
Task_31044,1623,849,178,142,320,1.9094117647058824,36.35005656686068
Task_31045,2598,129,107,153,260,19.984615384615385,48.6480894456728
Task_31046,2814,593,91,88,179,4.737373737373737,53.30694969675722
Task_31047,1621,979,89,189,278,1.6540816326530612,36.62813343218731
Task_31048,1889,297,112,135,247,6.3389261744966445,38.46289683630204
Task_31049,643,814,64,116,180,0.7889570552147239,19.90170087227647
Task_31050,1073,850,173,166,339,1.2608695652173914,27.65370955202107
Task_31051,1820,1022,134,146,280,1.7790811339198436,39.821279414198244
Task_31052,1085,611,143,167,310,1.772875816993464,27.064232203234592
Task_31053,1032,560,37,147,184,1.839572192513369,25.331658009800986
Task_31054,567,988,181,152,333,0.5733063700707786,20.157062905990827
Task_31055,1718,655,86,49,135,2.6189024390243905,35.43040412890172
Task_31056,2602,922,85,64,149,2.819068255687974,50.52880361557939
Task_31057,2105,339,94,44,138,6.1911764705882355,40.49721562786767
Task_31058,1963,288,55,56,111,6.7923875432525955,38.04125829281261
Task_31059,2933,331,72,54,126,8.83433734939759,53.82218753825682
Task_31060,673,537,137,117,254,1.2509293680297398,19.873960677637807
Task_31061,1507,764,57,103,160,1.969934640522876,33.30319329295204
Task_31062,1718,974,17,158,175,1.7620512820512821,37.47635577154411
Task_31063,2345,355,132,27,159,6.587078651685394,44.319280016819675
Task_31064,1304,999,45,42,87,1.304,29.276071863922954
Task_31065,2634,524,152,161,313,5.017142857142857,51.335176249192635
Task_31066,1361,473,91,111,202,2.871308016877637,30.49448597184224
Task_31067,1602,793,151,196,347,2.017632241813602,36.04385951279899
Task_31068,1041,861,20,146,166,1.2076566125290022,26.151175443442124
Task_31069,2454,65,108,40,148,37.18181818181818,43.829701079875484
Task_31070,1422,578,14,15,29,2.4559585492227978,29.066222738524175
Task_31071,532,454,71,79,150,1.1692307692307693,16.540494031495225
Task_31072,1204,295,193,150,343,4.0675675675675675,28.081175362848896
Task_31073,2340,908,138,23,161,2.5742574257425743,46.01497897452941
Task_31074,678,81,122,30,152,8.268292682926829,16.33829704140572
Task_31075,1765,976,97,104,201,1.8065506653019447,38.42640993036668
Task_31076,1426,925,21,74,95,1.5399568034557236,31.536462859808353
Task_31077,2335,719,96,153,249,3.2430555555555554,46.97252074755417
Task_31078,2754,672,30,181,211,4.092124814264487,53.31899371404797
Task_31079,2561,307,126,194,320,8.314935064935066,49.5378266471644
Task_31080,2595,128,143,41,184,20.11627906976744,47.24584581752342
Task_31081,523,812,161,34,195,0.6432964329643296,17.729486480770806
Task_31082,743,182,60,54,114,4.060109289617486,18.450720627187902
Task_31083,1175,295,124,44,168,3.9695945945945947,25.77069619902488
Task_31084,543,372,133,163,296,1.4557640750670242,17.612703051060333
Task_31085,2887,294,14,92,106,9.786440677966102,53.10955027759823
Task_31086,1873,1021,46,169,215,1.8326810176125246,40.44657453641923
Task_31087,1265,301,170,117,287,4.188741721854305,28.764578855294417
Task_31088,595,303,183,103,286,1.957236842105263,18.152776695979004
Task_31089,2828,854,10,155,165,3.3076023391812868,54.7084454886132
Task_31090,2891,919,81,71,152,3.142391304347826,55.14934323510865
Task_31091,1640,828,92,162,254,1.9782870928829916,36.363422603232735
Task_31092,1804,676,79,39,118,2.6646971935007384,36.57702943388883
Task_31093,769,502,140,158,298,1.52882703777336,21.623644055757154
Task_31094,665,87,81,31,112,7.556818181818182,15.765393298950642
Task_31095,2359,278,127,110,237,8.455197132616487,45.74492869874249
Task_31096,975,408,68,196,264,2.3838630806845966,24.656224059375774
Task_31097,2986,928,63,94,157,3.2142088266953714,57.17275070948284
Task_31098,1245,1015,165,26,191,1.2253937007874016,29.406055658779078
Task_31099,2022,300,100,130,230,6.717607973421927,40.49196004845668
Task_31100,2851,656,199,112,311,4.339421613394216,55.11318231374607
Task_31101,2574,618,129,27,156,4.158319870759289,48.7854124038748
Task_31102,1798,516,12,19,31,3.4777562862669247,34.74042845143807
Task_31103,2223,639,44,157,201,3.4734375,44.69654132949896
Task_31104,1520,551,79,30,109,2.753623188405797,31.656818992302476
Task_31105,1725,284,153,80,233,6.052631578947368,35.396975752921
Task_31106,1203,162,191,182,373,7.380368098159509,27.496494654322888
Task_31107,1490,82,96,101,197,17.951807228915662,30.348292888900374
Task_31108,1911,281,67,194,261,6.776595744680851,39.027584249529475
Task_31109,718,364,69,36,105,1.9671232876712328,18.201869103824873
Task_31110,1234,637,157,65,222,1.9341692789968652,28.532461088837792
Task_31111,2242,411,130,124,254,5.441747572815534,44.44260513571064
Task_31112,1490,364,164,79,243,4.082191780821918,31.98229191960043
Task_31113,2779,947,102,124,226,2.931434599156118,54.522672084564896
Task_31114,1586,432,133,115,248,3.6628175519630486,34.08898359058176
Task_31115,526,192,160,155,315,2.7253886010362693,16.917106233528557
Task_31116,962,807,129,73,202,1.1905940594059405,24.698520509943947
Task_31117,2723,341,54,100,154,7.961988304093567,51.139336173166946
Task_31118,678,335,114,61,175,2.017857142857143,18.397614594713435
Task_31119,2118,385,36,141,177,5.487046632124352,41.90361323671137
Task_31120,1629,175,182,174,356,9.255681818181818,34.07970426165361
Task_31121,1046,266,34,73,107,3.9176029962546814,23.687601226119824
Task_31122,510,179,77,133,210,2.8333333333333335,15.83994870701008
Task_31123,2192,228,113,139,252,9.572052401746724,43.034606714460615
Task_31124,709,981,97,134,231,0.7219959266802444,21.922158666752072
Task_31125,1364,564,122,98,220,2.4141592920353983,30.8452385539959
Task_31126,2474,317,61,79,140,7.779874213836478,46.85032236155643
Task_31127,2195,453,175,141,316,4.834801762114537,44.14013754493914
Task_31128,2244,821,81,172,253,2.72992700729927,45.94749174834762
Task_31129,2866,212,179,192,371,13.455399061032864,54.22980028237631
Task_31130,2428,567,14,134,148,4.274647887323944,47.15538921630235
Task_31131,1127,335,66,180,246,3.3541666666666665,26.72342743792682
Task_31132,2403,631,144,145,289,3.8022151898734178,47.88745174870619
Task_31133,697,286,15,114,129,2.4285714285714284,18.86165742820535
Task_31134,1925,849,90,81,171,2.264705882352941,39.8853225556292
Task_31135,2294,837,120,147,267,2.7374701670644392,46.71248912488388
Task_31136,1846,923,60,82,142,1.9978354978354977,38.87760148773174
Task_31137,923,618,88,124,212,1.4911147011308563,24.003484206399218
Task_31138,1375,585,29,14,43,2.34641638225256,28.34442290765074
Task_31139,2836,317,140,134,274,8.918238993710691,53.62606563210985
Task_31140,1429,635,115,46,161,2.24685534591195,30.75768806159365
Task_31141,2977,124,56,105,161,23.816,53.7593606942362
Task_31142,2082,452,123,135,258,4.596026490066225,42.07812299435172
Task_31143,2035,291,59,17,76,6.969178082191781,37.88731147044935
Task_31144,1375,822,14,74,88,1.6707168894289186,30.472431517712852
Task_31145,1286,946,113,19,132,1.3579725448785638,29.21113074808004
Task_31146,2896,309,81,190,271,9.341935483870968,54.7188075849078
Task_31147,702,634,108,130,238,1.105511811023622,20.56023688737073
Task_31148,2770,940,78,128,206,2.9436769394261426,54.4046224879446
Task_31149,1438,210,136,131,267,6.815165876777251,31.118003374156018
Task_31150,944,324,197,146,343,2.9046153846153846,24.058488709896313
Task_31151,2685,70,97,35,132,37.816901408450704,47.43542105267303
Task_31152,1463,657,63,23,86,2.223404255319149,30.628874533230956
Task_31153,2582,97,154,47,201,26.346938775510203,46.79094615705125
Task_31154,2167,609,81,71,152,3.5524590163934424,42.70485539015606
Task_31155,762,436,199,130,329,1.7437070938215102,21.434211170977818
Task_31156,730,887,190,115,305,0.8220720720720721,22.127128926671187
Task_31157,1465,421,197,156,353,3.471563981042654,32.67211341776868
Task_31158,1130,109,49,10,59,10.272727272727273,22.69744357220237
Task_31159,2990,1018,38,104,142,2.9342492639842983,57.39157276826101
Task_31160,2789,788,141,53,194,3.534854245880862,53.527072405205566
Task_31161,2271,847,183,61,244,2.678066037735849,45.62073334840638
Task_31162,822,1015,61,90,151,0.8090551181102362,22.88634623864839
Task_31163,1741,152,109,189,298,11.379084967320262,35.58976270387674
Task_31164,518,944,75,84,159,0.5481481481481482,17.995609749649358
Task_31165,2643,848,147,182,329,3.1130742049469964,52.60725728817598
Task_31166,1961,746,69,150,219,2.6251673360107093,41.06164387919982
Task_31167,1525,880,56,130,186,1.7309875141884223,34.2874275864214
Task_31168,1986,357,90,104,194,5.5474860335195535,39.96351531549567
Task_31169,2595,204,100,57,157,12.658536585365853,47.97263249911481
Task_31170,2445,803,88,106,194,3.041044776119403,48.62892563556176
Task_31171,2828,888,137,196,333,3.1811023622047245,55.70236727373867
Task_31172,1620,178,58,50,108,9.050279329608939,31.51793356842136
Task_31173,1678,239,180,95,275,6.991666666666666,34.96662628295032
Task_31174,1514,576,36,119,155,2.6239168110918545,32.692184386248094
Task_31175,537,265,196,81,277,2.018796992481203,16.718943385115182
Task_31176,626,385,111,55,166,1.621761658031088,17.732847001397175
Task_31177,1108,997,167,70,237,1.1102204408817635,27.649840207597915
Task_31178,1775,749,154,86,240,2.3666666666666667,37.73971776292353
Task_31179,1722,182,108,175,283,9.40983606557377,35.469377900372514
Task_31180,503,646,100,94,194,0.7774343122102009,17.228284391890735
Task_31181,1207,338,43,111,154,3.56047197640118,27.024528668630662
Task_31182,1094,291,148,72,220,3.7465753424657535,25.244311050314455
Task_31183,1308,610,88,132,220,2.1407528641571196,30.16886667051664
Task_31184,2252,425,34,23,57,5.286384976525822,42.097273812675255
Task_31185,876,638,122,17,139,1.3708920187793427,21.644134252608904
Task_31186,2589,527,74,130,204,4.903409090909091,50.22747363411855
Task_31187,2928,293,48,156,204,9.959183673469388,54.83531804561738
Task_31188,2624,727,67,200,267,3.6043956043956045,51.79516689665124
Task_31189,1971,136,94,51,145,14.386861313868613,37.48826507178777
Task_31190,2155,128,103,195,298,16.705426356589147,41.902271542550665
Task_31191,996,390,199,132,331,2.547314578005115,25.017349640439573
Task_31192,2500,376,176,105,281,6.63129973474801,48.502669973221316
Task_31193,2769,567,149,31,180,4.875,51.97520542201684
Task_31194,1793,136,120,168,288,13.087591240875913,36.23710920097541
Task_31195,1280,156,158,161,319,8.152866242038217,28.425589209387066
Task_31196,1266,296,114,177,291,4.262626262626263,28.8698833580746
Task_31197,893,80,105,68,173,11.024691358024691,20.267001991749776
Task_31198,672,726,106,155,261,0.9243466299862448,20.579737676640534
Task_31199,1005,405,22,134,156,2.4753694581280787,24.07700132123155
Task_31200,2268,402,146,191,337,5.6277915632754345,45.29673086845199
Task_31201,2417,889,173,115,288,2.715730337078652,48.87161458833555
Task_31202,2184,437,16,10,26,4.986301369863014,40.61837261242455
Task_31203,773,84,134,200,334,9.094117647058823,19.874117035494248
Task_31204,689,339,31,95,126,2.026470588235294,18.87248945017329
Task_31205,2501,776,125,43,168,3.2187902187902186,48.30553674683964
Task_31206,1434,664,196,110,306,2.156390977443609,32.66914115338452
Task_31207,1852,694,58,39,97,2.664748201438849,37.038778544139404
Task_31208,1466,245,31,34,65,5.959349593495935,29.054152459747026
Task_31209,1767,639,121,45,166,2.7609375,36.254952638591575
Task_31210,1415,680,98,35,133,2.077826725403818,30.658783430178648
Task_31211,1090,906,181,75,256,1.2017640573318633,27.319309369254523
Task_31212,1082,200,163,50,213,5.383084577114428,24.463763075374278
Task_31213,1268,605,163,189,352,2.092409240924092,30.17860879272389
Task_31214,2305,966,38,43,81,2.3836608066184075,45.07382102556562
Task_31215,2023,826,105,74,179,2.446191051995163,41.32557560987693
Task_31216,822,161,30,112,142,5.074074074074074,19.863153889866982
Task_31217,2785,315,101,79,180,8.813291139240507,51.82317578141473
Task_31218,2155,419,13,125,138,5.130952380952381,42.30359468233849
Task_31219,1925,978,25,117,142,1.9662921348314606,40.4442680800985
Task_31220,2861,218,175,145,320,13.06392694063927,53.8763449472934
Task_31221,2290,170,124,111,235,13.391812865497077,43.883978033259915
Task_31222,896,470,104,32,136,1.9023354564755839,21.758504800173473
Task_31223,859,292,15,69,84,2.931740614334471,20.468153336305935
Task_31224,1759,455,29,12,41,3.857456140350877,33.997331837228366
Task_31225,779,117,190,104,294,6.601694915254237,20.032193829625744
Task_31226,926,610,190,26,216,1.5155482815057284,23.22046637857993
Task_31227,2530,217,171,120,291,11.605504587155963,48.47830170365578
Task_31228,2745,296,146,143,289,9.242424242424242,52.19366418308647
Task_31229,2881,734,163,16,179,3.919727891156463,54.08914165629159
Task_31230,1210,454,15,178,193,2.659340659340659,28.09491855132218
Task_31231,2920,675,68,34,102,4.319526627218935,54.054582766506904
Task_31232,1834,447,15,198,213,4.09375,38.068635594408555
Task_31233,2365,236,122,74,196,9.978902953586498,45.09247106242202
Task_31234,652,287,192,177,369,2.263888888888889,19.485482704921555
Task_31235,1549,82,165,192,357,18.662650602409638,32.1089085384175
Task_31236,1688,590,164,64,228,2.856175972927242,35.58549405581541
Task_31237,2521,684,168,142,310,3.68029197080292,50.014427184218995
Task_31238,2698,353,189,154,343,7.621468926553672,51.90844130311556
Task_31239,1368,75,111,105,216,18.0,28.44498216092367
Task_31240,756,843,152,84,236,0.8957345971563981,21.810542119206286
Task_31241,524,481,58,10,68,1.0871369294605808,14.676361997132373
Task_31242,1875,108,21,197,218,17.201834862385322,36.74030463489164
Task_31243,2071,498,145,196,341,4.150300601202405,42.51562653805038
Task_31244,2101,374,146,186,332,5.602666666666667,42.532066512339824
Task_31245,1195,353,143,104,247,3.3757062146892656,27.627568870824565
Task_31246,1778,267,186,170,356,6.634328358208955,37.14779184623601
Task_31247,2857,158,191,93,284,17.968553459119498,52.94511874633424
Task_31248,1956,518,55,119,174,3.76878612716763,39.98671823202965
Task_31249,1848,407,86,54,140,4.529411764705882,36.86333803471255
Task_31250,2685,949,157,165,322,2.8263157894736843,53.532157644374955
Task_31251,1958,93,57,70,127,20.829787234042552,36.654416915324724
Task_31252,1898,638,198,25,223,2.9702660406885757,38.71009651266249
Task_31253,1107,271,15,178,193,4.069852941176471,25.876040791881888
Task_31254,795,431,14,182,196,1.8402777777777777,21.47341365547832
Task_31255,1412,803,43,58,101,1.756218905472637,30.77331770096451
Task_31256,2223,392,109,101,210,5.656488549618321,43.84737162501491
Task_31257,861,760,43,34,77,1.1314060446780552,21.216245227077593
Task_31258,2325,657,33,158,191,3.533434650455927,46.35956131864987
Task_31259,1928,683,172,43,215,2.818713450292398,39.34878489746017
Task_31260,2856,209,142,76,218,13.6,52.838614642891436
Task_31261,1771,460,59,148,207,3.841648590021692,37.125132996949226
Task_31262,1901,649,40,97,137,2.9246153846153846,39.02595444442044
Task_31263,1325,485,10,189,199,2.7263374485596708,30.016179738014227
Task_31264,1923,586,110,116,226,3.2759795570698467,39.81675562983326
Task_31265,1489,556,46,76,122,2.673249551166966,31.875566018600278
Task_31266,999,275,36,18,54,3.619565217391304,21.570973085616988
Task_31267,1375,826,186,189,375,1.6626360338573156,32.65259913548177
Task_31268,801,245,108,141,249,3.2560975609756095,21.110625337219815
Task_31269,987,98,118,24,142,9.969696969696969,21.199178523727685
Task_31270,901,851,30,75,105,1.057511737089202,23.122191477852507
Task_31271,1548,819,70,18,88,1.8878048780487804,32.45388906077577
Task_31272,770,785,27,118,145,0.9796437659033079,21.454025987104263
Task_31273,671,718,108,181,289,0.933240611961057,20.707804740344994
Task_31274,866,577,70,127,197,1.4982698961937717,23.037563205566073
Task_31275,1966,985,52,109,161,1.9939148073022313,41.30213458511085
Task_31276,2598,339,186,75,261,7.641176470588236,49.42917700448851
Task_31277,1691,310,13,36,49,5.437299035369775,32.88069850732161
Task_31278,1032,653,97,66,163,1.5779816513761469,24.957708096241593
Task_31279,1594,442,24,21,45,3.598194130925508,31.555515105781407
Task_31280,1664,390,187,83,270,4.255754475703325,34.94666546582077
Task_31281,1581,246,53,135,188,6.40080971659919,33.28591699670083
Task_31282,721,218,69,79,148,3.2922374429223744,18.83594150434908
Task_31283,1465,327,48,22,70,4.466463414634147,29.27190138270576
Task_31284,2465,378,53,13,66,6.503957783641161,45.05547612430291
Task_31285,2183,606,29,158,187,3.5963756177924218,43.886985994248555
Task_31286,1675,897,75,45,120,1.8652561247216035,35.181290394096095
Task_31287,1440,527,42,191,233,2.727272727272727,32.13735679141886
Task_31288,2601,220,191,119,310,11.76923076923077,49.69537540916451
Task_31289,1479,654,130,185,315,2.2580152671755727,33.50111753131001
Task_31290,1879,219,54,64,118,8.540909090909091,36.7747496411996
Task_31291,2841,429,18,150,168,6.6069767441860465,53.421463593368664
Task_31292,2597,521,78,158,236,4.975095785440613,50.51896143435127
Task_31293,2244,1002,152,170,322,2.23728813559322,46.716276503598486
Task_31294,2020,236,95,92,187,8.523206751054852,39.913532504649964
Task_31295,2934,657,194,196,390,4.458966565349544,56.910179408098905
Task_31296,1646,325,30,20,50,5.049079754601227,31.96837842618962
Task_31297,1709,488,158,185,343,3.494887525562372,36.74575707025227
Task_31298,2735,190,29,12,41,14.319371727748692,48.73133067913022
Task_31299,1103,251,83,178,261,4.376984126984127,26.06393063798318
Task_31300,620,371,109,90,199,1.6666666666666667,18.177726859021917
Task_31301,2610,407,48,36,84,6.397058823529412,48.12541908937623
Task_31302,2166,488,140,40,180,4.429447852760736,42.172330732681665
Task_31303,2701,451,78,74,152,5.975663716814159,50.77055681351717
Task_31304,2475,87,82,31,113,28.125,44.23816244094775
Task_31305,2307,559,147,57,204,4.119642857142857,45.12622932588724
Task_31306,2031,141,193,34,227,14.30281690140845,38.9708871577679
Task_31307,2904,624,104,40,144,4.6464,54.03083760444212
Task_31308,1343,318,197,133,330,4.210031347962382,30.271080510764005
Task_31309,2855,152,181,168,349,18.66013071895425,53.345330717797566
Task_31310,1669,303,155,23,178,5.490131578947368,33.62608937533526
Task_31311,1567,739,188,47,235,2.1175675675675674,33.90041487832709
Task_31312,2978,582,165,109,274,5.108061749571184,56.71691125939028
Task_31313,1243,861,143,52,195,1.4419953596287702,29.229673815895097
Task_31314,811,588,137,68,205,1.3769100169779287,21.56377636514463
Task_31315,1400,815,199,186,385,1.7156862745098038,33.05517639400287
Task_31316,2837,585,183,142,325,4.841296928327645,54.771921811057815
Task_31317,2627,864,27,72,99,3.036994219653179,50.405481775908015
Task_31318,521,856,200,77,277,0.6079346557759626,18.527157583086154
Task_31319,2974,505,158,129,287,5.877470355731226,56.492447633374034
Task_31320,1940,254,62,147,209,7.607843137254902,39.093985793658035
Task_31321,801,847,188,153,341,0.9445754716981132,23.362037199992585
Task_31322,551,942,137,154,291,0.584305408271474,19.607061011902946
Task_31323,1352,384,134,63,197,3.5116883116883115,29.46464999150075
Task_31324,1833,574,116,191,307,3.187826086956522,38.828603648213985
Task_31325,1271,520,148,76,224,2.439539347408829,28.855339282404653
Task_31326,2573,980,152,26,178,2.6228338430173292,50.11216832350448
Task_31327,2894,1006,194,37,231,2.8738828202581925,55.7600937787657
Task_31328,1268,912,162,22,184,1.388828039430449,29.212384901120043
Task_31329,1078,774,43,121,164,1.3909677419354838,26.52484355939671
Task_31330,2504,893,108,180,288,2.80089485458613,50.35792003762439
Task_31331,1987,1019,123,79,202,1.9480392156862745,41.72931020634899
Task_31332,929,352,27,169,196,2.631728045325779,23.323092086685023
Task_31333,841,579,126,163,289,1.45,22.9449652021251
Task_31334,1416,949,28,108,136,1.4905263157894737,32.21232673113034
Task_31335,1271,1019,48,103,151,1.246078431372549,30.07086111441968
Task_31336,1312,800,15,77,92,1.637952559300874,29.452125277907772
Task_31337,606,957,71,79,150,0.6325678496868476,19.48295969192838
Task_31338,724,500,173,101,274,1.4451097804391217,20.687646888855593
Task_31339,2622,323,194,165,359,8.092592592592593,50.69142792076027
Task_31340,2617,558,23,124,147,4.6815742397137745,50.17210107959227
Task_31341,2478,223,155,92,247,11.0625,47.34037413339923
Task_31342,1172,838,110,182,292,1.396901072705602,29.03425135029231
Task_31343,2440,821,93,180,273,2.9683698296836982,49.16298597465058
Task_31344,1722,754,91,114,205,2.280794701986755,37.1123598333782
Task_31345,1628,614,146,176,322,2.6471544715447153,35.75388282222946
Task_31346,1278,549,127,55,182,2.3236363636363637,28.58840912678268
Task_31347,1023,462,64,73,137,2.2095032397408207,24.25668065767338
Task_31348,2627,932,70,99,169,2.8156484458735265,51.714023285149864
Task_31349,1170,483,94,11,105,2.4173553719008263,25.751339565889456
Task_31350,2263,910,145,199,344,2.4840834248079036,46.87251014291163
Task_31351,2063,380,28,79,107,5.414698162729659,40.22377340108862
Task_31352,2903,164,116,52,168,17.593939393939394,52.62913601691895
Task_31353,2472,855,107,170,277,2.8878504672897196,49.66783905739472
Task_31354,2659,290,183,43,226,9.137457044673539,49.685918010021304
Task_31355,2042,287,152,105,257,7.090277777777778,40.84841067545055
Task_31356,2581,422,28,118,146,6.101654846335697,49.0919055358734
Task_31357,1396,594,29,89,118,2.346218487394958,30.613466213702264
Task_31358,2085,581,39,132,171,3.582474226804124,41.95607011593205
Task_31359,575,513,120,126,246,1.1186770428015564,18.189009599136682
Task_31360,2999,735,198,153,351,4.074728260869565,57.94838384162898
Task_31361,2075,479,168,104,272,4.322916666666667,42.07207636450875
Task_31362,2386,886,72,11,83,2.689966178128523,45.998578522611986
Task_31363,1482,177,73,45,118,8.325842696629213,29.452883071450554
Task_31364,1984,814,147,120,267,2.434355828220859,41.68948788417309
Task_31365,1146,485,140,51,191,2.3580246913580245,26.475775014077524
Task_31366,654,533,184,89,273,1.2247191011235956,19.417457117183403
Task_31367,614,138,61,141,202,4.41726618705036,17.313198134744546
Task_31368,2989,692,200,115,315,4.313131313131313,57.4358003863887
Task_31369,1626,193,149,21,170,8.381443298969073,32.52916599141687
Task_31370,2294,737,142,157,299,3.1084010840108403,46.557990757291805
Task_31371,2736,928,100,198,298,2.945102260495156,54.214909739704886
Task_31372,1996,86,125,23,148,22.942528735632184,36.93559179257478
Task_31373,1809,635,172,39,211,2.8443396226415096,37.26516123695428
Task_31374,1173,958,71,92,163,1.2231491136600625,28.498000146929495
Task_31375,978,805,44,94,138,1.2133995037220844,24.623706719968073
Task_31376,2306,634,160,28,188,3.631496062992126,44.99153148511948
Task_31377,847,600,177,14,191,1.4093178036605658,21.647784384256102
Task_31378,2514,630,28,129,157,3.9841521394611727,48.75082433805918
Task_31379,1170,412,141,109,250,2.8329297820823243,27.441846604047033
Task_31380,1054,404,25,56,81,2.602469135802469,23.756576837656908
Task_31381,1462,158,182,40,222,9.19496855345912,30.06203632496165
Task_31382,553,800,159,145,304,0.6903870162297129,19.232002699300057
Task_31383,2066,331,151,162,313,6.22289156626506,41.71404484500572
Task_31384,2550,139,91,188,279,18.214285714285715,48.17210311437183
Task_31385,1393,808,115,108,223,1.7218788627935724,32.07802656854553
Task_31386,1654,393,92,25,117,4.197969543147208,33.32309871490359
Task_31387,1264,198,175,109,284,6.351758793969849,28.419546372664552
Task_31388,2295,706,63,97,160,3.246110325318246,45.624169244537576
Task_31389,1528,634,153,154,307,2.4062992125984253,34.133050653047896
Task_31390,2368,987,118,76,194,2.396761133603239,47.556522984895885
Task_31391,2841,222,69,58,127,12.739910313901346,51.89803959219574
Task_31392,1760,162,115,85,200,10.797546012269938,35.17265403733029
Task_31393,2383,1010,153,38,191,2.3570722057368942,47.509312880877225
Task_31394,659,145,122,64,186,4.513698630136986,17.28866150813754
Task_31395,1504,323,193,190,383,4.6419753086419755,33.15599400005828
Task_31396,2795,189,12,163,175,14.710526315789474,51.99106514002841
Task_31397,1797,538,196,68,264,3.333951762523191,37.32975961343436
Task_31398,2253,116,139,35,174,19.256410256410255,41.86503639350574
Task_31399,1781,182,80,140,220,9.73224043715847,36.195970799884144
Task_31400,1745,765,119,137,256,2.2780678851174936,37.725392291907525
Task_31401,563,667,22,179,201,0.842814371257485,18.306194969937742
Task_31402,2866,350,74,70,144,8.165242165242166,52.989787818598415
Task_31403,2032,991,118,45,163,2.0483870967741935,41.53300880703564
Task_31404,2129,860,142,71,213,2.472706155632985,43.37943413532535
Task_31405,1347,858,45,128,173,1.568102444703143,31.2113755740035
Task_31406,740,159,79,159,238,4.625,19.693906726000332
Task_31407,1841,795,180,178,358,2.312814070351759,39.85975701255267
Task_31408,989,371,32,128,160,2.6586021505376345,23.796904972644114
Task_31409,2603,232,143,143,286,11.17167381974249,49.700426390228074
Task_31410,2759,180,111,27,138,15.243093922651934,49.86205007641362
Task_31411,2540,692,40,22,62,3.665223665223665,47.42789442467322
Task_31412,2740,1016,93,104,197,2.6941986234021633,54.071898534031796
Task_31413,2847,194,77,109,186,14.6,52.80566908433817
Task_31414,1054,196,89,97,186,5.350253807106599,24.498572218873523
Task_31415,1922,339,107,185,292,5.652941176470589,39.40244998434186
Task_31416,628,921,112,69,181,0.6811279826464208,19.604824100455957
Task_31417,2007,934,54,101,155,2.146524064171123,41.73233249852583
Task_31418,904,556,70,73,143,1.622980251346499,22.68283462793906
Task_31419,2932,397,140,152,292,7.366834170854271,55.526866007485786
Task_31420,2142,557,153,180,333,3.838709677419355,43.76872889611201
Task_31421,2707,771,82,43,125,3.506476683937824,51.2366273981091
Task_31422,1819,320,150,179,329,5.666666666666667,37.867901176288875
Task_31423,2341,260,30,103,133,8.969348659003831,44.71621399574966
Task_31424,978,404,127,56,183,2.414814814814815,23.38817698988322
Task_31425,669,362,46,142,188,1.8429752066115703,19.122347704106723
Task_31426,2586,367,16,119,135,7.0271739130434785,48.867313099300226
Task_31427,1731,973,130,148,278,1.7772073921971252,38.25274360634318
Task_31428,1909,310,179,199,378,6.138263665594855,39.507535499475104
Task_31429,2150,150,54,148,202,14.23841059602649,41.66757295574643
Task_31430,2232,945,15,200,215,2.3594080338266386,45.952837197912636
Task_31431,1796,290,188,121,309,6.171821305841925,37.22767752580806
Task_31432,1141,859,138,45,183,1.3267441860465117,27.08912566091755
Task_31433,2549,207,77,129,206,12.254807692307692,48.4947177830183
Task_31434,2619,303,116,21,137,8.615131578947368,48.361116928908196
Task_31435,2246,202,27,108,135,11.064039408866995,42.96454722614423
Task_31436,1020,276,45,91,136,3.6823104693140793,23.755214439159303
Task_31437,1627,367,54,42,96,4.421195652173913,32.47065646161416
Task_31438,2165,697,79,184,263,3.1017191977077365,44.39681973367237
Task_31439,857,142,147,51,198,5.993006993006993,20.54304293121322
Task_31440,1678,422,43,71,114,3.966903073286052,34.3608443423386
Task_31441,1973,932,158,97,255,2.114683815648446,41.828736728160976
Task_31442,1375,665,158,183,341,2.0645645645645647,32.002516712253886
Task_31443,1474,333,70,60,130,4.413173652694611,30.7724102217401
Task_31444,978,650,75,140,215,1.5023041474654377,25.134449577555387
Task_31445,1132,679,101,148,249,1.6647058823529413,27.717831923162304
Task_31446,2214,440,52,56,108,5.020408163265306,42.49980864048489
Task_31447,1939,999,53,85,138,1.939,40.611330389312826
Task_31448,2835,590,126,62,188,4.7969543147208125,53.48260868109969
Task_31449,1578,760,140,188,328,2.073587385019711,35.463421230455005
Task_31450,1976,767,60,83,143,2.5729166666666665,40.42475738342045
Task_31451,1795,974,112,18,130,1.841025641025641,37.289175770326956
Task_31452,2782,520,127,176,303,5.339731285988484,53.64240361433665
Task_31453,1392,963,85,70,155,1.4439834024896265,31.428447683932987
Task_31454,1187,228,21,179,200,5.183406113537118,26.96634306809247
Task_31455,778,756,198,186,384,1.0277410832232496,22.8987058103249
Task_31456,857,677,61,74,135,1.2640117994100295,22.32285232133926
Task_31457,2372,706,117,156,273,3.355021216407355,47.57741600317369
Task_31458,1204,207,156,164,320,5.788461538461538,27.70030254802786
Task_31459,2871,169,38,23,61,16.888235294117646,50.937473418905284
Task_31460,688,253,177,84,261,2.7086614173228347,19.02817139301578
Task_31461,921,477,80,147,227,1.9267782426778242,23.785518717738373
Task_31462,1036,356,195,150,345,2.9019607843137254,25.631197154295947
Task_31463,1945,966,45,48,93,2.0113753877973113,39.48446074830654
Task_31464,2344,225,20,172,192,10.371681415929203,45.18233938669058
Task_31465,924,621,171,100,271,1.4855305466237942,24.242319110513506
Task_31466,1577,287,140,111,251,5.475694444444445,33.47939544984186
Task_31467,1339,414,55,78,133,3.2265060240963854,29.319555341288474
Task_31468,2812,181,182,158,340,15.45054945054945,52.70024768527347
Task_31469,1481,367,28,33,61,4.024456521739131,29.65624109170201
Task_31470,1724,630,191,39,230,2.7321711568938194,35.98884873409303
Task_31471,812,717,138,200,338,1.1309192200557103,23.16855367565712
Task_31472,1700,196,115,21,136,8.629441624365482,33.42776411112851
Task_31473,1192,594,98,79,177,2.003361344537815,27.521544858744154
Task_31474,2135,101,13,96,109,20.931372549019606,39.750558959897354
Task_31475,745,371,88,182,270,2.002688172043011,20.80391930268588
Task_31476,1017,295,49,160,209,3.435810810810811,24.69629059905076
Task_31477,1892,376,146,66,212,5.018567639257294,38.052603209604854
Task_31478,1042,744,56,72,128,1.3986577181208053,25.561773830977927
Task_31479,2069,220,106,44,150,9.361990950226245,39.44920349417849
Task_31480,1619,473,181,83,264,3.4156118143459917,34.474286962989034
Task_31481,971,684,130,79,209,1.4175182481751825,24.5587265866086
Task_31482,2912,938,67,42,109,3.101171458998935,54.8333129206352
Task_31483,1725,341,61,101,162,5.043859649122807,35.43149455461917
Task_31484,2657,240,166,29,195,11.024896265560166,49.34988236620908
Task_31485,2745,795,135,63,198,3.448492462311558,52.83099700528506
Task_31486,1859,102,25,71,96,18.04854368932039,34.97516450291133
Task_31487,2210,357,166,81,247,6.173184357541899,43.33968032152836
Task_31488,1665,100,100,41,141,16.485148514851485,31.940042030333995
Task_31489,2972,78,86,16,102,37.620253164556964,51.62296086991012
Task_31490,592,226,199,199,398,2.607929515418502,18.503652860385387
Task_31491,2443,957,126,90,216,2.5501043841336117,48.969829014359505
Task_31492,1592,648,175,125,300,2.453004622496148,35.11652826878305
Task_31493,1978,788,155,130,285,2.5069708491761724,41.60899287511274
Task_31494,1822,674,52,91,143,2.6992592592592595,37.86899658853286
Task_31495,1047,250,138,129,267,4.171314741035856,25.07737121709801
Task_31496,2399,287,124,72,196,8.32986111111111,45.7525957534911
Task_31497,526,558,72,180,252,0.9409660107334525,17.816468444801806
Task_31498,2875,362,162,99,261,7.920110192837465,54.27412732286706
Task_31499,1787,261,140,106,246,6.820610687022901,36.679576423735185
Task_31500,1062,606,77,106,183,1.7495881383855025,25.96613669552327
Task_31501,1341,384,144,36,180,3.483116883116883,28.784309133020695
Task_31502,2989,799,50,87,137,3.73625,56.70938664624066
Task_31503,2220,244,162,113,275,9.061224489795919,43.60156320710512
Task_31504,2584,763,113,79,192,3.3821989528795813,50.34245698744005
Task_31505,2940,319,145,126,271,9.1875,55.25245703430014
Task_31506,1502,990,82,53,135,1.515640766902119,33.29240674611146
Task_31507,2827,924,72,108,180,3.056216216216216,54.92583828799522
Task_31508,850,885,161,99,260,0.9593679458239278,23.798019149632694
Task_31509,1229,792,162,74,236,1.549810844892812,29.06648410960717
Task_31510,1409,307,89,90,179,4.574675324675325,30.211431858012105
Task_31511,2697,446,147,44,191,6.033557046979865,50.64989326721824
Task_31512,1947,1019,117,139,256,1.9088235294117648,41.719577773620095
Task_31513,2941,692,38,113,151,4.243867243867244,55.613779574204415
Task_31514,1515,191,139,55,194,7.890625,31.490429652714287
Task_31515,1497,1014,13,23,36,1.4748768472906404,31.74138179305888
Task_31516,1266,212,84,122,206,5.943661971830986,28.16867283911363
Task_31517,1408,497,163,138,301,2.8273092369477912,31.751058203749434
Task_31518,1646,801,168,147,315,2.052369077306733,36.54982288469882
Task_31519,1305,834,125,55,180,1.562874251497006,29.883108321665713
Task_31520,2015,88,159,63,222,22.640449438202246,38.272199732820546
Task_31521,1281,715,112,95,207,1.7891061452513966,29.908443481391416
Task_31522,1667,902,97,16,113,1.8460686600221483,34.97630127771898
Task_31523,570,128,19,16,35,4.4186046511627906,13.90843408504135
Task_31524,1460,195,182,84,266,7.448979591836735,30.997721651330266
Task_31525,2610,198,164,110,274,13.115577889447236,49.6207397672322
Task_31526,1233,974,123,73,196,1.2646153846153847,29.44927434020548
Task_31527,1244,135,124,183,307,9.147058823529411,27.637928254799718
Task_31528,2517,997,152,14,166,2.5220440881763526,49.12029019849851
Task_31529,967,751,44,36,80,1.2859042553191489,23.119572939548664
Task_31530,1052,887,41,162,203,1.1846846846846846,26.792833209728983
Task_31531,1359,562,148,62,210,2.413854351687389,30.16597277749752
Task_31532,2033,343,177,112,289,5.909883720930233,41.05094220524813
Task_31533,1506,359,53,177,230,4.183333333333334,32.76681699484353
Task_31534,2578,1023,157,109,266,2.517578125,51.732797969325986
Task_31535,1608,165,85,49,134,9.686746987951807,31.648748013271277
Task_31536,845,302,94,29,123,2.788778877887789,20.445845785543955
Task_31537,1108,373,168,170,338,2.962566844919786,26.822413415990848
Task_31538,1908,113,41,195,236,16.736842105263158,37.52672082950995
Task_31539,677,80,67,152,219,8.358024691358025,17.846167318077008
Task_31540,1982,721,186,168,354,2.7451523545706373,41.8293316061821
Task_31541,1565,209,69,30,99,7.4523809523809526,31.080901992124552
Task_31542,2310,866,171,148,319,2.6643598615916955,47.29246550648014
Task_31543,2916,498,115,80,195,5.843687374749499,54.77773507332741
Task_31544,2092,238,166,55,221,8.753138075313808,40.803235826353635
Task_31545,2898,169,132,59,191,17.04705882352941,52.91177638588439
Task_31546,1129,478,106,153,259,2.356993736951983,27.107008083727248
Task_31547,564,811,40,169,209,0.6945812807881774,18.985411347743632
Task_31548,2449,910,187,89,276,2.6882546652030737,49.16454284126761
Task_31549,2286,327,194,194,388,6.969512195121951,45.564736557886626
Task_31550,557,630,47,176,223,0.8827258320126783,18.28369937348432
Task_31551,1648,1006,166,41,207,1.6365441906653426,35.885014778975204
Task_31552,2145,867,50,82,132,2.4711981566820276,43.586883694736834
Task_31553,2724,579,158,105,263,4.696551724137931,52.62957851080231
Task_31554,2949,638,84,80,164,4.615023474178404,55.5588268488676
Task_31555,754,353,152,109,261,2.1299435028248586,20.72212869703714
Task_31556,2289,131,109,110,219,17.34090909090909,43.55972261974736
Task_31557,1816,603,52,82,134,3.006622516556291,37.47488193119304
Task_31558,2688,163,12,70,82,16.390243902439025,48.58295935240083
Task_31559,1277,972,200,109,309,1.3124357656731758,31.09866387857421
Task_31560,1353,445,122,169,291,3.0336322869955157,30.715806910292297
Task_31561,2411,183,43,177,220,13.103260869565217,46.102894856201004
Task_31562,2830,905,23,97,120,3.123620309050773,54.48487799264129
Task_31563,1393,917,111,133,244,1.5174291938997821,32.51846923431053
Task_31564,2960,449,137,53,190,6.5777777777777775,55.11982083067818
Task_31565,2932,719,109,12,121,4.072222222222222,54.45410014090914
Task_31566,961,291,51,65,116,3.291095890410959,22.59350471538652
Task_31567,2302,309,133,104,237,7.425806451612903,44.94350102624225
Task_31568,1264,441,157,112,269,2.8597285067873304,29.1117447981857
Task_31569,1594,91,76,127,203,17.32608695652174,32.23752109603442
Task_31570,2541,310,29,126,155,8.170418006430868,48.115657750352376
Task_31571,1030,262,57,158,215,3.9163498098859315,24.815444408629702
Task_31572,2725,423,83,58,141,6.42688679245283,50.77797078116847
Task_31573,2422,849,64,166,230,2.8494117647058825,48.76714481269439
Task_31574,1150,539,61,122,183,2.1296296296296298,27.188982480484118
Task_31575,1311,338,19,64,83,3.8672566371681416,27.677152708766197
Task_31576,1913,85,60,110,170,22.24418604651163,36.8148166372415
Task_31577,2207,570,56,129,185,3.865148861646235,44.12630574351823
Task_31578,1425,106,147,155,302,13.317757009345794,30.00472210951824
Task_31579,2351,717,150,158,308,3.2743732590529246,47.44007644988195
Task_31580,2665,210,84,57,141,12.630331753554502,49.0529740895837
Task_31581,1329,680,138,82,220,1.9515418502202644,30.344021838658577
Task_31582,1587,131,193,17,210,12.022727272727273,31.638264035522326
Task_31583,1505,381,36,65,101,3.93979057591623,31.150660602971485
Task_31584,2195,761,80,144,224,2.8805774278215224,44.835177680685945
Task_31585,2612,150,24,129,153,17.29801324503311,48.06165671684719
Task_31586,1355,74,107,84,191,18.066666666666666,27.92352962156843
Task_31587,648,956,66,39,105,0.677115987460815,19.246405004878486
Task_31588,2022,798,169,98,267,2.530663329161452,42.212591980025465
Task_31589,1083,725,30,85,115,1.4917355371900827,25.972726794957463
Task_31590,2155,491,96,165,261,4.380081300813008,43.469796524268965
Task_31591,2268,147,167,190,357,15.324324324324325,44.13246362900028
Task_31592,791,502,105,117,222,1.5725646123260437,21.569297511051293
Task_31593,1361,530,111,103,214,2.5630885122410545,30.667735998599948
Task_31594,2892,422,190,169,359,6.836879432624113,55.30447859747744
Task_31595,2582,93,172,86,258,27.46808510638298,47.616516882987206
Task_31596,2849,979,100,53,153,2.907142857142857,54.5879960524207
Task_31597,507,83,25,193,218,6.035714285714286,15.237095909111906
Task_31598,727,442,64,167,231,1.6410835214446953,20.639615712616518
Task_31599,2710,825,125,130,255,3.280871670702179,53.18693650977334
Task_31600,2668,896,51,45,96,2.9743589743589745,50.64398953243651
Task_31601,574,339,159,112,271,1.688235294117647,17.86677027437242
Task_31602,2616,108,152,48,200,24.0,47.567130181636976
Task_31603,2666,394,130,164,294,6.749367088607595,51.334468937549275
Task_31604,1470,134,134,78,212,10.88888888888889,30.339669992495143
Task_31605,1201,452,26,132,158,2.65121412803532,27.405468438774438
Task_31606,2034,215,194,78,272,9.416666666666666,40.19370244987818
Task_31607,1737,974,67,118,185,1.7815384615384615,37.88007241265773
Task_31608,1139,317,110,66,176,3.5817610062893084,25.603688596081184
Task_31609,1456,151,83,95,178,9.578947368421053,30.176222134491198
Task_31610,1668,495,169,152,321,3.3629032258064515,35.97145935679042
Task_31611,2515,139,157,106,263,17.964285714285715,47.41002539270428
Task_31612,1777,1007,82,146,228,1.7628968253968254,38.95135382243867
Task_31613,1312,127,14,163,177,10.25,27.809094239970037
Task_31614,1490,414,85,33,118,3.5903614457831323,30.752186248721245
Task_31615,2110,716,152,102,254,2.9428172942817294,43.29382117689025
Task_31616,500,987,119,116,235,0.5060728744939271,18.585850429816453
Task_31617,1936,516,130,24,154,3.74468085106383,38.314665250390554
Task_31618,2978,360,134,190,324,8.249307479224377,56.328798619583175
Task_31619,2852,1021,108,97,205,2.7906066536203524,55.80983171617128
Task_31620,2823,297,129,141,270,9.473154362416107,53.34183704798075
Task_31621,2675,756,107,100,207,3.533685601056803,52.15523797292095
Task_31622,1439,806,82,116,198,1.7831474597273853,32.792066872822794
Task_31623,1003,797,168,73,241,1.2568922305764412,25.442168491849404
Task_31624,1721,294,199,49,248,5.8338983050847455,35.05102331262977
Task_31625,1439,996,178,33,211,1.4433299899699097,32.564980276302016
Task_31626,2164,818,152,144,296,2.642246642246642,44.719701981053504
Task_31627,758,625,20,116,136,1.2108626198083068,20.601037353013567
Task_31628,739,220,150,174,324,3.3438914027149322,20.435269995127634
Task_31629,1338,247,164,43,207,5.395161290322581,28.572238693781582
Task_31630,2369,799,44,110,154,2.96125,46.88281348179769
Task_31631,2090,492,123,35,158,4.239350912778905,40.7902282224074
Task_31632,1211,480,173,177,350,2.5176715176715176,28.856701110564245
Task_31633,2791,866,122,23,145,3.2191464821222606,53.04776493996142
Task_31634,2165,114,95,59,154,18.82608695652174,40.29470192592592
Task_31635,2194,501,27,26,53,4.370517928286852,41.46785224470339
Task_31636,2471,845,158,91,249,2.92080378250591,49.23257440166109
Task_31637,1466,137,151,193,344,10.623188405797102,31.380902227118757
Task_31638,1538,664,122,111,233,2.312781954887218,33.98885719669527
Task_31639,1609,145,83,52,135,11.020547945205479,31.837157697749433
Task_31640,2643,654,35,173,208,4.035114503816794,51.46699819529195
Task_31641,1244,442,171,78,249,2.8081264108352144,28.360621744234688
Task_31642,1517,995,170,115,285,1.5230923694779117,34.88365120347026
Task_31643,2253,766,144,67,211,2.9374185136897,45.029994307609535
Task_31644,1330,793,56,67,123,1.6750629722921915,30.063491551296877
Task_31645,2615,448,182,183,365,5.8240534521158125,51.05396341724107
Task_31646,1567,473,79,110,189,3.3059071729957807,33.74990533962319
Task_31647,946,104,31,15,46,9.00952380952381,19.741508312760885
Task_31648,1859,136,34,167,201,13.569343065693431,36.893634837951474
Task_31649,632,660,109,93,202,0.9561270801815431,19.326806559663908
Task_31650,1359,689,176,67,243,1.9695652173913043,30.771332052608216
Task_31651,685,959,39,95,134,0.7135416666666666,20.651636693582155
Task_31652,1858,875,107,107,214,2.1210045662100456,39.6253823758114
Task_31653,2899,459,105,31,136,6.302173913043478,53.42706853688838
Task_31654,1458,278,189,28,217,5.225806451612903,30.591111244868575
Task_31655,714,447,112,175,287,1.59375,20.585657508845376
Task_31656,2325,993,172,54,226,2.339034205231388,46.913254903723754
Task_31657,1663,673,86,122,208,2.4673590504451037,35.942441468006905
Task_31658,1103,674,46,174,220,1.634074074074074,27.184630065805596
Task_31659,2670,287,74,111,185,9.270833333333334,50.46206641544467
Task_31660,1502,177,171,50,221,8.438202247191011,30.762162707884688
Task_31661,525,694,195,111,306,0.7553956834532374,18.27662260418484
Task_31662,2565,514,30,191,221,4.980582524271845,49.880752543637236
Task_31663,1342,938,157,106,263,1.4291799787007455,31.7958825784538
Task_31664,1158,926,117,23,140,1.249190938511327,27.222217697815342
Task_31665,2331,148,168,151,319,15.644295302013424,44.917883162387376
Task_31666,2821,705,95,120,215,3.9957507082152977,54.44258847516489
Task_31667,2339,228,49,137,186,10.213973799126638,45.08678590926862
Task_31668,1631,212,10,160,170,7.657276995305164,33.59517911070855
Task_31669,1219,994,199,60,259,1.2251256281407035,29.437018554089693
Task_31670,1991,320,46,134,180,6.202492211838006,39.70289971964579
Task_31671,2670,184,183,128,311,14.432432432432432,50.50416086508989
Task_31672,730,989,179,144,323,0.7373737373737373,22.545350668071492
Task_31673,2962,755,194,123,317,3.917989417989418,57.22822049663307
Task_31674,1794,465,182,122,304,3.8497854077253217,37.749642829720365
Task_31675,1561,437,116,69,185,3.5639269406392695,32.737367797979275
Task_31676,2839,557,102,128,230,5.087813620071684,54.264960009181415
Task_31677,1504,926,39,154,193,1.622437971952535,34.14790173224754
Task_31678,947,317,195,116,311,2.9779874213836477,23.89519069338419
Task_31679,2529,87,171,51,222,28.738636363636363,46.13351811217921
Task_31680,821,355,34,18,52,2.306179775280899,19.026242652370225
Task_31681,884,463,16,178,194,1.9051724137931034,22.888551913739164
Task_31682,783,788,103,10,113,0.9923954372623575,20.777918523001702
Task_31683,1470,214,29,174,203,6.837209302325581,31.45310759646611
Task_31684,2078,692,68,46,114,2.9985569985569986,40.974391496199786
Task_31685,2898,347,141,158,299,8.327586206896552,54.858978317337744
Task_31686,529,307,127,136,263,1.7175324675324675,17.053195410816272
Task_31687,1856,101,89,117,206,18.19607843137255,36.263563138279686
Task_31688,1349,726,59,77,136,1.8555708390646493,30.340175285528915
Task_31689,2239,634,89,122,211,3.525984251968504,44.954067438032894
Task_31690,2967,179,59,197,256,16.483333333333334,54.88642346948723
Task_31691,1759,646,61,34,95,2.7187017001545595,35.390046698591064
Task_31692,1610,363,108,113,221,4.423076923076923,34.12089267276569
Task_31693,1951,99,109,97,206,19.51,37.74323557612059
Task_31694,2464,147,77,195,272,16.64864864864865,46.975633258829475
Task_31695,1291,363,23,163,186,3.5467032967032965,28.959880266363104
Task_31696,664,251,94,118,212,2.634920634920635,18.848971131847847
Task_31697,906,954,14,22,36,0.9486910994764398,22.3560510077513
Task_31698,1084,142,48,134,182,7.580419580419581,24.47419829859197
Task_31699,2719,774,121,184,305,3.5083870967741935,53.47378407905311
Task_31700,2272,442,181,163,344,5.128668171557562,45.48156208149536
Task_31701,1190,91,130,65,195,12.934782608695652,25.250792077138428
Task_31702,2266,406,75,116,191,5.5675675675675675,44.64633997457533
Task_31703,1781,555,50,174,224,3.2032374100719423,37.73553565478534
Task_31704,1916,832,122,84,206,2.300120048019208,40.04687537080289
Task_31705,2063,870,90,143,233,2.3685419058553387,43.04564284868828
Task_31706,2766,517,84,73,157,5.33976833976834,51.93181552135946
Task_31707,2529,470,37,150,187,5.369426751592357,48.89664346870046
Task_31708,1055,390,46,59,105,2.6982097186700766,23.827893164434936
Task_31709,921,232,102,200,302,3.9527896995708156,23.288570813767777
Task_31710,2363,747,70,17,87,3.159090909090909,45.12708940085941
Task_31711,1683,700,29,176,205,2.4008559201141226,36.408333104721756
Task_31712,2467,228,61,185,246,10.77292576419214,47.54633830472767
Task_31713,2880,822,104,70,174,3.4993924665856624,54.887953828375714
Task_31714,2049,1012,15,17,32,2.0227048371174727,40.278065873501205
Task_31715,2316,965,128,172,300,2.3975155279503104,47.645858693086815
Task_31716,503,156,126,46,172,3.2038216560509554,14.61098664276703
Task_31717,1933,948,139,53,192,2.0368809272918864,40.45517945836672
Task_31718,2644,554,192,52,244,4.763963963963964,50.70706100503878
Task_31719,2895,406,94,104,198,7.113022113022113,54.561381070964664
Task_31720,1398,487,84,76,160,2.8647540983606556,30.234207913530593
Task_31721,2827,314,167,176,343,8.974603174603175,53.84574229011281
Task_31722,2103,962,90,14,104,2.1838006230529596,41.89535327099116
Task_31723,1455,664,26,55,81,2.18796992481203,30.927925356818225
Task_31724,2426,937,57,98,155,2.5863539445629,48.38413867302279
Task_31725,1554,615,153,185,338,2.522727272727273,34.67037831014288
Task_31726,958,479,190,92,282,1.9958333333333333,24.316769202206277
Task_31727,962,1014,154,29,183,0.9477832512315271,24.863461779478673
Task_31728,2560,219,179,190,369,11.636363636363637,49.414013974068745
Task_31729,1136,429,182,37,219,2.641860465116279,26.048383273284184
Task_31730,1623,535,112,92,204,3.0279850746268657,34.66993507963433
Task_31731,623,471,83,84,167,1.319915254237288,18.115308492568428
Task_31732,929,650,17,13,30,1.4270353302611367,21.366739418150903
Task_31733,610,633,12,183,195,0.9621451104100947,18.995126458703872
Task_31734,1048,795,175,63,238,1.3165829145728642,26.111333100984357
Task_31735,1703,797,161,74,235,2.1340852130325816,36.615922754389395
Task_31736,709,845,142,74,216,0.8380614657210402,20.925819635737074
Task_31737,1366,669,16,152,168,2.038805970149254,30.825982190828938
Task_31738,2429,1017,12,49,61,2.3860510805500983,46.82835725518927
Task_31739,2612,122,170,48,218,21.235772357723576,47.86322067940577
Task_31740,2269,806,53,131,184,2.811648079306072,45.81787430292769
Task_31741,1252,546,190,96,286,2.2888482632541134,29.330064161273896
Task_31742,2943,347,94,111,205,8.456896551724139,55.161995613646006
Task_31743,1827,483,181,110,291,3.774793388429752,38.25347018479933
Task_31744,691,745,69,46,115,0.9262734584450402,19.25479725868802
Task_31745,612,83,42,59,101,7.285714285714286,15.251582199442689
Task_31746,756,939,31,85,116,0.8042553191489362,21.3177303096006
Task_31747,894,236,103,93,196,3.7721518987341773,22.175485430331207
Task_31748,1502,842,148,23,171,1.7817319098457889,32.627943612632166
Task_31749,656,472,135,72,207,1.386892177589852,18.787673282480416
Task_31750,756,1010,120,116,236,0.7477744807121661,22.5793313522052
Task_31751,1078,119,87,190,277,8.983333333333333,24.804608051686944
Task_31752,2204,338,76,61,137,6.501474926253687,42.356472353474395
Task_31753,834,86,155,133,288,9.586206896551724,20.534609016636058
Task_31754,2229,789,96,107,203,2.821518987341772,45.23822773216282
Task_31755,942,78,138,150,288,11.924050632911392,22.17049453826336
Task_31756,975,603,78,53,131,1.6142384105960266,23.840798754157674
Task_31757,614,406,57,79,136,1.5085995085995085,17.754952170159797
Task_31758,2972,309,56,196,252,9.587096774193549,55.898675786387486
Task_31759,861,238,125,146,271,3.602510460251046,22.141894482187283
Task_31760,2622,614,82,64,146,4.263414634146342,49.953456715743044
Task_31761,2331,995,104,151,255,2.3403614457831323,47.74336127693801
Task_31762,538,408,76,33,109,1.315403422982885,15.665714785109968
Task_31763,1804,240,64,176,240,7.485477178423237,37.077749414423025
Task_31764,622,518,150,167,317,1.1984585741811176,19.40575194075788
Task_31765,502,120,39,171,210,4.148760330578512,15.424484576114745
Task_31766,2628,216,23,87,110,12.110599078341014,48.75434067315019
Task_31767,1874,649,102,72,174,2.883076923076923,38.43912990523311
Task_31768,2891,800,62,86,148,3.6092384519350813,55.07524690851732
Task_31769,1816,204,80,165,245,8.858536585365854,37.14148249096013
Task_31770,2293,389,157,45,202,5.87948717948718,44.089172406184936
Task_31771,2923,812,71,13,84,3.5953259532595325,54.27576260840136
Task_31772,2571,164,136,174,310,15.581818181818182,48.77811741780119
Task_31773,1117,1001,192,42,234,1.1147704590818364,27.514086659037602
Task_31774,2476,114,57,165,222,21.530434782608694,46.503740991064355
Task_31775,755,552,158,175,333,1.3652802893309222,21.72193859121981
Task_31776,1481,210,120,182,302,7.018957345971564,32.029402133844314
Task_31777,2652,195,29,199,228,13.53061224489796,50.13429276143
Task_31778,582,425,124,196,320,1.3661971830985915,18.55927650374529
Task_31779,1223,902,77,70,147,1.35437430786268,28.717087466461546
Task_31780,2568,835,56,84,140,3.0717703349282295,50.046291936798575
Task_31781,1899,315,178,190,368,6.0094936708860756,39.30804861713589
Task_31782,2560,166,137,75,212,15.32934131736527,47.682990242167385
Task_31783,730,602,23,20,43,1.2106135986733002,18.306168230383104
Task_31784,1418,824,21,190,211,1.7187878787878788,32.570427094228975
Task_31785,2193,417,115,180,295,5.246411483253588,43.95373742453768
Task_31786,2215,434,165,151,316,5.091954022988506,44.4095699917713
Task_31787,950,477,91,62,153,1.9874476987447698,22.878774206355583
Task_31788,741,122,120,122,242,6.024390243902439,19.275104359353776
Task_31789,1538,764,92,20,112,2.0104575163398692,32.46453907678479
Task_31790,2739,815,31,11,42,3.3566176470588234,50.68159308698545
Task_31791,1262,627,75,164,239,2.0095541401273884,29.74250905387029
Task_31792,2868,232,196,73,269,12.30901287553648,53.30005603845617
Task_31793,1264,861,71,51,122,1.4663573085846868,28.89497467804135
Task_31794,1155,451,65,28,93,2.5553097345132745,25.304412526556558
Task_31795,1243,297,41,78,119,4.171140939597316,27.150044455439716
Task_31796,1643,714,144,42,186,2.297902097902098,34.665240329310734
Task_31797,1953,340,17,133,150,5.7272727272727275,38.77659957967155
Task_31798,2671,83,134,130,264,31.797619047619047,49.20301922195355
Task_31799,1692,962,181,89,270,1.7570093457943925,37.2946129285856
Task_31800,1297,735,14,97,111,1.7622282608695652,29.540610667026787
Task_31801,771,240,197,52,249,3.199170124481328,20.07757470928828
Task_31802,656,139,128,109,237,4.685714285714286,18.017410911588353
Task_31803,1500,429,49,186,235,3.488372093023256,32.92458724114749
Task_31804,1141,742,148,183,331,1.5356662180349934,28.44797235744652
Task_31805,647,630,56,39,95,1.0253565768621236,17.847336337371544
Task_31806,1710,189,152,46,198,9.0,34.295483159786485
Task_31807,1414,767,88,87,175,1.8411458333333333,31.747634449085282
Task_31808,1201,527,24,40,64,2.274621212121212,25.760800212700385
Task_31809,2930,956,176,116,292,3.0616509926854754,57.22931861624303
Task_31810,1568,334,113,15,128,4.6805970149253735,31.85887895596633
Task_31811,1951,173,33,48,81,11.21264367816092,36.788181401004856
Task_31812,2607,792,43,45,88,3.287515762925599,49.282254615597616
Task_31813,1449,753,144,131,275,1.9217506631299734,33.075555422697256
Task_31814,1264,391,75,199,274,3.2244897959183674,29.238357464617312
Task_31815,1522,814,134,92,226,1.8674846625766872,34.043268037461665
Task_31816,2884,618,198,188,386,4.659127625201939,55.96419198673973
Task_31817,2139,278,79,195,274,7.666666666666667,42.68961057565142
Task_31818,1856,303,178,104,282,6.105263157894737,38.07386135233505
Task_31819,2026,455,56,200,256,4.442982456140351,41.44639014578349
Task_31820,2428,746,25,110,135,3.250334672021419,47.65817621063278
Task_31821,1129,352,110,151,261,3.198300283286119,26.712339807133457
Task_31822,2086,630,120,10,130,3.3058637083993663,40.95061158791194
Task_31823,2983,858,167,123,290,3.4726426076833525,57.763429346893474
Task_31824,2327,560,110,150,260,4.14795008912656,46.33470639542508
Task_31825,2971,493,43,77,120,6.01417004048583,55.10145325713804
Task_31826,2300,886,41,17,58,2.593010146561443,44.04003968639025
Task_31827,1450,426,57,30,87,3.395784543325527,29.73772261688389
Task_31828,2333,420,94,30,124,5.541567695961995,44.35629779978373
Task_31829,1897,658,82,152,234,2.8786039453717756,39.81325791155935
Task_31830,1509,738,116,121,237,2.0419485791610286,33.79337027734799
Task_31831,1299,354,81,31,112,3.659154929577465,27.463591684233908
Task_31832,1600,409,87,146,233,3.902439024390244,34.222915218700784
Task_31833,2792,401,115,92,207,6.945273631840796,52.75325303831165
Task_31834,886,998,87,152,239,0.8868868868868869,24.671169712699108
Task_31835,1603,225,57,62,119,7.092920353982301,32.30503784329965
Task_31836,1041,763,142,34,176,1.362565445026178,25.218475338981648
Task_31837,2270,838,21,200,221,2.705601907032181,46.186184068037484
Task_31838,623,695,154,57,211,0.8951149425287356,18.960757024715495
Task_31839,2690,542,126,107,233,4.953959484346225,51.840120240420354
Task_31840,2367,944,133,131,264,2.5047619047619047,48.166231192370105
Task_31841,1518,661,124,36,160,2.293051359516616,32.269441894835545
Task_31842,893,336,170,53,223,2.649851632047478,22.205799120509283
Task_31843,2135,547,192,107,299,3.895985401459854,43.36578251645337
Task_31844,2718,255,99,132,231,10.6171875,51.34178613114773
Task_31845,1336,254,15,54,69,5.23921568627451,27.379949998916672
Task_31846,1392,67,177,87,264,20.470588235294116,28.870409959290097
Task_31847,1754,793,173,20,193,2.209068010075567,36.646424948238355
Task_31848,2422,241,168,150,318,10.008264462809917,47.02974829622901
Task_31849,997,522,169,183,352,1.9063097514340344,25.618671187867765
Task_31850,2666,204,181,78,259,13.004878048780487,50.07005810064782
Task_31851,2831,853,119,193,312,3.3149882903981265,55.541161349990716
Task_31852,2257,255,22,77,99,8.81640625,42.57176718048594
Task_31853,1380,72,73,60,133,18.904109589041095,27.449634343304684
Task_31854,1212,307,117,121,238,3.935064935064935,27.731315879917066
Task_31855,667,872,78,188,266,0.7640320733104238,21.135145500046875
Task_31856,2826,415,48,21,69,6.793269230769231,51.070522328493745
Task_31857,1507,972,147,47,194,1.5488180883864338,33.4859068120613
Task_31858,1580,118,141,143,284,13.277310924369749,32.65844974697598
Task_31859,723,690,96,26,122,1.0463096960926195,19.62332334121583
Task_31860,2362,411,82,43,125,5.733009708737864,44.621759137442616
Task_31861,1398,960,32,10,42,1.4547346514047867,29.840835804981207
Task_31862,2416,641,170,163,333,3.763239875389408,48.34973287914204
Task_31863,2355,663,27,193,220,3.5466867469879517,47.02881072869116
Task_31864,591,619,55,186,241,0.9532258064516129,18.99094653773267
Task_31865,2913,887,128,192,320,3.2804054054054053,56.981608542539824
Task_31866,2210,70,50,168,218,31.12676056338028,41.829794538692774
Task_31867,2482,449,179,31,210,5.515555555555555,47.360761069910325
Task_31868,2471,360,155,31,186,6.8448753462603875,46.64943615066713
Task_31869,1485,283,187,69,256,5.22887323943662,31.502320299157194
Task_31870,1704,385,166,74,240,4.414507772020725,35.35133803943592
Task_31871,2681,192,43,177,220,13.89119170984456,50.54808488661407
Task_31872,1936,325,158,200,358,5.938650306748467,39.89642924252283
Task_31873,2915,284,47,101,148,10.228070175438596,53.86959066500237
Task_31874,1168,172,173,21,194,6.7514450867052025,25.215656004659348
Task_31875,2022,481,54,102,156,4.195020746887967,40.550823028305494
Task_31876,1970,191,27,117,144,10.260416666666666,38.57227294317905
Task_31877,607,299,146,83,229,2.0233333333333334,17.750209454583807
Task_31878,2042,941,178,184,362,2.1677282377919322,43.52629549573303
Task_31879,1644,336,91,161,252,4.878338278931751,34.82936460525611
Task_31880,1110,550,135,107,242,2.014519056261343,26.888387264703876
Task_31881,2457,528,90,131,221,4.644612476370511,48.13626559333195
Task_31882,1150,397,44,33,77,2.8894472361809047,24.53685831844031
Task_31883,901,186,50,83,133,4.818181818181818,21.97780878543476
Task_31884,2743,253,180,151,331,10.799212598425196,52.20620804156903
Task_31885,2747,201,88,28,116,13.599009900990099,49.85560131287044
Task_31886,1973,548,200,33,233,3.593806921675774,39.72725968803723
Task_31887,1075,402,75,97,172,2.667493796526055,25.6479358827779
Task_31888,2272,575,124,120,244,3.9444444444444446,45.39549950482198
Task_31889,752,324,148,53,201,2.313846153846154,19.83837781615057
Task_31890,1173,328,97,87,184,3.5653495440729484,26.463003626864506
Task_31891,1451,960,97,92,189,1.509885535900104,33.15979986691051
Task_31892,1021,427,52,17,69,2.385514018691589,22.326731473625262
Task_31893,1437,865,116,172,288,1.6593533487297922,33.33904953043387
Task_31894,2389,87,65,14,79,27.147727272727273,42.21060730635457
Task_31895,1328,819,81,27,108,1.6195121951219513,29.38015197843765
Task_31896,1956,624,23,191,214,3.1296,40.61143111893829
Task_31897,2428,620,93,103,196,3.9098228663446055,47.87972950546736
Task_31898,2986,277,177,143,320,10.741007194244604,56.074283610592126
Task_31899,2663,736,28,55,83,3.6132971506105833,50.28719594101069
Task_31900,1074,977,110,71,181,1.098159509202454,26.61547790620025
Task_31901,2652,70,130,46,176,37.352112676056336,47.31619228810419
Task_31902,741,689,140,56,196,1.0739130434782609,20.69476196475138
Task_31903,1994,199,113,46,159,9.97,38.24597624466332
Task_31904,2086,291,66,149,215,7.1438356164383565,41.55567841442768
Task_31905,1815,869,194,147,341,2.086206896551724,39.556411848896545
Task_31906,1202,174,158,160,318,6.868571428571428,27.162241275387785
Task_31907,1329,113,51,157,208,11.657894736842104,28.360766959545956
Task_31908,687,522,115,166,281,1.3135755258126196,20.313023582117037
Task_31909,1112,585,75,20,95,1.8976109215017065,24.99273222362065
Task_31910,2681,426,154,124,278,6.278688524590164,51.54748601151787
Task_31911,1605,394,143,41,184,4.063291139240507,33.00137039008553
Task_31912,1065,428,83,144,227,2.4825174825174825,25.832243734317043
Task_31913,1862,670,179,111,290,2.774962742175857,39.396473991223175
Task_31914,2093,1000,49,170,219,2.090909090909091,44.013718699176735
Task_31915,952,198,122,183,305,4.78391959798995,23.698171242622465
Task_31916,970,818,76,145,221,1.1843711843711844,25.514085829708694
Task_31917,2436,554,18,124,142,4.389189189189189,47.14380642873518
Task_31918,1153,368,197,106,303,3.124661246612466,27.266744059148618
Task_31919,1345,895,13,57,70,1.5011160714285714,29.516380703261643
Task_31920,2929,723,31,107,138,4.045580110497237,55.48529952061671
Task_31921,2672,91,77,147,224,29.043478260869566,49.26478083373859
Task_31922,1093,249,170,100,270,4.372,25.771833751785437
Task_31923,882,712,120,186,306,1.2370266479663394,24.063214294689757
Task_31924,2991,865,52,51,103,3.453810623556582,56.02988112087302
Task_31925,1178,539,46,88,134,2.1814814814814816,27.04864466929716
Task_31926,2935,661,140,38,178,4.433534743202417,54.91896965167684
Task_31927,2765,328,176,106,282,8.404255319148936,52.536742388400775
Task_31928,2063,797,28,74,102,2.5852130325814535,41.41286942985351
Task_31929,2169,883,131,38,169,2.4536199095022626,43.42292285480704
Task_31930,1488,780,112,69,181,1.9052496798975673,32.59767199103155
Task_31931,733,915,36,68,104,0.8002183406113537,20.604151159148927
Task_31932,1207,280,36,36,72,4.295373665480427,25.075354276001793
Task_31933,2267,132,103,57,160,17.045112781954888,42.14724363171047
Task_31934,2596,783,138,136,274,3.311224489795918,51.343364029542045
Task_31935,2008,476,173,81,254,4.209643605870021,40.56384144610675
Task_31936,989,826,43,117,160,1.1958887545344619,25.008396731059445
Task_31937,1406,72,151,149,300,19.26027397260274,29.47280583920129
Task_31938,1793,234,130,200,330,7.629787234042553,37.19536428698418
Task_31939,2531,156,179,139,318,16.121019108280255,48.10770546361519
Task_31940,1228,540,15,63,78,2.2698706099815156,26.729595376229287
Task_31941,787,215,151,65,216,3.6435185185185186,20.09001361227693
Task_31942,1419,497,20,52,72,2.8493975903614457,29.437305823441264
Task_31943,519,366,69,92,161,1.4141689373297002,16.243348529524678
Task_31944,1228,294,142,78,220,4.16271186440678,27.49962095463914
Task_31945,1986,835,171,37,208,2.375598086124402,40.73498015183183
Task_31946,1832,308,59,37,96,5.9288025889967635,35.532592664168625
Task_31947,635,915,131,103,234,0.6932314410480349,20.504373699063134
Task_31948,1885,162,33,18,51,11.56441717791411,35.23319983888094
Task_31949,2678,394,182,83,265,6.779746835443038,50.98154383233136
Task_31950,1261,341,100,110,210,3.6871345029239766,28.47473726421866
Task_31951,2293,357,198,45,243,6.405027932960894,44.167273862399334
Task_31952,2205,447,90,62,152,4.921875,42.65472531961486
Task_31953,614,387,58,41,99,1.5824742268041236,16.44510688525092
Task_31954,2492,116,51,83,134,21.299145299145298,45.72660323660714
Task_31955,1905,374,108,52,160,5.08,37.76868638901462
Task_31956,1627,360,113,85,198,4.5069252077562325,33.96052708376401
Task_31957,1269,333,37,132,169,3.7994011976047903,28.258164028831533
Task_31958,842,1002,159,47,206,0.839481555333998,23.12880489202281
Task_31959,2588,619,72,82,154,4.174193548387096,49.647845565432185
Task_31960,739,532,168,38,206,1.3864915572232646,20.039391482990457
Task_31961,797,157,43,102,145,5.044303797468355,19.508365045087555
Task_31962,1689,810,181,63,244,2.082614056720099,36.35487117572026
Task_31963,1115,277,158,193,351,4.010791366906475,26.71401491178661
Task_31964,1719,203,156,152,308,8.426470588235293,35.74411867580476
Task_31965,2243,575,19,82,101,3.8940972222222223,43.62816141296455
Task_31966,1987,832,187,154,341,2.385354141656663,42.176568996292374
Task_31967,666,964,66,104,170,0.6901554404145078,20.777258603135987
Task_31968,1106,847,142,195,337,1.304245283018868,28.239810248724158
Task_31969,1641,824,31,136,167,1.989090909090909,35.7075884418974
Task_31970,1510,272,30,171,201,5.531135531135531,32.273145355676256
Task_31971,1630,784,123,187,310,2.0764331210191083,36.27945788879058
Task_31972,1269,437,169,139,308,2.8972602739726026,29.393520865080983
Task_31973,1929,802,150,121,271,2.4022415940224158,40.80012999610602
Task_31974,802,205,154,30,184,3.8932038834951457,19.69922949248293
Task_31975,1535,668,178,165,343,2.294469357249626,34.5287947915093
Task_31976,638,380,195,193,388,1.6745406824146982,19.6543606685006
Task_31977,1310,435,24,149,173,3.0045871559633026,29.417186498938065
Task_31978,1544,552,62,24,86,2.7920433996383363,31.569953118722726
Task_31979,1342,869,90,87,177,1.542528735632184,30.80872975464195
Task_31980,1568,600,42,181,223,2.6089850249584026,34.33443102216075
Task_31981,1513,313,99,130,229,4.818471337579618,32.48487294980162
Task_31982,1303,343,117,65,182,3.7877906976744184,28.318322439116017
Task_31983,1690,454,32,28,60,3.7142857142857144,33.26846071178202
Task_31984,926,980,64,39,103,0.9439347604485219,23.332344927291388
Task_31985,2583,277,113,27,140,9.29136690647482,47.731117024069725
Task_31986,923,582,194,93,287,1.5831903945111492,24.101492481462497
Task_31987,1339,644,199,68,267,2.075968992248062,30.4239334266184
Task_31988,2248,1004,148,39,187,2.23681592039801,45.22468704999674
Task_31989,2106,1006,98,29,127,2.0913604766633567,42.56157925832819
Task_31990,1475,476,90,126,216,3.092243186582809,32.393677198799104
Task_31991,1358,300,31,180,211,4.511627906976744,30.016694316668275
Task_31992,2061,252,88,183,271,8.146245059288537,41.22259644024405
Task_31993,565,908,56,85,141,0.6215621562156216,18.687842288684905
Task_31994,1541,722,188,109,297,2.131396957123098,34.50319694964488
Task_31995,2355,627,75,87,162,3.75,46.130647374120066
Task_31996,1740,633,50,193,243,2.7444794952681386,37.44575507751471
Task_31997,694,568,138,81,219,1.2196836555360282,19.8194032407132
Task_31998,1775,534,136,152,288,3.317757009345794,37.64069550369357
Task_31999,754,96,126,34,160,7.77319587628866,17.611770755349305
Task_32000,2453,168,137,146,283,14.514792899408285,46.79866042795414
Task_32001,2519,237,47,13,60,10.584033613445378,45.41297804287364
Task_32002,2462,431,102,148,250,5.699074074074074,48.00702551590422
Task_32003,1452,687,186,83,269,2.11046511627907,32.526431034949134
Task_32004,2085,225,120,33,153,9.225663716814159,39.7588187491324
Task_32005,1980,132,182,137,319,14.887218045112782,39.19011962589093
Task_32006,1076,733,104,176,280,1.465940054495913,27.13907267310242
Task_32007,2829,400,66,116,182,7.054862842892768,53.298901197951885
Task_32008,1718,767,195,145,340,2.2369791666666665,37.6942160195345
Task_32009,2312,552,22,87,109,4.180831826401446,44.779922335158965
Task_32010,522,248,153,43,196,2.0963855421686746,15.633651967648369
Task_32011,1465,952,145,109,254,1.5372507869884575,33.7778060303187
Task_32012,516,844,148,48,196,0.6106508875739645,17.780692213661563
Task_32013,1079,958,198,13,211,1.1251303441084464,26.531755220355844
Task_32014,2560,918,55,111,166,2.7856365614798695,50.65648915940434
Task_32015,2533,448,141,65,206,5.641425389755011,48.42646321050009
Task_32016,1624,69,144,179,323,23.2,33.02085523354419
Task_32017,2016,86,52,135,187,23.17241379310345,38.685101319595724
Task_32018,2130,784,150,200,350,2.713375796178344,44.400155006274154
Task_32019,702,903,172,193,365,0.7765486725663717,22.149572941804845
Task_32020,2900,431,169,82,251,6.712962962962963,54.563406791124315
Task_32021,2123,854,72,74,146,2.4830409356725145,42.97606312719324
Task_32022,2042,597,143,53,196,3.4147157190635453,41.101079371999305
Task_32023,2571,727,110,76,186,3.5315934065934065,49.77474349463026
Task_32024,2618,760,118,186,304,3.440210249671485,51.828086153242964
Task_32025,618,902,151,34,185,0.6843853820598007,19.31071353594179
Task_32026,1255,590,14,26,40,2.1235194585448394,26.666360567835994
Task_32027,2897,586,61,49,110,4.93526405451448,53.44000817759368
Task_32028,1456,998,117,90,207,1.4574574574574575,33.35174346850164
Task_32029,2721,119,138,53,191,22.675,49.67939799253552
Task_32030,1237,228,110,76,186,5.401746724890829,27.0497192212365
Task_32031,685,629,23,13,36,1.0873015873015872,17.623176614586452
Task_32032,891,495,187,136,323,1.7963709677419355,23.65630939545149
Task_32033,2366,932,32,64,96,2.5359056806002145,46.46473093161274
Task_32034,1097,319,173,53,226,3.428125,25.39078993035316
Task_32035,2412,550,14,18,32,4.3774954627949185,44.59926507460522
Task_32036,1824,679,128,150,278,2.6823529411764704,38.82591088672303
Task_32037,1811,660,137,133,270,2.7397881996974283,38.499380510774536
Task_32038,982,523,168,81,249,1.8740458015267176,24.44742006019122
Task_32039,905,668,37,77,114,1.352765321375187,22.842390642103435
Task_32040,1050,836,136,132,268,1.2544802867383513,26.8588119329694
Task_32041,2246,480,23,146,169,4.669438669438669,44.29118099596328
Task_32042,1964,798,135,178,313,2.458072590738423,41.614999274086
Task_32043,2196,958,116,42,158,2.289885297184567,43.89712916289591
Task_32044,1928,528,184,92,276,3.6446124763705106,39.801352872038194
Task_32045,877,912,136,45,181,0.9605695509309967,23.110822897352296
Task_32046,1877,818,99,199,298,2.2918192918192917,40.263931570467314
Task_32047,1336,241,192,64,256,5.520661157024794,29.012718659449323
Task_32048,1814,977,79,12,91,1.8548057259713702,37.34361216858301
Task_32049,1079,131,81,126,207,8.174242424242424,24.55825097326048
Task_32050,2830,729,157,126,283,3.8767123287671232,54.90618060153114
Task_32051,2009,820,98,162,260,2.4470158343483557,42.14824102731023
Task_32052,2661,340,103,29,132,7.803519061583578,49.281072420430604
Task_32053,1072,742,165,176,341,1.442799461641992,27.364098769451715
Task_32054,2381,747,61,195,256,3.1831550802139037,47.957517087795885
Task_32055,931,834,197,43,240,1.1149700598802395,24.078518784955047
Task_32056,2310,655,61,75,136,3.5213414634146343,45.29606639658498
Task_32057,2764,418,89,134,223,6.5966587112171835,52.64105844123577
Task_32058,1581,300,71,11,82,5.25249169435216,31.393428073889027
Task_32059,1872,404,133,175,308,4.622222222222222,38.88289684024102
Task_32060,2898,627,143,198,341,4.614649681528663,56.026490969949066
Task_32061,1179,618,37,24,61,1.9046849757673667,25.644854802644115
Task_32062,1857,608,51,146,197,3.0492610837438425,38.95024171587978
Task_32063,2774,581,34,93,127,4.766323024054983,52.583951868436486
Task_32064,1414,611,39,32,71,2.310457516339869,29.390198768302792
Task_32065,1124,323,38,89,127,3.4691358024691357,25.52546097877402
Task_32066,1472,217,152,191,343,6.752293577981652,32.110346541330216
Task_32067,806,768,113,85,198,1.048114434330299,22.13468656002083
Task_32068,1304,495,98,18,116,2.629032258064516,27.802520471886055
Task_32069,1497,129,123,10,133,11.515384615384615,29.612040057259662
Task_32070,1034,223,20,182,202,4.616071428571429,24.546306002562414
Task_32071,1366,371,120,147,267,3.672043010752688,30.54397001329392
Task_32072,2673,217,76,71,147,12.261467889908257,49.50224599371116
Task_32073,1417,87,51,152,203,16.102272727272727,29.39359666339828
Task_32074,1249,288,165,41,206,4.321799307958478,27.30200885774995
Task_32075,800,449,52,43,95,1.7777777777777777,19.663270296619345
Task_32076,2478,938,10,196,206,2.6389776357827475,49.74231374311024
Task_32077,1068,759,181,23,204,1.4052631578947368,25.858136526658726
Task_32078,2440,234,151,44,195,10.382978723404255,45.87071743375591
Task_32079,1415,612,76,119,195,2.3083197389885806,31.856540571234664
Task_32080,2278,616,78,176,254,3.6920583468395463,45.878617478274826
Task_32081,1431,516,97,141,238,2.7678916827853,31.91940842687475
Task_32082,1486,691,122,44,166,2.147398843930636,31.99596069637813
Task_32083,1032,374,60,99,159,2.752,24.496117372201155
Task_32084,2401,184,137,143,280,12.978378378378379,46.1422379677474
Task_32085,801,1020,107,56,163,0.7845249755142018,22.45919511596397
Task_32086,747,397,37,114,151,1.8768844221105527,19.95354497043935
Task_32087,630,79,99,25,124,7.875,15.315064034359386
Task_32088,2624,753,189,181,370,3.480106100795756,52.19124351881686
Task_32089,2252,77,98,138,236,28.871794871794872,42.43511483613565
Task_32090,2094,123,182,148,330,16.887096774193548,41.00421740978013
Task_32091,2370,641,147,166,313,3.691588785046729,47.53542982999314
Task_32092,709,173,50,189,239,4.074712643678161,19.256174136059418
Task_32093,2474,312,87,111,198,7.904153354632588,47.516602155914775
Task_32094,590,947,14,110,124,0.6223628691983122,19.23875230408947
Task_32095,1521,233,127,72,199,6.5,31.701339824497552
Task_32096,1412,680,27,45,72,2.0734214390602057,29.577832139942767
Task_32097,1124,75,112,174,286,14.789473684210526,25.041655709028245
Task_32098,1033,321,56,150,206,3.2080745341614905,25.00334399214813
Task_32099,2093,130,50,51,101,15.977099236641221,38.816740715303595
Task_32100,2274,547,154,150,304,4.149635036496351,45.65228323397995
Task_32101,1112,388,187,170,357,2.858611825192802,27.019266999549448
Task_32102,1793,701,135,103,238,2.5541310541310542,38.154663380743806
Task_32103,2190,280,40,134,174,7.7935943060498225,42.77901752930137
Task_32104,1341,427,119,39,158,3.133177570093458,28.676683761502773
Task_32105,1471,414,80,63,143,3.544578313253012,31.05724291736024
Task_32106,1718,301,34,164,198,5.688741721854305,35.62243026576059
Task_32107,1390,424,95,29,124,3.2705882352941176,29.41861042500616
Task_32108,608,462,88,181,269,1.3131749460043196,18.84824307220443
Task_32109,744,217,74,167,241,3.4128440366972477,20.251742375536992
Task_32110,2055,149,58,153,211,13.7,40.208070600924046
Task_32111,1155,547,154,113,267,2.1076642335766422,27.712991246303847
Task_32112,2844,745,138,113,251,3.812332439678284,55.01519716723103
Task_32113,2521,774,198,130,328,3.2529032258064516,50.36148165826489
Task_32114,1605,875,70,163,233,1.832191780821918,35.92480276587301
Task_32115,603,820,153,38,191,0.7344701583434835,18.781695939111938
Task_32116,576,249,27,194,221,2.304,17.561247884552646
Task_32117,1043,837,107,135,242,1.2446300715990453,26.63821700941269
Task_32118,2088,593,64,58,122,3.515151515151515,41.057874491156035
Task_32119,1139,920,164,19,183,1.236699239956569,26.997056826500142
Task_32120,2411,438,190,46,236,5.492027334851937,46.30530077254446
Task_32121,1067,528,135,66,201,2.0170132325141776,25.430962360052828
Task_32122,1971,538,53,187,240,3.6567717996289426,40.761528830626254
Task_32123,2230,840,53,40,93,2.6516052318668253,43.56106249211814
Task_32124,2947,264,176,187,363,11.120754716981132,55.66797930000632
Task_32125,2332,619,43,18,61,3.761290322580645,43.69375007789847
Task_32126,669,903,31,165,196,0.7400442477876106,20.745606854664363
Task_32127,1898,380,189,195,384,4.981627296587926,39.58771488094799
Task_32128,1468,476,192,200,392,3.0775681341719077,33.13532899919167
Task_32129,2869,298,21,51,72,9.595317725752508,51.68818769401597
Task_32130,1404,724,100,20,120,1.936551724137931,30.159808495538723
Task_32131,1666,464,48,142,190,3.5827956989247314,35.347825961962165
Task_32132,714,235,135,188,323,3.0254237288135593,20.105861834827962
Task_32133,1491,359,119,184,303,4.141666666666667,32.69900997750127
Task_32134,2159,1001,59,87,146,2.154690618762475,44.14702424335789
Task_32135,2030,908,198,97,295,2.233223322332233,42.837520662151206
Task_32136,821,744,24,99,123,1.1020134228187919,21.910959830663206
Task_32137,1172,963,27,160,187,1.2157676348547717,28.798122609788617
Task_32138,2956,889,49,62,111,3.3213483146067415,55.81971553568184
Task_32139,722,123,95,84,179,5.82258064516129,18.276803589751914
Task_32140,2301,338,90,76,166,6.787610619469026,44.216362025909774
Task_32141,1217,708,26,191,217,1.7165021156558533,29.114306602025408
Task_32142,1440,343,53,86,139,4.186046511627907,30.65047995782689
Task_32143,2305,359,197,143,340,6.402777777777778,45.682366060912955
Task_32144,664,643,24,187,211,1.031055900621118,19.90862490828273
Task_32145,2352,888,55,22,77,2.645669291338583,44.99391790324009
Task_32146,2495,70,115,151,266,35.140845070422536,46.35445402784174
Task_32147,1382,910,173,95,268,1.5170142700329308,32.3467874215616
Task_32148,1509,891,183,147,330,1.6917040358744395,34.71327039581925
Task_32149,2689,236,19,189,208,11.345991561181435,50.77051885583367
Task_32150,1323,198,127,124,251,6.648241206030151,29.224037230534766
Task_32151,2977,594,10,78,88,5.003361344537815,55.08322034329916
Task_32152,1172,587,86,160,246,1.9931972789115646,28.12377113815735
Task_32153,1197,755,125,127,252,1.5833333333333333,28.937369159017
Task_32154,777,935,85,107,192,0.8301282051282052,22.497942621338144
Task_32155,2315,343,182,124,306,6.729651162790698,45.60554803265861
Task_32156,1840,582,70,146,216,3.156089193825043,38.62906767371467
Task_32157,1590,1006,56,182,238,1.5789473684210527,36.123243259196016
Task_32158,2365,121,176,86,262,19.385245901639344,44.69371483617607
Task_32159,2622,636,83,75,158,4.116169544740973,50.10605890390457
Task_32160,1133,644,46,154,200,1.7565891472868218,27.446861982538774
Task_32161,817,1000,27,148,175,0.8161838161838162,23.19931353678945
Task_32162,1664,388,128,63,191,4.277634961439588,34.38506834363119
Task_32163,642,469,188,161,349,1.3659574468085107,19.725764173043867
Task_32164,2607,1003,142,67,209,2.596613545816733,51.3706451153627
Task_32165,2522,1011,194,88,282,2.492094861660079,50.59735517428624
Task_32166,2646,457,174,162,336,5.777292576419214,51.4126356865145
Task_32167,974,653,129,173,302,1.489296636085627,25.380541957973232
Task_32168,2171,862,17,163,180,2.5156431054461184,44.23274839410933
Task_32169,2181,935,195,120,315,2.3301282051282053,45.40456169091353
Task_32170,1569,873,56,29,85,1.7951945080091534,33.058286036335204
Task_32171,1466,887,113,12,125,1.6509009009009008,31.829093836027997
Task_32172,1864,104,94,63,157,17.752380952380953,35.421947344520724
Task_32173,1788,886,160,129,289,2.015783540022548,38.92075450914071
Task_32174,2493,819,72,31,103,3.040243902439024,47.75428340756102
Task_32175,748,140,160,167,327,5.304964539007092,19.978691964589864
Task_32176,1010,449,169,42,211,2.2444444444444445,24.05665594927939
Task_32177,778,294,39,132,171,2.6372881355932205,20.355658861735463
Task_32178,2573,705,12,20,32,3.644475920679887,47.621039988713754
Task_32179,2639,112,43,105,148,23.353982300884955,47.90488070861348
Task_32180,1155,124,79,161,240,9.24,25.968256896410974
Task_32181,1071,381,124,171,295,2.803664921465969,26.070258180315605
Task_32182,1630,474,108,25,133,3.431578947368421,33.33803411312132
Task_32183,998,959,89,191,280,1.0395833333333333,26.53286279575414
Task_32184,2340,508,27,62,89,4.597249508840864,44.50419376194131
Task_32185,2923,169,30,85,115,17.194117647058825,52.757710116818636
Task_32186,1738,565,131,196,327,3.070671378091873,37.39327675404922
Task_32187,2298,756,58,157,215,3.035667107001321,46.45697313221143
Task_32188,2090,810,160,37,197,2.5770653514180024,42.255072888910426
Task_32189,1970,881,67,83,150,2.233560090702948,40.64931193465933
Task_32190,1268,413,25,170,195,3.0628019323671496,28.88595859947641
Task_32191,1945,246,155,11,166,7.874493927125506,37.68106664874034
Task_32192,2210,124,160,18,178,17.68,41.011714298949094
Task_32193,1661,125,61,104,165,13.182539682539682,33.30327320634224
Task_32194,1627,705,134,142,276,2.3045325779036827,35.76611330587749
Task_32195,1646,625,79,163,242,2.6293929712460065,35.824614001260954
Task_32196,2213,978,40,172,212,2.26046986721144,45.669930946140475
Task_32197,1430,836,97,90,187,1.7084826762246117,32.38330192561113
Task_32198,1163,76,196,93,289,15.103896103896103,25.53462786509752
Task_32199,1338,992,200,12,212,1.3474320241691844,30.812460167861506
Task_32200,2014,609,131,46,177,3.301639344262295,40.12026694267632
Task_32201,2339,741,17,140,157,3.152291105121294,46.2422563137899
Task_32202,1979,73,175,134,309,26.743243243243242,38.44297381392792
Task_32203,2991,614,36,170,206,4.863414634146341,56.81724186925572
Task_32204,2707,302,15,135,150,8.933993399339935,50.682827682373095
Task_32205,545,178,146,194,340,3.0446927374301676,16.94617856972151
Task_32206,1580,670,151,145,296,2.354694485842027,35.00667208974426
Task_32207,2297,959,143,150,293,2.392708333333333,47.26228987200306
Task_32208,534,571,131,59,190,0.9335664335664335,17.06250252745867
Task_32209,2783,450,46,42,88,6.170731707317073,50.99512590119098
Task_32210,2621,984,17,154,171,2.660913705583756,51.673664626872664
Task_32211,539,435,150,38,188,1.2362385321100917,16.441215388200717
Task_32212,2911,110,74,25,99,26.225225225225227,51.324283047633564
Task_32213,1750,312,84,48,132,5.5910543130990416,34.74809175245202
Task_32214,2720,525,66,158,224,5.171102661596958,52.417143976022295
Task_32215,2679,230,90,198,288,11.597402597402597,51.03204192834292
Task_32216,1554,117,86,50,136,13.169491525423728,30.422879702653077
Task_32217,593,967,181,26,207,0.612603305785124,19.415524346724137
Task_32218,2533,335,73,46,119,7.538690476190476,47.01773125368563
Task_32219,1438,89,132,46,178,15.977777777777778,28.55687767049218
Task_32220,1645,507,93,27,120,3.2381889763779528,33.60842010974093
Task_32221,1865,76,127,197,324,24.22077922077922,36.85553785920276
Task_32222,1590,564,142,37,179,2.814159292035398,33.30028755474753
Task_32223,927,766,62,148,210,1.2086049543676662,24.616559828626055
Task_32224,2029,305,100,53,153,6.630718954248366,39.449054567599674
Task_32225,2612,715,94,150,244,3.64804469273743,51.35183638134736
Task_32226,2621,412,27,128,155,6.346246973365617,49.730026311859234
Task_32227,2078,64,20,124,144,31.96923076923077,38.67266057588399
Task_32228,2870,510,71,63,134,5.616438356164384,53.56081179447319
Task_32229,1053,397,139,147,286,2.6457286432160805,25.760676686556135
Task_32230,1301,434,181,179,360,2.9908045977011493,30.183433871975726
Task_32231,946,349,144,110,254,2.702857142857143,23.716375404073972
Task_32232,832,411,96,38,134,2.0194174757281553,20.643941444392333
Task_32233,1456,727,191,10,201,2.0,31.80117486193159
Task_32234,2191,735,183,85,268,2.9769021739130435,44.40000240433201
Task_32235,2144,285,80,136,216,7.496503496503497,42.44181053579325
Task_32236,631,759,121,129,250,0.8302631578947368,19.935563937216795
Task_32237,2635,334,68,17,85,7.865671641791045,48.05174242183457
Task_32238,2814,570,147,142,289,4.928196147110333,54.19732395624675
Task_32239,958,270,122,159,281,3.5350553505535056,23.844186663659173
Task_32240,568,169,84,52,136,3.3411764705882354,15.57276876461446
Task_32241,1748,420,193,132,325,4.1520190023752965,36.98610964999767
Task_32242,1590,638,64,147,211,2.488262910798122,34.81260159492043
Task_32243,1424,86,167,187,354,16.367816091954023,30.163496140479435
Task_32244,867,316,50,68,118,2.7350157728706623,21.226798244653008
Task_32245,1285,425,40,128,168,3.016431924882629,28.78565741824899
Task_32246,1630,804,196,138,334,2.0248447204968945,36.37811936734378
Task_32247,1388,141,16,69,85,9.774647887323944,27.96447177294432
Task_32248,2450,81,134,78,212,29.878048780487806,45.099579334117
Task_32249,917,89,162,131,293,10.188888888888888,21.91068424887915
Task_32250,1062,501,80,139,219,2.1155378486055776,26.045224356232495
Task_32251,1869,244,164,49,213,7.628571428571429,37.05893826926943
Task_32252,2477,268,131,48,179,9.20817843866171,46.35095765168209
Task_32253,2113,143,26,196,222,14.67361111111111,41.116727984212744
Task_32254,1922,747,70,98,168,2.56951871657754,39.977805354021875
Task_32255,1723,735,17,91,108,2.3410326086956523,36.031345858576486
Task_32256,1733,196,32,45,77,8.796954314720812,33.112746342762314
Task_32257,2175,942,53,160,213,2.306468716861082,45.09999935157364
Task_32258,780,378,27,49,76,2.058047493403694,18.682486602991958
Task_32259,2412,851,173,175,348,2.8309859154929575,49.03199751964698
Task_32260,2753,182,27,138,165,15.043715846994536,51.05337026545513
Task_32261,622,313,34,183,217,1.980891719745223,18.44560182844967
Task_32262,603,380,62,77,139,1.5826771653543308,17.351342072610585
Task_32263,1410,463,107,125,232,3.038793103448276,31.3448450099658
Task_32264,1232,745,185,20,205,1.6514745308310992,28.280113419578512
Task_32265,2075,389,91,156,247,5.32051282051282,41.79239077001137
Task_32266,2077,842,14,157,171,2.4638196915776986,42.719739734529526
Task_32267,1535,399,67,93,160,3.8375,32.509902903000516
Task_32268,2107,621,60,100,160,3.387459807073955,42.32333964970961
Task_32269,1036,1015,99,69,168,1.0196850393700787,26.028630082783337
Task_32270,1337,733,179,135,314,1.8215258855585832,31.42063344580507
Task_32271,2227,585,167,105,272,3.8003412969283277,44.818907315486456
Task_32272,2893,877,186,49,235,3.29498861047836,55.41655228852655
Task_32273,2748,944,69,30,99,2.907936507936508,52.178555473454175
Task_32274,2364,1017,89,100,189,2.3222003929273085,47.97548759448991
Task_32275,2586,209,71,150,221,12.314285714285715,49.18631676624091
Task_32276,610,169,144,194,338,3.588235294117647,18.051587115397748
Task_32277,526,988,145,94,239,0.531850353892821,18.95879191439691
Task_32278,987,758,83,123,206,1.300395256916996,25.397399591306954
Task_32279,2171,143,34,102,136,15.07638888888889,40.97386546498216
Task_32280,2434,950,127,76,203,2.559411146161935,48.52964411460655
Task_32281,1230,751,136,77,213,1.6356382978723405,28.88429209999755
Task_32282,1243,494,131,73,204,2.511111111111111,28.190118923050452
Task_32283,1869,80,193,69,262,23.074074074074073,36.00015682768896
Task_32284,1366,591,130,157,287,2.3074324324324325,31.346850878537627
Task_32285,1792,203,17,138,155,8.784313725490197,35.81011703136017
Task_32286,1028,904,78,111,189,1.1359116022099447,26.458501246411586
Task_32287,860,494,153,103,256,1.7373737373737375,22.79864258381761
Task_32288,2065,476,174,129,303,4.329140461215933,42.0804908800735
Task_32289,941,470,24,98,122,1.9978768577494692,23.17935693738311
Task_32290,2814,763,133,39,172,3.683246073298429,53.335021150854516
Task_32291,1964,518,170,36,206,3.7842003853564545,39.367313371656905
Task_32292,675,153,125,20,145,4.383116883116883,16.85471132364033
Task_32293,1547,93,130,70,200,16.45744680851064,30.76214718318717
Task_32294,1361,120,61,199,260,11.24793388429752,29.292916172396005
Task_32295,1411,100,123,81,204,13.970297029702971,28.985547048873304
Task_32296,1238,416,13,161,174,2.968824940047962,28.258631286926192
Task_32297,2773,146,71,133,204,18.86394557823129,51.39537308398755
Task_32298,1663,824,185,101,286,2.0157575757575756,36.692665149481655
Task_32299,2812,346,53,146,199,8.103746397694524,53.19672988838746
Task_32300,2547,317,122,102,224,8.00943396226415,48.78377108567966
Task_32301,2361,391,178,36,214,6.0229591836734695,45.275062192062116
Task_32302,1603,308,70,158,228,5.1877022653721685,34.06661060743497
Task_32303,1359,77,152,154,306,17.423076923076923,28.789140326330795
Task_32304,519,64,164,200,364,7.984615384615385,15.987149661997961
Task_32305,829,225,177,22,199,3.668141592920354,20.34652491803239
Task_32306,2548,1019,16,194,210,2.4980392156862745,51.080379026400756
Task_32307,562,95,95,180,275,5.854166666666667,16.313401464062732
Task_32308,2497,317,138,190,328,7.852201257861635,48.590842033719866
Task_32309,2890,181,109,193,302,15.87912087912088,53.81083417017958
Task_32310,2310,81,114,193,307,28.170731707317074,43.803814835236324
Task_32311,2542,400,42,93,135,6.339152119700748,48.32925042525377
Task_32312,970,261,128,103,231,3.7022900763358777,23.69678434280931
Task_32313,2786,402,40,196,236,6.913151364764268,53.05794656487586
Task_32314,1281,873,60,196,256,1.465675057208238,30.874959955221772
Task_32315,1656,506,47,175,222,3.2662721893491122,35.454348694974094
Task_32316,683,950,62,198,260,0.7181913774973712,21.723322110488564
Task_32317,1488,585,144,197,341,2.539249146757679,33.562024187897684
Task_32318,1122,682,173,37,210,1.642752562225476,26.578369378121426
Task_32319,2520,863,46,168,214,2.9166666666666665,50.20082989385344
Task_32320,1634,487,143,142,285,3.348360655737705,35.23083721188237
Task_32321,2355,466,163,110,273,5.042826552462527,46.47563976822662
Task_32322,1796,91,51,198,249,19.52173913043478,35.67179573391838
Task_32323,2177,355,174,162,336,6.115168539325842,43.653981558255644
Task_32324,1854,465,148,29,177,3.9785407725321886,37.15188087551122
Task_32325,698,874,25,143,168,0.7977142857142857,20.809099098551243
Task_32326,1379,829,13,29,42,1.6614457831325302,29.465551859155113
Task_32327,2482,985,125,37,162,2.5172413793103448,48.609169041811526
Task_32328,2575,598,115,61,176,4.298831385642738,49.16898183396049
Task_32329,1424,602,106,13,119,2.361525704809287,30.145839221697358
Task_32330,1904,717,151,50,201,2.651810584958217,39.08187889692659
Task_32331,2453,604,156,123,279,4.054545454545455,48.5162603984439
Task_32332,2097,581,141,99,240,3.6030927835051547,42.57973153085722
Task_32333,2618,968,27,89,116,2.7017543859649122,51.13400464490456
Task_32334,662,517,23,79,102,1.277992277992278,18.399541827286424
Task_32335,1659,879,137,28,165,1.8852272727272728,35.38566232100266
Task_32336,985,270,102,170,272,3.6346863468634685,24.246474153097978
Task_32337,1791,304,39,97,136,5.872131147540983,36.17286040457924
Task_32338,2750,596,120,196,316,4.606365159128978,53.467984204986315
Task_32339,1905,338,86,13,99,5.619469026548672,36.73259656990896
Task_32340,2426,858,98,22,120,2.8242142025611177,46.92017007066275
Task_32341,2640,726,130,162,292,3.6313617606602477,51.98022644671814
Task_32342,1769,421,12,132,144,4.191943127962086,36.214909773156734
Task_32343,747,787,68,43,111,0.9479695431472082,20.203883218510132
Task_32344,2854,470,189,15,204,6.059447983014862,53.11388050786285
Task_32345,1530,869,37,71,108,1.7586206896551724,33.23570020351423
Task_32346,1953,116,30,23,53,16.692307692307693,36.06222084998238
Task_32347,1658,798,122,109,231,2.075093867334168,36.29629431582509
Task_32348,1675,584,15,105,120,2.8632478632478633,35.116855575628215
Task_32349,1579,758,99,159,258,2.080368906455863,35.11671000433574
Task_32350,1151,271,14,43,57,4.231617647058823,24.284849211925025
Task_32351,1825,855,28,128,156,2.1320093457943927,38.53653494933975
Task_32352,2713,887,109,127,236,3.05518018018018,53.338723149714134
Task_32353,1007,575,42,160,202,1.7482638888888888,25.233223127021713
Task_32354,2940,1006,190,146,336,2.919563058589871,57.7862430116107
Task_32355,2411,613,130,151,281,3.92671009771987,47.92977486555168
Task_32356,1201,599,144,76,220,2.0016666666666665,27.97677030760759
Task_32357,1182,785,191,50,241,1.5038167938931297,28.034394391934843
Task_32358,2275,308,93,147,240,7.3624595469255665,44.7016403366074
Task_32359,2284,562,110,108,218,4.05683836589698,45.409328029319965
Task_32360,1436,493,106,120,226,2.9068825910931175,31.817245072949053
Task_32361,996,423,103,150,253,2.349056603773585,24.796795400125973
Task_32362,2973,571,46,67,113,5.1975524475524475,55.30259161626385
Task_32363,2536,990,126,16,142,2.5590312815338043,49.16643777091334
Task_32364,1419,780,114,101,215,1.8169014084507042,32.369958805344865
Task_32365,503,155,62,126,188,3.2243589743589745,15.540148978546044
Task_32366,1430,1006,63,121,184,1.420059582919563,33.019837638706676
Task_32367,2761,809,132,114,246,3.408641975308642,53.88070129900634
Task_32368,2116,801,107,53,160,2.638403990024938,42.4791398455215
Task_32369,2955,338,185,75,260,8.716814159292035,55.067668774388814
Task_32370,2365,579,149,21,170,4.077586206896552,45.42606854604361
Task_32371,1464,289,119,18,137,5.048275862068966,29.887685528125157
Task_32372,2641,788,175,14,189,3.347275031685678,50.65670717261745
Task_32373,671,821,167,176,343,0.816301703163017,21.265078940519214
Task_32374,988,815,22,34,56,1.2107843137254901,23.381789851979704
Task_32375,1561,909,79,80,159,1.7153846153846153,34.29403028591392
Task_32376,1502,674,62,159,221,2.225185185185185,33.59419672738489
Task_32377,1393,371,61,48,109,3.7446236559139785,28.912740639515814
Task_32378,2392,526,69,182,251,4.538899430740038,47.38290740488289
Task_32379,799,383,43,19,62,2.0807291666666665,18.70450341523316
Task_32380,2734,992,120,56,176,2.7532729103726084,53.026543709364496
Task_32381,521,304,100,32,132,1.7081967213114755,15.300543995561464
Task_32382,2578,226,47,53,100,11.3568281938326,47.39630019639325
Task_32383,613,410,122,193,315,1.491484184914842,18.994626229627816
Task_32384,2008,113,163,68,231,17.614035087719298,38.438421698726025
Task_32385,909,844,72,146,218,1.0757396449704142,24.501610091082597
Task_32386,1885,909,104,73,177,2.0714285714285716,39.337243272650205
Task_32387,703,146,101,54,155,4.782312925170068,17.615778712075386
Task_32388,1600,155,54,34,88,10.256410256410257,30.961695838071098
Task_32389,623,994,66,145,211,0.6261306532663317,20.712649981139474
Task_32390,2741,284,42,43,85,9.617543859649123,49.763865920862145
Task_32391,2898,648,118,111,229,4.465331278890601,55.46110138606095
Task_32392,1776,363,19,137,156,4.8791208791208796,36.155583836967004
Task_32393,2824,247,26,124,150,11.387096774193548,52.307932570772465
Task_32394,2529,866,37,155,192,2.916955017301038,50.220299234600084
Task_32395,1522,352,105,72,177,4.311614730878187,31.820166723441286
Task_32396,2465,455,80,160,240,5.405701754385965,48.232854046133205
Task_32397,679,95,25,120,145,7.072916666666667,16.989679626458074
Task_32398,981,847,37,198,235,1.1568396226415094,25.743604155974143
Task_32399,1400,173,87,126,213,8.045977011494253,29.779650321487306
Task_32400,2820,608,43,59,102,4.630541871921182,52.45651770672591
Task_32401,1464,296,133,104,237,4.929292929292929,31.649823708869743
Task_32402,2846,422,148,110,258,6.7281323877068555,54.03480149924559
Task_32403,671,629,144,78,222,1.065079365079365,19.694932951016856
Task_32404,2489,761,117,101,218,3.2664041994750654,49.27539135161095
Task_32405,2791,561,127,16,143,4.9661921708185055,51.8804223141396
Task_32406,2804,778,30,63,93,3.599486521181001,52.91823162121482
Task_32407,2059,581,184,92,276,3.5378006872852232,42.04405571992719
Task_32408,2230,107,151,135,286,20.64814814814815,42.56048442435526
Task_32409,2559,247,24,159,183,10.318548387096774,48.485431908037334
Task_32410,859,260,169,94,263,3.2911877394636013,22.014897303413836
Task_32411,2280,766,75,96,171,2.9726205997392436,45.734808777332226
Task_32412,2690,842,147,128,275,3.190984578884935,53.010588201195446
Task_32413,626,689,43,166,209,0.9072463768115943,19.41676962716398
Task_32414,2658,922,174,106,280,2.8797399783315276,52.74420013686076
Task_32415,719,570,15,53,68,1.2591943957968477,18.617066995944132
Task_32416,1448,238,90,185,275,6.058577405857741,31.53913050982001
Task_32417,1277,780,26,175,201,1.6350832266325224,30.193218608266353
Task_32418,2973,810,86,137,223,3.665844636251541,57.21473241445281
Task_32419,2078,689,26,67,93,3.0115942028985505,41.15402829480141
Task_32420,2187,548,127,155,282,3.9836065573770494,44.186085547937495
Task_32421,1955,698,192,125,317,2.7968526466380546,41.09969268388182
Task_32422,1837,845,141,141,282,2.1713947990543736,39.55552886621471
Task_32423,1591,558,49,120,169,2.8461538461538463,34.19253310310525
Task_32424,1087,72,85,81,166,14.89041095890411,23.47983445384391
Task_32425,2391,774,166,191,357,3.0851612903225805,48.52208702446754
Task_32426,1516,199,133,172,305,7.58,32.55694336166456
Task_32427,2550,373,158,12,170,6.818181818181818,47.655338354497445
Task_32428,1759,522,192,87,279,3.363288718929254,36.959213668248374
Task_32429,2051,419,42,113,155,4.883333333333334,40.684382118010085
Task_32430,1325,660,173,10,183,2.004538577912254,29.25175880263899
Task_32431,2210,804,21,111,132,2.7453416149068324,44.3559382510069
Task_32432,1361,827,42,25,67,1.643719806763285,29.2022814310246
Task_32433,2559,813,82,46,128,3.1437346437346436,49.234879698020826
Task_32434,995,697,132,148,280,1.4255014326647564,25.68856692219487
Task_32435,828,283,81,41,122,2.915492957746479,19.899756191847164
Task_32436,1714,568,20,12,32,3.0123022847100174,33.58941762510932
Task_32437,2997,934,52,142,194,3.205347593582888,57.98842182542421
Task_32438,2072,501,56,22,78,4.127490039840637,39.41504173684161
Task_32439,2402,917,36,185,221,2.616557734204793,48.53089556098831
Task_32440,530,324,86,84,170,1.6307692307692307,16.18781645831212
Task_32441,2255,918,25,145,170,2.453754080522307,45.7713096408798
Task_32442,544,1006,134,154,288,0.5402184707050646,19.63971320366075
Task_32443,1858,203,170,195,365,9.107843137254902,38.25825255141323
Task_32444,1586,710,49,101,150,2.230661040787623,34.32304409672309
Task_32445,1345,470,152,190,342,2.8556263269639066,30.929237462355257
Task_32446,2722,828,183,169,352,3.2834740651387215,53.88083061391095
Task_32447,2262,286,138,152,290,7.881533101045296,44.540317612012224
Task_32448,1454,603,74,199,273,2.4072847682119205,32.90839498712358
Task_32449,2314,374,133,185,318,6.1706666666666665,45.83732927078004
Task_32450,2537,931,29,77,106,2.7221030042918457,49.39182979565729
Task_32451,1801,895,39,78,117,2.010044642857143,37.89863895591505
Task_32452,1636,821,84,114,198,1.9902676399026764,35.92529828017983
Task_32453,1687,609,82,184,266,2.765573770491803,36.52429398643272
Task_32454,2273,692,101,160,261,3.27994227994228,45.91690635587122
Task_32455,1611,538,114,80,194,2.9888682745825603,34.240275358371285
Task_32456,1187,618,139,88,227,1.9176090468497577,27.973065172537883
Task_32457,2607,267,10,48,58,9.727611940298507,47.26115134212913
Task_32458,2425,552,90,91,181,4.3851717902350815,47.12613563297936
Task_32459,1693,666,46,180,226,2.5382308845577213,36.55409070142403
Task_32460,1184,974,192,120,312,1.2143589743589744,29.590185078210244
Task_32461,1057,712,111,13,124,1.482468443197756,24.731813064957482
Task_32462,2684,722,154,59,213,3.7123098201936378,51.63174393477497
Task_32463,985,107,158,88,246,9.12037037037037,22.60778657827126
Task_32464,1149,974,131,20,151,1.1784615384615384,27.17569927038007
Task_32465,2847,637,166,50,216,4.462382445141066,53.833537848187696
Task_32466,2243,408,30,179,209,5.484107579462103,44.36734055601323
Task_32467,1368,702,97,15,112,1.945945945945946,29.56386694041889
Task_32468,1240,349,119,24,143,3.5428571428571427,26.75902264069866
Task_32469,1758,841,28,200,228,2.0878859857482186,38.17544881191149
Task_32470,1424,938,152,110,262,1.516506922257721,33.12222533291831
Task_32471,1618,762,122,46,168,2.1205766710353866,34.268663416140264
Task_32472,2857,910,79,23,102,3.1361141602634466,53.827110955895904
Task_32473,527,241,133,157,290,2.177685950413223,16.977147218975485
Task_32474,2822,116,164,171,335,24.11965811965812,52.386482923720905
Task_32475,1132,978,173,121,294,1.1562819203268642,28.74003460413768
Task_32476,1463,76,109,41,150,19.0,28.494456295625366
Task_32477,2547,863,87,180,267,2.9479166666666665,50.85931671573491
Task_32478,1460,389,51,162,213,3.7435897435897436,32.06383673514331
Task_32479,1920,646,173,84,257,2.9675425038639878,39.757647971028305
Task_32480,1739,791,155,181,336,2.1957070707070705,38.136538530629316
Task_32481,987,272,10,142,152,3.6153846153846154,23.360705686292743
Task_32482,2174,748,91,75,166,2.902536715620828,43.521573057662835
Task_32483,1176,774,186,110,296,1.5174193548387096,28.837112621545955
Task_32484,1438,576,135,180,315,2.4922010398613517,32.59984341533305
Task_32485,698,79,134,142,276,8.725,18.328874674994108
Task_32486,1182,588,59,63,122,2.00679117147708,26.964277364982763
Task_32487,2962,329,101,55,156,8.975757575757576,54.306895395448635
Task_32488,1490,326,50,27,77,4.556574923547401,29.701643108968252
Task_32489,2100,169,21,97,118,12.352941176470589,39.67847641721035
Task_32490,2592,345,72,128,200,7.491329479768786,49.64878950401197
Task_32491,1263,447,23,82,105,2.8191964285714284,27.798130430093394
Task_32492,1260,694,176,73,249,1.8129496402877698,29.288682982683003
Task_32493,2444,415,139,85,224,5.875,47.185204891956666
Task_32494,1785,215,184,175,359,8.26388888888889,37.09410269271106
Task_32495,2986,347,167,158,325,8.580459770114942,56.368104630689515
Task_32496,1508,642,45,40,85,2.3452566096423015,31.382336290598904
Task_32497,1099,967,171,52,223,1.1353305785123966,27.449934468084546
Task_32498,1427,551,149,54,203,2.585144927536232,31.201606363240575
Task_32499,659,112,165,55,220,5.831858407079646,17.20209817665386
Task_32500,1441,789,163,87,250,1.8240506329113924,32.629522492511356
Task_32501,1806,689,12,183,195,2.617391304347826,38.24845328581307
Task_32502,2068,274,156,62,218,7.52,40.48261603029489
Task_32503,884,332,147,155,302,2.6546546546546548,22.963664713531916
Task_32504,2408,745,106,112,218,3.227882037533512,47.95803125831177
Task_32505,1025,193,193,63,256,5.283505154639175,24.048759596968722
Task_32506,551,257,53,168,221,2.135658914728682,17.282658282228038
Task_32507,817,814,47,46,93,1.0024539877300613,21.162523151359395
Task_32508,2137,245,125,171,296,8.6869918699187,42.473591181130935
Task_32509,2802,837,101,181,282,3.343675417661098,54.8786795697099
Task_32510,701,144,161,152,313,4.834482758620689,19.21992719866628
Task_32511,1213,82,45,36,81,14.614457831325302,24.190484317609172
Task_32512,2071,721,104,88,192,2.8684210526315788,42.13784163397985
Task_32513,1812,290,128,61,189,6.22680412371134,36.29292172113341
Task_32514,2029,895,21,68,89,2.2645089285714284,40.890718134140634
Task_32515,822,213,142,71,213,3.8411214953271027,20.63544021165227
Task_32516,1676,540,130,52,182,3.0979667282809613,34.87481891731269
Task_32517,2509,1012,92,133,225,2.47680157946693,50.532986603337264
Task_32518,913,897,164,71,235,1.0167037861915367,24.261789621068278
Task_32519,686,465,74,55,129,1.4721030042918455,18.80471850486052
Task_32520,2294,820,50,193,243,2.7941534713763705,46.80805488904792
Task_32521,990,151,22,166,188,6.5131578947368425,23.094069571210593
Task_32522,2472,69,19,69,88,35.31428571428572,44.15808432437899
Task_32523,579,570,156,42,198,1.0140105078809107,17.46854999641542
Task_32524,1919,601,14,70,84,3.1877076411960132,38.22284162240079
Task_32525,2547,127,65,83,148,19.8984375,46.805047350461116
Task_32526,2632,727,99,18,117,3.6153846153846154,49.55704869249646
Task_32527,1192,185,62,84,146,6.408602150537634,26.190940334769007
Task_32528,976,927,167,25,192,1.0517241379310345,24.847718980742812
Task_32529,1523,443,108,69,177,3.43018018018018,32.071124210334325
Task_32530,1072,954,109,30,139,1.1225130890052355,25.987335779397043
Task_32531,1767,836,144,169,313,2.111111111111111,38.59916926959537
Task_32532,2938,651,135,156,291,4.506134969325154,56.4495997093512
Task_32533,1403,211,144,40,184,6.617924528301887,29.197961479200334
Task_32534,2058,203,183,166,349,10.088235294117647,41.30074704506473
Task_32535,1802,695,87,51,138,2.589080459770115,36.983187913052866
Task_32536,2404,663,105,33,138,3.6204819277108435,46.201624064419235
Task_32537,1783,212,28,171,199,8.370892018779342,36.365431338359336
Task_32538,1350,214,67,141,208,6.27906976744186,29.613781120428424
Task_32539,1533,790,171,119,290,1.9380530973451326,34.57157787630705
Task_32540,1984,487,27,29,56,4.065573770491803,38.07525042658312
Task_32541,2656,547,192,118,310,4.846715328467154,51.68102067923138
Task_32542,1193,338,184,18,202,3.5191740412979353,26.308869355878045
Task_32543,2289,363,71,91,162,6.288461538461538,44.310244477152956
Task_32544,564,470,70,173,243,1.197452229299363,18.145776086512658
Task_32545,2637,768,16,182,198,3.4291287386215865,51.63389679505132
Task_32546,1583,749,52,41,93,2.1106666666666665,33.04068432592472
Task_32547,1458,320,41,165,206,4.542056074766355,31.596676403209315
Task_32548,1816,469,52,73,125,3.8638297872340424,36.87364191131983
Task_32549,1571,932,189,94,283,1.6838156484458735,35.47790494029806
Task_32550,2297,654,114,80,194,3.5068702290076335,45.470731722947185
Task_32551,643,1003,156,165,321,0.6404382470119522,21.37578504959528
Task_32552,560,324,165,156,321,1.7230769230769232,17.88786426300761
Task_32553,1670,955,185,114,299,1.7468619246861925,37.27504232124323
Task_32554,1414,731,41,184,225,1.9316939890710383,32.317302900457676
Task_32555,1759,604,124,105,229,2.9074380165289258,37.27381761454432
Task_32556,802,367,71,152,223,2.1793478260869565,21.544565528789203
Task_32557,2578,324,22,101,123,7.932307692307693,48.55617183505611
Task_32558,2284,686,146,113,259,3.3245997088791848,45.99432977585777
Task_32559,2108,283,162,165,327,7.422535211267606,42.281269244681326
Task_32560,566,615,198,61,259,0.9188311688311688,18.007103804215827
Task_32561,2051,341,116,121,237,5.997076023391813,41.107774054614865
Task_32562,2176,793,48,27,75,2.7405541561712847,42.04287466400241
Task_32563,753,73,129,148,277,10.175675675675675,19.132360483489418
Task_32564,2362,816,54,80,134,2.8910648714810283,46.76563156800621
Task_32565,2630,507,108,95,203,5.177165354330708,50.59626139832971
Task_32566,2079,474,63,104,167,4.376842105263158,41.58371420684562
Task_32567,2185,897,20,95,115,2.433184855233853,44.08766658218362
Task_32568,1869,229,167,191,358,8.126086956521739,38.490748574480726
Task_32569,1001,675,16,25,41,1.4807692307692308,22.9349765311991
Task_32570,879,848,56,161,217,1.0353356890459364,24.07030914359281
Task_32571,2082,705,37,124,161,2.9490084985835696,42.15077574785456
Task_32572,1222,210,54,101,155,5.791469194312796,26.996054383275183
Task_32573,2926,598,158,126,284,4.884808013355593,56.014760007703025
Task_32574,887,370,149,152,301,2.3908355795148246,23.12336845364997
Task_32575,1197,893,145,40,185,1.3389261744966443,28.18213036914275
Task_32576,1959,471,29,181,210,4.15042372881356,40.08450265689405
Task_32577,2913,489,197,183,380,5.944897959183673,55.97286569076283
Task_32578,2921,121,195,17,212,23.942622950819672,52.59243481349401
Task_32579,2176,391,188,164,352,5.551020408163265,43.83276151739424
Task_32580,1488,576,135,191,326,2.5788561525129983,33.45732030095544
Task_32581,1540,899,189,111,300,1.711111111111111,35.04132990206572
Task_32582,2943,487,118,56,174,6.030737704918033,54.8258978086596
Task_32583,2798,728,143,44,187,3.8381344307270235,53.095381437772424
Task_32584,699,221,91,130,221,3.1486486486486487,19.327441216335924
Task_32585,2089,664,95,171,266,3.1413533834586467,43.02301971307108
Task_32586,957,473,33,128,161,2.018987341772152,23.640011511344166
Task_32587,2982,982,154,84,238,3.0335707019328586,57.55058393603102
Task_32588,1523,763,197,148,345,1.993455497382199,34.61944088857282
Task_32589,1899,791,60,158,218,2.397727272727273,40.233839344660396
Task_32590,1652,580,65,99,164,2.8433734939759034,35.199038548165724
Task_32591,1525,658,103,67,170,2.314112291350531,32.77228123390159
Task_32592,2063,931,53,140,193,2.213519313304721,43.17154322959681
Task_32593,2606,415,146,192,338,6.264423076923077,50.6942780236108
Task_32594,2488,285,42,192,234,8.6993006993007,47.92923328792051
Task_32595,2442,159,29,101,130,15.2625,45.335099649964086
Task_32596,652,689,122,77,199,0.9449275362318841,19.508722890416003
Task_32597,2163,690,166,127,293,3.130246020260492,44.2640589203632
Task_32598,1226,738,62,13,75,1.658998646820027,26.597607245388332
Task_32599,1842,269,94,92,186,6.822222222222222,37.11500095043399
Task_32600,1415,825,191,178,369,1.7130750605326877,33.24007317025683
Task_32601,2821,405,14,142,156,6.948275862068965,52.903546419325956
Task_32602,1119,552,57,129,186,2.023508137432188,26.84575456528471
Task_32603,2729,694,28,123,151,3.9266187050359713,52.30433154907848
Task_32604,2688,496,19,29,48,5.408450704225352,49.12957964639818
Task_32605,2969,346,167,183,350,8.556195965417867,56.245068220737515
Task_32606,713,383,102,22,124,1.8567708333333333,18.38393507162034
Task_32607,1178,752,52,151,203,1.5644090305444887,28.614781086707353
Task_32608,897,597,93,46,139,1.5,22.250820568031713
Task_32609,1991,916,32,127,159,2.1712104689203926,41.366641541458954
Task_32610,1523,98,129,93,222,15.383838383838384,30.978501048171605
Task_32611,1230,599,38,17,55,2.05,26.200639643914553
Task_32612,1257,339,12,115,127,3.697058823529412,27.78760456381814
Task_32613,1063,556,122,165,287,1.9084380610412925,26.450799879646443
Task_32614,506,844,96,100,196,0.5988165680473373,18.210276014990367
Task_32615,1993,697,133,114,247,2.855300859598854,41.36686280540897
Task_32616,2848,659,10,120,130,4.315151515151515,54.031756279369915
Task_32617,1533,589,40,49,89,2.5983050847457627,31.73736110510842
Task_32618,597,321,72,90,162,1.8540372670807452,17.38076701445252
Task_32619,1789,556,159,45,204,3.2118491921005385,36.65894746721934
Task_32620,1958,589,27,46,73,3.31864406779661,37.973292292845116
Task_32621,1306,846,36,84,120,1.5419126328217236,29.807717713281416
Task_32622,1263,482,103,124,227,2.6149068322981366,29.054123387369103
Task_32623,2825,95,157,152,309,29.427083333333332,51.89380803865214
Task_32624,1291,282,41,112,153,4.561837455830389,28.164751599404564
Task_32625,902,782,185,42,227,1.1519795657726692,23.49784008230618
Task_32626,2292,887,83,102,185,2.581081081081081,46.321057715688966
Task_32627,1207,676,195,142,337,1.7828655834564253,29.28427964995306
Task_32628,1327,701,77,116,193,1.8903133903133904,30.715209997324603
Task_32629,2064,518,196,82,278,3.976878612716763,41.73446109829101
Task_32630,2795,860,67,110,177,3.2462253193960513,54.20305770862935
Task_32631,846,207,61,82,143,4.0673076923076925,20.79109299207896
Task_32632,1522,879,156,148,304,1.7295454545454545,34.76626760303581
Task_32633,617,362,192,92,284,1.699724517906336,18.547988168688033
Task_32634,1153,783,148,47,195,1.4706632653061225,27.300778142102867
Task_32635,982,810,142,117,259,1.2108508014796548,25.6383169966379
Task_32636,2619,882,96,190,286,2.9660249150622877,52.20420516735766
Task_32637,1466,1006,180,119,299,1.4558093346573981,34.15288763045052
Task_32638,2871,873,164,41,205,3.2848970251716247,54.84237259106627
Task_32639,934,360,56,195,251,2.587257617728532,23.831429360417307
Task_32640,2718,350,106,183,289,7.743589743589744,52.01367716636086
Task_32641,2391,489,119,50,169,4.8795918367346935,45.72885476381499
Task_32642,2049,355,126,156,282,5.75561797752809,41.37703067709766
Task_32643,1811,874,168,77,245,2.069714285714286,38.61468254468501
Task_32644,915,465,67,142,209,1.963519313304721,23.559328367187252
Task_32645,2057,591,29,115,144,3.4746621621621623,41.32605035754445
Task_32646,983,961,149,26,175,1.021829521829522,24.930624584897874
Task_32647,1235,561,37,142,179,2.197508896797153,28.51142413954513
Task_32648,1142,587,150,169,319,1.9421768707482994,27.948855852825222
Task_32649,1404,957,71,51,122,1.465553235908142,31.41101706890815
Task_32650,1078,383,34,10,44,2.8072916666666665,23.029358678859793
Task_32651,860,238,189,64,253,3.598326359832636,21.469557858749194
Task_32652,2533,407,35,153,188,6.208333333333333,48.77147929219967
Task_32653,1314,897,200,172,372,1.4632516703786191,31.81311530948423
Task_32654,2050,466,184,31,215,4.389721627408994,40.60058689638607
Task_32655,2735,441,53,89,142,6.1877828054298645,51.5297551991018
Task_32656,1411,171,162,99,261,8.203488372093023,30.110159733761474
Task_32657,715,490,171,184,355,1.4562118126272912,21.00069478453369
Task_32658,2684,583,50,60,110,4.595890410958904,50.43744634191805
Task_32659,1761,386,58,31,89,4.550387596899225,34.553623696436006
Task_32660,1269,628,174,183,357,2.0174880763116056,30.28012607688844
Task_32661,553,297,11,91,102,1.8557046979865772,16.104044558906104
Task_32662,2547,257,138,156,294,9.872093023255815,48.96457151920357
Task_32663,2832,756,75,27,102,3.7410832232496696,52.983140147196856
Task_32664,812,712,48,67,115,1.1388499298737729,21.511515404646904
Task_32665,2773,402,170,133,303,6.880893300248139,53.04943896545999
Task_32666,2953,974,11,93,104,3.0287179487179485,56.314057777696384
Task_32667,2380,344,51,52,103,6.898550724637682,44.720625005306225
Task_32668,1440,892,173,45,218,1.612541993281075,32.26162159511504
Task_32669,2210,1023,73,111,184,2.158203125,45.48749216809839
Task_32670,1595,805,190,86,276,1.978908188585608,35.2250025070612
Task_32671,2923,104,94,108,202,27.83809523809524,53.06624387821946
Task_32672,1716,80,188,163,351,21.185185185185187,34.6425709913214
Task_32673,586,349,34,121,155,1.6742857142857144,17.296819956049724
Task_32674,1602,532,100,47,147,3.0056285178236397,33.14470323727728
Task_32675,2840,387,40,72,112,7.319587628865979,52.526078112811014
Task_32676,2753,628,121,58,179,4.376788553259141,52.09456274788758
Task_32677,2992,142,102,171,273,20.923076923076923,55.11943712476807
Task_32678,1983,716,37,102,139,2.7656903765690375,40.461258368568686
Task_32679,2476,339,61,91,152,7.2823529411764705,47.07940709105265
Task_32680,2018,624,128,196,324,3.2288,42.00029270544662
Task_32681,1013,867,19,159,178,1.1670506912442395,25.78038504360373
Task_32682,2665,631,28,177,205,4.216772151898734,51.746245697015745
Task_32683,1287,554,119,117,236,2.3189189189189188,29.691223639206402
Task_32684,1989,754,45,80,125,2.6344370860927153,40.506110664553425
Task_32685,2934,162,130,50,180,18.0,52.91162733895499
Task_32686,1132,802,27,181,208,1.4097135740971358,27.905719303192097
Task_32687,2127,1000,17,58,75,2.1248751248751248,42.11884734499746
Task_32688,1188,1019,15,130,145,1.1647058823529413,28.86196394380151
Task_32689,2663,520,195,47,242,5.111324376199616,50.59690748610779
Task_32690,1358,384,47,165,212,3.5272727272727273,30.28820068020443
Task_32691,2420,928,13,66,79,2.6049515608180838,46.915067365849204
Task_32692,1503,706,129,192,321,2.1258840169731257,34.08113064264301
Task_32693,2795,304,156,11,167,9.163934426229508,51.302885419667064
Task_32694,2008,184,70,68,138,10.854054054054053,38.8495057760232
Task_32695,763,577,178,149,327,1.320069204152249,21.882198339790307
Task_32696,1848,598,139,187,326,3.0851419031719534,39.22174302513063
Task_32697,956,833,80,127,207,1.146282973621103,25.22588614676025
Task_32698,2155,980,62,47,109,2.196738022426096,42.84875246508847
Task_32699,1269,664,113,54,167,1.9082706766917292,28.729259995992095
Task_32700,2037,288,88,159,247,7.048442906574395,40.826538755980664
Task_32701,2373,776,140,125,265,3.054054054054054,47.73179832350137
Task_32702,1457,323,75,97,172,4.496913580246914,31.43575225229175
Task_32703,1624,350,86,119,205,4.626780626780627,34.278510313750026
Task_32704,1947,383,119,167,286,5.0703125,39.89008302170729
Task_32705,2790,983,157,73,230,2.8353658536585367,54.345793106327925
Task_32706,533,803,57,42,99,0.6629353233830846,16.825595651605937
Task_32707,2232,392,164,185,349,5.679389312977099,44.73939375650175
Task_32708,2352,258,133,11,144,9.08108108108108,43.959660384613954
Task_32709,2170,428,108,130,238,5.058275058275059,43.29548782833255
Task_32710,1007,345,80,27,107,2.9104046242774566,22.80805297289758
Task_32711,2391,1020,41,82,123,2.3418217433888344,47.724221606720086
Task_32712,2479,803,65,42,107,3.0833333333333335,47.430106530547796
Task_32713,837,866,24,19,43,0.9653979238754326,20.90256209327854
Task_32714,933,356,106,196,302,2.6134453781512605,23.875501619342106
Task_32715,857,863,17,24,41,0.9918981481481481,21.35867853725536
Task_32716,678,109,153,120,273,6.163636363636364,18.109180123304707
Task_32717,950,734,130,169,299,1.2925170068027212,25.183314783766793
Task_32718,2595,663,145,145,290,3.908132530120482,51.03435734533851
Task_32719,1794,744,63,66,129,2.408053691275168,37.294868134565334
Task_32720,781,656,31,112,143,1.1887366818873668,21.18405787781342
Task_32721,2493,432,163,180,343,5.757505773672055,48.96699286283212
Task_32722,882,146,95,124,219,6.0,21.60669386171105
Task_32723,895,530,79,178,257,1.6854990583804144,23.710535294364927
Task_32724,2985,972,100,188,288,3.0678314491264134,58.238397145018645
Task_32725,1672,799,17,85,102,2.09,35.26378121922813
Task_32726,1733,511,168,54,222,3.384765625,36.00564194197794
Task_32727,2727,480,192,173,365,5.669438669438669,52.91678314153205
Task_32728,1895,645,83,138,221,2.93343653250774,39.62277648603136
Task_32729,912,883,92,38,130,1.0316742081447965,23.40521541702945
Task_32730,1339,577,162,82,244,2.3166089965397925,30.28830169781392
Task_32731,1580,691,138,156,294,2.2832369942196533,35.079492008629074
Task_32732,547,393,187,137,324,1.3883248730964468,17.829846516788738
Task_32733,803,245,10,117,127,3.2642276422764227,20.30656172974275
Task_32734,629,788,120,134,254,0.7972116603295311,20.06630628364206
Task_32735,1840,757,119,79,198,2.4274406332453826,38.566142889772166
Task_32736,2995,1014,25,135,160,2.9507389162561575,57.605235361370944
Task_32737,724,643,177,132,309,1.124223602484472,21.245022281059818
Task_32738,706,1009,40,120,160,0.699009900990099,21.248252230769165
Task_32739,2690,69,12,167,179,38.42857142857143,48.89153022726168
Task_32740,1858,823,115,10,125,2.254854368932039,37.84846281061015
Task_32741,1007,181,150,59,209,5.532967032967033,23.204691256863793
Task_32742,1243,217,112,23,135,5.701834862385321,26.358600309606462
Task_32743,665,727,122,81,203,0.9134615384615384,19.854262915025004
Task_32744,875,235,127,68,195,3.707627118644068,21.453589819841564
Task_32745,827,452,143,152,295,1.82560706401766,22.405644530441407
Task_32746,2547,499,136,86,222,5.094,49.09285176155669
Task_32747,2347,211,79,86,165,11.070754716981131,44.77918925506078
Task_32748,1341,473,182,86,268,2.829113924050633,30.125371796675264
Task_32749,2216,283,165,156,321,7.802816901408451,43.948225798827615
Task_32750,771,990,178,146,324,0.7780020181634713,23.257957092452674
Task_32751,735,183,122,167,289,3.994565217391304,19.934637564858722
Task_32752,2519,66,59,94,153,37.59701492537314,45.800200720724064
Task_32753,1855,463,169,29,198,3.997844827586207,37.43791966751816
Task_32754,1989,904,96,20,116,2.197790055248619,40.02254406388615
Task_32755,2577,102,124,165,289,25.019417475728154,48.05082185627452
Task_32756,2370,821,40,82,122,2.883211678832117,46.74770048201035
Task_32757,1080,330,43,199,242,3.2628398791540785,25.864756896557367
Task_32758,2101,300,161,80,241,6.980066445182724,41.43203955319296
Task_32759,2699,924,138,112,250,2.917837837837838,53.273708224774886
Task_32760,1212,190,111,11,122,6.345549738219895,25.682886657902014
Task_32761,737,682,50,104,154,1.0790629575402635,20.587112322559648
Task_32762,820,251,155,146,301,3.253968253968254,21.672201096436737
Task_32763,2617,912,125,92,217,2.8663745892661554,51.658105503017616
Task_32764,2129,337,17,22,39,6.298816568047338,39.57969008785198
Task_32765,1297,946,17,57,74,1.3695881731784583,28.79149384422549
Task_32766,1678,169,191,104,295,9.870588235294118,34.56838031767814
Task_32767,1955,237,68,96,164,8.214285714285714,38.91425017121293
Task_32768,753,877,73,96,169,0.857630979498861,21.75867142302471
Task_32769,2416,792,44,31,75,3.046658259773014,45.83748856124339
Task_32770,1283,588,47,24,71,2.1782682512733444,27.228160175359246
Task_32771,2481,758,73,111,184,3.268774703557312,48.95382814440157
Task_32772,765,151,163,171,334,5.032894736842105,20.34040770459666
Task_32773,2313,664,105,45,150,3.4781954887218047,44.74898550821714
Task_32774,2329,499,75,19,94,4.658,43.99039762312221
Task_32775,770,551,179,69,248,1.394927536231884,20.96500425980989
Task_32776,2696,350,34,114,148,7.680911680911681,50.64076943581211
Task_32777,1171,754,53,198,251,1.5509933774834437,28.795340201502512
Task_32778,1036,593,176,62,238,1.7441077441077442,25.26564767668074
Task_32779,1785,342,140,74,214,5.204081632653061,36.37436373187513
Task_32780,2380,474,156,147,303,5.010526315789473,47.08677134143688
Task_32781,1416,179,65,84,149,7.866666666666666,29.332736595093724
Task_32782,1025,529,149,52,201,1.9339622641509433,24.799100074499236
Task_32783,1925,106,134,101,235,17.990654205607477,37.48140356222567
Task_32784,1682,230,176,57,233,7.2813852813852815,34.28110372888997
Task_32785,1591,413,172,190,362,3.842995169082126,34.730775389329985
Task_32786,1842,268,174,142,316,6.847583643122676,37.94139927097746
Task_32787,1309,266,34,80,114,4.902621722846442,28.14006181629947
Task_32788,2810,1022,35,137,172,2.7468230694037143,54.98514440889888
Task_32789,1695,550,89,190,279,3.076225045372051,36.47962579088448
Task_32790,1589,723,87,159,246,2.1947513812154695,35.11864615660571
Task_32791,1343,911,123,149,272,1.4725877192982457,31.846119569714265
Task_32792,1335,937,73,45,118,1.4232409381663114,29.879697829940827
Task_32793,1659,691,105,114,219,2.397398843930636,35.93125585418061
Task_32794,1920,223,19,59,78,8.571428571428571,36.43559881148695
Task_32795,2337,725,27,104,131,3.21900826446281,46.16582779485074
Task_32796,1756,85,89,48,137,20.41860465116279,33.04676384246431
Task_32797,882,809,139,142,281,1.0888888888888888,24.165393120904408
Task_32798,2334,773,125,14,139,3.0155038759689923,45.26126665349825
Task_32799,2237,652,30,161,191,3.42572741194487,44.94746459473137
Task_32800,712,781,126,99,225,0.9104859335038363,21.128644565764922
Task_32801,2969,892,179,115,294,3.32474804031355,57.654544884589846
Task_32802,2006,804,43,164,207,2.4919254658385093,41.81452341927831
Task_32803,1224,627,127,19,146,1.9490445859872612,27.265928124699823
Task_32804,1697,317,27,37,64,5.336477987421383,32.949218966987935
Task_32805,1081,677,179,154,333,1.5943952802359882,27.291175670497324
Task_32806,1148,600,163,12,175,1.9101497504159735,26.34507693638585
Task_32807,749,76,126,23,149,9.727272727272727,17.325707140916403
Task_32808,1339,717,52,20,72,1.8649025069637883,28.304244273283075
Task_32809,584,591,84,61,145,0.9864864864864865,17.512762768394044
Task_32810,2582,138,70,39,109,18.575539568345324,46.49483487032642
Task_32811,1746,634,23,119,142,2.7496062992125982,36.58508389304838
Task_32812,1151,583,177,119,296,1.970890410958904,27.901909528762193
Task_32813,1868,485,10,37,47,3.843621399176955,36.14942128651638
Task_32814,530,244,68,89,157,2.163265306122449,16.00854416100984
Task_32815,608,194,118,65,183,3.117948717948718,16.839407903527274
Task_32816,2289,718,37,85,122,3.1835883171070933,45.146026399372005
Task_32817,2517,622,79,83,162,4.040128410914928,48.58759259343771
Task_32818,2331,149,157,83,240,15.54,44.240313987556
Task_32819,2673,561,24,168,192,4.7562277580071175,51.57951038408145
Task_32820,2220,231,127,152,279,9.568965517241379,43.62878672185118
Task_32821,1762,887,151,95,246,1.9842342342342343,38.2401149028316
Task_32822,2556,881,39,24,63,2.8979591836734695,48.30314229540385
Task_32823,1774,291,190,145,335,6.075342465753424,37.03565628334123
Task_32824,849,1012,33,35,68,0.8381046396841066,21.829257280038846
Task_32825,1322,375,47,52,99,3.515957446808511,28.001666155583823
Task_32826,2751,911,195,41,236,3.0164473684210527,53.19965207351595
Task_32827,626,587,124,97,221,1.064625850340136,19.127036830107322
Task_32828,2486,901,42,151,193,2.7560975609756095,49.64065627959972
Task_32829,597,927,31,17,48,0.6433189655172413,17.506986266330937
Task_32830,1280,792,35,63,98,1.614123581336696,28.855053319331333
Task_32831,600,312,193,188,381,1.9169329073482428,18.813176733823195
Task_32832,1238,921,163,29,192,1.3427331887201734,29.097924634693154
Task_32833,2846,815,41,45,86,3.4877450980392157,53.12548193896086
Task_32834,1479,298,104,79,183,4.946488294314381,31.125764504228727
Task_32835,660,989,49,113,162,0.6666666666666666,20.684239498132488
Task_32836,1185,905,157,175,332,1.3079470198675496,29.633717295820148
Task_32837,2756,453,111,10,121,6.070484581497797,50.80220736324747
Task_32838,2605,928,151,118,269,2.804090419806243,51.891129922929984
Task_32839,1491,381,110,179,289,3.9031413612565444,32.699996562813624
Task_32840,1404,1006,164,130,294,1.394240317775571,33.16391664311181
Task_32841,2088,865,110,195,305,2.4110854503464205,43.77764061214966
Task_32842,1799,561,139,24,163,3.201067615658363,36.4732810686037
Task_32843,2127,514,50,17,67,4.1300970873786405,40.131126968414726
Task_32844,2240,640,25,144,169,3.4945397815912638,44.65603788645618
Task_32845,1280,989,165,150,315,1.292929292929293,31.246519670712146
Task_32846,1551,101,189,71,260,15.205882352941176,31.285701307274326
Task_32847,2574,857,73,161,234,3.0,51.21021044095168
Task_32848,2874,154,175,75,250,18.54193548387097,52.71579865456488
Task_32849,1191,1017,142,193,335,1.1699410609037328,30.08600021655532
Task_32850,846,442,107,179,286,1.909706546275395,22.673974420218702
Task_32851,2270,843,65,191,256,2.68957345971564,46.49123714483209
Task_32852,1571,1008,40,113,153,1.5569871159563924,34.84282079167138
Task_32853,2875,852,151,99,250,3.3704572098475967,55.803144252558106
Task_32854,2019,306,173,181,354,6.576547231270358,41.09868236369325
Task_32855,2854,361,183,156,339,7.883977900552487,54.388407691840484
Task_32856,1180,184,195,99,294,6.378378378378378,26.861508764711143
Task_32857,2067,728,72,166,238,2.8353909465020575,42.79900342772212
Task_32858,1497,994,19,166,185,1.5045226130653266,34.04613281839129
Task_32859,2585,310,193,152,345,8.311897106109324,49.978916243720526
Task_32860,1250,531,68,82,150,2.3496240601503757,28.186926360328812
Task_32861,1279,330,87,155,242,3.86404833836858,28.942367199873008
Task_32862,1437,694,125,94,219,2.0676258992805754,32.33927130981561
Task_32863,903,177,155,107,262,5.073033707865169,22.090306638751624
Task_32864,1849,538,169,181,350,3.430426716141002,39.14701764378219
Task_32865,1155,213,169,82,251,5.397196261682243,26.23314080258467
Task_32866,2952,683,137,111,248,4.315789473684211,56.51331999717039
Task_32867,2941,222,187,132,319,13.188340807174887,55.132145876393885
Task_32868,2953,216,176,56,232,13.608294930875577,54.36802456638345
Task_32869,1523,133,40,76,116,11.365671641791044,30.23191276593772
Task_32870,2904,999,85,76,161,2.904,55.700629482732985
Task_32871,2525,530,34,54,88,4.75517890772128,47.458282862295846
Task_32872,1962,974,37,197,234,2.0123076923076924,41.82336196004113
Task_32873,1286,568,183,178,361,2.260105448154657,30.372146071050025
Task_32874,2516,768,79,75,154,3.271781534460338,48.86237054634395
Task_32875,929,748,164,167,331,1.240320427236315,25.004252932417653
Task_32876,743,1018,82,99,181,0.7291462217860648,22.094484292937192
Task_32877,2556,780,41,22,63,3.272727272727273,47.97012132710424
Task_32878,2229,390,195,178,373,5.70076726342711,44.78322629707596
Task_32879,2438,886,85,21,106,2.7485907553551296,46.985182066032
Task_32880,2264,1009,54,33,87,2.241584158415842,44.451406733737805
Task_32881,707,593,126,93,219,1.1902356902356903,20.364984738859263
Task_32882,1064,186,140,139,279,5.689839572192513,25.34723704763343
Task_32883,1496,499,168,26,194,2.992,31.79696188613032
Task_32884,660,782,95,163,258,0.842911877394636,20.62266550789924
Task_32885,756,266,121,64,185,2.831460674157303,19.46118336506887
Task_32886,2443,484,99,186,285,5.0371134020618555,48.09419393524198
Task_32887,2467,87,41,181,222,28.03409090909091,45.931055996383755
Task_32888,2369,808,198,175,373,2.9283065512978985,48.32879906978982
Task_32889,1716,650,114,139,253,2.6359447004608296,36.89547303539023
Task_32890,2197,336,191,148,339,6.519287833827893,43.89943970958753
Task_32891,1815,419,76,63,139,4.321428571428571,36.51614333471833
Task_32892,2132,555,134,107,241,3.8345323741007196,43.0823553503786
Task_32893,1838,907,92,145,237,2.0242290748898677,39.64494701529397
Task_32894,735,541,187,100,287,1.3560885608856088,21.074646309047612
Task_32895,1217,721,107,58,165,1.685595567867036,28.12019715182667
Task_32896,1507,257,21,62,83,5.841085271317829,30.421238210865862
Task_32897,1423,295,174,65,239,4.8074324324324325,30.51010869219493
Task_32898,2593,277,156,122,278,9.327338129496402,49.64239102384312
Task_32899,1408,886,80,81,161,1.5873731679819616,31.73780304493174
Task_32900,1198,702,188,181,369,1.7041251778093884,29.424111876835763
Task_32901,1090,358,184,17,201,3.0362116991643453,24.76564907758154
Task_32902,2838,972,47,52,99,2.9167523124357655,53.89509694317298
Task_32903,2783,517,190,172,362,5.372586872586872,53.90857612969497
Task_32904,2342,713,152,83,235,3.280112044817927,46.552603810815555
Task_32905,2156,636,166,100,266,3.3846153846153846,43.82167111553832
Task_32906,1051,708,115,113,228,1.4823695345557122,26.34975648296668
Task_32907,2539,94,117,193,310,26.726315789473684,47.46111102960277
Task_32908,552,361,146,87,233,1.5248618784530388,17.100674996522958
Task_32909,2057,80,183,115,298,25.395061728395063,39.67625602888459
Task_32910,2354,847,131,79,210,2.775943396226415,47.04499463947298
Task_32911,1929,573,66,165,231,3.3606271777003482,40.0876277846262
Task_32912,2867,991,155,165,320,2.8901209677419355,56.5383316896234
Task_32913,1475,517,88,90,178,2.8474903474903477,31.91313025005265
Task_32914,1219,487,47,18,65,2.497950819672131,25.646280411126828
Task_32915,834,646,28,178,206,1.2890262751159196,22.653148097579635
Task_32916,1405,538,100,171,271,2.6066790352504636,31.746199033048125
Task_32917,1045,981,140,175,315,1.0641547861507128,27.489665395984833
Task_32918,2517,739,160,36,196,3.401351351351351,48.78005436511174
Task_32919,798,495,175,165,340,1.6088709677419355,22.28972866262298
Task_32920,1358,231,75,166,241,5.853448275862069,29.998889066780364
Task_32921,1841,646,162,47,209,2.8454404945904175,37.83215540847803
Task_32922,525,555,87,33,120,0.9442446043165468,15.98724923833124
Task_32923,1184,443,165,144,309,2.6666666666666665,28.079104973961282
Task_32924,2152,818,136,104,240,2.6275946275946276,44.21854772852845
Task_32925,2536,803,93,198,291,3.154228855721393,50.73504141898067
Task_32926,2897,188,51,156,207,15.328042328042327,54.050176441354814
Task_32927,2116,502,170,32,202,4.20675944333996,41.70400016249148
Task_32928,1885,361,86,122,208,5.207182320441989,38.46130437881277
Task_32929,2384,418,54,79,133,5.689737470167064,45.876085631257894
Task_32930,2781,768,118,165,283,3.6163849154746424,54.31011544458687
Task_32931,1381,708,53,84,137,1.9478138222849084,30.87331253324957
Task_32932,1373,247,73,174,247,5.536290322580645,30.320722287307166
Task_32933,2966,199,113,84,197,14.83,54.534341001511585
Task_32934,1062,728,104,11,115,1.4567901234567902,24.74607811022172
Task_32935,1398,478,131,197,328,2.918580375782881,31.740739034064816
Task_32936,2916,479,199,129,328,6.075,55.674125287212235
Task_32937,2821,330,113,55,168,8.522658610271904,52.22298111033073
Task_32938,2002,555,31,116,147,3.6007194244604315,40.35611965261679
Task_32939,1014,971,142,31,173,1.0432098765432098,25.483979658489346
Task_32940,2634,592,160,167,327,4.441821247892074,51.625258232308305
Task_32941,2902,203,194,173,367,14.22549019607843,54.71517609972432
Task_32942,1656,811,118,26,144,2.039408866995074,34.832796978160566
Task_32943,656,376,111,54,165,1.740053050397878,18.21307973505664
Task_32944,1453,390,11,120,131,3.7161125319693094,31.0950290893411
Task_32945,1999,621,35,67,102,3.2138263665594855,39.73718291194134
Task_32946,2400,125,44,14,58,19.047619047619047,42.92947709589547
Task_32947,630,832,137,126,263,0.7563025210084033,20.19479384097025
Task_32948,1110,421,133,65,198,2.6303317535545023,25.782053331496538
Task_32949,2567,427,88,28,116,5.997663551401869,47.81503010862058
Task_32950,2931,291,33,76,109,10.037671232876713,53.6839891046828
Task_32951,1119,301,43,109,152,3.705298013245033,25.501018231034028
Task_32952,2763,384,126,167,293,7.176623376623376,52.835567183230715
Task_32953,1064,486,124,92,216,2.184804928131417,25.719309424830865
Task_32954,2069,686,118,66,184,3.011644832605531,41.524072491885676
Task_32955,1127,486,100,156,256,2.3141683778234086,27.091436768433685
Task_32956,2039,803,32,128,160,2.5360696517412937,41.78333235070604
Task_32957,778,84,138,25,163,9.152941176470588,18.076445361180095
Task_32958,728,118,37,107,144,6.117647058823529,18.052901761052723
Task_32959,2453,979,28,43,71,2.503061224489796,47.03032306788959
Task_32960,663,80,186,195,381,8.185185185185185,18.3258717935652
Task_32961,1254,182,127,131,258,6.852459016393443,27.90868903818765
Task_32962,2875,412,164,76,240,6.961259079903147,53.96799982606581
Task_32963,921,873,182,155,337,1.0537757437070938,25.269223068195032
Task_32964,962,587,163,144,307,1.6360544217687074,24.99421813468825
Task_32965,2241,1016,98,61,159,2.2035398230088497,45.01853730956244
Task_32966,2381,869,139,157,296,2.7367816091954023,48.336338944697324
Task_32967,979,810,173,41,214,1.2071516646115907,24.753108905843945
Task_32968,870,888,33,195,228,0.9786276715410573,24.068738248340676
Task_32969,1337,346,27,60,87,3.8530259365994235,27.990620637154223
Task_32970,1519,963,45,188,233,1.5757261410788381,34.6925331218967
Task_32971,855,819,186,17,203,1.0426829268292683,22.453641755035363
Task_32972,802,807,194,15,209,0.9925742574257426,21.833400821380206
Task_32973,723,146,155,44,199,4.918367346938775,18.18155410783564
Task_32974,581,642,15,129,144,0.9035769828926905,18.02748633810253
Task_32975,1908,995,193,109,302,1.9156626506024097,41.19035968471096
Task_32976,2426,152,53,63,116,15.856209150326798,44.62209987246618
Task_32977,2156,480,67,61,128,4.482328482328482,42.13987098592759
Task_32978,1813,555,163,23,186,3.2607913669064748,36.804454733673744
Task_32979,1869,435,128,195,323,4.286697247706422,39.03285362301463
Task_32980,763,900,106,187,293,0.8468368479467259,22.741651029106094
Task_32981,619,438,10,55,65,1.4100227790432802,16.539744354744546
Task_32982,2173,436,101,169,270,4.97254004576659,43.57042564828384
Task_32983,568,358,116,136,252,1.5821727019498608,17.751949671358002
Task_32984,2168,671,168,28,196,3.2261904761904763,42.99915959003177
Task_32985,819,234,102,113,215,3.4851063829787234,21.16443440246549
Task_32986,618,1007,81,86,167,0.6130952380952381,19.969279988056858
Task_32987,2914,697,17,129,146,4.174785100286533,55.16323735422441
Task_32988,2024,258,40,112,152,7.814671814671815,39.66306249685929
Task_32989,1891,913,141,15,156,2.0689277899343543,38.763425889293444
Task_32990,1885,97,50,100,150,19.23469387755102,36.018102021512156
Task_32991,2639,704,135,112,247,3.743262411347518,51.61882938656807
Task_32992,2301,467,157,137,294,4.916666666666667,45.75833948916582
Task_32993,2022,83,88,142,230,24.071428571428573,38.88867787361535
Task_32994,2508,911,139,101,240,2.75,50.14538506277103
Task_32995,1634,106,47,95,142,15.271028037383177,32.10338806709421
Task_32996,2768,466,134,93,227,5.927194860813705,52.715459278434025
Task_32997,873,113,13,113,126,7.657894736842105,20.160512348242424
Task_32998,1020,619,115,185,300,1.6451612903225807,26.041081786263543
Task_32999,888,527,136,147,283,1.6818181818181819,23.53135454377757
Task_33000,1003,658,196,34,230,1.5220030349013658,24.69887465437731
Task_33001,1472,531,90,120,210,2.7669172932330826,32.48452204215668
Task_33002,598,966,52,92,144,0.6184074457083765,19.542786485543406
Task_33003,2797,338,119,189,308,8.250737463126844,53.31637581737258
Task_33004,2519,896,179,118,297,2.8082497212931994,50.55465001593026
Task_33005,1977,823,45,53,98,2.3992718446601944,39.79050030744426
Task_33006,1071,960,44,131,175,1.1144640998959416,26.97923718158329
Task_33007,923,437,57,102,159,2.1073059360730593,23.02295842486836
Task_33008,1115,949,159,38,197,1.1736842105263159,27.294472282971245
Task_33009,1482,539,160,156,316,2.7444444444444445,33.14936840106467
Task_33010,1078,183,149,25,174,5.858695652173913,24.005788977398797
Task_33011,1961,600,42,119,161,3.262895174708819,39.88619904450662
Task_33012,803,133,132,29,161,5.992537313432836,18.891063654352035
Task_33013,2765,373,105,83,188,7.393048128342246,51.89210235531744
Task_33014,2286,526,54,19,73,4.337760910815939,42.64795827164389
Task_33015,931,994,53,197,250,0.935678391959799,25.581819468246447
Task_33016,1892,351,130,139,269,5.375,38.796754212921336
Task_33017,1152,469,154,57,211,2.451063829787234,26.585758816624733
Task_33018,1435,358,186,91,277,3.997214484679666,31.41025647165304
Task_33019,1931,270,166,140,306,7.125461254612546,39.306959348230365
Task_33020,2611,144,29,87,116,18.00689655172414,47.701883909939816
Task_33021,2394,674,179,126,305,3.546666666666667,47.92521492950856
Task_33022,2167,918,32,146,178,2.3579978237214365,44.41190435096062
Task_33023,2932,243,55,16,71,12.01639344262295,51.94710281468122
Task_33024,1317,956,150,87,237,1.3761755485893417,31.0602961086478
Task_33025,1216,512,71,49,120,2.3703703703703702,26.84172229180381
Task_33026,2356,346,15,39,54,6.789625360230548,43.53523676009945
Task_33027,1937,75,77,130,207,25.486842105263158,37.500416044935456
Task_33028,692,789,163,198,361,0.8759493670886076,21.604587862125907
Task_33029,961,1003,103,67,170,0.9571713147410359,24.963308983605497
Task_33030,1423,693,123,15,138,2.0504322766570606,30.574836802977444
Task_33031,526,850,170,60,230,0.618096357226792,18.180542362435265
Task_33032,1484,67,155,90,245,21.823529411764707,30.307809063332243
Task_33033,987,1015,90,88,178,0.9714566929133859,25.562703972698895
Task_33034,844,685,95,149,244,1.2303206997084548,23.105915244731218
Task_33035,2078,131,25,143,168,15.742424242424242,39.82051003690893
Task_33036,2160,881,146,183,329,2.4489795918367347,45.0589493444289
Task_33037,2205,533,158,66,224,4.129213483146067,43.56858127851475
Task_33038,2353,925,180,42,222,2.541036717062635,46.86917348123104
Task_33039,672,445,84,132,216,1.506726457399103,19.548155766814677
Task_33040,2058,709,13,103,116,2.898591549295775,41.59153739476283
Task_33041,2453,213,78,64,142,11.462616822429906,45.90696735532283
Task_33042,2009,328,85,127,212,6.1063829787234045,40.34327286001241
Task_33043,525,616,112,144,256,0.8508914100486223,17.871448911013047
Task_33044,1911,93,84,162,246,20.329787234042552,37.27441076015913
Task_33045,2091,759,90,171,261,2.751315789473684,43.30964378209588
Task_33046,2174,674,102,172,274,3.220740740740741,44.3682488473054
Task_33047,1923,267,175,117,292,7.175373134328358,39.07323042971673
Task_33048,1788,288,61,187,248,6.186851211072664,37.0441935738908
Task_33049,1487,540,136,129,265,2.7486136783733826,32.962252392852946
Task_33050,2048,823,149,195,344,2.4854368932038833,43.18856648599461
Task_33051,973,607,27,104,131,1.600328947368421,24.186683181201214
Task_33052,2865,744,136,50,186,3.8456375838926173,54.188615491052055
Task_33053,795,470,188,189,377,1.6878980891719746,22.36595329422721
Task_33054,1292,221,177,72,249,5.81981981981982,28.267922237728914
Task_33055,1713,590,113,139,252,2.8984771573604062,36.65471818834585
Task_33056,576,368,110,121,231,1.5609756097560976,17.793303045008702
Task_33057,1202,107,109,193,302,11.12962962962963,26.560554566218794
Task_33058,2431,320,118,27,145,7.573208722741433,45.59660944155502
Task_33059,2841,766,104,176,280,3.7040417209908734,55.25695448167403
Task_33060,511,509,192,87,279,1.0019607843137255,17.012735625132756
Task_33061,537,123,99,98,197,4.330645161290323,15.819993348410764
Task_33062,1517,507,90,39,129,2.986220472440945,31.68821472612841
Task_33063,2620,197,90,56,146,13.232323232323232,48.53154641130075
Task_33064,2152,243,32,50,82,8.819672131147541,40.3990746764536
Task_33065,2417,192,87,150,237,12.523316062176166,46.41056585402561
Task_33066,2774,412,12,154,166,6.716707021791768,52.3430528451532
Task_33067,1736,290,110,52,162,5.965635738831615,34.85812006969038
Task_33068,1795,480,15,15,30,3.731808731808732,34.64845709463372
Task_33069,1815,851,170,88,258,2.130281690140845,38.78783279670284
Task_33070,1705,193,196,175,371,8.788659793814434,35.80864037804897
Task_33071,2641,145,71,169,240,18.089041095890412,49.589016825975555
Task_33072,2272,1009,12,135,147,2.2495049504950497,46.05220026269643
Task_33073,1260,614,172,21,193,2.048780487804878,28.34145132990348
Task_33074,2380,668,142,168,310,3.5575485799701045,47.76861525651486
Task_33075,2668,814,143,54,197,3.2736196319018407,51.658263651101606
Task_33076,785,94,153,17,170,8.263157894736842,18.118921537909483
Task_33077,507,474,104,117,221,1.0673684210526315,16.88751217274772
Task_33078,862,248,160,91,251,3.461847389558233,21.873835650818
Task_33079,1966,592,149,112,261,3.315345699831366,40.668571376601925
Task_33080,2501,216,49,41,90,11.525345622119815,45.756301950757766
Task_33081,1412,175,88,122,210,8.022727272727273,29.947675187831447
Task_33082,520,239,24,84,108,2.1666666666666665,15.433063299412433
Task_33083,1014,308,161,42,203,3.2815533980582523,23.634085567951114
Task_33084,1189,750,164,106,270,1.5832223701731025,28.8454348921107
Task_33085,858,491,106,42,148,1.7439024390243902,21.20063748651674
Task_33086,1179,756,46,23,69,1.5574636723910171,26.105830658037544
Task_33087,1271,348,29,160,189,3.641833810888252,28.64834706067099
Task_33088,2071,418,33,59,92,4.94272076372315,40.009611514179745
Task_33089,950,361,28,74,102,2.6243093922651934,22.416099328271827
Task_33090,2854,600,111,119,230,4.748752079866889,54.627290519232
Task_33091,1241,163,19,29,48,7.567073170731708,25.151022093724876
Task_33092,669,554,167,83,250,1.2054054054054053,19.577070623674015
Task_33093,1835,517,119,198,317,3.5424710424710426,38.734777715189715
Task_33094,1002,456,165,135,300,2.192560175054705,25.185768960696635
Task_33095,1488,712,75,139,214,2.0869565217391304,33.4383646393138
Task_33096,2794,265,96,44,140,10.503759398496241,51.10278509593624
Task_33097,1350,662,35,129,164,2.0361990950226243,30.638018698891226
Task_33098,1572,425,186,128,314,3.6901408450704225,34.16146963261533
Task_33099,881,249,45,147,192,3.524,22.139780217869646
Task_33100,1984,528,10,148,158,3.7504725897920603,40.03243332985925
Task_33101,1881,387,148,56,204,4.847938144329897,37.90076187137854
Task_33102,2755,880,140,137,277,3.127128263337117,54.181747480557156
Task_33103,2611,875,193,113,306,2.980593607305936,51.97996159491106
Task_33104,2034,870,159,119,278,2.3352468427095294,42.70452303339717
Task_33105,1104,346,146,192,338,3.1815561959654177,26.704727500483653
Task_33106,1726,189,117,122,239,9.08421052631579,35.46105998512246
Task_33107,2262,870,77,51,128,2.5970149253731343,45.01323094397039
Task_33108,927,86,29,46,75,10.655172413793103,19.482430945600075
Task_33109,2026,603,111,82,193,3.3543046357615895,41.01782263033146
Task_33110,800,201,17,103,120,3.9603960396039604,19.922035073229736
Task_33111,1479,426,90,40,130,3.4637002341920375,30.848779034909388
Task_33112,1271,583,60,64,124,2.1763698630136985,28.35624592394268
Task_33113,1465,614,69,70,139,2.3821138211382116,31.632950649558353
Task_33114,1244,457,185,71,256,2.7161572052401746,28.29145181450922
Task_33115,1991,418,57,102,159,4.751789976133652,39.86432977196145
Task_33116,1112,551,111,184,295,2.0144927536231885,27.274937376020677
Task_33117,2396,242,83,162,245,9.860082304526749,46.36491991283554
Task_33118,1734,224,42,32,74,7.706666666666667,33.2069393555067
Task_33119,1075,918,191,75,266,1.1697497279651796,27.16384770409721
Task_33120,2698,680,187,65,252,3.9618208516886932,51.991090897054846
Task_33121,1824,78,200,147,347,23.088607594936708,36.24719790712815
Task_33122,2136,655,145,94,239,3.2560975609756095,43.378836616717656
Task_33123,685,407,192,92,284,1.678921568627451,19.76537872265457
Task_33124,546,931,17,91,108,0.5858369098712446,18.064494154194932
Task_33125,2082,738,51,98,149,2.817320703653586,42.34172316616058
Task_33126,2136,620,94,136,230,3.4396135265700485,43.4286507339018
Task_33127,1334,267,191,133,324,4.977611940298507,29.932340836386768
Task_33128,1417,671,32,23,55,2.1086309523809526,29.672080588117357
Task_33129,2219,590,110,90,200,3.754653130287648,44.19680579494127
Task_33130,2899,820,39,145,184,3.5310596833130328,55.70629537887489
Task_33131,2974,131,101,94,195,22.53030303030303,54.16845854899841
Task_33132,2540,458,151,120,271,5.533769063180828,49.38356435482041
Task_33133,2400,942,21,55,76,2.545068928950159,46.37132324182688
Task_33134,1253,443,86,11,97,2.8220720720720722,26.804649436829312
Task_33135,1442,97,52,75,127,14.714285714285714,28.72030067939672
Task_33136,679,736,52,56,108,0.921302578018996,19.066261242047823
Task_33137,2962,912,30,20,50,3.2442497261774372,54.67748245274254
Task_33138,2111,319,36,146,182,6.596875,41.60140228724093
Task_33139,2734,402,81,93,174,6.784119106699752,51.75507770961207
Task_33140,917,638,174,142,316,1.4350547730829422,24.423128706859046
Task_33141,1035,817,150,82,232,1.265281173594132,26.110823390043027
Task_33142,1115,604,174,79,253,1.8429752066115703,26.852182474279147
Task_33143,1145,687,125,28,153,1.6642441860465116,26.345580551414987
Task_33144,2702,787,92,65,157,3.4289340101522843,51.73867461908558
Task_33145,1412,623,102,173,275,2.2628205128205128,32.14502424506785
Task_33146,709,495,46,199,245,1.4294354838709677,20.44341649500791
Task_33147,1089,752,40,183,223,1.4462151394422311,27.107317713912725
Task_33148,2059,672,119,136,255,3.0594353640416045,42.40201223451524
Task_33149,2048,151,198,85,283,13.473684210526315,40.00224124969099
Task_33150,1615,762,33,96,129,2.1166448230668413,34.9469492735276
Task_33151,1068,423,98,200,298,2.518867924528302,26.226266618084185
Task_33152,2538,764,98,117,215,3.3176470588235296,50.08493216523004
Task_33153,863,564,144,79,223,1.527433628318584,22.56347735380166
Task_33154,2965,490,123,149,272,6.038696537678208,56.26272471589939
Task_33155,2170,919,187,104,291,2.358695652173913,45.04879050246992
Task_33156,1243,980,95,144,239,1.2670744138634047,30.329226857539606
Task_33157,1772,204,55,33,88,8.64390243902439,34.10914744433603
Task_33158,502,963,153,128,281,0.520746887966805,18.87028963754442
Task_33159,2029,534,137,151,288,3.7925233644859815,41.66089878288776
Task_33160,2542,402,89,92,181,6.3076923076923075,48.53008550971549
Task_33161,1565,126,115,141,256,12.32283464566929,32.36552633221789
Task_33162,1153,961,104,129,233,1.1985446985446986,28.757001939787784
Task_33163,1616,436,154,128,282,3.6979405034324944,34.748912445690216
Task_33164,824,96,96,59,155,8.494845360824742,18.949353614999133
Task_33165,589,577,100,168,268,1.019031141868512,18.793383076985766
Task_33166,850,745,157,12,169,1.1394101876675604,21.92693310741987
Task_33167,853,392,63,196,259,2.1704834605597965,22.658353310200027
Task_33168,2367,657,59,39,98,3.5972644376899696,45.06018992986771
Task_33169,1371,208,44,53,97,6.559808612440191,28.265300145815857
Task_33170,1415,481,25,91,116,2.9356846473029043,30.605852517865134
Task_33171,2835,156,67,113,180,18.05732484076433,52.1089270984131
Task_33172,2703,897,158,187,345,3.010022271714922,53.79078493091718
Task_33173,580,881,74,142,216,0.6575963718820862,19.65532032402941
Task_33174,924,841,45,164,209,1.0973871733966747,24.551929711480653
Task_33175,2712,922,158,92,250,2.9382448537378116,53.343424840858624
Task_33176,2046,376,50,15,65,5.427055702917772,38.437993606014864
Task_33177,1023,178,178,36,214,5.715083798882682,23.213048170514366
Task_33178,791,951,181,103,284,0.8308823529411765,23.1792078798531
Task_33179,1016,711,199,103,302,1.4269662921348314,26.097908179019353
Task_33180,2642,905,70,195,265,2.9161147902869757,52.64082964272172
Task_33181,1553,945,118,80,198,1.6416490486257929,34.60378859132858
Task_33182,1538,66,162,62,224,22.955223880597014,30.73203548011988
Task_33183,2441,558,77,133,210,4.366726296958855,48.00910174042399
Task_33184,647,350,167,163,330,1.8433048433048433,19.410244880277155
Task_33185,1557,140,131,141,272,11.042553191489361,32.435336918699875
Task_33186,2981,423,28,189,217,7.03066037735849,56.14656374238371
Task_33187,2406,492,168,119,287,4.880324543610548,47.44345296750898
Task_33188,1369,317,69,142,211,4.30503144654088,30.27728929353791
Task_33189,2956,806,34,150,184,3.6629491945477075,56.59174230104296
Task_33190,809,195,98,155,253,4.127551020408164,21.063352046020558
Task_33191,2379,857,46,87,133,2.772727272727273,47.11977025580279
Task_33192,2977,97,128,187,315,30.377551020408163,54.36969062505013
Task_33193,1335,404,48,66,114,3.2962962962962963,28.848279268105657
Task_33194,2761,850,71,107,178,3.244418331374853,53.63787005124721
Task_33195,1320,453,34,59,93,2.907488986784141,28.22087611854946
Task_33196,2519,825,10,11,21,3.049636803874092,47.11146513389869
Task_33197,1665,404,182,19,201,4.111111111111111,34.010604270494355
Task_33198,1383,240,131,75,206,5.738589211618257,29.633507478762215
Task_33199,1699,116,164,66,230,14.521367521367521,33.64626710914164
Task_33200,1860,585,172,80,252,3.174061433447099,38.59511156259068
Task_33201,2721,975,131,103,234,2.7879098360655736,53.69627582580964
Task_33202,1611,479,34,107,141,3.35625,33.86219477698788
Task_33203,2432,847,199,132,331,2.8679245283018866,49.19671588041481
Task_33204,2374,706,62,37,99,3.3578500707213577,45.32051060725399
Task_33205,656,559,163,148,311,1.1714285714285715,20.01671007317812
Task_33206,2591,612,84,75,159,4.226753670473083,49.51208663184752
Task_33207,2253,277,38,115,153,8.10431654676259,43.35798430830338
Task_33208,986,219,184,35,219,4.4818181818181815,22.98547263683501
Task_33209,864,650,135,110,245,1.327188940092166,23.28198337562711
Task_33210,2038,948,85,133,218,2.1475237091675448,42.808230268636215
Task_33211,789,303,73,124,197,2.5953947368421053,20.976742382187762
Task_33212,1439,82,108,37,145,17.337349397590362,28.191302945751545
Task_33213,1044,457,64,32,96,2.2794759825327513,23.494975345531046
Task_33214,2539,459,72,129,201,5.519565217391304,49.19567950880715
Task_33215,912,566,130,101,231,1.6084656084656084,23.731359087825734
Task_33216,827,139,68,120,188,5.9071428571428575,20.534427372300414
Task_33217,2132,616,35,198,233,3.4554294975688817,43.402706093109465
Task_33218,565,210,177,14,191,2.677725118483412,15.997567988453278
Task_33219,2108,242,187,90,277,8.674897119341564,41.63536429375955
Task_33220,2818,1011,127,97,224,2.7845849802371543,55.32547219912863
Task_33221,2513,571,65,197,262,4.393356643356643,49.518385397809254
Task_33222,2653,80,17,166,183,32.75308641975309,48.37873562093995
Task_33223,926,189,200,93,293,4.873684210526315,22.991135788027506
Task_33224,2598,954,169,163,332,2.7204188481675393,52.21127979159157
Task_33225,2157,934,95,36,131,2.306951871657754,43.27153638708188
Task_33226,1950,582,50,131,181,3.3447684391080617,40.057982444236636
Task_33227,802,674,36,39,75,1.1881481481481482,19.905843787698114
Task_33228,2415,975,150,112,262,2.4743852459016393,48.98659476118118
Task_33229,2120,169,81,65,146,12.470588235294118,40.302795833165256
Task_33230,2163,264,172,80,252,8.162264150943397,42.335780383097116
Task_33231,2260,146,144,54,198,15.374149659863946,42.70386889197746
Task_33232,2820,574,190,32,222,4.904347826086957,53.17198118220477
Task_33233,1023,288,163,179,342,3.5397923875432524,25.234799120107976
Task_33234,2053,112,37,22,59,18.168141592920353,37.2809929659455
Task_33235,788,923,25,84,109,0.8528138528138528,21.697526898310333
Task_33236,945,215,125,118,243,4.375,23.22422685351334
Task_33237,1478,587,100,170,270,2.5136054421768708,33.05037008655607
Task_33238,2519,928,72,44,116,2.7115177610333694,48.65236107489908
Task_33239,959,235,101,89,190,4.063559322033898,23.03059085096861
Task_33240,920,615,87,76,163,1.4935064935064934,23.155768609344808
Task_33241,568,639,132,108,240,0.8875,18.498821289470495
Task_33242,1935,682,21,176,197,2.833089311859444,40.24702933462969
Task_33243,1517,855,106,148,254,1.772196261682243,34.38711848717707
Task_33244,2772,381,66,67,133,7.2565445026178015,51.627427706055556
Task_33245,2321,950,29,184,213,2.440588853838065,47.34479833423817
Task_33246,1760,322,36,58,94,5.4489164086687305,34.7404813411456
Task_33247,2514,453,99,168,267,5.537444933920705,49.00972145932864
Task_33248,2411,178,86,180,266,13.46927374301676,46.059020674545614
Task_33249,1332,677,130,178,308,1.9646017699115044,31.202833881515357
Task_33250,613,370,192,71,263,1.6522911051212938,18.06815915846712
Task_33251,1779,946,97,75,172,1.8785638859556495,37.932558410854675
Task_33252,1548,678,126,151,277,2.279823269513991,34.4480067819025
Task_33253,2941,397,87,33,120,7.389447236180905,53.655678512710374
Task_33254,1310,567,146,93,239,2.306338028169014,30.009249633891326
Task_33255,1712,409,12,86,98,4.175609756097561,34.639620570691996
Task_33256,2635,554,172,185,357,4.747747747747748,51.68103602985491
Task_33257,1620,362,120,14,134,4.462809917355372,32.68954369730686
Task_33258,1544,754,47,68,115,2.0450331125827814,33.242950417384435
Task_33259,1258,832,145,11,156,1.510204081632653,28.47141387017589
Task_33260,2688,883,195,63,258,3.0407239819004523,52.47430126135966
Task_33261,505,612,172,140,312,0.8238172920065253,17.780430418941847
Task_33262,2738,529,147,57,204,5.166037735849057,51.854346158940096
Task_33263,1514,421,176,94,270,3.5876777251184833,32.92703930588576
Task_33264,1074,555,61,143,204,1.9316546762589928,26.343500603110943
Task_33265,1198,517,189,112,301,2.312741312741313,28.451372972872914
Task_33266,2754,334,72,139,211,8.22089552238806,52.238944770065075
Task_33267,2340,211,10,17,27,11.037735849056604,42.232294626061744
Task_33268,2640,352,46,140,186,7.478753541076487,50.163807091344324
Task_33269,1767,122,69,20,89,14.365853658536585,33.27512787161913
Task_33270,1932,631,61,72,133,3.0569620253164556,39.20444810042979
Task_33271,927,567,148,115,263,1.6320422535211268,24.136753614771987
Task_33272,1227,906,90,165,255,1.3528114663726571,29.993992856408685
Task_33273,2123,751,35,134,169,2.8231382978723403,43.11824586733184
Task_33274,703,653,17,177,194,1.0749235474006116,20.367279815022556
Task_33275,2174,907,198,24,222,2.394273127753304,43.9164745394315
Task_33276,2489,585,135,199,334,4.247440273037543,49.38514687626522
Task_33277,2136,854,105,38,143,2.498245614035088,42.63311803208649
Task_33278,735,388,28,182,210,1.8894601542416452,20.450272158656976
Task_33279,1872,91,88,54,142,20.347826086956523,35.2604437259024
Task_33280,1046,650,22,82,104,1.6067588325652842,24.913899652152093
Task_33281,1698,439,161,159,320,3.859090909090909,36.273060220192264
Task_33282,2822,297,25,134,159,9.46979865771812,52.54470399624578
Task_33283,2483,336,99,100,199,7.367952522255193,47.72316763735131
Task_33284,866,745,109,116,225,1.160857908847185,23.48557204351964
Task_33285,627,277,37,55,92,2.2553956834532376,16.773816427997698
Task_33286,1020,680,176,34,210,1.497797356828194,24.946441092992064
Task_33287,2571,946,13,158,171,2.7148891235480463,50.88685467531968
Task_33288,1453,693,114,199,313,2.0936599423631126,33.22272350295257
Task_33289,2550,328,125,144,269,7.750759878419453,49.13364761792565
Task_33290,1228,528,174,198,372,2.321361058601134,29.407019201507666
Task_33291,2137,336,143,142,285,6.341246290801187,42.69829956539996
Task_33292,1183,953,95,187,282,1.240041928721174,29.534430833605683
Task_33293,715,167,155,112,267,4.255952380952381,19.241177846631942
Task_33294,1193,982,112,34,146,1.2136317395727365,28.085793904973254
Task_33295,2430,751,16,119,135,3.231382978723404,47.633450113684745
Task_33296,2913,266,141,170,311,10.910112359550562,54.87882463783825
Task_33297,2352,525,200,194,394,4.47148288973384,47.286988121005685
Task_33298,2658,620,31,126,157,4.280193236714976,50.99402572036745
Task_33299,2479,890,78,10,88,2.782267115600449,47.558364107999274
Task_33300,670,664,17,27,44,1.0075187969924813,17.73982113764036
Task_33301,2031,541,156,104,260,3.7472324723247232,41.51977034971909
Task_33302,2648,111,96,130,226,23.642857142857142,48.91896491311388
Task_33303,921,948,84,193,277,0.9704952581664911,25.322846852993624
Task_33304,2571,692,76,74,150,3.70995670995671,49.502685938856224
Task_33305,648,607,50,25,75,1.0657894736842106,17.333446811483917
Task_33306,2074,378,95,199,294,5.472295514511873,42.03604753581235
Task_33307,2889,181,190,32,222,15.873626373626374,52.7019221735006
Task_33308,1251,127,122,130,252,9.7734375,27.366137360268766
Task_33309,2967,173,39,57,96,17.051724137931036,53.00291301793832
Task_33310,1169,148,26,185,211,7.845637583892618,26.18058601011867
Task_33311,2983,780,11,176,187,3.819462227912932,57.09625061259204
Task_33312,1972,896,90,61,151,2.198439241917503,40.35550103143287
Task_33313,2851,175,157,38,195,16.198863636363637,51.92916967769923
Task_33314,2464,224,22,148,170,10.95111111111111,46.743770983871805
Task_33315,1637,1008,99,139,238,1.622398414271556,36.67993418987573
Task_33316,2210,723,147,197,344,3.052486187845304,45.44479611221434
Task_33317,1644,803,60,99,159,2.044776119402985,35.534629889537435
Task_33318,760,372,124,34,158,2.037533512064343,19.35615450339934
Task_33319,904,174,196,116,312,5.1657142857142855,22.370403931520148
Task_33320,2826,210,146,160,306,13.393364928909953,53.250247137045505
Task_33321,1310,138,115,151,266,9.424460431654676,28.50589190791116
Task_33322,846,611,76,174,250,1.3823529411764706,23.10658549371601
Task_33323,1941,209,112,118,230,9.242857142857142,38.86986133009973
Task_33324,2193,950,102,86,188,2.305993690851735,44.70688823389806
Task_33325,2765,422,47,82,129,6.536643026004728,51.86814610323132
Task_33326,2421,774,91,172,263,3.1238709677419356,48.59510445817275
Task_33327,2734,833,97,118,215,3.278177458033573,53.418100709502404
Task_33328,844,727,162,139,301,1.1593406593406594,23.457509873026527
Task_33329,1061,275,14,13,27,3.8442028985507246,22.38042577162832
Task_33330,2942,126,109,156,265,23.165354330708663,54.10040516621967
Task_33331,831,239,108,155,263,3.4625,21.64842770276989
Task_33332,518,536,59,115,174,0.9646182495344506,17.089718948515277
Task_33333,2842,920,136,150,286,3.0857763300760044,55.74509735664149
Task_33334,2872,387,39,177,216,7.402061855670103,54.25032239567793
Task_33335,2175,914,92,124,216,2.377049180327869,44.881242049355116
Task_33336,2664,987,14,85,99,2.6963562753036436,51.55993379283535
Task_33337,2684,945,180,79,259,2.8372093023255816,52.800983637782984
Task_33338,1563,666,69,77,146,2.343328335832084,33.52338539005208
Task_33339,725,228,116,192,308,3.165938864628821,20.194869541002472
Task_33340,2808,354,119,199,318,7.909859154929578,53.605169878483196
Task_33341,1311,332,199,37,236,3.936936936936937,28.582281108361467
Task_33342,715,396,82,144,226,1.801007556675063,20.22688005137269
Task_33343,2503,242,77,42,119,10.300411522633745,46.2212874163815
Task_33344,807,839,73,142,215,0.9607142857142857,22.915007517174235
Task_33345,2268,914,70,162,232,2.4786885245901638,46.545610934800315
Task_33346,1177,831,150,153,303,1.4146634615384615,29.09882419360201
Task_33347,1276,132,152,136,288,9.593984962406015,27.964882586395174
Task_33348,924,747,39,106,145,1.2352941176470589,23.674846786981178
Task_33349,2515,938,102,143,245,2.6783812566560172,50.42469184766477
Task_33350,2526,615,178,143,321,4.10064935064935,49.92596142943904
Task_33351,1963,180,174,115,289,10.845303867403315,38.98626012458082
Task_33352,1726,689,81,114,195,2.5014492753623188,36.98178378360455
Task_33353,1055,244,142,85,227,4.3061224489795915,24.664137533682123
Task_33354,1164,509,128,178,306,2.2823529411764705,28.00719833363911
Task_33355,1489,1014,130,153,283,1.4669950738916255,34.53438334984511
Task_33356,2240,943,179,14,193,2.3728813559322033,44.835818060737815
Task_33357,1071,735,118,189,307,1.455163043478261,27.192329717516813
Task_33358,1407,483,11,62,73,2.90702479338843,29.2013293617574
Task_33359,697,98,167,70,237,7.040404040404041,17.599141669660245
Task_33360,1910,70,24,149,173,26.901408450704224,36.784965874084094
Task_33361,2161,682,107,155,262,3.16398243045388,44.10852483457504
Task_33362,2775,986,136,157,293,2.811550151975684,54.931398545055025
Task_33363,2047,472,85,90,175,4.3276955602537,40.95193439860453
Task_33364,713,776,102,176,278,0.9176319176319176,21.491392734632893
Task_33365,622,285,37,192,229,2.174825174825175,18.415849852390068
Task_33366,2969,367,121,170,291,8.067934782608695,56.032366165583106
Task_33367,1655,352,192,167,359,4.688385269121813,35.49784421680214
Task_33368,2059,791,32,108,140,2.599747474747475,41.948644354387476
Task_33369,1958,374,81,15,96,5.221333333333333,37.69017423586522
Task_33370,2265,987,128,150,278,2.29251012145749,46.77476487068267
Task_33371,2952,812,152,94,246,3.6309963099630997,56.831348714975185
Task_33372,2275,189,40,65,105,11.973684210526315,42.82798035787624
Task_33373,955,561,175,121,296,1.699288256227758,24.71892847149448
Task_33374,1258,493,115,129,244,2.5465587044534415,29.09366503082011
Task_33375,519,371,127,52,179,1.3951612903225807,15.982549763748835
Task_33376,1822,603,200,86,286,3.0165562913907285,38.233347622426216
Task_33377,1076,398,157,152,309,2.6967418546365916,26.238784728565737
Task_33378,2740,404,192,151,343,6.765432098765432,52.74060507247659
Task_33379,1356,140,117,181,298,9.617021276595745,29.44518373296673
Task_33380,2046,824,109,167,276,2.48,42.812476283833895
Task_33381,1005,694,160,185,345,1.4460431654676258,26.184842503418324
Task_33382,2120,506,99,192,291,4.181459566074951,43.08748770092499
Task_33383,2132,901,95,73,168,2.3636363636363638,43.257328080582056
Task_33384,2605,357,190,147,337,7.276536312849162,50.41363233526014
Task_33385,2539,121,146,42,188,20.811475409836067,46.52188394044983
Task_33386,2168,920,142,175,317,2.3539630836047776,45.241477431248974
Task_33387,2202,731,164,32,196,3.0081967213114753,43.764301277425226
Task_33388,864,225,94,14,108,3.8230088495575223,20.14688643759393
Task_33389,2742,759,76,197,273,3.607894736842105,53.803958179562045
Task_33390,1509,718,186,32,218,2.09874826147427,32.844893769302146
Task_33391,925,771,72,141,213,1.1981865284974094,24.602628337174824
Task_33392,937,510,12,148,160,1.8336594911937378,23.405196821718892
Task_33393,2007,200,27,106,133,9.985074626865671,39.22192757742359
Task_33394,2613,449,172,14,186,5.806666666666667,49.0082885748654
Task_33395,1576,1012,112,70,182,1.5557749259624876,34.72760759763358
Task_33396,1122,289,136,196,332,3.8689655172413793,26.782955933247347
Task_33397,929,988,155,165,320,0.9393326592517695,25.746935793092046
Task_33398,1247,412,13,38,51,3.0193704600484264,26.288468742240482
Task_33399,2857,210,86,194,280,13.540284360189574,53.71438107652268
Task_33400,2420,755,145,140,285,3.201058201058201,48.522579815484484
Task_33401,2682,988,91,147,238,2.711830131445905,53.2505940540209
Task_33402,624,474,177,151,328,1.3136842105263158,19.35589006784607
Task_33403,2842,671,85,176,261,4.229166666666667,54.93406709310576
Task_33404,1929,704,70,164,234,2.7361702127659573,40.53018209943232
Task_33405,1265,203,105,174,279,6.200980392156863,28.479004248067728
Task_33406,2201,220,91,11,102,9.959276018099548,41.06588911001825
Task_33407,1345,518,134,83,217,2.5915221579961463,30.06742465105951
Task_33408,1224,915,92,43,135,1.3362445414847162,28.441023859822675
Task_33409,2319,247,74,173,247,9.350806451612904,45.270218940298086
Task_33410,1355,261,197,101,298,5.17175572519084,30.079857259747182
Task_33411,514,358,118,24,142,1.4317548746518105,15.271161158471669
Task_33412,1088,651,173,26,199,1.6687116564417177,25.832298393693407
Task_33413,1901,400,20,75,95,4.740648379052369,37.44698449317975
Task_33414,2428,984,188,90,278,2.46497461928934,49.09570259707658
Task_33415,2211,882,168,52,220,2.5039637599093996,44.77463586918839
Task_33416,2665,847,67,76,143,3.142688679245283,51.52345265425908
Task_33417,2375,255,168,156,324,9.27734375,46.37459988231723
Task_33418,1338,836,106,26,132,1.5985663082437276,29.884637743194574
Task_33419,1893,802,82,157,239,2.3574097135740972,40.23074003512347
Task_33420,1392,178,41,90,131,7.776536312849162,28.814250610709063
Task_33421,843,876,167,67,234,0.9612314709236032,23.187886956541302
Task_33422,2742,872,77,123,200,3.140893470790378,53.70905284563634
Task_33423,2629,669,193,133,326,3.9238805970149255,51.736559876207615
Task_33424,1334,431,166,185,351,3.087962962962963,30.664381132923285
Task_33425,1774,932,160,125,285,1.9013933547695605,38.81805479672145
Task_33426,2478,312,177,138,315,7.916932907348243,48.138234432200306
Task_33427,1444,904,64,74,138,1.5955801104972376,32.32919210666897
Task_33428,1219,228,150,20,170,5.323144104803493,26.051703365438694
Task_33429,1724,761,80,125,205,2.2624671916010497,37.260057460784914
Task_33430,2237,558,132,162,294,4.001788908765653,45.074038313955704
Task_33431,1578,852,147,57,204,1.8499413833528722,34.49910576075583
Task_33432,2315,340,116,26,142,6.788856304985337,43.73231152219372
Task_33433,2826,320,19,90,109,8.80373831775701,52.176198104207
Task_33434,2224,414,186,178,364,5.3590361445783135,44.74253964382069
Task_33435,2943,244,195,114,309,12.012244897959183,55.17859122948736
Task_33436,1974,464,187,88,275,4.245161290322581,40.163143142654775
Task_33437,2960,1020,18,164,182,2.899118511263467,57.27457556386579
Task_33438,1239,460,150,92,242,2.6876355748373104,28.52460019527278
Task_33439,1783,175,80,45,125,10.130681818181818,34.29965221867674
Task_33440,2946,428,187,142,329,6.8671328671328675,56.004253315291784
Task_33441,1747,415,88,198,286,4.199519230769231,36.89471552571303
Task_33442,2433,898,21,98,119,2.7063403781979978,47.998709952248056
Task_33443,1866,697,177,118,295,2.673352435530086,39.57735821540327
Task_33444,2316,776,69,116,185,2.9806949806949805,46.44657436651874
Task_33445,2792,710,21,194,215,3.926863572433193,54.01782971361351
Task_33446,1700,549,125,85,210,3.090909090909091,35.776145730230645
Task_33447,688,384,189,117,306,1.787012987012987,19.99046863993816
Task_33448,2654,509,26,127,153,5.203921568627451,50.52336769503005
Task_33449,1331,981,150,62,212,1.3553971486761711,31.033865555414014
Task_33450,1924,87,42,20,62,21.863636363636363,34.847072164589584
Task_33451,539,486,185,42,227,1.106776180698152,16.747994539853586
Task_33452,1726,97,113,130,243,17.612244897959183,34.3182815905221
Task_33453,2693,826,44,22,66,3.2563482466747278,50.288677282213456
Task_33454,2553,761,32,140,172,3.3503937007874014,50.11079504426576
Task_33455,2908,640,150,107,257,4.536661466458658,55.714336852286486
Task_33456,871,405,50,164,214,2.145320197044335,22.796024634260913
Task_33457,734,464,173,54,227,1.578494623655914,20.049352810446035
Task_33458,2736,70,121,183,304,38.53521126760563,50.3421166354548
Task_33459,1042,903,124,22,146,1.1526548672566372,25.4506825675083
Task_33460,879,294,80,181,261,2.9796610169491524,22.742981604658286
Task_33461,1661,153,191,35,226,10.785714285714286,33.209220509205934
Task_33462,2480,979,73,158,231,2.5306122448979593,50.08378413014117
Task_33463,1699,306,42,160,202,5.534201954397394,35.33678824424101
Task_33464,2989,308,51,130,181,9.673139158576053,55.60207986049175
Task_33465,2396,373,199,103,302,6.406417112299465,46.938972634621415
Task_33466,2560,232,174,69,243,10.987124463519313,48.24870042035246
Task_33467,854,358,23,78,101,2.3788300835654597,20.990658133783768
Task_33468,1330,531,59,109,168,2.5,29.947990820079212
Task_33469,1397,369,14,81,95,3.7756756756756755,29.482592942494637
Task_33470,2641,828,169,139,308,3.185765983112183,52.35519653890649
Task_33471,1927,213,199,31,230,9.004672897196262,37.86632686814395
Task_33472,1911,776,30,123,153,2.4594594594594597,39.59581535216629
Task_33473,1092,328,33,34,67,3.3191489361702127,23.438308697755208
Task_33474,866,475,32,119,151,1.819327731092437,22.108951371387388
Task_33475,1272,69,129,31,160,18.17142857142857,25.51503507379272
Task_33476,2026,182,10,139,149,11.07103825136612,39.30302694818026
Task_33477,2346,375,112,85,197,6.23936170212766,45.380208354054616
Task_33478,1834,370,137,102,239,4.943396226415095,37.75249182079735
Task_33479,2035,599,93,101,194,3.3916666666666666,41.577288099266795
Task_33480,2639,538,157,75,232,4.896103896103896,50.60407694730827
Task_33481,2603,623,60,159,219,4.171474358974359,50.86260432894475
Task_33482,1238,131,123,32,155,9.378787878787879,25.686536172012854
Task_33483,1069,443,197,35,232,2.4076576576576576,25.082228437201753
Task_33484,2627,268,137,88,225,9.765799256505575,49.60647515442269
Task_33485,635,729,187,198,385,0.8698630136986302,20.62414926275082
Task_33486,1608,452,178,139,317,3.5496688741721854,34.84742389102679
Task_33487,2534,566,69,104,173,4.469135802469136,49.221524643200524
Task_33488,2454,722,103,140,243,3.3941908713692945,48.768087181343
Task_33489,2032,101,110,155,265,19.92156862745098,39.379422098172164
Task_33490,2381,535,36,166,202,4.442164179104478,46.880732065828994
Task_33491,2909,987,171,96,267,2.944331983805668,56.874989438500954
Task_33492,1148,748,66,22,88,1.5327102803738317,26.032162317503396
Task_33493,875,885,88,51,139,0.9875846501128668,22.943700513013244
Task_33494,1302,271,101,60,161,4.786764705882353,27.792981651872314
Task_33495,970,685,162,151,313,1.41399416909621,25.408366454526657
Task_33496,1650,681,69,163,232,2.4193548387096775,36.00930749490316
Task_33497,1727,374,24,93,117,4.605333333333333,35.27218765678745
Task_33498,2823,999,176,119,295,2.823,55.685921967373
Task_33499,2525,898,149,77,226,2.8086763070077865,49.91724347291757
Task_33500,913,708,136,21,157,1.2877291960507757,22.686535254393437
Task_33501,2355,188,77,47,124,12.46031746031746,43.913691294611645
Task_33502,538,196,172,122,294,2.730964467005076,16.92579263692625
Task_33503,919,544,20,24,44,1.6862385321100917,21.191399826230384
Task_33504,2331,417,80,90,170,5.576555023923445,45.19767790512208
Task_33505,1358,119,42,82,124,11.316666666666666,27.79962489321065
Task_33506,1819,836,140,48,188,2.173237753882915,37.95294565584806
Task_33507,635,131,103,62,165,4.8106060606060606,16.702575750799152
Task_33508,1834,487,11,142,153,3.7581967213114753,37.459519852096264
Task_33509,1099,1004,106,87,193,1.0935323383084576,27.483061534991588
Task_33510,1654,212,14,119,133,7.765258215962441,33.720223902275286
Task_33511,2472,879,72,59,131,2.809090909090909,48.30908604157324
Task_33512,2786,420,79,23,102,6.617577197149644,51.139077640310695
Task_33513,2604,846,181,59,240,3.074380165289256,50.8758106171245
Task_33514,1430,405,122,136,258,3.522167487684729,31.609423417635767
Task_33515,2632,558,162,199,361,4.708407871198569,51.68491968152745
Task_33516,986,88,69,49,118,11.07865168539326,20.95155346897693
Task_33517,2824,136,74,82,156,20.613138686131386,51.2932135686433
Task_33518,2069,245,178,55,233,8.410569105691057,40.51939849532268
Task_33519,1726,979,175,70,245,1.7612244897959184,37.489214607065925
Task_33520,2416,621,170,51,221,3.8842443729903535,47.150937128223354
Task_33521,969,877,93,195,288,1.103644646924829,25.971873689775332
Task_33522,2314,991,164,96,260,2.3326612903225805,47.42702267060121
Task_33523,998,253,37,46,83,3.9291338582677167,22.090688040293966
Task_33524,2530,638,11,189,200,3.9593114241001564,49.58645611158235
Task_33525,1748,629,43,73,116,2.7746031746031745,36.15070348586017
Task_33526,1595,71,160,180,340,22.15277777777778,32.66155978922564
Task_33527,1784,456,116,46,162,3.903719912472648,35.84368595379506
Task_33528,2244,136,30,82,112,16.37956204379562,41.74690647422678
Task_33529,2249,1000,103,108,211,2.2467532467532467,46.19812036527787
Task_33530,689,76,10,198,208,8.948051948051948,17.930085956277136
Task_33531,510,446,191,25,216,1.1409395973154361,16.150125364168517
Task_33532,1921,273,163,68,231,7.010948905109489,38.27512761810886
Task_33533,2811,329,145,83,228,8.518181818181818,52.69725701452629
Task_33534,2199,785,41,77,118,2.7977099236641223,43.80236727354469
Task_33535,2759,933,101,91,192,2.9539614561027836,53.81229966558289
Task_33536,978,441,83,44,127,2.2126696832579187,22.777909518217673
Task_33537,1093,962,169,14,183,1.1349948078920042,26.49981217900144
Task_33538,1501,769,164,16,180,1.9493506493506494,32.34772254831086
Task_33539,1170,65,48,57,105,17.727272727272727,23.643404074776488
Task_33540,1956,220,198,43,241,8.850678733031675,38.39122993925468
Task_33541,2234,405,117,146,263,5.502463054187192,44.36910778547585
Task_33542,2695,609,189,12,201,4.418032786885246,51.0646960159421
Task_33543,764,409,42,54,96,1.8634146341463416,19.29709470019736
Task_33544,1646,264,110,140,250,6.211320754716981,34.52961364726988
Task_33545,1730,957,53,166,219,1.8058455114822547,38.13091706095354
Task_33546,2764,502,37,20,57,5.495029821073559,50.20386707775168
Task_33547,1398,225,151,36,187,6.185840707964601,29.32397346211539
Task_33548,621,182,35,20,55,3.3934426229508197,15.484820580051988
Task_33549,1506,178,82,185,267,8.41340782122905,31.849178963224997
Task_33550,878,715,18,35,53,1.2262569832402235,21.38093387141713
Task_33551,944,347,171,194,365,2.7126436781609193,24.301764784085872
Task_33552,1291,1008,133,161,294,1.2794846382556988,31.401131564560956
Task_33553,788,893,109,46,155,0.8814317673378076,21.392045460067084
Task_33554,1125,991,12,32,44,1.1340725806451613,26.02381303007996
Task_33555,1480,509,57,141,198,2.9019607843137254,32.6277547018955
Task_33556,770,185,40,128,168,4.139784946236559,19.68419940549607
Task_33557,2204,759,26,134,160,2.9,44.26526640958635
Task_33558,602,89,196,111,307,6.688888888888889,17.00279789800321
Task_33559,1970,695,85,107,192,2.8304597701149423,40.78542747322458
Task_33560,1248,104,137,196,333,11.885714285714286,27.413228333973972
Task_33561,2279,389,200,39,239,5.843589743589743,44.04308359036287
Task_33562,1092,336,155,24,179,3.2403560830860534,24.60777524860904
Task_33563,2282,353,73,129,202,6.446327683615819,44.782866682891004
Task_33564,1606,367,25,136,161,4.364130434782608,33.57997066766091
Task_33565,1720,708,180,141,321,2.4259520451339913,37.450017836390636
Task_33566,1310,889,108,146,254,1.4719101123595506,31.16947432125126
Task_33567,2057,477,180,131,311,4.303347280334728,41.99605856781337
Task_33568,2970,921,15,144,159,3.2212581344902387,56.9238334767007
Task_33569,2179,172,121,101,222,12.595375722543352,42.0572874243771
Task_33570,2954,468,159,11,170,6.298507462686567,54.35779646643226
Task_33571,1689,706,181,26,207,2.388967468175389,35.56317800817541
Task_33572,1985,408,45,129,174,4.853300733496333,39.9475042907279
Task_33573,2356,442,28,15,43,5.318284424379232,43.42145333783045
Task_33574,2481,556,33,51,84,4.454219030520647,46.82589314301214
Task_33575,1495,563,128,168,296,2.650709219858156,33.358320111551755
Task_33576,1934,414,147,17,164,4.660240963855422,38.0368561898115
Task_33577,2661,422,72,37,109,6.290780141843972,49.26667896080789
Task_33578,1909,741,179,194,373,2.57277628032345,40.85931951006048
Task_33579,1322,432,185,22,207,3.0531177829099305,28.84922619536357
Task_33580,545,523,192,164,356,1.0400763358778626,18.327462028788407
Task_33581,1299,321,84,84,168,4.03416149068323,28.34910803644884
Task_33582,539,663,124,158,282,0.8117469879518072,18.38402898706481
Task_33583,1661,856,190,194,384,1.9381563593932323,37.338596367308455
Task_33584,2095,482,62,116,178,4.337474120082816,41.93849434106114
Task_33585,949,512,104,11,115,1.8499025341130604,22.35904507182796
Task_33586,879,130,60,33,93,6.709923664122138,19.335549158708936
Task_33587,1007,413,38,80,118,2.4323671497584543,23.829894288844745
Task_33588,2631,392,157,193,350,6.694656488549619,51.068889225222016
Task_33589,1480,817,168,127,295,1.8092909535452322,33.850177471393344
Task_33590,704,1018,187,93,280,0.6908734052993131,22.05636319153922
Task_33591,558,784,198,186,384,0.710828025477707,19.660753255563474
Task_33592,934,534,74,31,105,1.7457943925233645,22.209539518842295
Task_33593,2798,288,98,117,215,9.681660899653979,52.64514805485246
Task_33594,2001,595,104,88,192,3.3573825503355703,40.63224447766411
Task_33595,983,690,44,103,147,1.422575976845152,24.480528105458948
Task_33596,1557,671,99,179,278,2.3169642857142856,34.61590051944925
Task_33597,809,731,47,119,166,1.105191256830601,21.99658825181972
Task_33598,1262,255,89,117,206,4.9296875,28.238584113279217
Task_33599,2338,448,20,157,177,5.2071269487750556,45.586584213016785
Task_33600,2546,794,39,89,128,3.2025157232704404,49.689160868126585
Task_33601,598,401,173,169,342,1.4875621890547264,18.815576730534975
Task_33602,1830,195,183,162,345,9.33673469387755,37.588225394853914
Task_33603,1881,1022,104,84,188,1.8387096774193548,39.95392992156327
Task_33604,1673,612,141,19,160,2.729200652528548,34.328412839255606
Task_33605,2280,802,17,21,38,2.839352428393524,43.43192912195437
Task_33606,2808,1017,19,51,70,2.7583497053045187,53.03238627108468
Task_33607,843,701,19,197,216,1.2008547008547008,23.00590360464514
Task_33608,1308,741,17,102,119,1.7628032345013478,29.66099122027863
Task_33609,1131,590,91,93,184,1.9137055837563453,26.85103926794997
Task_33610,2716,70,56,193,249,38.25352112676056,49.89559738727548
Task_33611,2440,575,135,79,214,4.236111111111111,47.567713734747734
Task_33612,747,466,119,174,293,1.5995717344753748,21.19304707082321
Task_33613,2472,84,61,123,184,29.08235294117647,45.66887549467622
Task_33614,2401,524,173,190,363,4.573333333333333,47.91400227891295
Task_33615,2141,569,130,15,145,3.756140350877193,41.69538323352126
Task_33616,1113,501,48,63,111,2.2171314741035855,25.501058543078656
Task_33617,2917,658,108,97,205,4.426403641881639,55.698774679234425
Task_33618,2887,220,102,25,127,13.063348416289593,52.2561553291416
Task_33619,2502,451,174,24,198,5.535398230088496,47.55944098046094
Task_33620,1675,577,43,71,114,2.897923875432526,34.80677881342419
Task_33621,914,598,113,106,219,1.5258764607679465,23.786749113770707
Task_33622,2682,735,166,51,217,3.6440217391304346,51.706787904313636
Task_33623,1077,652,22,73,95,1.6493108728943338,25.213420043900637
Task_33624,2669,148,149,165,314,17.91275167785235,50.24177159838348
Task_33625,736,142,146,64,210,5.146853146853147,18.764415204354147
Task_33626,2716,825,87,182,269,3.288135593220339,53.42984809804398
Task_33627,1226,903,120,195,315,1.3561946902654867,30.24203096350294
Task_33628,993,81,109,162,271,12.109756097560975,22.957719457817188
Task_33629,2842,1008,47,84,131,2.8166501486620414,54.90283721993217
Task_33630,924,334,102,103,205,2.7582089552238807,23.089283865218025
Task_33631,1810,137,186,84,270,13.115942028985508,36.092701524919654
Task_33632,1353,300,50,126,176,4.495016611295681,29.698805194203256
Task_33633,2240,676,11,14,25,3.308714918759232,42.24729717402156
Task_33634,2177,519,51,165,216,4.186538461538461,43.84819568484132
Task_33635,592,320,141,196,337,1.8442367601246106,18.525438845792454
Task_33636,1715,784,36,107,143,2.1847133757961785,36.47107887012823
Task_33637,2812,73,102,66,168,38.0,50.07480133017802
Task_33638,522,317,100,125,225,1.6415094339622642,16.78671387072352
Task_33639,2376,530,154,46,200,4.47457627118644,45.88680853601161
Task_33640,657,629,179,83,262,1.042857142857143,19.635069609078823
Task_33641,1705,539,49,171,220,3.1574074074074074,36.430369655608516
Task_33642,1997,163,33,42,75,12.176829268292684,37.17311799018449
Task_33643,1634,926,43,89,132,1.7626752966558792,35.53778658049421
Task_33644,2988,660,30,158,188,4.5204236006051435,56.81254944131451
Task_33645,1731,655,139,192,331,2.638719512195122,37.577991920842315
Task_33646,2426,157,41,171,212,15.354430379746836,46.06429318015776
Task_33647,730,221,77,180,257,3.2882882882882885,20.12918616092014
Task_33648,1180,617,170,175,345,1.9093851132686084,28.770399619580477
Task_33649,934,748,150,132,282,1.2469959946595461,24.811308974960323
Task_33650,998,684,109,150,259,1.456934306569343,25.603963104575584
Task_33651,933,277,80,12,92,3.356115107913669,21.263232664839425
Task_33652,1549,704,62,67,129,2.197163120567376,33.33025149616598
Task_33653,2225,382,164,72,236,5.809399477806789,43.504605775398005
Task_33654,1520,800,19,104,123,1.8976279650436954,33.338202584465364
Task_33655,2325,529,190,128,318,4.386792452830188,46.43304204696724
Task_33656,2682,854,59,23,82,3.136842105263158,50.56432652426159
Task_33657,2251,946,176,12,188,2.3769799366420274,44.99112803463503
Task_33658,2134,648,58,155,213,3.288135593220339,43.50741072902895
Task_33659,2366,195,57,18,75,12.071428571428571,42.931355561122224
Task_33660,2528,538,73,149,222,4.690166975881262,49.40117313498754
Task_33661,2408,222,39,39,78,10.798206278026905,43.82957711640001
Task_33662,2935,1007,99,104,203,2.9117063492063493,57.05081004299493
Task_33663,1649,710,47,114,161,2.319268635724332,35.31122795959074
Task_33664,1728,702,101,50,151,2.458036984352774,35.730885582998276
Task_33665,1150,794,29,30,59,1.4465408805031446,25.748999957797462
Task_33666,2212,605,150,123,273,3.65016501650165,44.67573209871161
Task_33667,1620,553,188,62,250,2.9241877256317688,34.45072514065611
Task_33668,2027,602,133,170,303,3.361525704809287,41.940546651529914
Task_33669,528,830,121,122,243,0.6353790613718412,18.601926061601805
Task_33670,809,907,154,81,235,0.8909691629955947,22.827429889848883
Task_33671,2819,644,190,48,238,4.370542635658914,53.45645423210271
Task_33672,2377,771,160,193,353,3.0790155440414506,48.2757822043121
Task_33673,1076,130,52,170,222,8.213740458015268,24.67237583721708
Task_33674,2807,227,106,200,306,12.31140350877193,53.07680777875377
Task_33675,929,934,198,110,308,0.9935828877005347,25.4392314944099
Task_33676,1558,786,102,143,245,1.9796696315120712,34.78755377978069
Task_33677,500,842,117,189,306,0.5931198102016607,18.59863737110083
Task_33678,1990,170,159,93,252,11.637426900584796,39.09423669806552
Task_33679,1632,79,191,42,233,20.4,31.916867924613438
Task_33680,2449,811,119,137,256,3.0160098522167487,49.02263535960353
Task_33681,2809,788,56,125,181,3.5602027883396703,54.2746541928222
Task_33682,2372,514,188,64,252,4.6058252427184465,46.28251951348532
Task_33683,1605,486,89,47,136,3.295687885010267,33.041581370394816
Task_33684,1760,459,137,187,324,3.8260869565217392,37.37765382916698
Task_33685,788,249,111,156,267,3.152,21.021465679155774
Task_33686,2170,616,167,164,331,3.5170178282009723,44.3669334798013
Task_33687,1651,1009,18,39,57,1.6346534653465346,34.38467888226352
Task_33688,2851,848,99,151,250,3.3580683156654887,55.50304484623414
Task_33689,1002,669,65,139,204,1.4955223880597015,25.511919692853713
Task_33690,2039,492,63,76,139,4.1359026369168355,40.4604029949856
Task_33691,1786,425,115,45,160,4.192488262910798,35.69871963389056
Task_33692,2961,928,106,68,174,3.18729817007535,56.504699562053446
Task_33693,1703,796,10,136,146,2.136762860727729,36.369949409187655
Task_33694,1970,840,92,69,161,2.342449464922711,40.299504242151734
Task_33695,1781,630,108,190,298,2.822503961965135,38.13968609767159
Task_33696,2471,1012,95,149,244,2.43928923988154,50.03249802132502
Task_33697,2843,796,172,187,359,3.5671267252195733,55.755281846677825
Task_33698,2610,323,124,174,298,8.055555555555555,50.23991980406896
Task_33699,1967,563,172,65,237,3.4875886524822697,39.97543920960705
Task_33700,2532,427,102,171,273,5.91588785046729,49.2390824052311
Task_33701,1054,994,107,130,237,1.0592964824120603,27.254970839159043
Task_33702,2967,330,123,55,178,8.963746223564955,54.581251630437855
Task_33703,2847,89,79,72,151,31.633333333333333,50.81111874865591
Task_33704,1148,1024,69,78,147,1.12,28.069795561138378
Task_33705,1327,819,30,197,227,1.6182926829268294,31.255996987521
Task_33706,2728,294,78,28,106,9.247457627118644,49.81665292399512
Task_33707,760,250,179,124,303,3.0278884462151394,20.697683218143005
Task_33708,1587,347,143,174,317,4.560344827586207,34.22677896247087
Task_33709,695,772,55,114,169,0.8990944372574385,20.484976513469086
Task_33710,1152,993,91,17,108,1.158953722334004,26.989320361180432
Task_33711,687,810,130,200,330,0.8471023427866831,21.445105293681063
Task_33712,692,937,10,108,118,0.7377398720682303,20.52454058697981
Task_33713,693,95,106,122,228,7.21875,18.014988576507573
Task_33714,766,605,17,93,110,1.2640264026402641,20.423036386741916
Task_33715,932,707,74,99,173,1.3163841807909604,24.22171108481743
Task_33716,965,578,15,174,189,1.6666666666666667,24.541339036357716
Task_33717,1428,572,138,60,198,2.492146596858639,31.201799420187772
Task_33718,2846,411,152,196,348,6.907766990291262,54.529846736640614
Task_33719,747,176,69,159,228,4.220338983050848,19.654667057648307
Task_33720,1487,253,65,158,223,5.854330708661418,32.009245148638655
Task_33721,1448,989,158,86,244,1.4626262626262627,33.258695528875634
Task_33722,2885,884,160,189,349,3.2598870056497176,56.65485490913667
Task_33723,678,350,94,33,127,1.9316239316239316,17.99099910635824
Task_33724,1559,912,81,191,272,1.7075575027382257,35.47751405444848
Task_33725,1318,735,152,154,306,1.7907608695652173,31.117671558735122
Task_33726,539,698,150,53,203,0.771101573676681,17.67569965995766
Task_33727,1660,635,199,43,242,2.610062893081761,35.07491702733998
Task_33728,2141,698,42,175,217,3.0629470672389125,43.682206803900534
Task_33729,2556,818,146,125,271,3.120879120879121,50.789844127676325
Task_33730,2281,137,159,193,352,16.528985507246375,44.25213400901122
Task_33731,2653,954,69,69,138,2.7780104712041886,51.490677910022356
Task_33732,1435,747,159,57,216,1.9184491978609626,31.960814986683193
Task_33733,2353,575,50,126,176,4.085069444444445,46.41377612743921
Task_33734,1188,704,57,143,200,1.6851063829787234,28.61321327046632
Task_33735,2856,425,167,190,357,6.704225352112676,54.766503410289545
Task_33736,2228,496,157,129,286,4.482897384305835,44.648590465374774
Task_33737,727,866,134,111,245,0.8385236447520185,21.738409890284913
Task_33738,2151,302,184,135,319,7.099009900990099,42.94686196390597
Task_33739,768,76,121,84,205,9.974025974025974,18.771568900393287
Task_33740,2299,250,169,93,262,9.159362549800797,44.71838372281397
Task_33741,512,938,188,72,260,0.5452609158679447,18.374844279777857
Task_33742,1935,784,48,195,243,2.464968152866242,40.94456172930616
Task_33743,1163,767,170,107,277,1.5143229166666667,28.51938533725075
Task_33744,568,183,90,129,219,3.0869565217391304,16.979758395121113
Task_33745,1867,950,182,123,305,1.9631966351209253,40.43488689371238
Task_33746,2319,273,146,17,163,8.463503649635037,43.58232985542674
Task_33747,2226,946,123,25,148,2.350580781414995,44.27009409690737
Task_33748,2742,631,119,196,315,4.3386075949367084,53.44843085479505
Task_33749,1687,424,56,151,207,3.969411764705882,35.688352766724336
Task_33750,795,1002,85,30,115,0.7926221335992024,21.66541893562487
Task_33751,1414,186,91,127,218,7.561497326203209,30.640856307601513
Task_33752,1607,895,47,22,69,1.7935267857142858,33.288210241174305
Task_33753,2115,1008,162,19,181,2.0961347869177405,42.751975953583745
Task_33754,2065,675,63,132,195,3.054733727810651,42.358189097529554
Task_33755,2317,711,91,183,274,3.2542134831460676,46.81527426440649
Task_33756,831,214,64,64,128,3.8651162790697673,20.439843538660973
Task_33757,1001,529,14,71,85,1.8886792452830188,23.516799529020613
Task_33758,2258,952,92,88,180,2.3693599160545644,45.667411789882465
Task_33759,1052,756,169,38,207,1.3896961690885072,25.697792912197343
Task_33760,2319,477,23,21,44,4.851464435146443,43.17454918570373
Task_33761,1051,305,200,65,265,3.434640522875817,24.778709468124074
Task_33762,1656,118,113,140,253,13.915966386554622,33.709848329958014
Task_33763,1974,578,73,126,199,3.4093264248704664,40.619002687463635
Task_33764,1010,81,162,181,343,12.317073170731707,23.576483343412065
Task_33765,2996,558,188,163,351,5.359570661896243,57.35087351526423
Task_33766,2846,436,19,156,175,6.5125858123569795,53.69335418050051
Task_33767,1250,347,154,125,279,3.5919540229885056,28.653174022766624
Task_33768,2216,202,57,199,256,10.916256157635468,43.578847480189516
Task_33769,2008,578,117,132,249,3.4680483592400693,41.26458067922308
Task_33770,2554,664,158,82,240,3.8406015037593986,49.787109896315336
Task_33771,566,81,161,106,267,6.902439024390244,16.166184019215077
Task_33772,2811,874,156,150,306,3.2125714285714286,55.200026478310065
Task_33773,2710,293,177,61,238,9.217687074829932,50.75069441539022
Task_33774,1615,486,132,63,195,3.316221765913758,33.94235027096767
Task_33775,2023,275,34,195,229,7.329710144927536,40.53994014387616
Task_33776,1410,733,44,44,88,1.9209809264305178,30.14475756755176
Task_33777,2014,754,141,26,167,2.667549668874172,40.511307086350406
Task_33778,1318,67,197,190,387,19.38235294117647,28.540139944531912
Task_33779,1467,479,54,101,155,3.05625,31.752790012277117
Task_33780,1375,511,27,15,42,2.685546875,28.10250363445392
Task_33781,2617,210,100,35,135,12.402843601895734,48.08638577466842
Task_33782,583,637,59,62,121,0.9137931034482759,17.411866763183497
Task_33783,1354,710,75,134,209,1.9043600562587903,31.279612358847654
Task_33784,1726,789,10,145,155,2.1848101265822786,36.74925797020827
Task_33785,1379,304,112,52,164,4.521311475409836,29.433186717371587
Task_33786,2206,224,191,148,339,9.804444444444444,43.64603277020118
Task_33787,2858,932,164,198,362,3.0632368703108255,56.449061984528534
Task_33788,2319,742,122,134,256,3.1211305518169583,46.74221727920561
Task_33789,2959,117,41,71,112,25.076271186440678,52.734298219059035
Task_33790,2626,293,64,150,214,8.931972789115646,50.10187468740471
Task_33791,821,651,165,38,203,1.25920245398773,21.698976238155065
Task_33792,902,421,50,29,79,2.137440758293839,20.904788868725827
Task_33793,2887,745,102,29,131,3.8699731903485253,54.16903438115913
Task_33794,959,742,186,99,285,1.2907133243606999,25.170202053259505
Task_33795,1295,125,117,153,270,10.277777777777779,28.18025952572296
Task_33796,878,199,38,140,178,4.39,21.698086287017276
Task_33797,2956,783,92,15,107,3.770408163265306,54.968125023608216
Task_33798,1771,826,41,126,167,2.1414752116082223,37.73241134950661
Task_33799,2723,718,43,124,167,3.787204450625869,52.4739991367488
Task_33800,2358,647,193,171,364,3.638888888888889,47.60154879279597
Task_33801,638,184,112,69,181,3.4486486486486485,17.26799523631501
Task_33802,2279,975,49,111,160,2.3350409836065573,46.20681874945554
Task_33803,534,971,137,134,271,0.5493827160493827,19.21428920737235
Task_33804,2902,182,110,40,150,15.857923497267759,52.55493151294877
Task_33805,2886,529,165,166,331,5.445283018867925,55.4296878510977
Task_33806,991,336,42,124,166,2.940652818991098,23.849475714469634
Task_33807,1214,678,137,97,234,1.7879234167893963,28.918228758642982
Task_33808,3000,653,104,92,196,4.587155963302752,56.815268692631484
Task_33809,1013,477,65,134,199,2.1192468619246863,25.094644251843008
Task_33810,998,527,187,18,205,1.8901515151515151,23.83605511696899
Task_33811,596,799,140,29,169,0.745,18.209247140615677
Task_33812,2643,897,92,61,153,2.943207126948775,51.02109966355514
Task_33813,2053,557,102,33,135,3.6792114695340503,40.34760815795419
Task_33814,2379,847,47,74,121,2.8054245283018866,46.89413922413743
Task_33815,2446,919,32,42,74,2.658695652173913,46.759337007818054
Task_33816,1625,310,118,159,277,5.22508038585209,34.50303615941538
Task_33817,753,334,78,135,213,2.2477611940298505,20.598465740429756
Task_33818,1947,210,166,95,261,9.227488151658768,39.046223503496726
Task_33819,2096,684,24,127,151,3.0598540145985402,42.253874062341175
Task_33820,2367,276,170,25,195,8.545126353790614,44.82245823235805
Task_33821,2629,237,131,162,293,11.046218487394958,50.189612414727186
Task_33822,2315,627,185,150,335,3.6863057324840764,46.695705555524114
Task_33823,1198,845,109,166,275,1.4160756501182032,29.36783505917339
Task_33824,2886,589,155,179,334,4.8915254237288135,55.65551040699082
Task_33825,2199,499,150,16,166,4.398,42.51775845739927
Task_33826,999,246,50,79,129,4.044534412955466,23.48853168627222
Task_33827,827,318,86,115,201,2.592476489028213,21.545604281484476
Task_33828,1287,977,195,15,210,1.3159509202453987,29.903467231920473
Task_33829,1880,384,147,10,157,4.883116883116883,36.95475828657647
Task_33830,1537,872,160,190,350,1.7605956471935853,35.25108508663171
Task_33831,1537,572,89,161,250,2.682373472949389,33.87395233152967
Task_33832,1803,638,109,141,250,2.8215962441314555,38.22511661982194
Task_33833,620,1021,81,187,268,0.6066536203522505,21.047017364155824
Task_33834,2323,1008,118,186,304,2.3022794846382557,47.929192031831384
Task_33835,2591,448,67,114,181,5.770601336302895,49.6835362550843
Task_33836,1308,490,51,104,155,2.663951120162933,29.311836743673737
Task_33837,2759,323,28,80,108,8.515432098765432,51.08790802183757
Task_33838,2678,874,15,158,173,3.0605714285714285,52.47942072924953
Task_33839,1455,511,121,28,149,2.841796875,30.73782225038103
Task_33840,1355,710,123,196,319,1.9057665260196905,31.746057189114964
Task_33841,1206,507,50,60,110,2.374015748031496,26.79351837610787
Task_33842,1811,939,109,88,197,1.926595744680851,38.72329572681031
Task_33843,790,556,161,148,309,1.4183123877917414,22.133880609410294
Task_33844,2087,941,195,153,348,2.215498938428875,44.1308263334703
Task_33845,2897,667,145,93,238,4.336826347305389,55.45453641017275
Task_33846,2728,509,162,82,244,5.349019607843137,52.064818983552755
Task_33847,1528,464,122,99,221,3.286021505376344,33.113346260357616
Task_33848,649,481,102,126,228,1.3464730290456433,19.29826970497982
Task_33849,669,598,63,94,157,1.1168614357262103,19.25118137422401
Task_33850,1713,338,71,62,133,5.053097345132743,34.63842586186373
Task_33851,1770,319,135,38,173,5.53125,35.4523074954962
Task_33852,2912,190,154,99,253,15.24607329842932,54.18828567088381
Task_33853,1958,781,50,200,250,2.50383631713555,41.404603163664355
Task_33854,2953,866,191,87,278,3.405997693194925,56.95213339595943
Task_33855,2575,981,36,29,65,2.6221995926680246,48.947986235652216
Task_33856,1135,212,118,140,258,5.328638497652582,26.31376843945402
Task_33857,987,1009,25,148,173,0.9772277227722772,25.90540800526188
Task_33858,1446,605,90,173,263,2.386138613861386,32.62223438337116
Task_33859,2909,1020,173,61,234,2.8491674828599414,56.225467476664875
Task_33860,1396,387,144,191,335,3.597938144329897,31.44120693431846
Task_33861,2369,890,102,98,200,2.6588103254769924,47.69592275872541
Task_33862,1235,352,100,97,197,3.498583569405099,28.05506062214825
Task_33863,2305,760,141,161,302,3.028909329829172,46.823852578143565
Task_33864,897,1003,152,70,222,0.8934262948207171,24.38275850409117
Task_33865,2755,369,187,107,294,7.445945945945946,52.574846294188454
Task_33866,2118,112,148,69,217,18.743362831858406,39.99526803869925
Task_33867,980,372,42,166,208,2.6273458445040214,24.216038526211303
Task_33868,1489,387,83,113,196,3.8376288659793816,32.225468867094385
Task_33869,950,156,97,183,280,6.050955414012739,23.112819807655228
Task_33870,1880,91,69,84,153,20.434782608695652,35.75670452741692
Task_33871,1003,739,12,108,120,1.3554054054054054,24.826187902831677
Task_33872,2013,676,45,128,173,2.9734121122599704,41.23324864042389
Task_33873,689,819,90,42,132,0.8402439024390244,19.62372483126453
Task_33874,2215,284,109,86,195,7.771929824561403,42.99937309537455
Task_33875,745,265,138,125,263,2.800751879699248,20.330632531617976
Task_33876,806,232,109,40,149,3.459227467811159,19.587464611070907
Task_33877,1403,147,106,98,204,9.47972972972973,29.65203084239971
Task_33878,2839,633,139,170,309,4.477917981072555,54.92592149306589
Task_33879,1185,278,181,45,226,4.247311827956989,26.305715067049807
Task_33880,971,490,76,27,103,1.9775967413441955,22.650635812334645
Task_33881,1248,416,160,76,236,2.9928057553956835,28.216024307282925
Task_33882,2003,495,28,14,42,4.038306451612903,37.98741865495905
Task_33883,1322,511,76,176,252,2.58203125,30.406833519618086
Task_33884,2265,636,52,48,100,3.5557299843014127,43.52720317358892
Task_33885,2689,914,68,46,114,2.9387978142076503,51.35023247585255
Task_33886,2892,866,17,44,61,3.3356401384083045,53.591923980520015
Task_33887,1273,843,155,181,336,1.5082938388625593,30.872511579680346
Task_33888,2173,876,114,160,274,2.4777651083238315,44.967730668883384
Task_33889,2387,615,18,147,165,3.875,46.92937124434987
Task_33890,1611,618,133,109,242,2.602584814216478,35.03843862196582
Task_33891,2788,333,148,28,176,8.347305389221557,51.45697694572766
Task_33892,2558,884,170,82,252,2.8903954802259886,50.596201714687346
Task_33893,773,643,106,89,195,1.200310559006211,21.328637070854345
Task_33894,1262,664,84,27,111,1.8977443609022557,27.820362826245514
Task_33895,769,332,83,189,272,2.309309309309309,21.11313204377426
Task_33896,1970,572,11,180,191,3.43804537521815,40.45477543347704
Task_33897,2932,539,111,131,242,5.42962962962963,55.73794078474119
Task_33898,2802,940,17,14,31,2.977683315621679,51.97345368162997
Task_33899,547,794,200,121,321,0.6880503144654088,19.159848824652226
Task_33900,2421,756,168,109,277,3.1981505944517834,48.46006441300818
Task_33901,1272,616,108,20,128,2.0615883306320906,28.046646803051697
Task_33902,2177,782,92,62,154,2.7803320561941254,43.32660237554099
Task_33903,1946,342,136,178,314,5.673469387755102,39.88095378965031
Task_33904,804,159,129,74,203,5.025,19.939725858018466
Task_33905,1589,830,136,160,296,1.9121540312876053,35.67046247054291
Task_33906,1945,959,45,74,119,2.0260416666666665,40.307737722458185
Task_33907,2458,560,176,82,258,4.381461675579323,48.01705027379726
Task_33908,1223,166,189,54,243,7.323353293413174,26.709960211691666
Task_33909,2955,514,60,56,116,5.737864077669903,54.54473852476368
Task_33910,1867,399,137,132,269,4.6675,38.54868369653256
Task_33911,519,621,30,199,229,0.8344051446945338,17.67660539511512
Task_33912,888,623,177,22,199,1.4230769230769231,22.54153194616673
Task_33913,592,432,156,91,247,1.3672055427251733,18.110356309003766
Task_33914,1673,791,189,129,318,2.1123737373737375,36.93355368259212
Task_33915,1199,508,42,161,203,2.355599214145383,28.082658311529926
Task_33916,884,421,138,160,298,2.09478672985782,23.235494388288704
Task_33917,2139,151,125,95,220,14.072368421052632,41.31729253301964
Task_33918,504,75,95,177,272,6.631578947368421,15.318070244961042
Task_33919,2841,903,144,172,316,3.142699115044248,55.84351775951461
Task_33920,1957,320,37,59,96,6.0965732087227416,37.85485444930312
Task_33921,1463,385,65,125,190,3.790155440414508,31.858543041975043
Task_33922,1229,763,138,90,228,1.6086387434554974,29.175343651555973
Task_33923,1902,489,81,84,165,3.8816326530612244,38.62935292546041
Task_33924,1598,959,180,73,253,1.6645833333333333,35.487204480436716
Task_33925,2953,242,174,99,273,12.152263374485596,55.12982296049275
Task_33926,1599,220,165,161,326,7.235294117647059,34.005943204236694
Task_33927,2091,438,100,101,201,4.763097949886105,41.868458060448
Task_33928,2600,596,84,163,247,4.355108877721943,50.78048016995111
Task_33929,2909,764,50,154,204,3.802614379084967,56.142612168482906
Task_33930,511,776,197,35,232,0.6576576576576577,17.59641886443144
Task_33931,2527,770,40,160,200,3.277561608300908,49.923462053268565
Task_33932,1870,539,64,15,79,3.462962962962963,36.25627595396975
Task_33933,993,698,177,112,289,1.4206008583690988,25.647785222226105
Task_33934,1300,873,18,13,31,1.4874141876430207,27.991472586174677
Task_33935,981,541,28,56,84,1.8099630996309963,23.040669075146727
Task_33936,2138,734,77,179,256,2.908843537414966,44.04166813637941
Task_33937,846,368,158,113,271,2.292682926829268,22.27600725049004
Task_33938,2805,647,46,77,123,4.328703703703703,53.03614197813269
Task_33939,2003,332,42,46,88,6.015015015015015,38.27362056306247
Task_33940,2883,675,101,105,206,4.264792899408284,55.19689596783818
Task_33941,2841,672,63,40,103,4.221396731054978,52.61848812557569
Task_33942,2686,609,52,163,215,4.4032786885245905,52.16215514709211
Task_33943,936,982,50,129,179,0.9521871820956256,25.059929835955398
Task_33944,586,529,110,49,159,1.1056603773584905,17.079363067806728
Task_33945,560,812,62,37,99,0.6888068880688807,17.35099303894621
Task_33946,1207,1011,123,109,232,1.1926877470355732,29.733630493596774
Task_33947,1119,698,36,89,125,1.6008583690987124,26.613994590048616
Task_33948,2167,674,50,106,156,3.2103703703703705,43.49677727093954
Task_33949,1481,616,188,155,343,2.40032414910859,33.49595692689113
Task_33950,2457,454,133,57,190,5.4,47.08819111996067
Task_33951,2820,678,96,66,162,4.153166421207659,53.27379581290092
Task_33952,1670,210,59,26,85,7.914691943127962,32.47334991311047
Task_33953,981,72,151,154,305,13.438356164383562,22.852655972752277
Task_33954,1238,501,156,150,306,2.4661354581673307,29.11250128360415
Task_33955,1163,275,167,100,267,4.213768115942029,26.95115917347789
Task_33956,1593,195,118,91,209,8.127551020408163,32.980926872544615
Task_33957,2577,219,77,134,211,11.713636363636363,49.01416593924429
Task_33958,2588,783,186,53,239,3.3010204081632653,50.52977761653427
Task_33959,1623,828,130,84,214,1.9577804583835947,35.42822787177074
Task_33960,1410,941,189,21,210,1.4968152866242037,31.81565528644234
Task_33961,1096,743,25,17,42,1.4731182795698925,24.359909112468966
Task_33962,2155,442,62,159,221,4.864559819413093,43.197530694699445
Task_33963,2819,669,12,160,172,4.2074626865671645,54.02556669120849
Task_33964,2179,618,36,55,91,3.520193861066236,42.33185029893803
Task_33965,1634,116,29,167,196,13.965811965811966,33.058455385483995
Task_33966,1919,286,26,103,129,6.686411149825784,38.172179681192375
Task_33967,2691,861,45,176,221,3.1218097447795823,52.913111642021214
Task_33968,2286,956,147,35,182,2.3887147335423196,45.56116829179976
Task_33969,1001,488,182,192,374,2.0470347648261757,25.68769044079349
Task_33970,1943,308,28,138,166,6.288025889967638,38.86349141730027
Task_33971,2822,375,131,121,252,7.50531914893617,53.486395612673526
Task_33972,719,480,188,99,287,1.4948024948024947,20.612518143557775
Task_33973,2052,496,16,111,127,4.128772635814889,40.824449553480754
Task_33974,2684,846,159,80,239,3.168831168831169,52.41021454579183
Task_33975,1930,462,198,70,268,4.168466522678186,39.20971345956254
Task_33976,2943,604,125,63,188,4.864462809917355,55.26883536843099
Task_33977,2556,401,87,17,104,6.358208955223881,47.20053641378564
Task_33978,1012,807,95,90,185,1.2524752475247525,25.45820120980015
Task_33979,859,336,73,32,105,2.548961424332344,20.41367329422506
Task_33980,718,775,119,179,298,0.9252577319587629,21.66205012676241
Task_33981,1533,588,137,154,291,2.602716468590832,33.99568900692126
Task_33982,1989,699,140,94,234,2.8414285714285716,41.166321606127845
Task_33983,2533,825,159,33,192,3.066585956416465,49.285818364765255
Task_33984,989,524,145,64,209,1.8838095238095238,24.224112824713753
Task_33985,2191,313,155,176,331,6.977707006369426,43.731299123466876
Task_33986,2069,248,82,127,209,8.309236947791165,41.04589998558837
Task_33987,1733,971,161,88,249,1.7829218106995885,37.81168944243931
Task_33988,2655,960,166,85,251,2.7627471383975024,52.37905291677527
Task_33989,1897,717,162,69,231,2.6420612813370474,39.300572143874234
Task_33990,723,991,189,179,368,0.7288306451612904,22.75915164318502
Task_33991,690,709,169,23,192,0.971830985915493,19.77219426514753
Task_33992,1344,923,55,17,72,1.4545454545454546,28.90787263969983
Task_33993,832,433,138,50,188,1.9170506912442395,21.116078745133468
Task_33994,1204,278,96,10,106,4.315412186379929,25.56615521348601
Task_33995,2771,526,67,123,190,5.258064516129032,53.01153323379172
Task_33996,1043,764,118,151,269,1.3633986928104576,26.618804693477685
Task_33997,2248,111,183,70,253,20.071428571428573,42.174471541501724
Task_33998,2416,664,77,186,263,3.6330827067669174,48.26664642636473
Task_33999,2834,796,166,22,188,3.5558343789209537,53.81918461168024
Task_34000,2654,456,79,131,210,5.807439824945296,51.053368398822094
Task_34001,962,223,49,75,124,4.294642857142857,22.60509442543783
Task_34002,2636,697,123,13,136,3.7765042979942693,49.86553608178762
Task_34003,1494,141,148,178,326,10.52112676056338,31.741548565076908
Task_34004,842,547,13,119,132,1.5364963503649636,21.937255458825746
Task_34005,543,418,176,57,233,1.295942720763723,16.860907706626794
Task_34006,2027,256,33,111,144,7.88715953307393,39.75596213367441
Task_34007,1861,673,151,126,277,2.7611275964391693,39.35345195825373
Task_34008,1787,100,113,160,273,17.693069306930692,35.56030764299239
Task_34009,798,469,186,70,256,1.6978723404255318,21.250666048782854
Task_34010,2188,707,97,140,237,3.0903954802259888,44.5038841990573
Task_34011,1033,962,70,81,151,1.0726895119418485,25.98366515370108
Task_34012,648,582,113,184,297,1.1114922813036021,19.874192518517656
Task_34013,1020,69,85,118,203,14.571428571428571,22.984937609627114
Task_34014,2201,923,68,103,171,2.382034632034632,44.934135605172266
Task_34015,2364,107,17,41,58,21.88888888888889,42.26458809056317
Task_34016,1376,225,193,170,363,6.088495575221239,30.681932540213737
Task_34017,611,451,119,146,265,1.3517699115044248,18.799217394998188
Task_34018,1915,227,63,163,226,8.399122807017545,38.70199594274923
Task_34019,810,816,130,166,296,0.9914320685434517,23.216699826416942
Task_34020,2712,809,62,44,106,3.348148148148148,50.98626646413277
Task_34021,2524,927,34,136,170,2.7198275862068964,50.02798312595393
Task_34022,1926,616,106,14,120,3.1215559157212316,38.12429552118142
Task_34023,2378,254,40,29,69,9.325490196078432,43.48511111128232
Task_34024,2943,207,119,182,301,14.149038461538462,55.09478188253462
Task_34025,1166,275,53,90,143,4.22463768115942,26.181587027622168
Task_34026,960,712,167,142,309,1.3464235624123422,25.33054456809801
Task_34027,2463,376,35,27,62,6.5331564986737405,45.26458007990627
Task_34028,2298,412,181,125,306,5.5641646489104115,45.567901780985245
Task_34029,2691,797,167,114,281,3.3721804511278197,52.89172344111787
Task_34030,2675,491,69,135,204,5.436991869918699,51.46956236267909
Task_34031,1618,303,13,170,183,5.322368421052632,33.83865721549101
Task_34032,576,303,54,93,147,1.894736842105263,17.05884770134487
Task_34033,1800,230,93,149,242,7.792207792207792,36.93211941831905
Task_34034,2568,267,58,144,202,9.582089552238806,49.05531561964667
Task_34035,1028,685,37,192,229,1.498542274052478,26.058554179417296
Task_34036,1323,278,97,123,220,4.741935483870968,29.335682038249374
Task_34037,529,480,190,46,236,1.0997920997920998,16.600609086428893
Task_34038,1959,260,85,177,262,7.505747126436781,39.61762065808812
Task_34039,1230,568,23,165,188,2.161687170474517,28.7454702061786
Task_34040,2697,582,59,167,226,4.626072041166381,52.290398964292514
Task_34041,613,460,57,66,123,1.3297180043383947,17.55898767939878
Task_34042,2315,598,194,192,386,3.8647746243739567,46.89513621005213
Task_34043,1377,923,76,74,150,1.4902597402597402,31.280956358226646
Task_34044,1333,204,42,116,158,6.5024390243902435,28.626120205963986
Task_34045,2377,796,154,178,332,2.982434127979925,48.2375517939013
Task_34046,1827,556,139,189,328,3.2800718132854576,38.768333447644025
Task_34047,2542,584,80,168,248,4.345299145299145,49.91549771947687
Task_34048,1855,882,116,11,127,2.10079275198188,38.02552869117759
Task_34049,1809,364,164,36,200,4.956164383561644,36.38947245942229
Task_34050,2520,144,167,123,290,17.379310344827587,47.73062363336863
Task_34051,2406,563,13,76,89,4.26595744680851,45.95597822671687
Task_34052,796,909,26,154,180,0.8747252747252747,22.501732041803475
Task_34053,1218,636,14,150,164,1.9120879120879122,28.50988473606148
Task_34054,2322,546,60,110,170,4.244972577696527,45.686331057952906
Task_34055,2310,295,146,27,173,7.804054054054054,43.822822091146804
Task_34056,2633,68,168,26,194,38.15942028985507,47.22590595310104
Task_34057,2644,86,164,71,235,30.39080459770115,48.16008612183225
Task_34058,2849,219,11,36,47,12.95,50.72972710455604
Task_34059,1482,107,173,27,200,13.722222222222221,29.76860328625216
Task_34060,1697,846,172,143,315,2.0035419126328216,37.492123944414075
Task_34061,1911,956,37,49,86,1.9968652037617556,38.858932103347406
Task_34062,2360,1009,13,84,97,2.3366336633663365,46.82049472634629
Task_34063,1984,506,144,17,161,3.913214990138067,38.92543188301265
Task_34064,2588,160,189,90,279,16.074534161490682,48.66007170590254
Task_34065,2523,933,10,129,139,2.701284796573876,49.718099506590356
Task_34066,2108,810,185,159,344,2.599260172626387,44.04578774597166
Task_34067,1638,407,103,101,204,4.014705882352941,34.612588074730404
Task_34068,2967,436,199,64,263,6.7894736842105265,55.49618237619236
Task_34069,2265,611,112,147,259,3.700980392156863,45.50619419628822
Task_34070,563,371,167,108,275,1.5134408602150538,17.77631597237303
Task_34071,979,722,105,167,272,1.3540802213001384,25.53245702090977
Task_34072,1265,416,171,16,187,3.0335731414868103,27.673886991391893
Task_34073,1710,341,70,32,102,5.0,33.86152320109104
Task_34074,1230,300,102,185,287,4.086378737541528,28.30759914996733
Task_34075,1529,344,162,65,227,4.431884057971015,32.29408683804572
Task_34076,721,250,185,16,201,2.8725099601593627,18.640113466893776
Task_34077,2515,537,31,187,218,4.674721189591078,49.13804251795858
Task_34078,1028,257,43,170,213,3.9844961240310077,24.63080794610616
Task_34079,1418,952,116,129,245,1.4879328436516264,33.02178659139974
Task_34080,2291,565,65,20,85,4.0477031802120145,43.30617493233073
Task_34081,2179,635,75,76,151,3.4261006289308176,43.13437031765515
Task_34082,2456,871,133,16,149,2.81651376146789,47.58173293083459
Task_34083,630,132,85,176,261,4.7368421052631575,17.75980382156087
Task_34084,2810,733,18,52,70,3.8283378746594003,52.20549084850882
Task_34085,668,837,181,122,303,0.7971360381861575,21.03890731704124
Task_34086,1531,904,72,65,137,1.6917127071823204,33.60127712857629
Task_34087,1927,944,92,196,288,2.039153439153439,41.47491103402028
Task_34088,1007,281,177,21,198,3.5709219858156027,23.302620492001466
Task_34089,581,780,57,156,213,0.7439180537772087,19.137934037408115
Task_34090,2198,483,33,109,142,4.541322314049586,43.20398353622869
Task_34091,2211,111,96,133,229,19.741071428571427,42.0662842127927
Task_34092,2686,155,17,109,126,17.21794871794872,48.94789876631253
Task_34093,1233,989,98,190,288,1.2454545454545454,30.42145842224491
Task_34094,1694,486,188,48,236,3.478439425051335,35.12994854871949
Task_34095,2893,720,44,80,124,4.0124826629681,54.715487686580666
Task_34096,2707,76,78,176,254,35.15584415584416,49.83878675756868
Task_34097,858,980,149,126,275,0.8746177370030581,24.3320843870758
Task_34098,2606,503,37,83,120,5.170634920634921,49.41753092311936
Task_34099,1525,297,32,169,201,5.117449664429531,32.59021157478883
Task_34100,2600,245,136,135,271,10.56910569105691,49.6229726898679
Task_34101,2315,959,146,117,263,2.4114583333333335,47.36393791180418
Task_34102,1065,101,105,113,218,10.441176470588236,23.91598601614126
Task_34103,746,629,13,26,39,1.1841269841269841,18.87243034049736
Task_34104,1402,143,189,34,223,9.73611111111111,29.088321552874575
Task_34105,1460,839,30,21,51,1.7380952380952381,30.833301930439973
Task_34106,1820,407,68,56,124,4.46078431372549,36.41065222374838
Task_34107,1809,819,73,118,191,2.2060975609756097,38.713985300015246
Task_34108,1091,267,105,99,204,4.07089552238806,25.486476749310665
Task_34109,1110,578,125,153,278,1.9170984455958548,27.205718977062674
Task_34110,2161,453,176,94,270,4.759911894273127,43.2702105444996
Task_34111,1251,186,30,183,213,6.689839572192513,28.060972412227425
Task_34112,1675,983,36,139,175,1.7022357723577235,36.8661530871596
Task_34113,2226,481,194,158,352,4.618257261410788,44.908579695285276
Task_34114,2910,704,54,134,188,4.127659574468085,55.79971956173466
Task_34115,2973,65,152,135,287,45.04545454545455,53.89163416984109
Task_34116,2323,346,47,173,220,6.694524495677234,45.47682621834142
Task_34117,2769,103,112,179,291,26.625,51.102487369558425
Task_34118,944,338,112,32,144,2.784660766961652,22.11504271905926
Task_34119,1774,912,185,108,293,1.9430449069003286,38.76702660170661
Task_34120,1101,709,163,193,356,1.5507042253521126,27.839071047620475
Task_34121,853,373,101,171,272,2.2807486631016043,22.492140903614228
Task_34122,1511,294,55,49,104,5.122033898305085,30.504630123848546
Task_34123,601,280,52,110,162,2.1387900355871885,17.515204610729786
Task_34124,2203,436,51,61,112,5.0411899313501145,42.38264701975997
Task_34125,2630,577,179,167,346,4.550173010380623,51.59960395780845
Task_34126,2240,610,83,143,226,3.6661211129296234,45.00612179050636
Task_34127,2593,755,106,129,235,3.42989417989418,51.0217582846293
Task_34128,720,643,135,65,200,1.1180124223602483,20.218485140499386
Task_34129,1532,948,168,13,181,1.6143308746048473,33.401253209198295
Task_34130,2156,514,109,48,157,4.186407766990291,41.87887620034097
Task_34131,2661,904,51,98,149,2.940331491712707,52.034853527572004
Task_34132,1347,897,30,191,221,1.5,31.754184745325002
Task_34133,1845,246,64,46,110,7.469635627530365,35.55788522098054
Task_34134,2591,393,72,163,235,6.5761421319796955,50.00401054006977
Task_34135,2174,678,167,181,348,3.2017673048600885,44.72756533029573
Task_34136,1091,973,50,21,71,1.120123203285421,25.45088187259975
Task_34137,686,932,150,78,228,0.7352625937834941,20.934991659143105
Task_34138,783,721,176,53,229,1.0844875346260388,21.632475718064256
Task_34139,1500,943,55,137,192,1.5889830508474576,34.228392938681665
Task_34140,2344,754,133,169,302,3.104635761589404,47.43458300616038
Task_34141,1383,772,124,48,172,1.7891332470892627,30.73744752043646
Task_34142,569,738,55,110,165,0.7699594046008119,18.50547608763456
Task_34143,1481,646,101,186,287,2.2890262751159196,33.38301938532164
Task_34144,1409,589,120,147,267,2.388135593220339,31.91672826630206
Task_34145,2348,489,94,100,194,4.791836734693877,46.1523597773174
Task_34146,956,142,28,193,221,6.685314685314685,22.876518587266407
Task_34147,1080,891,91,59,150,1.210762331838565,26.141536801812634
Task_34148,1339,65,106,93,199,20.28787878787879,27.899174975043454
Task_34149,1901,953,65,141,206,1.9926624737945493,40.68849613870749
Task_34150,2007,810,62,172,234,2.474722564734895,42.09687537750029
Task_34151,2276,140,24,91,115,16.141843971631207,42.37377198661061
Task_34152,1676,967,108,110,218,1.7314049586776858,37.03643152415254
Task_34153,672,348,167,89,256,1.9255014326647564,19.169870754279817
Task_34154,1258,985,129,192,321,1.2758620689655173,30.974115799689514
Task_34155,1963,448,103,12,115,4.371937639198218,38.21381023354408
Task_34156,1436,80,43,40,83,17.728395061728396,27.66688790900641
Task_34157,2012,880,96,11,107,2.2837684449489215,40.32477566847766
Task_34158,2687,549,65,175,240,4.885454545454546,52.07169514416186
Task_34159,1914,719,150,105,255,2.658333333333333,40.20732794264572
Task_34160,2958,944,137,82,219,3.13015873015873,56.97332847428195
Task_34161,2060,252,29,192,221,8.142292490118576,41.015975138247235
Task_34162,1384,609,147,182,329,2.2688524590163937,31.91429026959477
Task_34163,1561,954,39,111,150,1.6345549738219896,34.539710964419776
Task_34164,2922,418,36,167,203,6.973747016706444,55.068780478225115
Task_34165,2404,961,73,12,85,2.498960498960499,46.56837848209315
Task_34166,970,874,166,177,343,1.1085714285714285,26.077141524941258
Task_34167,2166,411,50,103,153,5.257281553398058,42.59245451370403
Task_34168,693,601,143,31,174,1.1511627906976745,19.317222958453613
Task_34169,1934,382,71,180,251,5.049608355091384,39.66940731338476
Task_34170,1928,880,180,191,371,2.188422247446084,41.58083708590357
Task_34171,2133,642,22,20,42,3.317262830482115,40.475422599439845
Task_34172,2787,426,149,188,337,6.526932084309133,53.58476582867405
Task_34173,876,882,49,127,176,0.9920724801812004,23.77237413352179
Task_34174,2856,500,144,96,240,5.700598802395209,54.371439420002055
Task_34175,2024,614,36,79,115,3.2910569105691057,40.54434695788879
Task_34176,1077,535,159,78,237,2.0093283582089554,25.956046001728165
Task_34177,1117,654,67,130,197,1.7053435114503817,27.263828367732817
Task_34178,2851,389,94,180,274,7.31025641025641,54.26197670838298
Task_34179,1539,155,103,175,278,9.865384615384615,32.307877632675506
Task_34180,1092,875,183,45,228,1.2465753424657535,26.70783346487868
Task_34181,723,631,63,165,228,1.143987341772152,21.060777734821833
Task_34182,1992,320,191,80,271,6.205607476635514,39.91191155691935
Task_34183,2019,121,53,160,213,16.549180327868854,39.42825037640062
Task_34184,502,941,112,155,267,0.5329087048832272,18.68600414203551
Task_34185,1865,116,91,191,282,15.94017094017094,37.14348806027008
Task_34186,654,429,184,151,335,1.5209302325581395,19.73154311030223
Task_34187,1743,613,107,82,189,2.8387622149837135,36.51948038964785
Task_34188,1627,388,15,38,53,4.182519280205655,32.23931457411703
Task_34189,2503,868,69,54,123,2.8803222094361334,48.657176839637145
Task_34190,2128,987,145,104,249,2.1538461538461537,44.405612003126954
Task_34191,2547,330,45,185,230,7.694864048338369,48.977573239925015
Task_34192,578,301,29,93,122,1.913907284768212,16.88790827370803
Task_34193,1014,467,119,132,251,2.1666666666666665,25.18511571505113
Task_34194,1739,845,45,115,160,2.0555555555555554,37.090741551242665
Task_34195,2578,894,127,47,174,2.880446927374302,50.05833859296479
Task_34196,1892,532,136,46,182,3.549718574108818,37.97011590404256
Task_34197,1698,510,69,182,251,3.3228962818003915,36.344081926066366
Task_34198,2000,331,161,91,252,6.024096385542169,40.14509708954248
Task_34199,1187,347,108,82,190,3.410919540229885,26.89595718591998
Task_34200,1209,885,155,45,200,1.3645598194130926,28.48156050362789
Task_34201,2758,162,63,44,107,16.920245398773005,49.202580868206695
Task_34202,1944,609,125,84,209,3.1868852459016392,39.80477081401755
Task_34203,761,550,78,128,206,1.381125226860254,21.29744135550598
Task_34204,2406,146,30,117,147,16.367346938775512,44.730076442721604
Task_34205,2244,1022,185,110,295,2.193548387096774,46.5688291243052
Task_34206,2671,294,170,59,229,9.054237288135592,50.09724915715382
Task_34207,1537,74,197,85,282,20.493333333333332,31.228782642252224
Task_34208,1732,712,62,68,130,2.429172510518934,36.22285749951525
Task_34209,1053,492,114,48,162,2.135902636916836,24.405480166037815
Task_34210,2296,123,177,172,349,18.516129032258064,44.30366484947857
Task_34211,1656,218,52,199,251,7.561643835616438,34.78630488150463
Task_34212,2816,193,32,85,117,14.515463917525773,51.781929309307344
Task_34213,938,989,166,153,319,0.9474747474747475,25.873848612741558
Task_34214,2295,634,50,153,203,3.6141732283464565,46.000057586721624
Task_34215,1037,935,85,37,122,1.107905982905983,25.212589971389622
Task_34216,2642,343,169,71,240,7.680232558139535,49.966737834387835
Task_34217,1662,285,95,22,117,5.811188811188811,33.083687041318456
Task_34218,939,824,158,193,351,1.1381818181818182,25.567635273943125
Task_34219,1300,736,89,91,180,1.7639077340569878,29.863026218947866
Task_34220,2332,901,50,53,103,2.5853658536585367,45.77899869955414
Task_34221,2728,642,39,78,117,4.242612752721618,51.79019342265996
Task_34222,839,703,140,161,301,1.1917613636363635,23.336125700535096
Task_34223,2820,1015,160,172,332,2.7755905511811023,55.93274111423191
Task_34224,2858,398,70,30,100,7.162907268170426,52.23736768362253
Task_34225,1316,164,188,95,283,7.975757575757576,28.708272796009737
Task_34226,1259,325,21,158,179,3.861963190184049,28.124033629813
Task_34227,1176,388,66,146,212,3.0231362467866325,27.465832364258986
Task_34228,1979,618,80,152,232,3.197092084006462,41.01183222100216
Task_34229,1878,139,140,144,284,13.414285714285715,37.527429728564194
Task_34230,2238,156,66,30,96,14.254777070063694,41.155740953297325
Task_34231,1535,765,94,179,273,2.003916449086162,34.62050434772967
Task_34232,2576,992,195,69,264,2.594159113796576,51.066626128498484
Task_34233,1507,340,177,110,287,4.419354838709677,32.70941946466286
Task_34234,1191,613,81,98,179,1.9397394136807817,27.993451387921358
Task_34235,750,947,115,124,239,0.7911392405063291,22.392526268833393
Task_34236,1158,989,18,36,54,1.1696969696969697,26.750492792107337
Task_34237,1524,496,144,52,196,3.0663983903420524,32.57276910895387
Task_34238,1491,117,185,101,286,12.635593220338983,31.191032404627794
Task_34239,710,724,32,54,86,0.9793103448275862,19.385326826900858
Task_34240,1682,109,176,178,354,15.290909090909091,34.34179313405262
Task_34241,1921,500,52,114,166,3.834331337325349,39.23365433769505
Task_34242,1239,672,73,96,169,1.8410104011887072,28.946582273652137
Task_34243,2749,372,95,187,282,7.369973190348525,52.6234125575068
Task_34244,1031,397,198,21,219,2.590452261306533,24.150162769376365
Task_34245,1587,550,101,91,192,2.88021778584392,34.04440058608103
Task_34246,1704,969,58,186,244,1.756701030927835,37.86948024758207
Task_34247,1589,771,192,95,287,2.0582901554404147,35.322728773209825
Task_34248,1221,195,168,185,353,6.229591836734694,28.046489859250745
Task_34249,973,961,126,95,221,1.0114345114345114,25.703600259148235
Task_34250,1159,190,153,103,256,6.0680628272251305,26.5595320740576
Task_34251,1194,433,91,197,288,2.751152073732719,28.23795246884257
Task_34252,2220,89,31,41,72,24.666666666666668,39.7962192227439
Task_34253,2587,269,67,192,259,9.58148148148148,49.65780550271214
Task_34254,1066,441,99,162,261,2.411764705882353,26.016896631880794
Task_34255,979,152,98,133,231,6.398692810457517,23.208626353015603
Task_34256,2949,141,169,114,283,20.767605633802816,54.37293458991112
Task_34257,1008,97,18,159,177,10.285714285714286,22.53855676260874
Task_34258,2859,817,177,109,286,3.4951100244498776,55.63144822543296
Task_34259,2211,839,174,100,274,2.632142857142857,45.36634045955291
Task_34260,1823,952,117,101,218,1.912906610703043,39.31950300515824
Task_34261,2820,519,181,66,247,5.423076923076923,53.364421400219804
Task_34262,2277,547,67,83,150,4.155109489051095,44.461734318492894
Task_34263,624,437,101,109,210,1.4246575342465753,18.63121428502131
Task_34264,1939,1019,170,108,278,1.9009803921568627,41.64651169514496
Task_34265,600,303,87,38,125,1.9736842105263157,16.44730444014333
Task_34266,1974,584,169,158,327,3.3743589743589744,41.13483868184556
Task_34267,2550,388,188,96,284,6.5552699228791775,49.357837064438236
Task_34268,2239,599,110,144,254,3.7316666666666665,45.02944074448624
Task_34269,1424,738,30,49,79,1.9269282814614344,30.195234492074523
Task_34270,1901,780,105,143,248,2.4340588988476313,40.21639912036313
Task_34271,550,859,37,101,138,0.6395348837209303,18.212465706404995
Task_34272,2262,692,106,149,255,3.264069264069264,45.69949849051337
Task_34273,1491,934,186,143,329,1.5946524064171124,34.55114150601741
Task_34274,637,705,154,192,346,0.9022662889518414,20.40463910449522
Task_34275,907,479,124,50,174,1.8895833333333334,22.355962890169888
Task_34276,1822,163,71,195,266,11.109756097560975,36.93034759304927
Task_34277,2323,547,199,140,339,4.239051094890511,46.571239609071995
Task_34278,2188,112,37,170,207,19.36283185840708,41.68091784429503
Task_34279,1438,158,128,54,182,9.044025157232705,29.602355169085843
Task_34280,724,945,11,63,74,0.7653276955602537,19.94477999849028
Task_34281,2668,264,38,134,172,10.067924528301887,50.26113880619567
Task_34282,1447,731,38,157,195,1.976775956284153,32.665273330621496
Task_34283,1968,857,102,115,217,2.2937062937062938,41.33745880300257
Task_34284,2345,292,62,59,121,8.003412969283277,44.12988179699986
Task_34285,1539,811,77,30,107,1.895320197044335,32.70047466283981
Task_34286,2803,824,186,73,259,3.3975757575757575,54.18486841810623
Task_34287,980,748,125,149,274,1.308411214953271,25.59947538901456
Task_34288,1190,655,132,153,285,1.8140243902439024,28.74472145734362
Task_34289,1546,175,38,177,215,8.784090909090908,32.1699629362702
Task_34290,2616,652,102,50,152,4.006125574272588,49.6150908524779
Task_34291,711,811,99,11,110,0.875615763546798,19.548284430854267
Task_34292,775,233,42,196,238,3.3119658119658117,20.70509487337093
Task_34293,2898,368,162,35,197,7.853658536585366,53.62108925117172
Task_34294,2526,332,148,42,190,7.585585585585585,47.55477478398981
Task_34295,1766,481,69,81,150,3.663900414937759,36.154085729843075
Task_34296,1937,531,101,199,300,3.6409774436090228,40.31913138309064
Task_34297,2306,527,85,68,153,4.367424242424242,44.54003611047262
Task_34298,1825,312,55,122,177,5.830670926517572,37.144190455097636
Task_34299,1982,729,190,56,246,2.7150684931506848,40.777578000121345
Task_34300,2879,380,44,17,61,7.556430446194225,51.571906551447825
Task_34301,2103,690,193,179,372,3.0434153400868307,43.74594468314243
Task_34302,872,322,37,163,200,2.6996904024767803,22.313854202301656
Task_34303,651,723,97,168,265,0.899171270718232,20.292337499675977
Task_34304,1120,558,178,33,211,2.0035778175313057,26.152951238026436
Task_34305,1344,594,160,82,242,2.2588235294117647,30.411793600927634
Task_34306,1253,1024,60,65,125,1.2224390243902439,29.432631423637947
Task_34307,2798,504,63,133,196,5.54059405940594,53.42653626832631
Task_34308,1125,641,98,46,144,1.7523364485981308,25.900611277846483
Task_34309,1696,721,172,46,218,2.3490304709141276,35.80212413728377
Task_34310,2170,89,91,129,220,24.11111111111111,41.20002736495931
Task_34311,2136,432,126,104,230,4.933025404157044,42.6962574097765
Task_34312,2767,207,143,121,264,13.302884615384615,52.06007500121873
Task_34313,2361,1017,54,73,127,2.319253438113949,47.226993290421916
Task_34314,1305,711,155,111,266,1.8328651685393258,30.593665899926165
Task_34315,2417,168,143,141,284,14.301775147928995,46.22813207000727
Task_34316,1927,503,141,102,243,3.8234126984126986,39.67242420529225
Task_34317,1889,650,104,65,169,2.901689708141321,38.505958525209536
Task_34318,2070,250,85,174,259,8.247011952191235,41.318044265213395
Task_34319,752,502,127,42,169,1.4950298210735586,19.748821753959938
Task_34320,861,314,109,162,271,2.7333333333333334,22.412766610202624
Task_34321,1067,1018,171,149,320,1.0471050049067714,27.94581517402881
Task_34322,543,152,173,191,364,3.549019607843137,17.009840618716243
Task_34323,2669,846,197,10,207,3.1511216056670603,51.41761274057735
Task_34324,2175,856,74,102,176,2.5379229871645275,44.38537788660472
Task_34325,2281,998,43,26,69,2.2832832832832834,44.35659432621225
Task_34326,1499,1009,190,117,307,1.4841584158415841,34.74387763186297
Task_34327,2449,742,42,80,122,3.2960969044414536,47.73564316671169
Task_34328,1478,99,160,189,349,14.78,31.086548687794345
Task_34329,2027,84,61,24,85,23.847058823529412,36.786714768681044
Task_34330,1787,519,148,135,283,3.4365384615384613,37.73559150022411
Task_34331,1023,255,124,113,237,3.99609375,24.55613424986207
Task_34332,2612,462,173,13,186,5.6414686825053995,49.055259914825626
Task_34333,1951,116,109,141,250,16.675213675213676,38.260140129303885
Task_34334,547,500,197,30,227,1.091816367265469,16.968531591633443
Task_34335,2480,227,186,150,336,10.87719298245614,47.97417932459812
Task_34336,2999,592,29,40,69,5.057335581787521,54.45291526742918
Task_34337,2630,204,181,50,231,12.829268292682928,48.99552664660809
Task_34338,1922,761,106,127,233,2.522309711286089,40.398634257156026
Task_34339,1428,1006,114,69,183,1.4180734856007944,32.31371889095693
Task_34340,502,688,27,126,153,0.7285921625544267,16.94755705353779
Task_34341,2934,77,28,120,148,37.61538461538461,52.283012943585305
Task_34342,2321,653,143,23,166,3.5489296636085625,45.057373603861855
Task_34343,2309,326,138,191,329,7.061162079510703,45.65474727067137
Task_34344,1876,274,13,188,201,6.821818181818182,38.10467345548836
Task_34345,1694,453,134,165,299,3.7312775330396475,36.16882455507585
Task_34346,2889,893,114,114,228,3.2315436241610738,56.09113369684538
Task_34347,2889,432,190,55,245,6.672055427251732,54.18343476859414
Task_34348,1635,197,12,65,77,8.257575757575758,31.937018552559127
Task_34349,2060,148,52,175,227,13.825503355704697,40.40059694901111
Task_34350,1704,110,117,11,128,15.35135135135135,32.71657680223039
Task_34351,2999,631,101,14,115,4.745253164556962,55.16005556329037
Task_34352,1486,164,10,50,60,9.006060606060606,29.070548278632103
Task_34353,2685,342,42,49,91,7.82798833819242,49.20582460615602
Task_34354,1377,816,160,127,287,1.6854345165238678,32.1657038184403
Task_34355,807,430,59,113,172,1.8723897911832947,21.49152650288509
Task_34356,1628,942,77,28,105,1.7264050901378578,34.43357910367946
Task_34357,1201,672,149,41,190,1.7845468053491829,27.678121131379612
Task_34358,1584,487,178,80,258,3.2459016393442623,33.94150523888488
Task_34359,2624,393,107,161,268,6.659898477157361,50.54498428210536
Task_34360,1534,373,200,182,382,4.101604278074866,33.7779224898962
Task_34361,1585,707,62,149,211,2.2387005649717513,34.952353685965456
Task_34362,2197,340,117,48,165,6.442815249266862,42.2328047645631
Task_34363,1078,415,186,43,229,2.5913461538461537,25.107891013438064
Task_34364,1564,165,180,199,379,9.421686746987952,33.25200476626306
Task_34365,872,576,88,92,180,1.511265164644714,22.589292420793168
Task_34366,1518,907,135,103,238,1.671806167400881,34.426405895582995
Task_34367,2662,774,191,89,280,3.4348387096774196,52.131328025799085
Task_34368,513,930,32,126,158,0.5510204081632653,17.95329723528263
Task_34369,1864,601,166,94,260,3.096345514950166,38.99525277120333
Task_34370,2849,669,182,61,243,4.2522388059701495,54.21269686618201
Task_34371,1934,962,180,100,280,2.0083073727933543,41.387495257737875
Task_34372,2928,753,83,178,261,3.883289124668435,56.56513068186336
Task_34373,2217,583,149,93,242,3.796232876712329,44.43605450913404
Task_34374,1323,814,199,61,260,1.6233128834355828,30.574162044535058
Task_34375,927,204,96,60,156,4.521951219512195,21.666603502061445
Task_34376,1274,631,115,118,233,2.0158227848101267,29.71453278661018
Task_34377,1610,791,127,12,139,2.032828282828283,33.891962506906516
Task_34378,1784,846,182,18,200,2.106257378984652,37.25931958445895
Task_34379,1045,752,178,138,316,1.3877822045152723,26.799005631907434
Task_34380,1873,540,28,63,91,3.4621072088724585,37.323837542596564
Task_34381,2377,746,78,154,232,3.182061579651941,47.72546272203591
Task_34382,2124,985,116,44,160,2.154158215010142,42.84353664053455
Task_34383,966,751,138,36,174,1.2845744680851063,24.062413200072893
Task_34384,2100,279,124,108,232,7.5,41.62911813394742
Task_34385,2764,816,59,170,229,3.383108935128519,54.1103449327293
Task_34386,2855,820,184,113,297,3.4774665042630937,55.6329425534643
Task_34387,2868,675,124,14,138,4.242603550295858,53.405204309393035
Task_34388,2795,246,52,104,156,11.31578947368421,51.99153177453923
Task_34389,738,647,103,46,149,1.1388888888888888,19.82786939145917
Task_34390,2343,704,109,83,192,3.323404255319149,46.34433575118282
Task_34391,2981,617,41,184,225,4.823624595469256,56.77813551488257
Task_34392,900,737,107,161,268,1.2195121951219512,24.21798979253191
Task_34393,2495,666,193,109,302,3.7406296851574212,49.46125612771632
Task_34394,960,879,129,135,264,1.0909090909090908,25.5310564698575
Task_34395,1266,285,185,177,362,4.426573426573427,29.15347404868101
Task_34396,1230,657,33,109,142,1.8693009118541033,28.426015163612913
Task_34397,1060,475,191,30,221,2.226890756302521,24.99388490494758
Task_34398,1115,505,30,164,194,2.2035573122529644,26.734506782916828
Task_34399,1261,573,116,98,214,2.196864111498258,29.215430724480015
Task_34400,2444,354,11,26,37,6.884507042253521,44.62782707760968
Task_34401,1700,562,146,60,206,3.019538188277087,35.513472137374315
Task_34402,1377,442,139,188,327,3.108352144469526,31.276217186150003
Task_34403,2363,981,56,188,244,2.4063136456211813,48.37021326518498
Task_34404,1063,937,58,87,145,1.1332622601279319,26.490243538221534
Task_34405,1969,77,50,30,80,25.243589743589745,35.94938064455514
Task_34406,1671,215,180,112,292,7.736111111111111,34.89973120558552
Task_34407,599,947,107,45,152,0.6318565400843882,18.82389550816897
Task_34408,1163,876,67,61,128,1.3261117445838084,27.667712970063633
Task_34409,640,396,72,70,142,1.6120906801007557,17.909698918022205
Task_34410,2787,954,137,24,161,2.918324607329843,53.23477834232295
Task_34411,2656,953,12,12,24,2.7840670859538785,49.70189208511968
Task_34412,1049,909,88,92,180,1.1527472527472526,26.342045100074472
Task_34413,851,284,12,156,168,2.9859649122807017,21.50231794787689
Task_34414,2133,919,179,177,356,2.3184782608695653,44.862471057651724
Task_34415,1724,976,177,171,348,1.7645854657113613,38.500339560450975
Task_34416,2033,762,168,167,335,2.6644823066841417,42.678595713013635
Task_34417,1694,732,128,66,194,2.311050477489768,35.96616361187475
Task_34418,1495,343,30,196,226,4.34593023255814,32.4215442102474
Task_34419,2398,755,16,61,77,3.171957671957672,45.72747390838946
Task_34420,665,306,188,79,267,2.1661237785016287,18.85546687893722
Task_34421,1105,166,75,34,109,6.616766467065868,23.51349569914554
Task_34422,1265,459,61,80,141,2.75,28.20146352643876
Task_34423,738,824,67,130,197,0.8945454545454545,21.68228236675831
Task_34424,2001,517,143,112,255,3.862934362934363,40.957446957718844
Task_34425,1748,542,113,15,128,3.2191528545119708,35.37687791842354
Task_34426,1835,715,157,145,302,2.5628491620111733,39.213838627513255
Task_34427,1705,1007,92,11,103,1.691468253968254,35.78729061312334
Task_34428,2764,613,169,98,267,4.501628664495114,53.382781863866
Task_34429,2789,998,94,200,294,2.7917917917917916,55.342024322560775
Task_34430,1676,170,106,34,140,9.801169590643275,32.77218733930125
Task_34431,2554,895,38,63,101,2.8504464285714284,49.368791658490835
Task_34432,1996,178,196,183,379,11.150837988826815,39.9950842061429
Task_34433,1717,768,80,170,250,2.2327698309492847,37.43979709396267
Task_34434,2772,297,38,44,82,9.302013422818792,50.26589500852356
Task_34435,1950,858,74,125,199,2.270081490104773,41.12072635400326
Task_34436,550,661,166,125,291,0.8308157099697885,18.528204345388474
Task_34437,1638,558,166,85,251,2.9302325581395348,35.007652263428206
Task_34438,2940,505,164,100,264,5.810276679841897,55.807997719546655
Task_34439,838,124,60,51,111,6.704,19.03301663930826
Task_34440,2004,916,140,71,211,2.1853871319520173,41.564321447294624
Task_34441,685,937,43,47,90,0.7302771855010661,19.623445691432558
Task_34442,692,267,172,90,262,2.582089552238806,19.27888712336846
Task_34443,2382,214,181,61,242,11.07906976744186,45.29346747363898
Task_34444,1374,313,111,42,153,4.375796178343949,28.792653526403356
Task_34445,1462,1015,31,113,144,1.438976377952756,33.10936323759379
Task_34446,2180,1014,122,152,274,2.147783251231527,45.49664811846403
Task_34447,1952,430,178,22,200,4.529002320185615,38.781835260121966
Task_34448,1699,984,145,108,253,1.7248730964467005,37.60847603340687
Task_34449,2186,532,38,190,228,4.101313320825516,43.93950875675165
Task_34450,884,106,184,15,199,8.261682242990654,20.23423906924207
Task_34451,2019,158,64,116,180,12.69811320754717,39.24047880939599
Task_34452,2346,1011,169,53,222,2.3181818181818183,47.33103976712465
Task_34453,2423,901,14,185,199,2.686252771618625,48.74806006623047
Task_34454,2078,521,194,121,315,3.9808429118773945,42.47294282793183
Task_34455,2909,802,124,170,294,3.62266500622665,56.501923384628846
Task_34456,1653,732,186,169,355,2.2551159618008185,36.657997658518546
Task_34457,2601,999,185,22,207,2.601,50.88860111848646
Task_34458,2719,636,153,45,198,4.268445839874412,51.61368233405795
Task_34459,1785,786,136,152,288,2.2681067344345616,38.59085873125841
Task_34460,2745,1004,47,37,84,2.7313432835820897,52.17095970663588
Task_34461,2688,411,106,193,299,6.524271844660194,51.80432271222664
Task_34462,1333,969,190,150,340,1.3742268041237113,32.16082691431829
Task_34463,819,644,124,114,238,1.2697674418604652,22.459445551575225
Task_34464,2603,813,195,128,323,3.197788697788698,51.75757151426982
Task_34465,1698,235,53,95,148,7.194915254237288,34.60325622148525
Task_34466,1009,216,143,153,296,4.649769585253456,24.528374569884864
Task_34467,1902,767,23,130,153,2.4765625,39.49057930302714
Task_34468,776,783,121,117,238,0.9897959183673469,22.2426631312789
Task_34469,967,719,104,181,285,1.3430555555555554,25.412165477462654
Task_34470,2566,570,180,97,277,4.493870402802101,50.183750025777265
Task_34471,1360,866,136,199,335,1.5686274509803921,32.344236919116156
Task_34472,2791,261,120,10,130,10.65267175572519,50.88335886626965
Task_34473,2795,673,59,107,166,4.146884272997033,53.5994414956022
Task_34474,1065,972,28,168,196,1.094552929085303,27.17399417426115
Task_34475,2041,601,138,165,303,3.3903654485049834,42.15176646873924
Task_34476,2128,266,130,68,198,7.9700374531835205,41.37335982306757
Task_34477,2436,702,57,113,170,3.465149359886202,48.02182010470877
Task_34478,2653,285,164,70,234,9.276223776223777,49.90048645986815
Task_34479,1226,146,45,98,143,8.34013605442177,26.054974880457248
Task_34480,865,363,55,78,133,2.3763736263736264,21.65713912548397
Task_34481,2541,304,130,134,264,8.331147540983606,48.870739997938244
Task_34482,2454,240,125,105,230,10.182572614107883,47.068949870611526
Task_34483,1718,675,163,175,338,2.5414201183431953,37.441445677636004
Task_34484,2831,475,170,109,279,5.947478991596639,54.065331432405706
Task_34485,504,879,151,182,333,0.5727272727272728,18.866472080715123
Task_34486,504,466,104,183,287,1.0792291220556745,17.20168785388827
Task_34487,2098,299,187,75,262,6.993333333333333,41.38948058760139
Task_34488,1854,606,16,155,171,3.054365733113674,38.36514665684198
Task_34489,2842,979,132,100,232,2.9,55.6127963690667
Task_34490,1422,527,182,12,194,2.6931818181818183,30.614808885612636
Task_34491,954,347,42,169,211,2.7413793103448274,23.74284409952079
Task_34492,1468,330,95,95,190,4.435045317220544,31.6300774150468
Task_34493,2020,426,78,166,244,4.730679156908665,41.125607593600215
Task_34494,2301,730,18,139,157,3.1477428180574556,45.640569875336524
Task_34495,1117,100,51,11,62,11.05940594059406,22.448473676728003
Task_34496,1192,256,184,81,265,4.638132295719845,26.98605526040922
Task_34497,2414,382,33,34,67,6.302872062663186,44.5279896796219
Task_34498,2046,354,24,193,217,5.763380281690141,41.130404386879746
Task_34499,1182,301,181,176,357,3.9139072847682117,27.854278581029124
Task_34500,671,595,27,134,161,1.1258389261744965,19.255932662789913
Task_34501,786,768,139,142,281,1.0221066319895968,22.526187087891454
Task_34502,1641,363,87,65,152,4.508241758241758,33.43197295284881
Task_34503,2855,344,38,102,140,8.27536231884058,53.071712235815255
Task_34504,1844,516,14,123,137,3.5667311411992264,37.70563647049482
Task_34505,2951,659,99,32,131,4.471212121212122,54.901514313839876
Task_34506,1033,956,16,17,33,1.0794148380355277,23.996273968101203
Task_34507,1406,350,37,85,122,4.005698005698005,29.994495199760763
Task_34508,2942,764,193,13,206,3.845751633986928,55.476636315654076
Task_34509,2021,164,141,66,207,12.248484848484848,39.11652898016343
Task_34510,2157,668,60,113,173,3.2242152466367715,43.594777842209176
Task_34511,2785,404,100,28,128,6.8765432098765435,51.48832433384396
Task_34512,1944,173,61,177,238,11.172413793103448,38.6080617535993
Task_34513,2438,443,86,140,226,5.490990990990991,47.58864793428057
Task_34514,1260,1017,10,137,147,1.237721021611002,29.900198215752862
Task_34515,2128,859,51,112,163,2.474418604651163,43.653860770628505
Task_34516,800,580,151,160,311,1.3769363166953528,22.393537066316128
Task_34517,2643,582,41,114,155,4.5334476843910805,50.58219522050775
Task_34518,2567,955,14,157,171,2.685146443514644,50.836537447865055
Task_34519,2276,1013,191,174,365,2.244575936883629,47.45726770302094
Task_34520,559,757,83,173,256,0.737467018469657,18.902609381949286
Task_34521,586,544,89,165,254,1.075229357798165,18.556074978685427
Task_34522,1455,156,110,122,232,9.26751592356688,30.73473985035484
Task_34523,2005,805,45,44,89,2.4875930521091814,39.76048331166226
Task_34524,1235,213,116,132,248,5.771028037383178,27.839358019583013
Task_34525,2472,606,39,95,134,4.072487644151565,47.895792545124976
Task_34526,1646,220,128,131,259,7.447963800904978,34.40219468904748
Task_34527,2567,508,194,126,320,5.043222003929273,50.20299598433106
Task_34528,1478,810,26,166,192,1.8224414303329224,33.43061848873393
Task_34529,1394,567,118,89,207,2.454225352112676,31.067141484312412
Task_34530,2110,494,89,76,165,4.262626262626263,41.77780573300478
Task_34531,2285,792,143,115,258,2.8814627994955866,46.3415902170764
Task_34532,1977,267,110,41,151,7.376865671641791,38.193006074245666
Task_34533,1289,353,160,185,345,3.6412429378531073,29.674919022230302
Task_34534,674,783,171,188,359,0.8596938775510204,21.27718817721495
Task_34535,2762,565,189,103,292,4.879858657243816,53.3141948400723
Task_34536,2580,988,142,108,250,2.608695652173913,51.581869773365646
Task_34537,2844,862,16,177,193,3.295480880648899,55.17882080452958
Task_34538,2560,90,135,160,295,28.13186813186813,47.74531544678624
Task_34539,1481,393,73,36,109,3.7588832487309647,30.517517999210664
Task_34540,2093,379,108,80,188,5.507894736842105,41.28418250553528
Task_34541,1784,447,30,48,78,3.982142857142857,34.893836617247146
Task_34542,796,327,152,132,284,2.426829268292683,21.4411077282905
Task_34543,1822,747,44,59,103,2.435828877005348,37.10840807988678
Task_34544,767,427,106,181,287,1.7920560747663552,21.38397512551141
Task_34545,1215,482,173,67,240,2.515527950310559,27.82836097917207
Task_34546,1770,483,36,46,82,3.65702479338843,35.055313263185056
Task_34547,2802,253,58,130,188,11.031496062992126,52.58040027445892
Task_34548,1881,497,111,155,266,3.7771084337349397,39.10636827362781
Task_34549,878,713,21,130,151,1.2296918767507004,22.81460956029352
Task_34550,2843,893,36,171,207,3.180089485458613,55.360073672685864
Task_34551,2055,87,97,61,158,23.352272727272727,38.18448012159647
Task_34552,2477,462,131,65,196,5.3498920086393085,47.540723427511644
Task_34553,2551,193,11,188,199,13.149484536082474,48.37332526354601
Task_34554,2802,602,161,158,319,4.646766169154229,54.26848192592794
Task_34555,1842,644,29,90,119,2.855813953488372,37.83215736051002
Task_34556,2110,256,23,142,165,8.210116731517509,41.47778937871213
Task_34557,1931,777,126,196,322,2.482005141388175,41.093516651960975
Task_34558,2076,671,23,87,110,3.0892857142857144,41.539449181825795
Task_34559,1629,672,150,175,325,2.4205052005943535,35.96374452768289
Task_34560,2236,889,35,58,93,2.512359550561798,44.10286406962126
Task_34561,1224,115,136,176,312,10.551724137931034,27.151985463867646
Task_34562,975,829,124,36,160,1.1746987951807228,24.202912713845887
Task_34563,2020,772,198,26,224,2.6131953428201813,41.08982401096311
Task_34564,2534,556,133,124,257,4.549371633752244,49.54804376169276
Task_34565,2814,74,34,53,87,37.52,49.46520764204923
Task_34566,2893,404,91,144,235,7.14320987654321,54.713896869977596
Task_34567,1070,325,126,69,195,3.2822085889570554,24.802189861332057
Task_34568,1803,648,100,29,129,2.778120184899846,36.69836908436412
Task_34569,656,436,81,113,194,1.5011441647597255,19.196115599210028
Task_34570,723,910,58,147,205,0.7936333699231614,21.810806651428877
Task_34571,2774,206,86,121,207,13.400966183574878,51.9516362863044
Task_34572,2267,781,49,185,234,2.898976982097187,46.17719296478734
Task_34573,2377,495,10,28,38,4.792338709677419,44.04982576858194
Task_34574,952,209,120,19,139,4.533333333333333,21.52277867167072
Task_34575,1264,202,158,137,295,6.226600985221675,28.477537479446813
Task_34576,2372,716,35,42,77,3.308228730822873,44.91721246168951
Task_34577,1144,866,97,23,120,1.3194925028835063,26.643034367484564
Task_34578,1139,321,176,51,227,3.5372670807453415,26.004052274147835
Task_34579,501,576,187,46,233,0.8682842287694974,16.529438253690472
Task_34580,1949,355,159,20,179,5.474719101123595,38.07880382542107
Task_34581,2793,873,38,49,87,3.1956521739130435,52.551623033716474
Task_34582,2771,933,74,10,84,2.9668094218415417,52.292984760634056
Task_34583,2986,853,159,86,245,3.496487119437939,57.27412690624258
Task_34584,2325,571,79,172,251,4.064685314685315,46.46052163069556
Task_34585,2333,608,44,51,95,3.8308702791461413,44.7525902620827
Task_34586,2712,180,54,89,143,14.98342541436464,49.7389385015291
Task_34587,2280,148,18,61,79,15.302013422818792,41.833292839067234
Task_34588,2725,910,177,77,254,2.991218441273326,53.25002695620557
Task_34589,2763,565,155,36,191,4.881625441696113,52.10132933824729
Task_34590,2720,513,129,52,181,5.291828793774319,51.31346803997172
Task_34591,2896,435,121,86,207,6.6422018348623855,54.340149799155235
Task_34592,578,777,183,104,287,0.7429305912596401,19.241048071719955
Task_34593,2818,794,141,54,195,3.5446540880503146,53.962889376563794
Task_34594,2750,456,39,65,104,6.017505470459518,51.105715420811606
Task_34595,2298,745,198,173,371,3.0804289544235925,46.99444889986023
Task_34596,2062,506,14,109,123,4.067061143984221,41.07894287100515
Task_34597,1624,1008,102,98,200,1.6095143706640238,36.24415303551002
Task_34598,2509,103,142,27,169,24.125,45.588614500212316
Task_34599,1078,983,102,132,234,1.0955284552845528,27.583026251847556
Task_34600,2982,413,130,96,226,7.202898550724638,56.01583403990191
Task_34601,1853,243,25,143,168,7.594262295081967,37.22567664205534
Task_34602,2008,911,87,151,238,2.2017543859649122,42.29543525466764
Task_34603,1089,117,145,162,307,9.228813559322035,25.0519043959309
Task_34604,1357,157,48,142,190,8.58860759493671,29.12489517816968
Task_34605,1826,683,98,146,244,2.6695906432748537,38.724947531289004
Task_34606,568,774,48,147,195,0.7329032258064516,18.85523000912625
Task_34607,2556,766,73,90,163,3.332464146023468,49.90860754484253
Task_34608,1777,410,48,152,200,4.32360097323601,37.00193074555654
Task_34609,720,458,15,188,203,1.5686274509803921,20.372242730272784
Task_34610,2494,601,98,184,282,4.142857142857143,49.27287063362229
Task_34611,2477,559,170,140,310,4.423214285714286,48.917407242778985
Task_34612,2889,694,14,174,188,4.1568345323741,55.377334745776984
Task_34613,2280,697,53,182,235,3.2664756446991405,46.128399602189155
Task_34614,1411,583,107,132,239,2.416095890410959,31.78137464312808
Task_34615,2818,992,138,105,243,2.837865055387714,55.329955981661044
Task_34616,633,299,65,73,138,2.11,17.53397685757808
Task_34617,1202,688,103,99,202,1.74455732946299,28.556188780742033
Task_34618,1469,87,92,106,198,16.693181818181817,30.072815386859656
Task_34619,805,624,191,92,283,1.288,22.259289702157293
Task_34620,1050,842,190,170,360,1.2455516014234875,27.347759389595407
Task_34621,2596,95,80,90,170,27.041666666666668,47.401647417733194
Task_34622,2404,266,37,143,180,9.00374531835206,46.04656386813559
Task_34623,2355,104,11,112,123,22.428571428571427,43.19065713661271
Task_34624,2754,956,34,103,137,2.877742946708464,53.45995389213919
Task_34625,1192,473,160,132,292,2.5147679324894514,28.206450818197805
Task_34626,1650,667,29,104,133,2.470059880239521,35.110534079825065
Task_34627,900,367,63,35,98,2.4456521739130435,20.91752763383597
Task_34628,2942,149,25,150,175,19.613333333333333,53.80219069263929
Task_34629,696,829,126,37,163,0.8385542168674699,19.95446756576942
Task_34630,507,1015,65,115,180,0.49901574803149606,18.382791989390505
Task_34631,2693,176,81,64,145,15.214689265536723,49.26865034572754
Task_34632,2026,190,100,11,111,10.607329842931938,38.4702708426285
Task_34633,2448,306,116,45,161,7.973941368078176,45.78558064700716
Task_34634,2578,651,168,39,207,3.9539877300613497,49.47734088525262
Task_34635,805,141,15,85,100,5.669014084507042,19.091706486108176
Task_34636,733,829,28,191,219,0.8831325301204819,21.669407236935758
Task_34637,1310,852,118,165,283,1.5357561547479484,31.224351763471734
Task_34638,1428,904,93,28,121,1.5779005524861878,31.453714029603745
Task_34639,1435,313,96,24,120,4.570063694267516,29.535405888075882
Task_34640,2270,406,96,31,127,5.577395577395578,43.29012294099161
Task_34641,2940,604,80,21,101,4.859504132231405,54.13591471701102
Task_34642,712,886,84,169,253,0.8027057497181511,21.724089093369102
Task_34643,2246,971,60,159,219,2.3106995884773665,46.29914252800082
Task_34644,891,955,151,45,196,0.9320083682008368,23.729773541717748
Task_34645,2839,718,91,112,203,3.9485396383866482,54.682157052704504
Task_34646,1242,537,146,128,274,2.308550185873606,29.112673185916762
Task_34647,1303,395,78,163,241,3.29040404040404,29.661419018446228
Task_34648,2020,83,116,168,284,24.047619047619047,39.14422027234658
Task_34649,1365,500,177,63,240,2.7245508982035926,30.23381330822936
Task_34650,690,545,122,61,183,1.2637362637362637,19.129994841269102
Task_34651,1381,454,152,191,343,3.035164835164835,31.45423654085023
Task_34652,2678,394,93,92,185,6.779746835443038,50.789186855856315
Task_34653,2606,328,166,65,231,7.920972644376899,49.29217977551796
Task_34654,2942,926,125,163,288,3.173678532901834,57.376514020017886
Task_34655,686,890,107,197,304,0.7699214365881033,21.58682481992066
Task_34656,2408,541,118,108,226,4.442804428044281,47.34170736063001
Task_34657,1266,337,79,160,239,3.7455621301775146,28.87554321177304
Task_34658,2786,560,67,146,213,4.966131907308378,53.5073585687847
Task_34659,2277,751,200,194,394,3.0279255319148937,46.81505632762177
Task_34660,993,705,116,100,216,1.406515580736544,25.322890341174354
Task_34661,2995,969,134,35,169,3.0876288659793816,56.75645368622182
Task_34662,2926,839,76,88,164,3.4833333333333334,55.99963644896329
Task_34663,696,263,101,77,178,2.6363636363636362,18.539394344366325
Task_34664,574,519,195,123,318,1.103846153846154,18.526457458796596
Task_34665,2293,138,32,42,74,16.496402877697843,41.63526391997151
Task_34666,1559,903,43,50,93,1.7245575221238938,33.243936327294854
Task_34667,652,474,21,13,34,1.3726315789473684,16.39735273976734
Task_34668,1027,112,186,69,255,9.08849557522124,23.01226362983697
Task_34669,944,216,171,199,370,4.350230414746544,23.902964748380644
Task_34670,2438,995,192,189,381,2.4477911646586343,50.06258102478114
Task_34671,1215,885,127,124,251,1.3713318284424378,29.598497610164628
Task_34672,1181,1024,76,173,249,1.1521951219512194,29.64996006493006
Task_34673,1079,557,106,180,286,1.9336917562724014,26.724763472546304
Task_34674,705,270,16,119,135,2.6014760147601477,18.800802021182115
Task_34675,2874,790,161,153,314,3.6333754740834387,55.97487358027163
Task_34676,2234,424,199,171,370,5.2564705882352944,44.950317661208565
Task_34677,842,403,94,199,293,2.0841584158415842,22.63249217142332
Task_34678,1433,629,14,99,113,2.2746031746031745,31.451177166529305
Task_34679,957,637,134,178,312,1.5,25.11389953363131
Task_34680,967,723,23,146,169,1.3356353591160222,24.72456139175019
Task_34681,1764,113,142,189,331,15.473684210526315,35.70975449856957
Task_34682,1583,84,126,54,180,18.623529411764707,31.106822441209115
Task_34683,2706,74,54,158,212,36.08,49.5673148844866
Task_34684,1600,656,50,17,67,2.43531202435312,32.23484115585793
Task_34685,791,242,148,112,260,3.2551440329218106,20.94985300353782
Task_34686,2405,1013,56,81,137,2.371794871794872,48.03112281669484
Task_34687,1539,863,176,170,346,1.78125,35.20746029985551
Task_34688,1379,792,37,36,73,1.7389659520807061,29.41429927404776
Task_34689,1123,1002,191,100,291,1.119641076769691,28.550385226263757
Task_34690,2940,704,36,62,98,4.170212765957447,54.731740978049054
Task_34691,807,852,162,71,233,0.9460726846424384,22.54447262957311
Task_34692,1261,244,180,83,263,5.146938775510204,28.05937417575876
Task_34693,2250,281,187,177,364,7.9787234042553195,44.70322735567038
Task_34694,1640,64,87,173,260,25.23076923076923,32.96957648764887
Task_34695,539,704,138,72,210,0.7645390070921986,17.73069383408158
Task_34696,1774,743,29,69,98,2.3844086021505375,36.49959282231003
Task_34697,860,783,81,133,214,1.096938775510204,23.469153765133893
Task_34698,1823,344,187,101,288,5.284057971014493,37.71205685586105
Task_34699,1999,650,155,93,248,3.0706605222734256,41.22249040394957
Task_34700,2914,867,46,137,183,3.357142857142857,56.088634305152084
Task_34701,555,414,156,136,292,1.3373493975903614,17.90436996928357
Task_34702,2913,853,69,154,223,3.411007025761124,56.50359364925063
Task_34703,1070,1012,184,14,198,1.0562685093780848,26.495745984765353
Task_34704,673,933,24,37,61,0.7205567451820128,19.000313201727398
Task_34705,1981,955,64,191,255,2.0721757322175733,42.25921953863426
Task_34706,702,301,148,42,190,2.3245033112582782,18.608573092873655
Task_34707,2761,685,92,30,122,4.024781341107872,51.924592055849786
Task_34708,1547,248,135,174,309,6.21285140562249,33.225725638367514
Task_34709,1329,513,64,59,123,2.585603112840467,28.833389612046272
Task_34710,1129,200,133,196,329,5.616915422885572,26.579239861821396
Task_34711,2855,188,165,179,344,15.105820105820106,53.855162208409716
Task_34712,2602,795,10,13,23,3.2688442211055277,48.36169565908821
Task_34713,1345,414,110,51,161,3.2409638554216866,28.985113203307588
Task_34714,752,343,193,45,238,2.186046511627907,19.723576348278034
Task_34715,1508,280,150,54,204,5.366548042704626,31.613763559733684
Task_34716,992,998,145,152,297,0.992992992992993,26.64741318006921
Task_34717,2758,686,124,69,193,4.014556040756914,52.668236354140014
Task_34718,917,401,58,131,189,2.281094527363184,23.28842383820682
Task_34719,2308,193,188,25,213,11.896907216494846,43.74021439345439
Task_34720,2974,930,135,106,241,3.1944146079484423,57.6007096381334
Task_34721,2808,612,24,63,87,4.580750407830343,52.28808947497834
Task_34722,1352,459,122,15,137,2.9391304347826086,28.760937978190444
Task_34723,1603,197,172,93,265,8.095959595959595,33.59082976870682
Task_34724,1295,182,120,93,213,7.076502732240437,28.242785879425757
Task_34725,1248,491,137,133,270,2.5365853658536586,29.052090794479213
Task_34726,2634,836,198,183,381,3.1469534050179213,52.66288708913087
Task_34727,1612,316,37,17,54,5.085173501577287,31.3769843152448
Task_34728,1060,381,30,155,185,2.774869109947644,25.291639808248206
Task_34729,517,662,35,66,101,0.779788838612368,16.368395646585167
Task_34730,768,244,16,68,84,3.1346938775510202,18.854800547841457
Task_34731,2129,405,44,122,166,5.24384236453202,42.07432099877234
Task_34732,2894,224,120,157,277,12.862222222222222,54.24523170085549
Task_34733,2972,347,20,180,200,8.540229885057471,55.59598239210248
Task_34734,846,107,154,111,265,7.833333333333333,20.678341217406928
Task_34735,1814,211,143,57,200,8.556603773584905,36.14774548294739
Task_34736,1020,387,82,62,144,2.6288659793814433,23.78650343521382
Task_34737,1829,953,19,82,101,1.9171907756813418,38.254613035527434
Task_34738,521,588,49,21,70,0.8845500848896435,15.313105901567654
Task_34739,1415,943,11,67,78,1.4989406779661016,30.903468241271778
Task_34740,2615,695,161,133,294,3.757183908045977,51.45284076525311
Task_34741,1278,608,184,69,253,2.0985221674876846,29.254007095948683
Task_34742,2731,1008,21,175,196,2.7066402378592667,53.87240530425706
Task_34743,2403,400,109,54,163,5.992518703241895,45.84168502469523
Task_34744,988,809,117,174,291,1.219753086419753,25.958060383199154
Task_34745,2346,233,154,190,344,10.025641025641026,45.97512022138894
Task_34746,957,174,170,125,295,5.468571428571429,23.142935464062262
Task_34747,824,688,167,17,184,1.1959361393323658,21.317538865369503
Task_34748,1499,817,162,93,255,1.832518337408313,33.85574510451064
Task_34749,2497,548,37,95,132,4.548269581056466,48.15476426534883
Task_34750,1420,675,98,80,178,2.100591715976331,31.397230363472133
Task_34751,2418,414,158,71,229,5.8265060240963855,46.61144098719401
Task_34752,2747,1010,143,192,335,2.7171117705242334,54.80314146180996
Task_34753,590,498,79,43,122,1.182364729458918,16.92245412856799
Task_34754,2998,145,199,51,250,20.534246575342465,54.54440380693518
Task_34755,1272,984,120,39,159,1.2913705583756345,29.302864674035664
Task_34756,1928,731,22,20,42,2.633879781420765,37.50802741734222
Task_34757,2609,183,131,30,161,14.179347826086957,48.021040274000995
Task_34758,1793,217,26,163,189,8.224770642201834,36.45807379473667
Task_34759,537,483,147,146,293,1.109504132231405,17.7352557764865
Task_34760,1939,72,131,28,159,26.561643835616437,35.99330305726689
Task_34761,2320,766,144,141,285,3.0247718383311604,46.97437380250193
Task_34762,1095,385,156,18,174,2.8367875647668392,24.696994014210535
Task_34763,2525,439,143,35,178,5.738636363636363,47.68831436205807
Task_34764,1568,135,46,195,241,11.529411764705882,32.47426885532472
Task_34765,2298,831,98,64,162,2.762019230769231,45.46174579153695
Task_34766,1208,920,121,57,178,1.3116178067318132,28.523963793901263
Task_34767,1683,277,160,149,309,6.053956834532374,35.43810450346184
Task_34768,1378,303,100,128,228,4.532894736842105,30.308012404036134
Task_34769,1939,371,167,177,344,5.212365591397849,40.00010793124704
Task_34770,2362,546,53,41,94,4.318098720292505,44.706499839144215
Task_34771,2747,520,78,173,251,5.272552783109405,52.98021299470767
Task_34772,1641,287,113,45,158,5.697916666666667,32.93891809808732
Task_34773,2893,72,51,125,176,39.63013698630137,52.16649894848758
Task_34774,2677,338,132,105,237,7.896755162241888,50.97527922763811
Task_34775,2628,505,22,170,192,5.1936758893280635,50.61608011636962
Task_34776,2399,892,193,88,281,2.686450167973124,48.272690498109306
Task_34777,1077,255,172,163,335,4.20703125,25.924390296116844
Task_34778,1912,434,10,36,46,4.395402298850574,36.651685315632655
Task_34779,779,389,70,26,96,1.9974358974358974,19.27983189151868
Task_34780,2008,908,136,25,161,2.209020902090209,40.750976863211896
Task_34781,674,79,98,151,249,8.425,17.844116711798396
Task_34782,2969,846,108,120,228,3.5053128689492326,57.22009512498187
Task_34783,1608,542,61,195,256,2.9613259668508287,35.06862284700066
Task_34784,1785,620,53,162,215,2.8743961352657004,37.92623275387113
Task_34785,1771,127,123,192,315,13.8359375,35.92564758996273
Task_34786,1869,658,90,48,138,2.836115326251897,37.73667213228635
Task_34787,1207,828,48,193,241,1.4559710494571774,29.428971869206563
Task_34788,557,720,124,56,180,0.7725381414701803,17.69464067109298
Task_34789,2064,90,79,36,115,22.681318681318682,37.88655046191193
Task_34790,677,257,193,195,388,2.624031007751938,19.89613917057388
Task_34791,1935,633,61,88,149,3.05205047318612,39.419446574759185
Task_34792,1768,282,53,13,66,6.247349823321555,33.707922399272896
Task_34793,1776,290,25,27,52,6.103092783505154,34.139632693536576
Task_34794,1596,493,166,130,296,3.230769230769231,34.68034284153456
Task_34795,2151,506,64,167,231,4.242603550295858,43.39749762742847
Task_34796,1931,902,100,93,193,2.1384274640088594,40.68365359483959
Task_34797,2201,390,195,158,353,5.629156010230179,44.22073685649997
Task_34798,1708,922,174,84,258,1.8504875406283856,37.265654473039675
Task_34799,2109,172,132,20,152,12.190751445086706,39.51672490244716
Task_34800,583,379,111,102,213,1.5342105263157895,17.82961435135959
Task_34801,2027,286,172,185,357,7.062717770034843,41.17580612632116
Task_34802,1584,343,14,169,183,4.604651162790698,33.41862711232767
Task_34803,829,312,14,84,98,2.648562300319489,20.377061694920208
Task_34804,542,962,48,30,78,0.5628245067497404,16.83645298045077
Task_34805,1881,418,134,126,260,4.4892601431980905,38.78264306084073
Task_34806,2221,478,153,26,179,4.6367432150313155,42.95740384344176
Task_34807,2448,185,12,36,48,13.161290322580646,44.41892787922043
Task_34808,1093,614,43,189,232,1.7772357723577237,26.894630356205326
Task_34809,1201,467,140,76,216,2.5662393162393164,27.54389588098765
Task_34810,1057,182,156,37,193,5.775956284153006,23.9052032551067
Task_34811,1868,414,57,187,244,4.501204819277109,38.739921185130676
Task_34812,2934,780,111,145,256,3.7567221510883484,56.62080648958973
Task_34813,2900,314,99,59,158,9.206349206349206,53.19157066075039
Task_34814,1506,913,48,85,133,1.6477024070021882,33.531638010562226
Task_34815,709,822,163,12,175,0.8614823815309842,20.153725505001603
Task_34816,2487,1006,193,142,335,2.4697120158887786,50.59711920400275
Task_34817,2435,848,77,185,262,2.868080094228504,49.139990514463896
Task_34818,1760,834,88,90,178,2.1077844311377247,37.420579096020184
Task_34819,871,678,185,50,235,1.2827687776141385,22.751382078689772
Task_34820,1934,306,78,192,270,6.299674267100977,39.52295112132678
Task_34821,1742,975,135,185,320,1.7848360655737705,38.6902261076964
Task_34822,2310,666,151,115,266,3.4632683658170915,46.37755117405504
Task_34823,1722,866,145,41,186,1.986159169550173,36.395310958166924
Task_34824,2537,165,114,158,272,15.283132530120483,48.05183835720942
Task_34825,2146,1017,35,62,97,2.1080550098231825,43.144760767088826
Task_34826,2931,810,151,192,343,3.6140567200986435,57.128739410877905
Task_34827,727,650,156,191,347,1.1167434715821813,21.572012949116075
Task_34828,2642,411,17,152,169,6.412621359223301,50.18359004255381
Task_34829,1682,80,150,11,161,20.765432098765434,31.97393136760486
Task_34830,1088,888,26,58,84,1.2238470191226096,25.740645618867177
Task_34831,1017,90,185,63,248,11.175824175824175,22.76490607870929
Task_34832,2920,255,12,105,117,11.40625,53.68853392937148
Task_34833,1001,384,48,118,166,2.6,24.26197472430194
Task_34834,2482,618,159,60,219,4.009693053311794,48.13338666464204
Task_34835,701,336,164,20,184,2.080118694362018,18.30289854147395
Task_34836,2718,424,178,178,356,6.395294117647059,52.55713153660029
Task_34837,736,499,117,113,230,1.472,20.7082783177482
Task_34838,719,598,58,106,164,1.2003338898163607,20.39984871981486
Task_34839,2467,919,38,51,89,2.6815217391304347,47.779488156355406
Task_34840,2612,738,162,163,325,3.534506089309878,51.72469807218314
Task_34841,2015,65,106,15,121,30.53030303030303,36.58197844647105
Task_34842,1843,931,61,112,173,1.9774678111587982,39.44086992048303
Task_34843,739,545,23,71,94,1.3534798534798536,19.565195427492927
Task_34844,2001,244,96,121,217,8.16734693877551,39.94485823312119
Task_34845,518,791,196,188,384,0.6540404040404041,19.083135459137065
Task_34846,644,618,128,93,221,1.0403877221324718,19.407784167616743
Task_34847,2426,816,86,122,208,2.9694002447980417,48.47761929755375
Task_34848,1851,676,184,189,373,2.7341211225997046,39.72950574782778
Task_34849,755,883,82,78,160,0.8540723981900452,21.396043076424878
Task_34850,2040,483,192,146,338,4.214876033057851,41.88991625805537
Task_34851,1067,394,117,145,262,2.7012658227848103,25.861553392732116
Task_34852,1433,426,97,66,163,3.3559718969555035,30.608276346959197
Task_34853,950,169,99,174,273,5.588235294117647,23.09285263839708
Task_34854,1951,402,74,53,127,4.841191066997519,38.544690823092516
Task_34855,2881,201,121,95,216,14.262376237623762,53.55228383440934
Task_34856,1652,484,10,74,84,3.406185567010309,33.668116599211004
Task_34857,2708,878,22,84,106,3.080773606370876,51.98337370986615
Task_34858,912,368,172,22,194,2.4715447154471546,22.09922655709566
Task_34859,2022,365,15,58,73,5.524590163934426,38.55908885747085
Task_34860,1310,314,183,70,253,4.158730158730159,28.852177779049857
Task_34861,873,234,174,66,240,3.7148936170212767,21.59845032715233
Task_34862,2402,767,60,77,137,3.1276041666666665,47.105745380151156
Task_34863,1088,673,113,129,242,1.6142433234421365,26.942810313639388
Task_34864,1411,292,26,108,134,4.815699658703072,30.09340858599762
Task_34865,2741,887,58,184,242,3.0867117117117115,54.04752942648043
Task_34866,1572,706,137,183,320,2.2234794908062234,35.15642518054674
Task_34867,1634,701,20,15,35,2.3276353276353277,32.673924412215165
Task_34868,1340,245,10,49,59,5.4471544715447155,27.117076446488586
Task_34869,2021,574,16,158,174,3.514782608695652,41.059396615421086
Task_34870,1412,309,67,152,219,4.554838709677419,30.98228905557481
Task_34871,743,979,17,20,37,0.7581632653061224,19.626987939777695
Task_34872,2046,958,190,126,316,2.133472367049009,43.35022111600026
Task_34873,1726,507,183,108,291,3.3976377952755907,36.72814693621543
Task_34874,2014,710,170,175,345,2.832630098452883,42.271430943087246
Task_34875,967,445,43,168,211,2.1681614349775784,24.25801177980536
Task_34876,2522,412,14,64,78,6.106537530266344,46.812917685576885
Task_34877,1386,738,119,60,179,1.8755074424898512,30.778758613471606
Task_34878,2446,395,173,168,341,6.1767676767676765,48.074445518083884
Task_34879,2118,911,94,137,231,2.3223684210526314,44.061635456484574
Task_34880,2241,829,60,140,200,2.7,45.66350141813623
Task_34881,2763,148,55,28,83,18.543624161073826,49.23933917912084
Task_34882,941,314,114,99,213,2.9873015873015873,23.309230584842393
Task_34883,2235,898,98,84,182,2.486095661846496,45.016611553345605
Task_34884,839,693,140,98,238,1.2089337175792507,22.932095957790057
Task_34885,1949,875,112,66,178,2.2248858447488584,40.1838553854715
Task_34886,2881,753,77,28,105,3.820954907161804,53.71309256999129
Task_34887,1243,1023,76,129,205,1.2138671875,30.338162877257673
Task_34888,2712,342,109,125,234,7.906705539358601,51.558418097782294
Task_34889,2048,471,13,55,68,4.338983050847458,39.39665320410307
Task_34890,2282,714,25,199,224,3.1916083916083915,46.067703165355944
Task_34891,2122,261,184,85,269,8.099236641221374,41.77157383534115
Task_34892,2776,671,89,55,144,4.130952380952381,52.4741791962578
Task_34893,1803,320,59,101,160,5.616822429906542,36.56838456804799
Task_34894,1292,1007,95,165,260,1.2817460317460319,31.328600422454553
Task_34895,557,936,13,18,31,0.5944503735325507,16.844673278846656
Task_34896,1091,872,82,57,139,1.2497136311569301,26.28917137074834
Task_34897,1873,644,172,94,266,2.903875968992248,39.300334107564666
Task_34898,876,435,72,47,119,2.0091743119266057,21.12402649627825
Task_34899,2919,72,35,192,227,39.986301369863014,52.923997550425895
Task_34900,2634,511,158,198,356,5.14453125,51.54123205249507
Task_34901,1645,237,155,33,188,6.911764705882353,33.272291035963654
Task_34902,2193,394,125,149,274,5.5518987341772155,43.738101439312295
Task_34903,1078,512,93,170,263,2.101364522417154,26.56150213447764
Task_34904,2325,476,99,69,168,4.8742138364779874,44.8382319011084
Task_34905,742,184,105,112,217,4.010810810810811,19.637701070116435
Task_34906,1879,242,124,104,228,7.732510288065844,37.98210178505415
Task_34907,1351,100,27,145,172,13.376237623762377,28.19252870382057
Task_34908,1686,585,150,95,245,2.8771331058020477,36.08719794735934
Task_34909,654,626,36,106,142,1.0430622009569377,18.95325420415175
Task_34910,707,821,165,194,359,0.8600973236009732,21.926315172254018
Task_34911,1083,302,30,45,75,3.5742574257425743,23.15052538865608
Task_34912,2180,917,183,196,379,2.374727668845316,45.73249947219807
Task_34913,627,101,149,28,177,6.147058823529412,16.10927228732569
Task_34914,1344,325,10,18,28,4.122699386503068,26.902662496027503
Task_34915,2712,339,25,177,202,7.976470588235294,51.52866693671172
Task_34916,1635,992,169,68,237,1.646525679758308,36.06649406004439
Task_34917,742,805,164,124,288,0.9205955334987593,22.009397984241804
Task_34918,2188,407,120,192,312,5.362745098039215,43.93604852282355
Task_34919,1278,816,147,89,236,1.5642594859241126,30.098911999355753
Task_34920,1294,690,59,25,84,1.8726483357452968,28.06384715499534
Task_34921,1342,191,126,38,164,6.989583333333333,28.294960850255865
Task_34922,2995,126,27,67,94,23.58267716535433,53.06633486078464
Task_34923,2723,476,122,22,144,5.7085953878406706,50.6430988459742
Task_34924,2387,153,188,101,289,15.5,45.605744381144426
Task_34925,1689,874,89,143,232,1.9302857142857144,37.11820253298027
Task_34926,1778,506,143,14,157,3.5069033530571994,35.69963209119497
Task_34927,1478,1005,69,184,253,1.4691848906560636,34.368224288795886
Task_34928,2295,81,62,81,143,27.98780487804878,42.24457920594913
Task_34929,2060,81,82,42,124,25.121951219512194,37.669357499631325
Task_34930,1197,699,116,66,182,1.71,27.73446455383771
Task_34931,2148,916,70,172,242,2.342420937840785,44.710104250270625
Task_34932,1648,979,48,169,217,1.6816326530612244,36.835265569575775
Task_34933,2149,514,35,39,74,4.172815533980582,40.70403852954818
Task_34934,1408,393,182,64,246,3.5736040609137056,30.60788903684752
Task_34935,1297,375,35,21,56,3.449468085106383,26.79362562846745
Task_34936,2493,171,148,37,185,14.494186046511627,46.05990821575477
Task_34937,2452,953,126,173,299,2.570230607966457,49.760530034214014
Task_34938,2610,97,55,93,148,26.632653061224488,47.37379369307277
Task_34939,1674,949,16,123,139,1.7621052631578948,36.252869632776886
Task_34940,1326,1013,13,80,93,1.3076923076923077,30.402020359887512
Task_34941,1549,856,145,108,253,1.807467911318553,34.84753049462447
Task_34942,1737,355,34,186,220,4.879213483146067,36.234047244758585
Task_34943,2334,422,183,66,249,5.5177304964539005,45.36432087287486
Task_34944,2137,1021,17,106,123,2.0909980430528377,43.762416050634386
Task_34945,944,123,30,31,61,7.612903225806452,20.099224060328627
Task_34946,1546,102,144,87,231,15.009708737864077,31.348633662974084
Task_34947,2036,883,198,155,353,2.3031674208144794,43.167536636179875
Task_34948,767,124,91,158,249,6.136,19.79635409436032
Task_34949,2854,97,89,195,284,29.122448979591837,52.26980990917423
Task_34950,1542,404,74,168,242,3.8074074074074074,33.48510146257542
Task_34951,1860,931,96,38,134,1.9957081545064377,38.550470045388984
Task_34952,732,680,131,60,191,1.0748898678414096,20.408876352319073
Task_34953,2629,296,18,79,97,8.851851851851851,48.6647065751078
Task_34954,1502,969,91,141,232,1.5484536082474227,34.41789131997522
Task_34955,1900,524,162,120,282,3.619047619047619,39.514092866950115
Task_34956,1794,507,33,186,219,3.531496062992126,37.642387759277575
Task_34957,1211,252,76,61,137,4.786561264822135,26.367252742878918
Task_34958,2031,72,174,54,228,27.82191780821918,38.36678626039548
Task_34959,518,951,12,59,71,0.5441176470588235,16.416734284127624
Task_34960,1433,475,35,76,111,3.0105042016806722,30.618461492469525
Task_34961,1776,996,116,88,204,1.7813440320962888,38.36788132789878
Task_34962,2900,989,119,66,185,2.9292929292929295,55.688370234884786
Task_34963,992,648,111,34,145,1.5285053929121726,23.92178824572508
Task_34964,554,745,165,61,226,0.7426273458445041,17.964235468222316
Task_34965,984,670,71,183,254,1.466467958271237,25.510313240401654
Task_34966,1124,294,69,118,187,3.8101694915254236,26.1473091143362
Task_34967,1531,603,150,179,329,2.5347682119205297,34.21908077561859
Task_34968,992,80,138,147,285,12.246913580246913,22.97773222371161
Task_34969,1495,502,113,176,289,2.9721669980119283,33.14583518269963
Task_34970,2007,678,127,183,310,2.955817378497791,41.91401799214315
Task_34971,1002,612,175,27,202,1.6345840130505709,24.350478556564543
Task_34972,1218,1013,121,95,216,1.2011834319526626,29.788982499097063
Task_34973,1153,1016,186,131,317,1.1337266470009832,29.30869593414366
Task_34974,2644,720,130,65,195,3.667128987517337,51.003289075535754
Task_34975,1385,199,133,14,147,6.925,28.46798519485777
Task_34976,2788,883,134,13,147,3.1538461538461537,52.900070697881574
Task_34977,516,202,199,170,369,2.541871921182266,17.05209582046769
Task_34978,1050,518,128,130,258,2.023121387283237,25.943900349593463
Task_34979,1713,618,131,162,293,2.767366720516963,36.961399999924275
Task_34980,1443,437,148,135,283,3.2945205479452055,32.02884829658947
Task_34981,1608,201,28,14,42,7.96039603960396,30.755694592098106
Task_34982,2978,385,111,142,253,7.715025906735751,56.02373162098104
Task_34983,2065,515,180,50,230,4.001937984496124,41.12399545795011
Task_34984,2900,586,18,84,102,4.940374787052811,54.05924416161648
Task_34985,2103,706,22,140,162,2.9745403111739743,42.48971457644074
Task_34986,2029,655,196,111,307,3.0929878048780486,42.071038433441785
Task_34987,2400,111,97,196,293,21.428571428571427,45.402804564488754
Task_34988,2209,993,189,38,227,2.222334004024145,44.8612839260064
Task_34989,2801,999,58,152,210,2.801,55.157107827284285
Task_34990,2661,322,87,174,261,8.238390092879257,50.88472930734909
Task_34991,2236,271,57,117,174,8.220588235294118,43.59563895756386
Task_34992,1779,419,77,149,226,4.235714285714286,37.1780913988997
Task_34993,2590,809,85,62,147,3.197530864197531,49.954727008961015
Task_34994,1700,979,121,16,137,1.7346938775510203,35.89017305830937
Task_34995,989,347,74,171,245,2.8419540229885056,24.570808208013933
Task_34996,1916,949,140,138,278,2.0168421052631578,41.1085403561122
Task_34997,1294,515,38,199,237,2.507751937984496,29.816480103401094
Task_34998,2912,1001,82,110,192,2.906187624750499,56.717546633283455
Task_34999,2488,95,152,98,250,25.916666666666668,46.25498519190154
Task_35000,1451,232,12,92,104,6.227467811158799,30.13599346549834
Task_35001,2056,597,127,169,296,3.4381270903010033,42.3509684608311
Task_35002,2790,553,57,100,157,5.036101083032491,52.94276898587905
Task_35003,961,321,108,133,241,2.984472049689441,23.838894748744394
Task_35004,2343,664,165,183,348,3.523308270676692,47.36318705765129
Task_35005,1189,855,150,104,254,1.389018691588785,29.07071633479188
Task_35006,2102,211,169,147,316,9.915094339622641,41.849453249959524
Task_35007,2031,660,22,196,218,3.0726172465960664,41.811389462036665
Task_35008,815,317,135,64,199,2.5628930817610063,20.771613186510994
Task_35009,2124,410,140,59,199,5.1678832116788325,41.703039919977535
Task_35010,1351,884,119,91,210,1.5265536723163842,31.38966696467932
Task_35011,1000,709,66,148,214,1.408450704225352,25.628831745200547
Task_35012,1403,605,112,104,216,2.315181518151815,31.579013160543365
Task_35013,1413,637,147,98,245,2.2147335423197494,31.96283757447482
Task_35014,2173,283,94,179,273,7.651408450704225,43.169676889254696
Task_35015,1939,308,141,103,244,6.275080906148867,39.23044048254527
Task_35016,1492,296,174,43,217,5.023569023569023,31.21672309002106
Task_35017,883,265,16,194,210,3.319548872180451,22.337052031255144
Task_35018,2855,169,35,36,71,16.794117647058822,50.783389204336906
Task_35019,2418,692,117,25,142,3.4891774891774894,46.4784494158606
Task_35020,2709,714,55,82,137,3.788811188811189,51.95384698856742
Task_35021,1411,247,81,185,266,5.689516129032258,30.99955475232611
Task_35022,2488,601,70,164,234,4.132890365448505,49.05871143018005
Task_35023,2358,779,19,73,92,3.023076923076923,45.897297715047664
Task_35024,1741,318,104,11,115,5.4576802507836994,34.26892377858533
Task_35025,2447,523,144,71,215,4.669847328244275,47.36179577624816
Task_35026,1937,723,191,90,281,2.675414364640884,40.51460119132154
Task_35027,1815,711,162,167,329,2.5491573033707864,39.03843758757485
Task_35028,1968,169,114,143,257,11.576470588235294,39.02762742604702
Task_35029,2698,790,170,47,217,3.4108723135271806,51.89656774396719
Task_35030,1133,846,92,124,216,1.3376623376623376,28.11098311205481
Task_35031,1250,848,26,139,165,1.4723203769140165,29.653412861031388
Task_35032,950,851,163,146,309,1.1150234741784038,25.49036640465995
Task_35033,1142,994,20,116,136,1.1477386934673366,27.882103690502024
Task_35034,873,707,74,38,112,1.2330508474576272,21.92717039515651
Task_35035,1509,556,107,61,168,2.7091561938958706,32.09974256729584
Task_35036,2687,308,74,46,120,8.6957928802589,49.36416030179328
Task_35037,1290,885,26,33,59,1.4559819413092552,28.213879090695574
Task_35038,1155,247,172,169,341,4.657258064516129,27.1658322363019
Task_35039,2128,940,167,139,306,2.261424017003188,44.56758211467328
Task_35040,2183,792,39,18,57,2.7528373266078185,41.894849936273154
Task_35041,2823,538,73,114,187,5.23747680890538,53.82571381499983
Task_35042,1707,165,40,159,199,10.283132530120483,34.67216238811129
Task_35043,2691,825,131,40,171,3.2578692493946733,51.48565815929197
Task_35044,1201,576,23,41,64,2.081455805892548,25.99703434189463
Task_35045,1042,130,61,96,157,7.9541984732824424,23.281030828710986
Task_35046,1739,416,113,195,308,4.170263788968825,36.846487181874295
Task_35047,787,94,99,136,235,8.284210526315789,19.539999942716232
Task_35048,2803,98,142,180,322,28.31313131313131,51.697417571037384
Task_35049,803,597,189,158,347,1.342809364548495,22.681194286741185
Task_35050,2102,374,124,199,323,5.605333333333333,42.52638037963423
Task_35051,1377,839,181,164,345,1.6392857142857142,32.55281349199006
Task_35052,1004,580,81,26,107,1.7280550774526677,23.42615395952294
Task_35053,2813,567,133,186,319,4.952464788732394,54.37156431933759
Task_35054,1837,91,123,192,315,19.967391304347824,36.54520268911535
Task_35055,1060,269,120,161,281,3.925925925925926,25.455891716883183
Task_35056,655,300,133,141,274,2.176079734219269,19.093490491970048
Task_35057,1449,257,199,142,341,5.616279069767442,31.805563004058783
Task_35058,2360,267,133,39,172,8.805970149253731,44.52725250854098
Task_35059,2074,571,156,71,227,3.625874125874126,41.66312421036725
Task_35060,1406,601,135,179,314,2.335548172757475,32.165614002491914
Task_35061,2065,724,113,96,209,2.8482758620689657,42.41807311772253
Task_35062,1214,1023,151,132,283,1.185546875,30.145263597047386
Task_35063,2043,439,194,196,390,4.6431818181818185,42.10310441084229
Task_35064,817,842,75,193,268,0.9691577698695136,23.40544235899135
Task_35065,1860,1011,107,89,196,1.8379446640316206,39.784811152479335
Task_35066,1151,101,31,181,212,11.284313725490197,25.362180521395896
Task_35067,1726,523,192,66,258,3.2938931297709924,36.10595102947789
Task_35068,508,749,170,127,297,0.6773333333333333,18.31113839394544
Task_35069,2302,306,47,70,117,7.498371335504886,43.77943541854905
Task_35070,1477,980,197,184,381,1.5056065239551477,34.73710951526307
Task_35071,1872,590,61,187,248,3.16751269035533,39.35298549873844
Task_35072,2914,617,33,46,79,4.715210355987055,53.3735896446099
Task_35073,2208,112,40,132,172,19.539823008849556,41.70085580202396
Task_35074,2424,593,72,136,208,4.08080808080808,47.84803212738521
Task_35075,1396,485,157,87,244,2.8724279835390947,30.937217337913882
Task_35076,2494,492,139,119,258,5.0588235294117645,48.70586160849018
Task_35077,1911,724,102,17,119,2.6358620689655172,38.15529312239053
Task_35078,1996,86,196,140,336,22.942528735632184,38.98346150767609
Task_35079,2960,690,56,126,182,4.283646888567294,56.363122991238335
Task_35080,1512,664,12,70,82,2.2736842105263158,31.89433785104424
Task_35081,2695,406,13,179,192,6.621621621621622,51.45163650452523
Task_35082,1007,392,172,90,262,2.5623409669211195,24.66040050974136
Task_35083,714,738,146,177,323,0.9661705006765899,21.58788473729005
Task_35084,1724,620,112,113,225,2.7761674718196456,36.76359323701671
Task_35085,1860,477,32,154,186,3.8912133891213387,38.26122137221657
Task_35086,808,777,103,118,221,1.038560411311054,22.604669768353613
Task_35087,1257,850,34,156,190,1.4770857814336076,29.9557685924277
Task_35088,2059,638,75,99,174,3.2222222222222223,41.93220932256907
Task_35089,2641,854,157,58,215,3.088888888888889,51.38691278125265
Task_35090,1902,489,111,78,189,3.8816326530612244,38.623558224576236
Task_35091,2577,321,95,65,160,8.003105590062113,48.25055818592739
Task_35092,1166,996,158,196,354,1.1695085255767301,29.714885579612936
Task_35093,1805,181,155,58,213,9.917582417582418,35.82212375068976
Task_35094,2938,69,45,112,157,41.97142857142857,52.29256065735583
Task_35095,2025,416,175,78,253,4.856115107913669,40.65526922976051
Task_35096,2403,290,35,25,60,8.257731958762887,43.98926860602339
Task_35097,1700,64,38,36,74,26.153846153846153,30.899502745554738
Task_35098,778,563,74,124,198,1.3794326241134751,21.56061899723457
Task_35099,599,829,45,178,223,0.7216867469879518,19.648868957431308
Task_35100,2627,571,132,195,327,4.5926573426573425,51.48830503453191
Task_35101,2042,652,33,92,125,3.127105666156202,41.21703996903566
Task_35102,1166,159,25,104,129,7.2875,25.281362278530953
Task_35103,2086,813,39,62,101,2.5626535626535625,41.58937071656924
Task_35104,2380,206,54,152,206,11.497584541062801,45.88966775595753
Task_35105,708,911,173,36,209,0.7763157894736842,20.760822560426657
Task_35106,642,821,26,181,207,0.781021897810219,20.15747690725873
Task_35107,1818,241,120,162,282,7.512396694214876,37.34326654704776
Task_35108,1315,297,80,197,277,4.412751677852349,29.741380690040653
Task_35109,1365,278,187,49,236,4.89247311827957,29.315406963171238
Task_35110,1750,176,34,75,109,9.887005649717514,34.051949279954094
Task_35111,1110,858,106,33,139,1.2922002328288709,26.293566959105988
Task_35112,1463,844,11,184,195,1.7313609467455622,33.28674227176999
Task_35113,2152,454,62,141,203,4.72967032967033,43.0814579811898
Task_35114,2213,418,65,193,258,5.281622911694511,44.25113517026505
Task_35115,2152,279,35,36,71,7.685714285714286,40.03138625149378
Task_35116,2196,398,58,177,235,5.503759398496241,43.818565467609666
Task_35117,786,697,161,11,172,1.1260744985673352,20.81460059422812
Task_35118,2567,129,175,81,256,19.746153846153845,47.78586454213259
Task_35119,1876,474,184,64,248,3.9494736842105262,38.28387281376802
Task_35120,1971,981,84,72,156,2.0071283095723014,40.780088387652164
Task_35121,2779,1013,108,191,299,2.7406311637080867,55.15588587431525
Task_35122,2978,415,76,55,131,7.158653846153846,54.91634742810589
Task_35123,2116,489,119,147,266,4.318367346938776,42.789267226008896
Task_35124,697,113,74,28,102,6.114035087719298,16.637590009930197
Task_35125,647,418,118,60,178,1.5441527446300716,18.056932647890893
Task_35126,1207,903,176,131,307,1.3351769911504425,29.811095166199394
Task_35127,2058,816,40,89,129,2.518971848225214,41.93247595559549
Task_35128,2863,333,134,193,327,8.571856287425149,54.43438360855399
Task_35129,819,834,66,190,256,0.9808383233532935,23.337386002907476
Task_35130,2451,424,92,121,213,5.767058823529411,47.681111721274455
Task_35131,2793,622,190,29,219,4.48314606741573,52.89320154856898
Task_35132,2700,607,25,171,196,4.440789473684211,52.18235978006448
Task_35133,1096,463,78,86,164,2.3620689655172415,25.814910469108924
Task_35134,520,105,163,71,234,4.90566037735849,14.944550421031368
Task_35135,2499,741,88,94,182,3.3679245283018866,48.93642943892157
Task_35136,1573,94,46,40,86,16.557894736842105,29.906626601165332
Task_35137,2866,252,37,160,197,11.328063241106719,53.575173004095795
Task_35138,1110,923,175,16,191,1.2012987012987013,26.878396534843134
Task_35139,2042,359,122,165,287,5.6722222222222225,41.31533445413948
Task_35140,1355,365,43,124,167,3.702185792349727,29.689437207995557
Task_35141,960,954,97,175,272,1.0052356020942408,25.867208307277902
Task_35142,1582,253,119,124,243,6.228346456692913,33.42529454707259
Task_35143,2010,1004,130,144,274,2.0,42.759822086788596
Task_35144,1440,324,95,62,157,4.430769230769231,30.223437387599034
Task_35145,2839,901,187,39,226,3.147450110864745,54.484715659360155
Task_35146,538,479,21,124,145,1.1208333333333333,16.72238077416038
Task_35147,994,401,56,87,143,2.472636815920398,23.805236203063256
Task_35148,730,756,192,163,355,0.964332892998679,22.020779382724744
Task_35149,2473,485,67,163,230,5.088477366255144,48.411267463630715
Task_35150,1614,208,125,112,237,7.722488038277512,33.72635097218146
Task_35151,1143,471,57,55,112,2.4216101694915255,25.67343828713822
Task_35152,2181,606,177,98,275,3.5930807248764416,44.16361879792862
Task_35153,627,933,24,77,101,0.671306209850107,19.279636484850183
Task_35154,2244,138,141,197,338,16.14388489208633,43.607866987759394
Task_35155,760,145,146,71,217,5.205479452054795,19.18338562708837
Task_35156,1260,818,37,54,91,1.5384615384615385,28.322855292578627
Task_35157,1914,92,130,173,303,20.580645161290324,37.66833273947133
Task_35158,1849,393,123,17,140,4.692893401015229,36.322277928017996
Task_35159,2501,494,10,157,167,5.052525252525252,48.28401586016444
Task_35160,935,482,128,147,275,1.9358178053830228,24.11188089613673
Task_35161,2824,416,88,139,227,6.772182254196642,53.58908633622253
Task_35162,2684,909,169,32,201,2.9494505494505496,51.98104494322908
Task_35163,1933,152,58,91,149,12.633986928104575,37.436698090216275
Task_35164,2005,879,153,160,313,2.278409090909091,42.49092559542144
Task_35165,1092,687,25,193,218,1.5872093023255813,27.058268610638446
Task_35166,2823,174,131,181,312,16.13142857142857,52.733697034882425
Task_35167,2526,810,99,124,223,3.1146732429099875,50.073339465675225
Task_35168,1394,114,122,184,306,12.121739130434783,29.78687752369636
Task_35169,607,879,125,165,290,0.6897727272727273,20.29778035240776
Task_35170,1970,888,134,58,192,2.2159730033745784,40.75763844472421
Task_35171,1810,666,79,140,219,2.7136431784107944,38.413496747650846
Task_35172,2250,365,105,36,141,6.147540983606557,42.823352048012886
Task_35173,2234,218,77,183,260,10.200913242009133,43.88665206032186
Task_35174,2126,691,132,125,257,3.0722543352601157,43.51593863462057
Task_35175,2300,516,196,95,291,4.448742746615087,45.79731600034648
Task_35176,960,838,99,57,156,1.1442193087008343,24.159554987976488
Task_35177,2246,408,145,15,160,5.491442542787286,42.8083317531293
Task_35178,1269,416,105,51,156,3.0431654676258995,27.756985781682175
Task_35179,1893,646,62,198,260,2.9258114374034,39.93234315249139
Task_35180,2398,599,54,148,202,3.9966666666666666,47.4780497864509
Task_35181,1237,361,92,81,173,3.4171270718232045,27.618028209903628
Task_35182,2081,874,139,166,305,2.378285714285714,43.652285467509806
Task_35183,2355,173,95,110,205,13.53448275862069,44.851105749592506
Task_35184,1019,328,157,106,263,3.0972644376899696,24.838263917015468
Task_35185,2729,661,78,164,242,4.122356495468278,53.09267185401092
Task_35186,1396,591,90,51,141,2.358108108108108,30.289488774029383
Task_35187,625,812,146,114,260,0.7687576875768758,20.059349715081144
Task_35188,1685,244,84,39,123,6.877551020408164,33.30172666546601
Task_35189,1811,453,84,22,106,3.988986784140969,35.72091263909036
Task_35190,2375,452,151,31,182,5.242825607064018,45.372070580616814
Task_35191,1483,924,23,96,119,1.6032432432432433,33.18701210212859
Task_35192,2733,738,165,17,182,3.698240866035183,51.70476934820982
Task_35193,539,151,149,39,188,3.5460526315789473,15.214557613267218
Task_35194,2601,942,83,189,272,2.758218451749735,52.04267741539707
Task_35195,1398,955,151,88,239,1.4623430962343096,32.35352225703355
Task_35196,2728,210,156,189,345,12.928909952606634,51.921294747937374
Task_35197,2983,848,131,164,295,3.513545347467609,57.814668189246525
Task_35198,2613,688,148,68,216,3.792452830188679,50.51153872857645
Task_35199,2046,637,52,124,176,3.206896551724138,41.72579630970258
Task_35200,930,670,160,189,349,1.3859910581222057,24.946123501489453
Task_35201,1539,726,77,167,244,2.1169188445667126,34.45605698269459
Task_35202,537,67,57,84,141,7.897058823529412,14.61765299340133
Task_35203,806,727,106,142,248,1.1071428571428572,22.54410286387259
Task_35204,2860,414,128,109,237,6.891566265060241,54.13358935077872
Task_35205,2503,450,160,108,268,5.549889135254989,48.740672526601166
Task_35206,2345,626,94,195,289,3.740031897926635,47.11009773691248
Task_35207,1789,662,133,68,201,2.6983408748114632,37.310273392518944
Task_35208,1048,759,84,22,106,1.3789473684210527,24.593002434515096
Task_35209,2485,317,40,93,133,7.814465408805032,47.18604259657835
Task_35210,931,87,112,44,156,10.579545454545455,20.241281780234214
Task_35211,2138,513,106,170,276,4.159533073929961,43.293345727127814
Task_35212,2310,347,137,73,210,6.637931034482759,44.62567569298517
Task_35213,1115,578,152,85,237,1.9257340241796201,26.725647471110435
Task_35214,996,679,143,73,216,1.464705882352941,24.863780682274136
Task_35215,2173,444,194,42,236,4.883146067415731,42.56081444180043
Task_35216,1654,456,149,51,200,3.6192560175054704,34.465581842665664
Task_35217,1694,862,16,12,28,1.962920046349942,34.21222817034551
Task_35218,2943,969,196,194,390,3.034020618556701,58.03198293705083
Task_35219,1653,125,134,63,197,13.119047619047619,32.99246581965495
Task_35220,1674,451,183,177,360,3.7035398230088497,36.13837680977775
Task_35221,2702,816,21,196,217,3.307221542227662,52.93787807072974
Task_35222,2774,597,186,179,365,4.638795986622074,54.047181557270505
Task_35223,689,75,91,138,229,9.06578947368421,17.944366702080888
Task_35224,2512,673,197,176,373,3.7270029673590503,50.170882771846834
Task_35225,1811,89,56,125,181,20.122222222222224,35.31878428434879
Task_35226,1206,493,140,31,171,2.4412955465587043,26.92293275767966
Task_35227,2591,679,162,163,325,3.8102941176470586,51.20578712061778
Task_35228,1231,160,200,97,297,7.645962732919255,27.476583570000603
Task_35229,2825,609,94,79,173,4.631147540983607,53.58596201359777
Task_35230,1485,625,135,171,306,2.3722044728434506,33.44422255781616
Task_35231,2192,578,112,198,310,3.785837651122625,44.550007699503915
Task_35232,737,102,24,188,212,7.155339805825243,18.88684078590966
Task_35233,2216,666,72,192,264,3.3223388305847075,45.11950994339256
Task_35234,1585,259,174,152,326,6.096153846153846,33.908548471733724
Task_35235,1935,866,172,16,188,2.2318339100346023,39.70301957357086
Task_35236,2044,751,53,114,167,2.7180851063829787,41.962998733755505
Task_35237,629,745,12,132,144,0.8431635388739946,19.091946851710503
Task_35238,2825,823,123,70,193,3.4283980582524274,54.18878174178251
Task_35239,1734,172,95,92,187,10.023121387283236,34.72126257938566
Task_35240,2513,372,83,125,208,6.737265415549598,48.44883828463148
Task_35241,1071,711,127,135,262,1.5042134831460674,26.861384340246886
Task_35242,581,789,140,77,217,0.7354430379746836,18.72529105285514
Task_35243,2439,634,173,141,314,3.840944881889764,48.57394114291636
Task_35244,1404,642,148,183,331,2.1835147744945567,32.34485865480295
Task_35245,1635,598,97,160,257,2.7295492487479134,35.52168954088298
Task_35246,1580,106,199,191,390,14.766355140186915,32.890038489959686
Task_35247,1396,761,178,76,254,1.832020997375328,31.724142384898595
Task_35248,2850,185,12,42,54,15.32258064516129,50.92665988091369
Task_35249,1974,315,71,96,167,6.246835443037975,39.4272691176251
Task_35250,987,424,167,143,310,2.3223529411764705,24.904167831444614
Task_35251,2408,329,145,188,333,7.296969696969697,47.24430591296573
Task_35252,2571,144,159,173,332,17.73103448275862,48.79667900489623
Task_35253,1398,228,72,190,262,6.104803493449782,30.74096774623712
Task_35254,1292,448,191,186,377,2.8775055679287305,30.172390255684487
Task_35255,1136,534,128,66,194,2.1233644859813086,26.508755882004795
Task_35256,954,212,73,133,206,4.47887323943662,23.338337516537376
Task_35257,2763,706,95,19,114,3.908062234794908,51.71356352068988
Task_35258,1174,354,177,28,205,3.307042253521127,26.295942149281434
Task_35259,716,837,167,121,288,0.8544152744630071,21.691364193737183
Task_35260,1346,742,140,115,255,1.8115746971736204,31.295999070144394
Task_35261,2571,367,144,16,160,6.986413043478261,47.81556822679562
Task_35262,1351,329,42,10,52,4.093939393939394,27.316709100685028
Task_35263,1127,405,147,12,159,2.7758620689655173,25.127385053707837
Task_35264,1126,702,100,107,207,1.6017069701280227,27.44498350882966
Task_35265,1433,96,105,175,280,14.77319587628866,29.939343314834527
Task_35266,616,940,34,148,182,0.6546227417640808,19.898917920792524
Task_35267,2101,847,91,51,142,2.4775943396226414,42.261987043790135
Task_35268,1950,381,150,184,334,5.104712041884817,40.17223834138787
Task_35269,2814,918,200,163,363,3.0620239390642,55.661263651201445
Task_35270,1542,83,30,89,119,18.357142857142858,30.341170714455703
Task_35271,610,313,69,108,177,1.9426751592356688,17.877508561969183
Task_35272,1735,148,141,163,304,11.644295302013424,35.476633892778494
Task_35273,1694,206,195,100,295,8.183574879227054,35.22578136537944
Task_35274,1579,812,179,179,358,1.9421894218942188,35.76329425769847
Task_35275,2703,123,140,60,200,21.798387096774192,49.476676457944734
Task_35276,2225,995,77,173,250,2.2339357429718874,46.199205785400544
Task_35277,1105,436,110,48,158,2.528604118993135,24.997827158093102
Task_35278,1513,437,80,103,183,3.454337899543379,32.57999213610314
Task_35279,743,235,100,84,184,3.1483050847457625,19.289047155827316
Task_35280,2274,740,88,29,117,3.068825910931174,44.22670250429329
Task_35281,648,783,67,136,203,0.826530612244898,20.14940528091135
Task_35282,2011,397,80,195,275,5.052763819095477,41.067390915770325
Task_35283,838,816,18,109,127,1.025703794369645,22.43468329231619
Task_35284,643,93,142,23,165,6.840425531914893,16.110651731004925
Task_35285,2430,254,131,153,284,9.529411764705882,47.055327862807474
Task_35286,2712,563,162,167,329,4.808510638297872,52.77660767289054
Task_35287,1459,120,153,132,285,12.057851239669422,30.773175200059097
Task_35288,963,261,109,94,203,3.6755725190839694,23.39122508627575
Task_35289,1099,302,153,154,307,3.627062706270627,26.28765705382632
Task_35290,2121,251,190,165,355,8.416666666666666,42.49961711937333
Task_35291,573,256,192,67,259,2.2295719844357977,17.0395497244047
Task_35292,2649,297,93,104,197,8.889261744966444,50.31961107815885
Task_35293,833,146,114,51,165,5.666666666666667,19.842239416332838
Task_35294,2739,800,111,129,240,3.4194756554307117,53.4988169135249
Task_35295,2323,707,96,92,188,3.281073446327684,46.23731444667879
Task_35296,2931,219,136,44,180,13.322727272727272,53.323370694474086
Task_35297,1000,842,190,11,201,1.1862396204033214,24.95496212079335
Task_35298,2161,640,103,123,226,3.371294851794072,43.766929435166084
Task_35299,502,256,29,93,122,1.953307392996109,15.543322737213847
Task_35300,1291,210,189,53,242,6.118483412322274,28.162700070597975
Task_35301,864,992,44,117,161,0.8700906344410876,23.556286221747815
Task_35302,2154,411,10,44,54,5.228155339805825,40.54948741914833
Task_35303,2405,802,150,104,254,2.995018679950187,48.239936190073315
Task_35304,1451,730,199,171,370,1.984952120383037,33.52235819436367
Task_35305,2511,191,197,10,207,13.078125,46.825056658875845
Task_35306,1373,663,67,98,165,2.0677710843373496,31.0999925620348
Task_35307,2810,218,147,30,177,12.831050228310502,51.416098864022466
Task_35308,2204,1002,34,154,188,2.19740777666999,45.445550085452986
Task_35309,2399,889,24,155,179,2.695505617977528,48.01853019680012
Task_35310,1231,904,173,27,200,1.3602209944751382,28.903899570400856
Task_35311,1637,723,190,62,252,2.2610497237569063,35.262670901267605
Task_35312,2258,550,104,144,248,4.098003629764065,45.1473269660522
Task_35313,699,301,196,99,295,2.314569536423841,19.81063039093507
Task_35314,651,651,179,63,242,0.9984662576687117,19.38859511101939
Task_35315,2574,596,193,147,340,4.311557788944723,50.7171184653234
Task_35316,2874,82,149,50,199,34.626506024096386,51.23994478801351
Task_35317,1336,934,20,57,77,1.4288770053475937,29.36086948621653
Task_35318,1634,875,65,153,218,1.865296803652968,36.28693302531354
Task_35319,1188,500,32,79,111,2.37125748502994,26.886385176454535
Task_35320,925,398,132,149,281,2.318295739348371,23.71886901579872
Task_35321,1873,136,59,98,157,13.671532846715328,36.42057282321533
Task_35322,1397,433,39,147,186,3.21889400921659,30.750938445142253
Task_35323,2330,903,123,156,279,2.577433628318584,47.556325125372986
Task_35324,1243,337,152,113,265,3.6775147928994083,28.429343450086076
Task_35325,1181,570,105,91,196,2.0683012259194395,27.698401682143416
Task_35326,553,956,28,115,143,0.5778474399164054,18.661048152941664
Task_35327,2846,928,117,196,313,3.063509149623251,56.02262463193434
Task_35328,802,588,72,25,97,1.3616298811544991,20.264020712029033
Task_35329,1524,605,168,39,207,2.514851485148515,32.6391675067626
Task_35330,541,821,179,151,330,0.6581508515815085,19.242557662080987
Task_35331,1892,65,37,106,143,28.666666666666668,35.785287850500296
Task_35332,1128,738,105,146,251,1.5263870094722598,27.81479710166307
Task_35333,2990,455,75,190,265,6.557017543859649,56.70810432948462
Task_35334,2277,162,91,65,156,13.969325153374234,42.57850375426634
Task_35335,2391,502,104,72,176,4.753479125248509,46.06991500462141
Task_35336,1524,729,46,160,206,2.0876712328767124,33.95466904749348
Task_35337,1917,880,29,133,162,2.1759364358683313,40.1481810385703
Task_35338,1779,424,180,91,271,4.185882352941176,37.04001585742616
Task_35339,908,712,197,120,317,1.273492286115007,24.45901652091665
Task_35340,1936,326,62,32,94,5.920489296636085,37.184917644877274
Task_35341,1222,874,143,183,326,1.3965714285714286,30.09281692442356
Task_35342,2195,653,55,31,86,3.356269113149847,42.28936736596351
Task_35343,1981,857,44,144,188,2.308857808857809,41.43157595033316
Task_35344,591,731,70,197,267,0.8073770491803278,19.49774399597706
Task_35345,1806,659,100,199,299,2.7363636363636363,38.64449936932929
Task_35346,2992,755,11,121,132,3.9576719576719577,56.63253858279807
Task_35347,1694,123,18,169,187,13.661290322580646,33.93049262929898
Task_35348,2722,655,25,86,111,4.149390243902439,51.69479541973536
Task_35349,2940,208,14,130,144,14.066985645933014,54.017147334664514
Task_35350,761,950,94,145,239,0.8002103049421662,22.667364980975282
Task_35351,1536,568,117,191,308,2.6994727592267136,34.111103648488324
Task_35352,505,239,131,180,311,2.1041666666666665,16.751536956211925
Task_35353,771,863,85,48,133,0.8923611111111112,21.05697450455268
Task_35354,2361,324,135,32,167,7.264615384615385,44.66683607505066
Task_35355,2307,161,125,107,232,14.24074074074074,44.152467502977764
Task_35356,544,729,26,34,60,0.7452054794520548,16.052577573361386
Task_35357,2911,577,64,31,95,5.036332179930795,53.430444793962074
Task_35358,2384,818,166,78,244,2.9108669108669107,47.57639220030722
Task_35359,1637,442,200,101,301,3.695259593679458,35.14658048155929
Task_35360,1486,235,180,194,374,6.296610169491525,32.53907445276412
Task_35361,690,502,23,79,102,1.371769383697813,18.73192346964186
Task_35362,661,849,50,137,187,0.7776470588235294,20.524668208284933
Task_35363,2376,184,165,84,249,12.843243243243244,45.37315420375567
Task_35364,650,171,48,47,95,3.7790697674418605,16.162433431695863
Task_35365,2076,943,117,20,137,2.1991525423728815,41.72038661293846
Task_35366,1765,970,60,36,96,1.8177136972193615,36.501985356657435
Task_35367,2914,801,11,55,66,3.6334164588528677,54.091790453979904
Task_35368,2238,128,174,193,367,17.348837209302324,43.51680722663958
Task_35369,1835,473,66,153,219,3.871308016877637,38.20926781823389
Task_35370,2267,706,166,118,284,3.2065063649222063,45.90803680245707
Task_35371,1688,287,57,94,151,5.861111111111111,34.566278235860565
Task_35372,971,874,168,33,201,1.1097142857142857,24.697151073703665
Task_35373,1908,701,155,22,177,2.717948717948718,38.66018534311609
Task_35374,2675,274,101,129,230,9.727272727272727,50.72153734698833
Task_35375,1946,491,24,87,111,3.9552845528455283,38.8872399824462
Task_35376,1293,965,70,186,256,1.3385093167701863,31.349347281688107
Task_35377,1110,582,167,96,263,1.9039451114922814,27.090663694557495
Task_35378,2328,974,43,100,143,2.3876923076923076,46.766934501863396
Task_35379,1523,126,89,54,143,11.992125984251969,30.321422706610946
Task_35380,924,855,111,147,258,1.0794392523364487,24.876915234362826
Task_35381,2129,543,122,135,257,3.9136029411764706,43.10977512618604
Task_35382,1672,549,47,131,178,3.04,35.3994001950428
Task_35383,1173,791,83,125,208,1.481060606060606,28.519893072877753
Task_35384,1422,822,122,151,273,1.7278250303766707,32.86939638332874
Task_35385,2397,407,197,192,389,5.875,47.59034684050355
Task_35386,2658,689,23,113,136,3.8521739130434782,51.178345496192584
Task_35387,1255,925,27,77,104,1.355291576673866,28.968472736859667
Task_35388,2051,690,91,23,114,2.968162083936324,40.488854284918105
Task_35389,1833,901,30,48,78,2.032150776053215,37.09806100189495
Task_35390,1760,703,76,155,231,2.5,37.82107028291025
Task_35391,2789,970,35,47,82,2.8722966014418128,52.74079651159465
Task_35392,2103,841,191,53,244,2.497624703087886,43.04989263308159
Task_35393,1548,860,187,41,228,1.7979094076655053,33.94301869811748
Task_35394,1285,963,146,40,186,1.3329875518672198,29.79793523913143
Task_35395,2686,220,39,54,93,12.153846153846153,49.06984285640373
Task_35396,2961,390,137,59,196,7.572890025575448,54.867284694987895
Task_35397,1465,702,117,46,163,2.0839260312944523,31.68374145140856
Task_35398,998,846,187,57,244,1.17827626918536,25.479631961999996
Task_35399,1663,713,144,109,253,2.3291316526610646,36.20935209017936
Task_35400,2568,531,39,20,59,4.827067669172933,47.134073149562674
Task_35401,995,666,21,153,174,1.4917541229385307,25.070455983940676
Task_35402,736,977,110,125,235,0.7525562372188139,22.194580769434463
Task_35403,2157,850,48,68,116,2.534665099882491,43.294890711554054
Task_35404,1086,1013,173,115,288,1.0710059171597632,28.0210388556056
Task_35405,691,960,82,48,130,0.7190426638917794,20.31667126135017
Task_35406,1038,295,16,141,157,3.5067567567567566,24.254502601835497
Task_35407,2252,974,145,27,172,2.3097435897435896,45.07299902754917
Task_35408,2903,604,187,28,215,4.798347107438016,54.513124546194945
Task_35409,1509,278,14,108,122,5.408602150537634,31.563081139932518
Task_35410,2465,653,120,35,155,3.7691131498470947,47.2277951042769
Task_35411,2900,831,197,186,383,3.485576923076923,56.87508770538909
Task_35412,1267,136,36,170,206,9.248175182481752,27.600146570270528
Task_35413,2146,622,176,119,295,3.4446227929373996,43.777599539695416
Task_35414,609,852,113,123,236,0.7139507620164126,19.919437475000677
Task_35415,2011,654,37,16,53,3.070229007633588,38.8271198252722
Task_35416,725,789,23,78,101,0.9177215189873418,20.277090638444008
Task_35417,1049,917,140,161,301,1.1427015250544663,27.326222288587605
Task_35418,2510,160,43,129,172,15.590062111801242,47.010343428207
Task_35419,2641,247,13,197,210,10.649193548387096,50.15015390969669
Task_35420,1140,163,141,62,203,6.951219512195122,25.21264631325072
Task_35421,1053,830,175,119,294,1.2671480144404332,27.003131355594636
Task_35422,1445,504,72,31,103,2.8613861386138613,30.16415254167626
Task_35423,1337,558,112,198,310,2.3917710196779964,30.94777767727815
Task_35424,926,224,135,55,190,4.115555555555556,22.186208934650637
Task_35425,784,264,61,19,80,2.9584905660377356,18.355169798839835
Task_35426,825,930,97,15,112,0.8861439312567132,21.709273587563533
Task_35427,1463,509,66,151,217,2.868627450980392,32.42287295864702
Task_35428,848,845,13,98,111,1.0023640661938533,22.604051150783942
Task_35429,736,414,69,20,89,1.7734939759036144,18.322755651032406
Task_35430,1653,567,66,181,247,2.910211267605634,35.79370907165415
Task_35431,2468,356,165,155,320,6.913165266106443,48.178185268072035
Task_35432,965,609,129,25,154,1.5819672131147542,23.225045062461074
Task_35433,713,1006,10,20,30,0.7080436941410129,19.503524153916803
Task_35434,1800,880,20,193,213,2.0431328036322363,38.8239617506019
Task_35435,2436,340,57,155,212,7.1436950146627565,47.28965404807445
Task_35436,2073,630,129,182,311,3.2852614896988905,42.81119437542114
Task_35437,1491,984,67,49,116,1.5137055837563451,32.63653806189621
Task_35438,1520,842,17,77,94,1.8030842230130486,32.76802188574504
Task_35439,2437,683,94,89,183,3.5628654970760234,47.72875035060082
Task_35440,1755,306,147,194,341,5.716612377850163,36.884914585421434
Task_35441,2428,758,33,90,123,3.1989459815546772,47.55834679734287
Task_35442,984,655,148,156,304,1.5,25.52924588682221
Task_35443,2463,148,163,179,342,16.530201342281877,47.14252859720485
Task_35444,1371,159,63,71,134,8.56875,28.353666363216078
Task_35445,2858,210,135,199,334,13.545023696682465,53.93883595899924
Task_35446,1763,963,90,76,166,1.8288381742738589,37.682410107440504
Task_35447,2487,113,106,166,272,21.81578947368421,46.7790526149902
Task_35448,1592,67,43,23,66,23.41176470588235,29.24921139150872
Task_35449,1504,339,21,33,54,4.423529411764706,30.03420584717423
Task_35450,2995,872,192,102,294,3.4306987399770903,57.98474346826231
Task_35451,923,289,172,109,281,3.182758620689655,23.27967469978451
Task_35452,2837,816,94,65,159,3.4724602203182373,53.95818289598342
Task_35453,1754,349,51,155,206,5.011428571428572,36.54270213432992
Task_35454,1722,483,193,47,240,3.5578512396694215,35.571692329540106
Task_35455,1529,1012,98,66,164,1.5093780848963474,34.0050702682616
Task_35456,670,121,51,45,96,5.491803278688525,16.015932477236912
Task_35457,2011,430,186,104,290,4.665893271461717,40.981889883714366
Task_35458,608,827,177,130,307,0.7342995169082126,20.048858015028625
Task_35459,1041,730,132,16,148,1.424076607387141,24.656284433772893
Task_35460,2578,679,103,166,269,3.791176470588235,50.751874041054975
Task_35461,1495,865,183,40,223,1.7263279445727482,33.08949332516356
Task_35462,2497,779,103,178,281,3.2012820512820515,49.85549603720117
Task_35463,1067,915,69,199,268,1.1648471615720524,27.614297507948805
Task_35464,1141,467,185,48,233,2.4380341880341883,26.30226175255883
Task_35465,667,127,184,135,319,5.2109375,18.483415851775707
Task_35466,2565,114,120,160,280,22.304347826086957,48.04949789587307
Task_35467,1521,368,173,174,347,4.121951219512195,33.38653440731627
Task_35468,2512,954,132,32,164,2.630366492146597,49.14103980518232
Task_35469,1696,468,174,135,309,3.6162046908315566,36.24958708389176
Task_35470,2513,506,129,144,273,4.956607495069034,49.156173159612194
Task_35471,1653,636,115,85,200,2.594976452119309,35.26089571424631
Task_35472,2761,800,151,191,342,3.446941323345818,54.397971978212944
Task_35473,607,587,10,115,125,1.032312925170068,18.12298241750359
Task_35474,2539,575,168,72,240,4.407986111111111,49.11916783355892
Task_35475,931,733,116,14,130,1.268392370572207,22.90245396437889
Task_35476,961,347,116,161,277,2.7614942528735633,24.12566626382276
Task_35477,1548,166,159,62,221,9.269461077844312,31.714062536753914
Task_35478,542,303,162,23,185,1.7828947368421053,15.875959394967758
Task_35479,836,676,178,136,314,1.2348596750369276,23.185606891579464
Task_35480,1590,803,117,130,247,1.9776119402985075,35.33743471188772
Task_35481,2296,494,78,79,157,4.638383838383838,44.637121477829304
Task_35482,1818,762,106,81,187,2.382699868938401,38.1080613535281
Task_35483,2342,703,28,30,58,3.3267045454545454,44.41207549556657
Task_35484,2600,260,190,160,350,9.96168582375479,50.07137348044504
Task_35485,1468,742,122,82,204,1.9757738896366084,32.667129471417205
Task_35486,1165,134,16,138,154,8.62962962962963,25.030290088735825
Task_35487,2614,859,198,189,387,3.0395348837209304,52.453895660279706
Task_35488,1767,939,134,36,170,1.8797872340425532,37.20433330557514
Task_35489,1545,983,17,167,184,1.5701219512195121,34.682389173255245
Task_35490,676,122,91,82,173,5.495934959349594,17.598946188555516
Task_35491,723,568,109,125,234,1.2706502636203867,20.71482893637277
Task_35492,2669,101,11,163,174,26.166666666666668,48.92367861920007
Task_35493,643,870,54,98,152,0.7382319173363949,19.766272688276
Task_35494,2659,328,83,113,196,8.082066869300911,50.53663508044096
Task_35495,892,915,187,74,261,0.9737991266375546,24.250442084077875
Task_35496,2846,773,145,60,205,3.6770025839793283,54.32626709547293
Task_35497,2194,567,191,112,303,3.862676056338028,44.38907695110114
Task_35498,912,178,101,27,128,5.094972067039106,20.793732557955867
Task_35499,586,202,22,10,32,2.8866995073891624,14.567810610149136
Task_35500,559,910,177,88,265,0.6136114160263447,19.27111930962948
Task_35501,2937,754,109,46,155,3.890066225165563,54.98252536768273
Task_35502,2345,174,96,19,115,13.4,42.88790504668058
Task_35503,1945,342,139,138,277,5.670553935860059,39.63973951237083
Task_35504,2694,408,181,63,244,6.58679706601467,50.98971672421595
Task_35505,887,278,71,36,107,3.1792114695340503,20.667512206942003
Task_35506,2121,804,165,97,262,2.634782608695652,43.80613229106407
Task_35507,1389,231,126,97,223,5.987068965517241,30.203803737869222
Task_35508,2670,1021,191,139,330,2.6125244618395302,53.51695648889834
Task_35509,1188,748,118,88,206,1.5861148197596795,28.260657245492354
Task_35510,1869,517,73,180,253,3.608108108108108,39.085220546709216
Task_35511,883,929,129,186,315,0.9494623655913978,24.847185220568136
Task_35512,967,738,163,85,248,1.3085250338294994,24.880796152434034
Task_35513,1501,785,100,88,188,1.9096692111959288,33.24648628739902
Task_35514,1610,550,21,90,111,2.9219600725952812,33.72562890012973
Task_35515,692,774,19,76,95,0.8929032258064517,19.486375691229682
Task_35516,2103,575,22,31,53,3.6510416666666665,40.2532654566598
Task_35517,2372,974,116,105,221,2.4328205128205127,48.10702351369105
Task_35518,2422,141,88,72,160,17.056338028169016,44.66152709724917
Task_35519,2123,751,171,168,339,2.8231382978723403,44.089411649140345
Task_35520,650,675,156,54,210,0.9615384615384616,19.376927870110944
Task_35521,1688,856,60,129,189,1.9696616102683782,36.89335608037003
Task_35522,549,378,52,125,177,1.4485488126649078,17.084034297938274
Task_35523,2564,463,123,172,295,5.525862068965517,49.96416887212107
Task_35524,2673,422,32,125,157,6.319148936170213,50.59385765886089
Task_35525,1170,972,11,154,165,1.2024665981500513,28.698948894956104
Task_35526,2413,677,44,153,197,3.5589970501474926,47.8020955790785
Task_35527,1354,392,137,173,310,3.44529262086514,30.6536881611755
Task_35528,2649,658,79,114,193,4.019726858877086,51.521898435197016
Task_35529,1557,507,87,27,114,3.0649606299212597,32.07195977569241
Task_35530,1284,725,183,197,380,1.7685950413223142,30.931062323651293
Task_35531,1244,246,123,128,251,5.036437246963563,28.1028356883637
Task_35532,2230,634,15,145,160,3.5118110236220472,44.30670421471225
Task_35533,1876,897,148,44,192,2.089086859688196,39.080188694693064
Task_35534,2558,603,95,11,106,4.235099337748345,48.105280432407675
Task_35535,1526,1014,111,152,263,1.5034482758620689,35.040241454681606
Task_35536,965,372,51,90,141,2.5871313672922254,23.325535250484645
Task_35537,1976,647,190,162,352,3.049382716049383,41.48397340141081
Task_35538,853,539,17,41,58,1.5796296296296297,20.36571418063077
Task_35539,2564,363,69,38,107,7.043956043956044,47.506219943953106
Task_35540,2794,342,106,107,213,8.145772594752186,52.73436684759912
Task_35541,1223,451,117,64,181,2.7057522123893807,27.37733051972812
Task_35542,941,491,193,82,275,1.9126016260162602,23.856511031986543
Task_35543,2820,69,102,11,113,40.285714285714285,49.26524984861522
Task_35544,936,287,112,192,304,3.25,23.70401329674495
Task_35545,2517,509,53,90,143,4.935294117647059,48.32065485817714
Task_35546,688,464,20,118,138,1.4795698924731182,19.098831077951893
Task_35547,608,345,138,33,171,1.7572254335260116,16.984199063751642
Task_35548,2519,236,108,199,307,10.628691983122362,48.56554297744466
Task_35549,2061,366,23,200,223,5.615803814713897,41.49817288846471
Task_35550,503,655,20,92,112,0.7667682926829268,16.509497042837406
Task_35551,1645,970,195,66,261,1.694129763130793,36.22576316787683
Task_35552,531,716,164,88,252,0.7405857740585774,17.917363936214542
Task_35553,1506,439,165,148,313,3.422727272727273,33.186603941078324
Task_35554,2520,277,29,107,136,9.06474820143885,47.576123473618885
Task_35555,2158,507,87,75,162,4.248031496062992,42.33966463817061
Task_35556,1963,197,95,95,190,9.914141414141413,39.032520629674096
Task_35557,2925,354,100,132,232,8.23943661971831,54.970102251239325
Task_35558,1464,763,72,140,212,1.9162303664921465,33.20056658244459
Task_35559,1116,967,132,131,263,1.1528925619834711,28.327393761586226
Task_35560,2220,215,182,17,199,10.277777777777779,42.127765393772926
Task_35561,728,562,162,21,183,1.2930728241563054,19.51836449776576
Task_35562,2955,355,187,118,305,8.30056179775281,55.756591753257034
Task_35563,1345,395,77,177,254,3.3964646464646466,30.40029445867408
Task_35564,2172,113,33,35,68,19.05263157894737,39.34337516638045
Task_35565,983,720,182,69,251,1.3633841886269071,24.884551795895053
Task_35566,1195,868,16,76,92,1.375143843498274,27.641585253431572
Task_35567,555,458,185,179,364,1.2091503267973855,18.387674770173103
Task_35568,2911,354,46,156,202,8.2,54.682918909745865
Task_35569,2245,688,81,16,97,3.258345428156749,43.24271352927175
Task_35570,1767,169,194,21,215,10.394117647058824,34.8419845537373
Task_35571,2102,744,178,138,316,2.821476510067114,43.58715207203347
Task_35572,2095,860,125,158,283,2.4332171893147505,43.71956068490879
Task_35573,857,713,154,72,226,1.2002801120448179,22.845082165314967
Task_35574,1539,77,64,52,116,19.73076923076923,29.789901917515433
Task_35575,1481,219,130,78,208,6.7318181818181815,31.187710591077536
Task_35576,1949,282,187,200,387,6.886925795053004,40.08617639830088
Task_35577,2343,413,171,46,217,5.659420289855072,45.06147662488646
Task_35578,1358,281,160,177,337,4.815602836879433,30.481745602914643
Task_35579,846,303,137,17,154,2.7828947368421053,20.202737815285214
Task_35580,2796,665,121,195,316,4.198198198198198,54.41483714797681
Task_35581,1825,965,51,180,231,1.8892339544513457,39.761907667412125
Task_35582,1054,373,189,85,274,2.8181818181818183,25.280264777980857
Task_35583,2615,105,96,155,251,24.669811320754718,48.51177053561717
Task_35584,2188,437,131,45,176,4.995433789954338,42.301103477451626
Task_35585,2617,417,147,131,278,6.260765550239235,50.515133162157554
Task_35586,2429,672,91,99,190,3.609212481426449,47.93660436693867
Task_35587,1908,455,138,144,282,4.184210526315789,39.45507346190687
Task_35588,1003,123,170,133,303,8.088709677419354,23.692780285435077
Task_35589,905,751,74,57,131,1.2034574468085106,23.131280199006014
Task_35590,2226,79,176,146,322,27.825,42.47965831244459
Task_35591,1385,833,175,165,340,1.660671462829736,32.639856925790134
Task_35592,1616,908,11,192,203,1.7777777777777777,35.95762708222445
Task_35593,681,856,191,175,366,0.79463243873979,21.665233831854266
Task_35594,823,700,137,197,334,1.174037089871612,23.274879651032535
Task_35595,743,584,135,51,186,1.27008547008547,20.216634767559125
Task_35596,1953,196,112,177,289,9.913705583756345,39.316615430232645
Task_35597,1821,75,46,36,82,23.960526315789473,33.562102243109145
Task_35598,1078,741,127,20,147,1.4528301886792452,25.314265133298864
Task_35599,1935,769,96,37,133,2.512987012987013,39.22820150763366
Task_35600,568,345,187,178,365,1.6416184971098267,18.31119377151204
Task_35601,3000,681,168,157,325,4.39882697947214,57.68175027763473
Task_35602,583,889,93,38,131,0.6550561797752809,18.633284004409646
Task_35603,2366,121,124,53,177,19.39344262295082,43.85194467304536
Task_35604,1568,694,199,72,271,2.256115107913669,34.255991833503835
Task_35605,2326,483,197,180,377,4.805785123966942,46.64298168296449
Task_35606,1781,823,142,92,234,2.1614077669902914,38.21083380841706
Task_35607,2131,77,33,122,155,27.32051282051282,39.75075580888393
Task_35608,1981,252,44,100,144,7.830039525691699,38.9609092835642
Task_35609,2361,253,93,141,234,9.295275590551181,45.830420786386924
Task_35610,681,326,13,127,140,2.0825688073394497,18.712983090800396
Task_35611,2557,407,159,118,277,6.267156862745098,49.50894811399155
Task_35612,2941,127,182,36,218,22.9765625,53.0550871350867
Task_35613,2441,822,101,40,141,2.965978128797084,47.28800291473967
Task_35614,1145,207,135,190,325,5.5048076923076925,26.829513681816337
Task_35615,2090,880,114,54,168,2.3723041997729855,42.38413588218943
Task_35616,2237,332,150,159,309,6.717717717717718,44.399437559955004
Task_35617,2464,283,194,151,345,8.67605633802817,47.969284666961336
Task_35618,2945,520,96,27,123,5.652591170825336,54.24572222298912
Task_35619,1820,695,64,52,116,2.6149425287356323,37.12495712666393
Task_35620,2143,86,51,18,69,24.632183908045977,38.25609385460992
Task_35621,1037,266,24,14,38,3.8838951310861423,21.92293837707942
Task_35622,599,263,45,134,179,2.268939393939394,17.469897744290183
Task_35623,1683,586,96,125,221,2.8671209540034073,36.05963645985859
Task_35624,2555,805,61,127,188,3.1699751861042182,50.452754270647546
Task_35625,2157,764,129,193,322,2.819607843137255,44.62880945656909
Task_35626,1183,864,32,83,115,1.3676300578034681,27.90785398833133
Task_35627,2090,639,90,129,219,3.265625,42.66576688880888
Task_35628,840,698,77,146,223,1.201716738197425,23.081058501693047
Task_35629,822,407,195,142,337,2.014705882352941,22.359596702638843
Task_35630,591,252,41,152,193,2.33596837944664,17.59160867637334
Task_35631,2077,285,53,98,151,7.2622377622377625,40.754641190550856
Task_35632,960,483,132,108,240,1.9834710743801653,24.295857981774827
Task_35633,1770,124,136,192,328,14.16,35.966176957655115
Task_35634,1491,307,18,113,131,4.840909090909091,31.381193357634682
Task_35635,1198,180,93,156,249,6.6187845303867405,26.891231097770557
Task_35636,730,881,73,197,270,0.8276643990929705,22.147683624575425
Task_35637,1687,879,141,103,244,1.9170454545454545,37.05770969840168
Task_35638,2421,888,147,135,282,2.7232845894263216,48.93414687582925
Task_35639,1251,218,93,111,204,5.712328767123288,27.992326326123916
Task_35640,2317,379,87,32,119,6.097368421052631,43.71516695543676
Task_35641,1618,885,116,136,252,1.8261851015801354,36.06749275046527
Task_35642,1258,869,53,197,250,1.445977011494253,30.45712730572754
Task_35643,2585,366,35,102,137,7.043596730245231,48.89916038163228
Task_35644,2300,656,22,90,112,3.5007610350076104,44.99217101879884
Task_35645,2446,197,73,62,135,12.353535353535353,45.77872680730349
Task_35646,2538,597,93,89,182,4.2441471571906355,49.08348692378862
Task_35647,1032,504,191,194,385,2.0435643564356436,26.28120748752673
Task_35648,1428,877,38,182,220,1.6264236902050113,32.9543080046568
Task_35649,2604,276,107,101,208,9.40072202166065,49.466372152369935
Task_35650,1851,973,11,174,185,1.9004106776180698,39.66241722686547
Task_35651,2776,607,37,17,54,4.565789473684211,50.74437987640638
Task_35652,2889,1016,48,59,107,2.84070796460177,54.951099963365955
Task_35653,950,752,129,193,322,1.2616201859229748,25.36414339121849
Task_35654,1762,649,155,118,273,2.710769230769231,37.68026451355458
Task_35655,634,144,178,136,314,4.372413793103449,18.145449217595292
Task_35656,1700,384,96,187,283,4.415584415584416,36.05401000288786
Task_35657,1451,157,130,26,156,9.183544303797468,29.22893223653269
Task_35658,2516,878,192,52,244,2.862343572241183,49.70300675600178
Task_35659,1609,126,159,154,313,12.669291338582678,33.333992986623855
Task_35660,1580,611,193,193,386,2.581699346405229,35.29764655569289
Task_35661,2576,383,46,160,206,6.708333333333333,49.505455253820514
Task_35662,1956,956,164,67,231,2.043887147335423,41.00729287561358
Task_35663,1690,696,199,174,373,2.42467718794835,37.219991656394
Task_35664,1872,727,30,172,202,2.5714285714285716,39.46736338712544
Task_35665,582,572,158,96,254,1.0157068062827226,18.521973323351535
Task_35666,2935,168,13,66,79,17.366863905325445,52.461020788607264
Task_35667,2711,1014,63,103,166,2.670935960591133,53.30639838739365
Task_35668,901,769,108,47,155,1.1701298701298701,22.792661064807913
Task_35669,2093,73,117,54,171,28.283783783783782,38.873953838397625
Task_35670,2627,738,117,114,231,3.554803788903924,51.46682678357081
Task_35671,2303,118,89,26,115,19.352941176470587,42.08100979697161
Task_35672,818,740,57,134,191,1.1039136302294197,22.603649574345877
Task_35673,2615,489,170,69,239,5.336734693877551,49.98247392313562
Task_35674,2013,667,176,152,328,3.0134730538922154,42.010141441551525
Task_35675,1726,540,85,123,208,3.190388170055453,36.528119379150354
Task_35676,2840,781,52,47,99,3.631713554987212,52.98400018847122
Task_35677,1425,935,148,127,275,1.5224358974358974,33.21228059732643
Task_35678,2488,1018,106,83,189,2.4416094210009813,49.58046536691956
Task_35679,2593,560,79,166,245,4.622103386809269,50.633300746933486
Task_35680,2910,66,86,120,206,43.43283582089552,52.58388109681564
Task_35681,1983,642,97,105,202,3.08398133748056,40.84315991053585
Task_35682,2822,241,29,132,161,11.661157024793388,52.353231608184835
Task_35683,2312,602,121,199,320,3.8341625207296848,46.573126489618154
Task_35684,1687,973,153,121,274,1.7320328542094456,37.49788535176173
Task_35685,768,506,66,106,172,1.514792899408284,21.031567624295267
Task_35686,942,282,135,50,185,3.3286219081272086,22.267287226926097
Task_35687,1744,142,36,125,161,12.195804195804195,34.467658079472706
Task_35688,1442,597,27,144,171,2.411371237458194,31.873711130168772
Task_35689,1203,693,96,187,283,1.7334293948126802,29.14932424299289
Task_35690,1258,613,178,54,232,2.04885993485342,28.850623221185273
Task_35691,2377,233,10,167,177,10.158119658119658,45.502272246179984
Task_35692,1182,213,172,198,370,5.5233644859813085,27.649141877711344
Task_35693,601,661,138,150,288,0.9078549848942599,19.37519463463824
Task_35694,2021,897,131,37,168,2.250556792873051,41.1020389673759
Task_35695,1560,972,145,104,249,1.6032887975334018,35.34466791264361
Task_35696,2643,462,99,42,141,5.708423326133909,49.333513822179235
Task_35697,1750,365,171,149,320,4.781420765027322,36.84116164353558
Task_35698,890,413,42,46,88,2.1497584541062804,20.92832186119468
Task_35699,567,712,197,184,381,0.7952314165497896,19.494805032551245
Task_35700,976,732,154,73,227,1.3315143246930423,24.789086569802805
Task_35701,2078,724,25,138,163,2.866206896551724,42.333757748846246
Task_35702,757,731,189,178,367,1.034153005464481,22.400253481866468
Task_35703,1530,402,124,128,252,3.796526054590571,33.143385104608306
Task_35704,2726,967,36,83,119,2.8161157024793386,52.76953830324408
Task_35705,2066,130,153,175,328,15.770992366412214,40.630520282406685
Task_35706,1475,1010,193,130,323,1.4589515331355094,34.43219932625188
Task_35707,533,892,94,185,279,0.5968645016797313,19.266011572112298
Task_35708,2435,956,126,45,171,2.5444096133751306,47.79337021017017
Task_35709,780,438,154,46,200,1.7767653758542141,20.318695626499142
Task_35710,2007,711,139,44,183,2.818820224719101,40.35543233764946
Task_35711,2891,664,134,61,195,4.347368421052631,54.645719161234744
Task_35712,521,327,126,56,182,1.5884146341463414,15.894777409152034
Task_35713,2722,98,84,32,116,27.494949494949495,48.18566533684251
Task_35714,1204,675,44,179,223,1.7810650887573964,28.78771664460801
Task_35715,2913,694,40,61,101,4.19136690647482,54.224478444287435
Task_35716,1213,1006,131,98,229,1.2045680238331677,29.786888596436512
Task_35717,1378,264,53,142,195,5.2,30.21915521343598
Task_35718,1698,361,59,194,253,4.69060773480663,35.92407262004313
Task_35719,1681,399,90,135,225,4.2025,35.460876101164295
Task_35720,681,610,148,105,253,1.1145662847790507,20.169610825478085
Task_35721,1168,378,30,127,157,3.0817941952506596,26.635799026394768
Task_35722,2603,944,122,99,221,2.7544973544973543,51.65040314406921
Task_35723,2604,418,43,172,215,6.214797136038186,50.102512699806105
Task_35724,1698,583,139,195,334,2.9075342465753424,36.84677575415422
Task_35725,640,533,88,59,147,1.198501872659176,18.13634931009943
Task_35726,536,416,84,117,201,1.2853717026378897,17.154094723506493
Task_35727,830,789,83,41,124,1.0506329113924051,21.49252257374197
Task_35728,2434,86,66,95,161,27.977011494252874,44.77150832314539
Task_35729,1143,937,122,114,236,1.2185501066098081,28.474621930861023
Task_35730,2146,715,146,178,324,2.9972067039106145,44.28785216328921
Task_35731,1263,441,17,21,38,2.8574660633484164,26.188973031999854
Task_35732,724,276,47,127,174,2.6137184115523464,19.621139227766392
Task_35733,1337,271,78,25,103,4.915441176470588,27.719962911341764
Task_35734,2648,564,191,122,313,4.686725663716814,51.628304629990716
Task_35735,1226,86,196,152,348,14.091954022988507,26.980150824314887
Task_35736,1415,824,128,129,257,1.715151515151515,32.66034454891125
Task_35737,1708,356,30,184,214,4.784313725490196,35.76171760787512
Task_35738,1060,898,198,173,371,1.1790878754171301,27.774792885240625
Task_35739,2578,354,51,112,163,7.261971830985916,49.16363650828726
Task_35740,633,822,158,166,324,0.7691373025516404,20.58167924080433
Task_35741,2030,438,105,187,292,4.624145785876993,41.43922703021125
Task_35742,1654,1017,41,131,172,1.62475442043222,36.607199159121095
Task_35743,1790,397,173,71,244,4.49748743718593,36.68586842563412
Task_35744,2070,505,53,96,149,4.090909090909091,41.4331021452636
Task_35745,893,703,112,54,166,1.2684659090909092,22.872956789691056
Task_35746,2303,160,97,180,277,14.304347826086957,44.435827099271556
Task_35747,2781,295,12,134,146,9.39527027027027,51.812012003068816
Task_35748,1638,174,72,188,260,9.36,33.93589792161965
Task_35749,2730,113,165,42,207,23.94736842105263,49.47235127721638
Task_35750,1706,322,164,143,307,5.281733746130031,35.93569155913914
Task_35751,1060,892,19,60,79,1.187010078387458,25.126966133929745
Task_35752,601,137,167,184,351,4.355072463768116,17.77664929453182
Task_35753,1496,741,141,34,175,2.0161725067385445,32.45008182523874
Task_35754,1254,475,44,90,134,2.634453781512605,28.0930781654436
Task_35755,1425,878,36,97,133,1.621160409556314,32.226908976142084
Task_35756,1004,853,97,45,142,1.1756440281030445,24.605733777481447
Task_35757,1423,767,178,99,277,1.8528645833333333,32.65457165511966
Task_35758,939,850,173,196,369,1.1034077555816686,25.671215706647583
Task_35759,2788,597,151,90,241,4.662207357859532,53.4147519614995
Task_35760,1016,624,16,142,158,1.6256,24.939503954498843
Task_35761,1486,157,30,106,136,9.405063291139241,30.269993969694912
Task_35762,2591,943,187,177,364,2.7447033898305087,52.23077698126067
Task_35763,2404,934,157,158,315,2.5711229946524066,48.990794267616955
Task_35764,1547,380,20,74,94,4.060367454068241,31.79300979506571
Task_35765,1507,931,76,73,149,1.6169527896995708,33.40785091842384
Task_35766,2385,224,196,88,284,10.6,45.885147996306756
Task_35767,517,321,147,137,284,1.6055900621118013,17.003774993829754
Task_35768,1705,454,113,161,274,3.7472527472527473,36.22759870008573
Task_35769,1561,246,153,200,353,6.319838056680162,33.676393421118625
Task_35770,844,979,84,50,134,0.8612244897959184,22.61920294048033
Task_35771,2744,575,124,14,138,4.763888888888889,51.122469792947506
Task_35772,1958,684,26,72,98,2.858394160583942,39.26340040760255
Task_35773,2576,173,37,184,221,14.804597701149426,48.46758608609744
Task_35774,2318,77,107,58,165,29.71794871794872,42.58808652112111
Task_35775,1187,491,80,154,234,2.41260162601626,28.082233899265535
Task_35776,2613,278,60,132,192,9.365591397849462,49.717158371613586
Task_35777,2309,343,52,197,249,6.712209302325581,45.530552416916464
Task_35778,2155,1011,29,162,191,2.1294466403162056,44.77267313371622
Task_35779,1621,153,54,51,105,10.525974025974026,31.499330018291086
Task_35780,1425,491,171,118,289,2.8963414634146343,31.91778308000589
Task_35781,2096,733,177,90,267,2.8555858310626703,43.001600667852756
Task_35782,1043,68,98,170,268,15.115942028985508,23.667430194611807
Task_35783,2721,852,43,63,106,3.189917936694021,51.8772383525638
Task_35784,2964,228,147,93,240,12.943231441048034,55.04073695038195
Task_35785,1022,912,161,83,244,1.1193866374589265,26.174978911474906
Task_35786,2234,812,36,187,223,2.747847478474785,45.55290813563579
Task_35787,2165,849,66,98,164,2.5470588235294116,44.18254007507065
Task_35788,1082,232,52,125,177,4.643776824034335,25.146322174589056
Task_35789,2968,956,79,187,266,3.1013584117032393,57.9490877262443
Task_35790,1136,678,130,163,293,1.6730486008836525,27.998375638063447
Task_35791,636,667,106,125,231,0.9520958083832335,19.655262032373823
Task_35792,2054,723,188,170,358,2.8370165745856353,42.99711578090353
Task_35793,621,934,45,117,162,0.6641711229946524,19.742183859550646
Task_35794,2989,559,10,145,155,5.3375,56.02695198715431
Task_35795,991,845,85,174,259,1.1713947990543736,26.04462435026176
Task_35796,2282,811,196,100,296,2.810344827586207,46.502834912607206
Task_35797,1951,475,19,19,38,4.098739495798319,37.012235298196345
Task_35798,599,448,82,193,275,1.334075723830735,18.792746198823895
Task_35799,1152,721,25,176,201,1.5955678670360112,28.03862304877868
Task_35800,615,956,83,49,132,0.6426332288401254,19.214782594493858
Task_35801,715,91,82,109,191,7.771739130434782,18.28569065430596
Task_35802,2853,435,17,136,153,6.543577981651376,53.3413999447595
Task_35803,3000,331,36,100,136,9.036144578313253,55.31897921468164
Task_35804,1676,647,124,58,182,2.5864197530864197,35.11378610206487
Task_35805,1483,776,99,186,285,1.9086229086229087,33.81321579004422
Task_35806,987,293,103,89,192,3.357142857142857,23.684535912363533
Task_35807,792,547,184,13,197,1.4452554744525548,20.66178188781522
Task_35808,2742,992,73,113,186,2.7613293051359515,53.877456895715056
Task_35809,793,267,40,97,137,2.958955223880597,20.27464649846343
Task_35810,822,140,184,27,211,5.829787234042553,19.7738480977933
Task_35811,1423,864,101,31,132,1.6450867052023121,31.337711155896628
Task_35812,597,351,111,46,157,1.6960227272727273,16.657132606708647
Task_35813,2368,96,31,73,104,24.412371134020617,42.91011928868115
Task_35814,2959,648,198,12,210,4.559322033898305,55.410748870750574
Task_35815,2507,495,96,105,201,5.054435483870968,48.69679878756768
Task_35816,877,959,84,177,261,0.9135416666666667,24.567243245907196
Task_35817,544,92,144,24,168,5.849462365591398,14.497021805686629
Task_35818,1647,193,196,67,263,8.489690721649485,33.921834783774955
Task_35819,633,596,110,23,133,1.0603015075376885,17.92540765871858
Task_35820,1300,1024,51,144,195,1.2682926829268293,31.25531793617203
Task_35821,2343,159,56,110,166,14.64375,44.29571636061686
Task_35822,1776,360,48,90,138,4.919667590027701,36.05319159335756
Task_35823,782,520,129,125,254,1.5009596928982725,21.638971071714764
Task_35824,1385,849,68,58,126,1.6294117647058823,30.951680855175955
Task_35825,2303,178,167,90,257,12.865921787709498,44.040641883827185
Task_35826,2259,578,16,162,178,3.901554404145078,44.74841972051039
Task_35827,1697,982,145,133,278,1.7263479145473042,37.719900531294314
Task_35828,2468,746,22,154,176,3.3038821954484603,48.600844190066404
Task_35829,533,352,15,125,140,1.5099150141643058,16.399084947057222
Task_35830,2733,578,47,55,102,4.72020725388601,51.051400826085704
Task_35831,770,769,11,100,111,1.0,21.08922415684047
Task_35832,665,736,197,91,288,0.9023066485753053,20.39658403217871
Task_35833,618,717,197,175,372,0.8607242339832869,20.22541328605973
Task_35834,1846,119,60,199,259,15.383333333333333,36.90593942608036
Task_35835,686,764,147,23,170,0.8967320261437909,19.549394768933055
Task_35836,1573,545,17,49,66,2.880952380952381,31.81368599516342
Task_35837,2779,160,176,19,195,17.26086956521739,50.55637053710291
Task_35838,1545,301,78,49,127,5.1158940397351,31.54441233267961
Task_35839,1407,808,91,120,211,1.739184177997528,32.312598969169755
Task_35840,1857,1007,52,137,189,1.8422619047619047,40.09409920169028
Task_35841,1471,885,131,84,215,1.6602708803611739,33.19222394634708
Task_35842,655,87,179,159,338,7.443181818181818,17.96250707886964
Task_35843,2242,753,58,162,220,2.973474801061008,45.59027559936814
Task_35844,1534,382,136,97,233,4.005221932114883,33.0445701459291
Task_35845,2835,422,61,57,118,6.702127659574468,52.27767189364579
Task_35846,2165,774,138,49,187,2.793548387096774,43.30277840930135
Task_35847,2554,866,99,142,241,2.9457900807381776,50.79989372636186
Task_35848,2084,559,23,192,215,3.7214285714285715,42.43861768592796
Task_35849,1102,128,121,173,294,8.542635658914728,25.277013823918086
Task_35850,2468,840,92,118,210,2.934601664684899,49.25683605136168
Task_35851,899,196,92,21,113,4.563451776649746,20.74235577510719
Task_35852,1697,294,149,139,288,5.752542372881356,35.60790393674694
Task_35853,1965,499,70,21,91,3.93,38.239709123280846
Task_35854,2042,83,80,160,240,24.30952380952381,39.38889903090449
Task_35855,1117,909,116,79,195,1.2274725274725276,27.4958288222096
Task_35856,2793,78,115,13,128,35.35443037974684,49.19292317044897
Task_35857,1970,667,48,83,131,2.9491017964071857,40.09315840382022
Task_35858,761,351,90,194,284,2.1619318181818183,21.10403757219427
Task_35859,2655,97,78,98,176,27.091836734693878,48.54078141988242
Task_35860,633,471,21,89,110,1.3411016949152543,17.90125633571031
Task_35861,1907,896,107,104,211,2.1259754738015606,40.44924516026024
Task_35862,2336,730,22,125,147,3.19562243502052,46.14177773872145
Task_35863,1192,567,12,76,88,2.0985915492957745,26.6654708189308
Task_35864,641,993,27,196,223,0.6448692152917505,20.92502028353967
Task_35865,848,977,105,66,171,0.8670756646216768,23.03646620154625
Task_35866,1084,458,74,70,144,2.3616557734204795,25.14584929877695
Task_35867,1796,754,176,135,311,2.3788079470198675,38.74393467417496
Task_35868,755,299,117,161,278,2.5166666666666666,20.718676134307113
Task_35869,1209,295,149,74,223,4.08445945945946,27.15105307290577
Task_35870,543,566,120,84,204,0.9576719576719577,17.433550325151106
Task_35871,706,408,181,83,264,1.726161369193154,19.808918867007588
Task_35872,1450,962,43,24,67,1.505711318795431,31.05078948424216
Task_35873,1546,655,27,54,81,2.356707317073171,32.29962123837729
Task_35874,2096,948,86,145,231,2.208640674394099,43.79821767320637
Task_35875,2982,153,192,153,345,19.363636363636363,55.311885102364016
Task_35876,2235,867,163,175,338,2.574884792626728,46.23245528935298
Task_35877,2455,177,52,148,200,13.792134831460674,46.476044177719594
Task_35878,609,535,39,88,127,1.1361940298507462,17.89845022788454
Task_35879,2066,382,137,150,287,5.394255874673629,41.749163938488444
Task_35880,2238,362,106,149,255,6.1652892561983474,44.258220492425096
Task_35881,2258,133,14,133,147,16.850746268656717,42.32749301426145
Task_35882,2822,511,33,82,115,5.51171875,52.922898086350735
Task_35883,1074,241,41,131,172,4.43801652892562,24.989387515840217
Task_35884,1256,362,99,33,132,3.4600550964187327,27.121935113933517
Task_35885,2871,551,50,166,216,5.201086956521739,54.93441674827579
Task_35886,2928,704,116,131,247,4.153191489361702,56.22456850100301
Task_35887,1795,152,145,109,254,11.732026143790849,36.12521269004869
Task_35888,1304,719,108,140,248,1.8111111111111111,30.564132959562766
Task_35889,2533,159,31,183,214,15.83125,47.75884142150366
Task_35890,1083,808,115,148,263,1.338689740420272,27.37849925941649
Task_35891,1232,293,124,196,320,4.190476190476191,28.481015776011073
Task_35892,2579,933,68,58,126,2.7612419700214135,50.12651807982107
Task_35893,792,966,142,156,298,0.8190279214064116,23.382180350747348
Task_35894,1828,75,101,169,270,24.05263157894737,35.983760502288476
Task_35895,1701,907,128,186,314,1.8733480176211454,37.80375288718276
Task_35896,1388,631,71,130,201,2.1962025316455698,31.520393918392987
Task_35897,2400,232,110,71,181,10.300429184549357,45.284377021827176
Task_35898,624,315,168,149,317,1.9746835443037976,18.856578001659656
Task_35899,1756,449,169,135,304,3.902222222222222,37.115881633417125
Task_35900,1413,916,81,42,123,1.5408942202835332,31.138050216912585
Task_35901,544,541,32,21,53,1.003690036900369,15.561265521829874
Task_35902,2986,534,125,17,142,5.581308411214954,54.785424646945984
Task_35903,1522,532,183,162,345,2.855534709193246,33.90010251666191
Task_35904,898,347,200,115,315,2.5804597701149423,23.23299911948244
Task_35905,1082,687,58,12,70,1.572674418604651,24.111439953207874
Task_35906,1940,570,10,19,29,3.3975481611208407,37.14686094123025
Task_35907,2171,81,31,32,63,26.475609756097562,38.958604508795034
Task_35908,2115,772,21,114,135,2.736093143596378,42.71893361830604
Task_35909,655,551,11,162,173,1.1865942028985508,19.286760082221107
Task_35910,764,432,197,163,360,1.7644341801385681,21.641402360882456
Task_35911,595,452,168,170,338,1.3134657836644592,18.901136313229987
Task_35912,696,255,44,52,96,2.71875,17.758915326269285
Task_35913,2882,927,55,182,237,3.105603448275862,56.38556381793676
Task_35914,1765,226,19,183,202,7.775330396475771,36.10294361192951
Task_35915,1590,1000,33,123,156,1.5884115884115884,35.222304422916736
Task_35916,1194,251,120,199,319,4.738095238095238,27.740330832370677
Task_35917,2997,478,101,185,286,6.25678496868476,56.8458658018972
Task_35918,512,534,11,195,206,0.9570093457943926,17.20592410363297
Task_35919,1019,919,149,37,186,1.107608695652174,25.39352307322895
Task_35920,1456,665,71,180,251,2.186186186186186,33.00243313378807
Task_35921,2657,437,103,147,250,6.066210045662101,51.11147242275862
Task_35922,1303,114,39,77,116,11.330434782608696,26.631248227621075
Task_35923,2318,148,132,29,161,15.557046979865772,42.93059171971723
Task_35924,2151,578,106,41,147,3.715025906735751,41.98205165871059
Task_35925,2758,93,102,129,231,29.340425531914892,50.476654339138484
Task_35926,804,931,99,32,131,0.8626609442060086,21.74124073012084
Task_35927,2318,934,172,70,242,2.479144385026738,46.72548758958681
Task_35928,1585,623,42,151,193,2.5400641025641026,34.49672929402265
Task_35929,961,964,12,61,73,0.9958549222797928,23.631834672341494
Task_35930,597,658,152,183,335,0.9059180576631259,19.562754525951092
Task_35931,1202,855,29,45,74,1.4042056074766356,26.75601496288904
Task_35932,2108,98,105,69,174,21.292929292929294,39.3860940797019
Task_35933,1840,546,122,168,290,3.363802559414991,38.74042444707573
Task_35934,608,753,122,189,311,0.8063660477453581,19.93158179203567
Task_35935,2621,908,191,183,374,2.8833883388338832,52.6507025049082
Task_35936,724,368,161,182,343,1.962059620596206,20.77161034602218
Task_35937,1283,165,85,26,111,7.728915662650603,26.22285886728325
Task_35938,1624,198,175,191,366,8.160804020100503,34.59144492568854
Task_35939,1247,122,172,197,369,10.138211382113822,27.91923669615105
Task_35940,2780,663,30,40,70,4.186746987951807,51.23114184984826
Task_35941,594,552,84,25,109,1.074141048824593,16.86903352584696
Task_35942,1407,609,135,59,194,2.3065573770491805,30.963958412962246
Task_35943,1332,893,97,98,195,1.4899328859060403,31.230320473375684
Task_35944,1282,638,168,40,208,2.0062597809076683,28.951250317505643
Task_35945,1928,457,100,192,292,4.209606986899563,39.893513713914615
Task_35946,2571,832,167,49,216,3.086434573829532,50.08799442728616
Task_35947,987,987,126,113,239,0.9989878542510121,26.19511071447475
Task_35948,742,264,54,91,145,2.8,19.509593449494563
Task_35949,2969,177,12,198,210,16.679775280898877,54.53969522211104
Task_35950,1758,930,92,128,220,1.8882921589688506,38.34726005844858
Task_35951,817,1012,126,140,266,0.8065153010858835,23.768789082463286
Task_35952,583,695,189,160,349,0.8376436781609196,19.468849379638446
Task_35953,2535,426,60,43,103,5.936768149882904,46.965916728484935
Task_35954,792,760,184,152,336,1.040735873850197,22.86670200908973
Task_35955,1597,652,182,80,262,2.445635528330781,34.68579589833522
Task_35956,2032,622,146,131,277,3.261637239165329,41.90858810597944
Task_35957,2502,412,41,70,111,6.058111380145278,47.18350522850468
Task_35958,1793,260,180,64,244,6.869731800766283,36.24511351304124
Task_35959,2089,555,96,94,190,3.7571942446043165,42.13827504984619
Task_35960,1033,310,102,123,225,3.3215434083601285,24.855105494664503
Task_35961,2705,634,131,190,321,4.25984251968504,52.89022171032368
Task_35962,1983,757,13,44,57,2.6160949868073877,38.977256669128344
Task_35963,1770,852,172,151,323,2.075029308323564,38.71521710703828
Task_35964,1054,129,71,30,101,8.107692307692307,22.349361537140606
Task_35965,1733,471,159,82,241,3.6716101694915255,36.17738294504972
Task_35966,2657,404,130,199,329,6.560493827160494,51.43448582909698
Task_35967,1985,671,106,180,286,2.9538690476190474,41.43097234726467
Task_35968,891,519,128,118,246,1.7134615384615384,23.344568658678693
Task_35969,2778,1003,143,109,252,2.766932270916335,54.77681885679673
Task_35970,518,613,26,84,110,0.8436482084690554,16.458314888470067
Task_35971,2846,779,191,100,291,3.6487179487179486,55.31528947302371
Task_35972,1305,774,182,125,307,1.6838709677419355,30.9816501627876
Task_35973,2456,653,137,167,304,3.7553516819571864,48.89643182882512
Task_35974,893,196,98,156,254,4.532994923857868,22.412174800189536
Task_35975,1870,694,49,73,122,2.6906474820143886,38.39674670571723
Task_35976,587,485,49,103,152,1.2078189300411524,17.658155642577423
Task_35977,1725,538,199,165,364,3.2003710575139146,37.22330056067006
Task_35978,999,910,64,53,117,1.0965971459934138,24.717317655480016
Task_35979,1691,763,62,103,165,2.2133507853403143,36.45596193888014
Task_35980,2917,736,112,189,301,3.9579375848032563,56.47996977625028
Task_35981,1875,248,99,176,275,7.530120481927711,38.259356026280194
Task_35982,2774,347,174,105,279,7.971264367816092,52.7297707278183
Task_35983,2828,313,70,85,155,9.006369426751592,52.49566676968079
Task_35984,2099,508,200,175,375,4.1237721021611,43.113412574796975
Task_35985,2173,424,58,172,230,5.1129411764705885,43.50997140876472
Task_35986,979,575,96,169,265,1.6996527777777777,25.126180527660594
Task_35987,1338,679,185,142,327,1.9676470588235293,31.336975356079197
Task_35988,2017,658,171,43,214,3.0606980273141122,40.67536878951075
Task_35989,2133,159,12,62,74,13.33125,39.49443126651989
Task_35990,1050,175,153,108,261,5.965909090909091,24.42203448694966
Task_35991,2363,938,133,42,175,2.516506922257721,46.78724691795092
Task_35992,1424,700,128,26,154,2.0313837375178316,30.811613309245022
Task_35993,2555,810,18,56,74,3.1504315659679407,48.4349246755824
Task_35994,2398,727,132,193,325,3.293956043956044,48.34399934140337
Task_35995,1869,415,139,10,149,4.492788461538462,36.87255938899032
Task_35996,1900,223,26,86,112,8.482142857142858,37.26129703593356
Task_35997,710,413,137,46,183,1.714975845410628,18.877072463858124
Task_35998,1676,222,17,41,58,7.515695067264574,32.326346288384585
Task_35999,2604,456,141,40,181,5.698030634573304,49.003594329972344
Task_36000,1586,751,118,188,306,2.109042553191489,35.46293081509304
Task_36001,1401,540,125,46,171,2.589648798521257,30.1454554176901
Task_36002,1690,252,11,32,43,6.679841897233201,32.47319335150119
Task_36003,1563,235,108,142,250,6.622881355932203,33.12026793302878
Task_36004,1024,719,17,141,158,1.4222222222222223,25.245323287829038
Task_36005,1719,504,130,159,289,3.403960396039604,36.6735283738016
Task_36006,2952,502,56,125,181,5.868787276341949,55.62710902563456
Task_36007,2508,746,152,138,290,3.357429718875502,49.90796641303128
Task_36008,1231,269,81,97,178,4.559259259259259,27.564670799047036
Task_36009,1247,564,167,189,356,2.207079646017699,29.735620635632344
Task_36010,1092,440,43,147,190,2.4761904761904763,26.083854635767427
Task_36011,792,116,189,107,296,6.769230769230769,20.18863689344047
Task_36012,2818,850,79,132,211,3.3113983548766157,54.91185586595737
Task_36013,555,888,118,23,141,0.6242969628796401,17.952118164511052
Task_36014,2105,739,23,142,165,2.8445945945945947,42.96838764763095
Task_36015,1577,213,198,191,389,7.369158878504673,33.961248693852696
Task_36016,1278,198,141,39,180,6.422110552763819,27.17514450664727
Task_36017,2174,195,178,47,225,11.091836734693878,41.65713033787062
Task_36018,1143,239,157,67,224,4.7625,25.83142039758515
Task_36019,1173,419,129,107,236,2.7928571428571427,27.445563150467393
Task_36020,2295,400,33,61,94,5.723192019950124,43.4979304341239
Task_36021,1955,417,171,180,351,4.677033492822966,40.43975795639732
Task_36022,1839,549,82,36,118,3.3436363636363637,36.689549972629486
Task_36023,2575,407,114,70,184,6.311274509803922,48.66469524191772
Task_36024,2134,123,160,157,317,17.20967741935484,41.58825063121229
Task_36025,2477,620,182,100,282,3.9887278582930756,48.92701567197404
Task_36026,1877,717,58,78,136,2.614206128133705,38.74595929244956
Task_36027,2470,300,144,44,188,8.205980066445182,46.51184387440568
Task_36028,2010,193,56,156,212,10.360824742268042,40.019539438607644
Task_36029,1406,630,162,134,296,2.2282091917591127,32.10939894369797
Task_36030,1789,770,77,169,246,2.3203631647211416,38.56581191830147
Task_36031,737,914,72,35,107,0.805464480874317,20.428073313958013
Task_36032,1489,714,89,110,199,2.0825174825174826,33.25407405114333
Task_36033,1466,631,31,125,156,2.319620253164557,32.14432629600292
Task_36034,2694,1008,106,173,279,2.6699702675916748,53.6767580793481
Task_36035,2257,130,60,122,182,17.229007633587788,42.777172590780566
Task_36036,2307,977,115,15,130,2.3588957055214723,45.505839552568716
Task_36037,2452,335,48,58,106,7.2976190476190474,45.82207261593728
Task_36038,2450,87,178,48,226,27.84090909090909,44.73416831893169
Task_36039,2010,813,129,34,163,2.4692874692874693,40.68091376355822
Task_36040,2666,662,18,30,48,4.0211161387631975,49.30467725213487
Task_36041,1897,562,172,21,193,3.369449378330373,38.26532139859403
Task_36042,946,256,85,79,164,3.6809338521400776,22.620193077282682
Task_36043,830,963,84,95,179,0.8609958506224067,23.114883858271938
Task_36044,892,380,126,15,141,2.341207349081365,21.210970225274906
Task_36045,2373,513,24,49,73,4.616731517509727,44.37294802013016
Task_36046,1520,437,120,134,254,3.470319634703196,33.11534305243932
Task_36047,2762,789,186,195,381,3.4962025316455696,54.56086858135774
Task_36048,1034,780,148,169,317,1.323943661971831,26.78950892060988
Task_36049,2017,577,44,159,203,3.48961937716263,41.24982451649683
Task_36050,1690,66,176,181,357,25.223880597014926,34.2825795700906
Task_36051,1373,269,98,15,113,5.0851851851851855,28.319517259784394
Task_36052,1731,1008,119,73,192,1.7155599603567888,37.459668126714796
Task_36053,1241,739,200,12,212,1.677027027027027,28.48210081092381
Task_36054,2710,665,199,124,323,4.069069069069069,52.98014248387718
Task_36055,1021,916,163,118,281,1.113413304252999,26.649308736834666
Task_36056,1000,147,114,105,219,6.756756756756757,23.406784357718
Task_36057,2262,820,93,38,131,2.7551766138855056,44.66710271852435
Task_36058,1146,414,22,144,166,2.76144578313253,26.539673360389703
Task_36059,2875,299,46,77,123,9.583333333333334,52.993553374727234
Task_36060,741,117,192,74,266,6.279661016949152,18.920405825308674
Task_36061,1863,434,139,37,176,4.2827586206896555,37.209522560853046
Task_36062,1972,933,84,32,116,2.1113490364025695,40.00428379810773
Task_36063,1716,378,63,147,210,4.527704485488127,35.97508103771941
Task_36064,1068,540,97,169,266,1.9741219963031422,26.41477306263529
Task_36065,1564,503,46,159,205,3.1031746031746033,33.87217036692655
Task_36066,1354,532,91,81,172,2.5403377110694185,29.980913500523542
Task_36067,814,978,191,118,309,0.8314606741573034,23.76174438444974
Task_36068,833,848,127,89,216,0.9811542991755006,23.011042167101433
Task_36069,585,164,89,197,286,3.5454545454545454,17.431330976541272
Task_36070,1186,190,16,194,210,6.209424083769633,26.83988164130113
Task_36071,906,292,37,154,191,3.092150170648464,22.70098966475028
Task_36072,1935,599,87,167,254,3.225,40.25737453941169
Task_36073,793,669,54,111,165,1.1835820895522389,21.84803663272773
Task_36074,994,533,84,12,96,1.8614232209737829,22.965240183468683
Task_36075,575,625,114,35,149,0.9185303514376997,17.29030081601278
Task_36076,1232,159,173,28,201,7.7,26.351258009174348
Task_36077,1504,465,118,146,264,3.227467811158798,33.01413587549862
Task_36078,1777,328,119,163,282,5.401215805471125,36.995161103927195
Task_36079,1531,607,91,154,245,2.518092105263158,33.86566407446089
Task_36080,2701,273,181,75,256,9.857664233576642,50.80263098699237
Task_36081,839,776,45,76,121,1.0797940797940797,22.05326622057683
Task_36082,2428,364,61,62,123,6.652054794520548,45.8555803477017
Task_36083,1139,677,159,139,298,1.6799410029498525,28.030133772919772
Task_36084,1146,796,143,11,154,1.4378920953575909,26.55478816443069
Task_36085,1526,289,126,142,268,5.2620689655172415,32.801971355747156
Task_36086,778,526,150,114,264,1.476280834914611,21.612190222682468
Task_36087,652,266,77,167,244,2.4419475655430714,18.965961140404186
Task_36088,2604,64,147,143,290,40.06153846153846,48.13891371235954
Task_36089,2800,546,176,78,254,5.118829981718465,53.34909484687818
Task_36090,2421,783,115,40,155,3.0880102040816326,46.9103992285801
Task_36091,1516,474,49,106,155,3.191578947368421,32.52213031430579
Task_36092,2733,324,108,136,244,8.409230769230769,51.889462026103196
Task_36093,1330,495,78,79,157,2.681451612903226,29.347569903064457
Task_36094,1840,836,141,12,153,2.198327359617682,37.725096074754525
Task_36095,706,906,27,174,201,0.7783902976846747,21.39684391934019
Task_36096,845,667,94,107,201,1.2649700598802396,22.84141578909931
Task_36097,2821,502,199,87,286,5.608349900596422,53.74017115219737
Task_36098,1545,168,93,71,164,9.142011834319527,31.478858690657557
Task_36099,2441,848,77,17,94,2.8751472320376914,46.84284275829224
Task_36100,884,780,17,142,159,1.1318822023047375,23.17399374189822
Task_36101,2195,826,22,125,147,2.6541717049576783,44.2088933560725
Task_36102,1168,871,114,19,133,1.3394495412844036,27.11346481276701
Task_36103,2262,945,175,87,262,2.3911205073995774,46.17778270236435
Task_36104,1970,414,56,126,182,4.746987951807229,39.80286368419335
Task_36105,1546,772,82,176,258,2.0,34.753208640303605
Task_36106,2292,237,184,58,242,9.630252100840336,43.97196273755636
Task_36107,806,921,96,197,293,0.8741865509761388,23.556851359543455
Task_36108,2342,513,69,153,222,4.556420233463035,46.37629630739256
Task_36109,1213,761,105,88,193,1.5918635170603674,28.665852773329306
Task_36110,917,1013,169,25,194,0.9043392504930966,24.29737961466752
Task_36111,771,787,165,100,265,0.9784263959390863,22.26828198005731
Task_36112,1818,305,11,23,34,5.9411764705882355,34.48853522734352
Task_36113,712,135,64,31,95,5.235294117647059,16.736527113496056
Task_36114,863,723,57,89,146,1.191988950276243,22.67010726755194
Task_36115,1875,616,38,55,93,3.038897893030794,37.6050405770667
Task_36116,1605,132,71,14,85,12.06766917293233,30.87634446397517
Task_36117,2373,788,67,104,171,3.0076045627376424,47.238965504469185
Task_36118,2514,152,86,76,162,16.431372549019606,46.38440012720494
Task_36119,2344,927,43,198,241,2.5258620689655173,47.75696526850583
Task_36120,1543,391,44,140,184,3.936224489795918,32.86452500562992
Task_36121,1865,426,125,115,240,4.3676814988290396,38.449090156474824
Task_36122,2665,645,101,38,139,4.125386996904025,50.301506041207375
Task_36123,1719,746,41,197,238,2.3012048192771086,37.273410716427
Task_36124,1177,469,55,52,107,2.5042553191489363,26.10710659439467
Task_36125,1037,186,200,137,337,5.545454545454546,25.179693544626463
Task_36126,2432,121,98,93,191,19.934426229508198,45.53583680065662
Task_36127,1002,977,146,58,204,1.0245398773006136,25.681873175317993
Task_36128,2194,549,200,50,250,3.9890909090909092,43.36520142670022
Task_36129,2200,507,183,40,223,4.330708661417323,43.14140208882981
Task_36130,1464,564,35,155,190,2.591150442477876,32.39187738251841
Task_36131,2437,764,181,156,337,3.1856209150326795,49.07799074222746
Task_36132,1122,443,19,189,208,2.527027027027027,26.689020093666795
Task_36133,1786,298,156,101,257,5.973244147157191,36.833094342698296
Task_36134,2897,838,135,129,264,3.4529201430274137,56.229644439193954
Task_36135,2456,932,23,62,85,2.632368703108253,47.68649048715517
Task_36136,2365,117,94,83,177,20.04237288135593,44.08914522486356
Task_36137,2539,895,165,60,225,2.833705357142857,49.93501755330152
Task_36138,2290,1014,119,30,149,2.2561576354679804,45.5844525449294
Task_36139,2598,278,57,198,255,9.311827956989248,49.891447492103616
Task_36140,2925,929,46,87,133,3.1451612903225805,55.996411330401536
Task_36141,2140,521,130,191,321,4.099616858237548,43.58421996286237
Task_36142,2545,119,114,155,269,21.208333333333332,47.80558017874173
Task_36143,1880,427,138,31,169,4.392523364485982,37.376103381546635
Task_36144,1410,922,157,120,277,1.5276273022751896,32.93302948569445
Task_36145,2433,446,167,182,349,5.442953020134228,48.093209284424006
Task_36146,2969,1014,115,33,148,2.9251231527093595,56.3221992715541
Task_36147,2976,472,163,176,339,6.291754756871036,56.71942584650071
Task_36148,2683,782,81,82,163,3.426564495530013,51.82301797271851
Task_36149,2168,545,13,193,206,3.970695970695971,43.64479991763099
Task_36150,2015,526,172,81,253,3.823529411764706,40.83022465492289
Task_36151,682,437,124,197,321,1.5570776255707763,20.204067475232865
Task_36152,727,145,187,62,249,4.97945205479452,18.81965315517336
Task_36153,2401,292,68,180,248,8.194539249146757,46.73273310307479
Task_36154,1887,874,84,48,132,2.1565714285714286,38.70375956464328
Task_36155,2497,747,91,147,238,3.338235294117647,49.56493924910788
Task_36156,1113,532,23,22,45,2.0881801125703565,24.307520359044577
Task_36157,2478,478,16,30,46,5.1732776617954075,45.77043831177568
Task_36158,1984,657,129,26,155,3.0151975683890577,39.57154757962326
Task_36159,2302,895,85,160,245,2.5691964285714284,46.987635194059635
Task_36160,612,554,43,37,80,1.1027027027027028,16.97636606431409
Task_36161,775,794,79,193,272,0.9748427672955975,22.59586808764801
Task_36162,1931,693,135,118,253,2.782420749279539,40.405122648272375
Task_36163,1980,503,71,164,235,3.9285714285714284,40.693305074083604
Task_36164,2867,521,199,132,331,5.492337164750958,55.05311031382248
Task_36165,566,707,91,73,164,0.7994350282485876,17.932942917262313
Task_36166,1138,582,176,112,288,1.9519725557461407,27.64659808570326
Task_36167,1977,483,119,143,262,4.0847107438016526,40.54567623494653
Task_36168,2662,552,30,149,179,4.81374321880651,51.10995084565576
Task_36169,2713,295,187,93,280,9.16554054054054,51.504995891257956
Task_36170,627,600,94,144,238,1.043261231281198,19.383928473004158
Task_36171,594,94,187,133,320,6.252631578947368,16.887484813005972
Task_36172,2668,624,128,68,196,4.2688,51.08952225589724
Task_36173,573,283,31,134,165,2.017605633802817,17.204563196682468
Task_36174,1603,616,154,138,292,2.59805510534846,35.17332128569847
Task_36175,547,81,119,183,302,6.670731707317073,16.139060994219104
Task_36176,2764,466,71,177,248,5.918629550321199,53.0622434810528
Task_36177,1294,831,67,181,248,1.5552884615384615,30.897179182989504
Task_36178,1467,577,25,158,183,2.538062283737024,32.30490422331848
Task_36179,2598,187,119,117,236,13.819148936170214,49.28321467936609
Task_36180,763,504,164,44,208,1.510891089108911,20.297255797305812
Task_36181,1395,661,179,156,335,2.107250755287009,32.24017668954318
Task_36182,1793,211,157,108,265,8.45754716981132,36.68377460498195
Task_36183,2247,332,19,77,96,6.747747747747748,42.69448320202665
Task_36184,2150,178,68,30,98,12.011173184357542,39.945911191250055
Task_36185,787,744,137,17,154,1.0563758389261746,20.61313266295025
Task_36186,1421,644,196,12,208,2.2031007751937985,31.029586867797125
Task_36187,1826,412,71,188,259,4.421307506053269,38.10616694938857
Task_36188,2694,1020,79,195,274,2.6385896180215473,53.85458566662812
Task_36189,686,532,174,91,265,1.2870544090056286,19.960686135106908
Task_36190,1716,64,58,148,206,26.4,33.95231546026635
Task_36191,1491,881,90,159,249,1.6904761904761905,34.09878394403406
Task_36192,1499,139,45,113,158,10.707142857142857,30.460154865500385
Task_36193,2010,445,176,118,294,4.506726457399103,41.05321547009826
Task_36194,2150,991,102,42,144,2.1673387096774195,43.22958861127185
Task_36195,1412,364,128,144,272,3.8684931506849316,31.267174122107818
Task_36196,880,190,106,72,178,4.607329842931938,21.244153252536606
Task_36197,2238,598,60,67,127,3.7362270450751254,43.81890516800009
Task_36198,715,273,55,12,67,2.6094890510948905,17.001570680557567
Task_36199,1191,306,174,66,240,3.8794788273615635,26.86165180448931
Task_36200,623,765,18,172,190,0.8133159268929504,19.501713436083197
Task_36201,2346,528,173,183,356,4.434782608695652,47.014222199809545
Task_36202,2403,71,21,110,131,33.375,43.74639158784273
Task_36203,1296,210,130,68,198,6.14218009478673,28.03208780498103
Task_36204,517,935,199,100,299,0.5523504273504274,18.922590074501024
Task_36205,1741,892,15,116,131,1.9496080627099663,37.26973284617566
Task_36206,2659,441,30,12,42,6.015837104072398,48.22131689633784
Task_36207,2552,814,151,169,320,3.1312883435582823,50.99927321781244
Task_36208,1219,520,92,43,135,2.3397312859884836,27.105518202502424
Task_36209,2878,962,104,137,241,2.988577362409138,56.22498103713008
Task_36210,1621,659,77,128,205,2.456060606060606,35.31246499207662
Task_36211,957,395,183,124,307,2.4166666666666665,24.29623889323607
Task_36212,2310,236,175,20,195,9.746835443037975,43.64344523171875
Task_36213,914,612,178,124,302,1.4910277324632952,24.23082656717384
Task_36214,1049,306,97,128,225,3.416938110749186,25.126120889881832
Task_36215,1384,710,62,141,203,1.9465541490857947,31.729978748475574
Task_36216,2671,344,101,162,263,7.742028985507246,51.10173123862874
Task_36217,2643,649,83,65,148,4.0661538461538465,50.338361322569256
Task_36218,2203,675,26,131,157,3.2588757396449703,43.97024761055715
Task_36219,2422,589,28,38,66,4.105084745762712,45.3256338876783
Task_36220,1979,705,195,157,352,2.803116147308782,41.706484723131545
Task_36221,2524,968,135,72,207,2.604747162022704,49.969529587999936
Task_36222,1613,933,127,40,167,1.7269807280513918,34.74780001442383
Task_36223,920,337,198,54,252,2.7218934911242605,22.71973127399205
Task_36224,945,879,103,49,152,1.0738636363636365,23.7982159929651
Task_36225,2539,725,79,135,214,3.497245179063361,50.11670603433834
Task_36226,2998,669,56,45,101,4.474626865671642,55.140694695276686
Task_36227,1009,758,21,49,70,1.3293807641633728,23.578398280542473
Task_36228,1645,468,169,25,194,3.5074626865671643,34.03482857917586
Task_36229,1272,767,128,62,190,1.65625,29.332266108878688
Task_36230,2286,343,190,196,386,6.645348837209302,45.61296496588002
Task_36231,1123,107,80,153,233,10.398148148148149,25.02705755876192
Task_36232,528,127,161,23,184,4.125,14.715962002002962
Task_36233,1334,488,69,141,210,2.7280163599182004,30.266847822215023
Task_36234,1457,893,89,25,114,1.6297539149888143,31.696866828630732
Task_36235,1338,581,112,168,280,2.2989690721649483,30.856647588515518
Task_36236,2967,70,139,158,297,41.7887323943662,53.886994848190675
Task_36237,586,1000,142,112,254,0.5854145854145855,20.112286513013306
Task_36238,680,602,82,138,220,1.1276948590381426,20.094714533516953
Task_36239,2017,953,10,15,25,2.1142557651991614,39.58931660659323
Task_36240,1935,829,13,41,54,2.3313253012048194,38.50261097900381
Task_36241,1318,965,169,16,185,1.3643892339544514,30.093229509234124
Task_36242,1997,663,121,130,251,3.0075301204819276,41.36483501833056
Task_36243,1093,564,60,161,221,1.9345132743362832,26.775533477024272
Task_36244,2147,190,178,12,190,11.24083769633508,41.011994742776274
Task_36245,2753,983,138,193,331,2.7977642276422765,54.79744918754621
Task_36246,1466,475,40,107,147,3.0798319327731094,31.576216931966666
Task_36247,1001,138,191,178,369,7.201438848920863,24.1431028913654
Task_36248,2298,595,145,165,310,3.8557046979865772,46.2342692552184
Task_36249,1089,92,95,21,116,11.709677419354838,22.62893808601292
Task_36250,554,810,71,117,188,0.6831072749691739,18.82285054638981
Task_36251,2538,956,30,29,59,2.652037617554859,48.292966856357054
Task_36252,1713,831,106,195,301,2.058894230769231,37.71205309093454
Task_36253,2457,623,20,77,97,3.9375,46.97079611127301
Task_36254,1203,666,179,88,267,1.8035982008995501,28.556568051513352
Task_36255,1695,204,42,191,233,8.268292682926829,35.10175781004682
Task_36256,1512,362,99,34,133,4.1652892561983474,31.170706285777133
Task_36257,2956,234,123,157,280,12.578723404255319,55.27746268225891
Task_36258,2817,638,84,122,206,4.408450704225352,54.10613854737161
Task_36259,1773,185,96,144,240,9.53225806451613,36.11178472380208
Task_36260,1651,727,55,65,120,2.267857142857143,34.82683501147876
Task_36261,1191,804,184,140,324,1.479503105590062,29.338089005727202
Task_36262,621,182,68,136,204,3.3934426229508197,17.803386600769873
Task_36263,1754,359,138,170,308,4.872222222222222,36.861429571698075
Task_36264,1437,81,96,105,201,17.524390243902438,29.535111876666765
Task_36265,2471,690,16,166,182,3.5759768451519536,48.484209924977826
Task_36266,1159,952,49,147,196,1.2161594963273872,28.74230642514527
Task_36267,775,966,122,173,295,0.8014477766287487,23.155725962087647
Task_36268,2330,890,168,35,203,2.6150392817059482,46.32593298621841
Task_36269,2547,604,171,119,290,4.209917355371901,50.04862887220713
Task_36270,1829,942,96,46,142,1.9395546129374337,38.025063793106106
Task_36271,2214,747,120,196,316,2.9598930481283423,45.45585167629355
Task_36272,687,614,18,31,49,1.1170731707317074,17.97637428631438
Task_36273,2607,625,111,194,305,4.164536741214057,51.243242198451505
Task_36274,2769,586,133,11,144,4.7172061328790456,51.65188589082618
Task_36275,2161,715,48,67,115,3.0181564245810057,42.95270421269256
Task_36276,1746,738,27,105,132,2.3626522327469552,36.8503659120146
Task_36277,876,969,167,195,362,0.9030927835051547,25.084253858196387
Task_36278,2976,911,19,53,72,3.263157894736842,55.40045844423937
Task_36279,836,1001,11,102,113,0.8343313373253493,22.98291702666832
Task_36280,2472,495,121,131,252,4.983870967741935,48.35783539521731
Task_36281,2540,384,165,193,358,6.597402597402597,49.63836123136775
Task_36282,1458,539,45,96,141,2.7,31.640499827981245
Task_36283,1722,205,168,126,294,8.359223300970873,35.69770434381117
Task_36284,2101,773,191,99,290,2.714470284237726,43.47301014173721
Task_36285,842,403,49,161,210,2.0841584158415842,22.279706393404997
Task_36286,2843,544,22,75,97,5.21651376146789,52.832630456691426
Task_36287,1946,1000,100,32,132,1.944055944055944,40.05244697480102
Task_36288,503,880,11,182,193,0.5709421112372304,18.235058386595956
Task_36289,1082,523,33,157,190,2.064885496183206,26.23583149752118
Task_36290,672,821,107,184,291,0.8175182481751825,21.05828227956022
Task_36291,1206,216,147,83,230,5.557603686635945,26.94561062424891
Task_36292,674,870,53,187,240,0.7738231917336394,21.10537679293618
Task_36293,2852,485,166,131,297,5.868312757201646,54.54382738999584
Task_36294,2890,473,66,105,171,6.09704641350211,54.42450846033581
Task_36295,2776,769,84,200,284,3.605194805194805,54.337184856898
Task_36296,2985,333,53,89,142,8.937125748502995,55.120014269416714
Task_36297,2232,136,49,154,203,16.291970802919707,42.874472177793855
Task_36298,2684,523,95,172,267,5.122137404580153,52.00251951304105
Task_36299,1357,937,166,18,184,1.4466950959488274,30.486450855934535
Task_36300,2524,159,27,98,125,15.775,46.539397715678355
Task_36301,1839,1002,25,57,82,1.8334995014955136,37.98637485331241
Task_36302,1727,820,68,144,212,2.1035322777101095,37.54592689748696
Task_36303,1335,79,157,30,187,16.6875,27.09543732259135
Task_36304,2140,907,74,96,170,2.356828193832599,43.96289054767155
Task_36305,2851,208,68,55,123,13.641148325358852,52.01848398325999
Task_36306,1480,794,149,60,209,1.8616352201257862,32.76891465763317
Task_36307,2709,312,58,86,144,8.654952076677317,50.624037676163255
Task_36308,2507,1015,75,102,177,2.46751968503937,50.125646168558376
Task_36309,1975,148,180,124,304,13.25503355704698,39.20116883814705
Task_36310,2050,770,112,19,131,2.6588845654993514,40.73830988309852
Task_36311,744,491,106,79,185,1.5121951219512195,20.12992046078279
Task_36312,1838,960,108,129,237,1.9125910509885535,39.708732450592656
Task_36313,2477,982,55,195,250,2.5198372329603256,50.21716105194606
Task_36314,1852,638,117,157,274,2.8982785602503913,39.132809109818716
Task_36315,1623,156,57,51,108,10.337579617834395,31.677962136030697
Task_36316,1598,530,114,134,248,3.0094161958568737,34.61886892238391
Task_36317,2208,680,118,41,159,3.2422907488986783,43.226561282048955
Task_36318,2494,737,136,110,246,3.3794037940379402,49.41850663567268
Task_36319,2617,803,158,176,334,3.2549751243781095,52.067936479027914
Task_36320,762,975,156,183,339,0.7807377049180327,23.190861813199998
Task_36321,2767,186,45,105,150,14.796791443850267,51.25130151970212
Task_36322,2159,195,108,175,283,11.01530612244898,42.5202676600589
Task_36323,1597,323,19,160,179,4.929012345679013,33.46563137888683
Task_36324,2551,352,142,112,254,7.2266288951841355,49.117058251850345
Task_36325,2721,543,43,20,63,5.001838235294118,49.647079273919395
Task_36326,1933,884,155,35,190,2.184180790960452,39.946875643301844
Task_36327,1901,290,118,157,275,6.5326460481099655,38.7871196699562
Task_36328,1155,977,106,31,137,1.1809815950920246,27.453846902112502
Task_36329,1558,114,154,101,255,13.547826086956523,32.01438909243719
Task_36330,792,756,100,88,188,1.046235138705416,21.817945827109583
Task_36331,2317,695,28,150,178,3.329022988505747,46.09741647926708
Task_36332,2360,814,148,153,301,2.895705521472393,47.848241440328174
Task_36333,2241,430,188,135,323,5.199535962877031,44.81610159826901
Task_36334,1245,963,43,35,78,1.29149377593361,27.886718512231734
Task_36335,769,778,40,82,122,0.9871630295250321,21.09750782186289
Task_36336,629,747,148,97,245,0.8409090909090909,19.831434093269444
Task_36337,1573,466,186,13,199,3.3683083511777303,32.819989539265286
Task_36338,1334,886,133,173,306,1.503945885005637,31.825513595537625
Task_36339,1458,199,95,62,157,7.29,30.095665899467264
Task_36340,1528,928,30,111,141,1.6447793326157158,33.95915372473615
Task_36341,1243,791,167,98,265,1.5694444444444444,29.797363542245836
Task_36342,2481,348,93,105,198,7.108882521489972,47.84551668906983
Task_36343,1479,496,100,199,299,2.975855130784708,32.952306489756644
Task_36344,2042,988,152,90,242,2.0647118301314458,42.82902178251768
Task_36345,1238,884,20,158,178,1.3988700564971752,29.444877809482616
Task_36346,1396,1013,171,43,214,1.3767258382642997,31.938525535338815
Task_36347,1751,326,127,141,268,5.3547400611620795,36.48196119664066
Task_36348,2684,176,132,121,253,15.163841807909604,50.15991232000787
Task_36349,1023,79,39,10,49,12.7875,20.585577544939408
Task_36350,506,349,127,87,214,1.4457142857142857,16.224080324098342
Task_36351,743,977,199,26,225,0.7597137014314929,21.567510121411683
Task_36352,1441,286,110,166,276,5.020905923344948,31.51944451335063
Task_36353,2645,415,90,18,108,6.358173076923077,48.76950999235049
Task_36354,2664,456,168,47,215,5.829321663019694,50.282947167360184
Task_36355,800,612,184,38,222,1.3050570962479608,21.340809577441675
Task_36356,973,569,175,39,214,1.707017543859649,23.821668537177526
Task_36357,1168,585,143,139,282,1.993174061433447,28.14359571513744
Task_36358,2061,693,140,71,211,2.9697406340057637,41.77032851442994
Task_36359,621,814,200,153,353,0.7619631901840491,20.477608136827598
Task_36360,1570,821,174,198,372,1.9099756690997567,35.73966640430894
Task_36361,1628,634,114,66,180,2.563779527559055,34.36044113427278
Task_36362,2122,248,94,76,170,8.522088353413654,41.06598422925136
Task_36363,1144,866,75,91,166,1.3194925028835063,27.847775610221486
Task_36364,1311,732,174,58,232,1.7885402455661665,30.011316290498684
Task_36365,2872,424,131,108,239,6.75764705882353,54.36435368653988
Task_36366,2285,463,122,83,205,4.924568965517241,44.71846418219602
Task_36367,898,700,178,188,366,1.2810271041369472,24.58389233028397
Task_36368,946,850,191,190,381,1.1116333725029377,25.81290159299884
Task_36369,2479,941,83,97,180,2.6316348195329087,49.41740503233974
Task_36370,1975,530,139,55,194,3.71939736346516,39.80288126055286
Task_36371,588,899,86,106,192,0.6533333333333333,19.606917631795408
Task_36372,2408,555,127,197,324,4.330935251798561,47.95868226140593
Task_36373,663,238,86,87,173,2.774058577405858,18.19870119558433
Task_36374,1157,315,136,106,242,3.661392405063291,26.883815513350836
Task_36375,2970,833,33,87,120,3.5611510791366907,56.289591240751015
Task_36376,999,1009,193,141,334,0.9891089108910891,26.94298009057714
Task_36377,2295,406,38,31,69,5.638820638820639,42.67378940738727
Task_36378,762,587,110,63,173,1.2959183673469388,20.52255349384132
Task_36379,2774,344,176,47,223,8.040579710144927,51.68464482500672
Task_36380,2648,435,118,18,136,6.073394495412844,49.10132395797743
Task_36381,2501,553,101,173,274,4.514440433212997,49.164345112241016
Task_36382,2404,125,33,41,74,19.07936507936508,43.154546463176416
Task_36383,2737,681,60,108,168,4.013196480938417,52.67626835856853
Task_36384,1287,331,119,34,153,3.8765060240963853,27.512008428251765
Task_36385,2440,640,139,110,249,3.8065522620904835,48.270395824481646
Task_36386,653,669,66,171,237,0.9746268656716418,20.077893624932145
Task_36387,513,881,33,115,148,0.5816326530612245,17.803372078839157
Task_36388,2756,788,107,156,263,3.4930291508238276,53.87366256753859
Task_36389,734,77,87,46,133,9.41025641025641,16.904894670220884
Task_36390,2320,746,159,156,315,3.105756358768407,47.06879054640839
Task_36391,2501,296,68,181,249,8.42087542087542,48.33372146883743
Task_36392,2761,630,47,101,148,4.375594294770206,52.58296835445065
Task_36393,2147,544,187,23,210,3.9394495412844037,42.300297034537685
Task_36394,949,844,73,123,196,1.123076923076923,25.017393236194852
Task_36395,1874,804,78,96,174,2.327950310559006,39.56394942744718
Task_36396,2801,943,199,197,396,2.9671610169491527,55.73200077152018
Task_36397,1467,491,193,25,218,2.981707317073171,31.398437465240843
Task_36398,1059,660,147,24,171,1.6021180030257187,25.06474213907939
Task_36399,1859,471,152,79,231,3.9385593220338984,38.11290290578634
Task_36400,1611,757,105,146,251,2.12532981530343,35.56823988270745
Task_36401,1749,941,123,76,199,1.856687898089172,37.629001987329076
Task_36402,2768,784,165,24,189,3.5261146496815288,52.76410869468082
Task_36403,1516,920,170,22,192,1.6460369163952226,33.380775955843916
Task_36404,1003,185,18,117,135,5.39247311827957,23.020319238621557
Task_36405,2284,679,92,103,195,3.3588235294117648,45.74666750183815
Task_36406,1351,796,187,77,264,1.6951066499372647,31.160724961695056
Task_36407,2610,644,126,103,229,4.046511627906977,50.87518817199528
Task_36408,1177,519,109,87,196,2.2634615384615384,27.361083647992682
Task_36409,532,390,97,138,235,1.360613810741688,17.222980804192115
Task_36410,2416,749,14,19,33,3.2213333333333334,45.228304146791395
Task_36411,2288,281,195,155,350,8.113475177304965,45.208542395096885
Task_36412,1869,475,164,69,233,3.926470588235294,38.100951304638336
Task_36413,851,91,32,138,170,9.25,20.13739253565511
Task_36414,2156,726,50,11,61,2.9656121045392023,41.297241123363456
Task_36415,2665,886,64,17,81,3.004509582863585,50.23822432257371
Task_36416,1919,866,122,29,151,2.2133794694348325,39.23462821314902
Task_36417,1731,462,17,179,196,3.73866090712743,36.27738613193387
Task_36418,959,559,111,127,238,1.7125,24.523406204376187
Task_36419,2066,461,39,17,56,4.471861471861472,38.99614016848279
Task_36420,1125,313,120,180,300,3.582802547770701,26.741179652568956
Task_36421,1919,692,45,36,81,2.769119769119769,38.091408352955064
Task_36422,2272,347,110,192,302,6.528735632183908,45.020566715810126
Task_36423,1453,618,189,33,222,2.347334410339257,31.663945857681554
Task_36424,1952,496,31,128,159,3.9275653923541247,39.425729715390986
Task_36425,2127,588,122,59,181,3.6112054329371817,42.05332275065557
Task_36426,2494,896,161,77,238,2.7803790412486067,49.47387699281335
Task_36427,862,953,105,120,225,0.9035639412997903,24.085550169745602
Task_36428,2485,537,74,164,238,4.618959107806692,48.816059005044906
Task_36429,2676,746,136,107,243,3.5823293172690764,52.312096227113216
Task_36430,1370,903,68,190,258,1.5154867256637168,32.38379070200775
Task_36431,1837,825,195,188,383,2.223970944309927,40.017303374041944
Task_36432,666,752,193,15,208,0.8844621513944223,19.465017768251766
Task_36433,1308,348,46,123,169,3.7478510028653296,28.921238194678498
Task_36434,1078,131,156,107,263,8.166666666666666,24.688263012195943
Task_36435,678,398,19,11,30,1.699248120300752,16.65114341123535
Task_36436,1230,356,146,19,165,3.4453781512605044,26.73314893999452
Task_36437,1504,943,60,104,164,1.5932203389830508,33.99690127133011
Task_36438,993,231,31,182,213,4.280172413793103,24.030167614883453
Task_36439,1032,708,51,132,183,1.4555712270803949,25.823384776607657
Task_36440,2886,96,150,188,338,29.75257731958763,53.03257424419732
Task_36441,533,137,199,101,300,3.86231884057971,16.354208990202284
Task_36442,1388,588,97,92,189,2.3565365025466893,31.045774445763538
Task_36443,605,344,148,143,291,1.7536231884057971,18.508448066609898
Task_36444,2101,723,15,175,190,2.9019337016574585,43.02285738437117
Task_36445,2596,998,111,73,184,2.5985985985985987,50.91592348293071
Task_36446,2972,96,154,14,168,30.63917525773196,52.480492517667734
Task_36447,531,545,122,27,149,0.9725274725274725,16.30581494973347
Task_36448,1117,720,148,131,279,1.5492371705963939,27.68879842839904
Task_36449,1240,624,42,186,228,1.984,29.244957048936456
Task_36450,556,127,66,198,264,4.34375,16.703915603964305
Task_36451,2195,692,119,89,208,3.167388167388167,44.15092990938322
Task_36452,1499,242,66,183,249,6.1687242798353905,32.31196834993885
Task_36453,1466,142,21,20,41,10.251748251748252,28.26050699619952
Task_36454,2788,820,85,100,185,3.3958587088915957,53.96087648359495
Task_36455,2528,709,140,111,251,3.5605633802816903,49.892877712055736
Task_36456,853,998,151,89,240,0.8538538538538538,23.90669560342687
Task_36457,666,374,89,13,102,1.776,17.279359719094064
Task_36458,1178,695,37,68,105,1.6925287356321839,26.981673344779978
Task_36459,2572,885,69,68,137,2.9029345372460496,50.05230033809263
Task_36460,1531,446,129,109,238,3.4250559284116333,33.20946457616113
Task_36461,1324,896,34,109,143,1.47603121516165,30.596404893839104
Task_36462,2897,894,17,142,159,3.2368715083798882,55.569515907578705
Task_36463,2849,911,87,19,106,3.12390350877193,53.482669813340834
Task_36464,1447,771,164,187,351,1.8743523316062176,33.52456132971244
Task_36465,2119,221,29,119,148,9.545045045045045,41.077781330991655
Task_36466,553,605,191,100,291,0.9125412541254125,18.37888514413208
Task_36467,2806,198,143,42,185,14.100502512562814,51.38546170779997
Task_36468,833,342,19,52,71,2.4285714285714284,19.667147729017994
Task_36469,2850,143,139,140,279,19.791666666666668,52.870185855828
Task_36470,964,596,42,42,84,1.6147403685092128,22.723132497331193
Task_36471,2891,244,30,54,84,11.8,52.24564973103645
Task_36472,2543,634,196,159,355,4.004724409448819,50.432266732913284
Task_36473,2357,511,113,134,247,4.603515625,46.570674404789855
Task_36474,1075,939,167,26,193,1.1436170212765957,26.54730791533143
Task_36475,1531,297,139,74,213,5.1375838926174495,32.20336497361496
Task_36476,2244,446,135,103,238,5.02013422818792,44.485712031329435
Task_36477,2319,511,196,81,277,4.529296875,45.703433535918826
Task_36478,566,182,137,100,237,3.092896174863388,16.914203103279988
Task_36479,552,340,130,146,276,1.6187683284457477,17.59433432661587
Task_36480,1094,824,37,138,175,1.3260606060606062,27.095854654125876
Task_36481,1111,352,150,85,235,3.1473087818696883,25.93890113756561
Task_36482,1837,110,132,95,227,16.54954954954955,36.07719001290109
Task_36483,1328,607,73,57,130,2.1842105263157894,29.321166649035366
Task_36484,2274,402,94,198,292,5.642679900744417,45.28290635586362
Task_36485,629,879,22,165,187,0.7147727272727272,20.046748386404328
Task_36486,1823,478,98,172,270,3.805845511482255,38.18430262431636
Task_36487,2682,244,66,10,76,10.946938775510205,48.154231664342085
Task_36488,1423,942,42,124,166,1.5090137857900319,32.550044156605445
Task_36489,2730,680,81,12,93,4.008810572687224,50.9330365997971
Task_36490,1427,587,111,196,307,2.42687074829932,32.44760912704076
Task_36491,2849,749,19,103,122,3.7986666666666666,54.211621000414375
Task_36492,2399,860,38,76,114,2.786295005807201,47.21595409365648
Task_36493,706,529,51,175,226,1.3320754716981131,20.56421958653446
Task_36494,1966,132,51,171,222,14.781954887218046,38.7066920435738
Task_36495,1518,597,77,19,96,2.5384615384615383,31.43619435407898
Task_36496,866,976,183,158,341,0.8863868986693961,24.790874684685175
Task_36497,2456,669,194,14,208,3.665671641791045,47.46675970625561
Task_36498,1909,565,198,133,331,3.372791519434629,40.02673072995977
Task_36499,1718,378,127,125,252,4.532981530343008,36.03578303239862
Task_36500,2168,439,17,55,72,4.927272727272728,41.150893835243956
Task_36501,760,249,128,191,319,3.04,20.864745360551566
Task_36502,859,285,148,119,267,3.0034965034965033,22.206537993426394
Task_36503,2647,345,112,67,179,7.6502890173410405,49.56842876876592
Task_36504,975,76,109,195,304,12.662337662337663,22.8265799597271
Task_36505,2322,698,187,69,256,3.3218884120171674,46.08579022581407
Task_36506,1495,199,77,77,154,7.475,30.868305157196684
Task_36507,650,64,23,116,139,10.0,16.431735495710363
Task_36508,1636,835,142,113,255,1.9569377990430623,36.176997871453466
Task_36509,965,637,72,90,162,1.5125391849529781,24.157670297115956
Task_36510,1457,74,155,130,285,19.426666666666666,30.214977397544754
Task_36511,1952,879,184,158,342,2.2181818181818183,41.77892005193641
Task_36512,1787,303,153,16,169,5.878289473684211,35.315330872414464
Task_36513,1696,96,98,190,288,17.484536082474225,34.12633149987161
Task_36514,905,796,81,25,106,1.1355081555834379,22.612763244726924
Task_36515,1863,733,172,100,272,2.5381471389645776,39.51256554285754
Task_36516,590,349,191,112,303,1.6857142857142857,18.29559479138936
Task_36517,978,347,57,23,80,2.810344827586207,21.928954508849387
Task_36518,2697,794,136,149,285,3.392452830188679,53.04668930948278
Task_36519,1568,774,191,86,277,2.023225806451613,34.70517852403451
Task_36520,1665,230,88,12,100,7.207792207792208,32.62424548433878
Task_36521,2437,422,58,198,256,5.761229314420804,47.83668251335592
Task_36522,938,208,128,151,279,4.488038277511961,23.300508726683162
Task_36523,2210,483,136,117,253,4.566115702479339,44.15544571103418
Task_36524,2120,1004,118,58,176,2.109452736318408,43.24711601455447
Task_36525,860,564,184,36,220,1.5221238938053097,22.09475852566017
Task_36526,2350,835,167,103,270,2.811004784688995,47.54251740253124
Task_36527,2354,325,101,160,261,7.220858895705521,46.0110588467719
Task_36528,2703,247,92,80,172,10.899193548387096,50.43424783927997
Task_36529,1187,918,92,108,200,1.2916213275299238,29.042542550806058
Task_36530,1207,234,97,130,227,5.136170212765958,27.395885084184314
Task_36531,1090,204,176,189,365,5.317073170731708,26.129607471034188
Task_36532,2990,878,165,173,338,3.401592718998862,58.22673019677336
Task_36533,2867,493,87,166,253,5.803643724696356,54.66890980706049
Task_36534,2291,926,91,41,132,2.471413160733549,45.28737139454904
Task_36535,2844,730,121,11,132,3.8905608755129957,53.291205920764355
Task_36536,1682,601,76,15,91,2.7940199335548175,34.042494329828266
Task_36537,1284,884,188,44,232,1.4508474576271186,29.838143268486434
Task_36538,2589,882,87,138,225,2.9320498301245754,51.33337166599668
Task_36539,1105,750,62,189,251,1.4713715046604527,27.67194740776407
Task_36540,828,612,131,145,276,1.3507340946166395,22.784711909397302
Task_36541,1618,634,198,156,354,2.548031496062992,35.773232578903624
Task_36542,1230,803,79,10,89,1.5298507462686568,27.483726952548878
Task_36543,2227,516,15,74,89,4.307543520309478,42.99180259528038
Task_36544,1630,992,113,126,239,1.6414904330312186,36.50314827479729
Task_36545,1826,571,188,94,282,3.1923076923076925,38.39784900564269
Task_36546,848,728,137,32,169,1.1632373113854595,22.013323489787183
Task_36547,1456,437,140,189,329,3.324200913242009,32.5210806189562
Task_36548,629,531,117,117,234,1.1823308270676691,19.10964444581562
Task_36549,2656,545,105,196,301,4.864468864468864,51.7483667742761
Task_36550,2373,735,164,47,211,3.224184782608696,46.547914819914276
Task_36551,2319,614,114,22,136,3.770731707317073,44.67448557498364
Task_36552,1401,487,130,40,170,2.8709016393442623,29.989147012787445
Task_36553,1332,139,109,74,183,9.514285714285714,27.78049180255404
Task_36554,1460,983,109,194,303,1.483739837398374,34.14012075176324
Task_36555,1615,950,10,153,163,1.698212407991588,35.67668106237778
Task_36556,586,933,84,74,158,0.6274089935760171,19.04500868701173
Task_36557,1860,590,45,199,244,3.1472081218274113,39.034683712892
Task_36558,1027,828,89,161,250,1.238841978287093,26.456171095056828
Task_36559,1039,532,175,173,348,1.949343339587242,26.28229716213441
Task_36560,864,652,49,176,225,1.3231240428790199,23.410782645712626
Task_36561,1057,285,180,187,367,3.695804195804196,25.88685459590523
Task_36562,631,243,38,62,100,2.5860655737704916,16.73433579825377
Task_36563,2749,132,197,110,307,20.669172932330827,51.20389312969788
Task_36564,2226,902,166,58,224,2.4651162790697674,45.00186770491732
Task_36565,775,477,142,145,287,1.6213389121338913,21.601138291524276
Task_36566,2151,221,11,108,119,9.68918918918919,41.4031635302222
Task_36567,2391,982,126,113,239,2.4323499491353,48.52588145197047
Task_36568,1626,713,121,190,311,2.277310924369748,36.00339305610629
Task_36569,2928,988,23,58,81,2.9605662285136503,55.25958476606348
Task_36570,2497,582,111,111,222,4.283018867924528,48.868472048222294
Task_36571,1874,548,51,52,103,3.413479052823315,37.37632155904729
Task_36572,2367,871,20,91,111,2.7144495412844036,46.769380524464204
Task_36573,2781,174,35,25,60,15.891428571428571,49.48491926980594
Task_36574,2837,360,184,76,260,7.858725761772853,53.28130305573387
Task_36575,2941,66,52,155,207,43.8955223880597,53.171547106056416
Task_36576,834,432,110,28,138,1.926096997690531,20.57467827181947
Task_36577,2104,1015,88,160,248,2.0708661417322833,44.20952732156098
Task_36578,2523,205,150,136,286,12.24757281553398,48.32116705715134
Task_36579,1289,282,76,111,187,4.554770318021202,28.72247891780965
Task_36580,1889,400,33,96,129,4.71072319201995,38.13919936246932
Task_36581,2669,991,178,172,350,2.690524193548387,53.546118626813644
Task_36582,2247,533,41,80,121,4.207865168539326,43.850598088455115
Task_36583,2322,782,132,39,171,2.9655172413793105,45.46778470980271
Task_36584,554,881,21,36,57,0.6281179138321995,17.08203360026931
Task_36585,1674,666,175,75,250,2.5097451274362816,35.808856521835786
Task_36586,2090,446,79,57,136,4.675615212527965,40.88718146129313
Task_36587,760,423,157,57,214,1.7924528301886793,20.249972876687718
Task_36588,1324,561,72,121,193,2.3558718861209966,30.238132607571874
Task_36589,2081,913,198,168,366,2.2768052516411377,44.0516880007394
Task_36590,1483,517,106,171,277,2.862934362934363,32.94191894350268
Task_36591,2714,170,98,150,248,15.871345029239766,50.698462098440125
Task_36592,2694,699,135,103,238,3.8485714285714288,52.42048996531222
Task_36593,1971,105,170,177,347,18.59433962264151,38.814710648029255
Task_36594,1777,443,108,38,146,4.002252252252252,35.70331422261585
Task_36595,2437,1023,156,70,226,2.3798828125,48.81632083128968
Task_36596,764,676,123,58,181,1.1285081240768096,20.654482565763917
Task_36597,842,400,77,99,176,2.0997506234413965,21.82093897107551
Task_36598,902,674,21,119,140,1.3362962962962963,23.144280227282593
Task_36599,2346,136,64,184,248,17.124087591240876,44.872228456037796
Task_36600,2012,667,16,53,69,3.0119760479041915,39.41996202925964
Task_36601,2034,457,139,16,155,4.441048034934497,39.589015529651675
Task_36602,832,871,39,68,107,0.9541284403669725,22.0872057629288
Task_36603,1055,617,95,199,294,1.7071197411003236,26.652765979277095
Task_36604,1581,633,175,96,271,2.493690851735016,34.74564780036115
Task_36605,1652,477,93,125,218,3.4560669456066946,35.26898063969336
Task_36606,2360,298,132,143,275,7.892976588628763,46.050795239438
Task_36607,2997,251,181,173,354,11.892857142857142,56.347894688176915
Task_36608,2182,717,134,111,245,3.0389972144846795,44.410131392103445
Task_36609,679,639,85,36,121,1.0609375,18.59393896573209
Task_36610,2832,318,112,176,288,8.877742946708464,53.69099423963443
Task_36611,1870,495,53,74,127,3.7701612903225805,37.87000743517965
Task_36612,2464,163,19,96,115,15.024390243902438,45.367914527122
Task_36613,673,72,39,45,84,9.219178082191782,15.523207114431484
Task_36614,1418,228,195,145,340,6.192139737991266,31.21545344912926
Task_36615,1497,256,82,51,133,5.824902723735408,30.852750996697825
Task_36616,2430,564,21,150,171,4.300884955752212,47.363183960973366
Task_36617,2214,640,108,91,199,3.453978159126365,44.29163013777353
Task_36618,2535,666,119,174,293,3.800599700149925,50.14954262126482
Task_36619,1344,256,46,69,115,5.229571984435798,28.465779807265644
Task_36620,2277,69,114,55,169,32.52857142857143,41.80701633614704
Task_36621,1496,585,196,85,281,2.5529010238907848,32.9793282181668
Task_36622,1978,583,183,132,315,3.386986301369863,41.10281736455703
Task_36623,2741,558,14,139,153,4.903398926654741,52.08339021718476
Task_36624,2227,563,18,102,120,3.948581560283688,43.70656112988988
Task_36625,1768,122,36,176,212,14.373983739837398,35.3676238978172
Task_36626,1430,367,148,198,346,3.885869565217391,31.97433819359891
Task_36627,608,737,178,159,337,0.8238482384823849,19.939253395428743
Task_36628,2226,525,14,76,90,4.231939163498099,42.980431549914194
Task_36629,2467,322,72,29,101,7.637770897832818,45.80505083420073
Task_36630,855,727,130,102,232,1.1744505494505495,23.26653739779042
Task_36631,1697,161,129,92,221,10.475308641975309,34.32862535146568
Task_36632,1570,215,42,97,139,7.268518518518518,32.35063625903567
Task_36633,2769,417,28,92,120,6.624401913875598,51.85749057096206
Task_36634,1974,771,20,98,118,2.55699481865285,40.338986088445644
Task_36635,1653,241,117,117,234,6.830578512396694,34.45433941092483
Task_36636,2350,782,95,97,192,3.001277139208174,47.11991600931511
Task_36637,2417,103,24,48,72,23.240384615384617,43.25466379252367
Task_36638,2306,913,105,81,186,2.5229759299781183,46.20463556632783
Task_36639,1924,697,41,114,155,2.7564469914040113,39.558514872097305
Task_36640,1795,628,105,33,138,2.853736089030207,36.44562763756711
Task_36641,1529,132,163,189,352,11.496240601503759,32.314358688904946
Task_36642,512,467,14,15,29,1.0940170940170941,14.405253856602974
Task_36643,1293,227,111,24,135,5.671052631578948,27.176065308654
Task_36644,2327,977,53,74,127,2.3793456032719837,46.62355106923866
Task_36645,2256,283,193,11,204,7.943661971830986,43.049909278642794
Task_36646,2481,456,48,29,77,5.428884026258205,45.831532160140746
Task_36647,592,952,194,68,262,0.621196222455404,19.80960669850226
Task_36648,2000,523,118,60,178,3.816793893129771,39.82221085402411
Task_36649,1477,782,109,142,251,1.8863346104725416,33.51741350990108
Task_36650,1408,220,28,96,124,6.3710407239819,29.816525117090748
Task_36651,2865,734,47,170,217,3.8979591836734695,55.293828771007405
Task_36652,1587,908,188,148,336,1.7458745874587458,36.03050441078764
Task_36653,2446,412,65,136,201,5.9225181598062955,47.5781588869253
Task_36654,1332,255,35,32,67,5.203125,26.963679481096985
Task_36655,2509,593,159,151,310,4.223905723905724,49.54884360214911
Task_36656,991,621,125,89,214,1.5932475884244373,24.876269369247563
Task_36657,2009,1003,34,199,233,2.000996015936255,42.664566985256236
Task_36658,2345,390,32,129,161,5.997442455242966,45.33287356828873
Task_36659,703,870,139,128,267,0.8071182548794489,21.510628285213972
Task_36660,1256,273,44,142,186,4.583941605839416,27.994615079442607
Task_36661,1361,547,109,134,243,2.4835766423357666,30.89741803368545
Task_36662,1958,605,62,141,203,3.231023102310231,40.4920661427403
Task_36663,641,629,103,100,203,1.0174603174603174,19.38555407393351
Task_36664,2328,884,149,68,217,2.630508474576271,46.616234942380096
Task_36665,1963,425,97,162,259,4.607981220657277,40.174999719328035
Task_36666,835,639,192,152,344,1.3046875,23.269817670922205
Task_36667,2351,733,132,122,254,3.2029972752043596,47.194253221112696
Task_36668,2903,955,80,124,204,3.036610878661088,56.54073857408772
Task_36669,2022,782,30,102,132,2.582375478927203,41.35595299709712
Task_36670,2385,697,23,49,72,3.4169054441260744,45.2309196571106
Task_36671,657,533,39,78,117,1.2303370786516854,18.504292062578024
Task_36672,2418,267,27,50,77,9.022388059701493,44.22893782763262
Task_36673,2744,716,66,168,234,3.8270571827057185,53.46614935208326
Task_36674,1908,920,110,174,284,2.0716612377850163,40.9714022516687
Task_36675,1037,239,145,52,197,4.320833333333334,24.041969147233768
Task_36676,1614,611,107,157,264,2.6372549019607843,35.23347163498105
Task_36677,2203,716,43,182,225,3.0725244072524407,44.76722352034659
Task_36678,2298,139,63,165,228,16.414285714285715,43.99301884447198
Task_36679,1952,477,12,121,133,4.083682008368201,39.2828079888979
Task_36680,1679,846,15,174,189,1.9822904368358913,36.700031465044525
Task_36681,1049,863,27,135,162,1.2141203703703705,26.13440408292928
Task_36682,2001,745,138,192,330,2.6823056300268098,42.13253614001514
Task_36683,889,173,146,85,231,5.109195402298851,21.5231158423929
Task_36684,881,654,97,196,293,1.3450381679389314,23.91767997431162
Task_36685,2927,719,42,106,148,4.065277777777778,55.467250574369814
Task_36686,2209,874,104,187,291,2.5245714285714285,45.64810205333282
Task_36687,2693,228,174,34,208,11.759825327510917,49.92453591311792
Task_36688,1274,1013,164,18,182,1.2564102564102564,29.38546916299708
Task_36689,1256,133,78,54,132,9.373134328358208,26.182186419314064
Task_36690,1529,382,79,46,125,3.9921671018276763,31.403864782567396
Task_36691,2430,626,111,44,155,3.875598086124402,46.54125242208111
Task_36692,1798,890,197,62,259,2.0179573512906845,38.365551473020645
Task_36693,2840,891,17,157,174,3.1838565022421523,55.00419286339629
Task_36694,2561,548,168,92,260,4.664845173041894,49.81582022682315
Task_36695,1366,653,139,153,292,2.08868501529052,31.55764357199499
Task_36696,2912,465,154,180,334,6.24892703862661,55.66668294930571
Task_36697,2396,241,63,60,123,9.900826446280991,44.8165899392626
Task_36698,1157,66,91,33,124,17.26865671641791,23.522219187165607
Task_36699,798,645,93,190,283,1.2352941176470589,22.530833549128346
Task_36700,1578,378,19,65,84,4.163588390501319,32.04068320863332
Task_36701,957,489,190,165,355,1.953061224489796,24.869069938276397
Task_36702,2785,433,189,126,315,6.417050691244239,53.38625717779399
Task_36703,2315,753,131,89,220,3.070291777188329,46.29767756477519
Task_36704,1706,130,143,121,264,13.022900763358779,34.595578960305666
Task_36705,2300,950,14,194,208,2.4185068349106205,47.00560753925703
Task_36706,1760,704,175,160,335,2.49645390070922,38.162067979320206
Task_36707,1737,879,111,43,154,1.9738636363636364,36.34156262205507
Task_36708,1400,908,23,175,198,1.54015401540154,32.55548891738379
Task_36709,2793,377,62,163,225,7.388888888888889,53.102223661501455
Task_36710,2791,578,32,138,170,4.820379965457685,53.1716292525708
Task_36711,2801,412,168,90,258,6.782082324455206,53.095256452393095
Task_36712,2111,973,66,116,182,2.1673511293634498,43.74860575787907
Task_36713,1348,999,157,11,168,1.348,30.58136336396582
Task_36714,570,464,92,57,149,1.2258064516129032,16.86305261606243
Task_36715,2844,807,184,30,214,3.51980198019802,54.262208806130296
Task_36716,1044,99,110,135,245,10.44,23.722543445979095
Task_36717,2368,400,24,90,114,5.905236907730673,45.38634363272892
Task_36718,1898,431,127,22,149,4.393518518518518,37.46222419089381
Task_36719,1553,914,13,178,191,1.6972677595628416,34.95734118215982
Task_36720,1914,560,46,101,147,3.411764705882353,38.95014416306359
Task_36721,852,705,81,152,233,1.206798866855524,23.318707224817945
Task_36722,1022,920,61,49,110,1.1096634093376765,24.75933020132672
Task_36723,2550,888,138,102,240,2.8683914510686166,50.740488407996644
Task_36724,2881,574,37,181,218,5.010434782608695,55.02830470267671
Task_36725,2592,904,143,89,232,2.8640883977900553,51.21338732149269
Task_36726,2716,900,60,42,102,3.014428412874584,51.36456421228281
Task_36727,1330,817,53,47,100,1.625916870415648,29.25970198541655
Task_36728,1804,148,64,141,205,12.10738255033557,36.17548679734164
Task_36729,1070,382,125,157,282,2.793733681462141,25.978512758488524
Task_36730,1281,749,104,152,256,1.708,30.33339674996815
Task_36731,1884,373,116,67,183,5.037433155080214,37.61369829123841
Task_36732,2628,361,191,58,249,7.259668508287293,49.75208123956094
Task_36733,1537,766,39,52,91,2.0039113428943938,32.635162189432485
Task_36734,2460,82,66,65,131,29.63855421686747,44.624643810021546
Task_36735,2987,758,141,76,217,3.935441370223979,56.7527079243363
Task_36736,2999,562,135,47,182,5.326820603907637,55.60345430864044
Task_36737,1354,747,17,174,191,1.8101604278074865,31.174118064904622
Task_36738,1479,699,173,18,191,2.112857142857143,31.928417808142033
Task_36739,1472,124,154,73,227,11.776,30.26970169481005
Task_36740,1981,128,30,53,83,15.356589147286822,36.9997749476319
Task_36741,2078,711,96,52,148,2.918539325842697,41.60410115389174
Task_36742,1705,847,185,35,220,2.01061320754717,36.365593215337135
Task_36743,1029,562,130,111,241,1.8277087033747779,25.644705683367892
Task_36744,2946,853,82,36,118,3.449648711943794,55.18290155587483
Task_36745,2410,595,28,41,69,4.043624161073826,45.12550390009978
Task_36746,2116,473,156,176,332,4.4641350210970465,43.07774270091613
Task_36747,1281,257,183,186,369,4.965116279069767,29.34156693026449
Task_36748,506,776,55,120,175,0.6512226512226512,17.809680123167464
Task_36749,2414,781,154,22,176,3.0869565217391304,46.937614033310915
Task_36750,585,974,113,32,145,0.6,18.86273232570471
Task_36751,702,216,152,96,248,3.2350230414746544,19.404480724870172
Task_36752,1573,647,12,59,71,2.427469135802469,32.27105014175625
Task_36753,705,518,135,48,183,1.3583815028901733,19.178916948262675
Task_36754,1179,602,34,61,95,1.955223880597015,26.4503906721486
Task_36755,649,387,27,190,217,1.672680412371134,19.116261859732898
Task_36756,1891,663,152,73,225,2.8478915662650603,39.078289564554645
Task_36757,2471,256,148,132,280,9.614785992217898,47.66169607904993
Task_36758,2447,544,52,25,77,4.489908256880734,45.487698411811756
Task_36759,1551,735,173,48,221,2.1073369565217392,33.58133643676218
Task_36760,640,668,62,67,129,0.9566517189835575,18.856547939379592
Task_36761,2505,466,145,130,275,5.364025695931478,48.8883305780549
Task_36762,2437,442,158,38,196,5.501128668171558,46.59208994803299
Task_36763,1033,879,14,186,200,1.1738636363636363,26.559565137763713
Task_36764,1981,120,200,82,282,16.371900826446282,38.70950422393647
Task_36765,1185,223,106,153,259,5.290178571428571,27.164906104226716
Task_36766,2408,212,189,163,352,11.305164319248826,46.87035974426065
Task_36767,2510,127,136,26,162,19.609375,45.73180757121793
Task_36768,1108,404,82,99,181,2.7358024691358023,26.002085470328485
Task_36769,2513,266,128,123,251,9.411985018726591,48.21798184194304
Task_36770,2434,407,92,23,115,5.965686274509804,45.7055833186565
Task_36771,1539,529,46,19,65,2.9037735849056605,30.841920305385983
Task_36772,1160,310,50,145,195,3.729903536977492,26.949764748346016
Task_36773,2161,592,39,105,144,3.6441821247892072,42.93387119557426
Task_36774,908,130,177,18,195,6.931297709923665,20.847431051662472
Task_36775,972,512,43,75,118,1.894736842105263,23.53392117606388
Task_36776,1120,399,67,91,158,2.8,25.881329284837907
Task_36777,2170,66,73,101,174,32.38805970149254,40.82500281651142
Task_36778,1163,610,51,97,148,1.9034369885433715,27.420517622678645
Task_36779,2183,353,138,82,220,6.166666666666667,42.8187973700418
Task_36780,1018,996,155,66,221,1.0210631895687061,26.124974492761982
Task_36781,2711,69,197,108,305,38.72857142857143,49.833992202255814
Task_36782,2153,533,57,109,166,4.031835205992509,42.993746317232244
Task_36783,896,691,183,40,223,1.2947976878612717,23.0700498557064
Task_36784,2031,397,174,72,246,5.103015075376884,40.5295518284294
Task_36785,2571,746,44,160,204,3.4417670682730925,50.56427500011544
Task_36786,1452,303,52,106,158,4.776315789473684,30.978035344122258
Task_36787,2433,138,80,160,240,17.503597122302157,46.17907864666182
Task_36788,2865,127,106,46,152,22.3828125,51.148503485995384
Task_36789,1274,725,22,103,125,1.7548209366391185,29.234696447945357
Task_36790,2531,201,47,18,65,12.529702970297029,45.42071818742485
Task_36791,2377,182,76,94,170,12.989071038251366,45.07111298791174
Task_36792,2482,630,191,67,258,3.9334389857369256,48.44046044933557
Task_36793,2001,197,71,50,121,10.106060606060606,38.31033899361373
Task_36794,2018,410,169,93,262,4.909975669099757,40.81991878147199
Task_36795,2470,831,95,58,153,2.96875,48.07295765911127
Task_36796,534,394,114,144,258,1.3518987341772153,17.368000930490958
Task_36797,709,529,134,103,237,1.3377358490566038,20.404642344978225
Task_36798,1456,433,90,59,149,3.3548387096774195,30.775109268766823
Task_36799,2750,551,141,159,300,4.981884057971015,53.1973260093171
Task_36800,589,718,155,125,280,0.8191933240611962,19.272757426177993
Task_36801,618,137,161,146,307,4.478260869565218,17.790361799173485
Task_36802,1727,246,100,136,236,6.991902834008097,35.67788795302837
Task_36803,2237,1015,56,146,202,2.201771653543307,46.22842457705039
Task_36804,2525,524,125,186,311,4.809523809523809,49.63703626801661
Task_36805,2474,74,36,124,160,32.986666666666665,45.206296464445614
Task_36806,2166,425,197,56,253,5.084507042253521,42.755640042131525
Task_36807,1690,442,86,28,114,3.81489841986456,34.007369705033234
Task_36808,1650,858,192,58,250,1.9208381839348079,35.85534494015149
Task_36809,2250,686,79,61,140,3.2751091703056767,44.16815653872069
Task_36810,2545,245,25,73,98,10.345528455284553,47.13684579612987
Task_36811,722,791,42,49,91,0.9116161616161617,19.611029894487228
Task_36812,940,635,99,70,169,1.4779874213836477,23.422847161462087
Task_36813,1680,898,137,83,220,1.8687430478309233,36.575019112734
Task_36814,2442,626,197,56,253,3.8947368421052633,47.770659724753074
Task_36815,2812,73,59,133,192,38.0,51.056758889476704
Task_36816,1448,189,184,47,231,7.621052631578947,30.318847088186242
Task_36817,824,502,103,75,178,1.6381709741550696,21.313580958338605
Task_36818,1168,706,60,131,191,1.652050919377652,28.213785031818134
Task_36819,2995,631,94,69,163,4.738924050632911,56.03625138499507
Task_36820,2264,775,30,50,80,2.917525773195876,43.80380852450802
Task_36821,519,230,168,124,292,2.2467532467532467,16.77596732127155
Task_36822,2786,381,197,142,339,7.293193717277487,53.360026901766524
Task_36823,1772,493,140,45,185,3.5870445344129553,35.96996446869171
Task_36824,2611,768,112,44,156,3.3953185955786735,49.86119461121416
Task_36825,1436,487,168,172,340,2.942622950819672,32.38826208010606
Task_36826,1864,298,138,32,170,6.234113712374582,36.70254604787207
Task_36827,2512,608,119,12,131,4.124794745484401,47.6478177806493
Task_36828,2430,489,61,10,71,4.959183673469388,44.83964698247047
Task_36829,2589,656,192,53,245,3.9406392694063928,50.17203222651114
Task_36830,2034,448,199,111,310,4.5300668151447665,41.50463259931659
Task_36831,889,455,38,16,54,1.9495614035087718,20.434946618410798
Task_36832,1538,713,81,24,105,2.15406162464986,32.233388800836615
Task_36833,1029,670,26,128,154,1.533532041728763,25.26022145295997
Task_36834,2985,293,35,28,63,10.153061224489797,53.23676354950007
Task_36835,1156,732,180,188,368,1.5770804911323328,28.828598517966725
Task_36836,1228,219,171,133,304,5.581818181818182,28.00361187258437
Task_36837,569,508,61,180,241,1.117878192534381,18.243657256089236
Task_36838,2916,445,189,49,238,6.538116591928251,54.41526838874059
Task_36839,2750,179,131,72,203,15.277777777777779,50.674618138423
Task_36840,892,418,137,112,249,2.1288782816229115,23.061424114250652
Task_36841,1223,543,177,57,234,2.2481617647058822,28.046454860916906
Task_36842,2181,345,90,43,133,6.303468208092486,41.703993791380206
Task_36843,2051,957,67,111,178,2.140918580375783,42.7228476901378
Task_36844,1017,589,109,128,237,1.723728813559322,25.532492039773615
Task_36845,2300,891,148,150,298,2.57847533632287,47.12035922982
Task_36846,2542,542,67,197,264,4.681399631675875,49.89058853407053
Task_36847,2826,790,32,185,217,3.572692793931732,54.863755980574105
Task_36848,2663,889,86,18,104,2.992134831460674,50.44587492830009
Task_36849,749,376,75,42,117,1.986737400530504,18.96761848881815
Task_36850,2814,205,184,120,304,13.660194174757281,52.9726655194082
Task_36851,2608,823,59,57,116,3.1650485436893203,50.01013631159926
Task_36852,2252,521,19,32,51,4.314176245210728,42.42141061590004
Task_36853,2734,903,98,107,205,3.024336283185841,53.56640917986457
Task_36854,2846,573,194,62,256,4.958188153310105,53.95501061150185
Task_36855,1101,572,112,53,165,1.9214659685863875,25.93258428818145
Task_36856,1789,301,37,159,196,5.923841059602649,36.72077760775425
Task_36857,2537,649,53,88,141,3.903076923076923,49.00919546297761
Task_36858,1544,245,130,21,151,6.276422764227642,31.193075591979834
Task_36859,2845,292,13,121,134,9.709897610921502,52.80311421421706
Task_36860,834,134,156,74,230,6.177777777777778,20.307192193294412
Task_36861,1753,948,85,18,103,1.8472075869336144,36.18162055212597
Task_36862,963,576,107,69,176,1.6689774696707105,23.640754628527997
Task_36863,2700,454,22,78,100,5.934065934065934,50.38629137337168
Task_36864,2855,130,55,186,241,21.793893129770993,52.78028325329311
Task_36865,2908,801,147,49,196,3.625935162094763,55.23977472451785
Task_36866,2121,443,58,108,166,4.777027027027027,42.192019247155365
Task_36867,1444,769,90,126,216,1.8753246753246753,32.822193097044924
Task_36868,2272,334,135,138,273,6.782089552238806,44.76673368205726
Task_36869,2890,444,32,48,80,6.49438202247191,52.62113600035491
Task_36870,2061,783,135,10,145,2.628826530612245,41.134782969001854
Task_36871,2504,750,33,92,125,3.33422103861518,48.84377230844718
Task_36872,2342,762,55,30,85,3.0694626474442988,44.95327112308564
Task_36873,2920,371,93,123,216,7.849462365591398,54.97586196860278
Task_36874,2860,898,139,62,201,3.181312569521691,54.956692743521366
Task_36875,2085,642,141,186,327,3.2426127527216173,43.11710099066522
Task_36876,2664,512,10,186,196,5.192982456140351,51.282713418805194
Task_36877,2897,409,122,72,194,7.065853658536585,54.03637989981056
Task_36878,2076,411,113,78,191,5.038834951456311,41.16461202531006
Task_36879,1298,471,194,52,246,2.75,29.141231620229515
Task_36880,1467,419,154,134,288,3.492857142857143,32.37214374268067
Task_36881,1825,682,161,165,326,2.67203513909224,39.08949008681391
Task_36882,2816,494,71,53,124,5.688888888888889,52.44790503469692
Task_36883,2498,499,192,47,239,4.996,47.90326048561744
Task_36884,1490,574,29,34,63,2.591304347826087,30.49700191918588
Task_36885,2225,930,89,62,151,2.3899033297529537,44.50898181067626
Task_36886,2946,292,116,192,308,10.054607508532424,55.51445550783584
Task_36887,905,696,60,35,95,1.2984218077474892,22.088391216204318
Task_36888,2062,382,38,162,200,5.383812010443864,41.32377457431839
Task_36889,2666,907,182,52,234,2.936123348017621,52.12537787393567
Task_36890,1640,923,72,186,258,1.774891774891775,36.7480393642342
Task_36891,1306,582,40,140,180,2.240137221269297,29.69196149183742
Task_36892,1230,321,141,14,155,3.8198757763975157,26.423935938809223
Task_36893,1363,627,187,34,221,2.1703821656050954,30.263720118237515
Task_36894,2738,294,74,26,100,9.28135593220339,49.989402643765224
Task_36895,824,267,85,195,280,3.074626865671642,21.812181540929746
Task_36896,537,783,72,24,96,0.6849489795918368,17.159386131529175
Task_36897,2484,345,147,57,204,7.179190751445087,47.22762603466425
Task_36898,642,861,183,47,230,0.7447795823665894,19.605869734461525
Task_36899,2603,225,48,114,162,11.517699115044248,48.91559836706918
Task_36900,1289,875,121,52,173,1.471461187214612,29.839798670238213
Task_36901,556,553,192,158,350,1.0036101083032491,18.540453721543276
Task_36902,735,530,189,187,376,1.384180790960452,21.541109728302377
Task_36903,1376,186,155,12,167,7.358288770053476,28.697608157919735
Task_36904,2409,166,193,79,272,14.425149700598803,45.67586326434218
Task_36905,2181,466,142,54,196,4.670235546038544,42.83634653773646
Task_36906,2523,683,159,134,293,3.68859649122807,49.95459922275675
Task_36907,780,309,84,150,234,2.5161290322580645,20.978890566020198
Task_36908,1242,728,71,53,124,1.7037037037037037,28.252331085709475
Task_36909,2910,271,66,84,150,10.698529411764707,53.57041150543103
Task_36910,2475,292,92,178,270,8.447098976109215,47.95412400639585
Task_36911,857,341,99,47,146,2.5058479532163744,20.768921901555938
Task_36912,2383,363,198,38,236,6.5467032967032965,45.65636155752235
Task_36913,994,777,85,193,278,1.2776349614395888,25.98805013671687
Task_36914,2317,678,24,189,213,3.4123711340206184,46.43877985493338
Task_36915,628,338,85,71,156,1.8525073746312684,17.483590809856015
Task_36916,898,990,54,38,92,0.9061553985872856,23.08049842117555
Task_36917,873,66,178,118,296,13.029850746268657,21.14740156424944
Task_36918,2204,991,141,196,337,2.221774193548387,46.153899465395966
Task_36919,1687,493,113,158,271,3.41497975708502,36.04932329867975
Task_36920,2523,568,118,86,204,4.434094903339192,48.85361284781387
Task_36921,599,119,142,107,249,4.991666666666666,17.03144510143687
Task_36922,2021,108,75,10,85,18.541284403669724,37.17209274255237
Task_36923,2669,937,92,119,211,2.845415778251599,52.750947484209355
Task_36924,2182,835,32,70,102,2.610047846889952,43.30670500541627
Task_36925,1090,736,197,151,348,1.4789687924016282,27.65112242674547
Task_36926,2798,729,151,90,241,3.8328767123287673,53.99239434271677
Task_36927,568,651,16,59,75,0.8711656441717791,16.47215478610607
Task_36928,958,234,136,23,159,4.076595744680851,21.977831861005125
Task_36929,1356,647,131,41,172,2.0925925925925926,29.908365789502586
Task_36930,1408,806,181,95,276,1.744733581164808,32.501140028950395
Task_36931,1251,750,113,74,187,1.6657789613848202,29.04577047861316
Task_36932,2816,531,23,75,98,5.293233082706767,52.45262873151216
Task_36933,2651,64,132,13,145,40.784615384615385,46.7385858347962
Task_36934,607,144,189,12,201,4.186206896551724,16.393856479388983
Task_36935,2647,841,75,14,89,3.143705463182898,50.048708863656096
Task_36936,1194,475,139,137,276,2.508403361344538,28.179643862685193
Task_36937,660,161,60,62,122,4.074074074074074,16.82578086880942
Task_36938,2541,403,162,194,356,6.28960396039604,49.709955158085165
Task_36939,2917,525,123,97,220,5.5456273764258555,55.33972634857142
Task_36940,1845,556,66,179,245,3.312387791741472,38.78725356345799
Task_36941,1190,375,16,29,45,3.1648936170212765,25.050538034639946
Task_36942,2763,204,152,11,163,13.478048780487805,50.428795202241076
Task_36943,2175,746,89,50,139,2.9116465863453813,42.89727664695829
Task_36944,1954,723,14,30,44,2.6988950276243093,38.23708846347552
Task_36945,948,357,170,142,312,2.64804469273743,24.08188603369203
Task_36946,2969,679,35,146,181,4.366176470588235,56.36996195804213
Task_36947,2483,325,188,19,207,7.616564417177914,46.71524335362522
Task_36948,1958,927,192,169,361,2.1099137931034484,42.125181272986964
Task_36949,1403,660,155,60,215,2.122541603630862,31.15830765542664
Task_36950,1895,703,172,48,220,2.6917613636363638,38.92600766784043
Task_36951,2190,454,120,23,143,4.813186813186813,42.13848865983183
Task_36952,2604,451,105,177,282,5.761061946902655,50.50680907023135
Task_36953,2317,967,180,66,246,2.393595041322314,46.80643189813075
Task_36954,2631,563,144,64,208,4.664893617021277,50.34243283845105
Task_36955,1913,926,43,57,100,2.063646170442287,39.09136792794325
Task_36956,1129,233,163,10,173,4.8247863247863245,24.841769197103073
Task_36957,2904,471,185,105,290,6.1525423728813555,55.25149758357336
Task_36958,815,482,10,145,155,1.6873706004140787,21.349057956094942
Task_36959,667,210,116,142,258,3.161137440758294,18.920898282664847
Task_36960,1649,861,197,77,274,1.9129930394431554,36.13810523776684
Task_36961,2267,752,135,108,243,3.01062416998672,45.85314209996171
Task_36962,1925,418,98,48,146,4.594272076372315,37.93796614101636
Task_36963,1932,102,135,107,242,18.75728155339806,37.62107405022896
Task_36964,1087,552,32,196,228,1.9656419529837252,26.63744671524027
Task_36965,1991,616,30,80,110,3.226904376012966,39.941310870657894
Task_36966,2139,529,53,71,124,4.035849056603774,42.10040794079052
Task_36967,715,595,17,72,89,1.1996644295302012,19.195481525253722
Task_36968,782,149,116,173,289,5.213333333333333,20.41079297464253
Task_36969,2602,882,118,19,137,2.9467723669309174,49.83103194148544
Task_36970,997,382,87,110,197,2.6031331592689293,24.38005706981261
Task_36971,1379,850,151,149,300,1.6204465334900118,32.393858940637784
Task_36972,2578,809,159,138,297,3.1827160493827162,51.246413036599755
Task_36973,1768,192,52,84,136,9.160621761658032,35.38737170538761
Task_36974,2838,113,39,72,111,24.894736842105264,50.666270523165046
Task_36975,2252,421,20,147,167,5.3364928909952605,44.068998667907245
Task_36976,2016,750,152,101,253,2.684420772303595,41.90538069110648
Task_36977,920,475,188,129,317,1.9327731092436975,24.01536984243792
Task_36978,2703,952,58,68,126,2.8363064008394545,52.38599056338481
Task_36979,1843,987,102,42,144,1.8653846153846154,38.352169914666526
Task_36980,2473,550,189,136,325,4.488203266787659,48.88699643599157
Task_36981,672,938,95,180,275,0.7156549520766773,21.521056779257492
Task_36982,1242,223,73,193,266,5.544642857142857,28.282243544911452
Task_36983,2677,446,106,127,233,5.988814317673378,51.35168722763755
Task_36984,2855,560,26,15,41,5.089126559714795,51.68269571264407
Task_36985,1761,195,109,53,162,8.98469387755102,34.91688576180436
Task_36986,1764,469,99,133,232,3.753191489361702,36.98088767052462
Task_36987,2524,449,45,62,107,5.608888888888889,47.37278979242648
Task_36988,2667,162,180,48,228,16.36196319018405,49.11239987685948
Task_36989,1846,503,149,62,211,3.6626984126984126,37.694536883645064
Task_36990,1482,629,145,118,263,2.3523809523809525,33.13775159903827
Task_36991,1579,160,155,83,238,9.807453416149068,32.454886487419124
Task_36992,2072,446,159,32,191,4.635346756152125,40.77748825714042
Task_36993,2375,674,140,134,274,3.5185185185185186,47.49627355693152
Task_36994,2619,555,169,73,242,4.710431654676259,50.34153625103395
Task_36995,2866,220,52,111,163,12.968325791855204,53.20256761465029
Task_36996,807,520,181,192,373,1.5489443378119,22.66934101714249
Task_36997,916,508,122,50,172,1.799607072691552,22.572508995103764
Task_36998,2878,938,161,17,178,3.0649627263045796,54.60861463282698
Task_36999,1910,931,168,124,292,2.0493562231759657,41.0000703546053
Task_37000,1009,495,38,198,236,2.034274193548387,25.235563062032114
Task_37001,609,288,105,199,304,2.1072664359861593,18.548215313914746
Task_37002,972,806,108,113,221,1.204460966542751,25.331515646998767
Task_37003,2940,382,61,99,160,7.676240208877284,54.72008669631924
Task_37004,2841,571,187,86,273,4.966783216783217,54.20980139840242
Task_37005,2144,645,39,164,203,3.318885448916409,43.482325251365985
Task_37006,1745,186,118,47,165,9.331550802139038,34.776355527036294
Task_37007,2693,981,82,41,123,2.7423625254582484,51.651949042036506
Task_37008,2983,540,188,31,219,5.513863216266174,55.62846468099797
Task_37009,2446,145,58,115,173,16.753424657534246,45.98905238731112
Task_37010,1514,921,24,122,146,1.6420824295010845,33.7702742603542
Task_37011,1575,96,67,29,96,16.237113402061855,29.94123849257458
Task_37012,2367,321,16,78,94,7.350931677018633,44.60893931477048
Task_37013,2950,246,72,116,188,11.94331983805668,54.84411765114822
Task_37014,688,259,37,71,108,2.646153846153846,18.00232051262253
Task_37015,722,897,61,191,252,0.8040089086859689,21.992347042029166
Task_37016,725,200,67,185,252,3.6069651741293534,19.961373942953994
Task_37017,1648,744,97,37,134,2.212080536912752,34.53779902551881
Task_37018,1852,191,174,121,295,9.645833333333334,37.6835597600052
Task_37019,2254,553,102,27,129,4.068592057761733,43.476519994307374
Task_37020,1815,694,77,95,172,2.6115107913669067,38.22116625648258
Task_37021,1814,687,194,89,283,2.636627906976744,38.43822308235796
Task_37022,2782,702,67,78,145,3.957325746799431,53.04167083048731
Task_37023,1255,547,149,180,329,2.29014598540146,29.67404871595906
Task_37024,1915,698,160,106,266,2.739628040057225,40.20837029565434
Task_37025,1544,870,194,152,346,1.772675086107922,35.28205103043476
Task_37026,2628,471,87,84,171,5.567796610169491,49.81682125291369
Task_37027,1751,132,92,165,257,13.165413533834586,35.4234073764657
Task_37028,2935,735,199,160,359,3.9877717391304346,56.98085332936616
Task_37029,2068,686,18,30,48,3.01018922852984,39.908466416163314
Task_37030,734,557,92,109,201,1.3154121863799284,20.791539872951564
Task_37031,2737,429,108,100,208,6.365116279069768,52.09299056202129
Task_37032,2754,474,152,154,306,5.797894736842105,53.030833903121696
Task_37033,1441,76,16,138,154,18.714285714285715,28.84714885782253
Task_37034,1320,755,61,57,118,1.746031746031746,29.337755982037915
Task_37035,1532,543,14,136,150,2.8161764705882355,32.883037916546684
Task_37036,1604,283,22,162,184,5.647887323943662,33.46475232050923
Task_37037,1562,702,193,185,378,2.2219061166429586,35.24986216035889
Task_37038,977,773,169,79,248,1.2622739018087856,25.114330903984666
Task_37039,2999,532,137,95,232,5.626641651031895,56.650138341144526
Task_37040,2132,426,146,193,339,4.992974238875878,43.23514508731679
Task_37041,2665,513,28,44,72,5.184824902723736,48.88360246518143
Task_37042,2246,191,10,27,37,11.697916666666666,41.11907877524031
Task_37043,1902,637,77,117,194,2.981191222570533,39.62827390648626
Task_37044,1956,452,150,42,192,4.317880794701987,38.95378523848927
Task_37045,692,560,28,41,69,1.2335115864527628,17.80826297552345
Task_37046,2689,674,105,154,259,3.9837037037037035,52.43157189416083
Task_37047,1976,93,168,120,288,21.02127659574468,38.446657454789815
Task_37048,1341,758,174,39,213,1.766798418972332,30.23497737159724
Task_37049,1727,441,124,166,290,3.9072398190045248,36.61352268959237
Task_37050,2744,122,112,197,309,22.308943089430894,51.20376001363385
Task_37051,1418,131,142,155,297,10.742424242424242,30.264654820274426
Task_37052,2317,1004,86,158,244,2.3054726368159204,47.55223859483277
Task_37053,1345,458,177,95,272,2.9302832244008714,30.408266522132124
Task_37054,1773,277,12,19,31,6.377697841726619,33.563172250857455
Task_37055,935,472,147,12,159,1.9767441860465116,22.300368570374047
Task_37056,1861,677,197,139,336,2.7448377581120944,39.65098378301204
Task_37057,629,921,93,106,199,0.6822125813449024,20.46175811122809
Task_37058,569,588,68,175,243,0.966044142614601,18.528924561577067
Task_37059,1540,615,71,10,81,2.5,31.783944785618147
Task_37060,2964,812,197,36,233,3.6457564575645756,56.258133641106205
Task_37061,1672,541,73,171,244,3.084870848708487,35.98854625886473
Task_37062,2276,413,196,18,214,5.497584541062802,43.74184486447578
Task_37063,691,173,173,94,267,3.971264367816092,18.68723618204599
Task_37064,1211,367,129,73,202,3.2907608695652173,27.27064078861869
Task_37065,1787,334,140,81,221,5.334328358208955,36.45501635343671
Task_37066,2452,162,69,120,189,15.042944785276074,46.346518891339805
Task_37067,1545,823,120,172,292,1.875,34.951119944470655
Task_37068,697,817,177,157,334,0.8520782396088019,21.58859706067732
Task_37069,1794,865,40,111,151,2.071593533487298,37.98249942093713
Task_37070,2735,579,137,168,305,4.7155172413793105,53.085418808986084
Task_37071,1333,884,123,82,205,1.5062146892655368,30.93561895133264
Task_37072,1879,430,169,13,182,4.359628770301624,37.28691403333722
Task_37073,2586,330,36,137,173,7.812688821752266,49.207900021195314
Task_37074,1363,458,122,88,210,2.969498910675381,30.179662073474613
Task_37075,1197,406,141,60,201,2.941031941031941,27.033430767472407
Task_37076,2732,304,94,105,199,8.957377049180328,51.63898938372483
Task_37077,2839,997,48,53,101,2.844689378757515,54.10487263670157
Task_37078,2481,307,106,149,255,8.055194805194805,47.91396959198111
Task_37079,960,372,73,153,226,2.5737265415549597,24.075038498991763
Task_37080,790,181,148,175,323,4.34065934065934,20.748942563653223
Task_37081,2067,77,130,148,278,26.5,39.74207769548861
Task_37082,2483,996,168,14,182,2.490471414242728,48.61790037475735
Task_37083,1170,634,39,96,135,1.8425196850393701,27.384515579317878
Task_37084,2409,693,141,115,256,3.4711815561959654,47.98580707806343
Task_37085,1896,597,92,175,267,3.17056856187291,39.77274379244992
Task_37086,2874,508,139,145,284,5.6463654223968565,54.92896852489694
Task_37087,914,775,160,141,301,1.1778350515463918,24.718166123230116
Task_37088,1877,724,134,200,334,2.5889655172413795,40.132193326260236
Task_37089,2244,876,134,97,231,2.5587229190421894,45.84016295016446
Task_37090,2832,548,50,93,143,5.158469945355192,53.56071291340472
Task_37091,1214,733,91,166,257,1.6539509536784742,29.29652476611228
Task_37092,1704,571,62,192,254,2.979020979020979,36.666946128371315
Task_37093,2817,800,135,110,245,3.5168539325842696,54.729263236832765
Task_37094,986,158,139,116,255,6.20125786163522,23.446121055549526
Task_37095,2519,133,41,23,64,18.79850746268657,44.94262040290562
Task_37096,1684,482,67,47,114,3.4865424430641823,34.06967865014182
Task_37097,1545,836,115,92,207,1.8458781362007168,34.39047725408104
Task_37098,2112,222,101,135,236,9.47085201793722,41.670749024236486
Task_37099,1090,766,177,11,188,1.4211212516297262,25.987033917512235
Task_37100,582,204,130,169,299,2.8390243902439023,17.78355055826844
Task_37101,2924,76,150,14,164,37.97402597402598,51.53266085726633
Task_37102,718,438,10,119,129,1.6355353075170842,19.633492965248852
Task_37103,2821,575,124,59,183,4.897569444444445,53.01086699274372
Task_37104,557,142,200,67,267,3.895104895104895,16.178565190330957
Task_37105,2880,772,109,131,240,3.725743855109961,55.64746541144475
Task_37106,2249,955,10,17,27,2.352510460251046,43.213649868475876
Task_37107,1753,887,16,55,71,1.9740990990990992,36.05206600359072
Task_37108,644,770,169,28,197,0.8352788586251622,19.206901808681124
Task_37109,575,656,11,27,38,0.8751902587519026,16.198966047381038
Task_37110,1371,111,28,37,65,12.241071428571429,26.638773631860108
Task_37111,1846,294,94,18,112,6.257627118644068,35.829566933760475
Task_37112,1904,864,49,156,205,2.2011560693641616,40.51203848544615
Task_37113,1345,745,11,136,147,1.8029490616621984,30.543992637965474
Task_37114,593,932,74,133,207,0.6355841371918542,19.940231228301606
Task_37115,1781,635,12,33,45,2.800314465408805,35.19883945817788
Task_37116,602,574,150,12,162,1.0469565217391303,17.35015679500495
Task_37117,1120,948,38,37,75,1.1801896733403583,25.868648838695194
Task_37118,1139,531,93,105,198,2.1409774436090228,27.198698054794367
Task_37119,1332,416,73,36,109,3.194244604316547,28.233589881851813
Task_37120,1994,155,62,131,193,12.782051282051283,39.1360376219439
Task_37121,1558,516,142,58,200,3.013539651837524,33.10161421955741
Task_37122,1850,598,82,134,216,3.0884808013355594,38.772363815713724
Task_37123,1575,736,149,10,159,2.1370420624151967,33.251415172668125
Task_37124,1065,348,134,15,149,3.0515759312320916,23.902998126910962
Task_37125,1236,711,152,126,278,1.7359550561797752,29.563307491924018
Task_37126,561,773,120,168,288,0.7248062015503876,19.215227150169834
Task_37127,2504,718,139,191,330,3.4826147426981917,50.01440749295489
Task_37128,2853,976,78,164,242,2.9201637666325486,56.04734514372809
Task_37129,2111,569,118,17,135,3.7035087719298247,41.053968847924956
Task_37130,1174,551,127,134,261,2.1268115942028984,28.030125655584765
Task_37131,2797,514,197,98,295,5.4310679611650485,53.71334969498381
Task_37132,1144,619,120,88,208,1.8451612903225807,27.209547788038368
Task_37133,1627,432,137,62,199,3.7575057736720554,33.94665647567063
Task_37134,910,363,146,68,214,2.5,22.509056600665133
Task_37135,2817,536,15,116,131,5.245810055865922,53.191324295823385
Task_37136,715,1003,17,181,198,0.7121513944223108,21.878961769696577
Task_37137,2153,1017,18,136,154,2.1149312377210214,44.137918710860085
Task_37138,965,945,88,141,229,1.0200845665961944,25.641967711164686
Task_37139,570,376,95,72,167,1.5119363395225465,16.881659342906215
Task_37140,1881,634,30,95,125,2.9622047244094487,38.62660706541768
Task_37141,628,817,181,195,376,0.7677261613691931,20.76388895406681
Task_37142,2519,627,188,61,249,4.011146496815287,48.8796520945724
Task_37143,1725,579,175,188,363,2.9741379310344827,37.382163871109576
Task_37144,2538,616,167,73,240,4.113452188006483,49.244638179067316
Task_37145,2618,812,78,12,90,3.220172201722017,49.55269850250088
Task_37146,1358,169,24,78,102,7.988235294117647,27.84525779120621
Task_37147,925,167,89,152,241,5.505952380952381,22.535757571261883
Task_37148,1472,999,54,198,252,1.472,34.30817495221827
Task_37149,1160,1020,178,199,377,1.1361410381978452,29.802104159783266
Task_37150,546,124,175,62,237,4.368,15.74032125018618
Task_37151,2952,168,150,28,178,17.467455621301774,53.23552578205845
Task_37152,580,339,167,55,222,1.7058823529411764,17.234801719820876
Task_37153,2065,168,135,29,164,12.218934911242604,39.351462397207634
Task_37154,1895,868,12,56,68,2.180667433831991,38.15342267274381
Task_37155,1020,785,27,158,185,1.297709923664122,25.76420245426438
Task_37156,2332,333,181,77,258,6.982035928143713,45.196626955730075
Task_37157,1091,882,83,187,270,1.2355605889014722,27.780656370836862
Task_37158,692,178,104,119,223,3.8659217877094973,18.627807018347287
Task_37159,750,76,31,179,210,9.74025974025974,18.9181400609129
Task_37160,2564,506,13,26,39,5.057199211045365,47.131957994041564
Task_37161,2150,150,113,34,147,14.23841059602649,40.22208196917369
Task_37162,1905,716,37,152,189,2.6569037656903767,39.81992460478774
Task_37163,2082,340,145,182,327,6.105571847507331,42.08979215375772
Task_37164,2468,507,62,48,110,4.858267716535433,46.343669284690804
Task_37165,1950,791,55,11,66,2.462121212121212,38.18157384349637
Task_37166,2353,437,105,151,256,5.372146118721461,46.333023367833185
Task_37167,2687,1011,170,104,274,2.6551383399209487,53.451496165208596
Task_37168,2371,783,127,44,171,3.024234693877551,46.26741280661176
Task_37169,2734,983,18,43,61,2.7784552845528454,51.48982156701706
Task_37170,2053,933,176,32,208,2.1980728051391862,42.08882560044143
Task_37171,2636,879,114,44,158,2.9954545454545456,50.614446845719634
Task_37172,1148,985,32,135,167,1.1643002028397567,28.23772239085012
Task_37173,1037,311,40,190,230,3.323717948717949,25.054769623622903
Task_37174,1710,525,182,149,331,3.2509505703422055,36.77239441285411
Task_37175,1409,698,92,80,172,2.015736766809728,31.434707073200084
Task_37176,1349,221,192,140,332,6.076576576576577,30.057827591382786
Task_37177,1610,145,165,134,299,11.027397260273972,33.438876310687675
Task_37178,2099,790,102,10,112,2.6536030341340076,41.44231240385921
Task_37179,1962,466,142,76,218,4.2012847965738755,39.59566123205695
Task_37180,1428,136,180,196,376,10.423357664233576,30.92681152261196
Task_37181,1913,582,90,53,143,3.281303602058319,38.55543488641948
Task_37182,2270,968,31,200,231,2.3426212590299276,46.691541544031224
Task_37183,2944,333,50,101,151,8.81437125748503,54.642924718654704
Task_37184,2640,148,194,89,283,17.71812080536913,49.398450256041
Task_37185,1368,504,12,51,63,2.708910891089109,28.606676470819167
Task_37186,2342,195,172,51,223,11.948979591836734,44.52575088235292
Task_37187,1324,755,140,107,247,1.7513227513227514,30.926737428922007
Task_37188,1956,134,56,77,133,14.488888888888889,37.39396174952123
Task_37189,750,679,89,98,187,1.1029411764705883,21.145300125549152
Task_37190,2835,371,12,79,91,7.620967741935484,52.14754269382326
Task_37191,1466,343,67,196,263,4.261627906976744,32.21087043983554
Task_37192,1109,326,168,191,359,3.3914373088685017,26.812410709468878
Task_37193,889,235,39,72,111,3.766949152542373,21.174355591802406
Task_37194,1254,277,119,112,231,4.510791366906475,28.251482201093424
Task_37195,2938,179,46,24,70,16.322222222222223,52.009276965280634
Task_37196,610,347,153,195,348,1.7528735632183907,18.930129554097125
Task_37197,1090,677,55,100,155,1.607669616519174,26.392734579865092
Task_37198,2928,319,171,79,250,9.15,54.60632304301345
Task_37199,595,604,130,60,190,0.9834710743801653,18.1160913807881
Task_37200,1320,517,176,195,371,2.548262548262548,30.820087259433645
Task_37201,1449,588,180,75,255,2.460101867572156,32.023165891176504
Task_37202,1799,519,164,92,256,3.4596153846153848,37.640147708285944
Task_37203,1710,114,134,86,220,14.869565217391305,34.05202926269086
Task_37204,2455,75,52,166,218,32.30263157894737,45.68078490025578
Task_37205,1947,763,162,52,214,2.548429319371728,40.19314491289053
Task_37206,647,228,76,137,213,2.8253275109170306,18.59233832082438
Task_37207,1196,224,109,31,140,5.315555555555555,25.68227670433838
Task_37208,1084,545,74,147,221,1.9853479853479854,26.55684311548239
Task_37209,2488,340,44,193,237,7.296187683284457,48.13546062238381
Task_37210,1465,881,102,166,268,1.6609977324263039,33.73345147495564
Task_37211,2211,408,11,10,21,5.405867970660147,40.9114848169394
Task_37212,2007,523,183,99,282,3.8301526717557253,41.1594287274277
Task_37213,1823,265,195,169,364,6.853383458646617,37.886607441743735
Task_37214,2972,815,149,83,232,3.642156862745098,56.840623134970976
Task_37215,663,330,79,198,277,2.003021148036254,19.543171697339208
Task_37216,574,371,57,83,140,1.543010752688172,16.971655819888195
Task_37217,1967,93,174,91,265,20.925531914893618,38.05529230263675
Task_37218,964,1006,170,138,308,0.9572989076464746,26.266842172638963
Task_37219,918,991,19,49,68,0.9254032258064516,22.91433065820389
Task_37220,2322,411,175,103,278,5.635922330097087,45.78595545549771
Task_37221,1075,904,31,62,93,1.1878453038674033,25.887660928258168
Task_37222,1001,898,181,151,332,1.1134593993325919,26.554929814856816
Task_37223,1234,877,20,72,92,1.4054669703872438,28.285428151731722
Task_37224,2010,855,21,167,188,2.3481308411214954,41.88535979529265
Task_37225,1386,92,167,185,352,14.903225806451612,29.620614484524197
Task_37226,1633,157,104,137,241,10.335443037974683,33.60974866668722
Task_37227,1208,331,77,181,258,3.63855421686747,28.05034718086459
Task_37228,898,434,48,81,129,2.064367816091954,22.39186940273969
Task_37229,2684,296,84,184,268,9.037037037037036,51.242040384929474
Task_37230,2640,618,73,20,93,4.264943457189014,49.30911776630097
Task_37231,2287,565,179,23,202,4.040636042402827,44.54801958856992
Task_37232,2399,266,131,43,174,8.985018726591761,45.18673041805702
Task_37233,2914,514,12,30,42,5.658252427184466,52.7123512105567
Task_37234,1528,997,155,24,179,1.531062124248497,33.587528346105266
Task_37235,1096,923,122,116,238,1.1861471861471862,27.73963129459257
Task_37236,2389,91,15,115,130,25.967391304347824,43.73450007726985
Task_37237,1378,996,181,183,364,1.382146439317954,33.11410793031242
Task_37238,2722,230,94,125,219,11.783549783549784,51.327742043739505
Task_37239,1655,815,60,137,197,2.028186274509804,36.317519296181224
Task_37240,1852,861,155,32,187,2.148491879350348,38.544647635975586
Task_37241,1152,299,127,66,193,3.84,26.008298646419252
Task_37242,2707,660,188,43,231,4.095310136157337,51.687163166962456
Task_37243,1237,361,143,50,193,3.4171270718232045,27.358449366658586
Task_37244,641,457,156,107,263,1.3995633187772927,19.198689885277634
Task_37245,1158,239,21,109,130,4.825,25.880799573267826
Task_37246,576,681,56,128,184,0.844574780058651,18.414977593534825
Task_37247,934,733,143,180,323,1.2724795640326976,25.051044958115156
Task_37248,2474,494,177,101,278,4.997979797979798,48.45947014751181
Task_37249,2029,222,191,188,379,9.09865470852018,41.08220216219465
Task_37250,2206,79,72,33,105,27.575,39.709199552217534
Task_37251,680,880,136,40,176,0.771850170261067,19.90888868166019
Task_37252,2544,356,34,158,192,7.126050420168068,48.83576144246243
Task_37253,1192,180,197,105,302,6.585635359116022,26.86706216811571
Task_37254,2539,813,39,121,160,3.119164619164619,49.695206292440695
Task_37255,2309,621,145,123,268,3.712218649517685,46.24011560639875
Task_37256,2788,113,187,62,249,24.45614035087719,50.83802235089479
Task_37257,1320,598,94,118,212,2.2036727879799667,30.3289149686328
Task_37258,1702,545,173,75,248,3.1172161172161172,35.86230820522487
Task_37259,2877,462,86,84,170,6.213822894168467,53.77934816759807
Task_37260,1200,238,120,118,238,5.02092050209205,27.307263692007606
Task_37261,2579,757,67,12,79,3.4023746701846966,48.343499869318215
Task_37262,1904,737,132,33,165,2.5799457994579944,38.86303745221712
Task_37263,1861,954,117,55,172,1.9486910994764397,39.1445866628003
Task_37264,2772,756,152,22,174,3.6618229854689566,52.619280471250846
Task_37265,2798,345,167,133,300,8.086705202312139,53.23820238958541
Task_37266,874,321,33,85,118,2.7142857142857144,21.47936680016461
Task_37267,1934,548,46,172,218,3.522768670309654,39.95083284677727
Task_37268,905,617,18,150,168,1.464401294498382,23.273271521791298
Task_37269,1011,782,33,61,94,1.2911877394636015,24.35536292663758
Task_37270,1302,559,95,149,244,2.325,30.09754529137868
Task_37271,1912,994,44,102,146,1.921608040201005,40.2547809361517
Task_37272,1919,761,200,129,329,2.5183727034120733,40.786718125000355
Task_37273,1006,729,74,69,143,1.378082191780822,24.68716420637911
Task_37274,1956,593,141,133,274,3.292929292929293,40.60274775896466
Task_37275,1635,652,25,116,141,2.5038284839203677,34.817761776981364
Task_37276,1451,544,20,44,64,2.6623853211009174,29.762220772712354
Task_37277,2798,1023,182,124,306,2.732421875,55.42149640067672
Task_37278,2548,827,68,73,141,3.077294685990338,49.5398297504533
Task_37279,2329,720,60,165,225,3.230235783633842,46.86517893827923
Task_37280,2900,989,50,116,166,2.9292929292929295,56.304056837481376
Task_37281,1180,687,150,78,228,1.7151162790697674,28.01271525332669
Task_37282,2964,693,123,75,198,4.270893371757925,56.09277352436402
Task_37283,2208,143,200,29,229,15.333333333333334,41.82478119020578
Task_37284,1735,615,127,156,283,2.8165584415584415,37.24651413047794
Task_37285,1783,351,82,42,124,5.065340909090909,35.23341971264092
Task_37286,1409,1014,44,96,140,1.3881773399014778,32.23635494086832
Task_37287,880,194,85,193,278,4.512820512820513,22.370728322870644
Task_37288,762,912,130,128,258,0.8346111719605696,22.5186505999816
Task_37289,1271,729,60,70,130,1.7410958904109588,28.956719496696934
Task_37290,2142,349,134,171,305,6.12,42.95372987734214
Task_37291,2343,1003,22,199,221,2.3336653386454183,47.84500145322113
Task_37292,2708,617,191,29,220,4.381877022653722,51.53559023887459
Task_37293,2125,244,120,188,308,8.673469387755102,42.35938046039335
Task_37294,2311,147,122,158,280,15.614864864864865,44.416035518356985
Task_37295,2559,657,16,79,95,3.8890577507598785,48.74359294254381
Task_37296,2716,1018,46,125,171,2.665358194308145,53.33550582921279
Task_37297,1120,665,22,187,209,1.6816816816816818,27.330497838446757
Task_37298,1075,831,157,137,294,1.2920673076923077,27.395041358376886
Task_37299,1473,256,107,165,272,5.7315175097276265,31.904107792118037
Task_37300,2103,762,136,165,301,2.7562254259501966,43.63137325508762
Task_37301,1971,586,38,149,187,3.3577512776831346,40.424595385537025
Task_37302,512,591,47,30,77,0.8648648648648649,15.19434758001862
Task_37303,2925,651,187,183,370,4.486196319018405,56.639335122120904
Task_37304,972,777,183,180,363,1.249357326478149,25.938680243094353
Task_37305,1246,467,112,183,295,2.6623931623931623,29.13054565169149
Task_37306,1517,417,59,137,196,3.6291866028708135,32.901387698057455
Task_37307,2303,832,79,172,251,2.764705882352941,46.934696367874324
Task_37308,1021,1015,39,173,212,1.0049212598425197,26.638419666943165
Task_37309,504,775,76,147,223,0.6494845360824743,18.167000930803407
Task_37310,1686,956,38,199,237,1.761755485893417,37.389272168043696
Task_37311,2951,433,155,46,201,6.799539170506913,54.67748711679255
Task_37312,1164,724,76,193,269,1.6055172413793104,28.65907180253211
Task_37313,1279,392,167,23,190,3.2544529262086512,27.973312483021928
Task_37314,879,122,100,131,231,7.146341463414634,21.410117661626657
Task_37315,1095,233,44,92,136,4.67948717948718,24.857680654893212
Task_37316,2299,223,164,79,243,10.263392857142858,44.2843183072126
Task_37317,861,732,38,198,236,1.17462482946794,23.488015453956027
Task_37318,1466,224,112,104,216,6.515555555555555,31.340494638999317
Task_37319,2873,88,86,98,184,32.28089887640449,51.874786698889494
Task_37320,1319,273,86,80,166,4.813868613138686,28.528953877606853
Task_37321,2999,348,133,62,195,8.593123209169054,55.35788073190114
Task_37322,1442,865,194,19,213,1.6651270207852193,31.98238915268335
Task_37323,698,64,108,61,169,10.738461538461538,17.16524245266498
Task_37324,715,345,131,67,198,2.066473988439306,19.29341380493356
Task_37325,1446,965,200,73,273,1.4968944099378882,33.16524295805937
Task_37326,2429,449,145,166,311,5.397777777777778,47.84497284983693
Task_37327,2539,703,173,47,220,3.606534090909091,49.11726483124307
Task_37328,1396,562,147,17,164,2.479573712255773,29.992182483933394
Task_37329,528,240,117,70,187,2.190871369294606,15.905206162719123
Task_37330,739,270,49,101,150,2.726937269372694,19.526271598303403
Task_37331,1356,546,97,53,150,2.4789762340036563,29.607303242859704
Task_37332,2504,745,199,174,373,3.35656836461126,50.26831233276937
Task_37333,608,134,88,14,102,4.503703703703704,15.222575025340392
Task_37334,1014,804,50,60,110,1.2596273291925466,24.58061550876985
Task_37335,770,832,44,62,106,0.9243697478991597,20.74481451240701
Task_37336,912,501,132,139,271,1.8167330677290836,23.77758985022085
Task_37337,2642,553,91,138,229,4.768953068592058,51.19212444019351
Task_37338,636,404,133,138,271,1.5703703703703704,19.060840011913488
Task_37339,1733,107,104,78,182,16.046296296296298,33.724977059355616
Task_37340,1683,644,63,102,165,2.609302325581395,35.955383201772875
Task_37341,2210,751,26,86,112,2.9388297872340425,43.8898623247753
Task_37342,1888,624,155,180,335,3.0208,39.967530531818035
Task_37343,1214,618,83,113,196,1.9612277867528272,28.60317471410674
Task_37344,2108,161,164,145,309,13.012345679012345,41.41786463241475
Task_37345,2201,833,39,179,218,2.6390887290167866,45.06498233439627
Task_37346,2604,512,168,171,339,5.076023391812866,50.95330354962558
Task_37347,2729,723,22,57,79,3.7693370165745854,50.947185965829256
Task_37348,702,496,66,186,252,1.4124748490945673,20.473567598428417
Task_37349,2056,91,22,96,118,22.347826086956523,38.3217873803006
Task_37350,2247,580,36,181,217,3.8674698795180724,44.99215786800725
Task_37351,2211,577,116,109,225,3.8252595155709344,44.334138624914374
Task_37352,1192,248,149,186,335,4.78714859437751,27.751663050238292
Task_37353,2722,539,185,46,231,5.04074074074074,51.53381171044607
Task_37354,1682,1007,26,130,156,1.6686507936507937,36.732425359793375
Task_37355,1526,812,110,101,211,1.8769987699876998,34.14671483813897
Task_37356,2913,782,121,137,258,3.7203065134099615,56.291699431548295
Task_37357,2729,140,193,78,271,19.354609929078013,50.52872567333109
Task_37358,1067,982,153,147,300,1.0854526958290946,27.725073839985424
Task_37359,667,971,152,138,290,0.6862139917695473,21.500501004740794
Task_37360,2654,369,49,95,144,7.172972972972973,50.16848463618902
Task_37361,2073,241,126,54,180,8.566115702479339,40.11604929626634
Task_37362,1634,419,180,137,317,3.8904761904761904,35.150069009603776
Task_37363,901,624,93,117,210,1.4416,23.72776946394012
Task_37364,1841,382,137,46,183,4.806788511749347,36.68451455629093
Task_37365,1776,297,47,45,92,5.959731543624161,34.636050689489046
Task_37366,788,93,175,130,305,8.382978723404255,19.89194752092131
Task_37367,2423,127,98,168,266,18.9296875,45.93167136374569
Task_37368,1636,489,149,160,309,3.3387755102040817,35.403420310703915
Task_37369,812,607,120,200,320,1.3355263157894737,22.794705177078
Task_37370,1291,337,102,174,276,3.8195266272189348,29.32751814925233
Task_37371,1280,404,163,170,333,3.1604938271604937,29.62049708166442
Task_37372,2292,365,109,79,188,6.262295081967213,44.376879033434705
Task_37373,796,882,43,22,65,0.9014722536806342,20.55242559914465
Task_37374,1448,833,97,173,270,1.73621103117506,33.35793999127648
Task_37375,1625,715,34,138,172,2.2695530726256985,35.251005309576115
Task_37376,1886,697,78,32,110,2.702005730659026,37.88148835008665
Task_37377,2620,183,22,110,132,14.23913043478261,48.533644481071384
Task_37378,2090,323,118,62,180,6.450617283950617,40.64249731612116
Task_37379,556,269,50,77,127,2.0592592592592593,16.412962592308332
Task_37380,756,1005,18,156,174,0.7514910536779325,22.204747805949864
Task_37381,2892,670,181,159,340,4.309985096870343,56.00667767474149
Task_37382,2247,357,184,61,245,6.276536312849162,43.68091517026548
Task_37383,1611,865,50,74,124,1.8602771362586605,34.9340439943004
Task_37384,1754,964,154,182,336,1.8176165803108808,38.91394886426731
Task_37385,1904,999,54,37,91,1.904,38.81746923062066
Task_37386,1805,393,98,69,167,4.581218274111675,36.37810106494121
Task_37387,1663,114,142,18,160,14.460869565217392,32.05314774409462
Task_37388,2645,267,150,130,280,9.869402985074627,50.448707597979364
Task_37389,998,591,30,95,125,1.6858108108108107,24.498938345828563
Task_37390,565,838,52,188,240,0.6734207389749702,19.422275452177715
Task_37391,2291,89,176,37,213,25.455555555555556,42.290122109821205
Task_37392,774,965,70,78,148,0.8012422360248447,22.05361509566929
Task_37393,997,261,47,19,66,3.8053435114503817,21.422263319259525
Task_37394,1966,619,200,177,377,3.170967741935484,41.371984384386835
Task_37395,2887,711,138,200,338,4.054775280898877,56.10856245536456
Task_37396,1331,250,90,36,126,5.302788844621514,27.89210611161892
Task_37397,2115,272,41,100,141,7.747252747252747,41.1219495836523
Task_37398,915,75,45,83,128,12.039473684210526,20.559472346951335
Task_37399,1536,447,190,68,258,3.4285714285714284,32.8811794554977
Task_37400,1809,594,120,20,140,3.0403361344537814,36.37439981472182
Task_37401,2009,393,27,116,143,5.098984771573604,39.927086055709886
Task_37402,1466,718,65,19,84,2.0389429763560503,30.72396086439441
Task_37403,959,75,25,113,138,12.618421052631579,21.303808930982694
Task_37404,1516,477,126,194,320,3.1715481171548117,33.56503363768419
Task_37405,2382,376,35,62,97,6.318302387267905,44.85073371310333
Task_37406,1326,163,115,160,275,8.085365853658537,28.965648899564325
Task_37407,568,255,52,125,177,2.21875,17.101773160344305
Task_37408,1245,377,35,114,149,3.2936507936507935,27.79166550010574
Task_37409,790,776,74,65,139,1.0167310167310166,21.366973389296017
Task_37410,1372,241,10,178,188,5.669421487603306,29.861977884313518
Task_37411,1876,473,50,37,87,3.957805907172996,36.73226113159989
Task_37412,1909,150,83,98,181,12.642384105960264,37.3815150210281
Task_37413,565,718,146,16,162,0.7858136300417247,17.28766835687347
Task_37414,2203,949,44,84,128,2.3189473684210524,44.67314475510043
Task_37415,857,230,180,83,263,3.70995670995671,21.630382747938114
Task_37416,2290,925,192,51,243,2.473002159827214,46.208534433437706
Task_37417,534,798,200,157,357,0.6683354192740926,19.18962498184649
Task_37418,911,714,40,155,195,1.274125874125874,23.962538768355813
Task_37419,1984,881,170,50,220,2.249433106575964,40.94724128590881
Task_37420,2218,337,61,44,105,6.562130177514793,41.6352103530181
Task_37421,2403,225,172,83,255,10.632743362831858,45.99379879678437
Task_37422,2578,714,186,152,338,3.6055944055944056,51.15290114067121
Task_37423,2520,416,110,88,198,6.043165467625899,48.30124309669941
Task_37424,1288,956,139,35,174,1.3458725182863114,29.842249237807238
Task_37425,2509,990,198,165,363,2.5317860746720484,51.05582946390198
Task_37426,2166,265,143,105,248,8.142857142857142,42.69059890632665
Task_37427,1821,561,61,161,222,3.2402135231316724,38.29835480443913
Task_37428,1964,761,77,134,211,2.57742782152231,41.10101701913789
Task_37429,828,262,55,149,204,3.1482889733840302,21.560486363391163
Task_37430,1350,648,158,125,283,2.0801232665639446,31.20698809064159
Task_37431,1718,945,85,17,102,1.8160676532769555,35.62919373556155
Task_37432,2151,322,170,150,320,6.659442724458204,43.04178696863138
Task_37433,1403,414,38,156,194,3.3807228915662653,30.964321461912846
Task_37434,942,514,122,174,296,1.829126213592233,24.457241643981934
Task_37435,2713,1011,34,32,66,2.680830039525692,51.238226751536025
Task_37436,1114,791,54,184,238,1.4065656565656566,27.86023007642778
Task_37437,2091,987,98,25,123,2.116396761133603,42.12908386090951
Task_37438,933,796,158,127,285,1.1706398996235885,24.991620537381223
Task_37439,2078,368,138,56,194,5.631436314363143,40.90988827919622
Task_37440,1312,341,40,160,200,3.8362573099415203,29.322036347349453
Task_37441,2825,152,154,71,225,18.464052287581698,51.78367859816702
Task_37442,1344,812,99,58,157,1.6531365313653137,30.169517566102158
Task_37443,1108,554,152,181,333,1.9963963963963964,27.38786834457638
Task_37444,2513,645,80,164,244,3.890092879256966,49.626353923211106
Task_37445,2743,485,141,119,260,5.6440329218107,52.63396414700063
Task_37446,865,659,79,189,268,1.3106060606060606,23.656051165344138
Task_37447,2584,538,102,70,172,4.794063079777366,49.281943063045624
Task_37448,778,797,82,177,259,0.974937343358396,22.521222573820413
Task_37449,2912,903,111,108,219,3.2212389380530975,56.43753504564694
Task_37450,1529,223,176,68,244,6.825892857142857,31.964654696717457
Task_37451,695,919,97,136,233,0.7554347826086957,21.399147562586773
Task_37452,1163,167,25,56,81,6.9226190476190474,24.553997043149604
Task_37453,2495,650,99,185,284,3.8325652841781874,49.442572158572794
Task_37454,1344,710,16,116,132,1.890295358649789,30.333274463476823
Task_37455,2010,149,192,169,361,13.4,40.08002710291738
Task_37456,1737,1020,140,175,315,1.7012732615083253,38.70000188738637
Task_37457,2569,810,60,160,220,3.1676942046855734,50.920153163001864
Task_37458,665,773,170,108,278,0.8591731266149871,20.621332809524713
Task_37459,2238,970,179,106,285,2.304840370751802,46.26104344834533
Task_37460,2782,439,66,82,148,6.322727272727272,52.18649053903366
Task_37461,2974,579,154,35,189,5.127586206896551,55.45241994059425
Task_37462,1720,399,22,129,151,4.3,35.322953465524684
Task_37463,2326,650,123,71,194,3.5729646697388633,45.753635459986924
Task_37464,1223,474,72,59,131,2.574736842105263,27.25462269946345
Task_37465,1358,967,73,76,149,1.4028925619834711,31.153683132192615
Task_37466,2068,609,132,50,182,3.3901639344262295,41.07527144816201
Task_37467,1196,434,169,26,195,2.749425287356322,26.846553321337524
Task_37468,1709,509,118,60,178,3.350980392156863,35.17042207440411
Task_37469,2346,937,196,128,324,2.5010660980810235,48.07766943415649
Task_37470,1416,439,61,163,224,3.2181818181818183,31.51102195362959
Task_37471,1128,805,28,109,137,1.3995037220843674,27.13395477778556
Task_37472,1863,375,48,147,195,4.954787234042553,38.218686417773725
Task_37473,978,998,185,142,327,0.978978978978979,26.546108027620388
Task_37474,2542,562,71,157,228,4.515097690941386,49.738588326458
Task_37475,590,240,18,171,189,2.4481327800829877,17.481716625123703
Task_37476,614,212,136,178,314,2.8826291079812205,18.395875289038248
Task_37477,815,152,92,86,178,5.326797385620915,19.9729209390355
Task_37478,797,397,179,121,300,2.0025125628140703,21.734919703439726
Task_37479,559,542,94,194,288,1.0294659300184161,18.42575027820592
Task_37480,2177,231,102,54,156,9.383620689655173,41.516331844035214
Task_37481,911,181,159,196,355,5.0054945054945055,22.832880477451692
Task_37482,2898,606,33,13,46,4.774299835255354,52.62714387909219
Task_37483,1604,898,156,144,300,1.7842046718576197,36.10069572089728
Task_37484,2021,451,165,80,245,4.471238938053097,40.6849368686413
Task_37485,2010,724,154,21,175,2.7724137931034485,40.41521874826181
Task_37486,1983,472,66,84,150,4.192389006342495,39.58622001813873
Task_37487,2750,757,16,15,31,3.627968337730871,50.6407873238077
Task_37488,2458,529,152,63,215,4.637735849056604,47.518212082902096
Task_37489,1175,989,21,98,119,1.1868686868686869,28.21324729079905
Task_37490,2176,216,180,146,326,10.027649769585253,43.080508200104966
Task_37491,1964,576,119,54,173,3.4038128249566726,39.566053508771944
Task_37492,1651,178,145,174,319,9.223463687150838,34.26915633501696
Task_37493,2740,484,104,105,209,5.649484536082475,52.33283158360111
Task_37494,2090,490,54,105,159,4.256619144602851,41.668796587017916
Task_37495,1734,502,114,31,145,3.4473161033797215,35.21817182951194
Task_37496,1200,406,38,108,146,2.9484029484029484,27.143542716341056
Task_37497,2220,69,136,57,193,31.714285714285715,41.15500250280747
Task_37498,548,536,96,68,164,1.0204841713221602,16.97986801183291
Task_37499,2064,889,101,108,209,2.3191011235955057,42.91198116028071
Task_37500,1084,558,182,37,219,1.9391771019677997,25.631313465576394
Task_37501,1145,107,151,24,175,10.601851851851851,24.249298715917607
Task_37502,1430,635,42,73,115,2.248427672955975,31.14528176594457
Task_37503,1910,859,60,66,126,2.2209302325581395,39.44179426954465
Task_37504,2118,875,112,186,298,2.4178082191780823,44.2394297151232
Task_37505,1928,480,24,79,103,4.008316008316008,38.33883502217409
Task_37506,929,88,71,122,193,10.438202247191011,21.667035515755273
Task_37507,1341,158,38,79,117,8.433962264150944,27.73267466740505
Task_37508,2232,911,187,35,222,2.4473684210526314,44.92423957318204
Task_37509,705,958,104,153,257,0.735140771637122,21.776786546345818
Task_37510,1641,731,135,165,300,2.2418032786885247,36.211026298355854
Task_37511,2965,1024,69,169,238,2.892682926829268,57.95211218714456
Task_37512,1699,900,18,56,74,1.8856825749167592,35.15309350804827
Task_37513,2286,806,54,15,69,2.83271375464684,43.53716306825786
Task_37514,1756,344,52,179,231,5.089855072463768,36.67954464694979
Task_37515,2401,252,40,72,112,9.4901185770751,45.11296350354028
Task_37516,1132,502,75,43,118,2.250497017892644,25.422971899492897
Task_37517,2651,569,72,109,181,4.650877192982456,51.02249322311141
Task_37518,1263,460,161,136,297,2.7396963123644253,29.317584546273338
Task_37519,1329,158,93,113,206,8.358490566037736,28.72456597671788
Task_37520,2365,1006,27,93,120,2.348560079443893,47.3522191152841
Task_37521,634,936,135,41,176,0.6766275346851655,19.584449563996134
Task_37522,974,470,82,147,229,2.067940552016985,24.57663630427663
Task_37523,2913,99,111,89,200,29.13,52.72098142474201
Task_37524,1063,610,173,122,295,1.739770867430442,26.57912556893503
Task_37525,1719,708,129,55,184,2.4245416078984485,36.08031105168237
Task_37526,1250,474,117,90,207,2.6315789473684212,28.51826093130074
Task_37527,624,802,55,31,86,0.7770859277708593,18.077082511866763
Task_37528,1155,580,153,121,274,1.9879518072289157,27.85964202358419
Task_37529,586,782,193,91,284,0.7484035759897829,19.22191944168688
Task_37530,1218,115,102,162,264,10.5,26.82076142410467
Task_37531,2746,650,82,40,122,4.218125960061444,51.4334011434778
Task_37532,2452,317,153,103,256,7.710691823899371,47.427203312702176
Task_37533,2837,800,175,90,265,3.5418227215980025,54.942150353009765
Task_37534,2932,609,157,197,354,4.80655737704918,56.564571892718355
Task_37535,1116,762,111,122,233,1.4626474442988204,27.557335200635098
Task_37536,1510,746,60,196,256,2.0214190093708164,34.15772389966683
Task_37537,2560,615,10,127,137,4.1558441558441555,49.32402910462551
Task_37538,1168,713,178,188,366,1.6358543417366946,28.9798734591706
Task_37539,1358,346,37,56,93,3.913544668587896,28.561574026768298
Task_37540,2137,686,132,138,270,3.1106259097525473,43.75209636672903
Task_37541,1134,844,152,200,352,1.3420118343195266,28.775519602154862
Task_37542,906,640,72,121,193,1.4134165366614664,23.795556303496614
Task_37543,674,476,188,69,257,1.4129979035639413,19.25179970209007
Task_37544,600,822,131,174,305,0.7290400972053463,19.997004410354194
Task_37545,1435,583,171,174,345,2.4571917808219177,32.70075094712116
Task_37546,611,472,142,118,260,1.291754756871036,18.74954699295067
Task_37547,2950,339,103,134,237,8.676470588235293,55.33912628019414
Task_37548,1907,642,34,163,197,2.9657853810264387,39.70611581367036
Task_37549,2866,91,97,169,266,31.152173913043477,52.452695838026926
Task_37550,893,917,96,12,108,0.9727668845315904,22.884988871589844
Task_37551,2233,901,195,71,266,2.475609756097561,45.39408404339394
Task_37552,2238,390,102,21,123,5.723785166240409,42.506413075931604
Task_37553,1344,87,98,103,201,15.272727272727273,28.068848910868997
Task_37554,1688,846,112,197,309,1.9929161747343564,37.40164241060413
Task_37555,1859,637,72,69,141,2.913793103448276,37.93198366518532
Task_37556,1392,914,37,172,209,1.521311475409836,32.41705975694722
Task_37557,2205,257,53,91,144,8.546511627906977,42.574427292392436
Task_37558,2497,742,104,187,291,3.360699865410498,49.79745879055258
Task_37559,2758,322,56,63,119,8.538699690402476,51.010025431073835
Task_37560,2844,302,125,84,209,9.386138613861386,53.03950330789402
Task_37561,2602,661,143,92,235,3.930513595166163,50.712602928892686
Task_37562,1336,185,52,116,168,7.182795698924731,28.727468679298198
Task_37563,726,507,154,137,291,1.4291338582677164,20.870544481140673
Task_37564,2742,538,121,117,238,5.087198515769944,52.68777919505006
Task_37565,1417,700,74,151,225,2.021398002853067,32.3391627422644
Task_37566,1946,404,135,194,329,4.8049382716049385,40.17636567880454
Task_37567,1213,575,38,168,206,2.1059027777777777,28.537286569633853
Task_37568,2977,327,13,43,56,9.076219512195122,53.355354745213184
Task_37569,737,808,197,39,236,0.9110012360939431,21.007126760006486
Task_37570,2417,463,135,120,255,5.209051724137931,47.38081999340077
Task_37571,1388,643,160,33,193,2.1552795031055902,30.582070379827996
Task_37572,2135,81,135,159,294,26.036585365853657,40.952998461978105
Task_37573,1902,219,34,134,168,8.645454545454545,37.87868956772409
Task_37574,2246,170,155,189,344,13.134502923976608,43.79567763555567
Task_37575,536,81,178,140,318,6.536585365853658,15.975762005089118
Task_37576,1951,484,132,186,318,4.022680412371134,40.45272559868942
Task_37577,2687,272,81,150,231,9.842490842490843,51.04289750507485
Task_37578,1037,389,186,158,344,2.658974358974359,25.75959506537066
Task_37579,1057,611,64,190,254,1.727124183006536,26.53010234824769
Task_37580,611,423,99,51,150,1.4410377358490567,17.303162370789707
Task_37581,1131,910,198,169,367,1.2414928649835346,28.871920890200784
Task_37582,793,202,102,187,289,3.9064039408866993,21.08895473210214
Task_37583,1114,351,174,20,194,3.164772727272727,25.124369017023312
Task_37584,2991,933,182,158,340,3.202355460385439,58.401904366082626
Task_37585,2591,100,152,134,286,25.653465346534652,48.20912214452466
Task_37586,2570,900,138,193,331,2.8523862375138735,51.63844088231374
Task_37587,1222,209,25,112,137,5.819047619047619,26.84391788723744
Task_37588,1696,832,63,62,125,2.036014405762305,35.77236042444927
Task_37589,2958,964,89,200,289,3.0652849740932644,57.84743854632219
Task_37590,1915,152,196,105,301,12.516339869281046,38.22236523161953
Task_37591,769,151,112,38,150,5.059210526315789,18.456124630253914
Task_37592,1477,594,123,27,150,2.4823529411764707,31.304448941137622
Task_37593,2231,404,106,24,130,5.508641975308642,42.601262783004636
Task_37594,1353,133,55,61,116,10.097014925373134,27.361242881577226
Task_37595,1831,99,105,113,218,18.31,35.92869499108088
Task_37596,876,290,102,183,285,3.0103092783505154,22.666419730319785
Task_37597,1290,575,37,185,222,2.2395833333333335,29.86122709892261
Task_37598,1864,867,151,135,286,2.1474654377880182,40.06109288665771
Task_37599,1237,150,29,112,141,8.19205298013245,26.331826316791894
Task_37600,1237,626,35,70,105,1.9728867623604465,27.69065944659611
Task_37601,1098,531,196,110,306,2.06390977443609,26.931673089934822
Task_37602,1590,88,117,133,250,17.865168539325843,32.25675330280321
Task_37603,716,749,60,32,92,0.9546666666666667,19.44712285029299
Task_37604,1853,196,60,93,153,9.406091370558375,36.752134591639575
Task_37605,2178,275,154,149,303,7.891304347826087,43.22805529814335
Task_37606,1243,687,46,47,93,1.806686046511628,27.479374478953208
Task_37607,1159,469,104,130,234,2.4659574468085106,27.40710443365465
Task_37608,1429,584,28,135,163,2.442735042735043,31.60291402703613
Task_37609,1085,556,162,147,309,1.947935368043088,26.87192829641761
Task_37610,1936,360,56,84,140,5.362880886426593,38.5241164365194
Task_37611,759,335,83,48,131,2.2589285714285716,19.163426098186733
Task_37612,2146,269,133,140,273,7.948148148148148,42.55269391625113
Task_37613,1739,984,40,199,239,1.765482233502538,38.325066693339
Task_37614,2387,429,144,129,273,5.551162790697674,46.88930598637116
Task_37615,580,902,25,114,139,0.6423034330011074,18.90039135695499
Task_37616,1465,582,162,150,312,2.5128644939965694,32.98876737579433
Task_37617,801,813,132,131,263,0.984029484029484,22.864785477628995
Task_37618,1275,154,185,45,230,8.225806451612904,27.0762801553734
Task_37619,2339,548,155,92,247,4.260473588342441,46.24205956129799
Task_37620,2990,226,193,50,243,13.17180616740088,54.82247590330889
Task_37621,2496,293,167,77,244,8.489795918367347,47.58826632491068
Task_37622,1655,772,18,51,69,2.1410090556274257,33.99736741671656
Task_37623,1935,83,174,109,283,23.035714285714285,37.720821543530995
Task_37624,1513,176,160,123,283,8.548022598870057,31.82691291465255
Task_37625,2036,84,191,75,266,23.95294117647059,38.79154340949314
Task_37626,698,818,25,151,176,0.8522588522588522,20.676995767547677
Task_37627,1007,483,11,49,60,2.080578512396694,22.630234617049496
Task_37628,1060,841,75,30,105,1.2589073634204275,25.24432725758572
Task_37629,572,607,68,29,97,0.9407894736842105,16.86847077764531
Task_37630,1709,427,147,120,267,3.9929906542056073,36.112492745988284
Task_37631,2561,581,52,95,147,4.400343642611684,49.42004756826484
Task_37632,1070,100,68,24,92,10.594059405940595,22.163878261320587
Task_37633,822,191,68,23,91,4.28125,19.371456711485717
Task_37634,1659,909,40,47,87,1.823076923076923,34.59703079623401
Task_37635,2938,776,84,195,279,3.7812097812097814,56.89584589977087
Task_37636,2013,583,150,40,190,3.4469178082191783,40.2627023577669
Task_37637,1278,317,116,26,142,4.018867924528302,27.255493923490707
Task_37638,1192,858,94,158,252,1.3876600698486612,29.285530077324797
Task_37639,1189,387,56,27,83,3.064432989690722,25.48259829092737
Task_37640,591,310,121,42,163,1.9003215434083602,16.619813637282142
Task_37641,663,294,152,30,182,2.247457627118644,17.784915134809594
Task_37642,2832,592,14,59,73,4.775716694772344,52.11248479628805
Task_37643,609,416,163,143,306,1.460431654676259,18.81064430135326
Task_37644,835,871,154,28,182,0.9575688073394495,22.35780807796119
Task_37645,564,649,84,198,282,0.8676923076923077,18.78645921946736
Task_37646,1872,890,32,45,77,2.101010101010101,37.501749488499605
Task_37647,969,588,154,184,338,1.6451612903225807,25.306544598001143
Task_37648,1199,332,77,154,231,3.6006006006006004,27.74998516647534
Task_37649,2857,470,11,47,58,6.065817409766455,51.88445469187226
Task_37650,652,323,193,76,269,2.0123456790123457,18.639966819096554
Task_37651,1262,173,130,196,326,7.252873563218391,28.198907854141073
Task_37652,1521,341,100,103,203,4.447368421052632,32.54527775812493
Task_37653,2374,161,128,34,162,14.654320987654321,43.943760514535676
Task_37654,720,439,175,57,232,1.6363636363636365,19.753084572050895
Task_37655,1464,176,105,105,210,8.271186440677965,30.698593694586247
Task_37656,2433,354,42,67,109,6.853521126760564,45.87306104903024
Task_37657,1467,484,169,28,197,3.024742268041237,31.311928935023186
Task_37658,1062,761,133,175,308,1.3937007874015748,27.1144401877491
Task_37659,602,841,192,47,239,0.7149643705463183,19.202032143185576
Task_37660,1053,676,19,40,59,1.5553914327917282,23.893838509593106
Task_37661,1852,662,143,83,226,2.793363499245852,38.59009831899197
Task_37662,1927,903,139,134,273,2.131637168141593,41.111354588813576
Task_37663,2184,905,145,176,321,2.410596026490066,45.46775279122445
Task_37664,598,1001,50,66,116,0.5968063872255489,19.14990287730296
Task_37665,2923,874,166,90,256,3.3405714285714287,56.49653585742476
Task_37666,2423,107,200,66,266,22.435185185185187,44.9216170035678
Task_37667,1748,134,121,86,207,12.948148148148148,34.78715297136278
Task_37668,2714,790,68,113,181,3.43109987357775,52.72182400250184
Task_37669,1939,831,200,120,320,2.3305288461538463,41.268454742890235
Task_37670,1371,692,71,155,226,1.9783549783549783,31.59108227162966
Task_37671,2591,991,76,70,146,2.6118951612903225,50.7076786139167
Task_37672,2663,635,123,180,303,4.187106918238993,52.13241971171948
Task_37673,2732,268,95,136,231,10.156133828996282,51.68541225324129
Task_37674,2153,895,85,25,110,2.4029017857142856,42.61970138405581
Task_37675,1945,634,124,36,160,3.062992125984252,38.94768658742153
Task_37676,1200,507,58,39,97,2.3622047244094486,26.125908365933284
Task_37677,858,69,52,152,204,12.257142857142858,20.579354340127903
Task_37678,1012,603,178,94,272,1.6754966887417218,25.54935087130417
Task_37679,1135,787,82,134,216,1.4403553299492386,27.967880161315772
Task_37680,719,905,172,32,204,0.7935982339955849,20.901310497737402
Task_37681,1848,370,165,132,297,4.981132075471698,38.27936332138385
Task_37682,2027,283,165,34,199,7.137323943661972,39.56129404906971
Task_37683,2029,752,89,56,145,2.694555112881806,40.98194434947878
Task_37684,2061,115,184,183,367,17.767241379310345,40.573670692042626
Task_37685,2965,808,78,119,197,3.665018541409147,57.02679198243555
Task_37686,742,489,154,86,240,1.5142857142857142,20.52863377155771
Task_37687,773,548,61,16,77,1.4080145719489983,18.79065693867397
Task_37688,2020,373,29,107,136,5.401069518716578,39.997661940507506
Task_37689,2642,825,87,151,238,3.198547215496368,52.07225155632637
Task_37690,2177,565,181,122,303,3.8462897526501765,44.12817593531465
Task_37691,1146,249,61,160,221,4.584,26.604317978818433
Task_37692,2956,501,16,163,179,5.888446215139442,55.542653870047765
Task_37693,2982,99,149,39,188,29.82,53.00423049094238
Task_37694,2667,173,118,95,213,15.327586206896552,49.637043454006715
Task_37695,1012,249,177,100,277,4.048,24.52359989948867
Task_37696,2072,755,150,25,175,2.740740740740741,41.54823018060045
Task_37697,2019,991,199,105,304,2.035282258064516,42.94009285798368
Task_37698,1293,315,200,75,275,4.091772151898734,28.773431489702137
Task_37699,1721,482,168,159,327,3.5631469979296067,36.806356593892474
Task_37700,1716,979,59,66,125,1.7510204081632652,36.70489660254041
Task_37701,1110,492,76,39,115,2.2515212981744424,25.009216715340013
Task_37702,2838,243,73,104,177,11.631147540983607,52.851565304303215
Task_37703,1429,459,174,109,283,3.106521739130435,31.83927561701236
Task_37704,810,348,14,89,103,2.320916905444126,20.34785932906289
Task_37705,1655,258,83,181,264,6.38996138996139,34.82793443723685
Task_37706,507,459,42,58,100,1.1021739130434782,15.25662516815747
Task_37707,2180,728,84,33,117,2.99039780521262,42.66652648458106
Task_37708,1238,894,12,69,81,1.3832402234636871,28.192798437238512
Task_37709,1524,107,112,93,205,14.11111111111111,31.006792755904275
Task_37710,2911,265,83,80,163,10.943609022556391,53.668777545449636
Task_37711,1729,889,28,21,49,1.942696629213483,35.15973452931421
Task_37712,1821,758,162,59,221,2.399209486166008,38.10961776041399
Task_37713,2870,993,127,93,220,2.887323943661972,55.97052743147204
Task_37714,963,377,182,104,286,2.5476190476190474,24.210029567347068
Task_37715,2440,439,176,173,349,5.545454545454546,48.16791372856562
Task_37716,1181,264,124,160,284,4.456603773584906,27.363610010665525
Task_37717,1738,648,146,70,216,2.6779661016949152,36.5251916002395
Task_37718,1765,186,98,123,221,9.438502673796792,36.13706742716173
Task_37719,772,110,56,84,140,6.954954954954955,18.489071625416532
Task_37720,2146,913,12,41,53,2.3479212253829322,42.039472184103374
Task_37721,1118,102,154,179,333,10.854368932038835,25.34889304059396
Task_37722,2596,445,69,68,137,5.820627802690583,49.033878369758064
Task_37723,2131,415,115,168,283,5.122596153846154,42.89436851051166
Task_37724,1489,240,119,140,259,6.178423236514523,32.006429550459195
Task_37725,2863,284,85,12,97,10.04561403508772,51.71994855806369
Task_37726,2055,113,118,151,269,18.026315789473685,39.95048889941699
Task_37727,2135,728,145,111,256,2.9286694101508917,43.749725657709064
Task_37728,2646,69,78,195,273,37.8,48.990915201316604
Task_37729,2626,458,95,181,276,5.721132897603486,50.926901312910395
Task_37730,1571,424,122,179,301,3.696470588235294,34.15860072493658
Task_37731,1586,293,76,83,159,5.394557823129252,32.73967254966384
Task_37732,2724,1004,28,120,148,2.71044776119403,53.191896573051935
Task_37733,729,727,161,50,211,1.0013736263736264,20.467825771741232
Task_37734,1693,773,69,199,268,2.1873385012919897,37.19302632082101
Task_37735,1153,357,30,59,89,3.2206703910614527,25.16229095384502
Task_37736,1426,419,90,134,224,3.395238095238095,31.4841148506905
Task_37737,636,815,131,186,317,0.7794117647058824,20.605346260274864
Task_37738,1463,824,155,19,174,1.7733333333333334,31.916044102589126
Task_37739,586,346,122,142,264,1.6887608069164266,18.0910707904906
Task_37740,716,825,34,153,187,0.8668280871670703,21.1335317304132
Task_37741,2898,727,70,83,153,3.980769230769231,54.87248144191796
Task_37742,2791,752,159,171,330,3.7065073041168657,54.63874482049283
Task_37743,977,395,164,106,270,2.467171717171717,24.419551519194044
Task_37744,2840,654,110,52,162,4.33587786259542,53.51573828057955
Task_37745,1299,561,123,155,278,2.311387900355872,30.148224457255562
Task_37746,573,853,54,121,175,0.6709601873536299,19.11149695441286
Task_37747,2354,777,147,98,245,3.025706940874036,47.30749857214946
Task_37748,537,231,87,120,207,2.314655172413793,16.683062974134042
Task_37749,1543,714,83,109,192,2.158041958041958,34.09027779733853
Task_37750,531,395,168,134,302,1.3409090909090908,17.507313022943283
Task_37751,2642,793,130,88,218,3.327455919395466,51.528838704633976
Task_37752,2052,668,98,57,155,3.0672645739910314,40.94467997286396
Task_37753,1688,625,18,47,65,2.696485623003195,33.8251187897271
Task_37754,2974,259,61,101,162,11.438461538461539,54.89123142599775
Task_37755,2797,882,81,25,106,3.1676104190260475,52.716516974867176
Task_37756,2280,726,132,50,182,3.1361760660247593,44.8020038143747
Task_37757,2219,598,23,175,198,3.704507512520868,44.598759856894354
Task_37758,1987,871,198,25,223,2.278669724770642,40.84934811504427
Task_37759,1613,991,101,103,204,1.626008064516129,36.03918647580338
Task_37760,2663,246,40,115,155,10.781376518218623,49.769200042083305
Task_37761,2430,386,108,66,174,6.27906976744186,46.34099541448638
Task_37762,736,796,66,169,235,0.9234629861982434,21.76990148450099
Task_37763,2518,522,72,107,179,4.81453154875717,48.754260543141065
Task_37764,1161,774,160,143,303,1.4980645161290322,28.679399887936686
Task_37765,1008,806,142,173,315,1.2490706319702602,26.372331638963136
Task_37766,2384,355,25,119,144,6.696629213483146,45.75012325243566
Task_37767,869,475,129,135,264,1.8256302521008403,22.977976229119246
Task_37768,2414,995,200,170,370,2.423694779116466,49.60482407134398
Task_37769,2494,231,160,87,247,10.75,47.462873530001595
Task_37770,2336,99,112,78,190,23.36,43.38322843593718
Task_37771,1566,825,198,102,300,1.8958837772397095,35.223503861685856
Task_37772,1937,208,85,141,226,9.267942583732058,38.86594538976605
Task_37773,2539,317,125,70,195,7.984276729559748,48.033143377473465
Task_37774,1284,802,91,15,106,1.5990037359900373,28.439012780318933
Task_37775,2969,899,60,45,105,3.298888888888889,55.30403641900103
Task_37776,1944,240,51,56,107,8.066390041493776,37.52587764021448
Task_37777,1078,978,199,150,349,1.101123595505618,28.11225983306308
Task_37778,2271,356,50,22,72,6.361344537815126,42.133149676572415
Task_37779,1953,566,72,174,246,3.4444444444444446,40.53062161257794
Task_37780,2643,145,138,61,199,18.102739726027398,48.763984902336766
Task_37781,1392,239,100,198,298,5.8,30.73142102503896
Task_37782,1249,147,62,179,241,8.43918918918919,27.629654960722622
Task_37783,1116,459,114,170,284,2.4260869565217393,26.97886790802148
Task_37784,1620,221,159,134,293,7.297297297297297,34.15284818307873
Task_37785,1644,503,158,14,172,3.261904761904762,33.837427253912175
Task_37786,1858,891,61,26,87,2.0829596412556053,37.58041536674472
Task_37787,2908,965,169,93,262,3.010351966873706,56.674560421633885
Task_37788,2633,698,14,151,165,3.7668097281831185,51.16275217598609
Task_37789,1878,748,155,12,167,2.507343124165554,38.23347087854295
Task_37790,1400,853,29,108,137,1.639344262295082,31.691707580364834
Task_37791,1752,402,84,10,94,4.347394540942928,34.53339969342459
Task_37792,1434,550,158,32,190,2.602540834845735,30.99310722363279
Task_37793,573,794,21,23,44,0.720754716981132,16.9008547034659
Task_37794,1218,797,132,110,242,1.5263157894736843,29.330562355853605
Task_37795,1408,355,11,127,138,3.955056179775281,30.224765858901534
Task_37796,2455,500,120,160,280,4.900199600798403,48.27357172582439
Task_37797,1201,151,114,15,129,7.901315789473684,25.098985667659345
Task_37798,961,267,158,82,240,3.5858208955223883,23.30077795582426
Task_37799,1137,383,193,175,368,2.9609375,27.455755293294015
Task_37800,1466,103,121,184,305,14.096153846153847,30.70098465891881
Task_37801,2953,691,107,28,135,4.267341040462428,54.98830596832226
Task_37802,2465,856,25,27,52,2.8763127187864646,46.86058236176955
Task_37803,2941,823,76,66,142,3.5691747572815533,55.65039116023852
Task_37804,533,747,137,47,184,0.7125668449197861,17.380865814913726
Task_37805,995,505,39,80,119,1.966403162055336,23.92345581611403
Task_37806,2710,898,145,157,302,3.014460511679644,53.66704906984821
Task_37807,924,338,99,174,273,2.725663716814159,23.51434670252448
Task_37808,2910,587,151,171,322,4.948979591836735,55.9633494966013
Task_37809,2994,744,157,141,298,4.018791946308725,57.641164257452566
Task_37810,1575,610,91,14,105,2.5777414075286416,32.43981247993363
Task_37811,2536,735,156,92,248,3.4456521739130435,49.95946782682981
Task_37812,1662,217,85,54,139,7.623853211009174,33.25155229155195
Task_37813,2238,348,39,46,85,6.412607449856734,42.02402530757522
Task_37814,1388,359,46,47,93,3.8555555555555556,28.73847575084504
Task_37815,2764,229,127,56,183,12.017391304347827,51.02969913037622
Task_37816,2170,857,169,178,347,2.5291375291375293,45.21630232155709
Task_37817,1579,1019,37,96,133,1.5480392156862746,35.07263838438923
Task_37818,1453,973,35,89,124,1.4917864476386038,32.68739243716231
Task_37819,1039,351,85,91,176,2.9517045454545454,24.54840866562954
Task_37820,2323,844,165,134,299,2.749112426035503,47.31902370656638
Task_37821,1061,988,166,89,255,1.0728008088978767,27.170084049793484
Task_37822,2058,602,169,133,302,3.4129353233830844,42.3727378596358
Task_37823,1893,439,76,15,91,4.302272727272728,36.86757229438976
Task_37824,522,866,191,85,276,0.6020761245674741,18.589023092147663
Task_37825,928,786,164,48,212,1.1791613722998728,23.87113981386327
Task_37826,1187,540,198,135,333,2.1940850277264325,28.527427436728402
Task_37827,1656,732,54,134,188,2.2592087312414733,36.02333316525674
Task_37828,2824,150,141,40,181,18.70198675496689,51.07359240770371
Task_37829,2907,647,63,189,252,4.486111111111111,55.94645384988407
Task_37830,879,921,74,73,147,0.9533622559652929,23.478954100964987
Task_37831,2234,460,147,153,300,4.845986984815618,44.72561530756011
Task_37832,1844,521,44,18,62,3.532567049808429,35.674008166463295
Task_37833,1406,221,27,52,79,6.333333333333333,28.43245007046062
Task_37834,1497,974,12,17,29,1.5353846153846153,31.363829029915404
Task_37835,1732,121,10,90,100,14.19672131147541,33.49052408694049
Task_37836,1240,106,52,67,119,11.588785046728972,25.514092194620023
Task_37837,2597,776,65,29,94,3.3423423423423424,49.1702629647472
Task_37838,846,213,44,146,190,3.953271028037383,21.45876737959466
Task_37839,2994,475,92,83,175,6.2899159663865545,55.83660227003961
Task_37840,904,920,43,77,120,0.9815418023887079,23.58917120998475
Task_37841,2955,355,55,18,73,8.30056179775281,52.667056936030285
Task_37842,1377,423,37,139,176,3.2476415094339623,30.33063623737225
Task_37843,2294,884,55,50,105,2.592090395480226,44.79770674020477
Task_37844,1680,247,67,90,157,6.774193548387097,34.19962031662512
Task_37845,2761,443,111,67,178,6.218468468468468,51.69621360531446
Task_37846,2458,892,103,57,160,2.7525195968645018,48.080614105894675
Task_37847,1774,651,69,99,168,2.7208588957055215,37.296932821310584
Task_37848,2227,651,76,189,265,3.415644171779141,45.25772681244198
Task_37849,1149,615,133,91,224,1.8652597402597402,27.45858213837765
Task_37850,914,981,174,65,239,0.9307535641547862,24.674480103622443
Task_37851,2852,117,89,152,241,24.16949152542373,52.4796068837928
Task_37852,1868,154,72,88,160,12.051612903225806,36.44241845557
Task_37853,651,1012,45,176,221,0.6426456071076012,21.055161706280284
Task_37854,1833,544,162,45,207,3.363302752293578,37.33114087784981
Task_37855,1684,112,100,92,192,14.902654867256636,33.44316614846483
Task_37856,2019,77,79,148,227,25.884615384615383,38.90573412993251
Task_37857,2891,534,52,35,87,5.40373831775701,52.92655243752864
Task_37858,2829,340,94,65,159,8.296187683284458,52.2914269400632
Task_37859,1444,475,67,91,158,3.033613445378151,31.25092231046791
Task_37860,2547,231,32,175,207,10.97844827586207,48.54254520804653
Task_37861,826,349,142,10,152,2.36,20.124938074235775
Task_37862,1268,616,46,176,222,2.055105348460292,29.64235553947613
Task_37863,2447,889,13,101,114,2.749438202247191,48.34655401242383
Task_37864,660,475,12,59,71,1.3865546218487395,17.22064847062969
Task_37865,1723,227,84,56,140,7.557017543859649,34.30908660554617
Task_37866,2669,359,50,18,68,7.413888888888889,48.20886116099944
Task_37867,2437,113,88,35,123,21.37719298245614,44.177018642575035
Task_37868,1178,652,161,83,244,1.8039816232771821,27.96454003469859
Task_37869,1233,623,73,155,228,1.9759615384615385,29.198866604551426
Task_37870,2227,701,166,51,217,3.1723646723646723,44.39208780273079
Task_37871,523,827,105,151,256,0.6316425120772947,18.64405536071615
Task_37872,766,206,141,110,251,3.7004830917874396,20.392061027870323
Task_37873,2782,449,183,30,213,6.182222222222222,52.13128605509123
Task_37874,2725,369,179,35,214,7.364864864864865,50.96422105103184
Task_37875,2096,255,66,25,91,8.1875,39.48529141117135
Task_37876,2493,407,105,72,177,6.110294117647059,47.36374805273829
Task_37877,2642,508,18,84,102,5.19056974459725,49.72282589057378
Task_37878,779,843,198,88,286,0.9229857819905213,22.414391977952587
Task_37879,730,800,39,198,237,0.9113607990012484,21.56190543835007
Task_37880,813,538,167,128,295,1.5083487940630798,22.375145905995783
Task_37881,2367,396,173,175,348,5.962216624685139,46.869550707796215
Task_37882,2127,928,38,35,73,2.2895586652314317,41.68921418638617
Task_37883,1879,405,189,88,277,4.62807881773399,38.477714467058036
Task_37884,815,228,10,69,79,3.558951965065502,19.23606155752152
Task_37885,1488,714,46,123,169,2.081118881118881,32.92838780650724
Task_37886,2987,971,26,48,74,3.0730452674897117,55.51863176138727
Task_37887,1869,780,176,156,332,2.3930857874519846,40.10708579198314
Task_37888,1830,594,156,182,338,3.0756302521008405,38.97081645435163
Task_37889,2149,168,30,46,76,12.715976331360947,39.58840260116346
Task_37890,628,748,194,77,271,0.8384512683578104,19.604490743617102
Task_37891,2015,985,187,112,299,2.0436105476673427,42.845783999132664
Task_37892,1749,69,141,87,228,24.985714285714284,34.29146788629681
Task_37893,1068,973,88,42,130,1.0965092402464065,25.942967739415394
Task_37894,2718,490,88,81,169,5.535641547861507,51.29174050407267
Task_37895,1355,389,134,22,156,3.4743589743589745,28.736461238551584
Task_37896,2162,297,29,149,178,7.25503355704698,42.351385060935634
Task_37897,506,918,37,77,114,0.5505984766050055,17.38729151847495
Task_37898,1080,394,115,196,311,2.7341772151898733,26.362858348513058
Task_37899,2818,672,51,165,216,4.187221396731055,54.486763292909025
Task_37900,640,201,63,118,181,3.1683168316831685,18.028240707874772
Task_37901,1134,729,77,18,95,1.5534246575342465,25.7453073308838
Task_37902,1911,734,82,96,178,2.6,39.79108169076293
Task_37903,1348,382,110,83,193,3.519582245430809,29.572006077048954
Task_37904,2789,236,153,192,345,11.767932489451477,52.99156190285206
Task_37905,981,801,101,158,259,1.2231920199501247,25.65468285530756
Task_37906,613,480,79,12,91,1.2744282744282744,16.824485744344965
Task_37907,1261,840,96,58,154,1.4994054696789536,28.917814752422746
Task_37908,2881,1014,143,40,183,2.838423645320197,55.16771149614413
Task_37909,849,373,80,40,120,2.270053475935829,20.520296497064557
Task_37910,777,252,29,199,228,3.0711462450592886,20.785691996840338
Task_37911,1394,964,178,165,343,1.444559585492228,33.147519208473476
Task_37912,719,563,17,200,217,1.274822695035461,20.567903905637245
Task_37913,2877,411,40,141,181,6.983009708737864,54.017192185666715
Task_37914,2987,398,87,185,272,7.486215538847118,56.36727129341446
Task_37915,2802,474,193,72,265,5.8989473684210525,53.06966031131662
Task_37916,1020,246,36,34,70,4.129554655870446,21.99677452488645
Task_37917,2640,411,125,132,257,6.407766990291262,50.76602734979159
Task_37918,2948,744,134,182,316,3.9570469798657717,57.05367791788473
Task_37919,2563,612,18,130,148,4.181076672104404,49.35706972366759
Task_37920,2958,806,78,104,182,3.6654275092936803,56.63766852508343
Task_37921,1474,486,134,72,206,3.026694045174538,31.82010932428824
Task_37922,2152,619,122,14,136,3.470967741935484,41.93262851026399
Task_37923,966,69,39,198,237,13.8,22.423839635872678
Task_37924,1192,731,41,40,81,1.6284153005464481,26.72451270410389
Task_37925,1912,481,154,66,220,3.966804979253112,38.74539523921525
Task_37926,554,555,66,198,264,0.9964028776978417,18.31227753657222
Task_37927,599,819,68,194,262,0.7304878048780488,19.909485347092957
Task_37928,1010,593,49,194,243,1.7003367003367003,25.71870924217562
Task_37929,2886,675,131,181,312,4.269230769230769,55.83357176713749
Task_37930,1990,878,182,182,364,2.2639362912400456,42.51224661316383
Task_37931,2176,1014,84,127,211,2.1438423645320195,45.15998455581265
Task_37932,1367,548,177,124,301,2.4899817850637525,31.242320137136783
Task_37933,2654,687,15,78,93,3.8575581395348837,50.39956664417517
Task_37934,1770,902,136,123,259,1.9601328903654485,38.54130034598239
Task_37935,563,337,26,63,89,1.665680473372781,15.943829052292417
Task_37936,996,482,63,143,206,2.062111801242236,24.88865786685078
Task_37937,1030,978,104,199,303,1.052093973442288,27.232471504623078
Task_37938,2248,871,142,63,205,2.5779816513761467,45.22618738697653
Task_37939,851,508,191,44,235,1.6719056974459725,21.823689029691582
Task_37940,1399,913,35,163,198,1.5306345733041575,32.47082741126477
Task_37941,1420,315,120,122,242,4.493670886075949,31.06607514663962
Task_37942,757,929,177,80,257,0.8139784946236559,22.20009909145252
Task_37943,2989,943,34,195,229,3.1663135593220337,57.98331856486278
Task_37944,1797,663,149,111,260,2.7063253012048194,38.209734423430916
Task_37945,1739,513,173,168,341,3.3832684824902723,37.26634905970163
Task_37946,675,670,96,56,152,1.0059612518628913,19.066059946060417
Task_37947,2240,1019,177,109,286,2.196078431372549,46.45408240175919
Task_37948,2427,263,135,186,321,9.193181818181818,47.25584835734028
Task_37949,2188,694,70,110,180,3.148201438848921,44.09711015737534
Task_37950,2597,590,182,76,258,4.39424703891709,50.22711995108964
Task_37951,1541,952,195,117,312,1.6169989506820566,35.2845525915368
Task_37952,1270,197,13,161,174,6.414141414141414,28.080040698051135
Task_37953,1497,187,177,103,280,7.962765957446808,32.088296903057106
Task_37954,1323,829,123,129,252,1.5939759036144578,31.195719187369445
Task_37955,515,65,81,188,269,7.803030303030303,15.518484883791364
Task_37956,541,251,69,198,267,2.1468253968253967,17.308401275926887
Task_37957,2092,520,132,101,233,4.015355086372361,42.29250538982828
Task_37958,633,857,190,17,207,0.7377622377622378,19.179415315462666
Task_37959,2179,887,73,133,206,2.453828828828829,44.87803458317891
Task_37960,558,896,168,137,305,0.6220735785953178,19.666751705063444
Task_37961,800,814,113,51,164,0.9815950920245399,21.891228792131585
Task_37962,1579,655,64,22,86,2.4070121951219514,32.43953367884492
Task_37963,2138,242,55,41,96,8.798353909465021,40.12209400603902
Task_37964,2325,935,195,11,206,2.483974358974359,46.24459767375987
Task_37965,547,556,192,148,340,0.9820466786355476,18.417250550326496
Task_37966,1268,424,49,133,182,2.9835294117647058,28.738096003058317
Task_37967,1311,262,76,136,212,4.984790874524715,29.189811100526217
Task_37968,1435,753,56,139,195,1.903183023872679,32.66360802291445
Task_37969,2159,721,87,45,132,2.990304709141274,42.47607392608061
Task_37970,2847,976,81,36,117,2.9140225179119756,53.99911841963691
Task_37971,1946,488,131,159,290,3.9795501022494886,40.220615411872174
Task_37972,2150,507,144,14,158,4.232283464566929,41.59674509746395
Task_37973,1740,909,140,70,210,1.9120879120879122,37.344621283332636
Task_37974,1187,94,77,113,190,12.494736842105263,25.659926376337356
Task_37975,2978,65,146,120,266,45.121212121212125,53.85311838372899
Task_37976,1725,444,66,117,183,3.8764044943820224,35.977736039422986
Task_37977,2714,536,143,82,225,5.054003724394786,51.84478750217613
Task_37978,2450,164,114,88,202,14.848484848484848,46.09499901422432
Task_37979,2020,919,199,189,388,2.1956521739130435,43.23372854587878
Task_37980,1350,710,23,124,147,1.8987341772151898,30.585249043815484
Task_37981,506,521,18,175,193,0.9693486590038314,16.91745364123518
Task_37982,2052,205,146,134,280,9.96116504854369,40.85582559006685
Task_37983,2511,563,47,171,218,4.452127659574468,49.149756086272305
Task_37984,1303,768,120,178,298,1.694408322496749,30.968435132436507
Task_37985,1488,472,13,46,59,3.145877378435518,30.2250869097417
Task_37986,1716,1008,164,155,319,1.7006937561942517,38.318697888549536
Task_37987,798,911,121,55,176,0.875,22.102680875154977
Task_37988,1658,192,76,11,87,8.590673575129534,32.45930237701804
Task_37989,1588,181,19,110,129,8.725274725274724,31.88901748333375
Task_37990,2607,712,198,142,340,3.656381486676017,51.60032619866204
Task_37991,1719,167,116,142,258,10.232142857142858,35.07672210296906
Task_37992,1142,665,125,137,262,1.7147147147147148,27.875083194465976
Task_37993,1271,102,140,191,331,12.339805825242719,27.761086300909493
Task_37994,2751,318,183,19,202,8.623824451410659,50.906544097308995
Task_37995,2433,297,180,182,362,8.164429530201343,47.650713119954425
Task_37996,2998,924,77,47,124,3.2410810810810813,56.35197909194017
Task_37997,2252,503,46,12,58,4.468253968253968,42.11381365172748
Task_37998,738,387,154,131,285,1.902061855670103,20.716896340381357
Task_37999,564,625,140,90,230,0.9009584664536742,18.161227620515344
Task_38000,2941,540,118,157,275,5.436229205175601,56.070523823136035
Task_38001,2627,760,180,50,230,3.45203679369251,50.80101263385083
Task_38002,1403,121,189,20,209,11.5,28.71142619715832
Task_38003,1421,418,184,33,217,3.3914081145584727,30.502276644613293
Task_38004,570,83,34,64,98,6.785714285714286,14.623232325987795
Task_38005,821,316,23,65,88,2.589905362776025,19.99251018989356
Task_38006,2976,450,167,152,319,6.598669623059867,56.521611173758835
Task_38007,2848,878,105,38,143,3.2400455062571103,53.98954300160059
Task_38008,1810,67,102,65,167,26.61764705882353,34.575818114643134
Task_38009,2532,355,145,143,288,7.112359550561798,49.02537411981098
Task_38010,1425,778,154,128,282,1.829268292682927,32.80034258844998
Task_38011,2471,185,44,37,81,13.28494623655914,45.33200663186985
Task_38012,1260,245,35,194,229,5.121951219512195,28.379252331514753
Task_38013,1048,321,144,90,234,3.2546583850931676,24.955320300776226
Task_38014,1439,1011,161,164,325,1.4219367588932805,33.9236524207054
Task_38015,898,283,168,24,192,3.1619718309859155,21.609207544894968
Task_38016,2023,721,108,145,253,2.801939058171745,41.98988178860082
Task_38017,2641,629,117,47,164,4.192063492063492,50.15780540126485
Task_38018,2322,322,65,196,261,7.188854489164087,45.672826115614065
Task_38019,631,800,114,163,277,0.787765293383271,20.281259348583024
Task_38020,1872,233,114,151,265,8.0,38.07483066722586
Task_38021,2396,981,61,88,149,2.439918533604888,47.812073186165684
Task_38022,712,718,37,25,62,0.9902642559109874,18.75793532998236
Task_38023,1761,927,177,69,246,1.8976293103448276,37.868402883458224
Task_38024,849,443,89,123,212,1.912162162162162,22.348788036173335
Task_38025,2190,263,34,133,167,8.295454545454545,42.57988553693159
Task_38026,895,277,109,111,220,3.2194244604316546,22.526035316206574
Task_38027,1678,201,142,116,258,8.306930693069306,34.81135056730084
Task_38028,1662,109,148,105,253,15.10909090909091,33.465176009551705
Task_38029,1178,812,115,23,138,1.4489544895448954,27.177457108466797
Task_38030,2173,531,132,142,274,4.084586466165414,43.85502126918186
Task_38031,2399,504,78,197,275,4.75049504950495,47.56233203213599
Task_38032,2933,494,170,110,280,5.925252525252525,55.748090353587976
Task_38033,506,692,43,75,118,0.7301587301587301,16.667867951629763
Task_38034,1477,712,115,153,268,2.0715287517531555,33.39196238716643
Task_38035,2739,866,45,34,79,3.1591695501730106,51.31185475009113
Task_38036,1704,602,130,193,323,2.825870646766169,36.94916184998321
Task_38037,2593,113,55,38,93,22.74561403508772,46.16707574131109
Task_38038,760,930,67,45,112,0.8163265306122449,20.803458121454007
Task_38039,1388,139,187,162,349,9.914285714285715,30.129122768428587
Task_38040,2747,773,137,168,305,3.549095607235142,53.890770956417555
Task_38041,1687,1024,31,27,58,1.6458536585365853,35.05714774978455
Task_38042,2341,986,94,184,278,2.3718338399189465,48.10964173953884
Task_38043,692,297,194,67,261,2.3221476510067114,19.060868969089647
Task_38044,1058,224,142,182,324,4.702222222222222,25.4981369602298
Task_38045,1121,248,25,137,162,4.502008032128514,25.55459448086829
Task_38046,1681,806,42,35,77,2.0830235439900866,34.22495256691392
Task_38047,2127,904,61,194,255,2.350276243093923,44.41835631576034
Task_38048,2617,805,89,64,153,3.2468982630272953,50.32381792259249
Task_38049,1357,177,142,50,192,7.623595505617978,28.34418141513845
Task_38050,836,611,165,21,186,1.3660130718954249,21.456999177511353
Task_38051,811,567,180,106,286,1.4278169014084507,22.33544868007148
Task_38052,2269,395,18,174,192,5.72979797979798,44.58511921955945
Task_38053,1818,518,91,65,156,3.5028901734104045,36.83583862583518
Task_38054,2050,557,14,154,168,3.673835125448029,41.388021766736365
Task_38055,2538,558,66,26,92,4.540250447227192,47.582984645435765
Task_38056,1312,721,31,14,45,1.817174515235457,27.835678371133117
Task_38057,595,920,80,111,191,0.6460369163952225,19.847106059020977
Task_38058,2185,259,73,183,256,8.403846153846153,43.24680687997309
Task_38059,653,287,128,59,187,2.267361111111111,17.935954370018298
Task_38060,1166,563,95,166,261,2.0673758865248226,28.0581065783133
Task_38061,2479,987,142,132,274,2.5091093117408905,50.121573444884575
Task_38062,2499,618,34,57,91,4.037156704361874,47.33392546814628
Task_38063,1283,912,138,118,256,1.4052573932092005,30.766397677692655
Task_38064,687,971,94,144,238,0.7067901234567902,21.65475004233224
Task_38065,1970,373,113,64,177,5.267379679144385,38.92529153786503
Task_38066,1976,268,43,102,145,7.345724907063197,38.98245136503496
Task_38067,1717,670,37,11,48,2.5588673621460507,34.08085670134906
Task_38068,998,638,176,130,306,1.5618153364632237,25.668969847758408
Task_38069,1670,128,199,73,272,12.945736434108527,33.57749392445472
Task_38070,1182,583,115,121,236,2.0239726027397262,28.12532751063138
Task_38071,2977,360,163,122,285,8.246537396121884,56.03752276194988
Task_38072,2919,699,23,23,46,4.17,53.46078868538362
Task_38073,2715,779,60,109,169,3.480769230769231,52.643035641435084
Task_38074,2366,523,61,35,96,4.515267175572519,44.61685507961482
Task_38075,1345,259,63,118,181,5.173076923076923,29.358306254387106
Task_38076,861,308,97,183,280,2.7864077669902914,22.48851107198701
Task_38077,2665,84,33,55,88,31.352941176470587,47.28794510072223
Task_38078,2776,261,52,195,247,10.595419847328245,52.61319616883793
Task_38079,2409,940,151,78,229,2.5600425079702442,48.286081961201894
Task_38080,774,287,101,88,189,2.6875,20.191176530926636
Task_38081,2519,477,40,178,218,5.2698744769874475,48.97160316520077
Task_38082,1949,231,48,24,72,8.400862068965518,36.62080583934193
Task_38083,2383,126,93,44,137,18.763779527559056,43.671328738430674
Task_38084,970,230,90,25,115,4.199134199134199,21.894307654250596
Task_38085,736,440,48,89,137,1.6689342403628118,19.861070475530425
Task_38086,2376,681,68,24,92,3.4838709677419355,45.41517281661513
Task_38087,2765,930,188,160,348,2.969924812030075,54.850339373903616
Task_38088,976,482,90,98,188,2.020703933747412,24.310321931633638
Task_38089,960,674,174,135,309,1.4222222222222223,25.17433480568563
Task_38090,1842,842,63,99,162,2.185053380782918,38.8573870755049
Task_38091,594,130,17,54,71,4.534351145038168,14.944854632852214
Task_38092,2216,197,94,164,258,11.191919191919192,43.487620089696634
Task_38093,1333,88,135,12,147,14.97752808988764,26.534322519747843
Task_38094,1856,634,97,125,222,2.9228346456692913,38.925980848112566
Task_38095,2858,535,94,195,289,5.332089552238806,54.94276923962132
Task_38096,623,683,165,200,365,0.9108187134502924,20.209302918110524
Task_38097,2061,901,69,115,184,2.2849223946784925,42.747119950966585
Task_38098,2934,371,54,186,240,7.887096774193548,55.445016486462144
Task_38099,2325,207,28,152,180,11.177884615384615,44.61187620178496
Task_38100,2572,260,131,119,250,9.854406130268199,49.11809642071213
Task_38101,1649,748,157,10,167,2.2016021361815756,34.59519150213184
Task_38102,1168,156,141,91,232,7.439490445859873,26.0149737490341
Task_38103,852,797,178,118,296,1.0676691729323309,23.69302477728374
Task_38104,1663,312,40,91,131,5.313099041533547,34.08776323193426
Task_38105,968,72,25,20,45,13.26027397260274,19.28616777036792
Task_38106,1852,902,185,55,240,2.05094130675526,39.22941567459751
Task_38107,2426,246,91,173,264,9.821862348178138,46.95110550789273
Task_38108,2786,956,46,185,231,2.911180773249739,54.80796941620042
Task_38109,550,158,82,88,170,3.459119496855346,15.847637025796416
Task_38110,2084,127,81,178,259,16.28125,40.65806476566659
Task_38111,2006,268,83,76,159,7.4572490706319705,39.142286738093944
Task_38112,958,680,126,25,151,1.406754772393539,23.34876480544983
Task_38113,2779,642,73,20,93,4.321928460342146,51.58695631489186
Task_38114,607,236,151,143,294,2.561181434599156,18.222259555978123
Task_38115,2426,722,163,34,197,3.355463347164592,47.291185070121315
Task_38116,1412,990,85,41,126,1.4248234106962665,31.422074516758627
Task_38117,1896,261,25,104,129,7.236641221374046,37.71454612190997
Task_38118,1863,114,68,191,259,16.2,37.076808667705826
Task_38119,2908,821,48,194,242,3.537712895377129,56.46996735832701
Task_38120,897,231,114,150,264,3.8663793103448274,22.661585879396352
Task_38121,968,482,97,56,153,2.0041407867494825,23.233514443810776
Task_38122,2428,986,20,168,188,2.459979736575481,48.9185852835524
Task_38123,1459,907,162,103,265,1.6068281938325992,33.61321617962503
Task_38124,1652,812,77,105,182,2.031980319803198,35.961718737895644
Task_38125,1234,317,22,48,70,3.880503144654088,25.698134633892654
Task_38126,1887,828,135,154,289,2.2762364294330517,40.34534057523374
Task_38127,2212,818,101,165,266,2.700854700854701,45.375764161805115
Task_38128,578,365,166,179,345,1.5792349726775956,18.414342518699346
Task_38129,2980,777,83,35,118,3.8303341902313623,55.46563343991223
Task_38130,1291,886,71,43,114,1.455467869222097,29.08759882243177
Task_38131,2453,659,60,157,217,3.716666666666667,48.58911890332365
Task_38132,2497,646,132,66,198,3.8593508500772797,48.43509990289326
Task_38133,873,259,167,164,331,3.3576923076923078,22.69749657984903
Task_38134,1217,162,131,153,284,7.466257668711656,27.273581181789833
Task_38135,2904,768,94,200,294,3.776332899869961,56.44339228352448
Task_38136,2566,256,176,157,333,9.98443579766537,49.43836147098801
Task_38137,2907,618,79,68,147,4.696284329563813,54.50554320152235
Task_38138,2643,542,179,37,216,4.867403314917127,50.2525437184967
Task_38139,1055,864,42,27,69,1.2196531791907514,24.520152405063953
Task_38140,1717,1006,160,109,269,1.70506454816286,38.03555631243909
Task_38141,835,75,147,11,158,10.986842105263158,18.611440064191477
Task_38142,2597,1010,179,175,354,2.568743818001978,52.48677559665117
Task_38143,1031,140,37,66,103,7.3120567375886525,22.303096907116128
Task_38144,2706,336,130,54,184,8.029673590504451,50.473074061078044
Task_38145,1334,687,178,180,358,1.938953488372093,31.494002712279258
Task_38146,2816,355,64,61,125,7.910112359550562,51.88877385525078
Task_38147,2336,781,110,88,198,2.9872122762148337,46.55314083147507
Task_38148,632,64,196,169,365,9.723076923076922,17.711335832510354
Task_38149,690,525,127,98,225,1.311787072243346,20.02108129456896
Task_38150,897,386,134,119,253,2.317829457364341,23.067638709338866
Task_38151,969,254,32,121,153,3.8,23.026839345168813
Task_38152,507,696,87,88,175,0.727403156384505,17.149333235645912
Task_38153,2299,514,37,14,51,4.464077669902912,42.88511914972992
Task_38154,2128,154,180,89,269,13.729032258064516,41.288359502280265
Task_38155,2721,924,197,60,257,2.9416216216216218,53.05375672152295
Task_38156,734,71,133,103,236,10.194444444444445,18.610382417573668
Task_38157,2265,783,90,122,212,2.889030612244898,45.84873301159357
Task_38158,1513,569,200,128,328,2.6543859649122807,33.747834918262924
Task_38159,2174,743,39,115,154,2.922043010752688,43.624076956538204
Task_38160,2597,143,73,128,201,18.03472222222222,48.634609057766376
Task_38161,2368,775,116,192,308,3.051546391752577,47.941467577880836
Task_38162,1678,962,38,14,52,1.742471443406023,34.473956879682696
Task_38163,2194,981,25,91,116,2.2342158859470467,44.511713171143576
Task_38164,2093,490,79,106,185,4.262729124236253,42.003976293325486
Task_38165,728,250,176,149,325,2.900398406374502,20.327884708709004
Task_38166,1174,540,150,172,322,2.1700554528650646,28.32625024318547
Task_38167,2453,578,16,182,198,4.236614853195164,48.11810082696157
Task_38168,1731,698,200,156,356,2.476394849785408,37.772695609153494
Task_38169,1868,606,195,105,300,3.077429983525535,39.32633594803345
Task_38170,1333,90,48,13,61,14.648351648351648,25.58049026557876
Task_38171,1753,657,150,55,205,2.664133738601824,36.738118249002966
Task_38172,1107,333,166,54,220,3.31437125748503,25.52021352542897
Task_38173,1571,227,142,107,249,6.890350877192983,33.162541939576826
Task_38174,1231,204,187,38,225,6.004878048780488,26.85240701582029
Task_38175,2719,740,36,48,84,3.669365721997301,50.94012588866345
Task_38176,1388,460,78,60,138,3.0108459869848154,29.78349759217224
Task_38177,712,213,191,138,329,3.3271028037383177,19.955474425180473
Task_38178,1406,582,173,68,241,2.411663807890223,31.17359319784812
Task_38179,1105,562,12,143,155,1.9626998223801067,26.200918214591805
Task_38180,2544,996,19,56,75,2.5516549648946842,48.820688644625655
Task_38181,940,1001,154,128,282,0.93812375249501,25.73591917798898
Task_38182,858,338,78,84,162,2.5309734513274336,21.443770136765803
Task_38183,776,457,67,114,181,1.6943231441048034,20.971036428163988
Task_38184,904,943,115,152,267,0.9576271186440678,24.957051206499997
Task_38185,1399,861,183,41,224,1.622969837587007,31.584423848058577
Task_38186,527,108,46,159,205,4.834862385321101,15.512702732799923
Task_38187,1641,324,69,40,109,5.049230769230769,32.7831181468834
Task_38188,922,190,183,75,258,4.827225130890052,22.519604529080283
Task_38189,1878,505,111,86,197,3.7114624505928853,38.40820046956394
Task_38190,2713,316,105,163,268,8.558359621451103,51.693004004451346
Task_38191,1579,736,162,146,308,2.1424694708276797,35.25268001153066
Task_38192,1205,271,162,16,178,4.430147058823529,26.066666207887717
Task_38193,1589,274,161,119,280,5.778181818181818,33.76743767405011
Task_38194,2200,940,68,191,259,2.3379383634431457,45.69510895108167
Task_38195,2135,207,135,152,287,10.264423076923077,42.23174753370778
Task_38196,1192,629,19,44,63,1.892063492063492,25.947616478986685
Task_38197,1414,661,47,82,129,2.13595166163142,31.24185625923484
Task_38198,1015,697,152,102,254,1.4541547277936964,25.820756169690785
Task_38199,1522,670,197,188,385,2.2682563338301045,34.55215479717628
Task_38200,1071,297,93,184,277,3.5939597315436242,25.84936579977017
Task_38201,1360,151,60,30,90,8.947368421052632,27.112220190687932
Task_38202,2562,379,178,180,358,6.742105263157895,49.95063009447781
Task_38203,2220,598,89,18,107,3.706176961602671,42.581568659234925
Task_38204,1245,474,191,182,373,2.6210526315789475,29.486947104360997
Task_38205,1061,731,160,28,188,1.4494535519125684,25.575165793656755
Task_38206,2104,271,182,114,296,7.735294117647059,41.96150881189855
Task_38207,1710,235,34,37,71,7.245762711864407,32.91700007015052
Task_38208,1507,134,97,133,230,11.162962962962963,31.36424082811226
Task_38209,2556,501,145,39,184,5.091633466135458,48.366774634333176
Task_38210,1820,784,72,168,240,2.3184713375796178,39.073207542602425
Task_38211,1106,573,110,16,126,1.9268292682926829,25.183756486033307
Task_38212,1221,72,62,133,195,16.726027397260275,26.14450598932331
Task_38213,672,429,86,134,220,1.5627906976744186,19.512682832741145
Task_38214,2394,591,124,86,210,4.043918918918919,46.911235738722276
Task_38215,2756,455,14,199,213,6.043859649122807,52.68947740555607
Task_38216,635,343,74,113,187,1.8459302325581395,18.57502883908442
Task_38217,2776,853,19,144,163,3.250585480093677,53.737331016922404
Task_38218,1886,468,128,181,309,4.021321961620469,39.32456675971145
Task_38219,1560,888,123,150,273,1.7547806524184477,35.259547264231536
Task_38220,2154,980,131,200,331,2.1957186544342506,45.30616250950501
Task_38221,682,290,167,106,273,2.343642611683849,19.432579291649205
Task_38222,1309,475,41,31,72,2.75,27.31004027931863
Task_38223,1066,551,163,126,289,1.931159420289855,26.434497383180815
Task_38224,1695,469,134,111,245,3.606382978723404,35.913320551834055
Task_38225,1500,362,77,86,163,4.132231404958677,31.81788164831188
Task_38226,2710,145,54,16,70,18.561643835616437,47.986929130847294
Task_38227,1628,932,141,170,311,1.744908896034298,36.674276781951214
Task_38228,1431,189,25,87,112,7.531578947368421,29.79277394464533
Task_38229,2731,543,118,61,179,5.020220588235294,51.46144055650786
Task_38230,1634,825,182,143,325,1.9782082324455206,36.47365472184566
Task_38231,1632,415,107,109,216,3.923076923076923,34.6092695541937
Task_38232,1581,142,111,20,131,11.055944055944057,30.990007686120595
Task_38233,836,884,107,116,223,0.9446327683615819,23.444952252098133
Task_38234,2290,492,88,93,181,4.645030425963489,44.851842432131434
Task_38235,1626,796,75,164,239,2.040150564617315,36.03582469366323
Task_38236,2541,820,161,79,240,3.095006090133983,50.0584848565079
Task_38237,1162,218,94,87,181,5.30593607305936,25.967570437357796
Task_38238,2314,112,126,58,184,20.47787610619469,42.82839239176823
Task_38239,2328,177,162,174,336,13.07865168539326,45.00045037043378
Task_38240,2466,143,94,11,105,17.125,44.835960468663394
Task_38241,889,943,24,50,74,0.9417372881355932,22.291595972134285
Task_38242,2891,956,169,126,295,3.0208986415882966,56.63949230935295
Task_38243,1367,884,84,87,171,1.544632768361582,31.20461274061626
Task_38244,1678,934,22,111,133,1.7946524064171123,36.32522339346247
Task_38245,2905,320,198,177,375,9.049844236760125,55.245998525193876
Task_38246,1204,277,27,198,225,4.330935251798561,27.601159683579112
Task_38247,2216,391,156,75,231,5.653061224489796,43.425610522486046
Task_38248,1465,1005,99,183,282,1.4562624254473162,34.15282902679557
Task_38249,2274,780,190,168,358,2.911651728553137,46.65811849817883
Task_38250,932,668,173,136,309,1.3931240657698056,24.713610585055264
Task_38251,2668,494,55,189,244,5.38989898989899,51.665113400213095
Task_38252,1134,528,42,129,171,2.1436672967863895,26.727049814042307
Task_38253,720,666,92,114,206,1.0794602698650675,20.81499568903219
Task_38254,2751,425,34,48,82,6.457746478873239,50.448673392623384
Task_38255,1347,71,59,108,167,18.708333333333332,27.892205983126516
Task_38256,906,447,85,190,275,2.0223214285714284,23.653210146450032
Task_38257,749,434,89,170,259,1.72183908045977,21.005131618144876
Task_38258,591,77,154,48,202,7.576923076923077,15.446750222175554
Task_38259,2075,517,82,69,151,4.005791505791506,40.91013243311564
Task_38260,2024,890,100,160,260,2.271604938271605,42.5873806311942
Task_38261,2358,416,88,61,149,5.654676258992806,44.960842052210744
Task_38262,610,821,85,105,190,0.7420924574209246,19.487323215451102
Task_38263,2077,682,79,171,250,3.04099560761347,42.87807178835893
Task_38264,1628,851,123,104,227,1.9107981220657277,35.96063812308932
Task_38265,1476,781,197,141,338,1.8874680306905371,33.889106361626
Task_38266,1083,520,32,31,63,2.0786948176583495,23.897151118096275
Task_38267,1379,717,119,132,251,1.9206128133704736,31.74775997134329
Task_38268,1307,150,138,55,193,8.655629139072847,27.725860025055265
Task_38269,551,541,178,82,260,1.0166051660516606,17.68872463975139
Task_38270,2724,503,39,169,208,5.404761904761905,52.24304525990999
Task_38271,1870,336,129,178,307,5.548961424332345,38.6273413503922
Task_38272,1860,186,127,115,242,9.946524064171124,37.70504114413547
Task_38273,2920,336,105,58,163,8.664688427299703,53.75005864363313
Task_38274,2631,616,192,190,382,4.2641815235008105,51.93588150998784
Task_38275,859,177,63,138,201,4.825842696629214,21.220950470518673
Task_38276,655,575,175,175,350,1.1371527777777777,20.26594797945216
Task_38277,1420,380,171,80,251,3.727034120734908,30.971814518643182
Task_38278,1326,708,138,55,193,1.8702397743300423,30.07997629095216
Task_38279,2627,902,156,90,246,2.9091915836101885,51.84898861042196
Task_38280,1677,237,83,65,148,7.046218487394958,33.700924898919304
Task_38281,2859,193,31,192,223,14.737113402061855,53.37714346215674
Task_38282,1140,585,14,134,148,1.9453924914675769,26.816169392399914
Task_38283,2792,227,158,121,279,12.24561403508772,52.60240523803734
Task_38284,2105,358,161,12,173,5.8635097493036215,40.70242817624904
Task_38285,1251,181,124,18,142,6.873626373626373,25.975435721022464
Task_38286,2884,533,180,190,370,5.400749063670412,55.62192237244144
Task_38287,1492,506,184,51,235,2.942800788954635,32.21798222451158
Task_38288,509,904,182,78,260,0.5624309392265193,18.364542514904006
Task_38289,1541,870,62,69,131,1.7692307692307692,33.668954050887116
Task_38290,1550,124,189,30,219,12.4,31.201936991457643
Task_38291,2709,707,42,71,113,3.8262711864406778,51.607270834475834
Task_38292,551,91,177,47,224,5.989130434782608,15.035944171837079
Task_38293,1635,733,105,22,127,2.2275204359673024,34.13926305364804
Task_38294,501,269,58,197,255,1.8555555555555556,16.71133417018714
Task_38295,699,380,116,19,135,1.8346456692913387,18.112554332340036
Task_38296,2722,104,115,185,300,25.923809523809524,50.40907298721871
Task_38297,1971,210,78,52,130,9.341232227488153,38.260566852563805
Task_38298,2387,800,173,61,234,2.9800249687890137,47.266444687428255
Task_38299,921,213,108,31,139,4.303738317757009,21.286238068996514
Task_38300,540,728,189,66,255,0.7407407407407407,17.949590446657464
Task_38301,509,219,13,97,110,2.3136363636363635,15.438682985313037
Task_38302,1242,128,71,176,247,9.627906976744185,27.392362665531465
Task_38303,1378,849,26,196,222,1.6211764705882352,32.13321474181706
Task_38304,1252,567,70,11,81,2.204225352112676,27.078691809877046
Task_38305,2303,262,102,109,211,8.756653992395437,44.68401057700989
Task_38306,1502,608,121,150,271,2.4663382594417076,33.47159402125244
Task_38307,1773,783,52,31,83,2.2614795918367347,36.03235612852958
Task_38308,2396,322,123,54,177,7.41795665634675,45.48735420533857
Task_38309,1563,492,105,85,190,3.1703853955375254,33.323011171036086
Task_38310,906,72,140,158,298,12.41095890410959,21.653438095485058
Task_38311,1401,883,167,57,224,1.584841628959276,31.865240206563644
Task_38312,1837,89,26,98,124,20.41111111111111,35.05934871627043
Task_38313,2885,425,175,184,359,6.772300469483568,55.22567073662378
Task_38314,505,522,23,109,132,0.9655831739961759,16.459991886578234
Task_38315,675,229,47,36,83,2.9347826086956523,16.912538438505692
Task_38316,2634,668,125,12,137,3.937219730941704,49.76711116331537
Task_38317,2029,811,75,53,128,2.498768472906404,41.23275348161853
Task_38318,1247,801,21,48,69,1.554862842892768,27.44301183281424
Task_38319,2214,923,130,17,147,2.396103896103896,43.843187108466054
Task_38320,2782,146,72,47,119,18.92517006802721,49.78481617262167
Task_38321,2930,755,113,38,151,3.875661375661376,54.918286693799935
Task_38322,2883,379,69,154,223,7.586842105263158,54.504208350283314
Task_38323,1376,919,81,97,178,1.4956521739130435,31.867846092153176
Task_38324,1238,123,192,191,383,9.983870967741936,27.836280743291923
Task_38325,1346,772,62,149,211,1.7412677878395861,31.355459934187124
Task_38326,2124,456,26,52,78,4.647702407002188,40.51521141436657
Task_38327,2182,529,123,186,309,4.1169811320754715,44.21337218145667
Task_38328,2806,204,33,59,92,13.68780487804878,50.87291889997554
Task_38329,1797,713,43,157,200,2.5168067226890756,38.17713706552732
Task_38330,822,569,82,67,149,1.4421052631578948,21.248115089456846
Task_38331,995,278,52,10,62,3.5663082437275984,21.47923630607428
Task_38332,703,388,143,15,158,1.80719794344473,18.316984800097718
Task_38333,711,267,19,41,60,2.6529850746268657,17.179782224510735
Task_38334,1103,585,21,72,93,1.8822525597269624,25.379654669305182
Task_38335,1427,310,194,152,346,4.588424437299035,31.672957422609063
Task_38336,1956,154,84,55,139,12.619354838709677,37.31568022399423
Task_38337,2430,607,52,99,151,3.9967105263157894,47.376618620772184
Task_38338,708,788,82,26,108,0.8973384030418251,19.548370205825844
Task_38339,2804,570,136,78,214,4.910683012259194,53.30935085356396
Task_38340,1925,859,24,78,102,2.238372093023256,39.46075085136794
Task_38341,1003,93,193,57,250,10.670212765957446,22.563828991160978
Task_38342,2997,894,110,191,301,3.3486033519553073,58.247435537930414
Task_38343,682,812,137,106,243,0.8388683886838868,20.84216267807057
Task_38344,583,75,15,18,33,7.671052631578948,13.258055130745412
Task_38345,1901,601,25,118,143,3.1578073089700998,38.89470508149315
Task_38346,2331,497,60,130,190,4.680722891566265,45.96784730211391
Task_38347,1762,617,118,175,293,2.8511326860841426,37.75333823170734
Task_38348,1899,525,84,96,180,3.6102661596958177,38.90361752380668
Task_38349,1588,281,68,163,231,5.631205673758865,33.741287604320625
Task_38350,1842,269,73,50,123,6.822222222222222,36.07396107393199
Task_38351,1643,992,199,46,245,1.6545820745216515,35.926277594308765
Task_38352,1389,373,96,133,229,3.713903743315508,30.77536558222973
Task_38353,1591,822,97,147,244,1.9331713244228432,35.44751471892324
Task_38354,1763,554,183,54,237,3.1765765765765765,36.68465259350621
Task_38355,2815,976,85,179,264,2.881269191402252,55.48292038341299
Task_38356,738,151,30,53,83,4.855263157894737,17.676075635207
Task_38357,2497,570,107,89,196,4.373029772329247,48.49321717050494
Task_38358,2827,459,69,182,251,6.145652173913043,54.05186170226785
Task_38359,1320,428,176,146,322,3.076923076923077,30.245374863015574
Task_38360,2033,539,150,94,244,3.7648148148148146,41.40274659628265
Task_38361,2006,321,177,129,306,6.229813664596273,40.65149106960859
Task_38362,2947,133,123,45,168,21.992537313432837,52.6848892183954
Task_38363,1937,767,147,115,262,2.5221354166666665,40.76814533806729
Task_38364,500,523,17,193,210,0.9541984732824428,16.900381786010445
Task_38365,2497,902,79,18,97,2.7652270210409746,47.90595240296645
Task_38366,1646,445,81,176,257,3.690582959641256,35.31395769880552
Task_38367,2901,798,113,174,287,3.6307884856070087,56.3369056991671
Task_38368,812,206,118,13,131,3.922705314009662,19.423701063547906
Task_38369,2213,432,77,27,104,5.1108545034642034,42.10012771739661
Task_38370,2969,440,139,82,221,6.732426303854876,55.55009853876758
Task_38371,2431,167,179,20,199,14.470238095238095,45.19256405666406
Task_38372,837,552,174,155,329,1.5135623869801085,22.991645950314183
Task_38373,527,582,167,185,352,0.9039451114922813,18.298210518338138
Task_38374,1320,467,168,183,351,2.8205128205128207,30.554297011771904
Task_38375,619,571,184,73,257,1.082167832167832,18.726151013274638
Task_38376,2905,733,102,136,238,3.957765667574932,55.918755093325196
Task_38377,1408,103,15,116,131,13.538461538461538,28.426595029646553
Task_38378,1012,75,46,140,186,13.31578947368421,22.720408923646193
Task_38379,1473,799,119,63,182,1.84125,32.424019236185025
Task_38380,1457,1003,34,78,112,1.451195219123506,32.562855530463494
Task_38381,521,939,67,154,221,0.5542553191489362,18.870922499463685
Task_38382,1419,410,181,53,234,3.4525547445255476,30.81413895156797
Task_38383,1114,773,173,118,291,1.4392764857881137,27.815353662545423
Task_38384,2174,84,169,99,268,25.576470588235296,41.40514518758043
Task_38385,2614,745,112,185,297,3.5040214477211795,51.68448351816411
Task_38386,1024,979,195,117,312,1.0448979591836736,27.060843524759182
Task_38387,1941,956,12,162,174,2.0282131661442007,41.033213743084424
Task_38388,1407,863,29,51,80,1.6284722222222223,30.668723373830982
Task_38389,2099,185,59,142,201,11.28494623655914,41.1458544588267
Task_38390,2280,117,66,119,185,19.322033898305083,43.123784499835246
Task_38391,1306,973,111,55,166,1.3408624229979467,30.323618866864553
Task_38392,1052,343,133,94,227,3.058139534883721,25.1730881732184
Task_38393,1001,986,38,10,48,1.0141843971631206,23.821554999888615
Task_38394,554,321,81,117,198,1.720496894409938,17.27564358738634
Task_38395,1954,996,23,82,105,1.9598796389167503,40.461248606091644
Task_38396,2669,253,94,194,288,10.507874015748031,50.9899696325483
Task_38397,2159,268,58,129,187,8.026022304832713,42.46811608224838
Task_38398,1604,467,17,63,80,3.427350427350427,32.6056624687721
Task_38399,2779,201,33,61,94,13.757425742574258,50.437005499845405
Task_38400,981,566,122,111,233,1.7301587301587302,24.847647490549225
Task_38401,1858,815,82,131,213,2.2769607843137254,39.56149317709815
Task_38402,795,819,197,20,217,0.9695121951219512,21.76907593714411
Task_38403,2199,1001,11,73,84,2.194610778443114,43.928992499320366
Task_38404,576,779,82,120,202,0.7384615384615385,18.95737582053307
Task_38405,2318,479,15,72,87,4.829166666666667,44.21170447212211
Task_38406,1059,496,121,96,217,2.130784708249497,25.806278475733226
Task_38407,2646,687,120,94,214,3.8459302325581395,51.445301038236174
Task_38408,922,304,168,40,208,3.0229508196721313,22.197450171539757
Task_38409,653,985,104,149,253,0.6622718052738337,21.172034282091147
Task_38410,2807,266,37,32,69,10.513108614232209,50.287598920385534
Task_38411,994,610,124,103,227,1.6268412438625204,25.152039701331102
Task_38412,1039,947,71,139,210,1.0959915611814346,26.833903452572827
Task_38413,2263,373,81,20,101,6.050802139037433,42.48419286230296
Task_38414,2760,424,158,36,194,6.4941176470588236,51.608238127874365
Task_38415,943,631,133,197,330,1.4920886075949367,24.982471954130265
Task_38416,1425,412,87,158,245,3.450363196125908,31.53494968318652
Task_38417,2769,325,88,101,189,8.493865030674847,52.15582440662572
Task_38418,2438,455,24,76,100,5.3464912280701755,46.22641142245745
Task_38419,2126,778,168,92,260,2.729139922978177,43.653340789833315
Task_38420,2089,824,193,55,248,2.532121212121212,42.77748947113363
Task_38421,1451,455,109,78,187,3.182017543859649,31.350653088013825
Task_38422,749,237,149,114,263,3.1470588235294117,20.286394150819472
Task_38423,2018,616,99,181,280,3.2706645056726096,41.756420053119214
Task_38424,1779,810,94,125,219,2.193588162762022,38.30388887603468
Task_38425,2821,208,137,67,204,13.497607655502392,52.1261421238676
Task_38426,1445,924,55,73,128,1.5621621621621622,32.5761997826442
Task_38427,2901,760,37,100,137,3.812089356110381,55.16202357115454
Task_38428,2252,735,171,196,367,3.0597826086956523,46.250019506249316
Task_38429,1717,965,63,122,185,1.7774327122153208,37.54683647479158
Task_38430,2377,165,175,147,322,14.319277108433734,45.73819871890001
Task_38431,2412,344,14,37,51,6.991304347826087,44.469756521952284
Task_38432,2713,293,99,136,235,9.227891156462585,51.425104460687216
Task_38433,1150,482,115,79,194,2.380952380952381,26.755823032120066
Task_38434,2289,336,94,173,267,6.792284866468843,45.15044517999474
Task_38435,2499,927,188,188,376,2.6928879310344827,50.79322048989085
Task_38436,712,89,64,91,155,7.911111111111111,17.591064620195176
Task_38437,734,503,142,31,173,1.4563492063492063,19.614903502057306
Task_38438,2137,999,168,94,262,2.137,44.573930718989224
Task_38439,2768,636,196,42,238,4.345368916797488,52.60712837806036
Task_38440,2174,536,196,137,333,4.048417132216015,44.14541812044174
Task_38441,2412,619,43,125,168,3.890322580645161,47.24269761286967
Task_38442,1625,526,99,130,229,3.0834914611005693,34.94388726229718
Task_38443,550,163,125,158,283,3.3536585365853657,16.763760979806843
Task_38444,1823,859,169,162,331,2.119767441860465,39.62894910789834
Task_38445,1371,72,98,194,292,18.78082191780822,28.954789387596104
Task_38446,2953,1007,197,11,208,2.929563492063492,56.42984841553015
Task_38447,1213,758,162,24,186,1.598155467720685,27.947525121350946
Task_38448,1675,521,126,152,278,3.2088122605363987,35.97108225916643
Task_38449,1300,887,106,117,223,1.4639639639639639,30.808093594988645
Task_38450,2499,562,46,122,168,4.438721136767318,48.45509234956206
Task_38451,973,643,117,112,229,1.5108695652173914,24.91514951852913
Task_38452,1404,568,189,55,244,2.467486818980668,31.1071688601033
Task_38453,1920,986,197,179,376,1.9452887537993921,41.788703431479554
Task_38454,2390,486,53,20,73,4.907597535934292,44.20990074033728
Task_38455,784,979,191,145,336,0.8,23.486171852344985
Task_38456,687,338,105,33,138,2.0265486725663715,17.990823934386462
Task_38457,2915,238,171,176,347,12.196652719665272,54.975231825679884
Task_38458,2714,191,192,134,326,14.135416666666666,51.44535871774082
Task_38459,1065,304,122,142,264,3.4918032786885247,25.545208613222158
Task_38460,2382,183,73,193,266,12.945652173913043,45.987667230431775
Task_38461,2210,665,44,180,224,3.3183183183183185,44.710107041172364
Task_38462,1314,149,166,170,336,8.76,29.00138157118677
Task_38463,810,1022,117,115,232,0.7917888563049853,23.530197332480583
Task_38464,1629,521,68,23,91,3.1206896551724137,33.005887930678206
Task_38465,2738,836,144,18,162,3.271206690561529,51.9162261648448
Task_38466,1910,945,132,17,149,2.019027484143763,39.09151832446137
Task_38467,851,971,181,139,320,0.8755144032921811,24.41522664373873
Task_38468,2227,706,127,16,143,3.14992927864215,43.40835284161591
Task_38469,591,66,187,157,344,8.82089552238806,17.013877166897675
Task_38470,2504,241,18,108,126,10.347107438016529,47.16061361117468
Task_38471,2340,344,92,138,230,6.782608695652174,45.75986034358763
Task_38472,2892,206,157,93,250,13.971014492753623,53.859846483596165
Task_38473,1257,780,117,21,138,1.6094750320102433,28.308243582479985
Task_38474,2315,877,191,38,229,2.6366742596810933,46.188478041478255
Task_38475,2689,820,198,83,281,3.275274056029233,52.5934584158245
Task_38476,2218,584,103,44,147,3.7914529914529913,43.04933519841643
Task_38477,1803,1004,124,133,257,1.7940298507462686,39.386726112122844
Task_38478,1682,284,173,138,311,5.901754385964912,35.43905537553547
Task_38479,2556,553,165,94,259,4.613718411552346,49.79627296551981
Task_38480,2465,740,177,63,240,3.326585695006748,48.4114880909163
Task_38481,705,648,27,160,187,1.086286594761171,20.384675263190392
Task_38482,699,90,140,33,173,7.681318681318682,17.09441905847856
Task_38483,1112,294,10,42,52,3.769491525423729,23.702417741063034
Task_38484,1016,453,57,173,230,2.237885462555066,25.296794541162015
Task_38485,717,850,49,159,208,0.8425381903642774,21.50214073927927
Task_38486,1010,189,28,49,77,5.315789473684211,21.946255329223003
Task_38487,680,138,124,136,260,4.892086330935252,18.53467471657557
Task_38488,2090,108,15,145,160,19.174311926605505,39.41996392565712
Task_38489,1433,282,82,38,120,5.063604240282685,29.42626832275789
Task_38490,1522,804,162,153,315,1.8906832298136647,34.60340648288441
Task_38491,2952,588,37,45,82,5.01188455008489,54.07367681746411
Task_38492,2564,792,189,115,304,3.2332912988650695,50.96908937216972
Task_38493,1967,231,76,113,189,8.47844827586207,39.281201800784665
Task_38494,2502,392,85,168,253,6.366412213740458,48.60124487171723
Task_38495,2913,223,50,120,170,13.004464285714286,54.00610048923795
Task_38496,2013,660,175,84,259,3.0453857791225416,41.2837303884379
Task_38497,2909,584,182,192,374,4.972649572649573,56.203039086618354
Task_38498,1257,871,177,32,209,1.44151376146789,29.283744709018197
Task_38499,2686,159,51,59,110,16.7875,48.60761421043898
Task_38500,792,75,80,132,212,10.421052631578947,19.568140764380892
Task_38501,2949,803,152,58,210,3.667910447761194,56.08414777311261
Task_38502,1405,1014,59,114,173,1.3842364532019704,32.69086614707761
Task_38503,1352,848,67,131,198,1.5924617196702002,31.59596418245977
Task_38504,1284,124,182,37,219,10.272,26.991459473209815
Task_38505,1857,770,180,161,341,2.4085603112840466,39.93362764319787
Task_38506,1429,981,40,10,50,1.455193482688391,30.504595810451317
Task_38507,563,237,132,200,332,2.365546218487395,17.785277947301303
Task_38508,1142,365,105,133,238,3.120218579234973,26.829717136897454
Task_38509,2705,640,29,190,219,4.21996879875195,52.49054077430896
Task_38510,2005,570,165,166,331,3.51138353765324,41.61112661863543
Task_38511,1921,653,123,31,154,2.937308868501529,38.58109894964289
Task_38512,1134,838,154,140,294,1.3516090584028606,28.407552119623094
Task_38513,2510,337,149,12,161,7.42603550295858,46.805054731987006
Task_38514,2822,256,140,118,258,10.980544747081712,53.08834784048596
Task_38515,970,953,188,190,378,1.0167714884696017,26.52152497075987
Task_38516,1424,535,129,126,255,2.656716417910448,31.89949909022353
Task_38517,1688,417,47,147,194,4.038277511961723,35.50884592442174
Task_38518,863,865,46,113,159,0.9965357967667436,23.111697493726222
Task_38519,1302,543,38,37,75,2.3933823529411766,27.408018063398913
Task_38520,1411,824,89,134,223,1.7103030303030302,32.49086080136319
Task_38521,1500,691,153,162,315,2.167630057803468,33.91573419601627
Task_38522,888,247,11,18,29,3.5806451612903225,19.446799281086616
Task_38523,1058,962,41,200,241,1.09865005192108,27.243749208936947
Task_38524,1954,501,121,95,216,3.8924302788844622,39.93339417602139
Task_38525,2391,804,92,48,140,2.9701863354037266,46.56901428205588
Task_38526,2537,862,30,40,70,2.939745075318656,48.00813292786601
Task_38527,2888,119,86,74,160,24.066666666666666,51.86246108638412
Task_38528,2585,355,105,126,231,7.26123595505618,49.58193398298706
Task_38529,2374,970,139,52,191,2.4449021627188467,47.50113086107488
Task_38530,2357,945,63,15,78,2.4915433403805496,45.19623003328234
Task_38531,2118,390,168,35,203,5.41687979539642,41.381194799418886
Task_38532,2552,191,111,86,197,13.291666666666666,48.054432728833376
Task_38533,880,661,64,39,103,1.3293051359516617,21.539665596784292
Task_38534,2676,213,94,49,143,12.504672897196262,49.2187444066217
Task_38535,1704,244,162,193,355,6.955102040816326,35.92736988538298
Task_38536,815,77,145,130,275,10.448717948717949,20.094699778075526
Task_38537,2243,476,19,55,74,4.70230607966457,42.43521306192019
Task_38538,518,717,104,71,175,0.7214484679665738,17.28376480925353
Task_38539,1209,71,28,67,95,16.791666666666668,24.33227848362401
Task_38540,1314,186,133,96,229,7.026737967914438,29.039774977623622
Task_38541,1689,759,199,151,350,2.2223684210526318,37.263688252952164
Task_38542,1127,349,30,110,140,3.22,25.79519541953837
Task_38543,873,339,23,87,110,2.5676470588235296,21.443703175080298
Task_38544,1103,810,45,167,212,1.3600493218249075,27.454899285178158
Task_38545,556,746,120,140,260,0.7443105756358769,18.722320454622334
Task_38546,1703,474,58,107,165,3.5852631578947367,35.768337373102604
Task_38547,553,154,188,119,307,3.567741935483871,16.81187694044051
Task_38548,2741,393,81,176,257,6.956852791878172,52.4723448511946
Task_38549,1086,940,157,92,249,1.1540913921360254,27.54309207569264
Task_38550,2436,667,162,40,202,3.6467065868263475,47.29320661187225
Task_38551,2052,371,25,159,184,5.516129032258065,40.918707052651094
Task_38552,979,874,192,24,216,1.1188571428571428,24.816453188151502
Task_38553,2502,717,57,145,202,3.4846796657381613,49.49391535669983
Task_38554,2966,133,22,171,193,22.134328358208954,54.1382206627135
Task_38555,2161,184,166,192,358,11.68108108108108,42.778978218391764
Task_38556,2646,935,131,168,299,2.826923076923077,52.77117905701207
Task_38557,1244,229,33,105,138,5.408695652173913,27.225496955503758
Task_38558,1310,385,126,51,177,3.393782383419689,28.506219036338184
Task_38559,2392,353,52,10,62,6.757062146892656,43.81994970403986
Task_38560,2281,643,192,87,279,3.5419254658385095,45.60889569806065
Task_38561,2048,189,40,92,132,10.778947368421052,39.83031734816894
Task_38562,942,641,25,137,162,1.4672897196261683,23.913565419984593
Task_38563,2742,413,183,12,195,6.6231884057971016,51.14569975751354
Task_38564,2406,806,139,121,260,2.9814126394052045,48.32027759191036
Task_38565,2767,956,143,69,212,2.891327063740857,53.74665378931181
Task_38566,509,995,24,111,135,0.5110441767068273,17.985017333391713
Task_38567,2994,479,72,176,248,6.2375,56.74417537193756
Task_38568,994,950,70,90,160,1.0452155625657202,25.392446701990476
Task_38569,2096,434,42,139,181,4.818390804597701,41.73146960458151
Task_38570,1909,802,154,101,255,2.37733499377335,40.38183565645219
Task_38571,1337,216,31,51,82,6.161290322580645,27.5958881066436
Task_38572,2520,292,193,81,274,8.600682593856655,48.14070747104433
Task_38573,609,628,67,108,175,0.9682034976152624,18.80656075938985
Task_38574,1196,614,50,178,228,1.9447154471544716,28.68097116456318
Task_38575,1371,793,68,141,209,1.7267002518891688,31.7903312099135
Task_38576,2650,331,44,14,58,7.981927710843373,47.85043460293951
Task_38577,1775,398,185,153,338,4.448621553884712,37.43145082563723
Task_38578,538,528,63,56,119,1.0170132325141776,16.204821118603665
Task_38579,2230,241,168,119,287,9.214876033057852,43.81142564507834
Task_38580,2974,78,64,16,80,37.64556962025316,51.38977565619464
Task_38581,861,186,77,107,184,4.60427807486631,21.63148270922017
Task_38582,708,559,76,150,226,1.2642857142857142,20.566473139111885
Task_38583,2916,324,144,198,342,8.972307692307693,55.31606220126895
Task_38584,798,322,110,49,159,2.4705882352941178,19.852050318970228
Task_38585,863,833,72,15,87,1.0347721822541966,21.805441053179702
Task_38586,2324,962,121,197,318,2.4132917964693665,47.88106084378418
Task_38587,590,864,65,100,165,0.6820809248554913,19.36157507467494
Task_38588,2942,447,47,109,156,6.566964285714286,54.90474852531302
Task_38589,926,169,176,154,330,5.447058823529412,22.940264330340995
Task_38590,2792,99,22,166,188,27.92,50.852249008659676
Task_38591,1370,986,78,188,266,1.3880445795339413,32.65702762985474
Task_38592,1042,525,67,145,212,1.9809885931558935,25.776070304572468
Task_38593,1333,764,117,144,261,1.742483660130719,31.214657626381836
Task_38594,2226,354,67,191,258,6.270422535211267,44.23891474430615
Task_38595,901,378,155,86,241,2.3773087071240107,22.739008481912833
Task_38596,2291,104,200,43,243,21.81904761904762,42.586649261533836
Task_38597,569,514,197,21,218,1.104854368932039,17.184079848726412
Task_38598,2754,698,176,111,287,3.939914163090129,53.60031617432634
Task_38599,788,213,31,67,98,3.682242990654206,19.22854615517016
Task_38600,644,756,98,76,174,0.8507265521796565,19.37413494386261
Task_38601,1032,291,88,166,254,3.5342465753424657,24.990819123375235
Task_38602,1985,859,68,73,141,2.308139534883721,40.71961282242694
Task_38603,600,209,33,38,71,2.857142857142857,15.335357254094255
Task_38604,2400,159,115,114,229,15.0,45.61938731270012
Task_38605,1353,854,40,44,84,1.5824561403508772,29.6037008742704
Task_38606,2576,841,109,36,145,3.0593824228028503,49.61997528568967
Task_38607,1534,530,115,155,270,2.888888888888889,33.735488480012215
Task_38608,1192,712,110,188,298,1.6718092566619915,29.050457932477638
Task_38609,1984,786,180,183,363,2.5209656925031765,42.12704212140763
Task_38610,1138,395,151,192,343,2.8737373737373737,27.422139801957172
Task_38611,1514,853,76,44,120,1.7728337236533958,32.48485498840483
Task_38612,1302,203,54,102,156,6.382352941176471,28.240217893974634
Task_38613,1933,349,166,94,260,5.522857142857143,39.27657047885835
Task_38614,958,294,77,178,255,3.247457627118644,23.959101816526715
Task_38615,2745,118,144,45,189,23.067226890756302,49.70003446824902
Task_38616,1835,788,83,77,160,2.3257287705956906,38.12112360262335
Task_38617,833,438,196,87,283,1.89749430523918,22.05305666254509
Task_38618,1730,72,35,162,197,23.698630136986303,34.140414549486216
Task_38619,1520,991,70,11,81,1.532258064516129,32.62679807961339
Task_38620,643,138,71,133,204,4.625899280575539,17.796738372913953
Task_38621,1754,354,79,153,232,4.940845070422535,36.60822850359308
Task_38622,809,448,87,171,258,1.8017817371937639,21.977802284840322
Task_38623,1320,694,177,16,193,1.8992805755395683,29.486673051902937
Task_38624,586,257,106,173,279,2.2713178294573644,17.93466016954545
Task_38625,1397,480,181,155,336,2.9043659043659042,31.705739725310053
Task_38626,1694,107,142,113,255,15.685185185185185,33.96420930543929
Task_38627,1472,618,11,48,59,2.378029079159935,30.407489464793954
Task_38628,1955,827,198,113,311,2.361111111111111,41.458650972074814
Task_38629,616,484,67,116,183,1.270103092783505,18.41380593920311
Task_38630,1681,1022,176,124,300,1.643206256109482,37.67638492055599
Task_38631,2420,1019,44,68,112,2.372549019607843,47.82022945261133
Task_38632,1192,392,172,48,220,3.0330788804071247,26.812645049461892
Task_38633,1874,952,17,167,184,1.9664218258132213,39.838784835525644
Task_38634,1964,678,132,34,166,2.8924889543446244,39.54872945382791
Task_38635,2380,576,176,158,334,4.124783362218371,47.57025513462013
Task_38636,2236,505,106,154,260,4.4189723320158105,44.72364174547746
Task_38637,1617,891,140,35,175,1.812780269058296,34.83619579960799
Task_38638,2126,798,61,169,230,2.6608260325406756,43.92228400110147
Task_38639,1441,577,17,106,123,2.4930795847750864,31.350103490414835
Task_38640,570,510,147,21,168,1.1154598825831703,16.72522038487035
Task_38641,1649,836,63,36,99,1.9701314217443249,34.2215905951347
Task_38642,2230,70,64,57,121,31.408450704225352,40.570119698570615
Task_38643,2846,539,125,36,161,5.270370370370371,52.92434401808983
Task_38644,1369,965,45,183,228,1.4171842650103519,32.224232056445835
Task_38645,2479,163,59,59,118,15.115853658536585,45.42586117120137
Task_38646,2023,965,170,122,292,2.0942028985507246,42.89349047312305
Task_38647,2536,892,96,156,252,2.83986562150056,50.71725490655132
Task_38648,1797,251,33,123,156,7.130952380952381,36.1601814518747
Task_38649,2756,224,52,156,208,12.248888888888889,51.92317090051406
Task_38650,2926,329,128,69,197,8.866666666666667,54.17885273434076
Task_38651,1738,933,81,174,255,1.860813704496788,38.291007242952
Task_38652,1332,425,67,35,102,3.1267605633802815,28.104361964836944
Task_38653,2746,350,195,172,367,7.823361823361823,52.792005132000725
Task_38654,2328,209,165,88,253,11.085714285714285,44.78747204861677
Task_38655,1093,193,142,66,208,5.634020618556701,24.907679980313514
Task_38656,2695,431,78,103,181,6.238425925925926,51.26598818154232
Task_38657,956,353,192,37,229,2.7005649717514126,23.00349770860062
Task_38658,883,920,66,87,153,0.9587404994571118,23.497352945510062
Task_38659,1149,756,159,104,263,1.5178335535006604,28.1959248548721
Task_38660,2248,706,38,183,221,3.1796322489391797,45.430826762063475
Task_38661,1873,457,109,101,210,4.0895196506550215,38.51997572750894
Task_38662,2270,805,153,99,252,2.8163771712158807,46.07935951767422
Task_38663,2750,884,159,14,173,3.1073446327683616,52.560334104141255
Task_38664,2452,417,85,176,261,5.866028708133971,47.94065413191202
Task_38665,1442,376,195,113,308,3.8249336870026527,31.897459863638485
Task_38666,1187,311,49,174,223,3.8044871794871793,27.519985690783216
Task_38667,2074,546,85,90,175,3.7915904936014626,41.61625206267189
Task_38668,2729,400,100,133,233,6.805486284289277,52.03101869994837
Task_38669,685,597,120,57,177,1.145484949832776,19.23944815577738
Task_38670,1484,898,200,191,391,1.6507230255839822,34.67830495199639
Task_38671,1402,705,38,82,120,1.9858356940509916,31.013601426041976
Task_38672,1327,106,197,38,235,12.401869158878505,27.44449516914493
Task_38673,1677,546,165,115,280,3.0658135283363803,36.03672098006752
Task_38674,2726,354,84,91,175,7.67887323943662,51.334181489761676
Task_38675,2867,397,121,161,282,7.203517587939698,54.46647957529433
Task_38676,2050,800,141,158,299,2.5593008739076155,42.89133786059071
Task_38677,1210,519,125,16,141,2.326923076923077,26.68450786176571
Task_38678,2095,556,197,84,281,3.761220825852783,42.35251760030343
Task_38679,1221,367,23,61,84,3.317934782608696,26.272316325649882
Task_38680,918,779,53,149,202,1.176923076923077,24.484173234005365
Task_38681,1368,426,28,139,167,3.2037470725995316,30.144039806424974
Task_38682,2419,290,193,149,342,8.312714776632303,47.26625560334694
Task_38683,2942,144,176,88,264,20.28965517241379,54.022145049160265
Task_38684,1645,864,31,94,125,1.9017341040462428,35.604180774264954
Task_38685,2403,535,60,190,250,4.483208955223881,47.59966552360009
Task_38686,731,961,150,85,235,0.7598752598752598,21.78702863613465
Task_38687,2655,601,93,169,262,4.410299003322259,51.80848150913898
Task_38688,2496,409,130,197,327,6.087804878048781,48.89145300458032
Task_38689,2053,743,108,177,285,2.7594086021505375,42.725229002365104
Task_38690,651,421,80,107,187,1.542654028436019,19.021047390366316
Task_38691,1722,888,42,69,111,1.937007874015748,36.33634538957821
Task_38692,898,183,37,162,199,4.880434782608695,22.11541396971545
Task_38693,1745,131,106,38,144,13.219696969696969,33.58629386661156
Task_38694,2997,391,82,44,126,7.645408163265306,54.63741413030081
Task_38695,2467,949,164,178,342,2.596842105263158,50.18688425854407
Task_38696,893,290,19,75,94,3.06872852233677,21.15060025770385
Task_38697,1325,315,148,149,297,4.193037974683544,29.85131303790285
Task_38698,2896,216,48,21,69,13.345622119815669,51.465741222625546
Task_38699,2868,198,91,164,255,14.412060301507537,53.738228520259334
Task_38700,2272,924,190,26,216,2.456216216216216,45.521123545670896
Task_38701,2718,885,184,85,269,3.0677200902934536,53.22407560046617
Task_38702,2857,316,188,153,341,9.012618296529968,54.28444799565341
Task_38703,2744,338,86,170,256,8.094395280235988,52.257935249501934
Task_38704,1493,297,84,43,127,5.010067114093959,30.50145330653636
Task_38705,1695,92,52,167,219,18.225806451612904,33.9067271936028
Task_38706,2509,757,78,11,89,3.3100263852242744,47.62548051879825
Task_38707,1210,84,84,128,212,14.235294117647058,26.09423224545993
Task_38708,744,314,12,200,212,2.361904761904762,20.354464496993014
Task_38709,657,844,131,155,286,0.7775147928994083,20.842519994054545
Task_38710,1997,176,178,178,356,11.282485875706215,39.8710820731178
Task_38711,1435,221,154,115,269,6.463963963963964,31.095334101864534
Task_38712,2736,288,96,31,127,9.46712802768166,50.25803156326631
Task_38713,1566,670,46,36,82,2.3338301043219074,32.41125884817029
Task_38714,2255,1018,34,111,145,2.212953876349362,45.826599789628496
Task_38715,2501,107,165,37,202,23.15740740740741,45.73665106207064
Task_38716,2559,562,143,10,153,4.5452930728241565,48.24029038416632
Task_38717,1986,776,54,132,186,2.555984555984556,41.2841165358833
Task_38718,1608,554,144,108,252,2.8972972972972975,34.83298721583842
Task_38719,1885,458,106,167,273,4.106753812636166,39.093827586651166
Task_38720,1737,339,24,46,70,5.108823529411764,33.66555773486818
Task_38721,841,83,176,69,245,10.011904761904763,19.84166983060432
Task_38722,1978,516,93,61,154,3.8259187620889747,39.32651826837352
Task_38723,861,420,78,104,182,2.045130641330166,22.21182856419003
Task_38724,791,479,36,26,62,1.6479166666666667,19.11557738050162
Task_38725,1835,599,10,177,187,3.058333333333333,38.34258409633866
Task_38726,1599,381,149,40,189,4.18586387434555,33.0393908383085
Task_38727,1355,335,175,40,215,4.032738095238095,29.177019825315245
Task_38728,2941,119,84,27,111,24.508333333333333,51.976855148119476
Task_38729,1176,610,45,72,117,1.9247135842880523,26.971521691249947
Task_38730,2508,978,172,16,188,2.561797752808989,49.13164151149425
Task_38731,1517,688,169,31,200,2.201741654571843,32.7953182606276
Task_38732,2747,838,37,19,56,3.2741358760429082,50.991154062415085
Task_38733,2528,215,49,163,212,11.703703703703704,48.306649433091614
Task_38734,2280,500,10,199,209,4.550898203592815,45.24226153468235
Task_38735,1082,603,194,89,283,1.7913907284768211,26.581645236054953
Task_38736,2360,469,147,62,209,5.0212765957446805,45.71303276199524
Task_38737,834,589,188,135,323,1.4135593220338982,22.977410949794784
Task_38738,715,547,108,188,296,1.3047445255474452,20.9197773674063
Task_38739,1276,124,17,130,147,10.208,26.65889965185359
Task_38740,1651,133,150,155,305,12.32089552238806,33.97729853140874
Task_38741,2949,448,183,41,224,6.567928730512249,54.806554002255304
Task_38742,966,410,18,99,117,2.3503649635036497,23.232182006945127
Task_38743,2811,869,135,97,232,3.231034482758621,54.8067486293511
Task_38744,2371,1020,195,47,242,2.3222331047992166,47.54660770033778
Task_38745,1693,789,168,168,336,2.143037974683544,37.382472708950864
Task_38746,799,89,190,47,237,8.877777777777778,18.975401635786824
Task_38747,1760,880,134,90,224,1.9977298524404086,37.94350058470982
Task_38748,2672,87,25,119,144,30.363636363636363,48.26196027219776
Task_38749,1304,278,74,114,188,4.673835125448028,28.948769183848558
Task_38750,1024,465,184,61,245,2.1974248927038627,24.67711526807865
Task_38751,1840,754,172,76,248,2.437086092715232,38.70911636998659
Task_38752,2076,177,58,88,146,11.662921348314606,39.680446959132205
Task_38753,871,72,98,29,127,11.931506849315069,19.06226313852431
Task_38754,1730,169,108,160,268,10.176470588235293,35.34882801039204
Task_38755,2894,435,10,150,160,6.637614678899083,54.14528034865656
Task_38756,759,584,194,152,346,1.2974358974358975,21.87904467392599
Task_38757,1240,741,145,180,325,1.6711590296495957,30.01103242215106
Task_38758,875,287,170,105,275,3.0381944444444446,22.48148086763656
Task_38759,1586,596,22,144,166,2.6566164154103853,34.08067254936482
Task_38760,734,538,65,124,189,1.3617810760667903,20.707056084840076
Task_38761,1978,486,103,116,219,4.061601642710472,40.33774602319661
Task_38762,912,565,43,135,178,1.6113074204946995,23.371096098443264
Task_38763,1642,417,167,132,299,3.9282296650717705,35.18176921655007
Task_38764,2793,563,47,55,102,4.952127659574468,51.953384178164946
Task_38765,1358,637,47,175,222,2.128526645768025,31.148037630062717
Task_38766,2923,722,136,198,334,4.0428769017980635,56.69267929697164
Task_38767,2121,221,98,137,235,9.554054054054054,41.82146558305341
Task_38768,1769,77,32,67,99,22.67948717948718,33.278373211927004
Task_38769,1002,91,180,121,301,10.891304347826088,23.275509087284036
Task_38770,1517,767,87,64,151,1.9752604166666667,32.755423043459224
Task_38771,1016,422,174,194,368,2.4018912529550827,25.69295575701929
Task_38772,1547,787,10,129,139,1.9631979695431472,33.79864131070297
Task_38773,592,299,31,82,113,1.9733333333333334,16.952482380439594
Task_38774,2424,348,51,177,228,6.945558739255015,47.268637349543546
Task_38775,2748,199,57,106,163,13.74,51.25172094312648
Task_38776,2314,341,103,160,263,6.766081871345029,45.441929287066664
Task_38777,1825,618,86,10,96,2.9483037156704364,36.40843515677173
Task_38778,1028,121,97,152,249,8.426229508196721,23.88250979983359
Task_38779,1802,943,186,27,213,1.9088983050847457,38.107411837286605
Task_38780,1485,597,27,81,108,2.483277591973244,31.798332525005307
Task_38781,1986,479,90,122,212,4.1375,40.46843117670026
Task_38782,1314,389,62,187,249,3.3692307692307693,29.884727539353307
Task_38783,1056,458,21,96,117,2.3006535947712417,24.845597785765012
Task_38784,859,259,56,197,253,3.3038461538461537,22.331766220833973
Task_38785,1360,134,93,75,168,10.074074074074074,28.09890867935988
Task_38786,949,189,148,29,177,4.994736842105263,22.027327038818697
Task_38787,2085,224,170,141,311,9.266666666666667,41.598645239523385
Task_38788,1352,342,36,35,71,3.941690962099125,27.565728745795194
Task_38789,2328,907,186,157,343,2.563876651982379,47.82703292911517
Task_38790,1956,440,76,168,244,4.4353741496598635,40.1685115967334
Task_38791,987,171,105,103,208,5.738372093023256,23.204943226760633
Task_38792,2935,556,133,50,183,5.269299820466786,54.640217962717514
Task_38793,1834,593,151,173,324,3.0875420875420874,38.95471254344056
Task_38794,2735,780,22,193,215,3.501920614596671,53.32315508646929
Task_38795,1992,432,196,166,362,4.600461893764434,41.103072773521376
Task_38796,1090,147,97,83,180,7.364864864864865,24.167076163241745
Task_38797,2674,860,51,57,108,3.105691056910569,51.05515891963977
Task_38798,854,468,140,94,234,1.8208955223880596,22.467717764622904
Task_38799,2412,388,71,180,251,6.200514138817481,47.252144569662256
Task_38800,2391,497,185,192,377,4.801204819277109,47.73478084762911
Task_38801,2672,553,72,173,245,4.823104693140794,51.86829490003807
Task_38802,2396,748,193,98,291,3.198931909212283,48.08914515598918
Task_38803,1208,650,102,142,244,1.8556067588325653,28.81330487812509
Task_38804,578,551,94,118,212,1.0471014492753623,18.300598834989128
Task_38805,2259,152,142,111,253,14.764705882352942,43.43621556006684
Task_38806,2278,928,167,72,239,2.4520990312163615,46.09089977576024
Task_38807,2202,88,125,32,157,24.741573033707866,40.33092647564313
Task_38808,705,928,28,43,71,0.7588805166846071,19.2697378859942
Task_38809,2038,810,154,170,324,2.5129469790382246,42.862736197955805
Task_38810,1293,907,156,75,231,1.4240088105726871,30.377953714686413
Task_38811,1738,258,95,36,131,6.710424710424711,34.47671105407468
Task_38812,2686,941,37,29,66,2.851380042462845,50.58039916426005
Task_38813,773,634,45,19,64,1.2173228346456693,19.069565862570393
Task_38814,1854,838,69,16,85,2.209773539928486,37.38801423455755
Task_38815,1805,693,134,124,258,2.6008645533141213,38.44060258488688
Task_38816,1898,1024,88,191,279,1.8517073170731708,41.15808760787374
Task_38817,2985,310,57,124,181,9.59807073954984,55.49991546721193
Task_38818,628,389,69,51,120,1.6102564102564103,17.346203963421026
Task_38819,926,619,92,55,147,1.4935483870967743,23.093952725077504
Task_38820,625,651,161,69,230,0.9585889570552147,19.009857785493036
Task_38821,1513,484,47,144,191,3.1195876288659794,32.93546028328244
Task_38822,2587,156,75,36,111,16.477707006369428,46.79508808287644
Task_38823,1335,750,127,43,170,1.77762982689747,29.750623257537853
Task_38824,2984,691,107,28,135,4.312138728323699,55.47934658984969
Task_38825,1750,453,181,130,311,3.854625550660793,37.05797609617182
Task_38826,2133,620,24,75,99,3.4347826086956523,41.847155468615945
Task_38827,2232,598,46,35,81,3.7262103505843074,42.774206779402505
Task_38828,2149,787,143,25,168,2.7271573604060912,42.70533009043512
Task_38829,2935,699,136,38,174,4.192857142857143,55.13449032257039
Task_38830,831,968,177,199,376,0.8575851393188855,24.429376830334135
Task_38831,2655,557,163,43,206,4.758064516129032,50.422417921283134
Task_38832,2501,314,137,163,300,7.93968253968254,48.47791234158196
Task_38833,664,683,105,60,165,0.9707602339181286,19.28786294809595
Task_38834,2434,500,116,41,157,4.858283433133733,46.223512579000925
Task_38835,1247,474,122,167,289,2.6252631578947367,29.11802427734013
Task_38836,535,560,23,147,170,0.9536541889483066,17.283194934127945
Task_38837,1061,320,144,149,293,3.305295950155763,25.674867157942327
Task_38838,2184,121,183,25,208,17.901639344262296,41.07333581887925
Task_38839,1464,707,171,92,263,2.0677966101694913,32.95776351126689
Task_38840,2112,284,38,59,97,7.410526315789474,40.18785563771834
Task_38841,702,548,114,81,195,1.278688524590164,19.79098779856041
Task_38842,1120,366,118,167,285,3.0517711171662127,26.746561938065867
Task_38843,1987,542,180,146,326,3.6593001841620625,41.18530239520107
Task_38844,2424,954,25,101,126,2.538219895287958,48.28100524332024
Task_38845,2788,171,117,184,301,16.209302325581394,52.146830933029996
Task_38846,2347,194,88,183,271,12.035897435897436,45.44906114368973
Task_38847,901,213,83,14,97,4.210280373831775,20.41585264263148
Task_38848,1258,855,170,162,332,1.469626168224299,30.615086961953825
Task_38849,1150,900,135,35,170,1.2763596004439512,27.293451269809026
Task_38850,2506,368,32,130,162,6.791327913279133,47.84283677655083
Task_38851,912,898,21,181,202,1.0144605116796441,24.50656697206686
Task_38852,2424,237,120,132,252,10.184873949579831,46.722538894380826
Task_38853,2550,888,84,169,253,2.8683914510686166,50.94461361745804
Task_38854,2908,605,57,113,170,4.798679867986799,55.189735738695475
Task_38855,1633,562,97,124,221,2.9005328596802844,35.1615295845162
Task_38856,2394,875,116,134,250,2.732876712328767,48.32002833310194
Task_38857,1406,823,112,177,289,1.7063106796116505,32.72923262196891
Task_38858,1065,910,176,172,348,1.1690450054884742,27.776779095463088
Task_38859,1229,620,122,16,138,1.9790660225442833,27.27554186496414
Task_38860,2079,287,180,154,334,7.21875,41.852183673295926
Task_38861,2376,761,82,70,152,3.1181102362204722,46.45217342284724
Task_38862,2073,968,197,145,342,2.1393188854489162,43.954214056905755
Task_38863,966,758,65,54,119,1.2727272727272727,23.742640421881834
Task_38864,1771,326,149,131,280,5.415902140672783,36.837679487746975
Task_38865,2426,651,19,78,97,3.7208588957055215,46.61706603362125
Task_38866,584,852,197,184,381,0.6846424384525205,20.295513468955708
Task_38867,2424,901,132,114,246,2.6873614190687363,48.82924315260331
Task_38868,630,898,57,58,115,0.7007786429365962,18.986638930466466
Task_38869,2834,512,34,96,130,5.524366471734893,53.3880322522316
Task_38870,2838,653,62,168,230,4.339449541284404,54.74274494774363
Task_38871,942,854,43,25,68,1.1017543859649124,22.731010590211298
Task_38872,813,873,135,199,334,0.9302059496567505,23.666262541109308
Task_38873,2767,70,106,35,141,38.971830985915496,48.79500227168355
Task_38874,1979,769,10,50,60,2.57012987012987,38.92913262343972
Task_38875,2556,639,120,106,226,3.99375,49.99492850458
Task_38876,2591,323,21,117,138,7.996913580246914,48.78667812124318
Task_38877,2331,841,193,27,220,2.7684085510688834,46.203141032944075
Task_38878,1108,191,92,132,224,5.770833333333333,25.717884620489247
Task_38879,2963,909,186,151,337,3.256043956043956,57.85930854807606
Task_38880,534,716,191,84,275,0.7447698744769874,18.026194940586652
Task_38881,1784,389,148,145,293,4.574358974358974,37.3300120064945
Task_38882,2329,301,147,87,234,7.711920529801325,45.05003779838762
Task_38883,818,939,116,166,282,0.8702127659574468,23.661735486024995
Task_38884,2149,294,146,199,345,7.284745762711864,43.098609860615376
Task_38885,2303,887,100,167,267,2.5934684684684686,47.04061096032628
Task_38886,1239,207,159,116,275,5.956730769230769,27.979669124611323
Task_38887,1387,949,187,69,256,1.46,32.011427301314455
Task_38888,1528,279,56,10,66,5.457142857142857,29.861638561909203
Task_38889,2452,663,119,21,140,3.6927710843373496,46.872635556061574
Task_38890,2583,68,134,187,321,37.43478260869565,48.00877109920256
Task_38891,2830,803,112,167,279,3.5199004975124377,55.18145409230916
Task_38892,1882,720,97,25,122,2.6102635228848823,37.939514537060596
Task_38893,799,274,50,167,217,2.9054545454545453,21.25697416444852
Task_38894,1552,447,85,128,213,3.4642857142857144,33.50753411947013
Task_38895,1162,689,39,103,142,1.6840579710144927,27.39213181523178
Task_38896,2042,645,44,58,102,3.1609907120743035,40.24989471865987
Task_38897,1305,930,183,164,347,1.40171858216971,31.64836658625803
Task_38898,1463,502,48,69,117,2.908548707753479,31.199253541788398
Task_38899,1195,497,160,78,238,2.3995983935742973,27.709349100114366
Task_38900,783,98,181,90,271,7.909090909090909,19.541335658800673
Task_38901,1920,273,196,134,330,7.007299270072993,39.2429297709308
Task_38902,2257,811,152,24,176,2.7795566502463056,44.55761790579843
Task_38903,1941,363,170,30,200,5.332417582417582,38.48099520660911
Task_38904,1583,596,152,115,267,2.6515912897822447,34.64732193479704
Task_38905,518,677,70,175,245,0.7640117994100295,18.070033395127812
Task_38906,568,453,180,78,258,1.251101321585903,17.679563211710455
Task_38907,1323,959,41,123,164,1.378125,30.98209351367346
Task_38908,1613,547,42,49,91,2.9434306569343067,32.90830176118959
Task_38909,1140,751,65,163,228,1.5159574468085106,28.096197234931555
Task_38910,833,719,192,36,228,1.1569444444444446,22.234119744500415
Task_38911,1202,294,75,117,192,4.074576271186441,27.45338115650242
Task_38912,2633,771,144,62,206,3.410621761658031,50.98418834683675
Task_38913,2111,851,89,19,108,2.477699530516432,41.71180786306453
Task_38914,649,225,17,59,76,2.8716814159292037,16.26884188994123
Task_38915,2486,483,174,139,313,5.136363636363637,48.82726633192019
Task_38916,2563,832,11,14,25,3.076830732292917,47.85439115670411
Task_38917,1533,445,33,51,84,3.437219730941704,31.462624095696345
Task_38918,2360,488,109,132,241,4.826175869120655,46.51404786822812
Task_38919,1394,989,104,45,149,1.408080808080808,31.215813668905287
Task_38920,2892,606,105,137,242,4.764415156507414,55.328752832373915
Task_38921,1775,564,82,181,263,3.1415929203539825,37.75798429342186
Task_38922,1601,496,52,78,130,3.221327967806841,33.73076143420837
Task_38923,1636,731,165,95,260,2.2349726775956285,35.82078914562353
Task_38924,725,416,195,17,212,1.7386091127098322,19.213455957010726
Task_38925,840,830,176,114,290,1.0108303249097472,23.562338899515993
Task_38926,2269,659,87,95,182,3.437878787878788,45.07337005704213
Task_38927,1050,114,84,104,188,9.130434782608695,23.69896471432013
Task_38928,605,200,88,124,212,3.009950248756219,17.69494118537521
Task_38929,2345,756,177,175,352,3.09775429326288,47.69085371605221
Task_38930,1127,119,161,189,350,9.391666666666667,25.913130224412086
Task_38931,2483,204,144,153,297,12.112195121951219,47.760210201957676
Task_38932,2407,737,51,134,185,3.261517615176152,47.866541686138156
Task_38933,1941,331,75,73,148,5.846385542168675,38.368930808729345
Task_38934,1549,991,107,37,144,1.561491935483871,33.73503767130152
Task_38935,2442,281,68,49,117,8.659574468085106,45.48101260561856
Task_38936,2964,95,143,67,210,30.875,53.024026132878866
Task_38937,1892,957,190,72,262,1.9749478079331941,40.16823230546893
Task_38938,2093,799,155,93,248,2.61625,43.17898507434882
Task_38939,2321,288,192,134,326,8.03114186851211,45.61588474785888
Task_38940,2725,916,92,111,203,2.97164667393675,53.52490745991591
Task_38941,1700,353,160,54,214,4.80225988700565,34.93787761773391
Task_38942,1895,401,44,29,73,4.713930348258707,36.39945250691381
Task_38943,711,753,75,33,108,0.9429708222811671,19.55456126685318
Task_38944,2556,741,19,10,29,3.444743935309973,47.465218154504505
Task_38945,1432,1023,84,66,150,1.3984375,32.18444413503832
Task_38946,1095,990,97,61,158,1.1049445005045408,26.667114796570676
Task_38947,1608,904,115,86,201,1.7767955801104973,35.39148516452355
Task_38948,2045,342,11,188,199,5.962099125364431,40.94517727390218
Task_38949,680,106,124,119,243,6.355140186915888,17.97789080394558
Task_38950,789,246,163,34,197,3.194331983805668,19.862457441717915
Task_38951,2019,231,107,23,130,8.702586206896552,38.662930427536075
Task_38952,1889,949,66,60,126,1.9884210526315789,39.233292089751956
Task_38953,2286,729,88,132,220,3.1315068493150684,46.03303557527513
Task_38954,692,345,112,17,129,2.0,17.897033448118652
Task_38955,1299,666,44,48,92,1.9475262368815591,28.350618696551177
Task_38956,1725,502,91,93,184,3.429423459244533,35.97902356383367
Task_38957,1259,422,116,149,265,2.976359338061466,29.008371378553182
Task_38958,1533,219,10,15,25,6.968181818181818,29.577943747475146
Task_38959,694,572,190,46,236,1.2111692844677138,19.528819981865908
Task_38960,991,196,83,135,218,5.030456852791878,23.806851068787694
Task_38961,555,705,37,145,182,0.7861189801699717,18.039391535982222
Task_38962,2850,75,90,147,237,37.5,51.81899700374052
Task_38963,2941,846,54,115,169,3.4722550177095632,56.474122593930765
Task_38964,1678,396,103,122,225,4.226700251889169,35.3353637100426
Task_38965,1596,150,154,33,187,10.56953642384106,31.941945607971594
Task_38966,711,857,129,117,246,0.8286713286713286,21.47038421073455
Task_38967,2890,581,166,193,359,4.965635738831615,55.826390440609885
Task_38968,557,439,111,131,242,1.2659090909090909,17.71594464577335
Task_38969,1227,585,163,41,204,2.0938566552901023,27.892495437782838
Task_38970,1057,663,116,100,216,1.591867469879518,26.260967545552916
Task_38971,1505,928,194,135,329,1.620021528525296,34.74264110400468
Task_38972,2244,845,111,193,304,2.652482269503546,46.179484872668866
Task_38973,2993,373,186,157,343,8.002673796791443,56.64786359371006
Task_38974,612,685,197,47,244,0.892128279883382,18.69207974907079
Task_38975,1727,906,198,11,209,1.9040793825799338,36.692123658127606
Task_38976,678,320,24,62,86,2.1121495327102804,17.579573285207815
Task_38977,1912,800,124,98,222,2.387016229712859,40.2732815532402
Task_38978,1158,75,26,70,96,15.236842105263158,23.642786888874525
Task_38979,996,955,120,33,153,1.0418410041841004,24.83890709201661
Task_38980,2892,429,34,152,186,6.725581395348837,54.42467156589044
Task_38981,639,729,197,78,275,0.8753424657534247,19.801157117936896
Task_38982,1567,72,142,94,236,21.465753424657535,31.66516047009601
Task_38983,1479,835,200,41,241,1.7691387559808613,32.81998213784682
Task_38984,2634,667,122,168,290,3.94311377245509,51.698472100293294
Task_38985,1208,348,130,82,212,3.4613180515759314,27.343755197662876
Task_38986,855,815,183,55,238,1.0477941176470589,23.09473848983107
Task_38987,2789,384,150,110,260,7.244155844155844,53.01464657872274
Task_38988,2730,895,15,115,130,3.046875,52.9387989118027
Task_38989,2723,980,62,139,201,2.7757390417940875,53.7755968057445
Task_38990,1746,801,16,185,201,2.1770573566084788,37.63928818400439
Task_38991,712,487,181,36,217,1.459016393442623,19.49633569040429
Task_38992,1245,678,199,18,217,1.8335787923416789,28.27352583563894
Task_38993,1699,353,185,13,198,4.799435028248587,34.444135345760905
Task_38994,2909,812,33,99,132,3.5781057810578107,55.49689873524043
Task_38995,1743,467,146,67,213,3.7243589743589745,36.0170499409952
Task_38996,2827,560,10,28,38,5.03921568627451,51.38408950844073
Task_38997,2928,611,30,194,224,4.784313725490196,55.95826499354103
Task_38998,1903,659,139,74,213,2.8833333333333333,39.25311535373802
Task_38999,1967,973,143,88,231,2.0195071868583163,41.45423035992187
Task_39000,2799,709,81,88,169,3.9422535211267604,53.44358715071289
Task_39001,2566,978,177,64,241,2.6210418794688457,50.76857025643636
Task_39002,2029,1006,116,48,164,2.014895729890765,41.65347120658876
Task_39003,2559,905,98,70,168,2.8245033112582782,49.94264035520053
Task_39004,2866,288,144,67,211,9.916955017301039,53.1739268200177
Task_39005,1309,865,31,19,50,1.5115473441108545,28.370595023914507
Task_39006,2542,490,101,15,116,5.177189409368635,47.476304826623306
Task_39007,2935,688,57,199,256,4.2597968069666186,56.583644436679656
Task_39008,1035,970,101,18,119,1.065911431513903,25.023279900093286
Task_39009,1856,444,197,166,363,4.170786516853933,38.99391305783261
Task_39010,2974,227,56,57,113,13.043859649122806,53.86589888695204
Task_39011,1382,672,36,82,118,2.053491827637444,30.587969942429726
Task_39012,2089,828,37,63,100,2.5199034981905912,41.77363384966655
Task_39013,1046,940,68,171,239,1.1115834218916048,27.110908600166244
Task_39014,1033,1004,112,142,254,1.0278606965174129,27.056000150516354
Task_39015,1623,67,96,16,112,23.86764705882353,30.423732636950533
Task_39016,1209,161,120,93,213,7.462962962962963,26.650437348359034
Task_39017,845,171,38,113,151,4.912790697674419,20.278483272676922
Task_39018,2302,1011,105,184,289,2.274703557312253,47.53519648734571
Task_39019,2683,361,152,179,331,7.411602209944752,51.680970107676025
Task_39020,2097,329,33,46,79,6.3545454545454545,39.502169235951875
Task_39021,1077,481,191,49,240,2.2344398340248963,25.431119356646093
Task_39022,1183,398,155,164,319,2.9649122807017543,27.994540588533194
Task_39023,539,508,199,71,270,1.0589390962671905,17.301472398052205
Task_39024,2207,146,45,96,141,15.013605442176871,41.537066612001716
Task_39025,566,853,154,177,331,0.6627634660421545,19.77860449822036
Task_39026,1362,583,25,148,173,2.3321917808219177,30.712027683302505
Task_39027,1366,538,165,75,240,2.5343228200371057,30.48400954235539
Task_39028,1418,92,151,88,239,15.24731182795699,29.33753140621789
Task_39029,2108,987,11,119,130,2.133603238866397,43.33492855680037
Task_39030,2722,574,22,193,215,4.733913043478261,52.46400258232915
Task_39031,2385,549,133,108,241,4.336363636363636,47.070748928687
Task_39032,1740,276,105,155,260,6.281588447653429,36.12357225541523
Task_39033,2925,124,155,177,332,23.4,54.13823901953598
Task_39034,2938,130,23,35,58,22.427480916030536,51.64018680938755
Task_39035,2646,666,64,62,126,3.967016491754123,50.36516369942783
Task_39036,1934,311,99,80,179,6.198717948717949,38.35751057389777
Task_39037,1003,258,128,21,149,3.8725868725868726,22.700971295766163
Task_39038,748,999,153,70,223,0.748,21.940849553091045
Task_39039,2228,509,71,123,194,4.368627450980392,44.393905144711596
Task_39040,2094,680,124,34,158,3.0748898678414096,41.44799353136707
Task_39041,1490,813,192,197,389,1.8304668304668306,34.52244721936166
Task_39042,1596,311,121,85,206,5.115384615384615,33.344561512169996
Task_39043,2180,642,114,87,201,3.390357698289269,43.65451542874524
Task_39044,2096,194,113,50,163,10.748717948717948,40.07851209134816
Task_39045,1055,82,162,146,308,12.710843373493976,24.078130010177905
Task_39046,2623,291,198,50,248,8.982876712328768,49.28922982653058
Task_39047,1209,927,72,39,111,1.302801724137931,27.83428037986161
Task_39048,1455,971,145,142,287,1.4969135802469136,33.87535448508873
Task_39049,1875,222,93,91,184,8.408071748878923,37.40070637440581
Task_39050,2743,655,56,31,87,4.1814024390243905,50.93661397034233
Task_39051,1442,78,75,143,218,18.253164556962027,29.835796923886594
Task_39052,1978,779,72,27,99,2.5358974358974358,39.448973777602895
Task_39053,637,334,120,56,176,1.9014925373134328,17.75208590330873
Task_39054,2276,828,170,82,252,2.7454764776839564,45.95295733925611
Task_39055,1730,863,109,103,212,2.002314814814815,37.54503331037679
Task_39056,797,76,122,11,133,10.35064935064935,17.8787802441636
Task_39057,1766,299,153,162,315,5.886666666666667,36.871107130844685
Task_39058,2840,506,34,189,223,5.601577909270217,54.201621128253855
Task_39059,863,738,113,198,311,1.1677943166441136,23.914896127036567
Task_39060,2624,824,28,55,83,3.1806060606060607,49.945998493294205
Task_39061,2722,493,169,53,222,5.510121457489879,51.652111954375364
Task_39062,1991,647,123,135,258,3.072530864197531,41.258307000916446
Task_39063,1651,455,191,45,236,3.620614035087719,34.29705642459907
Task_39064,1335,230,112,70,182,5.779220779220779,28.449868687721004
Task_39065,582,73,163,194,357,7.864864864864865,16.8842057857553
Task_39066,838,65,97,107,204,12.696969696969697,20.134158467777965
Task_39067,719,466,16,138,154,1.5396145610278373,19.652230057705424
Task_39068,2228,458,85,150,235,4.8540305010893245,44.37412227811683
Task_39069,2793,602,187,41,228,4.6318407960199,52.854089390015076
Task_39070,1596,731,68,175,243,2.180327868852459,35.37814295908564
Task_39071,2505,998,119,139,258,2.5075075075075075,50.506008734815715
Task_39072,2545,405,54,190,244,6.268472906403941,49.428339178544284
Task_39073,1249,539,87,41,128,2.312962962962963,27.610189117811412
Task_39074,790,479,98,29,127,1.6458333333333333,20.068943922487563
Task_39075,2280,624,175,109,284,3.648,45.841923092017815
Task_39076,1625,567,139,63,202,2.8609154929577465,34.390772612156596
Task_39077,2628,519,153,126,279,5.053846153846154,51.01949785608031
Task_39078,2623,509,106,130,236,5.143137254901961,50.72008353799246
Task_39079,1698,630,132,194,326,2.6909667194928684,36.95720845355686
Task_39080,755,156,65,175,240,4.808917197452229,19.93834766462644
Task_39081,1618,185,40,41,81,8.698924731182796,31.799678263220944
Task_39082,659,868,111,125,236,0.7583429228998849,20.678151928898032
Task_39083,1694,168,88,56,144,10.023668639053254,33.37770614473272
Task_39084,1601,236,144,182,326,6.755274261603375,34.12521725391
Task_39085,2465,899,140,75,215,2.738888888888889,48.911530300199765
Task_39086,2389,842,188,147,335,2.833926453143535,48.53979153331286
Task_39087,1219,611,39,171,210,1.9918300653594772,28.767400793608005
Task_39088,793,1008,108,42,150,0.7859266600594648,21.81241283964418
Task_39089,502,894,147,26,173,0.5608938547486033,17.392943314946404
Task_39090,2311,654,152,72,224,3.5282442748091603,45.687153070161706
Task_39091,1651,564,172,168,340,2.92212389380531,36.03002565361753
Task_39092,2016,865,200,161,361,2.327944572748268,42.83938520762308
Task_39093,1546,227,106,119,225,6.780701754385965,32.677120190989704
Task_39094,544,870,14,42,56,0.6245694603903559,16.946324601017555
Task_39095,2863,118,161,189,350,24.058823529411764,53.20553416854735
Task_39096,714,1014,98,35,133,0.7034482758620689,20.844934196846534
Task_39097,853,1018,119,75,194,0.8370951913640824,23.64105024844694
Task_39098,2711,366,151,169,320,7.386920980926431,52.07665677584644
Task_39099,782,916,81,88,169,0.8527808069792803,22.009247085694508
Task_39100,2743,124,192,56,248,21.944,50.371342071323475
Task_39101,2028,1015,96,12,108,1.9960629921259843,41.03539700403647
Task_39102,522,542,176,151,327,0.9613259668508287,17.919438684752723
Task_39103,2443,828,113,99,212,2.9469240048250906,48.712016025300294
Task_39104,2078,799,93,63,156,2.5975,41.88279860270291
Task_39105,2549,206,181,72,253,12.31400966183575,48.0770756249838
Task_39106,1305,708,93,117,210,1.840620592383639,30.452674541832334
Task_39107,822,1004,54,12,66,0.817910447761194,21.151579930000825
Task_39108,1423,847,74,199,273,1.678066037735849,33.16510982510169
Task_39109,1301,551,159,81,240,2.3568840579710146,29.54559088482471
Task_39110,972,898,144,105,249,1.0812013348164626,25.66841286143413
Task_39111,518,818,170,175,345,0.6324786324786325,18.97335993276595
Task_39112,809,153,105,53,158,5.253246753246753,19.393219538036707
Task_39113,2329,966,43,139,182,2.408479834539814,47.106076187554144
Task_39114,1089,581,37,41,78,1.8711340206185567,24.220239966282605
Task_39115,1516,290,96,134,230,5.209621993127148,32.51710022963105
Task_39116,548,165,193,73,266,3.3012048192771086,16.185096822198975
Task_39117,2652,649,124,29,153,4.08,50.145998315299146
Task_39118,2104,799,104,121,225,2.63,43.355977825813746
Task_39119,2119,762,172,84,256,2.7771952817824377,43.26957980317985
Task_39120,1115,501,94,72,166,2.2211155378486054,25.946411225766695
Task_39121,853,688,26,59,85,1.2380261248185775,21.383780192156934
Task_39122,869,573,15,42,57,1.5139372822299653,20.787530945343562
Task_39123,792,304,113,79,192,2.59672131147541,20.517112077768715
Task_39124,1342,196,83,76,159,6.812182741116751,28.371519572632412
Task_39125,1831,137,96,108,204,13.268115942028986,36.4229007960941
Task_39126,1997,967,55,33,88,2.06301652892562,40.128440069764046
Task_39127,2982,514,136,148,284,5.790291262135923,56.66273218072816
Task_39128,2470,221,182,139,321,11.126126126126126,47.70944877430403
Task_39129,1876,189,98,179,277,9.873684210526315,38.09678295406387
Task_39130,1228,926,62,16,78,1.3247033441208198,27.30374706349835
Task_39131,2680,541,119,81,200,4.944649446494465,51.1685736623806
Task_39132,1968,839,131,109,240,2.342857142857143,41.376194285485276
Task_39133,1985,249,71,31,102,7.94,37.88317663831302
Task_39134,2824,732,32,33,65,3.8526603001364257,52.12879134603856
Task_39135,2277,248,140,175,315,9.144578313253012,44.78789896752457
Task_39136,2163,489,53,134,187,4.414285714285715,43.29068478136967
Task_39137,1072,333,128,104,232,3.2095808383233533,25.549948779793777
Task_39138,1659,738,59,55,114,2.2449255751014885,34.79135183982343
Task_39139,2984,990,188,60,248,3.0110998990918265,57.386986938328356
Task_39140,2556,90,75,22,97,28.087912087912088,45.357617820471916
Task_39141,1983,240,114,22,136,8.228215767634854,38.12420085368701
Task_39142,2039,68,105,142,247,29.55072463768116,39.10406562589018
Task_39143,1857,93,54,12,66,19.75531914893617,33.83443679833771
Task_39144,924,701,197,20,217,1.3162393162393162,23.333784743955164
Task_39145,1976,326,85,127,212,6.042813455657492,39.81465138132705
Task_39146,1414,523,64,93,157,2.698473282442748,30.987467614653905
Task_39147,2717,532,30,128,158,5.097560975609756,51.655085675919274
Task_39148,2037,742,47,43,90,2.7415881561238225,40.13847722508362
Task_39149,595,934,122,80,202,0.6363636363636364,19.55735380407472
Task_39150,1003,892,190,149,339,1.1231802911534154,26.596667377509288
Task_39151,1991,807,73,192,265,2.464108910891089,42.00204180695173
Task_39152,1607,488,59,32,91,3.2862985685071573,32.4712368953757
Task_39153,1550,362,85,136,221,4.2699724517906334,33.249495271958274
Task_39154,1528,551,30,155,185,2.7681159420289854,33.23834725402322
Task_39155,1774,626,50,85,135,2.8293460925039873,36.9032052101824
Task_39156,1803,118,80,152,232,15.15126050420168,36.05551263749373
Task_39157,1579,579,38,59,97,2.722413793103448,32.714063130045304
Task_39158,1038,99,148,141,289,10.38,23.835417810750652
Task_39159,1118,385,161,58,219,2.8963730569948187,25.806591630871768
Task_39160,937,269,133,52,185,3.4703703703703703,22.371119247750148
Task_39161,2891,671,105,189,294,4.302083333333333,55.83066663361378
Task_39162,542,194,36,140,176,2.7794871794871794,16.320498723325926
Task_39163,2875,432,78,77,155,6.63972286374134,53.512716605550885
Task_39164,1172,966,28,126,154,1.2119958634953465,28.289044504067448
Task_39165,2134,717,198,43,241,2.9721448467966574,42.835848752265214
Task_39166,1935,758,161,81,242,2.549407114624506,40.24518618651148
Task_39167,2091,508,162,171,333,4.1080550098231825,42.79159746048
Task_39168,1831,543,105,197,302,3.3658088235294117,38.684997465219475
Task_39169,2554,586,21,34,55,4.350936967632027,47.40871429979651
Task_39170,1415,584,104,36,140,2.4188034188034186,30.30565736068024
Task_39171,756,280,145,60,205,2.6903914590747333,19.6724180610769
Task_39172,2186,209,60,58,118,10.40952380952381,41.296524245560484
Task_39173,2222,413,133,50,183,5.367149758454106,42.88873372618158
Task_39174,2901,94,124,124,248,30.53684210526316,52.76285441056641
Task_39175,2444,759,85,34,119,3.2157894736842105,46.93854846011203
Task_39176,1284,642,30,36,66,1.9968895800933126,27.452818576544008
Task_39177,2519,953,93,167,260,2.640461215932914,50.749616427921914
Task_39178,2129,801,188,95,283,2.6546134663341645,43.9534717050303
Task_39179,1611,459,57,91,148,3.502173913043478,33.84152335186346
Task_39180,1204,514,185,67,252,2.337864077669903,27.809166393069034
Task_39181,2286,811,161,163,324,2.815270935960591,46.78475791546244
Task_39182,942,867,31,108,139,1.0852534562211982,24.253689402126046
Task_39183,1131,877,119,26,145,1.2881548974943053,26.778279798964785
Task_39184,1310,692,134,161,295,1.8903318903318904,30.817641597280986
Task_39185,1772,902,92,121,213,1.9623477297895902,38.44025000616766
Task_39186,2477,958,97,83,180,2.5828988529718457,49.040802351709
Task_39187,2785,394,182,134,316,7.050632911392405,53.27257405551469
Task_39188,2341,193,119,52,171,12.06701030927835,44.24044066843817
Task_39189,1836,568,48,44,92,3.226713532513181,36.49546065445081
Task_39190,1701,862,39,66,105,1.9710312862108923,35.76126981584351
Task_39191,1808,795,10,79,89,2.271356783919598,37.211736909806326
Task_39192,2975,531,134,145,279,5.592105263157895,56.58016246528867
Task_39193,2524,527,179,115,294,4.78030303030303,49.450160936669455
Task_39194,2063,241,58,38,96,8.524793388429751,38.969742336221266
Task_39195,2735,366,185,61,246,7.452316076294278,51.43562188665373
Task_39196,2680,116,130,40,170,22.905982905982906,48.390102728813986
Task_39197,1429,275,120,141,261,5.177536231884058,31.188541939794092
Task_39198,2710,342,69,139,208,7.900874635568513,51.55161892305427
Task_39199,2590,242,112,28,140,10.65843621399177,47.72983448115365
Task_39200,962,619,126,24,150,1.5516129032258064,23.204332334612108
Task_39201,1054,800,65,164,229,1.3158551810237205,26.86985769835032
Task_39202,1970,474,135,15,150,4.147368421052631,38.60262646770837
Task_39203,1229,515,64,156,220,2.381782945736434,28.763295649130836
Task_39204,1851,630,194,155,349,2.9334389857369256,39.42688748868055
Task_39205,2996,1013,196,146,342,2.9546351084812623,58.72257650067311
Task_39206,1621,738,190,129,319,2.1935047361299054,35.94892124617672
Task_39207,2321,186,127,126,253,12.411764705882353,45.044667663141674
Task_39208,1236,203,53,152,205,6.0588235294117645,27.825247960393728
Task_39209,691,864,120,33,153,0.7988439306358381,19.796742711710746
Task_39210,2630,358,178,33,211,7.325905292479109,49.40685302638914
Task_39211,2310,673,150,144,294,3.427299703264095,46.56835444256507
Task_39212,886,72,86,184,270,12.136986301369863,21.294137084550634
Task_39213,1084,582,135,80,215,1.8593481989708405,26.130312069056682
Task_39214,1845,166,67,50,117,11.047904191616766,35.20976353168094
Task_39215,847,621,122,90,212,1.3617363344051447,22.5628920745982
Task_39216,1755,641,51,98,149,2.7336448598130842,36.8575970201262
Task_39217,1910,560,119,164,283,3.4046345811051695,39.85581863325407
Task_39218,2886,97,51,123,174,29.448979591836736,52.26666779313828
Task_39219,2509,262,176,140,316,9.539923954372624,48.45809428556995
Task_39220,2916,211,86,196,282,13.754716981132075,54.66192985890773
Task_39221,2460,566,176,95,271,4.338624338624339,48.40072367245458
Task_39222,654,675,193,148,341,0.9674556213017751,20.48096200330403
Task_39223,804,812,141,57,198,0.988929889298893,22.14801255703061
Task_39224,1242,854,91,98,189,1.4526315789473685,29.633481669993113
Task_39225,2061,655,51,180,231,3.1417682926829267,42.532416967829626
Task_39226,2748,973,113,158,271,2.8213552361396306,54.365279113162636
Task_39227,1807,627,85,197,282,2.877388535031847,38.52749410909448
Task_39228,658,308,115,164,279,2.129449838187702,19.222667442560795
Task_39229,1587,297,188,169,357,5.325503355704698,34.2339133813313
Task_39230,2207,685,113,31,144,3.217201166180758,43.20862347976314
Task_39231,884,872,132,26,158,1.0126002290950744,22.781512545176373
Task_39232,1056,593,132,62,194,1.7777777777777777,25.38406206896423
Task_39233,2245,943,192,120,312,2.378177966101695,46.43010486335496
Task_39234,2332,935,117,58,175,2.4914529914529915,46.485042285871124
Task_39235,2365,589,144,60,204,4.008474576271187,46.12066791999347
Task_39236,755,832,118,136,254,0.9063625450180072,22.17022133620884
Task_39237,1992,689,121,194,315,2.8869565217391306,41.74965057613093
Task_39238,540,661,50,194,244,0.8157099697885196,18.373758834738137
Task_39239,638,103,191,95,286,6.134615384615385,17.47015030929573
Task_39240,2582,871,161,76,237,2.9610091743119265,50.781292457998575
Task_39241,1283,199,21,51,72,6.415,26.271600096237293
Task_39242,1997,793,157,119,276,2.5151133501259446,41.86894603219566
Task_39243,2496,744,63,141,204,3.350335570469799,49.45635143238783
Task_39244,2401,698,165,99,264,3.434907010014306,47.87265763311268
Task_39245,1012,415,160,50,210,2.4326923076923075,24.04751862920072
Task_39246,2474,104,147,65,212,23.561904761904763,45.581150660884624
Task_39247,1750,352,78,119,197,4.957507082152975,36.330776328405854
Task_39248,2736,828,68,53,121,3.3003618817852836,52.180526173471144
Task_39249,1858,685,67,199,266,2.7084548104956268,39.523248336670854
Task_39250,1170,597,76,47,123,1.9565217391304348,26.394708506482033
Task_39251,889,977,112,153,265,0.908997955010225,24.8134025462308
Task_39252,2791,379,131,25,156,7.344736842105263,51.43194250093637
Task_39253,2909,146,64,70,134,19.789115646258505,52.38632267991673
Task_39254,2976,677,83,62,145,4.389380530973451,55.71804489051601
Task_39255,842,777,75,38,113,1.082262210796915,21.76288682799053
Task_39256,2494,411,192,22,214,6.053398058252427,47.36012260667956
Task_39257,1242,212,29,76,105,5.830985915492958,26.56977179941089
Task_39258,868,222,21,137,158,3.89237668161435,21.343100459242816
Task_39259,1103,635,178,63,241,1.7342767295597483,26.50431815904945
Task_39260,1894,670,69,172,241,2.8226527570789868,39.89340110773895
Task_39261,2868,724,68,104,172,3.955862068965517,55.01044375741458
Task_39262,2965,448,133,122,255,6.603563474387528,56.00846353726621
Task_39263,1270,478,199,163,362,2.651356993736952,29.817911211659354
Task_39264,1019,126,198,193,391,8.023622047244094,24.456822590995813
Task_39265,1687,429,13,108,121,3.9232558139534883,34.871038489200636
Task_39266,2399,648,121,168,289,3.6964560862865947,47.91166382394689
Task_39267,1292,460,82,46,128,2.8026030368763557,28.056490157802727
Task_39268,1542,708,73,125,198,2.1748942172073344,34.179554024198104
Task_39269,1885,913,174,109,283,2.062363238512035,40.48538637792446
Task_39270,2048,503,109,47,156,4.063492063492063,40.1193297048473
Task_39271,1422,802,93,122,215,1.7708592777085927,32.61524662635149
Task_39272,2843,948,26,145,171,2.9957850368809273,55.16919681963404
Task_39273,2923,1016,11,62,73,2.8741396263520156,54.88901595138245
Task_39274,2274,640,73,67,140,3.547581903276131,44.52730293715282
Task_39275,1706,931,194,78,272,1.8304721030042919,37.31216476309363
Task_39276,1324,563,45,68,113,2.347517730496454,29.142782394811423
Task_39277,2516,786,45,164,209,3.1969504447268107,49.83361034258407
Task_39278,1211,646,182,192,374,1.8717156105100463,29.5075514283683
Task_39279,2019,138,181,188,369,14.525179856115107,40.19075499911242
Task_39280,594,186,77,60,137,3.176470588235294,16.708912991172976
Task_39281,1795,294,71,160,231,6.084745762711864,37.05808673470694
Task_39282,786,215,99,24,123,3.638888888888889,19.01264916570637
Task_39283,2429,771,57,46,103,3.1463730569948187,46.46407109830344
Task_39284,1308,779,92,182,274,1.676923076923077,31.057063904363286
Task_39285,517,350,129,175,304,1.4729344729344729,17.20048553221336
Task_39286,2940,912,38,150,188,3.2201533406352683,56.80635242812809
Task_39287,2439,770,137,143,280,3.1634241245136185,48.85255888471105
Task_39288,841,207,143,113,256,4.043269230769231,21.60638039594683
Task_39289,1529,519,40,77,117,2.9403846153846156,32.35787246912111
Task_39290,1805,249,185,123,308,7.22,37.22627132376335
Task_39291,1382,928,64,105,169,1.4876210979547901,31.943315012678898
Task_39292,1577,465,31,61,92,3.38412017167382,32.339830039720425
Task_39293,2358,659,61,81,142,3.5727272727272728,46.12032422179857
Task_39294,1282,966,29,88,117,1.3257497414684591,29.841386888972895
Task_39295,1014,163,38,168,206,6.182926829268292,23.78240880429614
Task_39296,2952,249,164,27,191,11.808,53.96023672033645
Task_39297,619,1013,152,134,286,0.6104536489151874,20.90451967428577
Task_39298,1247,165,37,170,207,7.5120481927710845,27.4646782324582
Task_39299,2575,830,112,171,283,3.098676293622142,51.25000770780749
Task_39300,1075,445,85,103,188,2.4103139013452917,25.764804841309978
Task_39301,1120,178,67,18,85,6.256983240223463,23.511012638624077
Task_39302,1868,412,69,80,149,4.523002421307506,37.63070899510168
Task_39303,1863,234,28,119,147,7.927659574468085,37.101476861442684
Task_39304,1044,609,75,193,268,1.7114754098360656,26.393549795079355
Task_39305,1353,205,178,105,283,6.567961165048544,29.792182396384003
Task_39306,1745,423,199,14,213,4.115566037735849,35.44722392002462
Task_39307,2113,109,120,74,194,19.20909090909091,39.872509244224986
Task_39308,779,740,148,27,175,1.0512820512820513,21.010433902662463
Task_39309,762,566,128,175,303,1.343915343915344,21.762074113745673
Task_39310,1849,184,183,130,313,9.994594594594595,37.562642539809005
Task_39311,698,1000,71,79,150,0.6973026973026973,21.036511507698695
Task_39312,1501,609,105,146,251,2.460655737704918,33.36289122354426
Task_39313,2961,189,185,25,210,15.58421052631579,54.02529555575061
Task_39314,994,469,19,148,167,2.1148936170212767,24.313440476437012
Task_39315,1954,500,20,50,70,3.900199600798403,37.71731783443724
Task_39316,1179,70,126,111,237,16.6056338028169,25.58153355582245
Task_39317,1286,605,158,132,290,2.122112211221122,30.100676684867384
Task_39318,2291,576,66,121,187,3.97053726169844,45.529458209161135
Task_39319,2155,461,65,188,253,4.6645021645021645,43.44318948273184
Task_39320,1051,279,94,68,162,3.7535714285714286,24.02699501224446
Task_39321,1893,215,67,117,184,8.76388888888889,37.874071801151295
Task_39322,1321,90,52,74,126,14.516483516483516,26.883064550563947
Task_39323,1428,456,27,189,216,3.12472647702407,31.670157802536945
Task_39324,1581,145,118,63,181,10.82876712328767,31.746034392940786
Task_39325,2252,678,92,38,130,3.3166421207658323,44.005818166198225
Task_39326,510,311,189,109,298,1.6346153846153846,16.883578037830638
Task_39327,1131,1023,13,195,208,1.1044921875,28.53219523342615
Task_39328,2916,728,113,185,298,4.0,56.41945648825966
Task_39329,1731,239,54,195,249,7.2125,36.020522109128095
Task_39330,2906,403,147,173,320,7.193069306930693,55.29260411522197
Task_39331,1503,816,153,150,303,1.8396572827417381,34.28123989558964
Task_39332,1226,132,135,123,258,9.218045112781954,27.023394297867664
Task_39333,2193,411,101,109,210,5.322815533980583,43.44690241393516
Task_39334,2341,994,111,45,156,2.3527638190954776,46.260843968224776
Task_39335,601,749,42,21,63,0.8013333333333333,17.082776728398397
Task_39336,1010,392,135,176,311,2.5699745547073793,25.21958074892453
Task_39337,2722,871,86,56,142,3.121559633027523,52.22121609444554
Task_39338,719,504,134,156,290,1.4237623762376237,20.773708351342133
Task_39339,1807,424,180,55,235,4.251764705882353,36.98834741479006
Task_39340,2211,763,198,191,389,2.893979057591623,45.78019445604107
Task_39341,1419,715,108,138,246,1.9818435754189945,32.36141600288369
Task_39342,1861,963,106,148,254,1.9304979253112033,40.186992783204865
Task_39343,967,1016,109,111,220,0.9508357915437562,25.909085455132313
Task_39344,2236,214,120,140,260,10.4,43.71399938887232
Task_39345,942,677,54,51,105,1.3893805309734513,22.865576922609012
Task_39346,2662,962,63,158,221,2.7642782969885773,52.870783743233936
Task_39347,2907,827,111,55,166,3.510869565217391,55.239637297937755
Task_39348,1752,650,74,40,114,2.6912442396313363,35.71744360105722
Task_39349,657,711,87,17,104,0.922752808988764,18.22616024914721
Task_39350,1033,303,93,160,253,3.398026315789474,25.124766773735093
Task_39351,896,80,94,32,126,11.061728395061728,19.65474264182555
Task_39352,1820,218,66,32,98,8.310502283105023,35.0823043040121
Task_39353,2100,133,65,45,110,15.671641791044776,38.60366046493987
Task_39354,1346,402,128,103,231,3.339950372208437,30.100527721075736
Task_39355,1331,698,48,100,148,1.90414878397711,30.218725558769766
Task_39356,1244,163,33,192,225,7.585365853658536,27.508721545997528
Task_39357,626,759,75,57,132,0.8236842105263158,18.734969129793093
Task_39358,1819,428,97,126,223,4.24009324009324,37.690752295559385
Task_39359,2161,476,77,70,147,4.530398322851153,42.237205866194024
Task_39360,1725,802,34,65,99,2.148194271481943,35.87948025266616
Task_39361,2449,366,122,116,238,6.6730245231607626,47.484578329378714
Task_39362,2135,491,74,178,252,4.3394308943089435,43.21064132263542
Task_39363,2367,522,160,60,220,4.525812619502868,46.0103072321183
Task_39364,2146,763,59,20,79,2.8089005235602094,41.30380151496836
Task_39365,2439,423,53,125,178,5.752358490566038,47.24656491066697
Task_39366,704,729,153,45,198,0.9643835616438357,20.070012434361196
Task_39367,994,301,108,120,228,3.2913907284768213,24.218376719208532
Task_39368,2129,220,41,64,105,9.633484162895927,40.44602398204936
Task_39369,1851,64,170,127,297,28.476923076923075,36.38473593520561
Task_39370,2321,590,155,82,237,3.9272419627749575,45.84861656021741
Task_39371,578,159,179,33,212,3.6125,16.136439350622407
Task_39372,1168,583,180,32,212,2.0,26.995017249488154
Task_39373,1423,244,39,156,195,5.808163265306122,30.725041311235433
Task_39374,689,312,191,80,271,2.2012779552715656,19.281162185329222
Task_39375,930,415,73,103,176,2.235576923076923,23.281348601665332
Task_39376,966,637,88,190,278,1.5141065830721003,25.137870355837276
Task_39377,1448,778,148,39,187,1.858793324775353,31.84537305285221
Task_39378,1522,705,194,125,319,2.1558073654390935,34.271747419632355
Task_39379,622,526,141,101,242,1.1802656546489563,18.99586254511951
Task_39380,2304,475,186,148,334,4.840336134453781,46.02814061492268
Task_39381,1795,640,19,170,189,2.800312012480499,37.82587195223901
Task_39382,709,703,133,86,219,1.0071022727272727,20.4683542493508
Task_39383,2178,485,13,62,75,4.481481481481482,41.451516707951434
Task_39384,1549,597,193,67,260,2.5903010033444818,33.56916583705833
Task_39385,978,631,16,98,114,1.5474683544303798,24.092823025653303
Task_39386,758,405,101,97,198,1.8669950738916257,20.68171191476225
Task_39387,773,821,125,195,320,0.940389294403893,22.80270625116241
Task_39388,651,474,35,63,98,1.3705263157894736,17.78036056373327
Task_39389,2231,879,48,92,140,2.5352272727272727,44.97286154348228
Task_39390,2492,607,59,23,82,4.098684210526316,46.775623950072834
Task_39391,2466,225,130,53,183,10.91150442477876,46.32539339688015
Task_39392,726,230,16,128,144,3.142857142857143,19.049042978701276
Task_39393,715,476,86,166,252,1.49895178197065,20.53146741433905
Task_39394,2724,373,64,70,134,7.283422459893048,50.80995219964544
Task_39395,1736,835,80,24,104,2.076555023923445,35.80954315885216
Task_39396,557,801,198,23,221,0.6945137157107232,18.256679626674508
Task_39397,2298,987,91,175,266,2.325910931174089,47.329533209206524
Task_39398,2371,339,115,102,217,6.973529411764706,46.044343090474655
Task_39399,1911,892,193,136,329,2.139977603583427,41.07891667891237
Task_39400,2642,830,125,42,167,3.1793020457280385,50.73318672417222
Task_39401,531,858,155,138,293,0.6181606519208381,19.076634409324054
Task_39402,754,463,196,166,362,1.625,21.593720232680823
Task_39403,694,141,38,69,107,4.887323943661972,17.146382395973813
Task_39404,593,236,133,36,169,2.50210970464135,16.4051036643531
Task_39405,2276,487,154,92,246,4.663934426229508,45.04424408716036
Task_39406,526,776,124,16,140,0.676962676962677,16.97934899235177
Task_39407,1894,242,154,145,299,7.794238683127572,38.59917505628287
Task_39408,538,399,124,23,147,1.345,15.870229434734972
Task_39409,1099,962,71,182,253,1.1412253374870198,28.17978195407106
Task_39410,1477,451,178,150,328,3.267699115044248,32.83646739273485
Task_39411,611,492,162,153,315,1.2393509127789046,19.079960002250488
Task_39412,2825,143,114,153,267,19.618055555555557,52.44132185930127
Task_39413,1369,385,29,20,49,3.5466321243523318,27.70676660399417
Task_39414,2675,804,68,155,223,3.3229813664596275,52.581131034350896
Task_39415,2916,609,10,182,192,4.780327868852459,55.56105428574791
Task_39416,1638,70,73,31,104,23.070422535211268,30.553388716565095
Task_39417,2221,68,95,94,189,32.18840579710145,41.66304220293285
Task_39418,1161,588,118,25,143,1.971137521222411,26.269238659343838
Task_39419,2306,997,28,58,86,2.31062124248497,45.41356603230134
Task_39420,1412,308,21,122,143,4.56957928802589,30.15222706592786
Task_39421,1768,278,156,13,169,6.336917562724015,34.94715217652505
Task_39422,1698,619,57,189,246,2.738709677419355,36.71340938658205
Task_39423,1489,826,78,62,140,1.800483675937122,32.58782934502239
Task_39424,2578,777,53,127,180,3.3136246786632393,50.59053641462063
Task_39425,769,921,175,173,348,0.834056399132321,23.1289790756281
Task_39426,750,203,92,83,175,3.676470588235294,19.445170877273906
Task_39427,1759,184,17,195,212,9.508108108108107,35.68034410122191
Task_39428,531,972,99,149,248,0.5457348406988695,19.090724642198584
Task_39429,1110,745,22,144,166,1.4879356568364612,26.968230502981402
Task_39430,1714,156,88,46,134,10.9171974522293,33.25685887628679
Task_39431,1010,152,90,156,246,6.601307189542483,23.83710826175597
Task_39432,2923,660,159,101,260,4.422087745839637,56.0203168271507
Task_39433,790,724,33,16,49,1.089655172413793,19.76172860225608
Task_39434,2092,448,157,137,294,4.65924276169265,42.388639868793426
Task_39435,2681,877,26,166,192,3.0535307517084282,52.70020464978568
Task_39436,1589,573,183,101,284,2.768292682926829,34.726023742227355
Task_39437,824,689,55,97,152,1.1942028985507247,22.110748871742857
Task_39438,2089,589,184,103,287,3.5406779661016947,42.71090895937999
Task_39439,1642,621,100,171,271,2.639871382636656,35.7604144442542
Task_39440,1745,819,200,176,376,2.1280487804878048,38.49184572496847
Task_39441,702,705,111,93,204,0.9943342776203966,20.57032313786941
Task_39442,2864,809,40,105,145,3.5358024691358025,54.79556745849246
Task_39443,1838,558,126,117,243,3.2880143112701252,38.46020439831161
Task_39444,2281,636,102,92,194,3.5808477237048666,45.36251633817437
Task_39445,2837,559,73,30,103,5.066071428571429,52.45220024427999
Task_39446,1390,221,200,93,293,6.261261261261262,30.39528452703463
Task_39447,1702,624,160,175,335,2.7232,37.014410971875925
Task_39448,2259,432,102,169,271,5.2170900692840645,44.92297906681307
Task_39449,2642,944,93,52,145,2.795767195767196,51.41945006988072
Task_39450,2674,238,91,16,107,11.188284518828452,48.65648355927123
Task_39451,2129,335,151,42,193,6.336309523809524,41.3109469302916
Task_39452,2450,932,121,40,161,2.6259378349410505,47.87226260453
Task_39453,2167,731,22,185,207,2.960382513661202,44.12314673783859
Task_39454,1278,915,145,74,219,1.3951965065502183,30.1205696592005
Task_39455,556,632,41,115,156,0.8783570300157978,17.51615061182007
Task_39456,2031,373,118,37,155,5.43048128342246,39.45939461264981
Task_39457,1432,662,189,137,326,2.1598793363499245,32.76093041257304
Task_39458,2878,173,130,83,213,16.54022988505747,52.790867046193945
Task_39459,917,953,15,14,29,0.9612159329140462,22.424427905940913
Task_39460,1764,512,120,184,304,3.43859649122807,37.515664727676075
Task_39461,2898,538,49,78,127,5.376623376623376,54.38998327286225
Task_39462,2850,319,135,11,146,8.90625,52.097782192422066
Task_39463,516,796,178,170,348,0.6474278544542033,18.878250619698303
Task_39464,1262,905,46,118,164,1.3929359823399559,29.877874879468987
Task_39465,686,352,14,29,43,1.9433427762039661,16.990502189451977
Task_39466,2563,648,95,74,169,3.9491525423728815,49.34705916976254
Task_39467,1111,643,117,193,310,1.7251552795031055,27.613942852742525
Task_39468,1713,310,53,187,240,5.508038585209003,35.93858737410801
Task_39469,2532,739,168,43,211,3.4216216216216218,49.07460284998899
Task_39470,2910,398,46,77,123,7.293233082706767,53.88927493599621
Task_39471,2730,220,190,157,347,12.352941176470589,51.95494838308529
Task_39472,1615,710,68,73,141,2.271448663853727,34.392725171627404
Task_39473,1035,577,156,86,242,1.7906574394463668,25.49037485466693
Task_39474,735,147,86,26,112,4.966216216216216,17.455326739526512
Task_39475,2507,248,95,63,158,10.068273092369479,46.85972261026046
Task_39476,1921,477,60,100,160,4.018828451882845,38.92006096656732
Task_39477,2221,487,175,184,359,4.551229508196721,44.91843658477808
Task_39478,2692,694,196,161,357,3.873381294964029,52.994359681544246
Task_39479,2092,615,124,26,150,3.396103896103896,41.12198944326274
Task_39480,634,87,70,65,135,7.204545454545454,16.000868487824178
Task_39481,2980,792,177,175,352,3.7578814627994954,57.864036320319805
Task_39482,2201,738,44,72,116,2.9783491204330175,43.62499006197294
Task_39483,880,899,185,70,255,0.9777777777777777,23.94382470383337
Task_39484,772,296,67,134,201,2.5993265993265995,20.713409451622677
Task_39485,2870,1003,67,28,95,2.858565737051793,54.258744439623804
Task_39486,1521,901,196,65,261,1.6862527716186253,34.06793928488248
Task_39487,1147,771,30,83,113,1.4857512953367875,27.121291961922527
Task_39488,1715,152,39,106,145,11.209150326797385,33.9322255484598
Task_39489,1882,164,61,30,91,11.406060606060606,35.45578908079302
Task_39490,2130,391,66,18,84,5.433673469387755,40.23142965386119
Task_39491,2329,583,32,104,136,3.988013698630137,45.56611961682569
Task_39492,2862,777,140,189,329,3.67866323907455,55.86420498867326
Task_39493,2130,700,31,16,47,3.0385164051355207,40.77011578288461
Task_39494,2909,64,61,12,73,44.753846153846155,49.41314539290472
Task_39495,507,68,52,181,233,7.3478260869565215,15.239706691926974
Task_39496,2141,165,34,15,49,12.897590361445783,39.22043866679783
Task_39497,2579,191,34,132,166,13.432291666666666,48.44340848457924
Task_39498,1823,769,47,181,228,2.3675324675324676,38.962258712751414
Task_39499,2880,886,134,182,316,3.2468996617812853,56.42290190448241
Task_39500,747,550,198,99,297,1.355716878402904,21.32149138004266
Task_39501,2264,805,48,188,236,2.8089330024813894,46.1807715875831
Task_39502,608,406,92,159,251,1.4938574938574938,18.646239675880565
Task_39503,756,332,165,83,248,2.27027027027027,20.296998184228553
Task_39504,1695,209,134,166,300,8.071428571428571,35.37192076720569
Task_39505,1124,394,190,89,279,2.8455696202531646,26.57049023764979
Task_39506,654,398,110,21,131,1.6390977443609023,17.595026796506364
Task_39507,841,338,101,55,156,2.4808259587020647,20.791894082413034
Task_39508,1034,147,16,150,166,6.986486486486487,23.401146391492194
Task_39509,1392,940,188,169,357,1.4792773645058448,33.13601299562694
Task_39510,2084,569,142,24,166,3.656140350877193,41.03095957208733
Task_39511,878,379,116,10,126,2.3105263157894735,20.99543298389436
Task_39512,1830,817,91,56,147,2.237163814180929,37.99035019015605
Task_39513,1166,350,142,133,275,3.321937321937322,27.327877665092732
Task_39514,1721,796,50,172,222,2.1593475533249684,37.529438427782445
Task_39515,1905,77,95,190,285,24.423076923076923,37.33971816291671
Task_39516,2263,492,52,18,70,4.59026369168357,42.203184835229784
Task_39517,615,547,139,118,257,1.1222627737226278,18.96587931730897
Task_39518,1950,149,183,123,306,13.0,38.819238590072395
Task_39519,674,190,114,180,294,3.5287958115183247,19.190209868501498
Task_39520,2914,695,167,195,362,4.186781609195402,56.58641209899355
Task_39521,2442,501,195,108,303,4.864541832669323,48.098428346397725
Task_39522,1174,486,196,29,225,2.410677618069815,26.85278674746253
Task_39523,2016,120,44,88,132,16.66115702479339,38.30939318142952
Task_39524,2128,699,177,50,227,3.04,42.69085395345585
Task_39525,2025,318,152,184,336,6.347962382445141,41.15763366183749
Task_39526,2835,382,93,162,255,7.402088772845953,53.90134543329512
Task_39527,2190,911,143,13,156,2.401315789473684,43.513797089149364
Task_39528,2023,410,169,111,280,4.922141119221411,41.07189059595298
Task_39529,1415,352,46,32,78,4.008498583569405,28.64984928900957
Task_39530,1245,695,94,19,113,1.7887931034482758,27.68001711985423
Task_39531,2986,309,127,35,162,9.63225806451613,54.40966892204543
Task_39532,1494,659,70,93,163,2.2636363636363637,32.85594608811893
Task_39533,2576,389,47,107,154,6.605128205128205,48.87857753642705
Task_39534,1181,208,33,78,111,5.650717703349282,25.827503037628464
Task_39535,2649,444,77,124,201,5.952808988764045,50.87923010809259
Task_39536,1327,70,128,164,292,18.690140845070424,28.22198549802738
Task_39537,1531,719,83,165,248,2.126388888888889,34.250286110991034
Task_39538,1964,906,92,178,270,2.165380374862183,41.83546637824126
Task_39539,860,787,175,69,244,1.0913705583756346,23.06683594141549
Task_39540,2748,946,37,104,141,2.901795142555438,53.32928746143404
Task_39541,1354,88,132,109,241,15.213483146067416,28.479143495676738
Task_39542,511,554,133,149,282,0.9207207207207208,17.58276688467392
Task_39543,1382,613,33,163,196,2.250814332247557,31.31570708424732
Task_39544,2025,76,189,184,373,26.2987012987013,39.562655044815095
Task_39545,609,214,102,19,121,2.832558139534884,15.95806729219865
Task_39546,1567,653,139,51,190,2.3960244648318043,33.65429366433024
Task_39547,2050,962,89,189,278,2.1287642782969884,43.38693291684703
Task_39548,2454,369,11,104,115,6.632432432432433,46.71947087892775
Task_39549,2719,264,25,176,201,10.260377358490565,51.3671167627847
Task_39550,2105,312,58,72,130,6.725239616613418,40.94037813383995
Task_39551,770,472,68,99,167,1.627906976744186,20.81860294761268
Task_39552,1345,519,165,86,251,2.5865384615384617,30.257491933772794
Task_39553,2855,807,187,158,345,3.5334158415841586,55.874385654760566
Task_39554,596,779,107,126,233,0.764102564102564,19.39381328994529
Task_39555,2195,387,31,161,192,5.657216494845361,43.42987431568747
Task_39556,830,822,124,18,142,1.008505467800729,21.496279733517145
Task_39557,2817,505,88,45,133,5.567193675889328,52.22451588427855
Task_39558,644,853,152,76,228,0.7540983606557377,19.9601309760553
Task_39559,1185,71,194,169,363,16.458333333333332,26.335017319369005
Task_39560,2622,663,198,103,301,3.9487951807228914,51.45002197813426
Task_39561,510,783,61,128,189,0.6505102040816326,18.042574073662013
Task_39562,2191,952,152,88,240,2.2990556138509968,44.97906948722997
Task_39563,2813,651,135,56,191,4.314417177914111,53.4465882686018
Task_39564,539,970,98,104,202,0.5550978372811535,18.989725565729938
Task_39565,1983,257,78,152,230,7.686046511627907,39.888784297417054
Task_39566,2278,957,166,145,311,2.3778705636743216,47.028777653239764
Task_39567,2439,983,131,39,170,2.4786585365853657,47.94942555116857
Task_39568,930,98,44,106,150,9.393939393939394,20.965518562525762
Task_39569,2631,844,54,86,140,3.113609467455621,51.09453184723248
Task_39570,1070,971,147,174,321,1.1008230452674896,27.87281804986034
Task_39571,670,588,139,168,307,1.137521222410866,20.339799240703897
Task_39572,2302,69,189,74,263,32.885714285714286,42.83986573233952
Task_39573,519,878,16,142,158,0.590443686006826,17.938429936241906
Task_39574,2642,496,56,30,86,5.315895372233401,48.87334016465805
Task_39575,1720,469,62,160,222,3.6595744680851063,36.40520637463665
Task_39576,1794,481,70,45,115,3.7219917012448134,35.772904629483016
Task_39577,978,636,31,139,170,1.5353218210361068,24.600469789642187
Task_39578,1206,621,42,42,84,1.9389067524115755,26.571006148631074
Task_39579,2435,285,45,180,225,8.513986013986013,47.01978669661014
Task_39580,2314,861,135,154,289,2.6844547563805103,47.213806433949685
Task_39581,2848,430,34,180,214,6.607888631090487,54.025189759932864
Task_39582,2316,560,37,124,161,4.128342245989304,45.398158529397016
Task_39583,566,297,80,71,151,1.8993288590604027,16.403378183422046
Task_39584,2952,75,191,198,389,38.8421052631579,54.159514801351115
Task_39585,571,311,115,70,185,1.830128205128205,16.700192969280916
Task_39586,2194,974,194,58,252,2.2502564102564104,44.84527093878966
Task_39587,2053,231,200,137,337,8.849137931034482,41.230458505810084
Task_39588,1498,245,87,66,153,6.0894308943089435,30.735302224304487
Task_39589,2542,455,47,87,134,5.574561403508772,48.39946671821475
Task_39590,2227,160,151,158,309,13.832298136645962,43.31728735569815
Task_39591,812,815,50,93,143,0.9950980392156863,22.25876938676832
Task_39592,1698,882,65,68,133,1.9229898074745186,36.215122948497346
Task_39593,2333,107,160,48,208,21.60185185185185,43.14870450805742
Task_39594,1803,982,200,82,282,1.834181078331638,39.07304273221331
Task_39595,911,933,72,45,117,0.9753747323340471,23.29604117550365
Task_39596,1552,638,103,188,291,2.428794992175274,34.50343221827024
Task_39597,755,211,78,89,167,3.561320754716981,19.604485553473605
Task_39598,1482,120,133,99,232,12.24793388429752,30.847152778228818
Task_39599,2051,807,153,89,242,2.5383663366336635,42.38350948044692
Task_39600,2786,951,63,18,81,2.926470588235294,52.34343795201954
Task_39601,2888,675,89,56,145,4.272189349112426,54.34641822774994
Task_39602,2227,1009,188,60,248,2.204950495049505,45.449994007041035
Task_39603,736,396,54,145,199,1.853904282115869,20.505627188465038
Task_39604,2829,573,125,91,216,4.928571428571429,53.89458437631254
Task_39605,2996,1012,110,57,167,2.9575518262586376,57.13476019554536
Task_39606,2651,545,100,160,260,4.855311355311355,51.431635013539676
Task_39607,602,607,63,187,250,0.9901315789473685,19.165646334385514
Task_39608,1896,771,18,196,214,2.4559585492227978,40.007618513672064
Task_39609,1480,785,60,129,189,1.8829516539440203,33.3769088782797
Task_39610,2524,698,113,172,285,3.6108726752503575,50.0374648335752
Task_39611,1735,344,116,64,180,5.028985507246377,35.131663800477774
Task_39612,1526,433,12,181,193,3.5161290322580645,32.99346992375146
Task_39613,1809,921,128,189,317,1.9620390455531453,39.57651085826287
Task_39614,1993,669,31,147,178,2.9746268656716417,40.87336186200162
Task_39615,2477,259,17,45,62,9.526923076923078,45.07615000302254
Task_39616,2173,332,20,136,156,6.525525525525525,42.330378189680374
Task_39617,1525,971,110,159,269,1.5689300411522633,34.92840775326172
Task_39618,2250,582,149,172,321,3.8593481989708405,45.492657207844495
Task_39619,1026,1022,97,179,276,1.002932551319648,27.147208873320363
Task_39620,1192,720,187,53,240,1.653259361997226,28.226876411082973
Task_39621,2822,825,38,60,98,3.416464891041162,53.17720149071774
Task_39622,2119,407,169,43,212,5.193627450980392,41.47884160603331
Task_39623,2863,79,73,37,110,35.7875,50.16494132034067
Task_39624,1329,613,15,83,98,2.1644951140065145,29.22623959430909
Task_39625,1778,328,68,118,186,5.404255319148936,36.5046112726136
Task_39626,1277,681,169,111,280,1.8724340175953078,30.119721212135037
Task_39627,1283,776,69,43,112,1.6512226512226513,28.5859464464893
Task_39628,1049,822,44,66,110,1.2746051032806804,25.305142164373176
Task_39629,1685,968,172,13,185,1.73890608875129,35.9529120824143
Task_39630,2097,1020,45,118,163,2.0538687561214495,43.47690523354603
Task_39631,2085,912,71,125,196,2.2836801752464404,43.40970088302229
Task_39632,1816,495,151,180,331,3.661290322580645,38.40056750916333
Task_39633,2152,205,169,62,231,10.446601941747574,41.6153978033713
Task_39634,812,670,120,52,172,1.2101341281669151,21.605902778911126
Task_39635,2163,561,87,119,206,3.8487544483985765,43.46069708610162
Task_39636,1139,683,40,58,98,1.6652046783625731,26.069963592825214
Task_39637,1860,699,30,71,101,2.657142857142857,37.84922936137888
Task_39638,2503,67,169,153,322,36.80882352941177,46.71595542630862
Task_39639,600,754,71,55,126,0.7947019867549668,18.35280221287452
Task_39640,1550,67,161,53,214,22.794117647058822,30.76029790029143
Task_39641,1647,98,40,34,74,16.636363636363637,30.84954868469224
Task_39642,598,606,127,185,312,0.985172981878089,19.308014764424502
Task_39643,1974,573,98,117,215,3.4390243902439024,40.54900976931351
Task_39644,1767,509,177,169,346,3.4647058823529413,37.7209239863762
Task_39645,827,641,145,184,329,1.2881619937694704,23.10344752789692
Task_39646,2899,258,96,43,139,11.193050193050192,52.731385327874044
Task_39647,2976,419,165,178,343,7.085714285714285,56.5648873950739
Task_39648,2732,957,112,61,173,2.8517745302713986,52.86271578164237
Task_39649,913,434,139,26,165,2.098850574712644,22.171989644674152
Task_39650,2310,282,59,194,253,8.162544169611307,45.334465916819674
Task_39651,2092,309,92,182,274,6.748387096774193,41.98160191467207
Task_39652,2290,868,157,183,340,2.6352128883774455,47.12777468158347
Task_39653,2140,216,103,107,210,9.861751152073733,41.93207062126702
Task_39654,1779,210,186,12,198,8.431279620853081,35.23059064244989
Task_39655,881,756,14,197,211,1.1638044914134742,23.82461637938171
Task_39656,1195,789,58,63,121,1.5126582278481013,27.721530684534702
Task_39657,1951,277,60,113,173,7.017985611510792,39.06482103270277
Task_39658,1650,433,148,36,184,3.80184331797235,33.846861480953514
Task_39659,1658,417,15,185,200,3.9665071770334928,35.10887950107506
Task_39660,1692,779,68,200,268,2.169230769230769,37.19808875320309
Task_39661,873,966,78,104,182,0.9027921406411582,23.967227142305802
Task_39662,1423,860,196,25,221,1.6527293844367015,31.866267590820186
Task_39663,2584,214,147,80,227,12.018604651162791,48.68684279894151
Task_39664,1358,941,48,35,83,1.4416135881104033,29.95820140747954
Task_39665,2423,117,82,193,275,20.533898305084747,46.025780574400876
Task_39666,1618,585,174,23,197,2.7610921501706485,33.99494410822121
Task_39667,2490,452,60,90,150,5.496688741721854,47.64994220251234
Task_39668,999,294,128,80,208,3.386440677966102,23.84065873107605
Task_39669,2450,529,130,101,231,4.622641509433962,47.98048118438993
Task_39670,2727,86,59,11,70,31.344827586206897,47.40045214694914
Task_39671,1432,299,105,199,304,4.773333333333333,31.595130636515094
Task_39672,1715,415,177,192,369,4.122596153846154,36.73398909107045
Task_39673,2109,636,42,20,62,3.3108320251177394,40.23069168072608
Task_39674,1990,362,24,166,190,5.482093663911845,40.09850681514711
Task_39675,1782,651,53,156,209,2.733128834355828,37.94036927346736
Task_39676,2495,66,85,149,234,37.23880597014925,46.259452199653715
Task_39677,2332,626,98,195,293,3.719298245614035,46.852358721611616
Task_39678,2441,212,121,162,283,11.460093896713616,47.078938432772304
Task_39679,877,852,164,118,282,1.0281359906213365,24.2049537593907
Task_39680,907,243,166,50,216,3.7172131147540983,21.859771173264463
Task_39681,1491,697,193,41,234,2.1361031518624642,32.55926271723948
Task_39682,2474,745,68,54,122,3.316353887399464,47.766740212200865
Task_39683,2539,106,103,180,283,23.72897196261682,47.46294364896243
Task_39684,768,652,176,170,346,1.1761102603369067,22.269279269333285
Task_39685,1626,851,79,110,189,1.908450704225352,35.87032507689836
Task_39686,2878,76,149,28,177,37.37662337662338,50.995421041532126
Task_39687,959,71,72,102,174,13.319444444444445,21.85859392715443
Task_39688,1856,992,73,96,169,1.8690835850956697,39.717609480439585
Task_39689,2457,1019,175,104,279,2.4088235294117646,49.85407545442712
Task_39690,2072,778,65,184,249,2.6598202824133503,43.109162750547966
Task_39691,1774,879,112,112,224,2.015909090909091,38.359266077345495
Task_39692,551,672,51,173,224,0.8187221396731055,18.438741748381247
Task_39693,1019,975,75,90,165,1.0440573770491803,26.120828753672125
Task_39694,1540,427,27,113,140,3.5981308411214954,32.58484837974172
Task_39695,1329,378,77,122,199,3.5065963060686016,29.763960673715626
Task_39696,1463,982,119,72,191,1.4883011190233977,33.10900822945066
Task_39697,1140,670,44,133,177,1.698956780923994,27.301909828761108
Task_39698,2118,854,12,170,182,2.4771929824561405,43.45094021410339
Task_39699,1454,491,145,55,200,2.9552845528455283,31.45750800699999
Task_39700,1413,100,16,55,71,13.990099009900991,27.64668854638361
Task_39701,632,206,81,50,131,3.0531400966183573,16.82775663273468
Task_39702,704,872,142,31,173,0.8064146620847652,20.309626940439333
Task_39703,751,605,114,69,183,1.2392739273927393,20.316193220015396
Task_39704,877,1010,44,78,122,0.8674579624134521,23.49828014466785
Task_39705,2881,373,116,142,258,7.7032085561497325,54.47085889879526
Task_39706,516,903,45,193,238,0.5707964601769911,18.629062724974478
Task_39707,2200,891,30,79,109,2.4663677130044843,44.092319003060844
Task_39708,1724,692,21,128,149,2.4877344877344876,36.338410020997394
Task_39709,732,1015,185,29,214,0.7204724409448819,21.68685350004357
Task_39710,1943,694,135,152,287,2.79568345323741,40.801423350296496
Task_39711,622,591,150,173,323,1.0506756756756757,19.622317973088823
Task_39712,1332,484,156,127,283,2.7463917525773196,30.40952880053634
Task_39713,1830,1020,107,79,186,1.792360430950049,39.02191667639918
Task_39714,2170,629,105,153,258,3.4444444444444446,44.06291599908303
Task_39715,2252,397,38,164,202,5.658291457286432,44.39145718558826
Task_39716,1979,611,177,79,256,3.2336601307189543,40.57077125629501
Task_39717,838,838,54,178,232,0.99880810488677,23.527043914441805
Task_39718,575,521,149,117,266,1.1015325670498084,18.305344665941988
Task_39719,2502,482,116,163,279,5.180124223602484,48.959247561228004
Task_39720,539,716,32,200,232,0.7517433751743375,18.326990468452504
Task_39721,2672,308,16,93,109,8.647249190938512,49.8002594387196
Task_39722,603,473,162,66,228,1.2721518987341771,18.00665778857189
Task_39723,1664,243,122,139,261,6.819672131147541,34.789093056832805
Task_39724,2405,547,48,103,151,4.388686131386861,46.75748817061149
Task_39725,2186,307,63,149,212,7.097402597402597,43.18371541086458
Task_39726,2585,765,191,156,347,3.3746736292428197,51.470850591592885
Task_39727,2118,852,178,169,347,2.4830011723329424,44.36359430471213
Task_39728,2158,426,50,59,109,5.053864168618267,41.595387667354316
Task_39729,1965,702,26,57,83,2.795163584637269,39.055920242447115
Task_39730,765,284,200,33,233,2.6842105263157894,19.76743751654814
Task_39731,1782,620,96,154,250,2.869565217391304,37.907793160926694
Task_39732,2405,403,167,176,343,5.952970297029703,47.47294023378429
Task_39733,1095,801,28,41,69,1.3653366583541147,24.917861526044394
Task_39734,1448,633,55,162,217,2.2839116719242902,32.627648779675816
Task_39735,2412,265,106,127,233,9.06766917293233,46.54292390123302
Task_39736,824,739,150,23,173,1.1135135135135135,21.662340488849992
Task_39737,1646,892,59,154,213,1.843225083986562,36.53817578799965
Task_39738,540,657,187,79,266,0.8206686930091185,17.951169646713364
Task_39739,2453,752,192,99,291,3.257636122177955,48.98807705028694
Task_39740,1807,1019,138,63,201,1.7715686274509803,38.67180648350641
Task_39741,695,476,133,63,196,1.4570230607966457,19.324882185374637
Task_39742,2431,328,32,138,170,7.3890577507598785,46.65173016487598
Task_39743,558,844,46,146,192,0.6603550295857988,18.936144497356363
Task_39744,2759,277,30,27,57,9.924460431654676,49.63122940492844
Task_39745,2124,73,115,26,141,28.7027027027027,38.75504044349481
Task_39746,937,369,45,80,125,2.5324324324324325,22.636038351482416
Task_39747,1996,99,16,97,113,19.96,37.51492652937603
Task_39748,1438,353,64,42,106,4.062146892655368,29.381965484982967
Task_39749,1038,222,97,123,220,4.654708520179372,24.64394101011156
Task_39750,1809,186,46,34,80,9.67379679144385,34.88102744351881
Task_39751,1514,724,55,152,207,2.0882758620689654,33.8978067411018
Task_39752,1917,856,43,149,192,2.236872812135356,40.47708043623964
Task_39753,2525,716,190,167,357,3.521617852161785,50.4272699938528
Task_39754,2475,586,113,47,160,4.216354344122657,47.1661892676726
Task_39755,2437,498,172,90,262,4.88376753507014,47.6336110066113
Task_39756,505,206,62,62,124,2.4396135265700485,14.921517906443349
Task_39757,2596,627,94,170,264,4.13375796178344,50.93920584518716
Task_39758,1042,599,11,65,76,1.7366666666666666,23.827873806614267
Task_39759,540,600,194,145,339,0.8985024958402662,18.447140160434174
Task_39760,1739,817,121,155,276,2.125916870415648,37.90906125361405
Task_39761,559,999,19,146,165,0.559,19.09536082736592
Task_39762,2757,486,95,122,217,5.661190965092403,52.73957543386472
Task_39763,2473,687,179,103,282,3.5944767441860463,49.080223628047804
Task_39764,800,994,172,74,246,0.8040201005025126,22.967174202972107
Task_39765,630,811,79,145,224,0.7758620689655172,20.108104791565808
Task_39766,880,266,43,103,146,3.295880149812734,21.62531297522366
Task_39767,2265,80,13,113,126,27.962962962962962,41.72012717103725
Task_39768,2431,893,96,102,198,2.71923937360179,48.734098335120386
Task_39769,2032,726,190,173,363,2.795048143053645,42.68495489390711
Task_39770,2743,543,38,145,183,5.042279411764706,52.34297158146874
Task_39771,721,938,67,155,222,0.7678381256656017,21.941610905858322
Task_39772,2722,390,31,40,71,6.961636828644501,49.43574923601616
Task_39773,2938,429,141,112,253,6.832558139534884,55.49445691124439
Task_39774,2912,512,153,140,293,5.6764132553606235,55.57681662380378
Task_39775,1216,464,72,104,176,2.6150537634408604,27.96428892080975
Task_39776,1343,535,63,119,182,2.5055970149253732,30.22337159808822
Task_39777,2447,537,119,86,205,4.548327137546468,47.555412246973766
Task_39778,1709,333,176,118,294,5.116766467065868,35.92446765144938
Task_39779,1695,764,54,53,107,2.215686274509804,35.23877035625765
Task_39780,603,141,80,107,187,4.246478873239437,16.983888019521
Task_39781,983,936,75,58,133,1.0490928495197438,24.846859675583236
Task_39782,1060,465,130,151,281,2.274678111587983,26.070015853533153
Task_39783,1384,1000,15,53,68,1.3826173826173827,30.436471291886615
Task_39784,1389,692,23,56,79,2.0043290043290045,29.774724812876162
Task_39785,783,357,11,160,171,2.1871508379888267,20.670072375172428
Task_39786,887,1019,170,174,344,0.8696078431372549,25.29347629523804
Task_39787,2048,130,67,177,244,15.633587786259541,40.092394151161066
Task_39788,2370,958,13,70,83,2.4713242961418143,46.4954838246725
Task_39789,1904,89,174,195,369,21.155555555555555,37.83092973901363
Task_39790,518,909,15,174,189,0.5692307692307692,18.504374823273842
Task_39791,2266,451,35,178,213,5.013274336283186,44.87688418126364
Task_39792,2551,458,196,39,235,5.557734204793029,48.55643496632623
Task_39793,2869,788,10,164,174,3.6362484157160964,55.21480761538544
Task_39794,827,682,182,40,222,1.2108345534407028,21.93469055247425
Task_39795,2071,669,192,174,366,3.091044776119403,43.138630070391
Task_39796,1008,974,89,44,133,1.0338461538461539,25.007901548962405
Task_39797,1401,765,195,64,259,1.828981723237598,31.726971042362663
Task_39798,1619,392,15,187,202,4.119592875318066,34.42288120900608
Task_39799,1434,403,87,22,109,3.5495049504950495,29.70778568857075
Task_39800,1441,770,92,185,277,1.8690012970168612,33.16745463236179
Task_39801,1892,706,54,192,246,2.676096181046676,40.06416064675625
Task_39802,2413,542,79,73,152,4.443830570902394,46.455570801390394
Task_39803,2438,788,133,125,258,3.0899873257287704,48.767668504012725
Task_39804,2845,658,148,167,315,4.317147192716237,55.123159932391296
Task_39805,2500,154,77,104,181,16.129032258064516,46.828465002552555
Task_39806,1158,752,188,72,260,1.5378486055776892,27.87568693421922
Task_39807,1099,179,165,109,274,6.105555555555555,25.27597328288098
Task_39808,1433,311,115,61,176,4.592948717948718,30.16641572228869
Task_39809,1056,523,24,124,148,2.015267175572519,25.272239093387952
Task_39810,1588,233,84,142,226,6.786324786324786,33.447261571079856
Task_39811,1210,824,185,25,210,1.4666666666666666,28.33769933752716
Task_39812,2652,290,110,138,248,9.11340206185567,50.50988592935926
Task_39813,2697,199,76,38,114,13.485,49.18781085022588
Task_39814,1148,525,111,30,141,2.182509505703422,25.909073060846634
Task_39815,1166,108,142,105,247,10.697247706422019,25.637229160466998
Task_39816,857,604,15,199,214,1.4165289256198348,23.013886933949703
Task_39817,839,102,108,64,172,8.145631067961165,19.601887899865485
Task_39818,2786,214,113,98,211,12.95813953488372,52.11912513847773
Task_39819,1095,272,160,129,289,4.010989010989011,26.00812354809447
Task_39820,560,474,21,197,218,1.1789473684210525,17.827706879016834
Task_39821,1980,607,129,25,154,3.2565789473684212,39.30377703135131
Task_39822,2519,379,26,172,198,6.628947368421053,48.578414120447405
Task_39823,1322,74,192,48,240,17.626666666666665,26.993297495828568
Task_39824,1761,163,178,44,222,10.737804878048781,34.79636324400446
Task_39825,896,150,188,80,268,5.933774834437086,21.719751381248184
Task_39826,1027,998,150,193,343,1.028028028028028,27.4182580400325
Task_39827,1951,310,111,94,205,6.273311897106109,39.182454229230636
Task_39828,798,79,87,36,123,9.975,17.88829917579172
Task_39829,1735,353,78,93,171,4.901129943502825,35.66621763484716
Task_39830,1256,762,74,169,243,1.6461336828309305,30.075928814680253
Task_39831,2097,242,33,107,140,8.62962962962963,40.774844809497004
Task_39832,1743,974,60,146,206,1.7876923076923077,38.2599803315254
Task_39833,1592,559,93,24,117,2.842857142857143,32.91127808281943
Task_39834,2717,110,94,20,114,24.47747747747748,48.446794763857696
Task_39835,1057,749,158,192,350,1.4093333333333333,27.212192072799265
Task_39836,2241,569,181,70,251,3.931578947368421,44.39921657952081
Task_39837,2026,588,17,198,215,3.4397283531409166,41.46260147309129
Task_39838,1989,735,71,194,265,2.702445652173913,41.74806434575298
Task_39839,2452,471,102,65,167,5.194915254237288,46.871031645934806
Task_39840,1348,785,65,153,218,1.7150127226463103,31.46233109121253
Task_39841,2658,308,139,154,293,8.601941747572816,50.894745459349814
Task_39842,2638,912,119,179,298,2.8893756845564074,52.58417643792726
Task_39843,1129,779,48,35,83,1.4474358974358974,25.827314665759932
Task_39844,767,670,70,90,160,1.1430700447093889,21.019189477208773
Task_39845,2254,560,24,19,43,4.017825311942959,42.14551497729488
Task_39846,1509,764,186,132,318,1.9725490196078432,34.25562149654833
Task_39847,1357,897,76,27,103,1.5111358574610245,30.048591223006866
Task_39848,2022,348,181,124,305,5.793696275071634,40.983362046253724
Task_39849,1475,656,20,171,191,2.2450532724505328,32.84507928205087
Task_39850,2139,112,80,32,112,18.92920353982301,39.25294029132819
Task_39851,1091,498,178,23,201,2.186372745490982,25.394777367303174
Task_39852,958,252,85,16,101,3.7865612648221343,21.4908929698617
Task_39853,2689,983,90,49,139,2.7327235772357725,51.811281751015535
Task_39854,2242,563,88,116,204,3.975177304964539,44.71570098235265
Task_39855,875,233,44,105,149,3.7393162393162394,21.43993770365368
Task_39856,2154,462,134,176,310,4.652267818574514,43.5445807456731
Task_39857,996,721,197,27,224,1.3795013850415512,24.694578614609938
Task_39858,999,580,170,11,181,1.7194492254733218,23.82333870487525
Task_39859,2105,149,141,150,291,14.033333333333333,41.23367217760992
Task_39860,2086,102,34,161,195,20.25242718446602,39.94548032878279
Task_39861,1903,784,119,61,180,2.424203821656051,39.11966146471127
Task_39862,638,829,165,56,221,0.7686746987951807,19.688940089794425
Task_39863,763,313,79,120,199,2.429936305732484,20.60455368341159
Task_39864,1159,140,146,20,166,8.21985815602837,24.590274412538587
Task_39865,2285,464,71,148,219,4.913978494623656,45.30042647929554
Task_39866,2995,131,50,140,190,22.689393939393938,54.70731342671286
Task_39867,1346,675,25,43,68,1.9911242603550297,28.538226157270575
Task_39868,931,657,176,41,217,1.4148936170212767,23.48347396361827
Task_39869,2554,333,15,51,66,7.6467065868263475,46.87637917985478
Task_39870,545,364,182,90,272,1.4931506849315068,17.268944292383495
Task_39871,2058,305,66,44,110,6.7254901960784315,39.23708936222358
Task_39872,1646,179,68,58,126,9.144444444444444,32.60076305524132
Task_39873,1693,1012,170,51,221,1.6712734452122409,36.924320371542024
Task_39874,2656,872,153,92,245,3.042382588774341,52.27716298446115
Task_39875,1040,595,96,118,214,1.74496644295302,25.849983638324233
Task_39876,1416,695,150,63,213,2.0344827586206895,31.531698232193026
Task_39877,565,729,116,98,214,0.773972602739726,18.62525965918712
Task_39878,1475,232,66,46,112,6.330472103004292,29.848512281639575
Task_39879,2176,994,189,50,239,2.1869346733668342,44.42703582227924
Task_39880,2145,266,142,97,239,8.03370786516854,42.34358940664869
Task_39881,2660,915,15,32,47,2.903930131004367,50.06157268807309
Task_39882,722,424,193,181,374,1.6988235294117646,21.041080574251062
Task_39883,2751,598,148,74,222,4.592654424040067,52.530795919889904
Task_39884,1054,311,182,134,316,3.378205128205128,25.616674984073356
Task_39885,2681,598,172,60,232,4.475792988313857,51.27982301298844
Task_39886,1847,576,18,102,120,3.20103986135182,37.73045800422573
Task_39887,1514,978,198,166,364,1.5464759959141983,35.21423144509948
Task_39888,2899,1000,96,21,117,2.896103896103896,54.84296080078113
Task_39889,2147,961,69,199,268,2.231808731808732,44.97220626603589
Task_39890,762,465,139,24,163,1.6351931330472103,19.75181114005269
Task_39891,1918,515,82,70,152,3.7170542635658914,38.42103697526395
Task_39892,1713,500,26,149,175,3.4191616766467066,36.01660694350149
Task_39893,2401,367,189,95,284,6.524456521739131,46.876985755431235
Task_39894,2152,422,17,197,214,5.087470449172577,42.918872895160256
Task_39895,1562,386,146,101,247,4.036175710594315,33.535899111979084
Task_39896,2219,580,85,21,106,3.819277108433735,42.55329481828963
Task_39897,1697,320,172,125,297,5.286604361370716,35.71524221591529
Task_39898,2030,617,42,159,201,3.284789644012945,41.57326871408403
Task_39899,2660,482,173,117,290,5.507246376811594,51.44256159289296
Task_39900,2195,132,180,113,293,16.50375939849624,42.42279864036024
Task_39901,1785,102,91,33,124,17.33009708737864,33.846852335591414
Task_39902,578,757,137,106,243,0.762532981530343,19.055525686901788
Task_39903,2008,609,178,100,278,3.2918032786885245,41.44649019808949
Task_39904,932,628,56,107,163,1.4817170111287759,23.90420705860083
Task_39905,621,181,94,61,155,3.412087912087912,16.639794658029434
Task_39906,958,357,72,87,159,2.6759776536312847,23.094236848938674
Task_39907,2816,995,64,153,217,2.8273092369477912,55.38878982730753
Task_39908,2636,318,198,41,239,8.263322884012538,49.482612690623775
Task_39909,1656,182,143,134,277,9.049180327868852,34.34096905544704
Task_39910,1053,189,195,99,294,5.542105263157895,25.040558398812802
Task_39911,1853,978,142,85,227,1.8927477017364658,39.617995488752165
Task_39912,2347,685,91,38,129,3.4212827988338192,45.461049521710926
Task_39913,1321,435,29,73,102,3.029816513761468,28.504569921092884
Task_39914,1397,801,161,128,289,1.7418952618453865,32.446418845447745
Task_39915,1760,964,144,111,255,1.8238341968911918,38.539876409297555
Task_39916,725,142,163,183,346,5.06993006993007,19.7547397898359
Task_39917,2662,176,85,40,125,15.03954802259887,48.150610515684996
Task_39918,1243,186,185,96,281,6.647058823529412,28.15386349262589
Task_39919,2028,435,54,139,193,4.651376146788991,41.040388152999725
Task_39920,2836,952,153,181,334,2.9758656873032527,56.011847141466966
Task_39921,1733,429,193,50,243,4.030232558139535,35.65121415986723
Task_39922,1001,414,25,193,218,2.4120481927710844,24.801297858581524
Task_39923,942,259,56,173,229,3.623076923076923,23.499999009427317
Task_39924,2226,678,122,134,256,3.2783505154639174,45.06767635668654
Task_39925,2224,717,10,97,107,3.097493036211699,44.037308492489196
Task_39926,3000,484,189,144,333,6.185567010309279,57.06475830992289
Task_39927,2017,841,16,18,34,2.3954869358669835,39.14391099412943
Task_39928,2948,582,170,68,238,5.056603773584905,55.57882347379288
Task_39929,2405,502,64,44,108,4.78131212723658,45.23823284900977
Task_39930,1336,365,15,87,102,3.650273224043716,28.68558387644354
Task_39931,2216,852,147,47,194,2.5978898007034,44.35052588414823
Task_39932,828,227,117,30,147,3.6315789473684212,19.954040688126042
Task_39933,2371,1018,126,15,141,2.326790971540726,46.634363965963416
Task_39934,2728,978,136,127,263,2.7865168539325844,53.982449962011
Task_39935,2986,977,130,15,145,3.053169734151329,56.36527063012405
Task_39936,1609,368,186,167,353,4.360433604336043,34.79548468028934
Task_39937,700,126,38,100,138,5.511811023622047,17.63663647835966
Task_39938,1657,816,143,25,168,2.0281517747858016,35.001039221671505
Task_39939,1396,857,192,17,209,1.627039627039627,31.199472219425974
Task_39940,2309,234,68,115,183,9.825531914893617,44.49872864521431
Task_39941,943,340,53,153,206,2.7653958944281527,23.656616589744203
Task_39942,1712,574,119,55,174,2.977391304347826,35.61299550830288
Task_39943,2406,287,174,13,187,8.354166666666666,45.310129583821116
Task_39944,875,835,79,67,146,1.0466507177033493,22.917348850402636
Task_39945,2133,242,144,177,321,8.777777777777779,42.520956465482136
Task_39946,1398,824,155,115,270,1.6945454545454546,32.429071140833
Task_39947,2072,303,84,197,281,6.815789473684211,41.6681728826713
Task_39948,515,877,102,45,147,0.5865603644646925,17.334151987684816
Task_39949,1174,84,43,193,236,13.811764705882354,25.75526545583328
Task_39950,1374,380,63,147,210,3.606299212598425,30.570670897529286
Task_39951,2691,471,168,169,337,5.701271186440678,52.185481787720015
Task_39952,1263,979,130,58,188,1.2887755102040817,29.747923079074877
Task_39953,1330,331,81,182,263,4.006024096385542,29.9815935496437
Task_39954,1330,179,147,26,173,7.388888888888889,27.7363837091244
Task_39955,2195,184,95,94,189,11.864864864864865,42.39181178996135
Task_39956,2664,614,180,130,310,4.331707317073171,52.039676253799406
Task_39957,2159,949,70,23,93,2.2726315789473683,42.87817746223127
Task_39958,985,597,105,173,278,1.6471571906354514,25.301447546702676
Task_39959,1333,227,153,156,309,5.8464912280701755,29.745890270214677
Task_39960,2641,207,169,26,195,12.697115384615385,48.91351390607472
Task_39961,2622,968,144,161,305,2.7058823529411766,52.510648668151156
Task_39962,935,414,117,61,178,2.253012048192771,22.614232002100067
Task_39963,895,257,189,121,310,3.4689922480620154,22.880892298931304
Task_39964,1441,716,177,50,227,2.0097629009762903,31.86163237888597
Task_39965,2701,411,85,11,96,6.555825242718447,49.58460539960446
Task_39966,2804,210,117,43,160,13.289099526066352,51.081146060361
Task_39967,2550,909,94,152,246,2.802197802197802,50.99024200020611
Task_39968,682,882,106,39,145,0.7723669309173273,19.74603480601464
Task_39969,2765,779,93,149,242,3.5448717948717947,53.99498007894403
Task_39970,1947,446,173,115,288,4.355704697986577,40.02787392396845
Task_39971,560,853,57,116,173,0.6557377049180327,18.8973861212213
Task_39972,1443,579,79,141,220,2.4879310344827585,32.33382330796646
Task_39973,1026,161,120,182,302,6.333333333333333,24.38219189092176
Task_39974,2158,358,66,140,206,6.011142061281337,42.867929135068664
Task_39975,2922,587,143,159,302,4.969387755102041,56.045649330994785
Task_39976,1396,970,19,154,173,1.4376930998970134,32.29930336068828
Task_39977,790,174,120,197,317,4.514285714285714,20.713577457915445
Task_39978,606,413,198,172,370,1.463768115942029,19.084740477314515
Task_39979,1682,297,73,115,188,5.644295302013423,34.98467894798536
Task_39980,2419,687,107,167,274,3.515988372093023,48.282630659613346
Task_39981,2892,769,162,192,354,3.755844155844156,56.43134387334103
Task_39982,2487,733,200,139,339,3.388283378746594,49.75669394867356
Task_39983,1040,518,25,72,97,2.003853564547206,24.19409717545788
Task_39984,1215,973,25,186,211,1.2474332648870636,29.7016802685623
Task_39985,2478,491,149,144,293,5.036585365853658,48.64372674481334
Task_39986,1092,767,81,29,110,1.421875,25.448735910447976
Task_39987,2929,1024,28,112,140,2.857560975609756,56.464466911736515
Task_39988,1831,520,155,111,266,3.5143953934740884,38.323601394107676
Task_39989,561,88,106,51,157,6.303370786516854,14.711840047459058
Task_39990,2792,198,112,177,289,14.030150753768844,52.6591859790934
Task_39991,1175,611,123,96,219,1.9199346405228759,28.01236878154123
Task_39992,2654,377,13,72,85,7.021164021164021,49.195320705799226
Task_39993,1974,680,175,38,213,2.898678414096916,40.09717409448602
Task_39994,2641,81,127,124,251,32.207317073170735,48.63729547446633
Task_39995,1503,146,82,165,247,10.224489795918368,31.60301285892289
Task_39996,1732,378,15,173,188,4.569920844327177,36.04430046750638
Task_39997,2671,692,22,121,143,3.854256854256854,51.30321878288322
Task_39998,2564,834,83,53,136,3.0706586826347304,49.63017504375147
Task_39999,912,945,120,55,175,0.9640591966173362,24.151201569245686
Task_40000,532,149,145,67,212,3.546666666666667,15.572790938456722
Task_40001,512,135,68,33,101,3.764705882352941,13.79108517354456
Task_40002,2886,647,128,123,251,4.453703703703703,55.38460200510578
Task_40003,1229,795,180,183,363,1.5439698492462313,30.150989688317846
Task_40004,2462,384,10,110,120,6.394805194805195,46.897088856288036
Task_40005,2457,836,153,166,319,2.935483870967742,49.55414747734013
Task_40006,1626,679,182,90,272,2.3911764705882352,35.409871534719024
Task_40007,2834,930,115,64,179,3.0440386680988185,54.38776288506032
Task_40008,1269,643,179,136,315,1.970496894409938,30.068803403280288
Task_40009,2296,817,27,110,137,2.806845965770171,45.78727935658532
Task_40010,2340,664,151,17,168,3.518796992481203,45.16103956756476
Task_40011,904,433,178,146,324,2.0829493087557602,23.686502564996285
Task_40012,658,156,177,147,324,4.191082802547771,18.62333412931021
Task_40013,1881,1016,36,88,124,1.8495575221238938,39.63913961213613
Task_40014,2422,571,198,92,290,4.234265734265734,47.82362112963938
Task_40015,2663,516,74,17,91,5.150870406189555,49.26179866763757
Task_40016,2733,578,37,30,67,4.72020725388601,50.169804406745726
Task_40017,2475,159,156,156,312,15.46875,47.237369244586
Task_40018,2625,958,103,137,240,2.7372262773722627,52.198848256136785
Task_40019,2911,147,183,103,286,19.66891891891892,53.81628758389345
Task_40020,1585,245,91,196,287,6.443089430894309,33.79801406038154
Task_40021,1628,873,55,103,158,1.862700228832952,35.55323482712456
Task_40022,2267,857,110,14,124,2.6421911421911424,44.378230487378595
Task_40023,1445,167,151,39,190,8.601190476190476,29.673288218029736
Task_40024,2169,553,185,185,370,3.9151624548736463,44.357609258964295
Task_40025,2284,129,29,177,206,17.56923076923077,43.49227293249478
Task_40026,841,200,186,116,302,4.1840796019900495,21.79435812739615
Task_40027,2060,529,61,93,154,3.8867924528301887,41.191565978138904
Task_40028,771,399,34,24,58,1.9275,18.575490113057516
Task_40029,1969,288,39,83,122,6.813148788927336,38.67256292100419
Task_40030,505,570,148,51,199,0.8844133099824869,16.672180241002973
Task_40031,1726,805,197,114,311,2.141439205955335,37.76334111521585
Task_40032,2191,964,94,150,244,2.270466321243523,45.461081529248354
Task_40033,1281,614,19,30,49,2.0829268292682928,27.279479260175236
Task_40034,2667,765,159,151,310,3.4817232375979112,52.595821511810925
Task_40035,2219,604,43,189,232,3.667768595041322,44.709018232180995
Task_40036,2478,71,198,188,386,34.416666666666664,46.69435044915471
Task_40037,2029,156,172,125,297,12.92356687898089,40.07976526741984
Task_40038,644,612,141,132,273,1.0505709624796085,19.7504295414727
Task_40039,2715,701,188,144,332,3.8675213675213675,53.243226798839544
Task_40040,2330,666,132,113,245,3.4932533733133435,46.59675432208038
Task_40041,1738,473,132,119,251,3.6666666666666665,36.64554194258033
Task_40042,1625,159,80,161,241,10.15625,33.647519880771384
Task_40043,664,685,198,151,349,0.967930029154519,20.710790820186574
Task_40044,2472,453,149,151,300,5.4449339207048455,48.467065128763295
Task_40045,2406,672,89,71,160,3.575037147102526,46.69105513208834
Task_40046,2398,340,190,74,264,7.032258064516129,46.28866178718837
Task_40047,1965,716,35,19,54,2.7405857740585775,38.29983405612305
Task_40048,1161,78,122,24,146,14.69620253164557,23.79845355157582
Task_40049,2648,697,184,47,231,3.793696275071633,50.874485359033535
Task_40050,2057,813,186,85,271,2.527027027027027,42.53487900895369
Task_40051,2712,1018,39,146,185,2.661432777232581,53.41241659392724
Task_40052,2616,484,59,90,149,5.393814432989691,49.81121017974812
Task_40053,1194,800,54,57,111,1.4906367041198503,27.386010142336715
Task_40054,1198,979,179,186,365,1.2224489795918367,30.163137519576935
Task_40055,1074,78,83,67,150,13.594936708860759,22.741292276177393
Task_40056,1496,706,23,64,87,2.1159830268741158,31.866805089974445
Task_40057,853,595,33,133,166,1.4312080536912752,22.421834968787483
Task_40058,775,280,120,195,315,2.7580071174377223,21.190300562494116
Task_40059,1586,1003,110,171,281,1.5796812749003983,36.06595704212902
Task_40060,2282,244,67,126,193,9.314285714285715,44.352765291859555
Task_40061,869,859,129,88,217,1.0104651162790699,23.492159306773875
Task_40062,2634,200,56,77,133,13.104477611940299,48.976621055499606
Task_40063,2858,523,40,77,117,5.4541984732824424,53.41221970091539
Task_40064,1131,404,15,186,201,2.7925925925925927,26.7336735965773
Task_40065,1831,1010,57,165,222,1.8110781404549952,39.89690655729855
Task_40066,2417,116,146,71,217,20.65811965811966,44.96823277597468
Task_40067,1044,378,46,96,142,2.7546174142480213,24.625237469459478
Task_40068,1579,897,57,131,188,1.7583518930957684,35.29898087582648
Task_40069,1057,91,60,89,149,11.48913043478261,23.050379160570774
Task_40070,1830,251,17,175,192,7.261904761904762,37.119520351405875
Task_40071,2544,589,150,124,274,4.311864406779661,49.88852036811185
Task_40072,1673,480,50,34,84,3.4781704781704783,33.53194661549833
Task_40073,2579,136,176,72,248,18.824817518248175,47.90352344259927
Task_40074,985,599,198,23,221,1.6416666666666666,24.121472324061813
Task_40075,766,458,12,22,34,1.6688453159041394,18.34203799615406
Task_40076,1388,592,62,125,187,2.3406408094435074,31.29145031424582
Task_40077,2183,291,82,70,152,7.476027397260274,41.87659116962938
Task_40078,2780,100,164,151,315,27.524752475247524,51.333348725053575
Task_40079,2972,566,79,48,127,5.241622574955908,54.90172375596629
Task_40080,2923,918,46,200,246,3.18063112078346,56.94965485238911
Task_40081,1634,247,36,195,231,6.588709677419355,34.28493590411982
Task_40082,2578,697,185,53,238,3.693409742120344,50.0959775549398
Task_40083,1983,345,30,95,125,5.73121387283237,39.31221274958593
Task_40084,2726,894,184,51,235,3.0458100558659216,52.984289580031714
Task_40085,2499,944,27,195,222,2.6444444444444444,50.20339807090517
Task_40086,2601,965,191,189,380,2.6925465838509317,52.54758927454657
Task_40087,1293,917,113,121,234,1.408496732026144,30.845593794442426
Task_40088,2839,387,196,52,248,7.31701030927835,53.2645358971011
Task_40089,1242,906,172,111,283,1.3693495038588754,30.216577228224025
Task_40090,1816,678,68,107,175,2.674521354933726,38.22568488456855
Task_40091,871,918,80,39,119,0.9477693144722524,22.63544504468254
Task_40092,2921,529,200,37,237,5.511320754716981,54.70692398781862
Task_40093,989,534,135,37,172,1.8485981308411215,23.763235452743753
Task_40094,749,297,76,19,95,2.5134228187919465,18.323269424463234
Task_40095,2174,887,161,160,321,2.4481981981981984,45.22972086079334
Task_40096,545,382,75,61,136,1.422976501305483,16.230895328734864
Task_40097,1631,354,125,114,239,4.594366197183098,34.50622821477493
Task_40098,1963,843,80,100,180,2.325829383886256,40.96729862088829
Task_40099,2190,936,49,197,246,2.3372465314834576,45.512971459044586
Task_40100,1101,784,55,192,247,1.4025477707006369,27.68441284261029
Task_40101,1157,461,199,79,278,2.5043290043290045,27.18089587388066
Task_40102,668,797,119,120,239,0.8370927318295739,20.576474633812577
Task_40103,2500,677,155,122,277,3.687315634218289,49.481619176780725
Task_40104,2431,224,54,159,213,10.804444444444444,46.80675088754412
Task_40105,2421,886,194,137,331,2.729425028184893,49.15167739481368
Task_40106,1214,496,189,56,245,2.442655935613682,27.878174832450714
Task_40107,686,1005,68,157,225,0.6819085487077535,21.767218989391505
Task_40108,506,570,78,12,90,0.8861646234676007,15.568223053272868
Task_40109,684,610,171,82,253,1.1194762684124386,19.959799211438177
Task_40110,1374,307,140,19,159,4.461038961038961,28.61308932939096
Task_40111,2592,862,104,161,265,3.003476245654693,51.52380140406924
Task_40112,1296,992,21,184,205,1.3051359516616314,31.031552298011835
Task_40113,1172,100,57,87,144,11.603960396039604,24.850524150838595
Task_40114,2722,408,149,99,248,6.6552567237163816,51.94991579279618
Task_40115,2738,577,50,16,66,4.737024221453288,50.07119023727741
Task_40116,2610,456,123,140,263,5.711159737417943,50.47827604780141
Task_40117,1980,1003,126,41,167,1.9721115537848606,40.78762560572518
Task_40118,1495,958,126,147,273,1.5589155370177268,34.41313910823853
Task_40119,1419,360,33,48,81,3.930747922437673,29.18950331411649
Task_40120,1076,262,155,23,178,4.091254752851711,24.115397329370577
Task_40121,1550,916,195,38,233,1.6902944383860414,34.19566344936189
Task_40122,756,448,183,155,338,1.6837416481069043,21.454094930622023
Task_40123,768,1000,135,76,211,0.7672327672327672,22.339063013107715
Task_40124,556,172,88,50,138,3.213872832369942,15.048767750543822
Task_40125,1095,698,12,77,89,1.5665236051502145,25.4840286062706
Task_40126,732,730,102,174,276,1.0013679890560876,21.56662010575229
Task_40127,823,568,84,176,260,1.4463971880492092,22.559859199248205
Task_40128,2122,214,28,192,220,9.869767441860466,41.8508951505804
Task_40129,1125,638,39,136,175,1.7605633802816902,27.075170270227563
Task_40130,615,652,180,43,223,0.9418070444104135,18.582375794835773
Task_40131,2894,998,139,80,219,2.896896896896897,56.12300276179573
Task_40132,1921,277,194,161,355,6.910071942446043,39.424881005179294
Task_40133,2530,271,63,156,219,9.301470588235293,48.53690215492416
Task_40134,1285,487,109,131,240,2.6331967213114753,29.48704673530582
Task_40135,1233,670,12,13,25,1.8375558867362145,26.29708362639428
Task_40136,2058,235,139,55,194,8.720338983050848,40.13350087467328
Task_40137,1303,595,192,45,237,2.186241610738255,29.234462971809155
Task_40138,2169,337,90,75,165,6.4171597633136095,42.20408899124818
Task_40139,2845,949,127,16,143,2.9947368421052634,53.961319883866445
Task_40140,792,815,125,93,218,0.9705882352941176,22.39974312617709
Task_40141,2410,584,13,186,199,4.119658119658119,47.559376618839885
Task_40142,1705,307,89,37,126,5.535714285714286,33.992006836167555
Task_40143,1403,73,195,38,233,18.95945945945946,28.190497856129223
Task_40144,2205,178,167,183,350,12.318435754189943,43.16131537040508
Task_40145,1871,1021,25,126,151,1.8307240704500978,39.74474977623408
Task_40146,2150,287,30,53,83,7.465277777777778,40.7100370174788
Task_40147,2634,742,155,29,184,3.5450874831763124,50.41839844998125
Task_40148,1643,983,86,68,154,1.6697154471544715,35.47021367177273
Task_40149,2545,858,95,21,116,2.9627473806752036,48.858905297597595
Task_40150,687,77,132,36,168,8.807692307692308,16.64866944487456
Task_40151,2135,729,53,117,170,2.9246575342465753,43.3556571376055
Task_40152,2056,231,183,98,281,8.862068965517242,40.971569222860964
Task_40153,2700,186,74,198,272,14.438502673796792,51.36265020039453
Task_40154,2584,101,70,91,161,25.333333333333332,47.166756774343725
Task_40155,2966,1003,106,23,129,2.954183266932271,56.165122815709395
Task_40156,2557,813,139,138,277,3.1412776412776413,50.83610764781872
Task_40157,2863,615,109,50,159,4.6477272727272725,53.46709746695493
Task_40158,816,811,118,142,260,1.0049261083743843,23.02912524631772
Task_40159,1514,187,148,32,180,8.053191489361701,31.019280982450425
Task_40160,1834,658,126,103,229,2.7830045523520486,38.62862629532863
Task_40161,2538,481,57,102,159,5.265560165975104,48.72692944215864
Task_40162,2957,526,155,160,315,5.611005692599621,56.463200695850446
Task_40163,1425,835,116,119,235,1.7045454545454546,32.7391545753155
Task_40164,2732,661,142,140,282,4.126888217522659,53.15457604605327
Task_40165,2236,295,59,86,145,7.554054054054054,43.129956084121396
Task_40166,2238,400,174,29,203,5.581047381546135,43.31721765954637
Task_40167,1656,703,121,140,261,2.352272727272727,36.14869339097304
Task_40168,611,77,112,156,268,7.833333333333333,16.906436203657446
Task_40169,2476,714,39,88,127,3.462937062937063,48.14554510139849
Task_40170,1042,749,78,83,161,1.3893333333333333,25.52401185090936
Task_40171,896,834,80,98,178,1.0730538922155688,23.82267644745951
Task_40172,1838,88,143,168,311,20.651685393258425,36.47308586644657
Task_40173,2664,924,96,174,270,2.88,52.95298510623443
Task_40174,1289,666,154,154,308,1.9325337331334334,30.452228237741426
Task_40175,1942,975,113,25,138,1.9897540983606556,39.7922517833784
Task_40176,2492,592,47,47,94,4.202360876897133,46.949568709545396
Task_40177,1503,646,43,18,61,2.3230293663060277,30.649193326630108
Task_40178,2434,721,147,111,258,3.371191135734072,48.47321336603026
Task_40179,749,457,171,27,198,1.6353711790393013,19.842464322893935
Task_40180,1156,1015,123,99,222,1.1377952755905512,28.863266954282636
Task_40181,1855,800,192,125,317,2.3158551810237205,39.834682756162024
Task_40182,1555,516,66,106,172,3.007736943907157,33.56122038847161
Task_40183,1268,352,144,64,208,3.592067988668555,28.089448903685565
Task_40184,864,797,58,192,250,1.0827067669172932,23.85577901353463
Task_40185,1711,502,196,94,290,3.4015904572564613,36.39418675283773
Task_40186,1262,472,63,19,82,2.668076109936575,26.676312358664713
Task_40187,775,745,103,22,125,1.0388739946380696,20.583114706742013
Task_40188,1567,551,44,59,103,2.838768115942029,32.45427209040505
Task_40189,1675,323,28,179,207,5.169753086419753,35.09180928629055
Task_40190,2376,343,165,129,294,6.906976744186046,46.523629922261854
Task_40191,1797,992,137,48,185,1.809667673716012,37.9823750734621
Task_40192,717,860,114,70,184,0.8327526132404182,20.685627937489063
Task_40193,630,745,193,138,331,0.8445040214477212,20.254686368524137
Task_40194,2119,717,14,52,66,2.9512534818941503,41.26239896472836
Task_40195,2874,987,160,136,296,2.908906882591093,56.486092929039046
Task_40196,820,693,196,90,286,1.181556195965418,22.664530155845586
Task_40197,2487,146,187,61,248,16.918367346938776,46.46790292441896
Task_40198,2291,652,10,52,62,3.5084226646248085,43.710043595814994
Task_40199,1712,557,169,164,333,3.068100358422939,36.93641533415978
Task_40200,1527,337,130,105,235,4.517751479289941,32.77420243872435
Task_40201,682,683,55,24,79,0.9970760233918129,18.241572171455914
Task_40202,644,567,14,156,170,1.1338028169014085,19.038404939838685
Task_40203,503,900,120,12,132,0.55826859045505,17.084833570366122
Task_40204,2655,707,188,187,375,3.75,52.568600886478826
Task_40205,846,848,18,17,35,0.9964664310954063,20.758434514743026
Task_40206,2426,864,165,58,223,2.8046242774566474,48.04770322485414
Task_40207,1972,410,71,119,190,4.798053527980535,39.9865700763197
Task_40208,703,647,199,48,247,1.0848765432098766,19.95057840779552
Task_40209,771,970,21,77,98,0.7940267765190525,21.407717008329048
Task_40210,2835,953,143,128,271,2.9716981132075473,55.637487597437406
Task_40211,877,954,134,10,144,0.9183246073298429,22.94716889399325
Task_40212,2718,401,47,173,220,6.7611940298507465,51.910720434219364
Task_40213,611,955,172,105,277,0.6391213389121339,20.434311421343406
Task_40214,2324,800,36,17,53,2.9013732833957553,44.209306078939754
Task_40215,2081,301,50,179,229,6.8907284768211925,41.68501415681009
Task_40216,2612,599,125,113,238,4.3533333333333335,50.81891102492983
Task_40217,2494,920,137,185,322,2.7079261672095547,50.44436252775222
Task_40218,523,406,46,91,137,1.285012285012285,16.189298744702885
Task_40219,2408,487,155,35,190,4.934426229508197,46.21744401376845
Task_40220,1289,442,27,194,221,2.909706546275395,29.45542660457744
Task_40221,2395,322,96,133,229,7.414860681114551,46.51819747554554
Task_40222,706,732,156,32,188,0.9631650750341064,20.08415604919068
Task_40223,2350,67,25,69,94,34.55882352941177,42.09838859909898
Task_40224,651,149,119,53,172,4.34,17.18416371631056
Task_40225,997,914,22,48,70,1.0896174863387977,23.844862332966823
Task_40226,561,938,180,15,195,0.597444089456869,18.64693507409181
Task_40227,2423,313,155,194,349,7.7165605095541405,47.50734274779173
Task_40228,2854,480,34,18,52,5.9334719334719335,51.60257780399638
Task_40229,1416,850,33,151,184,1.663924794359577,32.33788993947987
Task_40230,1202,214,151,124,275,5.590697674418605,27.431764801562508
Task_40231,2668,680,104,133,237,3.9177679882525696,51.98800506953054
Task_40232,2408,102,152,17,169,23.37864077669903,43.80649787648529
Task_40233,2941,504,179,134,313,5.823762376237624,56.09125954866255
Task_40234,2685,499,87,138,225,5.37,51.63992235278891
Task_40235,2622,285,158,76,234,9.167832167832168,49.502354465036525
Task_40236,2461,834,39,31,70,2.947305389221557,46.66899775129118
Task_40237,1230,393,111,35,146,3.1218274111675126,26.868206718513964
Task_40238,2978,929,73,75,148,3.2021505376344086,56.74808856517603
Task_40239,2775,512,143,34,177,5.409356725146199,51.87699018352677
Task_40240,2871,268,174,79,253,10.672862453531598,53.534842317223195
Task_40241,1605,664,10,119,129,2.4135338345864663,34.39472625374578
Task_40242,1081,133,146,180,326,8.067164179104477,25.133787311271835
Task_40243,2290,876,40,155,195,2.6111744583808436,46.47060810670357
Task_40244,1412,973,156,67,223,1.4496919917864477,32.35960669480955
Task_40245,834,758,84,113,197,1.098814229249012,22.817773311268397
Task_40246,1346,253,82,10,92,5.299212598425197,27.62762376825778
Task_40247,1543,780,133,182,315,1.9756722151088348,34.90388724166636
Task_40248,711,825,177,20,197,0.860774818401937,20.31957502994665
Task_40249,1623,829,54,179,233,1.955421686746988,36.109051363497045
Task_40250,2128,483,174,117,291,4.396694214876033,43.02863438277965
Task_40251,1758,785,91,173,264,2.236641221374046,38.13185819565224
Task_40252,2267,693,51,11,62,3.26657060518732,42.9508564844956
Task_40253,2646,199,33,161,194,13.23,49.9243585771134
Task_40254,804,482,159,23,182,1.6645962732919255,20.535652228299874
Task_40255,2755,541,160,19,179,5.083025830258302,51.408595597221584
Task_40256,2638,110,88,195,283,23.765765765765767,49.05470552122961
Task_40257,845,227,58,47,105,3.706140350877193,19.64242967189423
Task_40258,854,241,116,73,189,3.5289256198347108,21.125797616729397
Task_40259,1135,475,170,45,215,2.384453781512605,26.098188983601844
Task_40260,662,186,78,134,212,3.5401069518716577,18.835127676214
Task_40261,1369,643,189,140,329,2.125776397515528,31.72159835373532
Task_40262,2995,591,162,126,288,5.059121621621622,57.1030470383206
Task_40263,2393,867,87,165,252,2.756912442396313,48.34216431430004
Task_40264,800,95,16,153,169,8.333333333333334,19.228384593391066
Task_40265,1823,912,175,149,324,1.9967141292442496,39.74327835221168
Task_40266,1063,285,47,121,168,3.7167832167832167,24.850227325400954
Task_40267,1781,940,143,174,317,1.8926673751328373,39.169890217596496
Task_40268,1445,930,141,99,240,1.552094522019334,33.30010170454536
Task_40269,1239,424,62,143,205,2.915294117647059,28.54699635107735
Task_40270,2142,200,185,62,247,10.656716417910447,41.51019782002621
Task_40271,2429,440,139,140,279,5.507936507936508,47.63322005328234
Task_40272,790,130,171,105,276,6.030534351145038,20.206001689360665
Task_40273,2932,541,55,146,201,5.409594095940959,55.74028306549204
Task_40274,1657,563,108,200,308,2.9379432624113475,36.02456040351333
Task_40275,528,294,188,35,223,1.7898305084745763,16.011392857518405
Task_40276,1630,926,98,176,274,1.7583603020496223,36.543284154093115
Task_40277,1636,304,164,113,277,5.363934426229508,34.58945652702608
Task_40278,2896,539,37,102,139,5.362962962962963,54.358724851433614
Task_40279,1112,966,75,100,175,1.1499482936918304,27.853125402200277
Task_40280,2668,288,69,37,106,9.231833910034602,48.81509403103738
Task_40281,1615,217,130,28,158,7.408256880733945,32.317461565446344
Task_40282,1673,865,102,88,190,1.9318706697459584,36.261776162087116
Task_40283,1681,957,91,78,169,1.754697286012526,36.38637699020192
Task_40284,2666,167,32,14,46,15.869047619047619,47.45465196774964
Task_40285,1097,404,123,49,172,2.708641975308642,25.1207218746864
Task_40286,645,308,105,11,116,2.087378640776699,16.91014198303211
Task_40287,2278,118,28,97,125,19.142857142857142,42.32760656269311
Task_40288,2587,614,136,184,320,4.20650406504065,50.944443242778014
Task_40289,2269,258,46,81,127,8.76061776061776,43.33204411412438
Task_40290,1464,263,73,44,117,5.545454545454546,29.84452107254735
Task_40291,1728,939,176,114,290,1.8382978723404255,38.11729916512707
Task_40292,2014,975,60,171,231,2.0635245901639343,42.70684833105935
Task_40293,2179,906,167,102,269,2.402425578831312,45.048799046273395
Task_40294,1753,835,182,140,322,2.09688995215311,38.37229147319687
Task_40295,1134,434,84,153,237,2.606896551724138,26.99523094033043
Task_40296,2483,952,28,192,220,2.6054564533053517,49.96139920131106
Task_40297,1239,556,75,35,110,2.2244165170556554,27.195946435714376
Task_40298,2628,280,50,103,153,9.352313167259787,49.45369906718418
Task_40299,1860,165,95,28,123,11.204819277108435,35.63916178124087
Task_40300,1566,633,160,151,311,2.470031545741325,34.745387700811854
Task_40301,2229,614,140,188,328,3.624390243902439,45.316656011572555
Task_40302,1244,514,92,119,211,2.4155339805825244,28.85235691313166
Task_40303,1586,451,67,148,215,3.5088495575221237,34.171699761115725
Task_40304,2807,364,153,165,318,7.69041095890411,53.57367600651321
Task_40305,1459,1000,76,135,211,1.4575424575424576,33.79271708088447
Task_40306,1581,634,11,136,147,2.489763779527559,33.93542019609786
Task_40307,693,769,188,194,382,0.9,21.65500397175349
Task_40308,2846,468,83,17,100,6.068230277185501,51.972106129778446
Task_40309,2515,570,86,27,113,4.404553415061296,47.50637157335232
Task_40310,2930,136,20,132,152,21.386861313868614,52.8715354364002
Task_40311,2523,737,105,184,289,3.4186991869918697,50.18018870064486
Task_40312,843,213,33,29,62,3.939252336448598,19.151547638703963
Task_40313,1717,230,123,17,140,7.432900432900433,33.68395612971702
Task_40314,1846,1015,88,87,175,1.8169291338582678,39.36344085443934
Task_40315,2284,852,174,124,298,2.6776084407971865,46.70693880113254
Task_40316,1549,535,59,141,200,2.889925373134328,33.807428759452606
Task_40317,742,175,58,148,206,4.215909090909091,19.472066436164134
Task_40318,1971,558,130,148,278,3.525939177101968,40.769397279895934
Task_40319,653,647,112,38,150,1.007716049382716,18.439290212698666
Task_40320,2099,977,77,134,211,2.1462167689161555,43.91357412782355
Task_40321,539,274,24,125,149,1.96,16.321829263962695
Task_40322,2529,81,10,91,101,30.841463414634145,45.63357875830341
Task_40323,1868,373,86,117,203,4.994652406417113,38.202023814842846
Task_40324,1403,834,47,116,163,1.6802395209580838,31.935853847224298
Task_40325,1950,93,93,189,282,20.74468085106383,38.14837819240738
Task_40326,2389,680,94,66,160,3.5080763582966226,46.40605968693685
Task_40327,2307,784,161,154,315,2.9388535031847134,46.97913699156779
Task_40328,2234,162,106,159,265,13.705521472392638,43.230947273178344
Task_40329,2219,392,47,191,238,5.646310432569974,44.092584879179924
Task_40330,2987,853,187,57,244,3.497658079625293,57.00716746295311
Task_40331,1881,551,124,167,291,3.407608695652174,39.408526738471615
Task_40332,2320,517,162,200,362,4.478764478764479,46.619230551763
Task_40333,2778,533,63,168,231,5.202247191011236,53.412849295783964
Task_40334,2018,632,72,94,166,3.1879936808846763,41.07186471091714
Task_40335,1759,360,42,71,113,4.872576177285318,35.45398813584596
Task_40336,2090,165,66,163,229,12.590361445783133,40.93802066671273
Task_40337,2467,969,37,92,129,2.543298969072165,48.98062678651288
Task_40338,1180,202,139,30,169,5.812807881773399,25.566496960685026
Task_40339,705,185,121,150,271,3.7903225806451615,19.35641116257896
Task_40340,2888,461,170,156,326,6.251082251082251,55.20240264980902
Task_40341,1627,544,18,65,83,2.985321100917431,33.32682756751978
Task_40342,2390,900,61,173,234,2.6526082130965594,48.44777134516582
Task_40343,1062,896,144,148,292,1.1839464882943145,27.407585335857416
Task_40344,761,222,102,86,188,3.412556053811659,19.735060425044818
Task_40345,1185,128,104,194,298,9.186046511627907,26.632305839490982
Task_40346,726,592,152,110,262,1.224283305227656,20.910051222396614
Task_40347,1694,279,147,172,319,6.05,35.69759449675899
Task_40348,2172,437,123,95,218,4.958904109589041,43.186873771007534
Task_40349,2183,223,43,183,226,9.745535714285714,42.83468873250055
Task_40350,1071,612,119,156,275,1.7471451876019577,26.67176172445706
Task_40351,1369,713,50,91,141,1.9173669467787116,30.817783421375907
Task_40352,1738,218,12,24,36,7.936073059360731,32.94363176106221
Task_40353,2378,776,122,130,252,3.0604890604890604,47.75974849437488
Task_40354,1640,259,178,92,270,6.3076923076923075,34.33661143643455
Task_40355,2436,874,115,23,138,2.784,47.308649668291345
Task_40356,824,913,60,54,114,0.9015317286652079,21.98544836105076
Task_40357,2835,840,21,171,192,3.370986920332937,54.971109101769144
Task_40358,1433,530,90,200,290,2.6986817325800376,32.34171004282627
Task_40359,763,998,198,50,248,0.7637637637637638,22.162333583269184
Task_40360,2125,967,62,75,137,2.1952479338842976,43.34043793992669
Task_40361,1190,490,91,68,159,2.423625254582485,26.807638786553436
Task_40362,2262,505,117,103,220,4.470355731225297,44.88022132524031
Task_40363,1778,486,169,76,245,3.650924024640657,36.868775785317176
Task_40364,1529,248,149,178,327,6.140562248995984,33.02832469216049
Task_40365,1955,876,12,106,118,2.2291904218928162,40.43250862485761
Task_40366,2374,666,143,192,335,3.5592203898050974,47.81511966512888
Task_40367,1102,782,48,55,103,1.4074074074074074,25.817743181622035
Task_40368,2425,555,122,105,227,4.361510791366906,47.65581986144209
Task_40369,569,964,198,23,221,0.5896373056994819,19.024912045870284
Task_40370,2383,91,35,186,221,25.902173913043477,44.678569755237255
Task_40371,2100,826,191,36,227,2.539298669891173,42.586132729575105
Task_40372,1240,918,39,77,116,1.3492927094668117,28.916746083989995
Task_40373,1569,922,86,188,274,1.6998916576381364,35.60999672871616
Task_40374,2964,726,168,76,244,4.0770288858321875,56.408911858999566
Task_40375,1353,723,118,21,139,1.8687845303867403,29.636815563852576
Task_40376,1861,342,12,47,59,5.425655976676385,35.650952796366504
Task_40377,2565,405,94,16,110,6.317733990147783,47.644650558011676
Task_40378,2563,713,60,183,243,3.589635854341737,50.65739440076916
Task_40379,1849,989,51,171,222,1.8676767676767676,40.16300732657676
Task_40380,2745,434,146,191,337,6.310344827586207,52.95094062595202
Task_40381,1907,661,81,90,171,2.880664652567976,39.23701923015026
Task_40382,2055,839,29,95,124,2.4464285714285716,41.996125304681705
Task_40383,2440,615,24,67,91,3.961038961038961,46.57673551441466
Task_40384,1820,666,94,182,276,2.7286356821589206,38.84343505546655
Task_40385,1745,201,157,81,238,8.638613861386139,35.40434288222857
Task_40386,2129,212,123,198,321,9.995305164319248,42.37685680872955
Task_40387,817,135,110,186,296,6.007352941176471,20.86877773201146
Task_40388,561,216,170,101,271,2.585253456221198,17.26545408716509
Task_40389,1826,158,17,73,90,11.484276729559749,34.95670075048043
Task_40390,2811,910,37,109,146,3.0856201975850714,54.259000504971645
Task_40391,1088,349,39,39,78,3.1085714285714285,23.402367640140017
Task_40392,2300,231,155,143,298,9.913793103448276,44.964820527761425
Task_40393,760,631,102,191,293,1.2025316455696202,21.869286330571118
Task_40394,886,925,107,26,133,0.9568034557235421,23.108027235474143
Task_40395,686,844,39,175,214,0.8118343195266272,20.879154949291358
Task_40396,1124,826,70,60,130,1.3591293833131801,26.80122859857019
Task_40397,2613,812,97,120,217,3.2140221402214024,51.447077186482865
Task_40398,2193,562,48,117,165,3.895204262877442,43.79028875302322
Task_40399,2688,579,59,172,231,4.63448275862069,52.16814011617953
Task_40400,1478,686,81,102,183,2.151382823871907,32.786016786792686
Task_40401,510,427,153,91,244,1.191588785046729,16.7584314676618
Task_40402,1991,320,147,72,219,6.202492211838006,39.519230978165474
Task_40403,811,574,90,33,123,1.4104347826086956,20.632633025494723
Task_40404,2304,292,186,104,290,7.863481228668942,45.154927739731384
Task_40405,2668,863,54,122,176,3.087962962962963,52.27573521046881
Task_40406,2885,585,188,23,211,4.92320819112628,54.12213398452615
Task_40407,630,661,168,110,278,0.9516616314199395,19.73148329028266
Task_40408,806,943,17,28,45,0.8538135593220338,20.843044579525674
Task_40409,2471,868,97,45,142,2.8434982738780206,47.878529280997355
Task_40410,1041,843,99,40,139,1.2334123222748816,25.114877685791296
Task_40411,1776,125,168,135,303,14.095238095238095,35.87249579660065
Task_40412,2232,591,26,132,158,3.77027027027027,44.16985288302714
Task_40413,571,266,152,141,293,2.1385767790262173,17.742677616534152
Task_40414,2646,130,190,153,343,20.198473282442748,49.79657571093842
Task_40415,2191,293,163,86,249,7.4523809523809526,42.89672466520167
Task_40416,693,530,51,192,243,1.305084745762712,20.436607191128584
Task_40417,616,537,184,158,342,1.1449814126394051,19.46933332306283
Task_40418,1344,705,137,128,265,1.9036827195467423,31.213159636005404
Task_40419,1686,263,57,91,148,6.386363636363637,34.383036024523214
Task_40420,2461,189,182,179,361,12.952631578947368,47.69270938953715
Task_40421,1524,116,24,97,121,13.025641025641026,30.327428553455846
Task_40422,1125,419,179,43,222,2.6785714285714284,25.832820255054532
Task_40423,872,824,14,175,189,1.056969696969697,23.651699625323776
Task_40424,1752,810,14,190,204,2.160295930949445,37.86242119389288
Task_40425,500,267,95,193,288,1.8656716417910448,16.747617735554538
Task_40426,2883,246,126,124,250,11.672064777327936,53.98707379551056
Task_40427,2720,992,19,83,102,2.7391742195367574,52.47804505118449
Task_40428,2919,871,161,27,188,3.3474770642201834,55.428909082998274
Task_40429,2159,452,122,103,225,4.766004415011038,43.10123828136535
Task_40430,1608,939,86,129,215,1.7106382978723405,35.92835306952957
Task_40431,2790,185,168,126,294,15.0,52.32228094256502
Task_40432,1599,437,63,164,227,3.6506849315068495,34.41593594559893
Task_40433,2945,464,77,177,254,6.333333333333333,55.946695345013886
Task_40434,2468,567,176,141,317,4.345070422535211,48.833491465462025
Task_40435,2945,238,111,112,223,12.322175732217573,54.79644491730793
Task_40436,1190,638,120,188,308,1.862284820031299,28.846648231340637
Task_40437,1249,669,143,136,279,1.864179104477612,29.670928752553632
Task_40438,2700,239,149,130,279,11.25,51.2088039790497
Task_40439,2034,403,26,45,71,5.034653465346534,38.54499813958439
Task_40440,2244,528,125,66,191,4.241965973534971,44.01937734535576
Task_40441,2376,869,185,44,229,2.731034482758621,47.08211699501478
Task_40442,2584,758,36,114,150,3.404479578392622,50.15590007861783
Task_40443,872,266,161,106,267,3.2659176029962547,22.331132412894693
Task_40444,1121,250,158,70,228,4.46613545816733,25.539769446220358
Task_40445,1287,122,108,123,231,10.463414634146341,27.818175714617535
Task_40446,2451,312,148,72,220,7.830670926517572,46.77037487922272
Task_40447,2541,140,29,73,102,18.02127659574468,46.18445927741093
Task_40448,520,663,38,39,77,0.7831325301204819,15.409982572533465
Task_40449,2265,72,15,52,67,31.027397260273972,40.3376954948923
Task_40450,1428,204,37,200,237,6.965853658536585,30.924485306339893
Task_40451,2774,372,18,61,79,7.436997319034853,50.536734556922305
Task_40452,716,907,113,79,192,0.788546255506608,21.21012894957414
Task_40453,927,65,28,50,78,14.045454545454545,19.31649930844915
Task_40454,2440,95,49,185,234,25.416666666666668,45.660240554418465
Task_40455,1490,251,22,134,156,5.912698412698413,31.242709908291516
Task_40456,1605,591,140,78,218,2.7111486486486487,34.407129931092285
Task_40457,2724,187,95,144,239,14.48936170212766,51.39460560279675
Task_40458,1639,188,87,175,262,8.671957671957673,34.31478918718573
Task_40459,2752,186,169,24,193,14.716577540106952,50.751346305389326
Task_40460,1895,787,38,32,70,2.4048223350253806,37.55532435385752
Task_40461,845,323,171,199,370,2.6080246913580245,22.689051929741936
Task_40462,1776,943,61,79,140,1.88135593220339,37.79619819296449
Task_40463,1670,118,106,60,166,14.033613445378151,32.80061859611715
Task_40464,582,561,47,68,115,1.0355871886120998,17.23302975514652
Task_40465,2712,383,43,153,196,7.0625,51.58121889133488
Task_40466,2714,526,78,66,144,5.149905123339659,51.119130233347626
Task_40467,559,309,153,150,303,1.803225806451613,17.74811169305853
Task_40468,2003,554,96,129,225,3.609009009009009,41.0495208871422
Task_40469,2931,140,183,35,218,20.78723404255319,53.08039314126132
Task_40470,1053,411,119,124,243,2.5558252427184467,25.577628711060004
Task_40471,2873,129,97,140,237,22.1,52.87448183610565
Task_40472,2096,315,135,144,279,6.632911392405063,41.95463905717552
Task_40473,1882,277,193,192,385,6.76978417266187,38.98909650873687
Task_40474,2123,205,62,190,252,10.305825242718447,42.06053584837715
Task_40475,2185,955,137,94,231,2.2855648535564854,45.05796656363295
Task_40476,2208,414,32,168,200,5.320481927710843,43.77514115003104
Task_40477,2887,217,65,149,214,13.243119266055047,53.936320856570696
Task_40478,1250,472,151,182,333,2.6427061310782243,29.37948650700557
Task_40479,2288,964,118,97,215,2.370984455958549,46.73960586537774
Task_40480,552,327,72,135,207,1.6829268292682926,17.353211500815508
Task_40481,2044,888,10,184,194,2.2992125984251968,42.637772760879066
Task_40482,2612,149,15,136,151,17.413333333333334,48.08019004788547
Task_40483,666,596,76,89,165,1.1155778894472361,19.341905495927676
Task_40484,2659,739,127,168,295,3.593243243243243,52.34451650537403
Task_40485,1215,220,95,88,183,5.497737556561086,26.810476287577696
Task_40486,2560,464,60,177,237,5.505376344086022,49.778022878719675
Task_40487,1390,956,166,172,338,1.452455590386625,33.04706628891149
Task_40488,899,591,137,110,247,1.5185810810810811,23.65945581887323
Task_40489,769,129,176,59,235,5.915384615384616,19.200290933474914
Task_40490,697,913,82,160,242,0.762582056892779,21.543215925537265
Task_40491,2201,631,63,189,252,3.482594936708861,44.71392958939865
Task_40492,1984,331,172,156,328,5.975903614457831,40.475996841947506
Task_40493,2546,849,197,101,298,2.9952941176470587,50.815041357554264
Task_40494,668,416,113,187,300,1.6019184652278178,19.83668558681399
Task_40495,1850,570,10,34,44,3.2399299474605954,36.0587546725634
Task_40496,2459,269,111,73,184,9.107407407407408,46.3982543789007
Task_40497,2123,218,62,185,247,9.69406392694064,42.08028356994427
Task_40498,1351,749,97,191,288,1.8013333333333332,31.680828925600597
Task_40499,2458,383,115,36,151,6.401041666666667,46.219714766106584
Task_40500,1110,395,120,104,224,2.803030303030303,26.31375542555382
Task_40501,888,458,153,92,245,1.934640522875817,22.97599302579133
Task_40502,2981,318,173,102,275,9.344827586206897,55.88012491418673
Task_40503,2926,99,159,110,269,29.26,53.35149043237635
Task_40504,842,640,56,172,228,1.313572542901716,23.02891309051273
Task_40505,2008,287,164,86,250,6.972222222222222,39.987451687826194
Task_40506,1376,439,137,161,298,3.1272727272727274,31.080546023881595
Task_40507,691,146,15,18,33,4.700680272108843,15.865897134276699
Task_40508,1384,263,157,44,201,5.242424242424242,29.316795620582994
Task_40509,726,999,173,19,192,0.726,21.154311738313556
Task_40510,2274,363,161,31,192,6.247252747252747,43.70416970542859
Task_40511,2875,634,185,58,243,4.52755905511811,54.52575278527123
Task_40512,2923,866,120,154,274,3.3713956170703576,56.811190352246875
Task_40513,666,214,23,198,221,3.097674418604651,18.92984055403048
Task_40514,1479,505,113,181,294,2.9229249011857705,32.93189724720798
Task_40515,1576,609,81,76,157,2.583606557377049,33.48963696334735
Task_40516,2016,981,185,115,300,2.0529531568228108,42.85810270467906
Task_40517,1513,450,50,109,159,3.354767184035477,32.44394961400966
Task_40518,2805,883,151,174,325,3.173076923076923,55.25396640002492
Task_40519,1870,542,44,51,95,3.443830570902394,37.211241849449195
Task_40520,2373,571,104,38,142,4.148601398601398,45.47002504961399
Task_40521,2284,816,182,59,241,2.795593635250918,45.7163569151594
Task_40522,2029,641,140,97,237,3.160436137071651,41.72450874054983
Task_40523,2305,976,101,41,142,2.3592630501535314,45.61295723358757
Task_40524,1850,533,196,90,286,3.4644194756554305,38.56032044542428
Task_40525,535,972,68,32,100,0.5498458376156218,17.35398021871525
Task_40526,1343,686,86,60,146,1.9548762736535663,29.780325684372603
Task_40527,1399,132,74,24,98,10.518796992481203,27.79683330388873
Task_40528,776,682,135,63,198,1.136163982430454,21.29515809036128
Task_40529,1738,581,72,104,176,2.986254295532646,36.598637384776346
Task_40530,2504,546,149,65,214,4.577696526508227,48.320639765858594
Task_40531,2456,186,167,120,287,13.133689839572192,47.319220406375756
Task_40532,2932,176,35,187,222,16.56497175141243,54.05485712237476
Task_40533,1658,407,162,56,218,4.063725490196078,34.50031833302986
Task_40534,667,962,137,115,252,0.6926272066458983,21.26019926291014
Task_40535,2707,655,161,188,349,4.126524390243903,53.111896462165134
Task_40536,1795,786,144,56,200,2.280813214739517,37.786051375472844
Task_40537,970,927,125,125,250,1.0452586206896552,25.776614657838255
Task_40538,2140,205,192,88,280,10.388349514563107,41.92563962388905
Task_40539,1591,95,113,65,178,16.572916666666668,31.175407173267757
Task_40540,903,503,41,145,186,1.7916666666666667,23.14954853653035
Task_40541,2455,508,178,163,341,4.823182711198428,48.57871655327977
Task_40542,2986,281,51,78,129,10.588652482269504,54.99109835019818
Task_40543,1693,765,14,200,214,2.210182767624021,36.84706732952225
Task_40544,913,400,173,57,230,2.2768079800498753,22.67072917847803
Task_40545,2488,107,85,48,133,23.037037037037038,44.80085065072674
Task_40546,1763,178,149,97,246,9.849162011173185,35.59983743202338
Task_40547,2118,755,92,112,204,2.8015873015873014,43.40971036556213
Task_40548,2219,72,137,172,309,30.397260273972602,42.26817203421346
Task_40549,2203,177,109,113,222,12.376404494382022,42.42543499524128
Task_40550,804,807,183,157,340,0.995049504950495,23.278905184196912
Task_40551,2856,603,171,118,289,4.728476821192053,54.9330126247556
Task_40552,737,399,50,55,105,1.8425,18.96282670653084
Task_40553,2496,446,55,146,201,5.583892617449664,48.529203912143196
Task_40554,1817,490,14,44,58,3.70061099796334,35.49027967790729
Task_40555,2409,383,102,39,141,6.2734375,45.35832729477155
Task_40556,668,305,97,167,264,2.183006535947712,19.331702561151218
Task_40557,775,890,23,31,54,0.8698092031425365,20.449024433004663
Task_40558,2736,170,153,105,258,16.0,51.01257686352677
Task_40559,2216,402,164,32,196,5.4987593052109185,42.93534968071352
Task_40560,1880,815,28,50,78,2.303921568627451,37.59369634389571
Task_40561,1149,745,154,163,317,1.5402144772117963,28.49161232212286
Task_40562,1577,267,105,106,211,5.884328358208955,33.22384086030203
Task_40563,2673,924,199,92,291,2.8897297297297295,52.91648117101993
Task_40564,719,147,152,157,309,4.858108108108108,19.46110145228096
Task_40565,898,814,16,47,63,1.101840490797546,22.026305480037347
Task_40566,1750,902,110,105,215,1.937984496124031,37.99969650956273
Task_40567,1754,583,139,114,253,3.0034246575342465,37.24977107058465
Task_40568,1886,939,94,17,111,2.0063829787234044,38.538817503064344
Task_40569,2459,905,90,156,246,2.7141280353200883,49.507148296680775
Task_40570,2058,787,108,148,256,2.6116751269035534,42.76897194262613
Task_40571,1071,158,59,43,102,6.735849056603773,22.581193321865737
Task_40572,2680,256,142,79,221,10.428015564202335,50.32777647893662
Task_40573,1287,742,191,115,306,1.7321668909825034,30.577779941967247
Task_40574,862,514,35,72,107,1.6737864077669904,21.55952124768181
Task_40575,2841,1016,101,30,131,2.793510324483776,54.288156338334936
Task_40576,2247,116,77,194,271,19.205128205128204,43.21709796820235
Task_40577,1285,149,95,129,224,8.566666666666666,28.051800172526367
Task_40578,2617,145,81,44,125,17.924657534246574,47.31842497185704
Task_40579,2606,407,194,72,266,6.387254901960785,49.751321779610095
Task_40580,2166,415,83,196,279,5.206730769230769,43.52487805581897
Task_40581,672,475,171,58,229,1.411764705882353,19.047733412522863
Task_40582,1272,523,42,160,202,2.427480916030534,29.279667480080196
Task_40583,1192,750,36,19,55,1.5872170439414115,26.129053612477637
Task_40584,962,843,168,69,237,1.1398104265402844,24.90236110411331
Task_40585,2503,525,96,190,286,4.758555133079848,49.237971248066515
Task_40586,1244,669,188,168,356,1.8567164179104478,29.98568527437243
Task_40587,743,302,109,91,200,2.452145214521452,19.938276067649962
Task_40588,1406,65,73,82,155,21.303030303030305,28.168268143263816
Task_40589,2695,196,119,11,130,13.680203045685278,49.09161907018927
Task_40590,2938,930,140,143,283,3.1557465091299677,57.27379369275908
Task_40591,804,814,108,70,178,0.9865030674846625,21.921226688194224
Task_40592,691,124,173,15,188,5.528,17.39416199846205
Task_40593,2267,214,55,11,66,10.544186046511628,41.30829902111335
Task_40594,1047,433,14,152,166,2.412442396313364,25.117874648197027
Task_40595,1805,486,105,68,173,3.706365503080082,36.78750473381437
Task_40596,2342,135,38,14,52,17.220588235294116,42.087247916968124
Task_40597,1681,878,127,49,176,1.912400455062571,35.78296505845841
Task_40598,2587,719,83,121,204,3.5930555555555554,50.71547117401831
Task_40599,1909,168,59,99,158,11.29585798816568,37.22221838722047
Task_40600,2447,256,113,65,178,9.521400778210117,46.086183689210834
Task_40601,1424,508,54,72,126,2.7976424361493124,30.80321279133911
Task_40602,2915,825,25,139,164,3.529055690072639,55.97484032252407
Task_40603,2098,972,40,12,52,2.1562178828365877,41.171624330371486
Task_40604,1555,566,51,57,108,2.742504409171076,32.40625749926791
Task_40605,1804,187,184,19,203,9.595744680851064,35.62509955378963
Task_40606,1674,953,185,128,313,1.7547169811320755,37.41584038183885
Task_40607,2926,813,33,43,76,3.5945945945945947,54.01820492758828
Task_40608,2368,510,11,108,119,4.634050880626223,45.813776309898856
Task_40609,1038,926,118,196,314,1.1197411003236246,27.21270385592848
Task_40610,1900,935,159,134,293,2.02991452991453,40.873216517925734
Task_40611,2822,807,82,49,131,3.492574257425743,53.41683479312021
Task_40612,2010,832,68,169,237,2.41296518607443,42.21644890522666
Task_40613,2117,447,28,119,147,4.725446428571429,41.83610578406469
Task_40614,1785,225,161,154,315,7.898230088495575,36.90151936142956
Task_40615,1417,394,16,123,139,3.5873417721518988,30.44922745380144
Task_40616,1558,138,104,56,160,11.20863309352518,31.06059894467812
Task_40617,2555,909,59,69,128,2.8076923076923075,50.019251415780786
Task_40618,2265,471,143,43,186,4.798728813559322,43.74664586214112
Task_40619,2707,426,18,149,167,6.339578454332552,51.28272375172651
Task_40620,1605,439,54,118,172,3.647727272727273,34.16152462068177
Task_40621,2462,133,158,154,312,18.37313432835821,46.77680059862527
Task_40622,2474,219,85,62,147,11.245454545454546,46.1734286817935
Task_40623,1561,1002,163,35,198,1.5563310069790628,34.46256049853966
Task_40624,1494,999,139,139,278,1.494,34.535199318163116
Task_40625,2593,863,97,113,210,3.0011574074074074,51.248209550250806
Task_40626,1226,174,104,33,137,7.005714285714285,25.6867009037322
Task_40627,914,986,40,148,188,0.9260385005065856,24.728384801785257
Task_40628,1059,971,117,44,161,1.0895061728395061,25.867820234094875
Task_40629,2768,958,191,188,379,2.886339937434828,55.16612005904676
Task_40630,1543,923,119,153,272,1.66991341991342,35.09874713094117
Task_40631,600,829,67,76,143,0.7228915662650602,18.929666348757237
Task_40632,2483,956,200,91,291,2.5945663531870427,49.958734044629296
Task_40633,2362,275,192,26,218,8.557971014492754,44.86576144829843
Task_40634,1407,190,108,23,131,7.366492146596858,28.94807895168954
Task_40635,2695,141,121,85,206,18.97887323943662,49.77495140828845
Task_40636,1092,219,93,158,251,4.963636363636364,25.765738159819875
Task_40637,721,779,105,173,278,0.9243589743589744,21.62301760325705
Task_40638,2770,763,97,39,136,3.6256544502617802,52.32269791252916
Task_40639,1825,374,98,197,295,4.866666666666666,38.02880505993942
Task_40640,2717,416,105,143,248,6.5155875299760195,51.97670168079247
Task_40641,1718,1000,59,51,110,1.7162837162837163,36.319853308288934
Task_40642,1960,206,42,78,120,9.468599033816425,38.171592651968076
Task_40643,2801,324,127,96,223,8.618461538461538,52.83515006119788
Task_40644,1439,288,188,150,338,4.97923875432526,31.75050962488008
Task_40645,2817,337,125,138,263,8.334319526627219,53.35166104267116
Task_40646,1062,265,36,68,104,3.992481203007519,23.78040916717585
Task_40647,1542,886,28,15,43,1.7384441939120632,31.931012132401317
Task_40648,2854,749,43,67,110,3.8053333333333335,53.818855988121015
Task_40649,2834,354,106,153,259,7.983098591549296,53.683100570163504
Task_40650,887,810,143,41,184,1.093711467324291,22.907631071694254
Task_40651,1641,249,133,91,224,6.564,34.063477879575444
Task_40652,1663,961,154,136,290,1.7286902286902286,37.17442778806805
Task_40653,1283,995,196,187,383,1.288152610441767,31.673354573962737
Task_40654,2581,346,10,123,133,7.438040345821325,48.807728889389494
Task_40655,2550,221,115,179,294,11.486486486486486,48.90974198312683
Task_40656,1207,953,134,49,183,1.2651991614255764,28.508945667288874
Task_40657,1000,224,90,142,232,4.444444444444445,24.15812876051362
Task_40658,1062,948,48,148,196,1.119072708113804,27.12572978567827
Task_40659,1704,926,74,121,195,1.838187702265372,37.41052195694074
Task_40660,1305,1005,65,126,191,1.297216699801193,31.211640342343355
Task_40661,1900,237,36,188,224,7.983193277310924,38.40991271517178
Task_40662,2269,813,14,157,171,2.7874692874692877,45.67110872708573
Task_40663,1620,169,146,155,301,9.529411764705882,33.755514421590966
Task_40664,1970,247,197,49,246,7.943548387096774,38.81407859894029
Task_40665,2583,852,105,30,135,3.0281359906213363,49.678787512363904
Task_40666,2431,771,154,111,265,3.1489637305699483,48.61444505978675
Task_40667,1726,625,172,82,254,2.757188498402556,36.612949320011964
Task_40668,1845,162,137,94,231,11.319018404907975,36.77937174326465
Task_40669,2673,595,50,110,160,4.48489932885906,51.28145616202685
Task_40670,1352,120,109,36,145,11.173553719008265,27.388821170534044
Task_40671,988,506,66,105,171,1.9487179487179487,24.420318448853106
Task_40672,1517,511,29,53,82,2.962890625,31.41594947080164
Task_40673,2557,923,41,90,131,2.767316017316017,50.16930812301442
Task_40674,2909,797,125,178,303,3.645363408521303,56.53847962933711
Task_40675,1113,78,40,196,236,14.08860759493671,24.740037077712643
Task_40676,2956,226,47,139,186,13.022026431718063,54.716266600564246
Task_40677,912,577,110,31,141,1.5778546712802768,22.311528412932137
Task_40678,2259,928,18,153,171,2.4316469321851453,45.79758355164623
Task_40679,1337,512,120,13,133,2.6062378167641325,28.722480485842137
Task_40680,2781,708,37,127,164,3.922425952045134,53.43704570085105
Task_40681,1726,211,163,84,247,8.141509433962264,35.21592410354316
Task_40682,2965,796,140,94,234,3.7202007528230867,56.93286853527686
Task_40683,2126,678,156,162,318,3.1310751104565537,43.80420120516535
Task_40684,609,437,78,59,137,1.3904109589041096,17.398097369473334
Task_40685,1171,581,95,66,161,2.0120274914089347,26.818798309671916
Task_40686,1004,435,98,107,205,2.302752293577982,24.69587127479775
Task_40687,1289,833,62,90,152,1.5455635491606714,29.78652477877594
Task_40688,2676,460,32,129,161,5.804772234273319,50.801765048475566
Task_40689,1030,950,92,17,109,1.0830704521556256,24.921445762601564
Task_40690,1408,548,176,105,281,2.564663023679417,31.773524573081442
Task_40691,2309,920,57,63,120,2.507057546145494,45.82346665974148
Task_40692,1977,629,149,150,299,3.138095238095238,41.186616316316574
Task_40693,1566,789,37,46,83,1.9822784810126581,32.77982740542798
Task_40694,1990,67,182,183,365,29.264705882352942,38.934912873113724
Task_40695,909,846,72,160,232,1.0731995277449824,24.591422463588902
Task_40696,2614,188,29,87,116,13.83068783068783,48.52877517917161
Task_40697,3000,491,33,27,60,6.097560975609756,54.13885834470762
Task_40698,2361,537,105,19,124,4.388475836431227,44.788974911744695
Task_40699,2174,82,57,29,86,26.19277108433735,39.18486369008706
Task_40700,2147,819,162,175,337,2.618292682926829,44.683720017494785
Task_40701,994,806,165,140,305,1.231722428748451,26.05708064897118
Task_40702,2768,1004,159,181,340,2.754228855721393,55.123633137287925
Task_40703,1699,695,147,37,184,2.4410919540229883,35.463906749838266
Task_40704,2054,1004,118,184,302,2.0437810945273633,43.64192856145041
Task_40705,2838,418,145,192,337,6.77326968973747,54.37114886552714
Task_40706,907,565,45,154,199,1.6024734982332156,23.582687401673677
Task_40707,642,794,36,85,121,0.8075471698113208,19.03757529163507
Task_40708,2668,702,58,197,255,3.795163584637269,52.387086149324766
Task_40709,2195,681,168,87,255,3.218475073313783,44.25848673386395
Task_40710,1233,974,193,199,392,1.2646153846153847,30.86029707354207
Task_40711,607,487,46,187,233,1.2438524590163935,18.654451086023414
Task_40712,2653,220,116,132,248,12.004524886877828,50.25615351296877
Task_40713,1621,644,177,193,370,2.5131782945736436,35.978475290052124
Task_40714,2462,655,98,196,294,3.7530487804878048,49.00914826825198
Task_40715,743,525,58,29,87,1.4125475285171103,18.854224609280994
Task_40716,1904,449,66,186,252,4.231111111111111,39.42143161474055
Task_40717,727,193,190,148,338,3.747422680412371,20.1859086668381
Task_40718,2757,419,17,29,46,6.564285714285714,49.94021781493638
Task_40719,531,840,109,171,280,0.6313912009512486,18.948429700899684
Task_40720,2952,532,36,24,60,5.538461538461538,53.448621381976004
Task_40721,1654,1000,148,67,215,1.6523476523476524,36.29148606541562
Task_40722,806,669,21,115,136,1.2029850746268658,21.55394467585522
Task_40723,558,714,108,66,174,0.7804195804195804,17.78044099539648
Task_40724,2203,818,195,55,250,2.68986568986569,44.573923429182535
Task_40725,2301,329,33,193,226,6.972727272727273,45.12501625193141
Task_40726,2270,1020,143,150,293,2.2233104799216457,47.02426355326552
Task_40727,2337,548,80,197,277,4.256830601092896,46.72752268271223
Task_40728,1155,941,171,184,355,1.2261146496815287,29.316111662282086
Task_40729,1416,84,136,15,151,16.658823529411766,27.767521575132278
Task_40730,2328,298,81,98,179,7.785953177257525,44.968615903931756
Task_40731,1920,644,75,10,85,2.9767441860465116,37.8970902045644
Task_40732,1387,631,66,136,202,2.194620253164557,31.5135226102434
Task_40733,999,726,120,72,192,1.37414030261348,24.94039259738889
Task_40734,1280,509,154,69,223,2.5098039215686274,28.839577280949797
Task_40735,872,933,154,95,249,0.9336188436830836,24.219071352187175
Task_40736,958,933,104,175,279,1.025695931477516,25.809021855785517
Task_40737,2669,528,46,75,121,5.045368620037808,50.46930017996855
Task_40738,1450,541,105,153,258,2.6752767527675276,32.38319200610943
Task_40739,1871,255,59,177,236,7.30859375,38.199576838667944
Task_40740,1052,433,194,38,232,2.423963133640553,24.805174425104273
Task_40741,874,962,103,192,295,0.9075804776739356,24.72455845977676
Task_40742,2336,505,90,97,187,4.616600790513834,45.94945678379448
Task_40743,2482,797,16,71,87,3.110275689223058,47.79746201723264
Task_40744,2949,688,83,143,226,4.28011611030479,56.48304407978167
Task_40745,2177,590,188,133,321,3.6835871404399323,44.304875535805195
Task_40746,2251,538,59,120,179,4.176252319109462,44.6248877141663
Task_40747,1875,628,156,138,294,2.9809220985691574,39.52788661435991
Task_40748,1693,805,91,117,208,2.100496277915633,36.829944156071704
Task_40749,924,590,121,29,150,1.5634517766497462,22.58744215731802
Task_40750,921,596,140,153,293,1.5427135678391959,24.293792724407965
Task_40751,1543,627,71,185,256,2.4570063694267517,34.29122873542102
Task_40752,1562,999,197,17,214,1.562,34.26767359332114
Task_40753,565,434,161,128,289,1.2988505747126438,18.048245195192212
Task_40754,1267,967,148,70,218,1.3088842975206612,30.03727552196534
Task_40755,2282,322,53,131,184,7.065015479876161,44.46861316650893
Task_40756,2137,666,168,160,328,3.2038980509745127,43.98277880404436
Task_40757,944,450,190,68,258,2.0931263858093128,23.520670546850955
Task_40758,2314,109,110,54,164,21.036363636363635,42.84477799351881
Task_40759,983,552,170,142,312,1.7775768535262206,25.23707151121386
Task_40760,2635,659,178,156,334,3.992424242424242,51.869675185371285
Task_40761,792,288,42,97,139,2.7404844290657437,20.305197952594323
Task_40762,1508,650,81,177,258,2.316436251920123,33.78296727340459
Task_40763,2034,494,125,19,144,4.109090909090909,39.62362494310243
Task_40764,800,634,100,169,269,1.2598425196850394,22.34779829213755
Task_40765,769,864,10,24,34,0.8890173410404625,19.823450286948205
Task_40766,855,437,77,110,187,1.952054794520548,22.341950948530826
Task_40767,1819,878,48,157,205,2.069397042093288,39.17282629978675
Task_40768,1487,650,126,96,222,2.284178187403994,33.08928198942047
Task_40769,1272,906,134,86,220,1.402425578831312,30.104326830523856
Task_40770,2642,642,59,149,208,4.108864696734059,51.503102321787786
Task_40771,1159,149,123,138,261,7.726666666666667,26.173982489906553
Task_40772,1253,137,84,163,247,9.079710144927537,27.57233795990129
Task_40773,2879,678,97,58,155,4.240058910162003,54.064988335520326
Task_40774,1689,1003,66,147,213,1.6822709163346614,37.50848420733016
Task_40775,1687,910,89,25,114,1.8518111964873765,35.39437077379237
Task_40776,1591,905,29,168,197,1.7560706401766004,35.52836383961536
Task_40777,1107,921,50,39,89,1.200650759219089,26.060204906161314
Task_40778,2381,989,136,133,269,2.405050505050505,48.55374155119085
Task_40779,971,390,199,196,395,2.483375959079284,25.00405679032245
Task_40780,2111,430,120,22,142,4.897911832946636,40.775630814148236
Task_40781,893,714,62,159,221,1.248951048951049,23.924853366191297
Task_40782,2422,382,39,110,149,6.323759791122716,46.40330615934659
Task_40783,2385,513,57,56,113,4.6400778210116735,45.60345786783324
Task_40784,1306,547,60,40,100,2.383211678832117,27.9346079470579
Task_40785,2457,247,98,67,165,9.90725806451613,46.31210275469822
Task_40786,1559,804,186,46,232,1.9366459627329193,33.9537770519544
Task_40787,2064,252,61,71,132,8.15810276679842,40.03529067721816
Task_40788,1231,832,69,135,204,1.4777911164465787,29.625258752201102
Task_40789,1446,173,64,12,76,8.310344827586206,28.269159793599133
Task_40790,2236,722,115,174,289,3.0926694329183957,45.57191575808495
Task_40791,1420,869,134,200,334,1.632183908045977,33.33048213135737
Task_40792,1179,1013,85,154,239,1.1627218934911243,29.41491306487492
Task_40793,2543,258,136,168,304,9.818532818532818,48.96770059418699
Task_40794,2899,840,75,130,205,3.447086801426873,56.13922049852434
Task_40795,2550,821,110,140,250,3.102189781021898,50.631528126898125
Task_40796,1738,494,192,110,302,3.511111111111111,36.92924251239726
Task_40797,1927,108,79,95,174,17.678899082568808,37.32625133491124
Task_40798,940,661,169,36,205,1.4199395770392749,23.59202280381824
Task_40799,2549,716,87,128,215,3.5550906555090656,50.11879966997292
Task_40800,1796,692,113,12,125,2.5916305916305915,36.467305032085974
Task_40801,2765,624,41,83,124,4.424,52.3698320594751
Task_40802,977,139,160,170,330,6.978571428571429,23.58183780358217
Task_40803,1525,577,180,171,351,2.63840830449827,34.12973938401711
Task_40804,2353,333,116,34,150,7.044910179640719,44.38266742329279
Task_40805,1618,710,93,100,193,2.2756680731364276,35.315483100351926
Task_40806,2968,940,20,185,205,3.1540913921360256,57.47093053113321
Task_40807,2835,267,71,64,135,10.578358208955224,52.18715532828684
Task_40808,2231,188,80,194,274,11.804232804232804,43.85202640099829
Task_40809,2465,560,131,57,188,4.393939393939394,47.512939213191345
Task_40810,866,470,190,96,286,1.8386411889596603,22.980389424264775
Task_40811,2835,678,187,120,307,4.175257731958763,54.923321101659575
Task_40812,2049,769,57,45,102,2.661038961038961,40.38856379892467
Task_40813,1198,376,75,41,116,3.1777188328912467,26.064722451227833
Task_40814,1296,172,109,171,280,7.491329479768786,28.494843207372355
Task_40815,1199,554,26,161,187,2.1603603603603605,28.145102633474647
Task_40816,1530,546,49,96,145,2.797074954296161,33.02863483516071
Task_40817,2310,302,91,100,191,7.623762376237623,44.88182985139562
Task_40818,2978,408,173,188,361,7.28117359413203,56.655491936464365
Task_40819,1552,389,127,61,188,3.9794871794871796,32.487713691589406
Task_40820,1519,702,200,61,261,2.1607396870554765,33.330755938991224
Task_40821,627,922,19,45,64,0.6793066088840737,18.27505202215199
Task_40822,1339,534,46,102,148,2.502803738317757,29.745746326024896
Task_40823,988,902,48,136,184,1.0941306755260243,25.54113884784699
Task_40824,780,353,30,58,88,2.2033898305084745,19.251524837307795
Task_40825,2303,647,29,166,195,3.5540123456790123,46.002368369069266
Task_40826,1601,345,17,81,98,4.627167630057803,32.53946219025689
Task_40827,736,275,119,95,214,2.6666666666666665,19.92777453202126
Task_40828,1455,1003,190,132,322,1.449203187250996,34.09199405997075
Task_40829,2919,755,181,167,348,3.861111111111111,56.75123541292684
Task_40830,2247,822,103,112,215,2.730255164034022,45.63524700716283
Task_40831,1528,373,33,53,86,4.0855614973262036,31.20094967164899
Task_40832,737,109,50,151,201,6.7,18.859049919122683
Task_40833,1928,537,41,198,239,3.58364312267658,39.93174608063665
Task_40834,2128,735,86,97,183,2.891304347826087,43.213305561119476
Task_40835,929,817,111,98,209,1.1356968215158925,24.611546584785714
Task_40836,2657,525,67,53,120,5.051330798479087,49.93489005828269
Task_40837,1274,160,167,82,249,7.913043478260869,27.693241916305556
Task_40838,680,991,54,192,246,0.6854838709677419,21.749536433609745
Task_40839,1194,905,111,40,151,1.3178807947019868,27.838046406243432
Task_40840,2529,75,72,160,232,33.276315789473685,46.88671991714955
Task_40841,2418,813,160,138,298,2.9705159705159705,48.72851926525495
Task_40842,1963,530,36,179,215,3.696798493408663,40.32410007808246
Task_40843,2410,788,30,47,77,3.0544993662864384,45.74122980430318
Task_40844,2947,538,85,73,158,5.467532467532467,54.8709570786506
Task_40845,2115,103,152,20,172,20.33653846153846,39.40319867954661
Task_40846,1999,519,62,152,214,3.8442307692307693,40.93400046481877
Task_40847,1983,390,158,111,269,5.071611253196931,40.32393996030336
Task_40848,1405,496,198,78,276,2.8269617706237424,31.201995735902305
Task_40849,1161,886,92,198,290,1.3089064261555805,29.10845757474111
Task_40850,2636,165,111,155,266,15.879518072289157,49.58142289150172
Task_40851,2718,178,196,71,267,15.184357541899441,50.43203060574047
Task_40852,897,722,18,77,95,1.2406639004149378,22.508010224062275
Task_40853,1478,400,116,31,147,3.685785536159601,30.787370741469903
Task_40854,1407,991,111,171,282,1.4183467741935485,33.17104898357818
Task_40855,587,792,113,122,235,0.7402269861286255,19.24219728628833
Task_40856,1082,840,33,156,189,1.286563614744352,27.05494248257388
Task_40857,721,95,38,38,76,7.510416666666667,16.297647832788197
Task_40858,599,416,77,181,258,1.4364508393285371,18.62198564141521
Task_40859,1903,162,104,22,126,11.674846625766872,36.21444920922499
Task_40860,1390,1014,97,165,262,1.3694581280788178,32.89252503946713
Task_40861,2301,194,33,40,73,11.8,42.28076126480811
Task_40862,2530,954,161,96,257,2.649214659685864,50.721085258012685
Task_40863,978,168,83,122,205,5.78698224852071,23.18810976697827
Task_40864,1128,130,44,193,237,8.610687022900763,25.470472259455573
Task_40865,2504,944,195,80,275,2.64973544973545,50.02673534077912
Task_40866,1719,254,113,104,217,6.741176470588235,35.44699379917805
Task_40867,551,132,189,45,234,4.142857142857143,15.491205621380415
Task_40868,2977,467,130,59,189,6.361111111111111,55.315406150075326
Task_40869,2586,364,62,53,115,7.0849315068493155,48.209428093869015
Task_40870,952,179,99,49,148,5.288888888888889,21.52890037146216
Task_40871,983,482,146,170,316,2.0351966873706004,25.09023468949262
Task_40872,2429,519,187,15,202,4.671153846153846,46.53574246383209
Task_40873,2538,685,69,125,194,3.6997084548104957,49.8606197527178
Task_40874,1957,287,16,49,65,6.795138888888889,37.109833671931256
Task_40875,556,592,73,185,258,0.9376053962900506,18.431341154290745
Task_40876,2063,197,18,36,54,10.419191919191919,38.417434393845504
Task_40877,1921,354,120,177,297,5.411267605633803,39.44733190284862
Task_40878,2662,838,191,171,362,3.172824791418355,53.009563197869475
Task_40879,2872,596,175,57,232,4.8107202680067,54.31780387137248
Task_40880,713,738,74,147,221,0.9648173207036536,21.152433268580946
Task_40881,1897,803,125,30,155,2.359452736318408,38.70398911939472
Task_40882,1745,444,87,42,129,3.9213483146067416,35.0849914399628
Task_40883,1145,229,163,82,245,4.978260869565218,26.10327356782156
Task_40884,1409,298,184,79,263,4.712374581939799,30.574648139499416
Task_40885,1425,551,194,199,393,2.5815217391304346,32.69473849737661
Task_40886,2476,194,107,10,117,12.697435897435897,45.47289481016344
Task_40887,2948,840,60,39,99,3.5053507728894173,54.773271243898016
Task_40888,658,745,99,177,276,0.8820375335120644,20.51764350607343
Task_40889,1735,738,140,83,223,2.3477672530446547,36.96138141645189
Task_40890,1546,265,77,137,214,5.81203007518797,32.91195472352993
Task_40891,2656,234,88,150,238,11.302127659574468,50.35879232407995
Task_40892,2947,798,145,182,327,3.688360450563204,57.25769663514618
Task_40893,2018,845,57,117,174,2.3853427895981087,41.994726754095645
Task_40894,2376,932,173,117,290,2.5466237942122185,48.36809299956457
Task_40895,2653,773,54,34,88,3.4276485788113695,49.91524067201922
Task_40896,534,683,78,114,192,0.7807017543859649,18.00187798612785
Task_40897,2969,691,196,84,280,4.290462427745664,56.61892436310864
Task_40898,1114,524,32,36,68,2.1219047619047617,24.399340599361892
Task_40899,575,456,83,136,219,1.2582056892778994,17.99760956335084
Task_40900,2405,470,88,73,161,5.10615711252654,46.02195131558625
Task_40901,1113,155,176,32,208,7.134615384615385,24.501007979498514
Task_40902,2302,770,69,123,192,2.985732814526589,46.37771263202624
Task_40903,1145,79,81,44,125,14.3125,23.27095975633796
Task_40904,2451,723,153,68,221,3.3853591160220993,48.078354630044906
Task_40905,575,842,56,142,198,0.6820877817319099,19.33569789775196
Task_40906,2439,684,95,173,268,3.5605839416058394,48.641844017510216
Task_40907,2328,126,49,15,64,18.330708661417322,41.766504063320276
Task_40908,765,649,135,45,180,1.176923076923077,20.466822137683106
Task_40909,2670,833,194,19,213,3.2014388489208634,51.34045856435421
Task_40910,887,408,12,135,147,2.1687041564792175,22.23519730773249
Task_40911,1924,607,13,117,130,3.164473684210526,39.28230729243831
Task_40912,630,353,77,191,268,1.7796610169491525,19.02489522862003
Task_40913,2528,857,154,178,332,2.9463869463869465,50.820999397609434
Task_40914,1388,620,120,34,154,2.2351046698872787,30.039535994555248
Task_40915,1812,569,91,87,178,3.1789473684210527,37.354949587066535
Task_40916,2525,508,84,52,136,4.960707269155206,47.95441113456385
Task_40917,618,367,145,76,221,1.6793478260869565,18.026405708608674
Task_40918,1120,793,124,16,140,1.4105793450881612,26.06145857673961
Task_40919,920,827,183,79,262,1.1111111111111112,24.401827672296832
Task_40920,2791,256,108,176,284,10.859922178988327,52.800706895518566
Task_40921,850,375,56,147,203,2.2606382978723403,22.263528136786437
Task_40922,539,148,111,139,250,3.61744966442953,16.352574208399602
Task_40923,1696,92,187,152,339,18.236559139784948,34.37862551304102
Task_40924,774,636,75,135,210,1.2150706436420722,21.737502552900235
Task_40925,675,460,105,67,172,1.4642082429501084,18.767729246894163
Task_40926,969,301,37,39,76,3.2086092715231787,21.28161472380034
Task_40927,1108,979,127,19,146,1.1306122448979592,26.56297071729386
Task_40928,2057,481,58,175,233,4.267634854771784,41.87641739856837
Task_40929,2312,68,177,66,243,33.507246376811594,42.75094989137989
Task_40930,689,905,81,36,117,0.760485651214128,19.641362380811277
Task_40931,973,901,74,119,193,1.0787139689578713,25.544662298936444
Task_40932,1605,584,64,110,174,2.7435897435897436,34.59412221800984
Task_40933,546,676,75,158,233,0.8064992614475628,18.400002786312537
Task_40934,1430,356,162,39,201,4.0056022408963585,30.331770372634654
Task_40935,1131,260,109,71,180,4.333333333333333,25.332823929093166
Task_40936,1961,839,82,91,173,2.3345238095238097,40.80568139710598
Task_40937,1240,475,90,145,235,2.6050420168067228,28.78400738072089
Task_40938,1083,846,189,14,203,1.2786304604486423,26.222170977158186
Task_40939,2766,454,123,91,214,6.079120879120879,52.50212411519622
Task_40940,2807,934,102,190,292,3.002139037433155,55.319951566711666
Task_40941,976,287,184,10,194,3.388888888888889,22.78043653842204
Task_40942,2024,863,140,70,210,2.3425925925925926,41.701400573370286
Task_40943,2904,495,10,147,157,5.854838709677419,54.48558926207583
Task_40944,1998,834,44,12,56,2.392814371257485,39.16754081318497
Task_40945,1976,65,140,183,323,29.939393939393938,38.54690599587866
Task_40946,810,873,113,18,131,0.9267734553775744,21.52490641484538
Task_40947,2373,921,152,138,290,2.5737527114967462,48.317031650802484
Task_40948,1918,880,20,40,60,2.177071509648127,38.21220392091961
Task_40949,2718,1024,72,52,124,2.651707317073171,52.56264205786011
Task_40950,1234,243,86,127,213,5.057377049180328,27.803961909043853
Task_40951,747,558,21,128,149,1.336314847942755,20.38284626897359
Task_40952,1255,390,21,81,102,3.209718670076726,27.346226290439375
Task_40953,933,590,49,116,165,1.5786802030456852,23.9226656387729
Task_40954,1404,71,152,44,196,19.5,28.03103644460468
Task_40955,590,316,42,37,79,1.861198738170347,15.596921390490538
Task_40956,1053,697,166,28,194,1.508595988538682,25.411668422383286
Task_40957,1842,510,66,103,169,3.604696673189824,37.951454609235505
Task_40958,1895,981,193,11,204,1.929735234215886,39.56478763837693
Task_40959,2004,378,32,143,175,5.287598944591029,40.21791498587753
Task_40960,2607,269,115,198,313,9.655555555555555,50.10385435003379
Task_40961,827,447,187,87,274,1.8459821428571428,21.94580636575095
Task_40962,625,193,24,159,183,3.2216494845360826,17.709998957085457
Task_40963,2275,230,169,147,316,9.848484848484848,44.65319483077434
Task_40964,1085,478,169,35,204,2.2651356993736953,25.319719042383323
Task_40965,959,804,187,19,206,1.191304347826087,24.15541731251584
Task_40966,1492,755,86,102,188,1.9735449735449735,33.33310231098785
Task_40967,1676,448,46,82,128,3.732739420935412,34.78906874684437
Task_40968,2465,507,111,78,189,4.852362204724409,47.594373123358366
Task_40969,1991,671,117,39,156,2.962797619047619,39.73155993829226
Task_40970,2439,788,96,76,172,3.091254752851711,47.93105593457608
Task_40971,2662,956,107,78,185,2.781609195402299,51.996419146146046
Task_40972,2609,346,56,51,107,7.518731988472623,48.330248252156615
Task_40973,1296,582,44,128,172,2.2229845626072042,29.591341217086768
Task_40974,2449,681,155,155,310,3.590909090909091,48.88354525280735
Task_40975,1054,177,73,189,262,5.921348314606742,24.70878697576021
Task_40976,1114,571,64,122,186,1.9475524475524475,26.78511881723909
Task_40977,842,432,144,142,286,1.9445727482678983,22.524981798959136
Task_40978,696,467,106,45,151,1.4871794871794872,18.527612730833855
Task_40979,1437,825,90,139,229,1.7397094430992737,32.949735508295106
Task_40980,1249,552,68,99,167,2.2585895117540686,28.666401939715712
Task_40981,665,450,124,115,239,1.4745011086474502,19.474781264754167
Task_40982,2310,412,134,72,206,5.593220338983051,44.813396069037424
Task_40983,2855,461,111,173,284,6.17965367965368,54.515679249305606
Task_40984,1102,261,130,49,179,4.206106870229007,24.663137110868576
Task_40985,2975,415,200,44,244,7.1514423076923075,55.18567945369508
Task_40986,1484,785,178,49,227,1.8880407124681935,32.76906147980039
Task_40987,2062,824,123,66,189,2.4993939393939395,42.03108224134747
Task_40988,2265,330,199,57,256,6.842900302114804,43.947209611373786
Task_40989,2307,169,163,70,233,13.570588235294117,43.81382891170682
Task_40990,1396,578,97,83,180,2.4110535405872193,30.72718641939721
Task_40991,2868,178,148,12,160,16.022346368715084,51.695804336106825
Task_40992,1185,188,106,128,234,6.26984126984127,26.932912904568713
Task_40993,883,73,110,96,206,11.932432432432432,20.79606338018622
Task_40994,1680,132,184,191,375,12.631578947368421,34.7983562342775
Task_40995,1363,922,28,97,125,1.47670639219935,31.288409043895896
Task_40996,1984,975,142,117,259,2.0327868852459017,42.15050096262842
Task_40997,2105,789,157,73,230,2.6645569620253164,42.88584930498336
Task_40998,2889,150,77,25,102,19.132450331125828,51.388676606146504
Task_40999,587,959,25,97,122,0.6114583333333333,19.1390031647003
Task_41000,877,550,68,20,88,1.5916515426497277,20.990136488660024
Task_41001,1307,903,143,184,327,1.4457964601769913,31.535576109993496
Task_41002,1203,915,69,56,125,1.3133187772925765,28.219502619571045
Task_41003,1861,513,176,148,324,3.6206225680933852,39.09193214134975
Task_41004,1042,236,89,24,113,4.39662447257384,23.08032687679281
Task_41005,1705,726,181,62,243,2.34525447042641,36.30867635137849
Task_41006,2855,345,64,163,227,8.251445086705202,53.982735240020226
Task_41007,1382,231,30,95,125,5.956896551724138,29.424533910044275
Task_41008,514,975,100,189,289,0.5266393442622951,19.199083755698712
Task_41009,2208,494,154,12,166,4.460606060606061,42.67588353567942
Task_41010,1447,458,181,62,243,3.1525054466230937,31.379155128018535
Task_41011,1851,126,41,183,224,14.5748031496063,36.79450711245445
Task_41012,1957,982,48,157,205,1.9908443540183114,41.68297073119567
Task_41013,2474,275,162,64,226,8.96376811594203,46.979696071967936
Task_41014,2721,881,46,130,176,3.0850340136054424,53.05879381456697
Task_41015,2630,318,11,160,171,8.244514106583072,49.75330039549962
Task_41016,1933,210,37,51,88,9.161137440758294,37.01533986432056
Task_41017,1887,182,126,137,263,10.311475409836065,37.92669393850113
Task_41018,2401,92,183,110,293,25.817204301075268,45.17363325686306
Task_41019,763,828,184,38,222,0.9203860072376358,21.496203549675425
Task_41020,989,668,141,98,239,1.4783258594917787,25.263075253132598
Task_41021,2876,1022,113,47,160,2.811339198435973,54.89017127952216
Task_41022,1678,860,179,188,367,1.948896631823461,37.53498060469098
Task_41023,1382,167,159,178,337,8.226190476190476,30.17138128898418
Task_41024,2179,726,165,91,256,2.9972489683631363,44.26501418252266
Task_41025,2708,646,83,22,105,4.185471406491499,50.514164514801394
Task_41026,974,1017,68,70,138,0.9567779960707269,25.151544995264633
Task_41027,2247,965,20,40,60,2.3260869565217392,43.690121667169905
Task_41028,1851,613,41,143,184,3.014657980456026,38.45069400649005
Task_41029,1700,987,186,40,226,1.7206477732793521,36.7301751568458
Task_41030,1535,763,39,88,127,2.0091623036649215,33.39226164534157
Task_41031,1025,831,93,76,169,1.2319711538461537,25.500196002691695
Task_41032,2811,344,139,10,149,8.147826086956522,51.53938816578573
Task_41033,1971,858,102,87,189,2.2945285215366704,40.93745309602637
Task_41034,507,999,191,147,338,0.507,19.237300214225055
Task_41035,2522,622,122,138,260,4.048154093097914,49.602604328909365
Task_41036,1210,363,186,101,287,3.3241758241758244,28.07296108463297
Task_41037,2183,623,120,41,161,3.4983974358974357,42.668959988375896
Task_41038,1520,889,126,117,243,1.7078651685393258,34.44526381798778
Task_41039,1945,782,166,12,178,2.4840357598978287,39.43902785818147
Task_41040,2245,376,123,46,169,5.954907161803714,42.971641568527936
Task_41041,2401,84,96,59,155,28.24705882352941,43.626282446461154
Task_41042,1472,847,147,143,290,1.7358490566037736,33.80418744481847
Task_41043,1482,908,192,139,331,1.6303630363036303,34.33100357746725
Task_41044,1023,594,75,184,259,1.719327731092437,25.9604197573222
Task_41045,2001,503,19,66,85,3.9702380952380953,39.12137558409183
Task_41046,500,111,127,38,165,4.464285714285714,14.026306432843228
Task_41047,1196,773,41,41,82,1.545219638242894,26.882975677522634
Task_41048,1189,673,130,164,294,1.7640949554896141,28.828264883433963
Task_41049,2276,256,144,142,286,8.85603112840467,44.62210312670547
Task_41050,859,249,121,83,204,3.436,21.45893792142373
Task_41051,1564,824,71,53,124,1.8957575757575758,33.6623283242519
Task_41052,2669,763,152,55,207,3.493455497382199,51.59037044922098
Task_41053,1650,670,26,31,57,2.459016393442623,33.329456745143254
Task_41054,1669,855,93,123,216,1.949766355140187,36.71293171266768
Task_41055,1169,598,158,39,197,1.9515859766277128,26.95015300584666
Task_41056,1120,296,101,87,188,3.771043771043771,25.665855041695057
Task_41057,2674,177,170,174,344,15.02247191011236,50.494421526100304
Task_41058,2773,723,156,47,203,3.8301104972375692,52.81052197307253
Task_41059,1843,753,136,182,318,2.444297082228117,39.58582513804471
Task_41060,2924,124,53,53,106,23.392,51.85140493153298
Task_41061,1192,855,135,29,164,1.3925233644859814,27.92284249467654
Task_41062,2159,507,187,195,382,4.25,44.12098351378381
Task_41063,2277,606,50,106,156,3.7512355848434926,45.0240370666535
Task_41064,851,365,130,147,277,2.3251366120218577,22.422466792091782
Task_41065,1858,767,147,143,290,2.4192708333333335,39.68384890894801
Task_41066,2692,852,140,123,263,3.155920281359906,53.01220585927424
Task_41067,2413,380,130,84,214,6.333333333333333,46.51313266236983
Task_41068,1723,1019,80,40,120,1.6892156862745098,36.361405851335505
Task_41069,2896,819,150,76,226,3.5317073170731708,55.54371729871036
Task_41070,2601,997,168,124,292,2.6062124248496996,52.15545716656502
Task_41071,2124,131,103,13,116,16.09090909090909,39.28655454793581
Task_41072,1151,417,160,69,229,2.7535885167464116,26.533543897670366
Task_41073,1781,451,28,177,205,3.940265486725664,37.17433044001283
Task_41074,2958,405,76,139,215,7.285714285714286,55.73727593279052
Task_41075,1496,569,116,52,168,2.624561403508772,32.04009911242352
Task_41076,1762,792,37,30,67,2.2219419924337958,35.464529340027916
Task_41077,2239,487,191,61,252,4.588114754098361,44.01195225874641
Task_41078,1630,711,133,45,178,2.289325842696629,34.32881773996072
Task_41079,1203,297,186,193,379,4.0369127516778525,28.297234140318533
Task_41080,2428,506,38,78,116,4.788954635108481,46.59683831424278
Task_41081,1725,192,99,132,231,8.937823834196891,35.42813826223988
Task_41082,1912,264,77,17,94,7.215094339622642,36.58705253134076
Task_41083,2823,465,99,159,258,6.05793991416309,53.88627165103255
Task_41084,2407,725,42,157,199,3.315426997245179,47.87325238031832
Task_41085,2306,534,153,168,321,4.310280373831776,46.220388329712
Task_41086,2818,143,161,66,227,19.569444444444443,51.594731096357634
Task_41087,2569,170,192,200,392,15.023391812865498,49.12207744875189
Task_41088,2984,774,140,158,298,3.850322580645161,57.602372287816
Task_41089,1576,205,43,86,129,7.650485436893204,32.28954187414932
Task_41090,1757,344,15,147,162,5.092753623188406,35.94324644533897
Task_41091,760,640,29,143,172,1.185647425897036,21.187351604199907
Task_41092,2917,704,181,185,366,4.137588652482269,56.66582311982361
Task_41093,1557,192,88,139,227,8.067357512953368,32.788639549311654
Task_41094,1561,982,31,57,88,1.5879959308240081,33.57280267288437
Task_41095,546,745,69,10,79,0.7319034852546917,16.45204839356059
Task_41096,2849,786,129,107,236,3.62007623888183,55.14722939717677
Task_41097,2208,724,52,175,227,3.04551724137931,45.026477768615074
Task_41098,2594,316,163,91,254,8.182965299684543,49.496476028168196
Task_41099,687,986,83,121,204,0.6960486322188449,21.481336696085464
Task_41100,2486,767,174,11,185,3.2369791666666665,48.035860532095796
Task_41101,2473,480,176,154,330,5.141372141372141,48.7103537461707
Task_41102,1905,676,49,17,66,2.813884785819793,37.13185354118129
Task_41103,911,633,186,90,276,1.4369085173501577,23.895310498648872
Task_41104,656,1018,87,41,128,0.6437684003925417,20.06419670490043
Task_41105,519,320,67,74,141,1.6168224299065421,15.872047549599735
Task_41106,2661,718,17,78,95,3.700973574408901,50.49943875350031
Task_41107,2136,691,128,151,279,3.086705202312139,43.81160766328373
Task_41108,2106,345,114,186,300,6.086705202312139,42.370345696877074
Task_41109,1084,276,50,135,185,3.9133574007220218,25.44707302408686
Task_41110,813,720,195,99,294,1.1276005547850207,22.762785852303825
Task_41111,2602,435,15,95,110,5.967889908256881,49.21748766364678
Task_41112,1103,393,163,18,181,2.799492385786802,24.771029816267205
Task_41113,1578,611,166,134,300,2.5784313725490198,34.79187671743782
Task_41114,2248,526,168,144,312,4.265654648956357,45.2007015167988
Task_41115,2180,763,178,182,360,2.8534031413612566,45.14518934428154
Task_41116,734,531,13,50,63,1.3796992481203008,18.541088274740584
Task_41117,2374,587,44,192,236,4.037414965986395,47.13207161377983
Task_41118,2365,72,23,190,213,32.397260273972606,44.25460313614275
Task_41119,918,1004,69,120,189,0.9134328358208955,25.002312219580475
Task_41120,2963,817,88,143,231,3.622249388753056,57.10074665787718
Task_41121,2911,367,139,41,180,7.9103260869565215,53.55926676688284
Task_41122,1322,552,176,183,359,2.390596745027125,30.89025977032138
Task_41123,1578,585,112,176,288,2.6928327645051193,34.71759718601601
Task_41124,796,369,196,59,255,2.151351351351351,20.8110752319442
Task_41125,1566,113,77,146,223,13.736842105263158,32.17554348636242
Task_41126,1916,467,190,16,206,4.094017094017094,38.26679866351993
Task_41127,2230,944,175,110,285,2.35978835978836,46.059178463039736
Task_41128,2688,445,198,127,325,6.026905829596412,51.93715269001259
Task_41129,912,485,98,98,196,1.876543209876543,23.346513451379966
Task_41130,825,846,170,149,319,0.974025974025974,23.62160216670307
Task_41131,1164,360,29,183,212,3.224376731301939,27.158751698489286
Task_41132,2982,488,188,78,266,6.098159509202454,56.09640995499271
Task_41133,1295,452,94,195,289,2.858719646799117,29.932937276046193
Task_41134,2679,168,34,170,204,15.85207100591716,50.05482247618616
Task_41135,2685,921,24,189,213,2.9121475054229933,53.031486185579816
Task_41136,1045,843,191,102,293,1.2381516587677726,26.869982904229797
Task_41137,1888,443,108,191,299,4.252252252252252,39.2453588911312
Task_41138,2679,672,77,154,231,3.9806835066864785,52.26655130193375
Task_41139,1013,167,47,147,194,6.029761904761905,23.720797925950176
Task_41140,2876,866,11,116,127,3.3171856978085352,55.09763317165474
Task_41141,2132,677,129,65,194,3.144542772861357,42.75302684218084
Task_41142,2259,267,37,159,196,8.42910447761194,44.032271583065665
Task_41143,932,957,179,150,329,0.9728601252609603,25.706846834170488
Task_41144,2852,262,12,82,94,10.844106463878328,52.12655037644361
Task_41145,2717,232,35,123,158,11.660944206008583,50.614781841726575
Task_41146,973,550,42,19,61,1.765880217785844,21.947594700897394
Task_41147,2336,954,17,93,110,2.446073298429319,46.53650728245412
Task_41148,1900,920,35,136,171,2.0629750271444083,40.11446479235313
Task_41149,1522,1014,169,60,229,1.4995073891625617,34.19178081922456
Task_41150,1629,1019,147,144,291,1.5970588235294119,36.831775401551795
Task_41151,2336,219,137,25,162,10.618181818181819,43.73389691993257
Task_41152,2252,535,51,30,81,4.201492537313433,42.90267148516417
Task_41153,1163,384,114,142,256,3.020779220779221,27.317154506106817
Task_41154,1846,670,18,177,195,2.751117734724292,38.785727632636004
Task_41155,2130,153,107,101,208,13.831168831168831,41.19021451109992
Task_41156,2564,349,160,172,332,7.325714285714286,49.751993047144744
Task_41157,1080,706,93,11,104,1.5275813295615275,24.983443084158026
Task_41158,1541,416,144,16,160,3.695443645083933,31.679423857731432
Task_41159,2200,144,158,169,327,15.172413793103448,42.92347591072188
Task_41160,1071,251,183,30,213,4.25,24.41156881455444
Task_41161,791,278,177,168,345,2.835125448028674,21.53237259898302
Task_41162,2053,691,189,183,372,2.9667630057803467,42.96295195269485
Task_41163,615,254,93,94,187,2.411764705882353,17.856270852748576
Task_41164,545,906,184,26,210,0.6008820286659317,18.480215583782456
Task_41165,2267,225,190,165,355,10.030973451327434,44.71020405605643
Task_41166,1379,900,178,92,270,1.5305216426193118,32.2002745265075
Task_41167,2996,449,45,137,182,6.657777777777778,56.01322813477558
Task_41168,2738,382,151,44,195,7.148825065274152,51.10390805467156
Task_41169,528,672,140,44,184,0.7845468053491828,16.848629600081342
Task_41170,1241,494,120,146,266,2.507070707070707,28.951770797829365
Task_41171,1383,231,148,24,172,5.961206896551724,28.931617599161086
Task_41172,1075,231,162,80,242,4.633620689655173,24.9860810866461
Task_41173,2950,545,149,184,333,5.402930402930403,56.530179343148426
Task_41174,2964,166,123,183,306,17.748502994011975,54.949240222289546
Task_41175,595,726,117,159,276,0.8184319119669876,19.42436179803154
Task_41176,1770,610,177,63,240,2.8968903436988542,36.99382035904421
Task_41177,1348,782,16,54,70,1.7215836526181354,29.260898587359737
Task_41178,2890,346,197,49,246,8.328530259365994,53.706235657270476
Task_41179,1818,903,182,176,358,2.0110619469026547,39.82887921664989
Task_41180,2147,598,103,75,178,3.5843071786310516,42.563078893145224
Task_41181,2342,253,180,18,198,9.220472440944881,44.165990188554495
Task_41182,1783,932,79,26,105,1.9110396570203645,36.891100050580086
Task_41183,2000,730,178,64,242,2.735978112175103,41.0302310898139
Task_41184,1322,684,112,38,150,1.92992700729927,29.208621946072356
Task_41185,2585,657,103,171,274,3.9285714285714284,50.82295551462175
Task_41186,1473,371,104,69,173,3.9596774193548385,31.135273606930856
Task_41187,1284,300,88,164,252,4.26578073089701,28.992453030731536
Task_41188,2038,691,143,62,205,2.945086705202312,41.30262673020906
Task_41189,1817,572,46,184,230,3.1710296684118675,38.2459124475406
Task_41190,682,159,27,106,133,4.2625,17.617695492334494
Task_41191,2087,761,142,95,237,2.7388451443569553,42.95556667334828
Task_41192,1306,765,19,124,143,1.7049608355091384,29.91558683197812
Task_41193,2880,815,22,86,108,3.5294117647058822,54.578858095560584
Task_41194,786,913,72,120,192,0.8599562363238512,22.685522399258605
Task_41195,2037,924,148,168,316,2.2021621621621623,43.1633776756257
Task_41196,1149,495,61,180,241,2.316532258064516,27.56362250422339
Task_41197,1604,832,141,16,157,1.9255702280912366,33.96993019778516
Task_41198,967,505,127,50,177,1.9110671936758894,23.287980338943168
Task_41199,1850,417,82,169,251,4.425837320574162,38.40370805736789
Task_41200,2081,974,129,38,167,2.134358974358974,42.333152742065444
Task_41201,745,614,51,26,77,1.2113821138211383,18.83416054538868
Task_41202,979,616,62,73,135,1.586709886547812,24.030493365963178
Task_41203,2919,198,160,175,335,14.668341708542714,54.86810329592843
Task_41204,658,364,140,171,311,1.8027397260273972,19.554523044615717
Task_41205,858,693,51,15,66,1.2363112391930835,20.60143708865691
Task_41206,994,836,188,65,253,1.1875746714456392,25.49795876479818
Task_41207,642,538,83,139,222,1.1910946196660481,19.355479907035583
Task_41208,1196,989,151,99,250,1.208080808080808,29.54290860342609
Task_41209,2277,241,77,95,172,9.409090909090908,44.04957080981058
Task_41210,1780,408,124,38,162,4.352078239608802,35.68502882706364
Task_41211,789,701,78,21,99,1.123931623931624,20.380039306568566
Task_41212,2998,816,76,114,190,3.6695226438188495,57.53205671543204
Task_41213,1120,400,25,79,104,2.7930174563591024,25.29502432810418
Task_41214,2144,336,100,158,258,6.362017804154303,42.71077550895048
Task_41215,2433,689,183,180,363,3.526086956521739,48.930886956071014
Task_41216,711,833,177,36,213,0.8525179856115108,20.57985916254503
Task_41217,973,361,173,73,246,2.6878453038674035,23.684651954168388
Task_41218,1900,564,28,80,108,3.3628318584070795,38.284091493145574
Task_41219,2223,278,171,82,253,7.967741935483871,43.34302681755124
Task_41220,1634,462,123,81,204,3.529157667386609,34.37346915440235
Task_41221,646,243,93,162,255,2.6475409836065573,18.82510987873376
Task_41222,2293,358,120,157,277,6.387186629526463,45.2257602138875
Task_41223,1058,265,133,72,205,3.9774436090225564,24.522049058810936
Task_41224,2586,262,140,51,191,9.832699619771864,48.514660007825874
Task_41225,2199,1010,199,113,312,2.1750741839762613,45.899407866843354
Task_41226,2149,407,76,19,95,5.267156862745098,40.82609199470216
Task_41227,2937,183,156,191,347,15.96195652173913,54.97263229455918
Task_41228,2684,531,197,119,316,5.045112781954887,52.10135598688802
Task_41229,2114,479,196,111,307,4.404166666666667,42.8574538621954
Task_41230,1684,967,155,49,204,1.7396694214876034,36.387542840964905
Task_41231,1982,361,181,91,272,5.475138121546961,40.0506146308993
Task_41232,2125,679,79,86,165,3.125,42.82205906048299
Task_41233,2277,922,21,27,48,2.466955579631636,43.945992321747774
Task_41234,2220,167,175,120,295,13.214285714285714,43.11153019887754
Task_41235,2506,998,45,98,143,2.5085085085085086,49.66233622645556
Task_41236,821,273,124,92,216,2.9963503649635035,21.196811009841714
Task_41237,1216,221,162,194,356,5.4774774774774775,28.144839546658506
Task_41238,1262,574,39,108,147,2.194782608695652,28.660079901759687
Task_41239,554,890,154,147,301,0.621773288439955,19.58148346161237
Task_41240,1993,1009,164,30,194,1.9732673267326732,41.31843530116311
Task_41241,2194,956,176,123,299,2.2925809822361547,45.60823762589269
Task_41242,1180,418,45,198,243,2.8162291169451072,27.718262151193414
Task_41243,1807,504,21,110,131,3.5782178217821783,37.02152475084631
Task_41244,2033,444,81,149,230,4.568539325842696,41.27468204996941
Task_41245,1129,539,98,125,223,2.0907407407407406,27.109414290802093
Task_41246,943,823,170,171,341,1.1444174757281553,25.550592318073274
Task_41247,1785,648,17,78,95,2.7503852080123266,36.40333647143535
Task_41248,1801,682,12,84,96,2.636896046852123,36.88434777438425
Task_41249,955,711,180,117,297,1.3412921348314606,25.157503802364477
Task_41250,1650,449,94,61,155,3.6666666666666665,33.91606328667428
Task_41251,725,589,66,22,88,1.228813559322034,18.933805128237566
Task_41252,649,79,178,32,210,8.1125,16.471882486967534
Task_41253,2861,871,43,174,217,3.2809633027522938,55.63055437664781
Task_41254,2821,908,116,152,268,3.1034103410341034,55.29660089421353
Task_41255,1604,637,38,35,73,2.5141065830721003,32.49449773722403
Task_41256,764,160,43,13,56,4.745341614906832,17.560437226509972
Task_41257,1055,500,129,108,237,2.1057884231536925,25.839656685919028
Task_41258,2669,528,187,52,239,5.045368620037808,50.996703117655954
Task_41259,1115,353,76,82,158,3.1497175141242937,25.52869368749245
Task_41260,739,277,167,36,203,2.658273381294964,19.1984438700058
Task_41261,1475,270,45,40,85,5.442804428044281,29.66603404272362
Task_41262,1827,877,98,141,239,2.080865603644647,39.31684877847294
Task_41263,2147,91,64,80,144,23.33695652173913,40.00146306268656
Task_41264,899,194,107,45,152,4.61025641025641,20.832399432195132
Task_41265,1084,157,121,141,262,6.860759493670886,25.056306031098018
Task_41266,1257,268,18,142,160,4.672862453531598,27.65014228897924
Task_41267,2514,386,15,47,62,6.496124031007752,46.211420928939255
Task_41268,1781,526,105,44,149,3.379506641366224,35.94243171815298
Task_41269,698,1009,170,192,362,0.691089108910891,22.5051663117668
Task_41270,1317,402,121,108,229,3.267990074441687,29.639955666691066
Task_41271,1022,820,44,77,121,1.2448233861144946,25.09787924610892
Task_41272,826,907,103,69,172,0.9096916299559471,22.61812457651793
Task_41273,2957,642,176,151,327,4.598755832037325,56.87678011550346
Task_41274,2679,238,184,186,370,11.209205020920502,51.3654860105871
Task_41275,604,556,68,193,261,1.0843806104129263,19.035541647910115
Task_41276,1169,388,80,121,201,3.005141388174807,27.27349722602024
Task_41277,900,395,39,24,63,2.272727272727273,20.549574718131904
Task_41278,1116,817,86,161,247,1.3643031784841075,27.88269322344529
Task_41279,2104,849,22,73,95,2.4752941176470586,42.07533211686596
Task_41280,2599,691,154,109,263,3.755780346820809,51.01185614187739
Task_41281,1270,434,74,190,264,2.9195402298850577,29.40807471106416
Task_41282,1859,273,113,39,152,6.7846715328467155,36.309204338701015
Task_41283,950,274,160,16,176,3.4545454545454546,22.05238001848919
Task_41284,1036,176,53,134,187,5.853107344632768,23.961430294088164
Task_41285,2965,436,94,51,145,6.784897025171625,54.80520551152028
Task_41286,2981,762,167,112,279,3.90694626474443,57.363921656531375
Task_41287,2808,110,124,92,216,25.2972972972973,51.20320454280591
Task_41288,1641,421,177,101,278,3.8886255924170614,35.03874047261881
Task_41289,2303,455,13,181,194,5.050438596491228,45.4208095154306
Task_41290,1052,702,194,169,363,1.496443812233286,27.037489379679553
Task_41291,2949,586,177,47,224,5.023850085178876,55.25688901499523
Task_41292,1886,648,118,25,143,2.906009244992296,37.93955544087516
Task_41293,522,860,70,49,119,0.6062717770034843,17.21719475815338
Task_41294,1035,160,134,72,206,6.428571428571429,23.564085110110767
Task_41295,2888,873,162,77,239,3.3043478260869565,55.64933172046205
Task_41296,2207,217,59,35,94,10.123853211009175,41.11043905668442
Task_41297,2629,462,137,81,218,5.6781857451403885,50.186191028173035
Task_41298,1143,598,128,42,170,1.9081803005008346,26.244648020498015
Task_41299,1583,851,128,51,179,1.857981220657277,34.303102497609636
Task_41300,549,405,143,15,158,1.3522167487684729,15.921956579706103
Task_41301,577,202,75,52,127,2.8423645320197046,16.16267418184784
Task_41302,2115,1005,12,177,189,2.1023856858846917,44.067292439349266
Task_41303,2226,267,147,22,169,8.305970149253731,42.227252635939294
Task_41304,947,467,137,12,149,2.0235042735042734,22.456401614891007
Task_41305,2366,658,91,140,231,3.590288315629742,47.167423282350285
Task_41306,1673,493,198,97,295,3.38663967611336,35.88004604593942
Task_41307,1893,659,10,29,39,2.868181818181818,36.94569703034629
Task_41308,2452,369,83,24,107,6.627027027027027,45.63012553863313
Task_41309,2511,552,74,181,255,4.540687160940325,49.377395351881226
Task_41310,1079,260,165,134,299,4.134099616858237,25.767875827127096
Task_41311,2631,490,82,33,115,5.358452138492872,49.05975326037004
Task_41312,1014,353,75,134,209,2.864406779661017,24.773224530112586
Task_41313,547,375,72,61,133,1.4547872340425532,16.230774368246138
Task_41314,2057,785,46,128,174,2.6170483460559795,42.31695342533161
Task_41315,1212,444,103,123,226,2.7235955056179777,28.120571309244298
Task_41316,692,307,71,107,178,2.2467532467532467,19.163541603885445
Task_41317,2946,71,194,169,363,40.916666666666664,53.884273639268436
Task_41318,1044,693,166,200,366,1.5043227665706052,26.941748303566087
Task_41319,1142,491,126,45,171,2.321138211382114,25.856244389672252
Task_41320,1739,166,26,37,63,10.41317365269461,33.07628161439038
Task_41321,2636,120,107,20,127,21.785123966942148,47.389129753430154
Task_41322,1471,169,115,13,128,8.652941176470588,29.607767860836116
Task_41323,1664,937,79,50,129,1.7739872068230278,35.48672164454047
Task_41324,1957,835,82,11,93,2.340909090909091,39.1648324695719
Task_41325,1518,109,45,59,104,13.8,29.51680286055174
Task_41326,1075,223,99,92,191,4.799107142857143,24.932504976279166
Task_41327,2332,266,150,90,240,8.734082397003744,45.09474237869762
Task_41328,1391,688,54,15,69,2.018867924528302,28.98989435703292
Task_41329,2656,788,178,39,217,3.3662864385297846,51.19029526909693
Task_41330,2451,180,128,119,247,13.541436464088397,46.501410379859614
Task_41331,2904,182,43,131,174,15.868852459016393,53.51245773003732
Task_41332,1727,611,161,74,235,2.8218954248366015,36.413769403762586
Task_41333,2512,260,189,55,244,9.624521072796934,47.62320272078157
Task_41334,1308,425,43,133,176,3.0704225352112675,29.22626141408084
Task_41335,2118,241,67,171,238,8.75206611570248,42.019679667619535
Task_41336,2982,550,166,116,282,5.411978221415608,56.72348127083899
Task_41337,2452,260,171,85,256,9.39463601532567,46.92422590172314
Task_41338,677,306,177,96,273,2.205211726384365,19.413591018743787
Task_41339,2617,347,175,32,207,7.5201149425287355,49.14492491396181
Task_41340,1322,457,178,98,276,2.88646288209607,30.094890262730456
Task_41341,2362,970,175,115,290,2.43254376930999,48.261745000168354
Task_41342,515,808,83,186,269,0.6365883807169345,18.58728328199325
Task_41343,570,672,20,80,100,0.8469539375928677,17.338536355032716
Task_41344,646,745,33,182,215,0.8659517426273459,19.99908548488207
Task_41345,587,787,199,19,218,0.7449238578680203,18.258300784775457
Task_41346,947,922,180,137,317,1.0260021668472372,25.716261161791106
Task_41347,2272,987,126,167,293,2.299595141700405,46.978219001120614
Task_41348,1736,691,149,115,264,2.508670520231214,37.355221297083816
Task_41349,569,857,31,73,104,0.6631701631701632,18.04947137079022
Task_41350,1113,184,199,96,295,6.0162162162162165,25.85371765126902
Task_41351,1238,875,66,69,135,1.41324200913242,28.824403572025854
Task_41352,1595,338,189,80,269,4.705014749262537,33.684360793278756
Task_41353,863,512,127,193,320,1.6822612085769981,23.322839558113667
Task_41354,1840,908,36,76,112,2.024202420242024,38.423920617431044
Task_41355,627,825,109,176,285,0.7590799031476998,20.333895065824564
Task_41356,1825,370,67,187,254,4.919137466307277,37.924533513756465
Task_41357,1451,789,170,17,187,1.8367088607594937,31.73294664114631
Task_41358,1615,365,164,176,340,4.412568306010929,34.83521539561914
Task_41359,1964,779,126,106,232,2.517948717948718,41.08500622210254
Task_41360,1124,827,67,65,132,1.357487922705314,26.9460546852193
Task_41361,2968,646,118,86,204,4.587326120556415,56.15001777195579
Task_41362,1580,678,192,28,220,2.3269513991163477,33.815705233410235
Task_41363,2496,181,126,136,262,13.714285714285714,47.3311473782743
Task_41364,774,958,15,40,55,0.8070907194994786,20.62955576394129
Task_41365,1811,695,84,43,127,2.6020114942528734,36.80775117849038
Task_41366,1521,661,136,53,189,2.297583081570997,32.989421301178076
Task_41367,2207,595,11,199,210,3.703020134228188,44.394301865752446
Task_41368,692,1001,152,164,316,0.6906187624750499,22.137023390457042
Task_41369,2754,295,127,69,196,9.304054054054054,51.33449762281759
Task_41370,2581,381,123,195,318,6.7565445026178015,50.09965210604406
Task_41371,2753,127,47,14,61,21.5078125,48.40598955833479
Task_41372,2407,150,46,156,202,15.940397350993377,45.64967158345351
Task_41373,1966,361,41,195,236,5.430939226519337,39.94625138519381
Task_41374,1148,264,197,156,353,4.332075471698113,27.147223174892105
Task_41375,1880,726,19,154,173,2.5859697386519946,39.30541425396317
Task_41376,1565,292,103,38,141,5.341296928327645,31.77306150253582
Task_41377,2150,483,21,196,217,4.4421487603305785,43.13963949909115
Task_41378,2185,573,70,69,139,3.8066202090592336,42.9003306499535
Task_41379,605,628,80,33,113,0.9618441971383148,17.613031089818776
Task_41380,1293,276,159,20,179,4.667870036101083,27.442569437378452
Task_41381,2646,376,117,133,250,7.018567639257294,50.71386345785347
Task_41382,1405,399,192,132,324,3.5125,31.486156526691612
Task_41383,1676,327,80,187,267,5.109756097560975,35.48940081443049
Task_41384,1534,373,158,103,261,4.101604278074866,33.11676143947536
Task_41385,1199,588,84,150,234,2.0356536502546687,28.49100295990871
Task_41386,2100,519,199,101,300,4.038461538461538,42.71794180147041
Task_41387,1620,271,166,107,273,5.955882352941177,34.19801924954661
Task_41388,693,929,37,55,92,0.7451612903225806,19.79353624325211
Task_41389,2797,876,153,171,324,3.1892816419612315,55.09637628925733
Task_41390,1008,268,64,17,81,3.7472118959107807,22.041299238217704
Task_41391,2405,864,145,164,309,2.7803468208092488,48.769835554179245
Task_41392,2194,879,102,92,194,2.493181818181818,44.74691029082268
Task_41393,2219,974,24,64,88,2.275897435897436,44.13863897564092
Task_41394,1521,456,157,18,175,3.3282275711159737,31.66966034856964
Task_41395,2493,746,58,41,99,3.3373493975903616,47.334669711178655
Task_41396,2298,247,10,138,148,9.266129032258064,43.99595652606666
Task_41397,738,803,98,167,265,0.917910447761194,21.913121696534517
Task_41398,1138,184,175,30,205,6.151351351351352,25.234477669641038
Task_41399,836,194,88,75,163,4.287179487179487,20.50188681042805
Task_41400,1780,96,119,52,171,18.350515463917525,34.138069521212635
Task_41401,1100,327,24,191,215,3.3536585365853657,26.067179163979834
Task_41402,1441,909,83,120,203,1.5835164835164834,33.10253924550373
Task_41403,1082,261,167,109,276,4.129770992366412,25.678297733409384
Task_41404,2799,334,181,197,378,8.355223880597014,53.66137639124296
Task_41405,1215,519,43,142,185,2.3365384615384617,28.131675344747006
Task_41406,2534,306,109,198,307,8.254071661237784,49.05468635625846
Task_41407,2045,947,108,53,161,2.1571729957805905,41.82069333970607
Task_41408,1088,201,31,107,138,5.3861386138613865,24.655452957837245
Task_41409,726,1018,18,108,126,0.7124631992149166,21.565088639588506
Task_41410,2666,722,15,79,94,3.6874135546334714,50.69021212337885
Task_41411,1695,789,105,115,220,2.1455696202531644,36.813646038101844
Task_41412,2271,676,63,179,242,3.3545051698670605,45.90500521987848
Task_41413,826,404,102,126,228,2.039506172839506,21.898706377665395
Task_41414,2539,273,21,105,126,9.266423357664234,47.83319384909229
Task_41415,755,988,161,166,327,0.7633973710819009,23.041070982691107
Task_41416,2448,589,109,161,270,4.149152542372882,48.40446603176699
Task_41417,1534,512,141,118,259,2.990253411306043,33.57471876028821
Task_41418,2499,961,143,157,300,2.5977130977130978,50.511303790719104
Task_41419,619,608,41,14,55,1.0164203612479474,16.709791201735147
Task_41420,1863,387,70,48,118,4.801546391752577,36.65653634324741
Task_41421,1815,982,57,119,176,1.8463886063072228,39.125490151183875
Task_41422,2078,839,130,41,171,2.473809523809524,41.81328248980794
Task_41423,1697,368,39,119,158,4.598915989159892,34.93768979128726
Task_41424,1770,230,117,190,307,7.662337662337662,36.699384779390876
Task_41425,1688,888,17,35,52,1.8987626546681664,34.661699128848646
Task_41426,2641,380,45,79,124,6.9317585301837275,49.59984847148592
Task_41427,1920,792,29,119,148,2.421185372005044,39.789324165651514
Task_41428,827,844,118,161,279,0.978698224852071,23.48872995407251
Task_41429,1772,1010,185,20,205,1.7527200791295747,37.649929416172256
Task_41430,2577,485,132,56,188,5.302469135802469,49.12079331452395
Task_41431,1462,240,130,190,320,6.066390041493776,31.928124604541576
Task_41432,1153,936,160,50,210,1.2305229455709712,27.893294243036227
Task_41433,1891,201,145,47,192,9.361386138613861,37.07751531725891
Task_41434,767,854,153,69,222,0.8970760233918129,21.84760075816585
Task_41435,981,673,69,94,163,1.4554896142433233,24.702085315396577
Task_41436,2839,971,68,12,80,2.9207818930041154,53.34347603353492
Task_41437,1680,356,15,60,75,4.705882352941177,33.081485902558946
Task_41438,2830,759,71,65,136,3.723684210526316,53.74077404167995
Task_41439,1862,686,94,139,233,2.710334788937409,39.314630797114624
Task_41440,2064,439,177,186,363,4.6909090909090905,42.29912139885953
Task_41441,2327,184,63,157,220,12.578378378378378,44.816331888868085
Task_41442,801,72,41,14,55,10.972602739726028,16.650102603906202
Task_41443,809,418,104,177,281,1.9307875894988067,21.987442400660303
Task_41444,1644,548,71,98,169,2.9945355191256833,34.936776510142536
Task_41445,2369,997,130,198,328,2.37374749498998,48.749684940195095
Task_41446,805,875,93,45,138,0.9189497716894978,21.722215979270786
Task_41447,2288,238,47,155,202,9.573221757322175,44.436645181663266
Task_41448,1581,406,142,123,265,3.8845208845208847,34.01456516019356
Task_41449,1723,597,155,86,241,2.8812709030100336,36.44379257214769
Task_41450,1871,592,63,18,81,3.1551433389544687,36.72132034321594
Task_41451,1087,914,192,117,309,1.1879781420765028,27.89062624825104
Task_41452,1030,922,151,45,196,1.1159263271939328,25.67301178192388
Task_41453,1825,792,168,64,232,2.301387137452711,38.406694585797716
Task_41454,2890,509,21,62,83,5.666666666666667,53.13720767424801
Task_41455,1091,658,53,119,172,1.6555386949924127,26.711679589670364
Task_41456,1700,866,197,99,296,1.9607843137254901,37.436962610367
Task_41457,1059,742,57,115,172,1.4253028263795424,26.366201456684394
Task_41458,966,173,19,105,124,5.551724137931035,21.815505056659998
Task_41459,2480,826,22,58,80,2.9987908101571947,47.48254839947959
Task_41460,1604,336,95,183,278,4.759643916913946,34.36702929224233
Task_41461,897,808,36,164,200,1.1087762669962917,23.981412679912477
Task_41462,572,138,16,105,121,4.115107913669065,15.48423240526557
Task_41463,944,437,30,135,165,2.1552511415525113,23.568304436393607
Task_41464,1715,863,111,147,258,1.9849537037037037,37.5791896705126
Task_41465,1880,264,33,154,187,7.09433962264151,37.974719348672274
Task_41466,1795,451,102,153,255,3.9712389380530975,37.54513388809632
Task_41467,1187,957,170,24,194,1.2390396659707725,28.297414211108972
Task_41468,1888,176,13,54,67,10.666666666666666,35.74760054877685
Task_41469,2373,506,133,100,233,4.680473372781065,46.69495044584132
Task_41470,2086,913,12,166,178,2.2822757111597376,43.10454310186645
Task_41471,720,497,128,173,301,1.4457831325301205,20.842194390682135
Task_41472,1158,305,57,144,201,3.784313725490196,26.896580238196567
Task_41473,1754,349,81,72,153,5.011428571428572,35.349843059920524
Task_41474,2303,845,13,173,186,2.7222222222222223,46.482792876018046
Task_41475,1278,436,177,72,249,2.9244851258581237,28.75264738330907
Task_41476,1235,865,25,150,175,1.426096997690531,29.487282215700798
Task_41477,930,132,28,34,62,6.992481203007519,19.954286844468434
Task_41478,1458,907,119,23,142,1.605726872246696,31.965314361346113
Task_41479,1371,482,125,141,266,2.8385093167701863,30.964478148552956
Task_41480,813,791,98,110,208,1.0265151515151516,22.670822580849375
Task_41481,1863,468,37,128,165,3.9722814498933903,38.18170128837853
Task_41482,920,441,32,128,160,2.081447963800905,22.926741062166894
Task_41483,2246,905,132,49,181,2.479028697571744,44.83022009170137
Task_41484,2051,722,51,139,190,2.8367911479944676,42.32840897828268
Task_41485,1485,407,53,159,212,3.639705882352941,32.48236538258676
Task_41486,2545,132,128,14,142,19.13533834586466,46.10643272211953
Task_41487,815,141,33,156,189,5.73943661971831,20.364732165230382
Task_41488,1783,306,159,133,292,5.807817589576548,37.01737014765708
Task_41489,1706,853,171,31,202,1.9976580796252927,36.31305608028542
Task_41490,1463,377,185,121,306,3.8703703703703702,32.23565118954619
Task_41491,1828,77,30,147,177,23.435897435897434,35.44365382151275
Task_41492,1354,488,76,46,122,2.7689161554192228,28.923621138121515
Task_41493,889,892,200,124,324,0.9955207166853304,24.747672993528145
Task_41494,2968,814,65,55,120,3.641717791411043,55.758655160139035
Task_41495,2817,925,119,188,307,3.0421166306695464,55.51494516250822
Task_41496,2639,940,158,101,259,2.8044633368756644,52.39737256948464
Task_41497,952,633,184,39,223,1.501577287066246,23.73960201519321
Task_41498,1763,445,125,195,320,3.9529147982062782,37.373888150896896
Task_41499,1599,767,169,99,268,2.08203125,35.402247852112616
Task_41500,1625,984,26,170,196,1.649746192893401,36.31075610031168
Task_41501,541,717,29,12,41,0.7534818941504178,15.711673706015382
Task_41502,518,578,124,14,138,0.8946459412780656,15.947193046416322
Task_41503,2388,438,171,62,233,5.439635535307517,46.16343467314005
Task_41504,2126,823,106,178,284,2.5800970873786406,44.129028067138734
Task_41505,896,731,34,183,217,1.2240437158469946,23.896349617249754
Task_41506,961,658,109,90,199,1.4582701062215477,24.41795448621929
Task_41507,2782,488,130,50,180,5.689161554192229,51.986703179840596
Task_41508,994,306,196,94,290,3.237785016286645,24.42037310466033
Task_41509,2347,442,63,51,114,5.297968397291196,44.63541956649551
Task_41510,1989,854,32,35,67,2.3263157894736843,39.28496806784116
Task_41511,2674,400,53,161,214,6.668329177057356,51.285935206215335
Task_41512,2435,665,30,39,69,3.656156156156156,45.70372292566793
Task_41513,572,509,107,145,252,1.1215686274509804,18.183968493540643
Task_41514,501,731,52,135,187,0.6844262295081968,17.73112640251745
Task_41515,2354,573,137,132,269,4.101045296167247,46.81789780444808
Task_41516,2737,1019,12,63,75,2.683333333333333,51.97944817718729
Task_41517,573,734,22,175,197,0.7795918367346939,18.679721520548895
Task_41518,1952,297,120,53,173,6.550335570469799,38.51875172395738
Task_41519,860,903,121,117,238,0.9513274336283186,23.954159692506277
Task_41520,551,827,85,111,196,0.6654589371980676,18.79843332087868
Task_41521,2474,130,111,20,131,18.885496183206108,44.934400691243674
Task_41522,1316,843,122,37,159,1.5592417061611374,29.629661844228426
Task_41523,1862,345,193,178,371,5.381502890173411,38.819206901292
Task_41524,1572,229,75,50,125,6.834782608695652,31.703846960317716
Task_41525,2087,83,148,84,232,24.845238095238095,39.62961649839614
Task_41526,1476,326,95,73,168,4.513761467889908,31.049122456713334
Task_41527,571,424,101,146,247,1.3435294117647059,18.000672343243192
Task_41528,2655,343,51,111,162,7.718023255813954,50.23084385831933
Task_41529,2911,990,46,52,98,2.937436932391524,55.135302715302
Task_41530,2213,1000,81,23,104,2.2107892107892106,43.81807763790332
Task_41531,1537,786,146,185,331,1.9529860228716645,34.90403115490176
Task_41532,1812,765,189,88,277,2.3655352480417755,38.55768750856541
Task_41533,2446,985,177,195,372,2.4807302231237323,50.126442048927494
Task_41534,1799,67,36,162,198,26.455882352941178,35.19525035090051
Task_41535,779,83,16,119,135,9.273809523809524,18.417412061323926
Task_41536,1595,661,100,84,184,2.409365558912387,34.12589807481746
Task_41537,2001,345,148,125,273,5.783236994219653,40.49842196912543
Task_41538,1930,510,107,116,223,3.776908023483366,39.67265399733663
Task_41539,2124,507,87,52,139,4.181102362204724,41.54305924305142
Task_41540,2288,1011,141,181,322,2.260869565217391,47.457670990127475
Task_41541,2908,796,70,132,202,3.648682559598494,56.13727406829108
Task_41542,2912,996,43,82,125,2.920762286860582,55.93267422811787
Task_41543,1212,90,130,73,203,13.31868131868132,25.629506398830816
Task_41544,2437,570,167,110,277,4.267950963222416,48.12646051533367
Task_41545,783,491,51,92,143,1.5914634146341464,20.869647073233452
Task_41546,2401,329,121,128,249,7.275757575757575,46.667052970754234
Task_41547,1996,361,38,50,88,5.513812154696133,38.35734280345587
Task_41548,624,840,178,11,189,0.7419738406658739,18.940507431771707
Task_41549,779,290,190,92,282,2.676975945017182,20.88535175197977
Task_41550,2109,944,90,104,194,2.231746031746032,43.77212059647665
Task_41551,1770,385,134,187,321,4.585492227979275,37.28322177674228
Task_41552,1057,318,35,50,85,3.3134796238244513,23.341071354338727
Task_41553,2956,778,195,124,319,3.7946084724005136,57.21620144213563
Task_41554,717,715,43,136,179,1.0013966480446927,20.500753055685895
Task_41555,1993,96,11,46,57,20.54639175257732,36.28637924765818
Task_41556,1807,447,181,164,345,4.033482142857143,38.143966314950035
Task_41557,678,570,157,108,265,1.1873905429071805,20.133308509683403
Task_41558,2482,1001,128,23,151,2.4770459081836327,48.505743932776966
Task_41559,949,625,108,184,292,1.5159744408945688,24.868494701032343
Task_41560,829,122,117,71,188,6.739837398373984,19.909950446448615
Task_41561,1253,437,182,157,339,2.8607305936073057,29.306396892199828
Task_41562,2249,947,48,96,144,2.3723628691983123,45.59721769843131
Task_41563,545,711,30,85,115,0.7654494382022472,17.298990832717433
Task_41564,1083,335,171,173,344,3.2232142857142856,26.33631395456763
Task_41565,1641,447,30,124,154,3.6629464285714284,34.28807382606321
Task_41566,1332,608,72,127,199,2.187192118226601,30.548073736765705
Task_41567,756,458,58,65,123,1.6470588235294117,19.888254713567306
Task_41568,2358,446,192,180,372,5.275167785234899,47.006873803003224
Task_41569,955,521,161,166,327,1.8295019157088122,24.812971681641983
Task_41570,2499,341,105,15,120,7.307017543859649,46.30348750537011
Task_41571,1523,188,190,106,296,8.058201058201059,32.51356137158433
Task_41572,1167,984,195,120,315,1.184771573604061,29.406418953738022
Task_41573,2645,151,62,136,198,17.401315789473685,49.4075371949593
Task_41574,1042,374,80,160,240,2.7786666666666666,25.452380462753016
Task_41575,635,915,191,154,345,0.6932314410480349,21.079418924457684
Task_41576,1279,198,176,177,353,6.42713567839196,29.06696988078524
Task_41577,505,597,124,95,219,0.8444816053511706,17.21683801995032
Task_41578,2623,786,27,45,72,3.3329097839898347,49.09381525273755
Task_41579,2367,905,40,32,72,2.6125827814569536,45.40926512830806
Task_41580,1268,145,94,32,126,8.684931506849315,26.35874689632143
Task_41581,1471,766,176,151,327,1.9178617992177314,33.728263713851106
Task_41582,2396,650,122,106,228,3.6804915514592933,47.504660953479515
Task_41583,2913,744,178,48,226,3.91006711409396,55.20826335541895
Task_41584,1643,861,69,95,164,1.906032482598608,35.93753228639034
Task_41585,1775,360,76,116,192,4.916897506925208,36.7331395725193
Task_41586,1134,816,156,63,219,1.3880048959608322,27.438997752918382
Task_41587,2437,233,41,46,87,10.414529914529915,44.732956656298846
Task_41588,2939,180,180,77,257,16.23756906077348,53.925718020549084
Task_41589,1982,606,76,14,90,3.2652388797364087,38.78561536384171
Task_41590,2806,580,48,42,90,4.82960413080895,51.82538216399369
Task_41591,2207,485,58,193,251,4.541152263374485,44.37134193990577
Task_41592,2346,263,173,109,282,8.886363636363637,45.687144732465576
Task_41593,2456,600,33,124,157,4.086522462562396,47.74098084072199
Task_41594,1833,272,167,100,267,6.714285714285714,37.53062076656592
Task_41595,1659,331,59,152,211,4.996987951807229,34.957473137770414
Task_41596,2729,259,191,58,249,10.496153846153845,50.989569994182716
Task_41597,2258,272,170,54,224,8.271062271062272,43.530650354287765
Task_41598,2029,114,109,90,199,17.643478260869564,39.0484336070365
Task_41599,1389,261,23,156,179,5.301526717557252,30.079487722021934
Task_41600,1636,988,34,152,186,1.6541961577350859,36.286617362117994
Task_41601,570,863,172,119,291,0.6597222222222222,19.607553024033944
Task_41602,2893,401,197,122,319,7.196517412935323,55.000915028917575
Task_41603,1885,869,34,150,184,2.1666666666666665,39.820023779469395
Task_41604,1656,212,120,74,194,7.774647887323944,33.795679543295314
Task_41605,1107,503,139,134,273,2.1964285714285716,26.872687818402934
Task_41606,2785,194,66,127,193,14.282051282051283,52.01921261644017
Task_41607,1512,391,132,43,175,3.857142857142857,31.586123780238015
Task_41608,2187,140,42,191,233,15.51063829787234,42.272271133912824
Task_41609,1124,258,62,149,211,4.33976833976834,26.22566565867288
Task_41610,2153,826,97,102,199,2.6033857315598548,44.09535882289299
Task_41611,1037,430,124,161,285,2.406032482598608,25.6281510557348
Task_41612,1513,448,91,70,161,3.3697104677060135,31.80926984330266
Task_41613,2980,319,115,130,245,9.3125,55.77367971676514
Task_41614,1334,462,56,176,232,2.8812095032397407,30.372118009347556
Task_41615,762,638,152,90,242,1.192488262910798,21.376857469485813
Task_41616,1737,598,48,22,70,2.8998330550918197,34.444683813204485
Task_41617,2378,724,197,73,270,3.28,47.18707575870925
Task_41618,1104,966,62,180,242,1.141675284384695,28.219887992538798
Task_41619,2486,852,58,29,87,2.914419695193435,47.48945035312199
Task_41620,2963,285,54,44,98,10.36013986013986,53.27889907965706
Task_41621,1228,499,103,101,204,2.456,28.41633244379345
Task_41622,2998,969,38,14,52,3.090721649484536,55.41311674839048
Task_41623,2408,87,78,110,188,27.363636363636363,44.79086326571039
Task_41624,1786,893,118,54,172,1.9977628635346756,37.73502300528613
Task_41625,1752,466,20,46,66,3.7516059957173447,34.32633872275053
Task_41626,2564,368,176,84,260,6.948509485094851,49.06914546841884
Task_41627,2188,982,156,81,237,2.2258392675483214,44.92992376611841
Task_41628,2969,357,173,83,256,8.293296089385475,55.41942576840764
Task_41629,2278,1006,129,28,157,2.2621648460774577,45.337512463513974
Task_41630,2604,213,141,113,254,12.16822429906542,49.453962589240724
Task_41631,1751,625,154,27,181,2.797124600638978,35.983515774013206
Task_41632,1876,110,14,113,127,16.9009009009009,35.75396985291151
Task_41633,1361,271,189,32,221,5.0036764705882355,29.090269110920982
Task_41634,2034,544,154,101,255,3.7321100917431194,41.54989003320849
Task_41635,1086,262,117,127,244,4.129277566539924,25.626992064205552
Task_41636,1538,926,149,96,245,1.6591154261057173,34.84718066953477
Task_41637,652,116,125,199,324,5.572649572649572,18.24774894562088
Task_41638,2402,449,188,13,201,5.337777777777778,45.89595111423416
Task_41639,2093,422,10,140,150,4.947990543735225,41.34181634062
Task_41640,1922,376,175,148,323,5.098143236074271,39.61045689294833
Task_41641,671,300,37,154,191,2.229235880398671,19.01142784683589
Task_41642,2767,972,166,157,323,2.8437821171634123,54.89614482099105
Task_41643,2755,849,21,183,204,3.2411764705882353,53.80348560895556
Task_41644,2775,750,105,144,249,3.6950732356857525,53.97431796036242
Task_41645,2390,353,100,158,258,6.751412429378531,46.65916901675329
Task_41646,2393,518,54,138,192,4.610789980732177,47.08022706423019
Task_41647,2184,847,127,59,186,2.5754716981132075,43.837554186302754
Task_41648,2619,395,101,101,202,6.613636363636363,50.08712935270503
Task_41649,1297,533,136,122,258,2.4288389513108615,29.89002157729539
Task_41650,2011,342,71,137,208,5.862973760932944,40.49817986004289
Task_41651,1296,508,120,147,267,2.5461689587426326,29.872636722871047
Task_41652,2761,221,110,92,202,12.436936936936936,51.59892992261106
Task_41653,1840,169,124,193,317,10.823529411764707,37.35276622518126
Task_41654,608,526,54,146,200,1.1537001897533208,18.763977705585404
Task_41655,2697,274,27,168,195,9.807272727272727,51.00964095146622
Task_41656,1410,610,70,19,89,2.3076923076923075,29.641916286435933
Task_41657,1418,609,46,21,67,2.324590163934426,29.362412768078524
Task_41658,950,393,116,70,186,2.4111675126903553,22.959728071364424
Task_41659,2003,698,188,105,293,2.86552217453505,41.7225370124711
Task_41660,1740,486,158,78,236,3.572895277207392,36.29324306122036
Task_41661,1829,875,135,85,220,2.0878995433789953,38.88589726426905
Task_41662,842,201,173,105,278,4.1683168316831685,21.689250027102975
Task_41663,1698,803,179,172,351,2.111940298507463,37.57880185185355
Task_41664,1519,700,89,103,192,2.166904422253923,33.64376176077416
Task_41665,2327,797,82,121,203,2.9160401002506267,46.87598391139906
Task_41666,830,371,175,71,246,2.2311827956989245,21.42234184837353
Task_41667,2260,465,195,51,246,4.849785407725322,44.29405168275033
Task_41668,626,640,56,192,248,0.9765990639625585,19.648136662806195
Task_41669,2215,530,71,117,188,4.171374764595104,44.1822348569249
Task_41670,2810,653,101,56,157,4.296636085626911,52.97183811026963
Task_41671,1615,583,83,69,152,2.7654109589041096,33.785367862290165
Task_41672,1565,97,147,189,336,15.96938775510204,32.29588652636621
Task_41673,2109,501,96,179,275,4.201195219123506,42.85730132785297
Task_41674,2788,279,22,58,80,9.957142857142857,50.57646399293497
Task_41675,2709,406,17,105,122,6.656019656019656,50.851228142311754
Task_41676,1831,295,122,171,293,6.1858108108108105,37.79921332348326
Task_41677,1813,520,141,185,326,3.4798464491362764,38.41751594097263
Task_41678,2250,187,152,167,319,11.96808510638298,44.239495563708886
Task_41679,2715,224,107,55,162,12.066666666666666,50.07355207642411
Task_41680,716,832,39,114,153,0.8595438175270108,20.628401475605656
Task_41681,1444,414,186,173,359,3.4795180722891565,32.36930460647283
Task_41682,1363,75,169,47,216,17.93421052631579,27.53644465874513
Task_41683,1172,658,156,51,207,1.7784522003034902,27.491491088416396
Task_41684,1902,118,30,142,172,15.983193277310924,37.11576587410542
Task_41685,1211,69,10,94,104,17.3,24.814879756039186
Task_41686,984,246,171,38,209,3.983805668016194,23.02317828979586
Task_41687,591,743,49,98,147,0.7943548387096774,18.616626452221453
Task_41688,1939,477,116,59,175,4.056485355648536,38.805302294431726
Task_41689,1548,375,116,199,315,4.117021276595745,33.72885624220988
Task_41690,1704,187,126,113,239,9.063829787234043,35.18442425520248
Task_41691,1813,631,18,61,79,2.8686708860759493,36.16107392050186
Task_41692,974,529,10,159,169,1.8377358490566038,24.233903253768517
Task_41693,1451,387,13,20,33,3.7396907216494846,28.817691555242888
Task_41694,1892,601,61,31,92,3.142857142857143,37.37741874662754
Task_41695,2645,1013,100,86,186,2.608481262327416,51.94747705001081
Task_41696,792,761,72,64,136,1.0393700787401574,21.36514318419543
Task_41697,1736,932,108,101,209,1.8606645230439443,37.83819207483696
Task_41698,2963,498,127,58,185,5.937875751503006,55.07636212848623
Task_41699,2067,932,40,112,152,2.215434083601286,42.50616136925942
Task_41700,1551,143,107,177,284,10.770833333333334,32.48324726659545
Task_41701,1093,377,39,66,105,2.8915343915343916,24.610626128452008
Task_41702,1345,890,169,59,228,1.509539842873176,30.99464377438838
Task_41703,1067,319,167,198,365,3.334375,26.162848349345108
Task_41704,2298,843,118,144,262,2.7227488151658767,46.76769156692276
Task_41705,1610,138,95,79,174,11.582733812949641,32.40651347222249
Task_41706,2881,426,141,168,309,6.747072599531616,54.91688457242185
Task_41707,2320,254,156,53,209,9.098039215686274,44.42516684532435
Task_41708,1591,321,66,195,261,4.940993788819876,34.10530830146015
Task_41709,1668,866,176,157,333,1.9238754325259515,37.196516309093376
Task_41710,1588,465,84,149,233,3.407725321888412,34.25576744480507
Task_41711,2346,355,48,91,139,6.589887640449438,45.0783138156761
Task_41712,873,109,101,27,128,7.9363636363636365,19.680397752816422
Task_41713,2885,184,190,25,215,15.594594594594595,52.752263449999795
Task_41714,1077,140,51,105,156,7.638297872340425,23.942859003056814
Task_41715,835,653,132,146,278,1.2767584097859328,22.98186990782275
Task_41716,1902,703,178,60,238,2.7017045454545454,39.30061854008505
Task_41717,1494,499,113,160,273,2.988,33.02492938346317
Task_41718,533,328,99,125,224,1.6200607902735562,16.992554131328543
Task_41719,752,480,15,126,141,1.5634095634095635,20.27043942576337
Task_41720,840,1012,128,72,200,0.8292201382033564,23.388937768161146
Task_41721,842,721,154,107,261,1.1662049861495845,23.180032232619066
Task_41722,1012,474,47,14,61,2.130526315789474,22.351917936181078
Task_41723,1445,1007,98,183,281,1.433531746031746,33.84979819125209
Task_41724,2884,485,19,173,192,5.934156378600823,54.61918190043166
Task_41725,2890,474,189,97,286,6.08421052631579,55.043571037757005
Task_41726,1533,112,23,69,92,13.56637168141593,29.899875139215027
Task_41727,845,741,164,46,210,1.1388140161725067,22.38050365969973
Task_41728,2483,502,102,82,184,4.936381709741551,47.69795819191764
Task_41729,2905,1010,166,52,218,2.873392680514342,56.16222469701438
Task_41730,654,777,44,167,211,0.8406169665809768,20.13992046532168
Task_41731,1494,193,97,157,254,7.701030927835052,31.948691912733242
Task_41732,547,179,136,122,258,3.0388888888888888,16.514949903391866
Task_41733,2738,467,33,110,143,5.85042735042735,51.70940418182604
Task_41734,561,252,40,143,183,2.217391304347826,16.876996112371447
Task_41735,1476,669,122,169,291,2.2029850746268655,33.368903165468915
Task_41736,1187,881,161,166,327,1.3458049886621315,29.567460633066847
Task_41737,1844,932,139,75,214,1.9764201500535905,39.169735670645125
Task_41738,1826,897,158,192,350,2.0334075723830733,39.92437481519051
Task_41739,2521,90,53,187,240,27.703296703296704,46.98669069052511
Task_41740,1883,412,53,19,72,4.559322033898305,35.937587602497985
Task_41741,1467,505,67,86,153,2.899209486166008,31.547632020276442
Task_41742,861,323,127,35,162,2.6574074074074074,20.85414980124418
Task_41743,1297,762,60,11,71,1.6998689384010486,27.761547109054018
Task_41744,2142,598,137,169,306,3.5759599332220366,43.76114286169187
Task_41745,1129,520,169,49,218,2.166986564299424,26.277831975043355
Task_41746,759,196,158,110,268,3.8527918781725887,20.27902812089184
Task_41747,1219,150,26,172,198,8.072847682119205,26.896238466208032
Task_41748,2022,568,197,143,340,3.5536028119507908,41.880826091482184
Task_41749,2877,70,146,116,262,40.521126760563384,52.25998816320742
Task_41750,2515,423,146,164,310,5.931603773584905,49.11336627967381
Task_41751,768,442,174,197,371,1.7336343115124153,21.835510997466557
Task_41752,600,308,65,179,244,1.941747572815534,18.295149123638897
Task_41753,2383,865,173,70,243,2.751732101616628,47.544578176152235
Task_41754,2327,391,168,15,183,5.936224489795919,44.23439177262938
Task_41755,633,970,81,58,139,0.6519052523171988,19.556417294829718
Task_41756,734,401,34,134,168,1.8258706467661692,20.018071750117496
Task_41757,2365,372,106,148,254,6.340482573726542,46.29481560231809
Task_41758,1971,764,13,77,90,2.5764705882352943,39.71461956576875
Task_41759,686,138,200,37,237,4.9352517985611515,17.756021275510964
Task_41760,2723,715,145,109,254,3.803072625698324,53.0113421134673
Task_41761,2473,173,65,153,218,14.21264367816092,46.84575848955225
Task_41762,2966,925,105,100,205,3.203023758099352,57.28724495377554
Task_41763,1615,720,55,87,142,2.2399445214979194,34.62988763473299
Task_41764,718,733,11,88,99,0.9782016348773842,19.862482361800634
Task_41765,1017,861,36,158,194,1.179814385150812,26.11423246858997
Task_41766,1496,350,167,45,212,4.262108262108262,31.397136563179497
Task_41767,2194,217,117,58,175,10.064220183486238,41.968588620085306
Task_41768,1965,100,16,190,206,19.455445544554454,38.04854298503349
Task_41769,2754,920,154,33,187,2.990228013029316,53.02186235340465
Task_41770,2311,782,175,187,362,2.9514687100894,47.29644537778095
Task_41771,2034,250,176,26,202,8.103585657370518,39.52092732779775
Task_41772,2736,831,40,105,145,3.2884615384615383,52.836686413063575
Task_41773,591,731,151,149,300,0.8073770491803278,19.486025536005915
Task_41774,1090,964,161,24,185,1.1295336787564767,26.65413433237023
Task_41775,805,306,198,151,349,2.6221498371335503,21.83702474651987
Task_41776,1053,978,185,23,208,1.0755873340143003,26.30104751147042
Task_41777,2906,569,171,152,323,5.098245614035088,55.81884547290637
Task_41778,989,320,160,115,275,3.0809968847352023,24.405311292716465
Task_41779,1241,197,140,59,199,6.267676767676767,27.089586685194504
Task_41780,2541,1010,81,178,259,2.513353115727003,51.27923969130512
Task_41781,1862,897,39,54,93,2.0734966592427617,38.23969757635523
Task_41782,2821,746,98,174,272,3.7764390896921016,54.851974462598776
Task_41783,1941,740,173,56,229,2.619433198380567,40.085919705406745
Task_41784,2014,529,171,18,189,3.8,39.826579118247075
Task_41785,1915,164,80,12,92,11.606060606060606,36.236790769563214
Task_41786,2131,407,108,49,157,5.223039215686274,41.20618737718835
Task_41787,2285,153,94,146,240,14.837662337662337,43.9414572037464
Task_41788,2136,675,66,175,241,3.1597633136094676,43.747808025772976
Task_41789,1368,564,73,126,199,2.421238938053097,30.978663606344686
Task_41790,2608,701,63,51,114,3.715099715099715,49.59706196583773
Task_41791,2954,406,16,89,105,7.257985257985258,54.39774737833971
Task_41792,1768,791,119,168,287,2.2323232323232323,38.35607947415663
Task_41793,1201,231,138,47,185,5.176724137931035,26.124779615975353
Task_41794,1566,184,178,47,225,8.464864864864865,32.06909329663333
Task_41795,1885,242,180,58,238,7.757201646090535,37.54265366623651
Task_41796,2835,112,122,12,134,25.088495575221238,50.41419106962243
Task_41797,1517,565,49,79,128,2.6802120141342756,32.777448003064514
Task_41798,1962,917,133,80,213,2.1372549019607843,41.074706696280835
Task_41799,1665,765,82,87,169,2.1736292428198434,35.656093135678766
Task_41800,805,960,29,31,60,0.8376690946930281,20.937324040349427
Task_41801,2338,983,93,22,115,2.3760162601626016,46.024767950963245
Task_41802,1697,685,60,43,103,2.4737609329446064,34.52397432026547
Task_41803,656,223,65,148,213,2.9285714285714284,18.721353503129134
Task_41804,2660,856,167,130,297,3.103850641773629,52.68122024949091
Task_41805,1579,434,107,194,301,3.6298850574712644,34.33929407512526
Task_41806,2137,633,198,24,222,3.3706624605678233,42.471510385702786
Task_41807,1405,613,47,155,202,2.288273615635179,31.697803076651713
Task_41808,2410,917,157,36,193,2.625272331154684,47.628862700659504
Task_41809,1937,787,139,56,195,2.4581218274111674,40.016313496528944
Task_41810,1592,134,24,144,168,11.792592592592593,32.188057290878064
Task_41811,1087,997,164,53,217,1.0891783567134268,27.249419467901934
Task_41812,538,889,120,174,294,0.604494382022472,19.33306767313107
Task_41813,2053,975,133,80,213,2.103483606557377,42.697125828639344
Task_41814,750,614,180,35,215,1.2195121951219512,20.4775546567892
Task_41815,2563,225,200,85,285,11.34070796460177,48.67741834398788
Task_41816,2457,316,153,107,260,7.750788643533123,47.5267022947531
Task_41817,1134,478,113,87,200,2.3674321503131526,26.569282963748748
Task_41818,741,226,142,197,339,3.26431718061674,20.588022667304244
Task_41819,778,974,11,75,86,0.7979487179487179,21.49119668882605
Task_41820,2317,496,16,176,192,4.661971830985915,45.666043403206025
Task_41821,2430,821,151,105,256,2.9562043795620436,48.706029878662626
Task_41822,836,893,123,33,156,0.9351230425055929,22.264694716960747
Task_41823,621,181,77,11,88,3.412087912087912,15.819972901452035
Task_41824,2284,142,144,108,252,15.972027972027972,43.77954641660557
Task_41825,2231,705,173,196,369,3.1600566572237963,45.83207364774444
Task_41826,1512,355,81,142,223,4.247191011235955,32.69971283654997
Task_41827,919,506,147,101,248,1.8126232741617356,23.744704453405983
Task_41828,1107,319,177,107,284,3.459375,26.296922006141823
Task_41829,2305,208,47,190,237,11.028708133971293,44.8001870965075
Task_41830,2322,171,186,121,307,13.5,44.732126607580874
Task_41831,719,936,39,99,138,0.767342582710779,20.964710539997665
Task_41832,2113,681,76,104,180,3.098240469208211,42.85718084927033
Task_41833,2430,105,188,145,333,22.92452830188679,45.91753853244689
Task_41834,2817,837,113,96,209,3.3615751789976134,54.68632019507526
Task_41835,2540,958,84,138,222,2.64859228362878,50.819564954394764
Task_41836,1926,90,21,143,164,21.164835164835164,36.963588952078155
Task_41837,899,121,139,118,257,7.368852459016393,21.818921389542663
Task_41838,982,630,140,70,210,1.5562599049128367,24.451521857677225
Task_41839,1205,589,144,187,331,2.042372881355932,29.033254805996823
Task_41840,2556,261,100,175,275,9.755725190839694,49.06368816873542
Task_41841,2235,498,137,21,158,4.478957915831663,42.98389577958854
Task_41842,2436,126,103,165,268,19.181102362204726,46.16328696287758
Task_41843,3000,801,165,21,186,3.7406483790523692,56.325572312944566
Task_41844,674,465,50,16,66,1.446351931330472,16.975570768654723
Task_41845,2434,329,49,144,193,7.375757575757576,47.120803517487566
Task_41846,2305,571,24,151,175,4.02972027972028,45.62096403373807
Task_41847,1194,393,22,157,179,3.030456852791878,27.302707119101242
Task_41848,1677,909,121,87,208,1.8428571428571427,36.55259586614794
Task_41849,964,412,118,53,171,2.334140435835351,23.12939657602544
Task_41850,568,911,138,92,230,0.6228070175438597,19.405778166929327
Task_41851,2738,810,105,117,222,3.376078914919852,53.415673755706564
Task_41852,2413,765,43,16,59,3.150130548302872,45.486743187807264
Task_41853,2406,480,195,162,357,5.002079002079002,47.78315909946301
Task_41854,2801,580,146,188,334,4.820998278829604,54.29379936580057
Task_41855,2130,350,36,48,84,6.068376068376068,40.35976260348125
Task_41856,2617,534,28,87,115,4.891588785046729,49.73221903754567
Task_41857,1884,335,49,28,77,5.607142857142857,35.96417946580831
Task_41858,2041,544,179,78,257,3.744954128440367,41.33825207256842
Task_41859,2275,462,67,166,233,4.913606911447085,45.22037573269486
Task_41860,1467,367,18,64,82,3.9864130434782608,30.22045555081723
Task_41861,2225,562,94,133,227,3.952042628774423,44.6360754639691
Task_41862,1275,884,17,142,159,1.4406779661016949,29.734685123777748
Task_41863,852,885,52,17,69,0.9616252821670429,21.27028162130767
Task_41864,1794,411,57,28,85,4.354368932038835,35.13300476745433
Task_41865,1982,775,179,93,272,2.554123711340206,41.45355469787871
Task_41866,2238,177,184,36,220,12.573033707865168,42.34917729426419
Task_41867,1974,504,169,75,244,3.908910891089109,40.02039634873769
Task_41868,846,433,175,153,328,1.9493087557603688,22.796855439391653
Task_41869,2241,642,126,128,254,3.4852255054432346,45.17383565786804
Task_41870,2519,708,161,62,223,3.552891396332863,49.056460159268646
Task_41871,1676,433,167,63,230,3.8617511520737327,34.898106070641354
Task_41872,2669,829,78,62,140,3.2156626506024097,51.29284559340104
Task_41873,1376,785,93,86,179,1.7506361323155217,31.151339857820094
Task_41874,1696,942,123,145,268,1.7985153764581123,37.56583049635725
Task_41875,2044,673,182,30,212,3.0326409495548963,41.15853888712479
Task_41876,971,678,144,76,220,1.4300441826215022,24.52046567465966
Task_41877,648,652,60,150,210,0.9923430321592649,19.80226087015593
Task_41878,950,287,51,116,167,3.298611111111111,23.202045700664467
Task_41879,2457,809,192,167,359,3.033333333333333,49.65131874388302
Task_41880,2570,1010,103,21,124,2.5420375865479725,49.71838596014433
Task_41881,2332,724,96,17,113,3.216551724137931,44.91373855789893
Task_41882,1916,113,141,180,321,16.80701754385965,38.04163938816572
Task_41883,2810,490,86,63,149,5.723014256619145,52.43290450156613
Task_41884,2735,661,79,117,196,4.1314199395770395,52.91148349073225
Task_41885,758,371,121,141,262,2.0376344086021505,20.893806772900916
Task_41886,1702,515,79,31,110,3.298449612403101,34.39215271805811
Task_41887,2171,430,84,15,99,5.037122969837587,41.20200811762179
Task_41888,2589,101,46,79,125,25.38235294117647,46.88616476828503
Task_41889,2931,242,152,56,208,12.061728395061728,54.01518525466599
Task_41890,2345,144,73,179,252,16.17241379310345,45.003646578487235
Task_41891,2727,432,149,107,256,6.297921478060046,52.171247582049
Task_41892,2353,910,194,194,388,2.5828759604829856,48.48958564662598
Task_41893,1666,789,156,90,246,2.108860759493671,36.26994130639515
Task_41894,1635,117,116,60,176,13.85593220338983,32.29744450671902
Task_41895,2501,338,142,11,153,7.377581120943953,46.590827531435245
Task_41896,550,724,46,178,224,0.7586206896551724,18.478394703319733
Task_41897,2849,298,75,117,192,9.528428093645484,53.505800375566814
Task_41898,1061,765,55,108,163,1.385117493472585,26.31691821731179
Task_41899,1660,526,30,150,180,3.1499051233396584,35.16766109248464
Task_41900,558,929,23,145,168,0.6,18.99462554690142
Task_41901,2290,105,19,42,61,21.60377358490566,41.05799250692588
Task_41902,2817,68,39,76,115,40.82608695652174,50.04656986312417
Task_41903,925,318,34,44,78,2.8996865203761755,20.80240858260277
Task_41904,2031,475,172,182,354,4.266806722689076,41.84661562723047
Task_41905,1275,501,176,160,336,2.539840637450199,29.848134388692287
Task_41906,1645,115,79,149,228,14.181034482758621,33.47789778183898
Task_41907,1898,921,160,133,293,2.058568329718004,40.796517865419766
Task_41908,1104,845,161,185,346,1.3049645390070923,28.22782712794203
Task_41909,1283,140,173,65,238,9.099290780141844,27.456109179168397
Task_41910,916,896,186,139,325,1.0211817168338908,25.17593076622342
Task_41911,2802,612,198,174,372,4.5709624796084825,54.562758666090154
Task_41912,1957,448,79,74,153,4.358574610244989,38.98414401611375
Task_41913,1961,915,112,10,122,2.140829694323144,39.71656857308165
Task_41914,1249,761,19,184,203,1.6391076115485563,29.652268875526634
Task_41915,1947,412,14,75,89,4.714285714285714,38.21260590009208
Task_41916,1065,136,160,158,318,7.773722627737226,24.893228504442558
Task_41917,2838,704,36,86,122,4.025531914893617,53.78875198550808
Task_41918,1059,547,183,145,328,1.9324817518248176,26.51476309600908
Task_41919,2465,128,120,42,162,19.108527131782946,44.977940235114694
Task_41920,1771,152,154,54,208,11.57516339869281,35.123387015961384
Task_41921,2886,470,140,53,193,6.127388535031847,54.04244811103025
Task_41922,2346,95,120,102,222,24.4375,43.90868917480301
Task_41923,554,152,79,19,98,3.6209150326797386,14.536686147161525
Task_41924,2983,430,22,189,211,6.921113689095128,56.102995367441615
Task_41925,855,1018,46,193,239,0.8390578999018645,24.269680732753287
Task_41926,1112,307,155,69,224,3.6103896103896105,25.540572811378606
Task_41927,829,945,195,171,366,0.8763213530655392,24.240505498546597
Task_41928,2152,808,118,142,260,2.6600741656365883,44.33312749516677
Task_41929,563,737,151,58,209,0.7628726287262872,18.09875190199176
Task_41930,688,723,87,130,217,0.9502762430939227,20.551708665106116
Task_41931,1001,397,190,41,231,2.5150753768844223,23.844386310440644
Task_41932,1307,273,142,116,258,4.7700729927007295,29.2033795186919
Task_41933,1504,835,111,37,148,1.799043062200957,32.55745354632211
Task_41934,2418,71,111,102,213,33.583333333333336,44.84991477060991
Task_41935,1982,664,113,174,287,2.9804511278195487,41.3571491488616
Task_41936,1317,975,46,27,73,1.3493852459016393,29.033781688684865
Task_41937,1479,869,158,147,305,1.7,34.05692040810093
Task_41938,1932,536,184,185,369,3.5977653631284916,40.54634006570107
Task_41939,640,148,65,15,80,4.295302013422819,15.68773136708795
Task_41940,663,245,110,132,242,2.6951219512195124,18.885652520301907
Task_41941,1648,657,110,117,227,2.5045592705167175,35.69096765763975
Task_41942,2966,225,116,67,183,13.123893805309734,54.1947360094101
Task_41943,1297,713,69,49,118,1.8165266106442577,28.756334590720183
Task_41944,1375,969,169,186,355,1.4175257731958764,32.94679800612355
Task_41945,639,367,56,56,112,1.736413043478261,17.35150433822572
Task_41946,1979,317,62,185,247,6.223270440251572,40.1551583847887
Task_41947,701,288,101,31,132,2.42560553633218,18.104539174444827
Task_41948,932,968,125,10,135,0.9618163054695562,23.848016215524652
Task_41949,664,165,94,175,269,4.0,18.628081084931793
Task_41950,503,568,109,149,258,0.8840070298769771,17.390669351092015
Task_41951,2548,529,84,50,134,4.807547169811321,48.142134467768365
Task_41952,2760,946,129,14,143,2.914466737064414,52.60208995824353
Task_41953,2269,956,67,167,234,2.3709508881922674,46.69046917593988
Task_41954,991,791,199,96,295,1.2512626262626263,25.87708108325786
Task_41955,1324,328,118,17,135,4.024316109422492,27.82373661927481
Task_41956,1650,251,49,29,78,6.5476190476190474,32.0901002304463
Task_41957,636,592,126,101,227,1.0725126475548061,19.292556478680964
Task_41958,594,341,131,188,319,1.736842105263158,18.517158781679438
Task_41959,1504,962,150,92,242,1.5617860851505712,34.247107824749975
Task_41960,1718,851,20,95,115,2.016431924882629,36.54484357039199
Task_41961,2623,542,27,45,72,4.830570902394107,48.31982948177801
Task_41962,1113,571,37,187,224,1.9458041958041958,27.057786021147923
Task_41963,1881,679,179,118,297,2.7661764705882352,39.76749465810194
Task_41964,722,681,138,86,224,1.0586510263929618,20.655144027656082
Task_41965,2409,566,163,141,304,4.248677248677248,47.8374382674015
Task_41966,2113,376,142,80,222,5.604774535809018,41.79214486060216
Task_41967,1075,341,193,81,274,3.1432748538011697,25.455622215160744
Task_41968,874,214,119,83,202,4.065116279069767,21.57032004357059
Task_41969,2440,744,98,166,264,3.2751677852348995,48.76221592268242
Task_41970,2868,938,142,88,230,3.0543130990415337,55.61814840537775
Task_41971,1519,233,185,186,371,6.4914529914529915,33.028078969266126
Task_41972,2453,237,110,195,305,10.306722689075631,47.51186697640865
Task_41973,2561,592,17,199,216,4.318718381112985,49.95362004311332
Task_41974,2681,685,123,34,157,3.9081632653061225,50.75719145101806
Task_41975,2913,718,34,190,224,4.051460361613352,56.041974276536024
Task_41976,2854,130,74,126,200,21.786259541984734,52.52120858059186
Task_41977,1516,113,132,177,309,13.298245614035087,31.69329204256263
Task_41978,2749,365,50,122,172,7.5109289617486334,52.05636767258227
Task_41979,2482,383,91,105,196,6.463541666666667,47.90746878595015
Task_41980,2389,929,57,103,160,2.5688172043010753,47.7921758371921
Task_41981,1211,147,82,91,173,8.182432432432432,26.353145402836827
Task_41982,1552,922,107,142,249,1.6814734561213434,35.11846722333937
Task_41983,539,851,23,48,71,0.6326291079812206,16.750761727851174
Task_41984,1972,555,54,94,148,3.5467625899280577,39.941079743103884
Task_41985,2905,424,35,90,125,6.8352941176470585,54.055126868563356
Task_41986,2024,301,63,28,91,6.701986754966887,38.42807113173085
Task_41987,1163,195,99,103,202,5.933673469387755,26.33202678871344
Task_41988,1489,139,20,14,34,10.635714285714286,28.455208289568844
Task_41989,738,645,26,66,92,1.1424148606811146,19.810188048879713
Task_41990,2427,77,143,165,308,31.115384615384617,45.54014079794033
Task_41991,1488,757,120,107,227,1.963060686015831,33.454334103263385
Task_41992,1504,102,19,95,114,14.601941747572816,29.779650618401053
Task_41993,1761,648,108,105,213,2.7134052388289676,37.371804123633694
Task_41994,1699,220,102,112,214,7.6877828054298645,35.00847570410313
Task_41995,1942,837,48,131,179,2.3174224343675416,40.65690411330427
Task_41996,2104,626,134,72,206,3.3556618819776713,42.23903710104326
Task_41997,2866,522,16,155,171,5.479923518164436,54.12174648013379
Task_41998,1215,207,126,147,273,5.841346153846154,27.637207989752074
Task_41999,925,625,189,93,282,1.4776357827476039,24.23347153944791
Task_42000,1504,982,61,40,101,1.5300101729399798,32.438108688328036
Task_42001,1295,257,80,169,249,5.01937984496124,29.12431378796042
Task_42002,1197,419,37,70,107,2.85,26.47483124009572
Task_42003,1240,251,101,50,151,4.920634920634921,26.564059703160904
Task_42004,762,832,167,193,360,0.9147659063625451,22.835437715653
Task_42005,1620,902,189,45,234,1.7940199335548173,35.19977401064222
Task_42006,1243,443,140,199,339,2.7995495495495497,29.228752775674426
Task_42007,1791,478,196,18,214,3.7390396659707723,36.27599098543188
Task_42008,2189,525,160,61,221,4.161596958174905,43.20267638170764
Task_42009,864,765,61,183,244,1.1279373368146215,23.73132199402454
Task_42010,710,945,179,61,240,0.7505285412262156,21.119146647487653
Task_42011,1856,887,168,127,295,2.09009009009009,40.02543913834698
Task_42012,2798,600,26,170,196,4.655574043261232,53.702922344821246
Task_42013,2175,921,143,63,206,2.359002169197397,44.22993148223395
Task_42014,894,151,106,52,158,5.881578947368421,20.715939117691892
Task_42015,1447,164,75,119,194,8.76969696969697,30.605232839994244
Task_42016,2913,665,186,45,231,4.373873873873874,54.9273210127059
Task_42017,1197,986,18,42,60,1.2127659574468086,27.171050145106822
Task_42018,2266,68,151,47,198,32.84057971014493,41.493777114683766
Task_42019,2551,409,169,48,217,6.221951219512195,48.358706385756754
Task_42020,1265,263,123,143,266,4.791666666666667,28.58168455794677
Task_42021,582,214,18,84,102,2.7069767441860466,16.18044059790129
Task_42022,1200,754,120,110,230,1.5894039735099337,28.857710721348877
Task_42023,2308,257,197,184,381,8.945736434108527,45.62111397519627
Task_42024,1681,170,31,179,210,9.830409356725147,34.27654875526737
Task_42025,1747,378,51,195,246,4.6094986807387865,36.7660971144224
Task_42026,1957,300,162,33,195,6.501661129568106,38.49369642232278
Task_42027,2870,425,79,111,190,6.737089201877934,54.23894809173387
Task_42028,2697,791,140,18,158,3.4053030303030303,51.06773785242074
Task_42029,1863,249,179,161,340,7.452,38.34258965645194
Task_42030,860,797,132,12,144,1.0776942355889725,22.036685098365584
Task_42031,1508,144,21,172,193,10.4,31.37428680978734
Task_42032,2740,870,53,80,133,3.145809414466131,52.97608415546918
Task_42033,2658,72,170,54,224,36.41095890410959,48.15948555162412
Task_42034,890,506,180,26,206,1.755424063116371,22.268539764621504
Task_42035,744,332,65,178,243,2.234234234234234,20.642620698465972
Task_42036,2154,728,83,96,179,2.954732510288066,43.587407233895995
Task_42037,1497,482,148,103,251,3.099378881987578,32.835770038742375
Task_42038,1218,404,112,81,193,3.0074074074074075,27.552851285317093
Task_42039,2040,321,61,137,198,6.3354037267080745,40.842114344019784
Task_42040,2242,209,148,38,186,10.676190476190476,42.52170192787102
Task_42041,1379,398,121,77,198,3.456140350877193,30.06439779746992
Task_42042,2308,693,129,18,147,3.325648414985591,44.58626295172724
Task_42043,2827,536,79,103,182,5.264432029795159,53.702636807466355
Task_42044,2613,687,163,197,360,3.79796511627907,51.787153576469414
Task_42045,2773,361,127,24,151,7.6602209944751385,51.06501386673421
Task_42046,1170,744,56,164,220,1.570469798657718,28.547735437100286
Task_42047,2919,337,28,34,62,8.636094674556213,52.327356923519545
Task_42048,1966,1013,83,49,132,1.9388560157790926,40.46991610162968
Task_42049,1411,356,118,28,146,3.9523809523809526,29.570188178716844
Task_42050,2401,995,84,50,134,2.4106425702811247,47.28119712300798
Task_42051,2589,762,185,177,362,3.3931847968545217,51.62317379921666
Task_42052,1153,810,50,43,93,1.4217016029593095,26.42302520454137
Task_42053,2532,738,122,157,279,3.4262516914749663,50.2412602474235
Task_42054,2021,708,19,171,190,2.85049365303244,41.640691574613065
Task_42055,840,994,174,168,342,0.8442211055276382,24.445210617571707
Task_42056,1106,467,137,76,213,2.3632478632478633,26.02660732324621
Task_42057,644,975,80,160,240,0.6598360655737705,21.080975017580403
Task_42058,2331,853,148,192,340,2.7295081967213113,47.74372529312018
Task_42059,1172,435,90,72,162,2.688073394495413,26.4777170189344
Task_42060,1981,649,101,15,116,3.0476923076923077,39.099811473868066
Task_42061,2786,133,108,40,148,20.791044776119403,49.94960628526286
Task_42062,2263,614,135,118,253,3.6796747967479675,45.414476942366036
Task_42063,849,169,148,97,245,4.9941176470588236,21.265097336671367
Task_42064,1130,740,73,25,98,1.524966261808367,25.959614106642594
Task_42065,1887,873,145,45,190,2.1590389016018308,39.13061270121043
Task_42066,1420,873,164,44,208,1.6247139588100687,31.869535245852656
Task_42067,993,125,145,110,255,7.880952380952381,23.296799616158207
Task_42068,1236,766,28,188,216,1.6114732724902217,29.586823285041035
Task_42069,708,608,130,95,225,1.1625615763546797,20.49458899861313
Task_42070,2327,350,88,185,273,6.62962962962963,45.779310722225546
Task_42071,1003,902,66,12,78,1.1107419712070874,23.857840907304887
Task_42072,1202,589,76,122,198,2.0372881355932204,28.42922127075259
Task_42073,2954,530,100,124,224,5.5630885122410545,55.96575313339533
Task_42074,1554,776,23,100,123,2.0,33.92144500924709
Task_42075,2103,472,67,131,198,4.446088794926005,42.32104031624689
Task_42076,1156,513,28,176,204,2.2490272373540856,27.47142945967907
Task_42077,2010,634,20,96,116,3.1653543307086616,40.50183744659003
Task_42078,1751,739,18,156,174,2.366216216216216,37.3098983968086
Task_42079,1050,499,138,50,188,2.1,24.774261256854256
Task_42080,1669,595,120,125,245,2.8003355704697985,35.92160652434239
Task_42081,1446,1001,195,183,378,1.4431137724550898,34.270330675541146
Task_42082,2758,656,28,56,84,4.197869101978691,51.54489377292487
Task_42083,1290,575,52,39,91,2.2395833333333335,27.75120950805032
Task_42084,1022,523,73,45,118,1.950381679389313,23.67604780114283
Task_42085,2700,674,187,105,292,4.0,52.68270998503086
Task_42086,1300,696,24,10,34,1.8651362984218078,27.367514543647786
Task_42087,2598,773,148,140,288,3.356589147286822,51.4125835208921
Task_42088,624,490,79,142,221,1.2708757637474541,18.993804711244934
Task_42089,1615,435,147,181,328,3.7041284403669725,35.01489450182591
Task_42090,2476,204,130,52,182,12.078048780487805,46.39030368617932
Task_42091,1463,639,79,12,91,2.2859375,30.72949461291489
Task_42092,2445,412,116,89,205,5.920096852300242,47.198640238973695
Task_42093,1708,881,190,154,344,1.9365079365079365,37.92213984732542
Task_42094,2518,1015,46,195,241,2.4783464566929134,50.80474144849186
Task_42095,802,360,72,154,226,2.221606648199446,21.53882514531273
Task_42096,1025,496,113,167,280,2.062374245472837,25.63244719946614
Task_42097,876,1021,142,195,337,0.8571428571428571,25.124567324369707
Task_42098,1037,340,168,136,304,3.0410557184750733,25.390350690255897
Task_42099,1251,195,199,29,228,6.38265306122449,27.117668642178973
Task_42100,1453,713,133,192,325,2.0350140056022408,33.328979036490495
Task_42101,1901,567,35,37,72,3.346830985915493,37.03372750929115
Task_42102,2241,151,40,22,62,14.743421052631579,40.791386500560826
Task_42103,2554,864,122,195,317,2.952601156069364,51.21217594591027
Task_42104,877,905,137,145,282,0.9679911699779249,24.45538685255845
Task_42105,951,219,56,174,230,4.322727272727272,23.514703901248666
Task_42106,819,76,139,78,217,10.636363636363637,19.528774439946034
Task_42107,2394,459,36,15,51,5.2043478260869565,44.230218699168745
Task_42108,2405,513,80,189,269,4.678988326848249,47.644120620296256
Task_42109,1974,576,15,112,127,3.4211438474870017,39.93044500450568
Task_42110,2022,277,43,131,174,7.273381294964029,40.1098567552547
Task_42111,1147,469,152,17,169,2.4404255319148938,25.658528242645875
Task_42112,1498,913,119,55,174,1.6389496717724288,33.28683823719747
Task_42113,1133,263,33,95,128,4.291666666666667,25.7643463909116
Task_42114,1587,592,135,93,228,2.6762225969645868,34.42472199428415
Task_42115,2361,513,79,82,161,4.593385214007782,45.77126188080401
Task_42116,1208,483,26,70,96,2.4958677685950414,26.700030519942555
Task_42117,1719,531,138,184,322,3.231203007518797,36.94466572848278
Task_42118,2534,569,142,182,324,4.445614035087719,49.976653594992136
Task_42119,2501,92,60,19,79,26.892473118279568,44.02495958252257
Task_42120,1334,448,13,74,87,2.9710467706013364,28.60641926394912
Task_42121,1176,783,144,187,331,1.5,29.135687301350515
Task_42122,2045,390,200,173,373,5.2301790281329925,41.86455590547191
Task_42123,2239,772,58,48,106,2.8965071151358344,43.48844053672055
Task_42124,2873,863,104,83,187,3.3252314814814814,55.17178305934407
Task_42125,668,1020,70,140,210,0.6542605288932419,21.451785432981364
Task_42126,2876,241,138,134,272,11.884297520661157,53.97113016305362
Task_42127,2832,909,143,180,323,3.112087912087912,55.76296402406774
Task_42128,2849,457,78,44,122,6.220524017467249,52.468521296177215
Task_42129,1332,837,85,144,229,1.5894988066825775,31.29803482367998
Task_42130,2563,753,128,65,193,3.3992042440318304,49.81509804577334
Task_42131,2356,487,19,172,191,4.827868852459017,46.26123403627307
Task_42132,863,422,54,149,203,2.0401891252955084,22.621119427851934
Task_42133,2636,182,20,143,163,14.404371584699453,49.082927366893294
Task_42134,2350,506,77,139,216,4.6351084812623276,46.43727915440025
Task_42135,2860,589,128,102,230,4.8474576271186445,54.662163035323566
Task_42136,2477,728,173,107,280,3.3978052126200273,49.269713455052624
Task_42137,1999,281,83,175,258,7.088652482269503,40.30862470333475
Task_42138,1605,190,91,178,269,8.403141361256544,33.816936344784814
Task_42139,685,608,58,175,233,1.1247947454844007,20.347771479643743
Task_42140,768,561,134,36,170,1.3665480427046264,20.203695308858176
Task_42141,1103,720,133,166,299,1.5298196948682385,27.60847311714285
Task_42142,2166,253,200,18,218,8.527559055118111,41.47519321329991
Task_42143,1024,818,85,143,228,1.2503052503052503,26.26069226121255
Task_42144,1148,82,91,182,273,13.831325301204819,25.453325916081614
Task_42145,502,523,78,126,204,0.9580152671755725,17.041142563477084
Task_42146,843,961,29,102,131,0.8762993762993763,23.084248812116595
Task_42147,1478,578,123,46,169,2.552677029360967,31.479699380384847
Task_42148,806,564,121,29,150,1.4265486725663716,20.636676934123802
Task_42149,516,369,164,193,357,1.3945945945945946,17.495014976115545
Task_42150,2085,274,70,70,140,7.581818181818182,40.360157307807334
Task_42151,671,342,63,79,142,1.956268221574344,18.428897050053262
Task_42152,2871,713,62,174,236,4.0210084033613445,55.491593945973385
Task_42153,2505,288,28,89,117,8.667820069204152,47.16079063248279
Task_42154,1462,203,68,173,241,7.166666666666667,31.53824898052154
Task_42155,1668,387,102,98,200,4.298969072164948,35.003352783687156
Task_42156,1622,297,151,13,164,5.442953020134228,32.80212041619884
Task_42157,956,757,84,99,183,1.2612137203166227,24.527728812029334
Task_42158,2021,619,187,77,264,3.259677419354839,41.2285280264275
Task_42159,1282,847,188,143,331,1.5117924528301887,30.949283703260196
Task_42160,1385,858,25,139,164,1.6123399301513388,31.823039643163167
Task_42161,559,534,58,110,168,1.0448598130841122,17.531268537878017
Task_42162,1659,882,152,39,191,1.8788221970554926,35.57043776039279
Task_42163,2516,553,92,135,227,4.541516245487364,49.211839974321066
Task_42164,2914,454,125,116,241,6.404395604395605,55.14915623628144
Task_42165,1163,943,66,75,141,1.2319915254237288,27.94307324892104
Task_42166,1057,352,196,117,313,2.9943342776203967,25.757958474420764
Task_42167,1183,233,132,31,163,5.055555555555555,25.734201939449672
Task_42168,2389,747,42,160,202,3.193850267379679,47.675215081860365
Task_42169,2266,857,84,113,197,2.641025641025641,46.01334157117652
Task_42170,2835,505,102,81,183,5.602766798418973,53.23457951968979
Task_42171,1518,637,26,125,151,2.3793103448275863,32.94650807060278
Task_42172,1874,382,110,163,273,4.892950391644908,38.66736223763927
Task_42173,2473,586,169,25,194,4.212947189097104,47.52099764748831
Task_42174,1437,268,95,133,228,5.342007434944238,31.200999527718466
Task_42175,1764,585,132,152,284,3.0102389078498293,37.60986558348254
Task_42176,1314,134,164,65,229,9.733333333333333,27.82404973975939
Task_42177,570,563,98,35,133,1.0106382978723405,16.86465342686741
Task_42178,1972,359,179,64,243,5.477777777777778,39.40642630186224
Task_42179,2068,650,99,31,130,3.176651305683564,40.87622370147098
Task_42180,946,383,60,24,84,2.4635416666666665,21.54867954410615
Task_42181,1114,454,119,81,200,2.4483516483516485,26.099212637798157
Task_42182,2460,105,169,12,181,23.20754716981132,44.813859175280236
Task_42183,698,72,75,179,254,9.561643835616438,18.434402601765974
Task_42184,1692,308,33,95,128,5.475728155339806,34.751388085286266
Task_42185,1206,361,105,103,208,3.3314917127071824,27.65011747241697
Task_42186,2713,676,10,178,188,4.00738552437223,52.497937108559
Task_42187,863,360,102,163,265,2.3905817174515236,22.565782064183377
Task_42188,2405,909,66,145,211,2.642857142857143,48.56349470115038
Task_42189,1382,492,89,12,101,2.8032454361054766,29.03945589138741
Task_42190,1849,266,133,189,322,6.925093632958801,38.141007079501954
Task_42191,1680,774,133,97,230,2.167741935483871,36.58151391858021
Task_42192,1560,823,45,165,210,1.8932038834951457,34.80909093805415
Task_42193,2234,386,129,15,144,5.772609819121447,42.49700176858764
Task_42194,2617,1001,141,166,307,2.6117764471057883,52.550649391575405
Task_42195,576,738,20,64,84,0.7794316644113667,17.376159260328745
Task_42196,2233,733,43,160,203,3.042234332425068,45.16446072742256
Task_42197,2208,518,106,103,209,4.254335260115607,44.017435669181424
Task_42198,2048,280,187,175,362,7.288256227758007,41.49479708861545
Task_42199,647,537,50,129,179,1.2026022304832713,19.129427616755663
Task_42200,2960,130,177,151,328,22.595419847328245,54.66920954715257
Task_42201,733,401,53,59,112,1.8233830845771144,18.943877935046824
Task_42202,1620,907,141,63,204,1.7841409691629957,35.37434277340589
Task_42203,2775,687,139,191,330,4.03343023255814,54.20920800355284
Task_42204,838,288,148,171,319,2.8996539792387543,22.194875219984848
Task_42205,2084,83,121,172,293,24.80952380952381,40.19386903838376
Task_42206,1451,915,63,139,202,1.584061135371179,33.382395196238114
Task_42207,1020,174,91,200,291,5.828571428571428,24.278207097422666
Task_42208,1973,113,179,67,246,17.30701754385965,37.944886521763145
Task_42209,1624,1020,46,39,85,1.5905974534769833,34.41915924901442
Task_42210,1682,667,140,135,275,2.5179640718562872,36.50357057128493
Task_42211,1095,392,76,196,272,2.786259541984733,26.55625144841893
Task_42212,572,674,188,197,385,0.8474074074074074,19.446831232851917
Task_42213,2386,466,70,156,226,5.109207708779444,46.962369734248966
Task_42214,592,313,180,95,275,1.8853503184713376,18.04763434020071
Task_42215,2937,725,157,177,334,4.045454545454546,56.893159956961085
Task_42216,1857,363,118,19,137,5.101648351648351,36.38318905363544
Task_42217,1094,601,141,51,192,1.8172757475083057,26.020682052310434
Task_42218,2618,1009,82,142,224,2.592079207920792,52.27457542818109
Task_42219,2171,445,129,158,287,4.867713004484305,43.62852471013294
Task_42220,2572,135,70,51,121,18.91176470588235,46.6692722432224
Task_42221,1573,990,73,30,103,1.5872855701311805,33.782181658188286
Task_42222,763,442,44,144,188,1.7223476297968396,20.83022255472337
Task_42223,1499,901,29,130,159,1.6618625277161863,33.51184724905669
Task_42224,1722,593,94,88,182,2.898989898989899,36.05013536738107
Task_42225,2190,209,184,61,245,10.428571428571429,42.25620103457512
Task_42226,1639,256,179,56,235,6.377431906614786,33.77472705554883
Task_42227,1814,855,180,144,324,2.119158878504673,39.41595636512955
Task_42228,2907,581,197,159,356,4.994845360824742,56.03223592780851
Task_42229,2750,403,36,186,222,6.806930693069307,52.41036492882958
Task_42230,2576,479,56,144,200,5.366666666666666,49.89569626282559
Task_42231,1525,976,62,179,241,1.5609007164790174,34.97861797694666
Task_42232,779,365,190,81,271,2.128415300546448,20.836509332775304
Task_42233,2498,234,46,148,194,10.629787234042553,47.67650228394218
Task_42234,1561,586,39,179,218,2.659284497444634,34.15285803096732
Task_42235,1457,156,111,104,215,9.280254777070065,30.66325852060847
Task_42236,564,520,10,138,148,1.0825335892514396,17.291095528342613
Task_42237,2130,317,195,170,365,6.69811320754717,42.924818704135966
Task_42238,1961,183,92,70,162,10.657608695652174,38.153475588151885
Task_42239,1286,618,13,114,127,2.0775444264943457,29.183659468168344
Task_42240,660,169,83,179,262,3.8823529411764706,18.513029606621657
Task_42241,1492,714,79,187,266,2.086713286713287,33.807356058565794
Task_42242,2731,893,171,90,261,3.0548098434004474,53.536351333974665
Task_42243,2338,705,84,130,214,3.311614730878187,46.77897757469119
Task_42244,2228,971,98,79,177,2.292181069958848,45.11026802637974
Task_42245,861,476,59,49,108,1.8050314465408805,20.881434406794554
Task_42246,1128,557,183,183,366,2.021505376344086,27.865619758531505
Task_42247,2772,342,61,17,78,8.081632653061224,49.76293364423544
Task_42248,810,524,73,182,255,1.542857142857143,22.313413531923597
Task_42249,2480,144,37,198,235,17.103448275862068,46.98605009875084
Task_42250,1116,902,172,70,242,1.2358803986710964,27.5241754898517
Task_42251,2440,675,126,66,192,3.6094674556213016,47.59503490784176
Task_42252,1388,883,124,47,171,1.5701357466063348,31.01564828579875
Task_42253,2743,408,150,105,255,6.706601466992665,52.33736818630208
Task_42254,1941,199,123,177,300,9.705,39.24995855914256
Task_42255,947,575,96,62,158,1.6440972222222223,23.21841702249976
Task_42256,1920,708,110,190,300,2.708039492242595,40.595311580994085
Task_42257,1701,917,19,81,100,1.8529411764705883,36.031792897051396
Task_42258,2610,919,71,52,123,2.8369565217391304,50.54051556934539
Task_42259,1204,945,32,17,49,1.2727272727272727,26.83782369136924
Task_42260,1754,464,34,49,83,3.772043010752688,34.82020221602706
Task_42261,2807,433,57,155,212,6.467741935483871,53.47140046531529
Task_42262,1743,568,185,18,203,3.063268892794376,35.75242890310873
Task_42263,2015,296,24,136,160,6.784511784511785,39.78696992910782
Task_42264,2464,694,47,182,229,3.545323741007194,48.88706741242464
Task_42265,2031,607,21,31,52,3.3404605263157894,39.21994225300655
Task_42266,1011,645,110,128,238,1.565015479876161,25.587251205557564
Task_42267,1966,649,126,150,276,3.0246153846153847,40.97175864618015
Task_42268,2507,432,35,136,171,5.789838337182448,48.183678246470954
Task_42269,1792,671,132,185,317,2.6666666666666665,38.52102772741244
Task_42270,1641,970,65,77,142,1.690010298661174,35.656948428367095
Task_42271,677,706,139,157,296,0.9575671852899575,20.7653595423367
Task_42272,765,590,189,32,221,1.2944162436548223,20.673243223351164
Task_42273,1335,137,84,143,227,9.673913043478262,28.74427052162778
Task_42274,2210,523,115,146,261,4.217557251908397,44.3625185376815
Task_42275,2168,427,151,66,217,5.065420560747664,42.60937312484354
Task_42276,2836,82,145,77,222,34.16867469879518,51.10403172611698
Task_42277,1492,258,30,36,66,5.760617760617761,29.512050535947335
Task_42278,2202,105,200,83,283,20.77358490566038,41.81921493761787
Task_42279,1412,302,13,154,167,4.66006600660066,30.474710945614678
Task_42280,2655,487,52,87,139,5.440573770491803,50.35714539238734
Task_42281,2948,610,33,120,153,4.824877250409165,55.50474969197001
Task_42282,2049,652,110,161,271,3.1378254211332313,42.28940215562434
Task_42283,1322,361,12,129,141,3.6519337016574585,28.917664208468782
Task_42284,821,791,122,24,146,1.0366161616161615,21.54219571007559
Task_42285,977,385,156,96,252,2.5310880829015545,24.31560277007357
Task_42286,1619,794,55,106,161,2.036477987421384,35.194155584034114
Task_42287,1246,165,149,113,262,7.506024096385542,27.584410366671047
Task_42288,2192,926,39,145,184,2.364617044228695,44.835676429124845
Task_42289,760,319,188,196,384,2.375,21.39078465952932
Task_42290,2893,899,26,193,219,3.2144444444444447,56.28950845828671
Task_42291,1717,383,95,177,272,4.471354166666667,36.27276913772644
Task_42292,1620,489,22,154,176,3.306122448979592,34.358791614820085
Task_42293,1209,875,25,153,178,1.38013698630137,29.00536206696532
Task_42294,1289,755,43,189,232,1.7050264550264551,30.43850674428637
Task_42295,1527,216,149,192,341,7.0368663594470044,32.96769487642825
Task_42296,2932,994,73,192,265,2.9467336683417087,57.49641788048532
Task_42297,1471,814,120,70,190,1.8049079754601227,32.68367313041947
Task_42298,1367,822,175,200,375,1.660996354799514,32.529545922975025
Task_42299,1889,173,168,52,220,10.85632183908046,37.14720604065621
Task_42300,2462,451,88,106,194,5.446902654867257,47.778161025411805
Task_42301,509,256,65,61,126,1.9805447470817121,15.209097898972374
Task_42302,1365,339,164,137,301,4.014705882352941,30.562879577231143
Task_42303,1218,678,129,120,249,1.7938144329896908,29.04930319621242
Task_42304,2288,708,75,101,176,3.227080394922426,45.71463119959759
Task_42305,1427,172,101,86,187,8.248554913294798,29.73857358140349
Task_42306,2320,625,133,73,206,3.7060702875399363,45.66740649937395
Task_42307,2846,245,86,117,203,11.56910569105691,53.21864777319116
Task_42308,1976,499,91,184,275,3.952,40.74906364640206
Task_42309,935,587,44,127,171,1.5901360544217686,23.718470428899195
Task_42310,1220,220,180,66,246,5.520361990950226,27.058392342936727
Task_42311,1667,958,26,180,206,1.7382690302398331,36.95536716683926
Task_42312,1444,995,62,37,99,1.4497991967871486,31.48099539654089
Task_42313,636,882,172,99,271,0.7202718006795017,20.547663859780958
Task_42314,1440,490,79,32,111,2.9327902240325865,30.193996744393004
Task_42315,2036,289,82,175,257,7.020689655172414,40.95551120962658
Task_42316,1321,323,173,128,301,4.077160493827161,29.801534254114486
Task_42317,520,721,169,23,192,0.7202216066481995,17.26508326975331
Task_42318,2379,391,72,20,92,6.0688775510204085,44.39524326302871
Task_42319,2913,748,51,50,101,3.889185580774366,54.22089549258943
Task_42320,833,796,72,161,233,1.0451693851944792,23.247656816595825
Task_42321,1366,233,71,139,210,5.837606837606837,29.94381480223933
Task_42322,1597,722,33,139,172,2.2088520055325036,34.85078179046738
Task_42323,2586,395,95,154,249,6.53030303030303,49.92462802700723
Task_42324,2145,1019,16,100,116,2.1029411764705883,43.83491517567364
Task_42325,1392,944,174,135,309,1.4730158730158731,32.87111686250059
Task_42326,1359,911,119,179,298,1.4901315789473684,32.271925096475904
Task_42327,1466,260,184,63,247,5.616858237547893,31.083860648702643
Task_42328,1186,468,170,42,212,2.5287846481876333,26.906967364997467
Task_42329,1404,704,63,151,214,1.9914893617021276,32.09231082741909
Task_42330,2847,64,128,190,318,43.8,52.12980204549711
Task_42331,2774,934,43,137,180,2.966844919786096,54.04644285383674
Task_42332,1349,995,134,27,161,1.354417670682731,30.60103598133946
Task_42333,1269,752,140,160,300,1.6852589641434264,30.362665952182123
Task_42334,2488,501,54,34,88,4.956175298804781,46.43729936971247
Task_42335,2117,317,74,91,165,6.6572327044025155,41.647312187147215
Task_42336,2648,227,17,127,144,11.614035087719298,49.36775312388303
Task_42337,1929,725,165,33,198,2.65702479338843,39.43065131137299
Task_42338,1150,473,87,11,98,2.4261603375527425,25.243028616957925
Task_42339,778,942,70,48,118,0.8250265111346765,21.278944939393085
Task_42340,2672,536,154,129,283,4.975791433891993,51.79339710514163
Task_42341,845,847,37,25,62,0.9964622641509434,21.23651804137729
Task_42342,643,835,198,75,273,0.7691387559808612,20.123906432361157
Task_42343,1227,845,154,79,233,1.450354609929078,29.222393683658215
Task_42344,1956,993,55,10,65,1.9678068410462777,38.89719556653168
Task_42345,2521,640,67,182,249,3.932917316692668,49.781052838262504
Task_42346,772,678,113,14,127,1.1369661266568483,20.27051960659788
Task_42347,2154,597,129,152,281,3.6020066889632107,43.81041365956287
Task_42348,2595,302,83,24,107,8.564356435643564,47.6619455388746
Task_42349,2047,562,105,183,288,3.635879218472469,42.08191586566248
Task_42350,1423,557,116,14,130,2.550179211469534,30.18698922518142
Task_42351,1544,229,99,112,211,6.71304347826087,32.58093990479742
Task_42352,2696,868,164,164,328,3.102416570771001,53.4787674486798
Task_42353,789,564,91,26,117,1.3964601769911504,20.113163015313496
Task_42354,2869,795,111,181,292,3.6042713567839195,55.85328480865943
Task_42355,2595,977,167,89,256,2.6533742331288344,51.59696948042665
Task_42356,554,157,183,188,371,3.5063291139240507,17.26201823975947
Task_42357,2166,152,29,80,109,14.156862745098039,40.531394861942985
Task_42358,1294,986,174,23,197,1.3110435663627154,30.125658948799583
Task_42359,1006,114,63,194,257,8.747826086956522,23.5723166293283
Task_42360,1100,951,126,152,278,1.1554621848739495,28.12273188125518
Task_42361,1642,741,100,89,189,2.2129380053908356,35.4297011053395
Task_42362,2774,251,62,132,194,11.007936507936508,52.17118414168912
Task_42363,916,445,50,197,247,2.0538116591928253,23.831415337741323
Task_42364,988,324,17,183,200,3.04,24.101828467289607
Task_42365,1379,493,14,71,85,2.791497975708502,29.38799737276318
Task_42366,2635,949,55,127,182,2.7736842105263158,52.029498845794535
Task_42367,551,509,195,32,227,1.080392156862745,17.04846937528065
Task_42368,2444,595,12,86,98,4.100671140939597,46.824380389441224
Task_42369,1176,575,53,139,192,2.0416666666666665,28.003142676724877
Task_42370,974,412,164,88,252,2.358353510895884,24.066492725965293
Task_42371,2320,208,182,149,331,11.10047846889952,45.35018575714988
Task_42372,2172,884,57,63,120,2.454237288135593,43.54038288261521
Task_42373,1138,693,89,64,153,1.6397694524495676,26.547283245841328
Task_42374,1259,856,95,40,135,1.4690781796966161,28.775709830164757
Task_42375,946,752,143,189,332,1.2563081009296149,25.322726910240224
Task_42376,2977,873,120,95,215,3.4061784897025174,57.308220230234866
Task_42377,2700,537,143,107,250,5.018587360594796,52.058973392409236
Task_42378,2778,585,116,31,147,4.7406143344709895,51.96132210427674
Task_42379,1889,415,58,131,189,4.540865384615385,38.714515486977426
Task_42380,1893,183,157,173,330,10.28804347826087,38.39822496915222
Task_42381,946,544,29,172,201,1.7357798165137615,24.210855568923353
Task_42382,1362,912,30,44,74,1.4917853231106244,29.524230985221067
Task_42383,1095,554,14,113,127,1.972972972972973,25.943675326167895
Task_42384,2455,757,84,151,235,3.2387862796833775,48.9214233931305
Task_42385,2374,713,164,121,285,3.3249299719887957,47.63392170753006
Task_42386,1667,746,199,113,312,2.2315930388219547,36.64760871307417
Task_42387,864,372,154,30,184,2.316353887399464,21.22114556689741
Task_42388,2439,723,69,172,241,3.3687845303867405,48.693011380201604
Task_42389,1006,829,138,145,283,1.2120481927710844,26.22665267310268
Task_42390,2911,830,87,37,124,3.503008423586041,54.65276895869426
Task_42391,2874,177,132,50,182,16.146067415730336,52.03818697878082
Task_42392,2196,588,18,61,79,3.7283531409168083,42.090736756660725
Task_42393,2012,846,30,35,65,2.375442739079103,39.6163721138251
Task_42394,1353,412,23,98,121,3.276029055690073,29.55267410679887
Task_42395,638,606,48,83,131,1.0510708401976936,18.639349596379294
Task_42396,2385,555,159,93,252,4.289568345323741,47.05219143712751
Task_42397,759,461,136,138,274,1.6428571428571428,21.22893504842482
Task_42398,1466,422,167,33,200,3.465721040189125,31.150612974081962
Task_42399,2448,370,140,103,243,6.598382749326146,47.485671145478044
Task_42400,1245,286,175,119,294,4.337979094076655,28.433323494827622
Task_42401,1461,853,38,190,228,1.7107728337236534,33.45042476988825
Task_42402,1509,191,79,97,176,7.859375,31.706408176623736
Task_42403,2046,497,187,177,364,4.108433734939759,42.19245143441609
Task_42404,2727,427,138,70,208,6.371495327102804,51.43959309529455
Task_42405,788,713,171,29,200,1.1036414565826331,21.32623146344744
Task_42406,2982,608,190,117,307,4.896551724137931,57.024114138464334
Task_42407,622,904,110,185,295,0.687292817679558,20.672037789424213
Task_42408,582,429,50,17,67,1.3534883720930233,15.420975884164314
Task_42409,662,337,194,44,238,1.9585798816568047,18.30992024335636
Task_42410,2208,753,31,132,163,2.9283819628647216,44.46198067016538
Task_42411,2368,599,132,116,248,3.9466666666666668,47.00426573293229
Task_42412,2297,230,130,197,327,9.943722943722944,45.123548998403635
Task_42413,605,87,177,59,236,6.875,16.13372030709098
Task_42414,990,763,161,99,260,1.2958115183246073,25.613775160727098
Task_42415,2159,360,113,132,245,5.980609418282548,42.93182737498022
Task_42416,2894,145,36,38,74,19.82191780821918,51.2829473711382
Task_42417,1305,491,54,163,217,2.652439024390244,29.918651599528513
Task_42418,2049,532,91,176,267,3.844277673545966,41.96244764671206
Task_42419,2617,846,88,89,177,3.089728453364817,51.01965407421306
Task_42420,2527,840,32,103,135,3.004756242568371,49.50684291376444
Task_42421,2328,871,96,179,275,2.669724770642202,47.49327115764306
Task_42422,1278,983,100,127,227,1.298780487804878,30.76591186755307
Task_42423,1631,661,44,46,90,2.4637462235649545,33.46259156104373
Task_42424,2920,922,117,142,259,3.1635969664138677,56.85390122307931
Task_42425,618,618,175,143,318,0.9983844911147012,19.606957524186466
Task_42426,2460,236,60,65,125,10.379746835443038,46.0680234519585
Task_42427,2568,455,189,50,239,5.631578947368421,48.933349541139904
Task_42428,1507,921,46,57,103,1.6344902386117137,32.68097172114117
Task_42429,2713,289,158,108,266,9.355172413793104,51.50778328357277
Task_42430,1479,945,103,169,272,1.5634249471458774,34.147025818703256
Task_42431,762,193,189,129,318,3.9278350515463916,20.62027177874865
Task_42432,876,878,56,183,239,0.9965870307167235,24.291333320074617
Task_42433,2306,466,36,160,196,4.937901498929336,45.43517627956777
Task_42434,715,280,32,174,206,2.5444839857651247,19.759458679786928
Task_42435,1034,446,117,38,155,2.3131991051454137,23.932737229954437
Task_42436,2370,876,168,89,257,2.7023945267958953,47.720962200060875
Task_42437,1100,719,90,171,261,1.5277777777777777,27.44720591902049
Task_42438,611,373,95,74,169,1.6336898395721926,17.57615058794801
Task_42439,2276,167,199,15,214,13.547619047619047,42.857769501339966
Task_42440,1417,814,107,87,194,1.7386503067484662,32.063330737760246
Task_42441,2088,639,181,29,210,3.2625,41.74088437791699
Task_42442,1630,482,104,53,157,3.3747412008281574,33.76108144071302
Task_42443,1414,857,146,157,303,1.648018648018648,32.99539828252074
Task_42444,983,911,44,14,58,1.0778508771929824,23.37706983641981
Task_42445,693,712,139,176,315,0.9719495091164095,21.137191830036116
Task_42446,1063,750,177,137,314,1.4154460719041277,27.067469079239846
Task_42447,2748,214,20,64,84,12.78139534883721,49.9547606364792
Task_42448,688,524,132,177,309,1.3104761904761906,20.47740876956712
Task_42449,2892,771,72,47,119,3.7461139896373057,54.10937373966264
Task_42450,2945,692,100,116,216,4.24963924963925,56.294104356818615
Task_42451,2480,264,143,21,164,9.358490566037736,46.292298248687835
Task_42452,2979,703,52,133,185,4.231534090909091,56.79261502099492
Task_42453,768,266,47,68,115,2.8764044943820224,19.419538022419513
Task_42454,505,413,124,98,222,1.2198067632850242,16.65936476201683
Task_42455,1960,428,130,198,328,4.568764568764569,40.47732987168456
Task_42456,1437,847,84,124,208,1.6945754716981132,32.899526851786625
Task_42457,2150,898,76,125,201,2.3915461624026695,44.429779601197936
Task_42458,1914,271,82,144,226,7.036764705882353,38.77948017147313
Task_42459,1921,775,169,80,249,2.475515463917526,40.1445501225146
Task_42460,2570,373,29,145,174,6.871657754010696,49.155694069746765
Task_42461,2215,146,25,85,110,15.068027210884354,41.2754101140269
Task_42462,1269,179,162,21,183,7.05,26.65053803089199
Task_42463,1262,288,165,141,306,4.366782006920415,28.79502256897916
Task_42464,1186,625,183,194,377,1.8945686900958467,29.062491204265573
Task_42465,1254,911,32,86,118,1.375,29.201673846908715
Task_42466,569,1002,161,103,264,0.5672981056829511,19.829659558713335
Task_42467,2646,223,127,132,259,11.8125,50.20694148802604
Task_42468,703,824,78,189,267,0.8521212121212122,21.537162939867972
Task_42469,1491,519,44,130,174,2.8673076923076923,32.49888534349543
Task_42470,2134,379,12,22,34,5.61578947368421,39.727048938953565
Task_42471,942,127,16,119,135,7.359375,21.355165914858578
Task_42472,977,847,115,195,310,1.1521226415094339,26.05907816120741
Task_42473,2113,1019,60,154,214,2.0715686274509806,44.31091480171474
Task_42474,2189,534,17,21,38,4.091588785046729,41.144484774181414
Task_42475,1835,726,180,10,190,2.5240715268225586,37.74098517420304
Task_42476,2524,270,15,172,187,9.313653136531366,48.19480837786025
Task_42477,2938,130,86,186,272,22.427480916030536,54.145363040941476
Task_42478,2592,641,199,77,276,4.037383177570093,50.395670712277756
Task_42479,1582,759,95,75,170,2.081578947368421,34.155108383724425
Task_42480,2189,271,124,125,249,8.047794117647058,43.10921703224545
Task_42481,852,407,129,150,279,2.088235294117647,22.584639504120958
Task_42482,1446,250,136,35,171,5.760956175298805,29.936330472159785
Task_42483,2748,754,58,139,197,3.639735099337748,53.47204564387724
Task_42484,1663,479,171,165,336,3.464583333333333,35.92800033272419
Task_42485,1975,947,63,116,179,2.0833333333333335,41.50503572829242
Task_42486,2022,724,188,141,329,2.788965517241379,42.32012305291135
Task_42487,1937,157,62,182,244,12.259493670886076,38.58534517622845
Task_42488,1400,221,187,200,387,6.306306306306307,31.199054563167195
Task_42489,1142,733,150,38,188,1.555858310626703,26.926866507476536
Task_42490,765,625,117,102,219,1.2220447284345048,21.424692835286326
Task_42491,1787,258,16,36,52,6.899613899613899,34.26401354045747
Task_42492,1315,767,23,111,134,1.7122395833333333,30.131196024258774
Task_42493,1688,428,46,199,245,3.9347319347319347,35.83432272885851
Task_42494,1324,110,175,161,336,11.927927927927929,28.62082239928212
Task_42495,812,994,44,78,122,0.8160804020100503,22.405679574897963
Task_42496,838,587,108,166,274,1.4251700680272108,22.859162984276093
Task_42497,2146,734,107,199,306,2.919727891156463,44.29716193658523
Task_42498,2846,759,86,185,271,3.7447368421052634,55.32877343321956
Task_42499,809,260,62,38,100,3.099616858237548,19.213929770211003
Task_42500,2177,966,114,175,289,2.25129265770424,45.401130953079964
Task_42501,2780,130,61,108,169,21.221374045801525,50.905534742061576
Task_42502,1990,90,196,194,390,21.86813186813187,39.28016689153947
Task_42503,2939,503,101,73,174,5.8313492063492065,54.84815291883266
Task_42504,1896,570,193,123,316,3.320490367775832,39.75445033047681
Task_42505,1117,949,157,67,224,1.1757894736842105,27.654299775730347
Task_42506,1905,827,68,169,237,2.300724637681159,40.53724782426904
Task_42507,2195,968,67,36,103,2.265221878224974,43.45244860384577
Task_42508,2156,475,156,78,234,4.529411764705882,42.8342525071287
Task_42509,1901,686,89,63,152,2.7671033478893743,38.606913213249584
Task_42510,2617,485,103,193,296,5.38477366255144,50.91006764982283
Task_42511,1360,535,123,175,298,2.537313432835821,31.151794504404368
Task_42512,1695,348,153,116,269,4.856733524355301,35.63700598088872
Task_42513,596,725,18,97,115,0.8209366391184573,18.1965785371172
Task_42514,1082,382,170,50,220,2.825065274151436,25.09531631448556
Task_42515,1676,866,89,105,194,1.9331026528258362,36.66036599704303
Task_42516,2929,719,130,17,147,4.0680555555555555,54.53135674397445
Task_42517,876,664,163,140,303,1.3172932330827067,23.808782665611318
Task_42518,2853,850,105,182,287,3.3525264394829613,55.751523468171875
Task_42519,1316,746,97,193,290,1.7617135207496653,31.115549117684356
Task_42520,2735,869,162,32,194,3.1436781609195403,52.63242149874093
Task_42521,2763,1023,129,184,313,2.6982421875,54.98634089142805
Task_42522,1072,952,169,35,204,1.1248688352570828,26.56803773130063
Task_42523,1405,378,164,43,207,3.70712401055409,30.064503621440974
Task_42524,798,69,162,128,290,11.4,19.88049709929393
Task_42525,1788,641,133,77,210,2.7850467289719627,37.36425286569233
Task_42526,2304,95,21,171,192,24.0,43.165398967112445
Task_42527,641,71,60,133,193,8.902777777777779,17.090412253488108
Task_42528,594,820,53,80,133,0.7235079171741778,18.886530157060694
Task_42529,901,349,41,56,97,2.5742857142857143,21.323456967438005
Task_42530,2402,920,99,107,206,2.6080347448425623,48.35108976861576
Task_42531,799,675,127,44,171,1.1819526627218935,21.055077090724932
Task_42532,1872,828,184,157,341,2.2581423401688783,40.34644903703761
Task_42533,2955,602,183,42,225,4.900497512437811,55.40156994003877
Task_42534,1862,325,41,50,91,5.711656441717792,36.14621235545003
Task_42535,1651,334,48,33,81,4.928358208955224,32.75769840045217
Task_42536,2217,1021,120,22,142,2.1692759295499022,44.3176270036706
Task_42537,504,74,83,74,157,6.72,13.96476720418967
Task_42538,1446,309,81,194,275,4.664516129032258,31.815323516295148
Task_42539,2604,699,109,55,164,3.72,50.08509551935015
Task_42540,1565,546,76,159,235,2.8610603290676417,34.263193760917936
Task_42541,776,352,200,142,342,2.198300283286119,21.480405058694924
Task_42542,2482,821,189,151,340,3.019464720194647,49.975922964720475
Task_42543,2047,317,148,122,270,6.437106918238993,41.11378356919394
Task_42544,2244,385,139,102,241,5.813471502590674,44.29767514744625
Task_42545,2498,95,39,105,144,26.020833333333332,45.496587401552944
Task_42546,2606,610,186,108,294,4.265139116202946,51.004018979469514
Task_42547,1752,553,66,148,214,3.1624548736462095,37.11998814595797
Task_42548,903,263,186,200,386,3.4204545454545454,23.48535433250957
Task_42549,2474,95,199,47,246,25.770833333333332,45.29306013417831
Task_42550,1405,728,77,157,234,1.9272976680384089,32.27985221096316
Task_42551,2317,500,56,12,68,4.624750499001996,43.08463295973297
Task_42552,2424,851,21,190,211,2.8450704225352115,48.60710611502393
Task_42553,1097,737,144,51,195,1.486449864498645,26.501499175087876
Task_42554,1683,919,99,169,268,1.8293478260869565,37.325264973355864
Task_42555,1950,968,157,179,336,2.0123839009287927,42.0278897482128
Task_42556,2154,564,93,156,249,3.8123893805309734,43.67920682485038
Task_42557,2186,919,107,50,157,2.376086956521739,43.689684222147655
Task_42558,818,420,116,170,286,1.9429928741092637,22.1484400952446
Task_42559,2146,509,147,198,345,4.207843137254902,43.759218310309535
Task_42560,1583,205,146,23,169,7.684466019417476,31.8668673303049
Task_42561,1298,341,128,138,266,3.7953216374269005,29.353397372904016
Task_42562,2952,800,69,176,245,3.6853932584269664,57.0863289412676
Task_42563,2516,161,23,33,56,15.530864197530864,45.4334085626848
Task_42564,1274,777,118,76,194,1.6375321336760926,29.570313165433863
Task_42565,2969,922,86,97,183,3.2166847237269773,57.12388014789812
Task_42566,1452,200,17,10,27,7.223880597014926,28.195102014646988
Task_42567,820,290,115,124,239,2.8178694158075603,21.48732128307384
Task_42568,1177,643,188,157,345,1.8276397515527951,28.77767344328039
Task_42569,985,522,174,186,360,1.8833652007648183,25.46913340104616
Task_42570,2416,201,45,65,110,11.96039603960396,45.003669634157056
Task_42571,2992,660,97,29,126,4.526475037821482,55.53847865094184
Task_42572,2167,981,30,113,143,2.206720977596741,44.282898658480896
Task_42573,2156,850,39,53,92,2.533490011750881,42.77962477095928
Task_42574,1131,413,57,193,250,2.7318840579710146,27.109677532288444
Task_42575,1654,188,14,119,133,8.751322751322752,33.62649506248541
Task_42576,1383,375,148,64,212,3.6781914893617023,30.001074977435906
Task_42577,2685,557,82,138,220,4.811827956989247,51.888444436751676
Task_42578,2269,338,52,36,88,6.6932153392330385,42.472932079695475
Task_42579,2988,113,178,46,224,26.210526315789473,53.61183778167176
Task_42580,2759,496,161,86,247,5.551307847082495,52.55200974575022
Task_42581,2610,988,43,190,233,2.639029322548028,52.114498650004386
Task_42582,750,480,57,191,248,1.5592515592515592,21.239410398944177
Task_42583,2894,160,19,88,107,17.975155279503106,52.09326501734501
Task_42584,2783,644,192,71,263,4.314728682170543,53.285745102162785
Task_42585,2428,560,185,163,348,4.327985739750446,48.34969036441759
Task_42586,1522,349,55,134,189,4.348571428571429,32.70145545699305
Task_42587,2303,236,42,48,90,9.717299578059071,42.732769880323424
Task_42588,2900,82,13,98,111,34.93975903614458,51.5730086719137
Task_42589,2338,694,83,24,107,3.3640287769784174,44.87265983127755
Task_42590,2707,737,133,129,262,3.668021680216802,52.89269811325769
Task_42591,2648,288,62,67,129,9.162629757785467,49.37438974446761
Task_42592,1097,540,179,97,276,2.0277264325323476,26.82339579430872
Task_42593,757,353,137,193,330,2.138418079096045,21.203706661071326
Task_42594,2855,782,85,182,267,3.6462324393358876,55.52667207720199
Task_42595,1272,384,97,71,168,3.303896103896104,27.937373163495334
Task_42596,1566,833,83,114,197,1.8776978417266188,34.85537685836665
Task_42597,2508,972,175,52,227,2.5775950668037,49.79305842572105
Task_42598,1769,425,112,63,175,4.152582159624413,36.01085434633604
Task_42599,2819,384,96,64,160,7.322077922077922,52.26593493157187
Task_42600,2496,288,174,21,195,8.636678200692042,46.85053718197421
Task_42601,858,189,167,195,362,4.515789473684211,22.425481199217433
Task_42602,627,406,187,195,382,1.5405405405405406,19.508536202020995
Task_42603,1392,185,49,194,243,7.483870967741935,30.27885726911524
Task_42604,890,489,142,66,208,1.816326530612245,22.538018949416188
Task_42605,1316,724,109,196,305,1.8151724137931033,31.108792568111184
Task_42606,876,881,18,153,171,0.9931972789115646,23.556743606122694
Task_42607,2020,194,45,57,102,10.35897435897436,38.47858539049937
Task_42608,1964,128,36,89,125,15.224806201550388,37.368941339002546
Task_42609,1320,97,114,13,127,13.46938775510204,26.294999218566982
Task_42610,2606,277,145,44,189,9.37410071942446,48.59500247916876
Task_42611,1192,895,55,144,199,1.3303571428571428,29.20525723329874
Task_42612,2003,739,191,126,317,2.7067567567567568,41.99008294347636
Task_42613,1265,196,116,67,183,6.4213197969543145,27.212132287854615
Task_42614,1901,933,102,21,123,2.0353319057815846,38.88869223282137
Task_42615,2525,777,21,108,129,3.2455012853470437,49.279739654108255
Task_42616,2251,241,35,26,61,9.301652892561984,41.425060343353145
Task_42617,1014,605,185,110,295,1.6732673267326732,25.769928845836887
Task_42618,2866,650,158,58,216,4.402457757296467,54.31247363386891
Task_42619,2347,965,50,146,196,2.429606625258799,47.81972993336155
Task_42620,2698,472,88,79,167,5.704016913319239,50.963005827825526
Task_42621,2289,148,181,105,286,15.36241610738255,44.03992025781812
Task_42622,1327,483,20,198,218,2.7417355371900825,30.11878901517008
Task_42623,1196,561,98,27,125,2.1281138790035588,26.659853511477934
Task_42624,862,920,34,110,144,0.9359391965255157,23.246056294895492
Task_42625,1124,598,110,94,204,1.8764607679465777,27.014385780848286
Task_42626,896,606,76,162,238,1.4761120263591434,23.82573031692422
Task_42627,1068,110,52,182,234,9.621621621621621,24.244403087963367
Task_42628,1898,336,92,105,197,5.632047477744807,38.544918747175636
Task_42629,783,360,178,91,269,2.1689750692520775,21.066608088682802
Task_42630,900,459,170,103,273,1.9565217391304348,23.412109254732723
Task_42631,1926,414,140,118,258,4.6409638554216865,39.46103625115182
Task_42632,2645,957,149,181,330,2.7609603340292277,52.982790122067875
Task_42633,1789,489,191,195,386,3.6510204081632653,38.22385889672783
Task_42634,1888,82,62,63,125,22.746987951807228,35.530562087562096
Task_42635,2231,894,119,42,161,2.492737430167598,44.27511170975177
Task_42636,955,881,86,83,169,1.082766439909297,24.481516815699326
Task_42637,2000,211,72,173,245,9.433962264150944,40.08411775549293
Task_42638,686,924,58,125,183,0.7416216216216216,20.892619311156785
Task_42639,2093,139,167,175,342,14.95,41.2205993487534
Task_42640,2912,479,31,42,73,6.066666666666666,52.74785338359525
Task_42641,873,234,47,22,69,3.7148936170212767,19.581822801752296
Task_42642,718,81,147,82,229,8.75609756097561,18.125142393098606
Task_42643,1252,610,139,51,190,2.049099836333879,28.53073892713326
Task_42644,1757,265,138,169,307,6.605263157894737,36.58666821397687
Task_42645,825,473,130,119,249,1.740506329113924,22.170717039398102
Task_42646,2092,666,14,174,188,3.136431784107946,42.664658876223704
Task_42647,2997,684,137,70,207,4.375182481751825,56.539852008475314
Task_42648,1157,367,98,129,227,3.1440217391304346,27.03190578115482
Task_42649,2372,855,58,57,115,2.7710280373831777,46.38262920123149
Task_42650,2124,205,167,28,195,10.310679611650485,40.75199639985732
Task_42651,1239,919,141,163,304,1.3467391304347827,30.40111632610296
Task_42652,1648,328,175,123,298,5.009118541033435,34.9685140023198
Task_42653,928,337,66,80,146,2.7455621301775146,22.51763330798717
Task_42654,828,456,200,173,373,1.811816192560175,22.816361237354084
Task_42655,1830,163,132,102,234,11.158536585365853,36.64228857117835
Task_42656,2824,130,198,128,326,21.557251908396946,52.48548821260823
Task_42657,1949,798,20,114,134,2.439299123904881,40.16945743913373
Task_42658,2064,356,13,187,200,5.781512605042017,41.34946637814611
Task_42659,2883,190,130,34,164,15.094240837696335,52.58298790289354
Task_42660,2679,437,15,89,104,6.116438356164384,50.20605040104544
Task_42661,2309,194,142,189,331,11.841025641025642,45.107656198090375
Task_42662,2304,1003,156,134,290,2.2948207171314743,47.47321397001681
Task_42663,2622,932,116,110,226,2.810289389067524,51.967470130437995
Task_42664,1638,903,78,125,203,1.8119469026548674,36.33407289932373
Task_42665,2092,548,179,68,247,3.8105646630236794,41.955907583224814
Task_42666,2783,773,154,24,178,3.595607235142119,52.76558728056125
Task_42667,2094,351,20,89,109,5.948863636363637,40.69727260559804
Task_42668,2660,333,142,25,167,7.9640718562874255,49.35827689972203
Task_42669,2200,453,123,143,266,4.845814977973569,43.9968564712324
Task_42670,1963,250,140,186,326,7.820717131474104,39.89968556031327
Task_42671,1205,401,96,68,164,2.9975124378109452,27.043315223944827
Task_42672,2512,181,98,32,130,13.802197802197803,46.05351957401567
Task_42673,1913,217,111,193,304,8.775229357798166,38.901135089317
Task_42674,1554,359,110,130,240,4.316666666666666,33.332505614312375
Task_42675,2924,181,31,121,152,16.065934065934066,53.107218107037
Task_42676,532,900,170,71,241,0.5904550499445061,18.535829518623032
Task_42677,1870,125,117,63,180,14.841269841269842,36.08214268530691
Task_42678,571,322,64,53,117,1.7678018575851393,16.176047480636125
Task_42679,1678,149,174,190,364,11.186666666666667,34.89273972709389
Task_42680,2519,591,192,143,335,4.2550675675675675,49.80177930775261
Task_42681,1558,210,89,69,158,7.38388625592417,31.688833966448826
Task_42682,622,927,151,148,299,0.6702586206896551,20.70764662206622
Task_42683,696,326,87,157,244,2.128440366972477,19.721341527811813
Task_42684,1064,741,115,148,263,1.4339622641509433,26.84166393611784
Task_42685,1788,955,33,14,47,1.8702928870292888,36.124134254249036
Task_42686,1939,512,194,57,251,3.779727095516569,39.36136770530939
Task_42687,1880,641,143,71,214,2.9283489096573208,38.75341708396692
Task_42688,2431,891,117,144,261,2.725336322869955,49.02051328178839
Task_42689,1259,144,84,166,250,8.682758620689656,27.79423595189012
Task_42690,832,510,144,100,244,1.6281800391389432,22.346928605146815
Task_42691,2937,314,82,41,123,9.323809523809524,53.367529401722244
Task_42692,1352,722,96,37,133,1.8699861687413555,29.84578364908387
Task_42693,2674,588,106,54,160,4.539898132427844,50.59492325782162
Task_42694,581,994,141,112,253,0.5839195979899497,20.0100365222007
Task_42695,2863,750,153,95,248,3.8122503328894806,55.263925654414614
Task_42696,1310,315,149,184,333,4.1455696202531644,29.827679669978494
Task_42697,2513,740,189,196,385,3.3913630229419702,50.481486857134676
Task_42698,1452,259,11,122,133,5.584615384615384,30.658811713016735
Task_42699,520,519,20,137,157,1.0,16.548092944467893
Task_42700,1654,95,47,165,212,17.229166666666668,33.120038530704356
Task_42701,2433,836,11,71,82,2.9068100358422937,47.07541243030153
Task_42702,1828,527,42,87,129,3.462121212121212,37.35456927922078
Task_42703,2367,979,98,45,143,2.4153061224489796,46.603105682666644
Task_42704,1689,426,11,143,154,3.9555035128805622,34.97468288572278
Task_42705,1387,934,193,99,292,1.483422459893048,32.62781132338039
Task_42706,1187,367,148,123,271,3.2255434782608696,27.68210867855288
Task_42707,1601,764,92,141,233,2.09281045751634,35.420711355378955
Task_42708,520,437,46,133,179,1.187214611872146,16.65797636554606
Task_42709,1457,340,160,36,196,4.2727272727272725,30.724698356386085
Task_42710,1868,456,138,70,208,4.087527352297593,37.938619327026636
Task_42711,2298,213,11,118,129,10.738317757009346,43.868071025058136
Task_42712,2809,651,140,133,273,4.308282208588957,54.291574320927545
Task_42713,1457,134,159,114,273,10.792592592592593,30.722730623089717
Task_42714,2887,396,101,151,252,7.272040302267002,54.629709742457806
Task_42715,770,824,23,88,111,0.9333333333333333,21.209101722951694
Task_42716,1753,582,65,167,232,3.006861063464837,37.33914902204493
Task_42717,1321,349,18,125,143,3.7742857142857145,28.845374662363184
Task_42718,2741,563,96,100,196,4.859929078014185,52.591014571379866
Task_42719,2726,76,149,31,180,35.4025974025974,48.61875032114051
Task_42720,1906,830,173,31,204,2.2936221419975933,39.419229881723346
Task_42721,1362,619,120,191,311,2.196774193548387,31.52926434006
Task_42722,1943,366,134,165,299,5.294277929155314,39.82648339690257
Task_42723,992,994,20,143,163,0.9969849246231156,25.729845943101363
Task_42724,674,529,43,176,219,1.271698113207547,19.774316685874968
Task_42725,1843,722,120,122,242,2.549100968188105,39.05834563268204
Task_42726,2263,851,199,172,371,2.6561032863849765,46.770462734554165
Task_42727,2357,635,48,78,126,3.7059748427672954,46.112729278298104
Task_42728,1094,130,79,84,163,8.351145038167939,24.216568091942264
Task_42729,2011,777,110,31,141,2.5848329048843186,40.35865190915843
Task_42730,870,652,184,71,255,1.332312404287902,22.959734814109158
Task_42731,775,178,167,83,250,4.329608938547486,19.830079268721267
Task_42732,2229,367,69,29,98,6.057065217391305,42.15514679057117
Task_42733,1526,606,134,84,218,2.514003294892916,33.216063521246525
Task_42734,1398,773,85,10,95,1.806201550387597,30.094925498728767
Task_42735,536,761,112,159,271,0.7034120734908137,18.69227626251044
Task_42736,2297,185,40,48,88,12.349462365591398,42.53423425648406
Task_42737,895,860,112,158,270,1.0394889663182345,24.519459520792726
Task_42738,2597,929,77,185,262,2.79247311827957,51.960060133530106
Task_42739,1607,283,191,167,358,5.658450704225352,34.504445919515824
Task_42740,870,639,90,197,287,1.359375,23.700873966216054
Task_42741,1391,392,37,74,111,3.539440203562341,29.68519553322862
Task_42742,1582,502,94,113,207,3.1451292246520874,34.145032060126105
Task_42743,745,782,40,18,58,0.9514687100893997,19.286640956024872
Task_42744,2744,114,61,117,178,23.860869565217392,50.23009538270771
Task_42745,1045,123,108,24,132,8.42741935483871,22.488869531743187
Task_42746,2421,757,51,89,140,3.1939313984168867,47.57922404590797
Task_42747,638,399,115,181,296,1.595,19.28180531993986
Task_42748,2303,493,115,159,274,4.661943319838056,45.816145243454365
Task_42749,2177,336,198,86,284,6.459940652818991,42.980262360182074
Task_42750,1957,987,26,45,71,1.9807692307692308,39.16769985548677
Task_42751,600,461,53,99,152,1.2987012987012987,17.771106326339325
Task_42752,1042,366,120,19,139,2.8392370572207084,23.459944027530792
Task_42753,2102,496,183,135,318,4.229376257545272,42.8068942585539
Task_42754,1188,227,86,41,127,5.2105263157894735,25.47881479100882
Task_42755,1128,271,68,33,101,4.147058823529412,24.427027340085107
Task_42756,2004,912,138,141,279,2.1949616648411827,42.396773630309
Task_42757,2417,941,51,188,239,2.5658174097664546,49.115989681803306
Task_42758,1585,587,183,112,295,2.695578231292517,34.77247619506536
Task_42759,852,1023,171,157,328,0.83203125,24.645719561264873
Task_42760,1311,572,195,190,385,2.287958115183246,30.906338966761727
Task_42761,1035,306,146,132,278,3.3713355048859937,25.125812971525477
Task_42762,2139,750,112,198,310,2.848202396804261,44.253017970887264
Task_42763,637,606,36,47,83,1.0494233937397035,17.543051969363542
Task_42764,584,68,93,48,141,8.46376811594203,14.699101586675019
Task_42765,2399,908,94,181,275,2.639163916391639,48.76767083616607
Task_42766,1575,333,97,11,108,4.7155688622754495,31.675872348117185
Task_42767,907,415,128,59,187,2.1802884615384617,22.360124933896216
Task_42768,2881,890,20,84,104,3.2334455667789,54.74026354645568
Task_42769,2478,936,56,46,102,2.644610458911419,47.75825140479164
Task_42770,1454,203,40,126,166,7.127450980392157,30.720700702814906
Task_42771,1967,766,18,57,75,2.564537157757497,38.894511946445995
Task_42772,966,218,66,176,242,4.410958904109589,23.769164796553486
Task_42773,1522,536,55,22,77,2.834264432029795,30.74229497860682
Task_42774,2162,423,49,134,183,5.099056603773585,42.889003929064415
Task_42775,828,530,32,134,166,1.5593220338983051,21.887370003716054
Task_42776,560,927,73,13,86,0.603448275862069,17.861449100893367
Task_42777,1189,178,165,115,280,6.64245810055866,26.718928716452158
Task_42778,2483,431,125,117,242,5.747685185185185,48.25787898652556
Task_42779,1873,605,31,66,97,3.0907590759075907,37.616063173767486
Task_42780,2361,470,24,182,206,5.012738853503185,46.43004384194146
Task_42781,1489,125,105,111,216,11.817460317460318,30.92844638985574
Task_42782,2233,530,176,79,255,4.2052730696798495,44.33100062906882
Task_42783,2352,184,104,75,179,12.713513513513513,44.40610486714439
Task_42784,2971,875,86,35,121,3.391552511415525,55.713316790043535
Task_42785,1657,487,69,66,135,3.3954918032786887,34.28679669043303
Task_42786,1189,840,126,156,282,1.4137931034482758,29.22661936069919
Task_42787,2517,289,189,126,315,8.679310344827586,48.65655350360953
Task_42788,1074,244,54,64,118,4.383673469387755,24.14755761939708
Task_42789,2927,680,39,107,146,4.298091042584435,55.35850309909798
Task_42790,1280,1024,153,22,175,1.248780487804878,29.804191918949712
Task_42791,1420,909,55,167,222,1.5604395604395604,33.034444778350306
Task_42792,1440,394,178,76,254,3.6455696202531644,31.26486677452648
Task_42793,2314,469,65,152,217,4.923404255319149,45.770870700092324
Task_42794,2758,825,120,36,156,3.3389830508474576,52.40658133425929
Task_42795,673,515,99,149,248,1.304263565891473,19.88331475600025
Task_42796,630,561,163,85,248,1.1209964412811388,18.8924116314297
Task_42797,2847,314,159,173,332,9.038095238095238,54.108022652561374
Task_42798,1312,144,185,12,197,9.048275862068966,27.482531548391425
Task_42799,2188,696,15,165,180,3.139167862266858,44.089642181978554
Task_42800,1980,657,163,36,199,3.0091185410334345,40.02925683036208
Task_42801,1895,891,196,96,292,2.124439461883408,40.62048222785361
Task_42802,1902,72,66,117,183,26.054794520547944,36.592438029020144
Task_42803,2195,662,116,151,267,3.310708898944193,44.60071202009687
Task_42804,1215,968,189,68,257,1.2538699690402477,29.365842445042166
Task_42805,508,365,165,56,221,1.3879781420765027,16.15531569398334
Task_42806,1188,416,130,156,286,2.8489208633093526,27.970578097026465
Task_42807,2567,113,177,195,372,22.517543859649123,48.530243309710585
Task_42808,2809,459,94,64,158,6.106521739130435,52.365657507765
Task_42809,2923,279,111,189,300,10.439285714285715,55.063120292120836
Task_42810,1881,722,157,184,341,2.6016597510373445,40.19738877413315
Task_42811,1735,172,82,84,166,10.028901734104046,34.50573717313126
Task_42812,909,1023,157,74,231,0.8876953125,24.72104550521603
Task_42813,1653,869,159,176,335,1.9,37.00504313799918
Task_42814,910,356,94,79,173,2.549019607843137,22.463450584316405
Task_42815,1244,71,148,84,232,17.27777777777778,26.356285657969668
Task_42816,2452,997,11,11,22,2.4569138276553106,46.59587645799645
Task_42817,2315,128,32,19,51,17.94573643410853,41.617444938015545
Task_42818,2179,724,67,105,172,3.0055172413793105,44.0974222998748
Task_42819,2709,1010,159,23,182,2.679525222551929,52.36327015045968
Task_42820,1281,185,97,20,117,6.887096774193548,26.433251293277205
Task_42821,1114,989,161,199,360,1.1252525252525252,28.823662844472253
Task_42822,849,683,189,107,296,1.2412280701754386,23.28961244093112
Task_42823,1228,319,162,90,252,3.8375,27.876419063897405
Task_42824,911,544,34,26,60,1.6715596330275229,21.220767342661038
Task_42825,1625,661,88,72,160,2.4546827794561934,34.26259374563688
Task_42826,2400,416,112,141,253,5.755395683453237,46.97977528321101
Task_42827,2529,440,91,167,258,5.73469387755102,49.210118019040664
Task_42828,2255,617,45,41,86,3.6488673139158574,43.15154938054275
Task_42829,1310,706,86,108,194,1.852899575671853,30.37042502923732
Task_42830,913,372,60,92,152,2.447721179624665,22.497661701283665
Task_42831,2383,745,193,117,310,3.1943699731903483,47.98396921053091
Task_42832,1397,299,198,102,300,4.656666666666666,30.881550049249494
Task_42833,1907,481,47,76,123,3.9564315352697097,38.29216499194823
Task_42834,2335,792,34,196,230,2.9445145018915513,47.15414012502665
Task_42835,577,459,78,49,127,1.2543478260869565,16.720932142871124
Task_42836,1320,114,13,27,40,11.478260869565217,25.869650357862856
Task_42837,1613,105,112,42,154,15.216981132075471,31.203950283760904
Task_42838,2153,536,137,128,265,4.009310986964619,43.493241990305876
Task_42839,2976,689,38,72,110,4.3130434782608695,55.63297575479617
Task_42840,2615,831,96,122,218,3.1430288461538463,51.57495849174069
Task_42841,720,396,37,73,110,1.81360201511335,19.020769401313796
Task_42842,738,620,40,115,155,1.1884057971014492,20.375343302139214
Task_42843,1446,668,135,140,275,2.1614349775784754,32.775974627319485
Task_42844,2059,490,175,41,216,4.193482688391039,40.819182931
Task_42845,1108,392,106,166,272,2.8193384223918576,26.579771724650154
Task_42846,816,657,181,34,215,1.2401215805471124,21.654215589404743
Task_42847,2718,91,115,67,182,29.543478260869566,48.92448957855985
Task_42848,1651,353,154,130,284,4.663841807909605,35.04558674121525
Task_42849,1258,136,61,157,218,9.182481751824817,27.565613434748414
Task_42850,2784,1001,177,173,350,2.7784431137724552,55.40117342977654
Task_42851,914,970,74,75,149,0.94129763130793,24.22426683444377
Task_42852,1962,754,186,15,201,2.5986754966887418,39.878677845867614
Task_42853,2207,536,123,128,251,4.109869646182496,44.285149509326374
Task_42854,2345,464,170,20,190,5.043010752688172,44.94008945307599
Task_42855,2326,583,194,54,248,3.982876712328767,45.74146386228926
Task_42856,2379,146,171,115,286,16.183673469387756,45.409418562747994
Task_42857,1087,673,76,163,239,1.6127596439169138,27.101488246501106
Task_42858,1212,779,188,156,344,1.5538461538461539,29.706746599682244
Task_42859,2200,455,123,51,174,4.824561403508772,42.91621164439656
Task_42860,2098,353,199,64,263,5.926553672316384,41.46975856606533
Task_42861,2669,617,10,130,140,4.318770226537217,51.058359305534346
Task_42862,2801,342,83,134,217,8.166180758017493,52.95631274829722
Task_42863,2071,401,80,119,199,5.151741293532338,41.57595527658817
Task_42864,1978,271,179,191,370,7.272058823529412,40.416490057099224
Task_42865,555,574,75,103,178,0.9652173913043478,17.697514409633175
Task_42866,1179,817,188,66,254,1.441320293398533,28.310329225578986
Task_42867,2444,989,65,98,163,2.4686868686868686,48.980435603823366
Task_42868,1072,544,91,149,240,1.9669724770642203,26.36971159158959
Task_42869,977,677,133,161,294,1.4410029498525074,25.42343990183164
Task_42870,2740,136,104,57,161,20.0,49.667785510078545
Task_42871,1837,82,50,172,222,22.132530120481928,36.11614339537329
Task_42872,2982,997,117,198,315,2.987975951903808,58.40530173879764
Task_42873,788,508,46,22,68,1.5481335952848723,19.109143393668376
Task_42874,1287,99,92,110,202,12.87,27.36232898522448
Task_42875,1972,330,199,52,251,5.957703927492447,39.371135485803265
Task_42876,814,628,166,25,191,1.2941176470588236,21.3681530654224
Task_42877,2619,459,169,178,347,5.693478260869565,51.06484343031087
Task_42878,1043,433,57,11,68,2.403225806451613,22.689793950700263
Task_42879,2687,916,56,173,229,2.93020719738277,53.21200536782706
Task_42880,918,709,198,124,322,1.2929577464788733,24.63651039600865
Task_42881,1332,821,144,175,319,1.6204379562043796,31.682868836279237
Task_42882,800,428,193,56,249,1.8648018648018647,21.128983950871127
Task_42883,1284,765,25,104,129,1.6762402088772845,29.635400587312535
Task_42884,1678,687,11,132,143,2.438953488372093,35.6125557683672
Task_42885,2204,963,87,53,140,2.2863070539419086,44.275488790542376
Task_42886,1156,588,134,154,288,1.9626485568760612,28.011980236105043
Task_42887,2430,294,196,127,323,8.23728813559322,47.33635135759342
Task_42888,2503,758,149,155,304,3.297760210803689,49.95451643090718
Task_42889,2440,120,81,141,222,20.165289256198346,46.01494279641383
Task_42890,580,323,42,180,222,1.7901234567901234,17.817036577966928
Task_42891,818,613,135,33,168,1.3322475570032573,21.16712639730824
Task_42892,1857,253,34,71,105,7.311023622047244,36.35146675402688
Task_42893,1519,258,79,159,238,5.864864864864865,32.60652490919971
Task_42894,2301,179,86,187,273,12.783333333333333,44.369801741066574
Task_42895,2691,1009,79,27,106,2.6643564356435645,51.5308473815783
Task_42896,1900,869,154,80,234,2.1839080459770117,40.03750787620097
Task_42897,1952,966,96,114,210,2.018614270941055,41.44304365771492
Task_42898,2679,253,16,90,106,10.547244094488189,49.53587689624723
Task_42899,961,505,188,181,369,1.8992094861660078,25.06912914384256
Task_42900,1122,228,175,18,193,4.899563318777292,24.78201762331275
Task_42901,905,78,96,99,195,11.455696202531646,21.126000254290137
Task_42902,612,956,178,89,267,0.6394984326018809,20.206741761610257
Task_42903,2489,538,163,163,326,4.617810760667903,49.14594130517219
Task_42904,2551,1003,70,49,119,2.5408366533864544,49.54112522009768
Task_42905,1838,282,183,86,269,6.4946996466431095,37.36855587897343
Task_42906,1137,156,149,146,295,7.24203821656051,26.041395278850427
Task_42907,2310,417,43,157,200,5.526315789473684,45.35702756729336
Task_42908,1370,352,35,154,189,3.8810198300283285,30.206982777129884
Task_42909,1554,490,118,39,157,3.164969450101833,32.244198952032555
Task_42910,2723,786,142,48,190,3.45997458703939,52.15706098154268
Task_42911,810,513,200,33,233,1.575875486381323,21.197083112205238
Task_42912,2077,618,198,108,306,3.355411954765751,42.70562395233998
Task_42913,1853,282,84,196,280,6.5477031802120145,38.127889581844734
Task_42914,1486,389,68,15,83,3.81025641025641,30.11327219852916
Task_42915,1192,602,25,196,221,1.976782752902156,28.434040810604305
Task_42916,1491,358,185,118,303,4.153203342618385,32.599003602654626
Task_42917,1157,645,132,14,146,1.7910216718266254,26.31866330980853
Task_42918,1783,798,161,37,198,2.2315394242803506,37.35824381096692
Task_42919,695,121,148,22,170,5.69672131147541,17.220168332091667
Task_42920,2737,483,175,10,185,5.654958677685951,51.1018551062333
Task_42921,2818,801,145,121,266,3.513715710723192,54.85902413635207
Task_42922,1419,208,42,191,233,6.7894736842105265,30.759217742890076
Task_42923,2937,158,32,142,174,18.471698113207548,53.762250900445906
Task_42924,1544,410,177,146,323,3.75669099756691,33.737082477133825
Task_42925,2955,195,175,112,287,15.076530612244898,55.00876888044912
Task_42926,927,956,136,72,208,0.9686520376175548,24.650711986068412
Task_42927,2324,631,54,120,174,3.6772151898734178,46.175077267278674
Task_42928,2449,344,22,49,71,7.098550724637681,45.02107175492108
Task_42929,2044,345,108,42,150,5.907514450867052,39.49968659144767
Task_42930,2669,148,24,112,136,17.91275167785235,48.84486696152283
Task_42931,2903,774,82,109,191,3.745806451612903,55.857465901213466
Task_42932,1267,315,53,57,110,4.0094936708860756,27.049345099884633
Task_42933,641,283,73,76,149,2.257042253521127,17.721343701660007
Task_42934,1684,646,91,144,235,2.6027820710973724,36.35154708229839
Task_42935,2609,246,173,186,359,10.562753036437247,50.24029578553691
Task_42936,1401,691,73,41,114,2.0245664739884393,30.282886825929296
Task_42937,874,593,28,94,122,1.4713804713804715,22.405860291207812
Task_42938,1573,494,125,50,175,3.1777777777777776,32.950925757508166
Task_42939,2759,319,80,39,119,8.621875,50.51741072343276
Task_42940,2887,900,129,198,327,3.2042175360710323,56.6507014994365
Task_42941,1676,455,171,151,322,3.675438596491228,35.97346463448277
Task_42942,2321,951,191,77,268,2.438025210084034,47.03936843337035
Task_42943,1284,722,102,19,121,1.7759336099585061,28.233730580838298
Task_42944,1700,802,129,175,304,2.1170610211706102,37.399936901075684
Task_42945,1855,881,54,116,170,2.1031746031746033,39.38232057580511
Task_42946,829,940,12,70,82,0.8809776833156217,22.005874942944175
Task_42947,2011,689,100,194,294,2.9144927536231884,41.95596130376383
Task_42948,751,859,66,34,100,0.8732558139534884,20.39932618630455
Task_42949,1451,581,125,65,190,2.493127147766323,31.636189332141115
Task_42950,1128,184,79,135,214,6.097297297297297,25.882657369193435
Task_42951,1009,954,42,183,225,1.056544502617801,26.35588036591952
Task_42952,2600,1002,193,76,269,2.59222333000997,51.61973664252137
Task_42953,535,943,25,117,142,0.5667372881355932,18.305896253892524
Task_42954,2445,164,32,56,88,14.818181818181818,44.71512509680099
Task_42955,2301,682,129,185,314,3.3689604685212298,46.60443009066338
Task_42956,2780,986,67,150,217,2.81661600810537,54.78005161645561
Task_42957,843,563,140,134,274,1.4946808510638299,22.842277097193065
Task_42958,2163,133,81,53,134,16.14179104477612,40.376884002617494
Task_42959,1471,620,165,100,265,2.368760064412238,32.9179522811897
Task_42960,1304,867,196,17,213,1.5023041474654377,29.765553945413803
Task_42961,1912,943,175,51,226,2.0254237288135593,40.19819109612331
Task_42962,1865,610,121,65,186,3.0523731587561374,38.12862194261208
Task_42963,1941,258,189,24,213,7.494208494208494,38.10363246091327
Task_42964,1226,579,170,56,226,2.113793103448276,28.243332607939347
Task_42965,2152,795,123,80,203,2.7035175879396984,43.65944433273071
Task_42966,912,650,104,51,155,1.400921658986175,22.806867596112216
Task_42967,2484,77,35,76,111,31.846153846153847,44.74519392412112
Task_42968,1820,691,90,190,280,2.6300578034682083,38.91709850721788
Task_42969,1472,267,88,186,274,5.492537313432836,31.98525541196806
Task_42970,822,370,97,110,207,2.215633423180593,21.63349995670932
Task_42971,709,341,133,144,277,2.073099415204678,20.09571324211993
Task_42972,2764,851,69,113,182,3.244131455399061,53.709293251327715
Task_42973,911,510,42,17,59,1.7827788649706457,20.821254420902594
Task_42974,2403,791,71,172,243,3.034090909090909,48.35084950840854
Task_42975,1109,865,122,37,159,1.2806004618937645,26.40458902068605
Task_42976,1887,982,80,111,191,1.9196337741607326,40.447136381445894
Task_42977,897,120,117,95,212,7.413223140495868,21.52421335265602
Task_42978,1343,783,87,69,156,1.7130102040816326,30.059174486949157
Task_42979,2404,657,146,60,206,3.653495440729483,46.96304863636775
Task_42980,2873,351,28,38,66,8.161931818181818,51.683917768494744
Task_42981,1081,662,78,189,267,1.6304675716440422,27.129030151603256
Task_42982,1768,902,66,34,100,1.9579180509413068,36.48918482639285
Task_42983,2761,820,136,92,228,3.3629719853836786,53.701163865775236
Task_42984,2968,615,83,189,272,4.818181818181818,56.82621490435093
Task_42985,873,979,160,63,223,0.8908163265306123,23.897390541605986
Task_42986,962,770,123,100,223,1.2477302204928664,25.01028888831783
Task_42987,2642,910,104,156,260,2.9001097694840836,52.436323457324896
Task_42988,2071,280,183,55,238,7.370106761565836,40.69768116537991
Task_42989,1115,969,26,75,101,1.1494845360824741,26.96379910289859
Task_42990,2234,467,78,28,106,4.773504273504273,42.58293381673726
Task_42991,1330,992,37,164,201,1.339375629405841,31.572927797814376
Task_42992,813,134,145,95,240,6.022222222222222,20.36791136971407
Task_42993,1037,490,16,113,129,2.1120162932790225,24.801256738413638
Task_42994,1639,206,181,183,364,7.917874396135265,34.790169403056574
Task_42995,1919,747,105,104,209,2.5655080213903743,40.16542446792578
Task_42996,1432,581,146,53,199,2.4604810996563575,31.404126536341938
Task_42997,911,525,31,43,74,1.731939163498099,21.208466560542693
Task_42998,561,643,33,161,194,0.8711180124223602,18.211542020392827
Task_42999,801,980,117,170,287,0.8165137614678899,23.555038790254383
Task_43000,1587,283,129,84,213,5.588028169014085,33.119393132661905
Task_43001,2060,588,60,160,220,3.497453310696095,42.15806392829408
Task_43002,2339,283,105,134,239,8.235915492957746,45.490698610353526
Task_43003,1424,324,65,24,89,4.381538461538462,29.00442759888678
Task_43004,2433,807,80,58,138,3.011138613861386,47.414153065887746
Task_43005,2137,261,180,21,201,8.15648854961832,41.1073679974242
Task_43006,2427,624,169,19,188,3.8832,46.67916685804874
Task_43007,882,906,132,192,324,0.9724366041896362,24.795900186534425
Task_43008,1055,559,27,195,222,1.8839285714285714,26.125486984266164
Task_43009,2341,963,83,76,159,2.4284232365145226,46.67291834060175
Task_43010,2829,947,138,28,166,2.9841772151898733,54.05576441510136
Task_43011,1594,797,123,98,221,1.9974937343358397,35.221319454015
Task_43012,1120,459,73,35,108,2.4347826086956523,25.006526054314488
Task_43013,1945,596,182,134,316,3.257956448911223,40.62879689500949
Task_43014,2738,472,170,114,284,5.788583509513742,52.613233873307784
Task_43015,1630,498,98,28,126,3.2665330661322645,33.4083182855346
Task_43016,1845,478,154,68,222,3.8517745302713986,37.709196986292746
Task_43017,1854,892,33,114,147,2.0761478163493843,39.078548657649996
Task_43018,1152,78,183,36,219,14.582278481012658,24.30651028658072
Task_43019,946,179,15,173,188,5.2555555555555555,22.493794335332257
Task_43020,1595,689,35,146,181,2.3115942028985508,34.63761564092416
Task_43021,2545,75,134,128,262,33.48684210526316,47.11267237415407
Task_43022,897,703,58,48,106,1.2741477272727273,22.005123010896728
Task_43023,2089,699,38,173,211,2.9842857142857144,42.83046392517573
Task_43024,1277,584,119,109,228,2.1829059829059827,29.579216661208886
Task_43025,597,123,154,79,233,4.814516129032258,16.67789875847181
Task_43026,2305,803,156,50,206,2.866915422885572,45.72648646749328
Task_43027,2642,640,100,18,118,4.121684867394696,49.441698791745615
Task_43028,1299,616,161,101,262,2.1053484602917343,30.16934570956239
Task_43029,1681,739,91,57,148,2.2716216216216214,35.29331088646007
Task_43030,1010,113,43,64,107,8.859649122807017,21.81191506189866
Task_43031,2929,685,88,163,251,4.269679300291545,56.26472099222344
Task_43032,2254,145,81,157,238,15.438356164383562,43.429300558391795
Task_43033,1697,655,69,173,242,2.586890243902439,36.73198840480052
Task_43034,590,891,178,79,257,0.6614349775784754,19.60316769400878
Task_43035,1314,891,72,143,215,1.4730941704035874,31.190183019399424
Task_43036,634,872,139,45,184,0.7262313860252004,19.251264858301855
Task_43037,1466,701,75,76,151,2.0883190883190883,32.04825505289972
Task_43038,2023,87,79,22,101,22.988636363636363,37.03560366379461
Task_43039,573,126,139,145,284,4.511811023622047,16.8846988011265
Task_43040,2212,685,157,65,222,3.2244897959183674,44.173557677273585
Task_43041,1620,204,104,163,267,7.902439024390244,34.016365447451406
Task_43042,676,809,121,80,201,0.8345679012345679,20.28958787798884
Task_43043,2655,692,26,161,187,3.831168831168831,51.639402775725074
Task_43044,1887,275,66,55,121,6.836956521739131,36.96180968311388
Task_43045,613,129,124,33,157,4.7153846153846155,15.81692203358527
Task_43046,2817,255,137,140,277,11.00390625,53.12347476304567
Task_43047,2865,648,149,103,252,4.414483821263483,55.030365816466826
Task_43048,2653,901,90,174,264,2.9412416851441243,52.676161958817026
Task_43049,2522,653,164,182,346,3.856269113149847,50.15307117849238
Task_43050,2339,109,109,63,172,21.263636363636362,43.19266685987327
Task_43051,744,263,147,60,207,2.8181818181818183,19.436784555579
Task_43052,2476,527,146,18,164,4.6893939393939394,46.95550427606551
Task_43053,2524,1006,162,196,358,2.506454816285998,51.366284333094995
Task_43054,2223,148,144,96,240,14.919463087248323,42.772180231565365
Task_43055,1201,689,49,41,90,1.7405797101449276,26.727202111324846
Task_43056,1734,204,117,11,128,8.458536585365854,34.06940868042412
Task_43057,1734,931,124,20,144,1.8605150214592274,36.277960220692
Task_43058,1395,718,165,127,292,1.9401947148817802,32.18179169454194
Task_43059,642,139,72,97,169,4.585714285714285,17.3520089967849
Task_43060,2519,252,117,146,263,9.956521739130435,48.34932938239147
Task_43061,1787,267,81,33,114,6.667910447761194,34.97539421139877
Task_43062,1507,325,186,91,277,4.622699386503068,32.441038789785814
Task_43063,1690,491,123,73,196,3.434959349593496,35.22094972490769
Task_43064,2430,481,124,83,207,5.04149377593361,47.08109717152204
Task_43065,862,497,99,26,125,1.7309236947791165,21.139476692741024
Task_43066,1835,543,166,21,187,3.3731617647058822,37.15583367620511
Task_43067,1222,89,132,33,165,13.577777777777778,25.22642893227334
Task_43068,1699,903,181,126,307,1.8794247787610618,37.64012655570913
Task_43069,1518,587,48,72,120,2.5816326530612246,32.39311528975118
Task_43070,1770,306,178,200,378,5.765472312703583,37.29764374999653
Task_43071,2810,179,138,169,307,15.61111111111111,52.50420301226365
Task_43072,1241,717,67,91,158,1.7284122562674096,28.782158035911447
Task_43073,2028,759,78,186,264,2.668421052631579,42.42855775268047
Task_43074,1638,388,175,56,231,4.210796915167095,34.18090594382712
Task_43075,785,606,52,43,95,1.2932454695222406,19.952587134775985
Task_43076,2973,134,103,50,153,22.022222222222222,52.94803127911941
Task_43077,1611,74,169,147,316,21.48,32.79015484330896
Task_43078,1299,521,86,187,273,2.4885057471264367,30.08883626091212
Task_43079,2064,865,38,67,105,2.3833718244803697,41.55983026344954
Task_43080,2506,906,14,91,105,2.762954796030871,49.00186277727179
Task_43081,1230,766,24,90,114,1.6036505867014341,28.53191385480665
Task_43082,2281,220,32,134,166,10.321266968325792,43.883762406858466
Task_43083,2895,104,87,151,238,27.571428571428573,52.75476878349395
Task_43084,567,521,43,117,160,1.0862068965517242,17.282974084560987
Task_43085,2850,465,195,130,325,6.115879828326181,54.5714273107636
Task_43086,2869,317,182,191,373,9.022012578616351,54.6776590649518
Task_43087,1659,283,93,182,275,5.841549295774648,35.08628660661645
Task_43088,736,1003,58,95,153,0.7330677290836654,21.678111946783503
Task_43089,1340,550,164,102,266,2.4319419237749544,30.63109286289179
Task_43090,1943,259,32,68,100,7.473076923076923,37.68296982593014
Task_43091,2481,139,14,79,93,17.72142857142857,45.28921724091489
Task_43092,2324,81,20,66,86,28.341463414634145,41.91641983061944
Task_43093,1907,746,192,52,244,2.5528781793842037,39.64149360760348
Task_43094,968,620,152,134,286,1.5587761674718197,25.053498987848602
Task_43095,653,425,53,43,96,1.5328638497652582,17.27776266249047
Task_43096,1055,195,54,28,82,5.38265306122449,22.850695683395305
Task_43097,2226,336,151,56,207,6.605341246290801,43.20242287248635
Task_43098,2400,440,49,171,220,5.442176870748299,47.11455580736136
Task_43099,2213,506,32,144,176,4.3648915187376724,43.85653073247073
Task_43100,1328,333,77,190,267,3.9760479041916166,30.00847372114886
Task_43101,2210,886,27,154,181,2.491544532130778,45.019494146946265
Task_43102,1477,255,67,156,223,5.76953125,31.852062911183165
Task_43103,1150,940,41,80,121,1.2221041445270988,27.567647524786697
Task_43104,2686,610,109,32,141,4.396072013093289,50.525374567954145
Task_43105,504,735,168,167,335,0.6847826086956522,18.434418425419974
Task_43106,2099,584,54,192,246,3.588034188034188,42.95819357318775
Task_43107,1597,916,123,164,287,1.7415485278080698,36.01641182192079
Task_43108,1871,962,137,191,328,1.9428868120456906,40.73890658541854
Task_43109,711,932,132,49,181,0.7620578778135049,20.641579068901486
Task_43110,1291,225,124,63,187,5.712389380530974,27.880088957053697
Task_43111,960,700,162,164,326,1.369472182596291,25.381230710163823
Task_43112,2997,187,161,24,185,15.941489361702128,54.39676701249832
Task_43113,1417,571,90,144,234,2.477272727272727,31.88299839319085
Task_43114,2950,718,83,121,204,4.1029207232267035,56.462554484088486
Task_43115,1350,359,197,112,309,3.75,30.3900234096114
Task_43116,2238,435,147,123,270,5.13302752293578,44.52847227848098
Task_43117,503,442,22,156,178,1.1354401805869074,16.368410375295657
Task_43118,2871,588,115,145,260,4.874363327674024,55.03140011506747
Task_43119,2786,287,184,158,342,9.67361111111111,53.07043311070371
Task_43120,2130,986,174,66,240,2.1580547112462005,43.87519279113449
Task_43121,2845,643,71,189,260,4.417701863354037,54.98678678233779
Task_43122,771,802,101,24,125,0.9601494396014943,20.825409401230146
Task_43123,513,903,25,30,55,0.5674778761061947,16.141427788162392
Task_43124,1788,741,75,177,252,2.4097035040431267,38.508275067600785
Task_43125,1843,812,154,19,173,2.2669126691266914,37.89756948625711
Task_43126,1249,644,37,200,237,1.9364341085271317,29.517425769675114
Task_43127,2411,689,144,182,326,3.4942028985507245,48.41857829571063
Task_43128,696,675,120,191,311,1.029585798816568,21.027132954866833
Task_43129,1443,809,33,167,200,1.7814814814814814,32.90397624177617
Task_43130,1969,297,151,125,276,6.60738255033557,39.843737841643545
Task_43131,1333,256,51,154,205,5.186770428015564,29.569726040348545
Task_43132,2371,666,68,68,136,3.55472263868066,46.184354184951935
Task_43133,1534,569,81,156,237,2.6912280701754385,33.814956044753096
Task_43134,971,209,184,131,315,4.623809523809523,23.957854417869402
Task_43135,879,304,185,159,344,2.8819672131147542,22.989820174472026
Task_43136,523,367,119,196,315,1.421195652173913,17.41462362017675
Task_43137,911,969,145,155,300,0.9391752577319588,25.298174816136456
Task_43138,1382,880,145,71,216,1.568671963677639,31.602532263611607
Task_43139,1887,1001,80,79,159,1.8832335329341316,39.72653192309142
Task_43140,1551,141,40,195,235,10.922535211267606,32.264317349839494
Task_43141,699,664,161,42,203,1.0511278195488722,19.73003003528819
Task_43142,2975,354,123,62,185,8.380281690140846,54.81046655413243
Task_43143,694,798,16,51,67,0.8685857321652065,18.982230813206925
Task_43144,975,911,27,74,101,1.069078947368421,24.475392880080364
Task_43145,2391,71,30,60,90,33.208333333333336,42.82746685942865
Task_43146,1309,228,128,104,232,5.716157205240175,28.947040363454718
Task_43147,1457,636,111,193,304,2.2872841444270016,33.058467367999484
Task_43148,2646,761,146,19,165,3.47244094488189,50.43995896690424
Task_43149,932,534,108,70,178,1.7420560747663552,23.025621389785176
Task_43150,1415,914,153,192,345,1.546448087431694,33.39946878167415
Task_43151,1017,491,192,15,207,2.067073170731707,24.11493127342492
Task_43152,845,119,164,146,310,7.041666666666667,21.23351184864074
Task_43153,1985,621,39,12,51,3.1913183279742765,38.26493762633942
Task_43154,1757,822,10,198,208,2.134872417982989,37.96838748025099
Task_43155,1177,152,13,137,150,7.69281045751634,25.494573111263332
Task_43156,1594,71,118,114,232,22.13888888888889,32.062403188396644
Task_43157,1315,221,145,37,182,5.923423423423423,27.851004831317052
Task_43158,2936,117,121,10,131,24.88135593220339,52.22444075706479
Task_43159,1853,289,154,16,170,6.389655172413793,36.315673615109596
Task_43160,809,328,44,53,97,2.4589665653495443,19.784040076985317
Task_43161,2917,849,199,17,216,3.431764705882353,55.31835007958784
Task_43162,1862,251,64,22,86,7.388888888888889,35.60778567971529
Task_43163,2418,309,63,195,258,7.8,47.133723763667625
Task_43164,618,926,89,11,100,0.6666666666666666,18.66243651429362
Task_43165,1337,678,195,196,391,1.9690721649484537,31.68562549964108
Task_43166,873,660,160,126,286,1.3207261724659607,23.66384852402993
Task_43167,2273,762,91,114,205,2.979030144167759,45.86635743027236
Task_43168,1448,983,86,115,201,1.4715447154471544,33.40281784454325
Task_43169,2313,393,38,144,182,5.870558375634518,45.041650623940974
Task_43170,2501,916,42,188,230,2.727371864776445,50.146181350911796
Task_43171,2927,212,98,189,287,13.741784037558686,54.82384138136498
Task_43172,1230,528,69,151,220,2.325141776937618,28.806209574555353
Task_43173,2168,252,73,82,155,8.569169960474309,41.82742080590962
Task_43174,1900,815,43,174,217,2.3284313725490198,40.229203117183445
Task_43175,2611,75,72,97,169,34.35526315789474,47.71707854464234
Task_43176,1829,764,37,35,72,2.3908496732026143,36.45279223854775
Task_43177,2609,427,91,65,156,6.095794392523365,49.06260293988084
Task_43178,2601,112,128,132,260,23.01769911504425,48.33412558132855
Task_43179,727,571,77,126,203,1.270979020979021,20.76739159876529
Task_43180,1525,678,44,68,112,2.2459499263622975,32.57631869051365
Task_43181,1328,148,147,199,346,8.912751677852349,29.305561665531727
Task_43182,2623,896,148,194,342,2.9241917502787067,52.51677916650402
Task_43183,671,324,119,121,240,2.0646153846153847,19.240301970872032
Task_43184,1165,744,73,18,91,1.563758389261745,26.23737190180415
Task_43185,2600,905,150,193,343,2.869757174392936,52.183512520945534
Task_43186,1633,845,13,85,98,1.9302600472813238,34.81519261531597
Task_43187,775,233,155,46,201,3.3119658119658117,19.599918207928003
Task_43188,2819,678,171,145,316,4.151693667157585,54.747098813456205
Task_43189,732,985,145,105,250,0.742393509127789,22.15831804579229
Task_43190,1115,1010,42,125,167,1.1028684470820969,27.65359448012515
Task_43191,1962,727,123,185,308,2.6950549450549453,41.34891272967681
Task_43192,1033,1024,20,183,203,1.0078048780487805,26.82101068575943
Task_43193,601,1002,67,132,199,0.5992023928215354,20.307914469675907
Task_43194,812,897,13,175,188,0.9042316258351893,22.991602972996166
Task_43195,1854,281,167,184,351,6.574468085106383,38.39534832866857
Task_43196,572,361,12,168,180,1.580110497237569,17.375084072601805
Task_43197,606,494,62,40,102,1.2242424242424241,16.735888931278286
Task_43198,876,970,28,44,72,0.90216271884655,22.080903293803374
Task_43199,1394,764,120,60,180,1.8222222222222222,30.997004791783738
Task_43200,658,269,152,43,195,2.437037037037037,17.84570262815147
Task_43201,2258,159,131,160,291,14.1125,43.72771640843484
Task_43202,2968,699,137,123,260,4.24,56.88920014299623
Task_43203,1243,984,87,102,189,1.2619289340101523,29.959627745160585
Task_43204,2167,876,155,170,325,2.4709236031927024,45.11718113731097
Task_43205,1790,832,115,18,133,2.148859543817527,36.78701794618942
Task_43206,2266,151,108,11,119,14.907894736842104,41.67379705701159
Task_43207,1518,112,16,133,149,13.43362831858407,30.274370798096797
Task_43208,2772,887,62,197,259,3.1216216216216215,54.607843552141105
Task_43209,2958,976,39,184,223,3.0276356192425795,57.5366352739912
Task_43210,1122,502,180,20,200,2.2306163021868786,25.757411924551377
Task_43211,2124,164,159,65,224,12.872727272727273,40.86577457224499
Task_43212,1468,756,18,40,58,1.9392338177014532,30.753934753145895
Task_43213,1418,754,118,151,269,1.8781456953642384,32.5898470258193
Task_43214,1338,521,58,40,98,2.5632183908045976,28.360402166950152
Task_43215,2244,145,172,42,214,15.36986301369863,42.304220658880254
Task_43216,2523,460,186,100,286,5.4728850325379605,49.15929471483194
Task_43217,2396,108,88,127,215,21.98165137614679,44.82441060475991
Task_43218,753,70,114,42,156,10.605633802816902,17.33587762311546
Task_43219,1251,600,125,146,271,2.08153078202995,29.46562973606657
Task_43220,2715,848,199,100,299,3.197879858657244,53.492625988278725
Task_43221,1979,709,108,147,255,2.787323943661972,41.267190645080824
Task_43222,1162,800,53,51,104,1.4506866416978776,26.72290073203428
Task_43223,2080,621,62,180,242,3.3440514469453375,42.70769735934119
Task_43224,1971,610,170,119,289,3.2258592471358427,40.941111121178686
Task_43225,1266,347,102,169,271,3.6379310344827585,28.934697492712697
Task_43226,748,230,59,137,196,3.238095238095238,20.133967307823678
Task_43227,1870,585,107,57,164,3.1911262798634814,38.02482850934984
Task_43228,1228,567,116,15,131,2.1619718309859155,27.141781172568923
Task_43229,1247,1022,129,150,279,1.2189638318670577,30.63233179097216
Task_43230,537,370,193,171,364,1.4474393530997305,17.829714341785664
Task_43231,860,499,129,160,289,1.72,23.04658270818634
Task_43232,2635,948,135,105,240,2.7766069546891465,52.2791928612477
Task_43233,2564,552,151,99,250,4.636528028933093,49.927258310815716
Task_43234,555,634,97,160,257,0.8740157480314961,18.440754258907997
Task_43235,1894,408,53,65,118,4.63080684596577,37.69183777738377
Task_43236,932,678,134,168,302,1.3726067746686303,24.767058191300716
Task_43237,604,871,170,36,206,0.6926605504587156,19.21301336647146
Task_43238,2695,282,175,35,210,9.522968197879859,50.168768519076245
Task_43239,1488,627,15,117,132,2.3694267515923566,32.44082470086261
Task_43240,1113,900,187,149,336,1.2352941176470589,28.386697213815328
Task_43241,2534,204,121,174,295,12.360975609756098,48.587064385353465
Task_43242,1010,70,162,175,337,14.225352112676056,23.482725697902538
Task_43243,2332,430,28,101,129,5.410672853828307,45.18352119732037
Task_43244,1199,650,38,31,69,1.8417818740399385,26.0983794232383
Task_43245,1734,396,65,49,114,4.367758186397985,34.604731147178676
Task_43246,1396,461,71,82,153,3.0216450216450217,30.2636904420867
Task_43247,678,189,175,28,203,3.568421052631579,18.003505427653227
Task_43248,2764,491,87,112,199,5.617886178861789,52.709277943630745
Task_43249,1244,177,200,130,330,6.98876404494382,27.809545862318288
Task_43250,1382,786,141,200,341,1.7560355781448538,32.50203528643352
Task_43251,969,764,12,147,159,1.2666666666666666,24.56107958456119
Task_43252,2997,399,195,112,307,7.4925,56.571088580739946
Task_43253,1690,75,142,121,263,22.236842105263158,33.72137413630279
Task_43254,2022,413,185,24,209,4.884057971014493,39.888276603949166
Task_43255,1201,202,121,84,205,5.916256157635468,26.70602857719082
Task_43256,961,367,184,64,248,2.6114130434782608,23.46143195587788
Task_43257,2786,239,166,14,180,11.608333333333333,50.946397011850905
Task_43258,2584,626,35,42,77,4.121212121212121,47.99053111608551
Task_43259,1308,517,16,70,86,2.525096525096525,28.292299506323598
Task_43260,1862,721,140,169,309,2.5789473684210527,39.727063652029514
Task_43261,1363,407,162,159,321,3.340686274509804,30.873286748553724
Task_43262,2550,452,117,150,267,5.629139072847682,49.548186606970795
Task_43263,637,998,38,121,159,0.6376376376376376,20.139092120664646
Task_43264,1915,874,21,54,75,2.1885714285714286,38.4356493346013
Task_43265,2598,415,29,189,218,6.2451923076923075,50.063392398664945
Task_43266,1586,763,82,77,159,2.075916230366492,34.12839904632298
Task_43267,1751,392,106,89,195,4.455470737913486,36.10439037190728
Task_43268,2698,956,22,111,133,2.819226750261233,52.55677920639869
Task_43269,2293,988,80,116,196,2.3185035389282103,46.92945933432507
Task_43270,2022,82,123,147,270,24.36144578313253,39.064194579039246
Task_43271,1632,233,162,130,292,6.9743589743589745,34.37482051303036
Task_43272,2545,646,85,64,149,3.9335394126738796,48.75825911129238
Task_43273,1936,566,80,18,98,3.4144620811287476,37.942567115902044
Task_43274,2020,340,188,100,288,5.92375366568915,40.813183640066306
Task_43275,2554,686,182,199,381,3.7176128093158662,50.94701988614727
Task_43276,1364,309,25,33,58,4.4,27.652938773213794
Task_43277,1896,220,77,89,166,8.57918552036199,37.666016016098474
Task_43278,1417,676,26,109,135,2.0930576070901035,31.414774491734168
Task_43279,1151,149,102,134,236,7.673333333333333,25.929379760330647
Task_43280,1439,815,103,127,230,1.7634803921568627,32.8879886691143
Task_43281,1952,526,89,36,125,3.7039848197343455,38.53871527785035
Task_43282,974,133,21,86,107,7.268656716417911,21.559531458665997
Task_43283,510,466,90,146,236,1.0920770877944326,17.022393146633057
Task_43284,610,884,82,27,109,0.6892655367231638,18.480151101906646
Task_43285,2045,188,43,63,106,10.82010582010582,39.157316735032445
Task_43286,1986,575,35,21,56,3.4479166666666665,38.33818685688312
Task_43287,1245,687,82,24,106,1.809593023255814,27.51556582011791
Task_43288,2873,725,125,157,282,3.9573002754820936,55.61564504219825
Task_43289,2415,964,139,74,213,2.5025906735751295,48.31885659301677
Task_43290,1989,336,64,31,95,5.902077151335312,38.05015850071089
Task_43291,1423,781,49,122,171,1.819693094629156,32.231470646428356
Task_43292,2810,287,135,148,283,9.756944444444445,53.169251680099
Task_43293,1041,302,13,164,177,3.4356435643564356,24.677214028553646
Task_43294,1023,245,155,182,337,4.158536585365853,25.07467598966036
Task_43295,1314,87,104,22,126,14.931818181818182,26.140715831228547
Task_43296,1384,167,75,46,121,8.238095238095237,27.990694748121033
Task_43297,2551,311,21,71,92,8.176282051282051,47.41615506001688
Task_43298,1714,219,118,28,146,7.790909090909091,33.894837869762206
Task_43299,2790,459,147,132,279,6.065217391304348,53.397612759513855
Task_43300,2008,612,192,136,328,3.2756933115823816,41.73409582299806
Task_43301,1467,492,33,28,61,2.975659229208925,29.880063600200334
Task_43302,2571,324,154,191,345,7.9107692307692306,49.863379123267045
Task_43303,1879,881,47,154,201,2.130385487528345,40.03748621992407
Task_43304,1928,603,189,165,354,3.19205298013245,40.59840680852977
Task_43305,1526,806,20,126,146,1.8909541511771994,33.555166959738955
Task_43306,2802,865,101,21,122,3.235565819861432,52.913774737356796
Task_43307,1779,167,162,34,196,10.589285714285714,35.0599763709331
Task_43308,2806,174,195,180,375,16.034285714285716,52.748038679630916
Task_43309,1400,481,68,76,144,2.904564315352697,30.339693287080767
Task_43310,575,874,67,66,133,0.6571428571428571,18.58031171320288
Task_43311,2360,418,67,43,110,5.6324582338902145,44.42092224769281
Task_43312,591,1000,141,81,222,0.5904095904095904,19.787334932881972
Task_43313,1043,935,94,34,128,1.1143162393162394,25.694680626013554
Task_43314,2954,498,70,113,183,5.919839679358717,55.61890545787762
Task_43315,933,913,61,160,221,1.0207877461706782,25.138141079879418
Task_43316,1027,981,146,42,188,1.0458248472505092,25.805444520156716
Task_43317,1529,128,70,93,163,11.852713178294573,31.141968447378343
Task_43318,1983,519,172,78,250,3.8134615384615387,40.308697357555076
Task_43319,2846,548,84,110,194,5.183970856102004,54.2054841300523
Task_43320,876,980,74,80,154,0.8929663608562691,23.63131708388056
Task_43321,2576,516,15,61,76,4.982591876208898,47.78630226804663
Task_43322,2670,894,183,118,301,2.983240223463687,52.959050885210445
Task_43323,1641,666,161,99,260,2.4602698650674664,35.71585377910151
Task_43324,1243,602,156,26,182,2.0613598673300166,27.882321874042237
Task_43325,634,328,95,57,152,1.9270516717325228,17.424400568266986
Task_43326,2275,416,178,22,200,5.4556354916067145,43.847865214504175
Task_43327,2382,674,172,67,239,3.528888888888889,46.910237486008306
Task_43328,552,455,84,107,191,1.2105263157894737,17.438173889851672
Task_43329,1729,935,66,84,150,1.8472222222222223,37.017925147392795
Task_43330,1706,356,28,190,218,4.778711484593837,35.756903925855624
Task_43331,2856,807,89,179,268,3.5346534653465347,55.61377045451692
Task_43332,1077,688,111,98,209,1.5631349782293178,26.595077302976694
Task_43333,1946,120,56,86,142,16.082644628099175,37.35175371766203
Task_43334,938,684,188,27,215,1.3693430656934307,23.626058642424184
Task_43335,1256,774,171,156,327,1.6206451612903225,30.340953969761312
Task_43336,1563,376,40,78,118,4.1458885941644565,32.48360077950149
Task_43337,2229,242,39,71,110,9.17283950617284,42.3323478330011
Task_43338,1698,230,120,74,194,7.35064935064935,34.52394945226384
Task_43339,2578,118,54,162,216,21.66386554621849,48.19552892901071
Task_43340,2346,1010,27,42,69,2.320474777448071,45.419938727512296
Task_43341,2899,713,25,110,135,4.060224089635854,55.01530131012237
Task_43342,1894,126,169,125,294,14.913385826771654,37.691405488339086
Task_43343,2289,871,48,139,187,2.625,46.45323393568535
Task_43344,517,829,17,187,204,0.6228915662650603,18.33699084235532
Task_43345,2048,545,100,117,217,3.750915750915751,41.626934034340486
Task_43346,2494,532,186,102,288,4.679174484052533,48.945148078476144
Task_43347,2072,520,61,198,259,3.9769673704414585,42.36321772898197
Task_43348,1515,379,147,119,266,3.986842105263158,32.88161795572296
Task_43349,738,754,96,33,129,0.9774834437086093,20.30461794802625
Task_43350,1347,851,135,146,281,1.5809859154929577,31.770620577591902
Task_43351,1122,442,35,144,179,2.5327313769751694,26.36004865142259
Task_43352,2227,188,159,97,256,11.783068783068783,43.474000515164754
Task_43353,1639,327,109,17,126,4.996951219512195,32.7644421398983
Task_43354,2164,746,119,114,233,2.896921017402945,44.166338882499055
Task_43355,2862,305,151,157,308,9.352941176470589,54.18170424896658
Task_43356,1958,807,71,61,132,2.4232673267326734,39.952266152633584
Task_43357,1531,162,114,31,145,9.392638036809815,30.571700980412896
Task_43358,597,264,111,121,232,2.2528301886792454,17.842910922242442
Task_43359,521,992,33,160,193,0.5246727089627392,18.889330967390826
Task_43360,1335,317,107,100,207,4.19811320754717,29.538546692380738
Task_43361,1828,131,62,154,216,13.848484848484848,36.448081229242746
Task_43362,718,682,195,67,262,1.0512445095168375,20.605793445091646
Task_43363,1459,182,174,102,276,7.972677595628415,31.181536154920423
Task_43364,551,982,15,73,88,0.560528992878942,17.896180514678758
Task_43365,2538,123,117,42,159,20.467741935483872,46.06648815806853
Task_43366,1271,894,29,61,90,1.4201117318435754,28.631294307371988
Task_43367,1177,567,165,26,191,2.0721830985915495,26.946827906529773
Task_43368,1985,70,58,15,73,27.95774647887324,35.050689182732995
Task_43369,1306,326,187,95,282,3.99388379204893,29.4119859339384
Task_43370,2507,679,76,22,98,3.6867647058823527,47.52686384060687
Task_43371,1866,175,184,133,317,10.602272727272727,37.58210237643082
Task_43372,1076,676,28,37,65,1.589364844903988,24.277349054461585
Task_43373,2973,597,133,51,184,4.971571906354515,55.54799524900226
Task_43374,513,536,97,148,245,0.9553072625698324,17.411314953523487
Task_43375,1508,772,156,102,258,1.9508408796895214,33.95030302069657
Task_43376,568,824,99,101,200,0.6884848484848485,19.013115105848488
Task_43377,1274,486,146,41,187,2.616016427104723,28.20827476312571
Task_43378,2305,741,176,101,277,3.106469002695418,46.563567622684694
Task_43379,803,903,128,25,153,0.8882743362831859,21.624053034010917
Task_43380,1925,561,68,197,265,3.425266903914591,40.18597558170786
Task_43381,641,765,28,177,205,0.8368146214099217,19.91426872533299
Task_43382,1111,117,168,76,244,9.415254237288135,24.62840706844389
Task_43383,1473,602,155,193,348,2.442786069651741,33.40356961298264
Task_43384,1551,939,114,43,157,1.65,33.61305468290745
Task_43385,2202,309,186,128,314,7.103225806451613,43.74452838484177
Task_43386,2604,470,179,155,334,5.528662420382165,50.77101903382654
Task_43387,721,205,142,57,199,3.5,18.86638969100314
Task_43388,650,446,83,30,113,1.45413870246085,17.536972415653906
Task_43389,1953,998,198,36,234,1.954954954954955,40.82402945111506
Task_43390,1554,217,128,42,170,7.128440366972477,31.510316603593612
Task_43391,2883,377,137,165,302,7.626984126984127,54.74811289683157
Task_43392,1337,73,13,187,200,18.06756756756757,28.021338471680945
Task_43393,2718,170,42,48,90,15.894736842105264,48.82385373007457
Task_43394,2082,654,178,128,306,3.1786259541984734,42.92775480508391
Task_43395,549,590,35,42,77,0.9289340101522843,15.733497087603974
Task_43396,2809,359,72,30,102,7.802777777777778,51.308298785265386
Task_43397,2819,708,115,49,164,3.9760225669957685,53.303969080473905
Task_43398,1053,568,128,172,300,1.850615114235501,26.398840910944756
Task_43399,1213,74,94,178,272,16.173333333333332,26.46607449881537
Task_43400,2728,487,59,107,166,5.590163934426229,51.94188133086104
Task_43401,633,597,11,57,68,1.0585284280936456,17.2451178492825
Task_43402,2771,91,125,73,198,30.119565217391305,50.07558598888402
Task_43403,1702,140,79,191,270,12.070921985815604,34.88832093808762
Task_43404,2621,850,105,27,132,3.079905992949471,50.225928473170875
Task_43405,2921,504,72,102,174,5.784158415841584,55.16235067732632
Task_43406,1984,171,156,173,329,11.534883720930232,39.576831650184324
Task_43407,1440,704,161,172,333,2.0425531914893615,33.101703957849026
Task_43408,2425,836,119,166,285,2.8972520908004777,48.893900439056864
Task_43409,1097,368,58,160,218,2.97289972899729,26.231422567443662
Task_43410,913,586,38,87,125,1.555366269165247,22.902930180874964
Task_43411,1840,591,30,20,50,3.108108108108108,35.894381288870996
Task_43412,2975,998,82,175,257,2.977977977977978,58.0947874178566
Task_43413,868,504,28,20,48,1.7188118811881188,20.106980725545956
Task_43414,2275,453,195,185,380,5.011013215859031,45.75933675927052
Task_43415,2845,848,166,170,336,3.3510011778563014,55.8217499226923
Task_43416,1618,1015,51,84,135,1.5925196850393701,35.604169166959004
Task_43417,1867,792,111,110,221,2.3543505674653216,39.54515958459564
Task_43418,1518,892,53,160,213,1.6998880179171332,34.52051041915046
Task_43419,1387,826,133,178,311,1.6771463119709795,32.53814679407153
Task_43420,2205,198,10,135,145,11.080402010050252,42.43171646737594
Task_43421,2725,108,121,58,179,25.0,49.22048478998466
Task_43422,2749,696,151,197,348,3.9440459110473456,53.91578473258155
Task_43423,2858,826,126,36,162,3.4558645707376057,54.057217867227685
Task_43424,2129,868,35,37,72,2.4499424626006903,41.59026617022414
Task_43425,718,497,100,75,175,1.4417670682730923,19.657837563499754
Task_43426,1587,255,17,169,186,6.19921875,33.13175313440052
Task_43427,2794,740,27,73,100,3.770580296896086,52.76684679626191
Task_43428,2722,312,67,40,107,8.696485623003195,49.758635698503106
Task_43429,1421,659,200,128,328,2.153030303030303,32.573142498767076
Task_43430,1883,203,177,193,370,9.230392156862745,38.67249591495546
Task_43431,2385,676,12,131,143,3.5228951255539145,46.77517393669756
Task_43432,617,868,67,125,192,0.7100115074798619,20.02758890177464
Task_43433,2489,80,102,109,211,30.728395061728396,46.04409248299812
Task_43434,2061,991,197,156,353,2.0776209677419355,43.90126978162175
Task_43435,2557,954,28,155,183,2.6774869109947645,50.74055806005678
Task_43436,1437,167,149,49,198,8.553571428571429,29.687211240210758
Task_43437,2040,763,112,154,266,2.670157068062827,42.46257692441505
Task_43438,536,210,200,128,328,2.5402843601895735,17.147622258157902
Task_43439,2650,450,172,60,232,5.875831485587583,50.310869934354876
Task_43440,869,356,73,27,100,2.434173669467787,20.64348600111527
Task_43441,734,421,193,48,241,1.7393364928909953,19.739225219271663
Task_43442,939,499,94,79,173,1.878,23.37382286925082
Task_43443,1011,210,187,158,345,4.791469194312796,24.7675922757619
Task_43444,2022,311,194,146,340,6.480769230769231,41.04875044893209
Task_43445,2995,311,119,86,205,9.599358974358974,55.47363724023518
Task_43446,1605,833,14,24,38,1.9244604316546763,32.9366405578465
Task_43447,1021,819,26,68,94,1.2451219512195122,24.76269654049707
Task_43448,1633,1008,19,52,71,1.6184340931615462,34.44697242536311
Task_43449,1530,662,37,40,77,2.3076923076923075,31.374035358852655
Task_43450,2586,613,174,21,195,4.2117263843648205,49.3473714728666
Task_43451,2338,308,56,24,80,7.566343042071197,43.3103500440619
Task_43452,1464,580,13,191,204,2.5197934595524956,32.595946277120284
Task_43453,557,678,28,11,39,0.8203240058910162,15.846191043557676
Task_43454,2113,441,133,58,191,4.780542986425339,41.60641105083472
Task_43455,878,708,149,11,160,1.2383638928067702,22.068982688278254
Task_43456,2534,482,149,133,282,5.246376811594203,49.43535740188537
Task_43457,1893,626,116,181,297,3.0191387559808613,39.883218780407084
Task_43458,751,241,151,72,223,3.103305785123967,19.673257675334238
Task_43459,2367,860,96,124,220,2.749128919860627,47.748326241095775
Task_43460,955,936,45,29,74,1.0192102454642475,23.256505638638828
Task_43461,1805,501,43,48,91,3.595617529880478,35.76648132271433
Task_43462,2752,417,157,98,255,6.583732057416268,52.50277704261705
Task_43463,2939,1014,169,59,228,2.8955665024630544,56.65524269629211
Task_43464,557,429,114,185,299,1.2953488372093023,18.034647864726978
Task_43465,2831,770,138,49,187,3.6718547341115433,53.84125448287636
Task_43466,2753,656,26,78,104,4.190258751902587,51.96353312036791
Task_43467,1604,489,124,17,141,3.273469387755102,32.75799559584451
Task_43468,1083,944,95,164,259,1.146031746031746,27.834141193591577
Task_43469,906,334,134,145,279,2.7044776119402987,23.199690611785005
Task_43470,2373,492,168,95,263,4.813387423935091,46.74954893922464
Task_43471,621,762,119,87,206,0.8138925294888598,19.303820216359313
Task_43472,2084,901,124,22,146,2.3104212860310422,41.91545674634374
Task_43473,2029,982,30,71,101,2.064089521871821,41.40972290327833
Task_43474,2377,479,168,178,346,4.952083333333333,47.29472707169543
Task_43475,1029,583,191,99,290,1.7619863013698631,25.885356119148767
Task_43476,1355,153,76,68,144,8.7987012987013,28.082869876740357
Task_43477,1317,696,39,150,189,1.8895265423242469,30.432677579579916
Task_43478,2396,750,106,19,125,3.1904127829560585,46.04067991148156
Task_43479,1906,136,61,33,94,13.912408759124087,35.615348622978665
Task_43480,506,409,137,134,271,1.2341463414634146,16.933026874401403
Task_43481,1159,795,188,190,378,1.4560301507537687,29.094233666170894
Task_43482,1449,426,135,56,191,3.3934426229508197,31.132294665220176
Task_43483,633,663,48,104,152,0.9533132530120482,18.892537593832554
Task_43484,1524,813,199,165,364,1.8722358722358723,34.901538423244475
Task_43485,1337,930,188,48,236,1.4360902255639099,30.86114090644754
Task_43486,1183,719,38,117,155,1.6430555555555555,27.88036148030186
Task_43487,2682,492,45,172,217,5.440162271805274,51.57511845633709
Task_43488,1906,424,89,153,242,4.484705882352941,39.19599051227809
Task_43489,2812,367,187,143,330,7.641304347826087,53.68482436328998
Task_43490,2620,209,158,175,333,12.476190476190476,50.137560395548725
Task_43491,728,472,142,148,290,1.5391120507399578,20.830129937097006
Task_43492,2238,550,126,75,201,4.061705989110708,44.15342861557091
Task_43493,551,160,187,159,346,3.422360248447205,17.063408235874782
Task_43494,834,276,51,13,64,3.0108303249097474,18.937035966361726
Task_43495,1621,363,130,11,141,4.4532967032967035,32.72599233631749
Task_43496,1292,908,112,96,208,1.4213421342134214,30.671654817022755
Task_43497,2079,917,86,139,225,2.264705882352941,43.39649159477133
Task_43498,810,69,46,93,139,11.571428571428571,18.967670479508683
Task_43499,993,286,91,111,202,3.4599303135888504,24.072612114644773
Task_43500,2502,557,21,20,41,4.483870967741935,46.04901595223865
Task_43501,2153,720,93,132,225,2.986130374479889,44.01276958671724
Task_43502,1440,194,26,77,103,7.384615384615385,29.68009214350728
Task_43503,1546,333,110,51,161,4.62874251497006,31.902570364285662
Task_43504,1916,71,181,179,360,26.61111111111111,37.77199063527079
Task_43505,2735,578,198,57,255,4.723661485319516,52.194279500002004
Task_43506,880,395,144,71,215,2.2222222222222223,22.14971287892166
Task_43507,2288,865,169,36,205,2.6420323325635104,45.587502862906774
Task_43508,1463,600,183,160,343,2.4342762063227954,33.16801502298739
Task_43509,1140,270,94,89,183,4.206642066420664,25.874444689615387
Task_43510,2768,243,34,130,164,11.344262295081966,51.696161594201264
Task_43511,2293,982,15,63,78,2.3326551373346898,44.98180093795128
Task_43512,2647,421,153,151,304,6.2725118483412325,51.149634828514614
Task_43513,572,860,26,11,37,0.6643437862950058,16.766375932573688
Task_43514,1469,900,135,134,269,1.6304106548279689,33.81341569370219
Task_43515,1207,323,42,106,148,3.7253086419753085,26.970763240580737
Task_43516,2000,782,78,90,168,2.554278416347382,41.112280712501935
Task_43517,893,431,44,106,150,2.0671296296296298,22.33671514489352
Task_43518,891,980,190,129,319,0.908256880733945,25.06539073518593
Task_43519,2601,728,41,103,144,3.567901234567901,50.33001916689801
Task_43520,911,255,171,64,235,3.55859375,22.250339986675865
Task_43521,1354,799,21,183,204,1.6925,31.436926965989496
Task_43522,2531,553,87,18,105,4.568592057761733,47.2820270928369
Task_43523,2399,263,196,147,343,9.087121212121213,46.85534603559097
Task_43524,1145,907,68,161,229,1.2610132158590308,28.57838082459901
Task_43525,633,204,100,159,259,3.0878048780487806,18.393693354073005
Task_43526,2261,537,79,186,265,4.202602230483271,45.42218953829325
Task_43527,976,559,181,42,223,1.7428571428571429,23.906937155259246
Task_43528,1204,621,31,21,52,1.9356913183279743,26.122802939525414
Task_43529,898,428,136,152,288,2.093240093240093,23.422327730750386
Task_43530,1567,969,18,67,85,1.6154639175257732,33.8006591038007
Task_43531,1137,234,104,18,122,4.8382978723404255,24.371393835031302
Task_43532,2311,727,26,78,104,3.1744505494505493,45.18653698849039
Task_43533,1257,158,116,125,241,7.90566037735849,27.66819143460223
Task_43534,2713,64,134,115,249,41.738461538461536,49.615718584646295
Task_43535,589,984,67,28,95,0.5979695431472081,18.562443816709358
Task_43536,1668,984,197,145,342,1.6934010152284265,37.57259278538095
Task_43537,2290,157,62,60,122,14.49367088607595,42.394133779532616
Task_43538,1048,135,121,37,158,7.705882352941177,22.694495215670845
Task_43539,1139,426,89,69,158,2.667447306791569,25.78088424827042
Task_43540,1827,780,115,91,206,2.3393085787451984,38.63239738444096
Task_43541,2052,349,89,183,272,5.862857142857143,41.43878833186154
Task_43542,1431,155,38,162,200,9.173076923076923,30.270242632766326
Task_43543,660,799,93,99,192,0.825,20.31732230185423
Task_43544,1230,209,112,10,122,5.857142857142857,25.89111430554964
Task_43545,2722,244,135,134,269,11.110204081632654,51.53615608937381
Task_43546,2018,975,13,29,42,2.067622950819672,40.03950756941603
Task_43547,2646,233,127,128,255,11.307692307692308,50.22175193672452
Task_43548,2324,646,113,13,126,3.591962905718702,44.720223706318485
Task_43549,789,160,170,151,321,4.900621118012422,20.691069621589502
Task_43550,2330,552,111,151,262,4.213381555153707,46.36714108715833
Task_43551,1837,670,174,195,369,2.737704918032787,39.47968503408131
Task_43552,2307,989,59,160,219,2.33030303030303,47.34995428599748
Task_43553,2466,1022,83,151,234,2.410557184750733,49.92573892475861
Task_43554,1403,371,197,157,354,3.771505376344086,31.53610038356641
Task_43555,751,452,61,115,176,1.6578366445916115,20.57050985473866
Task_43556,2886,506,10,46,56,5.6923076923076925,52.45401263883419
Task_43557,2198,630,46,96,142,3.4833597464342314,43.69441220318776
Task_43558,2901,1018,177,114,291,2.846908734052993,56.95591725035217
Task_43559,609,1003,66,47,113,0.6065737051792829,19.03629732156983
Task_43560,1591,805,159,198,357,1.9739454094292803,35.95496451230441
Task_43561,975,131,20,136,156,7.386363636363637,22.0342541432897
Task_43562,507,602,139,106,245,0.8407960199004975,17.429320289887823
Task_43563,1487,494,109,94,203,3.004040404040404,32.430466738992415
Task_43564,1068,180,188,78,266,5.900552486187845,24.52623514489527
Task_43565,2313,997,164,44,208,2.317635270541082,46.388278206453045
Task_43566,2983,263,64,149,213,11.299242424242424,55.62937681229033
Task_43567,2693,953,186,172,358,2.8228511530398324,53.843931795711796
Task_43568,1381,572,80,196,276,2.4101221640488655,31.659625409403404
Task_43569,2604,1020,111,194,305,2.5504407443682666,52.43586331518113
Task_43570,2192,818,119,162,281,2.6764346764346763,45.122101502946755
Task_43571,665,304,88,138,226,2.180327868852459,19.063236151857126
Task_43572,1700,991,181,199,380,1.7137096774193548,38.35183683538778
Task_43573,1209,1011,66,34,100,1.1946640316205535,28.11589466010052
Task_43574,987,357,62,33,95,2.7569832402234637,22.267483795868902
Task_43575,2944,572,64,199,263,5.137870855148342,56.35669396636871
Task_43576,1491,726,148,144,292,2.0508940852819806,33.75239866483398
Task_43577,1978,834,139,13,152,2.3688622754491018,39.87655561996767
Task_43578,1759,564,58,29,87,3.113274336283186,35.068359183503
Task_43579,2966,337,178,199,377,8.775147928994082,56.31149887708947
Task_43580,2511,128,119,51,170,19.46511627906977,45.99735242143877
Task_43581,1604,172,138,11,149,9.271676300578035,31.646196979458406
Task_43582,2553,68,163,83,246,37.0,46.85707985971573
Task_43583,1757,636,100,11,111,2.758241758241758,35.540937691448136
Task_43584,1734,756,47,99,146,2.2906208718626155,36.710990683884575
Task_43585,1464,147,103,200,303,9.891891891891891,31.23560334160324
Task_43586,1518,221,68,185,253,6.837837837837838,32.55877487878791
Task_43587,1280,365,197,38,235,3.4972677595628414,28.209379528257482
Task_43588,1573,399,186,164,350,3.9325,34.30858204435509
Task_43589,856,973,93,79,172,0.8788501026694046,23.552418241186675
Task_43590,1652,424,63,19,82,3.887058823529412,32.69598040604799
Task_43591,2982,427,127,144,271,6.9672897196261685,56.3121826887788
Task_43592,2444,313,158,105,263,7.7834394904458595,47.32133528432263
Task_43593,803,667,63,127,190,1.2020958083832336,22.21294097135559
Task_43594,1544,464,117,103,220,3.3204301075268816,33.382763113983735
Task_43595,1322,931,48,136,184,1.4184549356223175,31.056295421135374
Task_43596,1574,89,24,30,54,17.488888888888887,29.71645486617395
Task_43597,1324,476,192,104,296,2.7756813417190775,30.282438204174927
Task_43598,1630,251,91,166,257,6.468253968253968,34.350706254382075
Task_43599,835,347,169,91,260,2.3994252873563218,21.80729967650865
Task_43600,604,773,94,20,114,0.7803617571059431,17.848961697093976
Task_43601,1340,450,189,87,276,2.9711751662971175,30.08393332188142
Task_43602,1631,773,197,96,293,2.107235142118863,36.074587136879856
Task_43603,1475,282,193,95,288,5.212014134275618,31.965338856057468
Task_43604,883,978,23,171,194,0.9019407558733401,24.416804707788923
Task_43605,1615,843,153,101,254,1.9135071090047393,35.8470690687868
Task_43606,1194,957,61,129,190,1.2463465553235908,29.251878671421935
Task_43607,822,840,125,34,159,0.9774078478002378,21.886075140873217
Task_43608,1501,911,187,151,338,1.6458333333333333,34.69051922734411
Task_43609,2404,93,72,139,211,25.574468085106382,44.91802613433308
Task_43610,1933,327,36,15,51,5.8932926829268295,36.50067632126227
Task_43611,2899,450,88,131,219,6.427937915742794,54.84099524968105
Task_43612,1450,425,174,148,322,3.403755868544601,32.29609492067353
Task_43613,1205,460,130,140,270,2.613882863340564,28.283697423751974
Task_43614,2839,491,191,178,369,5.770325203252033,54.75101275238018
Task_43615,2155,687,99,116,215,3.1322674418604652,43.76191189546839
Task_43616,979,976,158,127,285,1.0020470829068577,26.212937164889794
Task_43617,2302,510,131,95,226,4.504892367906066,45.51674555911499
Task_43618,2303,724,92,142,234,3.176551724137931,46.42227011139682
Task_43619,2395,1015,145,26,171,2.357283464566929,47.34597175586364
Task_43620,1013,703,58,180,238,1.4389204545454546,25.97655901811392
Task_43621,954,277,83,149,232,3.431654676258993,23.622006639851687
Task_43622,1206,970,199,139,338,1.2420185375901134,30.071464652885282
Task_43623,1685,964,117,104,221,1.7461139896373057,37.17446439638983
Task_43624,731,779,35,86,121,0.9371794871794872,20.441366417140188
Task_43625,1465,154,79,16,95,9.451612903225806,29.000145521941594
Task_43626,2810,518,104,72,176,5.414258188824663,52.755219858943924
Task_43627,523,590,112,129,241,0.8849407783417935,17.66963152727716
Task_43628,2129,843,105,137,242,2.522511848341232,43.98963306737419
Task_43629,1975,346,39,167,206,5.69164265129683,39.86252301514408
Task_43630,1405,473,33,148,181,2.9641350210970465,30.970461410893268
Task_43631,1826,893,176,160,336,2.0425055928411635,39.80192215139126
Task_43632,1691,245,100,94,194,6.873983739837398,34.79722876300086
Task_43633,2690,112,26,155,181,23.805309734513273,49.24249440358927
Task_43634,2965,169,50,188,238,17.441176470588236,54.900579123368
Task_43635,2470,659,169,23,192,3.742424242424242,47.699622208820365
Task_43636,509,399,60,96,156,1.2725,16.23162851459473
Task_43637,2906,690,176,46,222,4.205499276410999,54.8895391707457
Task_43638,2256,1007,27,147,174,2.238095238095238,46.20049355785358
Task_43639,2495,531,90,137,227,4.68984962406015,48.783402793281596
Task_43640,2947,980,49,76,125,3.0040774719673804,56.48033465604379
Task_43641,1039,678,124,26,150,1.5301914580265095,24.634329709929858
Task_43642,2128,580,92,195,287,3.6626506024096384,43.51233628719302
Task_43643,1671,957,15,33,48,1.744258872651357,34.52930239249523
Task_43644,2687,241,61,136,197,11.103305785123966,50.778251863720506
Task_43645,541,915,39,75,114,0.5906113537117904,18.061266447073148
Task_43646,1981,267,85,108,193,7.391791044776119,39.577789273173835
Task_43647,2047,1013,164,104,268,2.0187376725838266,43.28845020602143
Task_43648,1272,583,13,196,209,2.1780821917808217,29.594765214621358
Task_43649,857,474,49,189,238,1.8042105263157895,22.907654432659672
Task_43650,1101,354,165,113,278,3.101408450704225,26.296774559027412
Task_43651,1192,95,51,187,238,12.416666666666666,26.074738632554187
Task_43652,2990,481,65,103,168,6.203319502074689,56.02998959299608
Task_43653,1360,191,136,199,335,7.083333333333333,30.214043973313185
Task_43654,1345,154,83,129,212,8.67741935483871,28.93581216166947
Task_43655,2222,475,122,165,287,4.668067226890757,44.54319372487887
Task_43656,1180,518,138,178,316,2.2736030828516376,28.33389002077781
Task_43657,2408,602,84,92,176,3.9933665008291874,47.066082894021626
Task_43658,2424,940,137,55,192,2.575982996811902,48.195182151397375
Task_43659,2858,215,55,168,223,13.231481481481481,53.572099674735085
Task_43660,2333,123,135,137,272,18.81451612903226,44.487538868906405
Task_43661,1419,204,187,13,200,6.921951219512195,29.519915569567384
Task_43662,1716,375,59,40,99,4.5638297872340425,33.84664743887384
Task_43663,2081,497,182,67,249,4.178714859437751,41.62603074927275
Task_43664,564,809,120,56,176,0.6962962962962963,18.206545179061617
Task_43665,660,612,61,15,76,1.0766721044045677,17.315873961820415
Task_43666,1860,468,77,189,266,3.9658848614072495,38.85683914642541
Task_43667,1639,553,129,112,241,2.9584837545126352,35.27698023052605
Task_43668,1323,146,187,34,221,9.0,27.774362181692112
Task_43669,2129,945,34,159,193,2.2505285412262155,44.14687713584642
Task_43670,596,781,122,89,211,0.7621483375959079,19.05654358366549
Task_43671,966,656,129,110,239,1.4703196347031964,24.875751356170664
Task_43672,1911,706,18,194,212,2.702970297029703,40.02982190404185
Task_43673,1190,98,40,17,57,12.02020202020202,23.44396703770234
Task_43674,1070,543,12,143,155,1.9669117647058822,25.587221633746477
Task_43675,2790,268,125,119,244,10.371747211895912,52.565596542399966
Task_43676,2693,576,157,149,306,4.667244367417678,52.387371102150404
Task_43677,1914,1019,171,198,369,1.8764705882352941,41.792402217236706
Task_43678,2073,541,102,167,269,3.8247232472324724,42.31770193443667
Task_43679,2949,447,188,175,363,6.582589285714286,56.31636979872828
Task_43680,1563,864,183,90,273,1.806936416184971,34.99317773213229
Task_43681,709,531,111,196,307,1.3327067669172932,20.862695621362253
Task_43682,1465,981,139,128,267,1.4918533604887985,33.95415230057237
Task_43683,1743,262,27,105,132,6.6273764258555135,35.271725078395534
Task_43684,535,820,140,108,248,0.6516443361753959,18.711794933449468
Task_43685,1243,240,96,146,242,5.157676348547718,28.105285163070917
Task_43686,2211,185,29,71,100,11.887096774193548,41.57571217425365
Task_43687,2793,458,139,76,215,6.084967320261438,52.70984259611049
Task_43688,2052,491,182,81,263,4.170731707317073,41.34911117968215
Task_43689,2230,237,41,123,164,9.369747899159664,43.145292047127434
Task_43690,1786,455,99,155,254,3.9166666666666665,37.415643982638024
Task_43691,1760,500,189,114,303,3.5129740518962076,37.30701743315086
Task_43692,1358,617,55,34,89,2.197411003236246,28.921164500366288
Task_43693,1051,179,42,199,241,5.838888888888889,24.48959024697754
Task_43694,1907,199,87,87,174,9.535,37.700540393976254
Task_43695,908,470,143,163,306,1.9278131634819533,23.80998031563748
Task_43696,2518,280,106,82,188,8.96085409252669,47.67188179357498
Task_43697,2353,74,96,101,197,31.373333333333335,43.819417828640574
Task_43698,1828,993,55,195,250,1.8390342052313884,39.96677053854504
Task_43699,1827,425,127,67,194,4.288732394366197,37.12386808540882
Task_43700,1970,245,29,30,59,8.008130081300813,36.98459862973855
Task_43701,2020,811,165,108,273,2.4876847290640396,42.25993336474104
Task_43702,2154,695,69,147,216,3.0948275862068964,43.940998339640736
Task_43703,2325,697,188,64,252,3.330945558739255,46.11984595164736
Task_43704,2162,1006,171,153,324,2.1469712015888778,45.41334676748637
Task_43705,695,172,24,144,168,4.017341040462428,18.217385431363216
Task_43706,2398,828,54,25,79,2.8926417370325694,45.71905106016731
Task_43707,2309,1018,183,39,222,2.26594700686948,46.4331226606489
Task_43708,1661,707,23,171,194,2.346045197740113,36.08005168538768
Task_43709,2262,975,187,24,211,2.317622950819672,45.47315706475814
Task_43710,1778,558,69,114,183,3.1806797853309483,37.17446975055605
Task_43711,2154,321,19,183,202,6.6894409937888195,42.58282506472131
Task_43712,1798,322,22,181,203,5.56656346749226,36.94700645367417
Task_43713,1428,322,161,130,291,4.421052631578948,31.448222156911054
Task_43714,1438,430,37,11,48,3.336426914153132,28.904796873834528
Task_43715,868,717,142,66,208,1.2089136490250696,22.90781345173122
Task_43716,1215,441,183,50,233,2.748868778280543,27.446307150019525
Task_43717,857,869,13,149,162,0.9850574712643678,23.221383477386308
Task_43718,2600,921,76,106,182,2.819956616052061,51.33619836642263
Task_43719,2574,671,87,15,102,3.830357142857143,48.40746836288313
Task_43720,936,710,37,169,206,1.3164556962025316,24.473796303369358
Task_43721,1961,243,66,134,200,8.03688524590164,39.32155592043811
Task_43722,1350,370,164,193,357,3.638814016172507,30.760680731491558
Task_43723,1112,659,147,177,324,1.6848484848484848,27.719291729953028
Task_43724,1233,242,10,178,188,5.074074074074074,27.66950145078866
Task_43725,2302,940,195,82,277,2.4463336875664186,46.827224501160494
Task_43726,2036,225,144,146,290,9.008849557522124,40.741185139358315
Task_43727,1288,996,139,37,176,1.291875626880642,29.84744274584403
Task_43728,2978,993,52,29,81,2.995975855130785,55.83602557493503
Task_43729,1246,766,16,77,93,1.6245110821382007,28.275850603618878
Task_43730,2504,673,198,136,334,3.71513353115727,49.80975593162466
Task_43731,1528,913,45,156,201,1.6717724288840263,34.51457468260413
Task_43732,2265,324,136,126,262,6.969230769230769,44.55482496992613
Task_43733,1794,822,99,70,169,2.1798298906439855,37.55330487589496
Task_43734,643,702,49,167,216,0.914651493598862,19.908334038548073
Task_43735,1527,157,94,136,230,9.664556962025317,31.985982193556737
Task_43736,926,876,47,72,119,1.055872291904219,23.714532827100125
Task_43737,2717,100,192,131,323,26.900990099009903,50.35055349760868
Task_43738,2954,434,89,16,105,6.7908045977011495,53.691794272888416
Task_43739,2135,99,104,149,253,21.35,40.91363398787198
Task_43740,1776,576,20,156,176,3.0779896013864816,37.11847203732984
Task_43741,1444,813,94,89,183,1.7739557739557739,32.3956359301539
Task_43742,2122,574,149,102,251,3.690434782608696,43.022170789852375
Task_43743,1021,1010,73,41,114,1.009891196834817,25.235683863858355
Task_43744,1203,1012,165,81,246,1.1875616979269497,29.43194644266232
Task_43745,1845,890,151,113,264,2.0707070707070705,39.700238474192304
Task_43746,1824,585,167,132,299,3.112627986348123,38.59830788074097
Task_43747,1424,522,143,73,216,2.7227533460803057,31.198145432131554
Task_43748,2923,917,116,99,215,3.184095860566449,56.60964733931388
Task_43749,2317,423,179,17,196,5.464622641509434,44.36840427104022
Task_43750,729,818,54,193,247,0.8901098901098901,21.832883978482545
Task_43751,2492,532,16,125,141,4.675422138836773,47.93678764877908
Task_43752,518,972,76,42,118,0.5323741007194245,17.275244662793096
Task_43753,842,926,146,83,229,0.9083063646170443,23.39528377716552
Task_43754,1407,723,114,145,259,1.9433701657458564,32.265125105928796
Task_43755,1027,469,172,25,197,2.1851063829787236,24.26905184736913
Task_43756,2622,456,186,150,336,5.737417943107221,51.01189074426825
Task_43757,2403,133,167,36,203,17.932835820895523,44.5724353346963
Task_43758,1160,218,36,144,180,5.296803652968037,26.214394175420622
Task_43759,647,187,136,182,318,3.4414893617021276,18.963200473123393
Task_43760,792,982,20,129,149,0.8056968463886063,22.343878080391153
Task_43761,2974,627,145,192,337,4.735668789808917,57.20333261463808
Task_43762,2937,590,44,147,191,4.969543147208122,55.788579339380554
Task_43763,657,816,37,105,142,0.8041615667074663,19.656054909190544
Task_43764,1481,718,190,15,205,2.0598052851182196,32.16448130567219
Task_43765,2918,987,186,54,240,2.9534412955465585,56.35485164356604
Task_43766,857,386,153,38,191,2.214470284237726,21.38589709389642
Task_43767,675,662,165,117,282,1.0180995475113122,20.407346113162973
Task_43768,2167,858,50,147,197,2.522700814901048,44.63986678054511
Task_43769,1519,965,24,137,161,1.5724637681159421,34.03112495846496
Task_43770,1053,793,153,79,232,1.3261964735516374,26.327685099626617
Task_43771,783,626,47,100,147,1.2488038277511961,21.068565186812947
Task_43772,503,563,127,149,276,0.8918439716312057,17.456295995019953
Task_43773,519,937,29,152,181,0.5533049040511727,18.30137771511181
Task_43774,2267,940,103,12,115,2.4091392136025505,44.58010965607715
Task_43775,747,661,78,84,162,1.1283987915407856,20.53948499370681
Task_43776,1576,890,148,144,292,1.7687991021324354,35.59612064948658
Task_43777,842,369,101,26,127,2.2756756756756755,20.464634907066717
Task_43778,1981,644,27,153,180,3.071317829457364,40.62814716385885
Task_43779,582,486,90,118,208,1.1950718685831623,18.15100171526692
Task_43780,2134,512,90,112,202,4.159844054580897,42.857529331454465
Task_43781,2890,326,48,18,66,8.837920489296636,51.5819491603892
Task_43782,2528,651,17,167,184,3.8773006134969323,49.25724651593771
Task_43783,1022,85,64,50,114,11.883720930232558,21.416250391034243
Task_43784,1869,364,18,86,104,5.120547945205479,37.05526135291415
Task_43785,2106,72,114,125,239,28.84931506849315,40.11565858322633
Task_43786,2874,585,183,130,313,4.90443686006826,55.286174693586
Task_43787,1130,383,12,190,202,2.9427083333333335,26.620825363723167
Task_43788,609,101,28,164,192,5.970588235294118,16.72753759932173
Task_43789,2686,986,108,52,160,2.7213779128672746,52.07681228087868
Task_43790,619,430,53,29,82,1.4361948955916473,16.626136230087663
Task_43791,1652,605,195,56,251,2.726072607260726,35.183871473861956
Task_43792,1517,154,21,66,87,9.787096774193548,30.004102596620736
Task_43793,1110,646,74,190,264,1.7156105100463679,27.527552168165027
Task_43794,2359,497,118,134,252,4.736947791164659,46.57977838408508
Task_43795,1339,311,34,34,68,4.291666666666667,27.273342147775036
Task_43796,1633,1010,107,181,288,1.6152324431256182,36.9079784990783
Task_43797,2395,537,159,180,339,4.451672862453532,47.737893184809444
Task_43798,1933,66,11,142,153,28.850746268656717,36.56463479492095
Task_43799,2302,97,98,143,241,23.489795918367346,43.37246444538556
Task_43800,2383,396,186,184,370,6.002518891687657,47.23506907671828
Task_43801,751,664,28,61,89,1.1293233082706766,19.723545336894855
Task_43802,2272,786,179,25,204,2.8869123252858957,45.01361560158579
Task_43803,1679,156,55,189,244,10.694267515923567,34.551296373680806
Task_43804,1364,774,117,83,200,1.76,31.083246633726436
Task_43805,2532,104,146,28,174,24.114285714285714,46.11606900450952
Task_43806,2793,752,23,103,126,3.7091633466135456,53.54522877217003
Task_43807,656,543,152,141,293,1.2058823529411764,19.875572188985416
Task_43808,548,372,76,59,135,1.4691689008042896,16.249497918578925
Task_43809,629,455,132,137,269,1.3793859649122806,19.073522789672833
Task_43810,593,470,24,122,146,1.2590233545647558,17.63351032217432
Task_43811,615,555,29,59,88,1.106115107913669,17.22006203532796
Task_43812,2214,795,55,164,219,2.7814070351758793,45.280865663639474
Task_43813,760,564,173,96,269,1.345132743362832,21.478730391119512
Task_43814,2413,989,163,133,296,2.437373737373737,49.18253215020269
Task_43815,2450,609,105,151,256,4.016393442622951,48.42203255988415
Task_43816,2721,345,156,131,287,7.864161849710983,51.958749105569986
Task_43817,1264,756,197,16,213,1.6697490092470277,28.872125598407198
Task_43818,560,874,162,200,362,0.64,19.89854711859195
Task_43819,1332,694,121,136,257,1.916546762589928,30.964444716634677
Task_43820,2977,250,159,72,231,11.860557768924302,54.90964517555722
Task_43821,1851,1006,151,143,294,1.8381330685203574,40.33501611603458
Task_43822,2311,252,147,41,188,9.134387351778656,43.84019640349712
Task_43823,2979,520,190,138,328,5.717850287907869,56.81838896448539
Task_43824,689,491,107,140,247,1.4004065040650406,20.0409160005299
Task_43825,2947,971,119,70,189,3.0318930041152266,56.537397905528785
Task_43826,978,617,104,91,195,1.5825242718446602,24.581258491789026
Task_43827,1182,641,122,22,144,1.841121495327103,26.7669049162247
Task_43828,754,237,198,194,392,3.168067226890756,21.064060726633056
Task_43829,1044,922,181,149,330,1.1310942578548213,27.368360588482872
Task_43830,641,677,152,127,279,0.9454277286135693,19.983605035812165
Task_43831,2648,838,53,29,82,3.156138259833135,50.067102927685674
Task_43832,1366,930,107,73,180,1.4672395273899033,31.170266367688907
Task_43833,1729,389,29,76,105,4.433333333333334,34.86129905284176
Task_43834,2730,1002,47,56,103,2.7218344965104686,52.36851547527002
Task_43835,1423,997,28,80,108,1.4258517034068137,31.948301264674612
Task_43836,2222,653,72,119,191,3.397553516819572,44.73749526182804
Task_43837,782,776,61,51,112,1.0064350064350065,20.723891908067177
Task_43838,1485,183,123,30,153,8.070652173913043,30.222922699154513
Task_43839,1476,306,157,177,334,4.807817589576548,32.4170399456219
Task_43840,2384,601,116,91,207,3.9601328903654487,46.89644687571965
Task_43841,2530,168,125,159,284,14.970414201183432,48.03648408553531
Task_43842,1457,360,107,125,232,4.03601108033241,31.75792490708676
Task_43843,2167,950,179,56,235,2.2786540483701367,44.34915508277231
Task_43844,1687,853,101,192,293,1.9754098360655739,37.328140742439665
Task_43845,827,760,24,111,135,1.0867279894875164,22.12548350977438
Task_43846,1576,898,180,75,255,1.753058954393771,34.99352359887676
Task_43847,2664,405,134,121,255,6.561576354679803,51.10072060677722
Task_43848,755,512,31,100,131,1.4717348927875245,20.38645361272425
Task_43849,1879,885,98,141,239,2.120767494356659,40.16568816793914
Task_43850,1458,979,111,196,307,1.4877551020408164,34.11699031862661
Task_43851,2624,313,25,51,76,8.356687898089172,47.81911793203136
Task_43852,986,771,26,153,179,1.2772020725388602,25.0959530990185
Task_43853,1748,315,175,178,353,5.531645569620253,36.83509672521467
Task_43854,1972,380,130,173,303,5.175853018372703,40.361179864584905
Task_43855,2606,967,186,65,251,2.6921487603305785,51.42984859946025
Task_43856,2113,322,160,131,291,6.541795665634675,42.28229691692551
Task_43857,2779,983,131,49,180,2.8241869918699187,53.5177706953246
Task_43858,755,879,28,195,223,0.8579545454545454,22.19644817577657
Task_43859,1568,818,157,81,238,1.9145299145299146,34.60004235189612
Task_43860,1175,923,27,81,108,1.2716450216450217,27.806334281629372
Task_43861,1787,965,18,124,142,1.849896480331263,38.15285038722416
Task_43862,2161,869,164,134,298,2.4839080459770115,44.82580888853661
Task_43863,2445,584,92,57,149,4.17948717948718,46.980344337400616
Task_43864,502,743,96,102,198,0.6747311827956989,17.787994254414603
Task_43865,1710,144,184,103,287,11.793103448275861,34.9268912689327
Task_43866,2366,93,36,35,71,25.170212765957448,42.092439899217474
Task_43867,584,936,17,133,150,0.6232657417289221,19.12395153254298
Task_43868,1059,570,155,147,302,1.8546409807355517,26.472471696773834
Task_43869,2120,699,186,151,337,3.0285714285714285,43.84473193194714
Task_43870,1608,521,65,67,132,3.0804597701149423,33.65325442426515
Task_43871,1125,665,61,15,76,1.6891891891891893,24.739556437413828
Task_43872,1245,74,145,186,331,16.6,27.185989677006617
Task_43873,2756,411,159,142,301,6.689320388349515,52.81464592159057
Task_43874,1765,926,87,87,174,1.9039913700107876,37.78786858136469
Task_43875,2544,679,168,72,240,3.7411764705882353,49.52882539565357
Task_43876,2517,800,18,144,162,3.142322097378277,49.35386444508162
Task_43877,2981,291,169,33,202,10.20890410958904,54.682676916621624
Task_43878,1261,865,105,134,239,1.456120092378753,30.218942779669334
Task_43879,2440,788,194,19,213,3.0925221799746514,47.55534127546752
Task_43880,1879,986,139,111,250,1.9037487335359675,40.47141229613276
Task_43881,1351,98,115,110,225,13.646464646464647,28.355794041790215
Task_43882,527,877,43,45,88,0.6002277904328018,17.087594005003478
Task_43883,2847,360,52,17,69,7.886426592797784,50.999490211353425
Task_43884,2663,530,117,15,132,5.015065913370998,49.75065474699281
Task_43885,664,274,33,79,112,2.4145454545454546,17.89571889894616
Task_43886,2470,302,42,53,95,8.151815181518153,45.958964673656645
Task_43887,1078,635,32,103,135,1.6949685534591195,25.90315062593451
Task_43888,1140,873,50,103,153,1.3043478260869565,27.688130813447845
Task_43889,2683,475,170,99,269,5.63655462184874,51.648009129308015
Task_43890,1179,743,67,119,186,1.5846774193548387,28.301597428528822
Task_43891,924,999,181,57,238,0.924,24.806127627359885
Task_43892,2815,475,198,83,281,5.913865546218488,53.48959973237677
Task_43893,2923,777,76,193,269,3.7570694087403598,56.704237217835505
Task_43894,868,945,19,50,69,0.9175475687103594,22.001524398861573
Task_43895,2700,215,194,102,296,12.5,51.150887851684296
Task_43896,1039,137,200,126,326,7.528985507246377,24.476872917525665
Task_43897,2185,530,111,25,136,4.114877589453861,42.29012329785463
Task_43898,726,1002,84,117,201,0.7238285144566301,22.1186307059136
Task_43899,1978,987,24,37,61,2.0020242914979756,39.50633665970361
Task_43900,1760,311,45,175,220,5.641025641025641,36.40774533254581
Task_43901,2716,438,65,25,90,6.186788154897494,49.84328460809379
Task_43902,2696,365,153,15,168,7.366120218579235,49.8958695628474
Task_43903,2984,581,144,147,291,5.1271477663230245,56.941036235716545
Task_43904,1991,554,198,198,396,3.5873873873873876,41.678512310878624
Task_43905,689,232,62,198,260,2.9570815450643777,19.559843527399774
Task_43906,2879,781,197,24,221,3.6815856777493607,54.687449165835766
Task_43907,1492,436,126,37,163,3.414187643020595,31.30056790958822
Task_43908,887,1018,156,137,293,0.8704612365063789,25.006288780032705
Task_43909,2876,760,97,68,165,3.7792378449408672,54.64431462137528
Task_43910,1044,697,160,98,258,1.495702005730659,26.321192687566153
Task_43911,708,123,54,97,151,5.709677419354839,18.007639593055753
Task_43912,1003,265,148,63,211,3.7706766917293235,23.621587155421512
Task_43913,1704,741,186,190,376,2.2964959568733154,37.61945870594891
Task_43914,1469,962,193,42,235,1.525441329179647,33.03461727759829
Task_43915,2481,973,102,101,203,2.547227926078029,49.74419817272703
Task_43916,1076,95,77,55,132,11.208333333333334,22.816854042998823
Task_43917,1608,458,186,11,197,3.503267973856209,33.34739625930657
Task_43918,2067,90,173,47,220,22.714285714285715,38.79947306646654
Task_43919,2311,841,181,104,285,2.7446555819477436,47.01243842093822
Task_43920,2945,913,24,113,137,3.2221006564551424,56.37724117647654
Task_43921,798,413,28,13,41,1.9275362318840579,18.66238878930406
Task_43922,2559,201,28,27,55,12.668316831683168,46.164410628690575
Task_43923,506,894,186,164,350,0.5653631284916201,18.975101867288984
Task_43924,1445,243,177,142,319,5.922131147540983,31.59508487344478
Task_43925,1411,959,72,126,198,1.4697916666666666,32.83651299387187
Task_43926,1115,496,74,194,268,2.243460764587525,27.174558310826416
Task_43927,2973,437,66,197,263,6.787671232876712,56.36728070860746
Task_43928,2377,342,134,144,278,6.930029154518951,46.485929721816696
Task_43929,2148,76,46,28,74,27.896103896103895,38.368832292202654
Task_43930,2738,539,115,126,241,5.07037037037037,52.65438277762022
Task_43931,1441,601,171,80,251,2.393687707641196,32.005596476477585
Task_43932,2400,984,24,103,127,2.436548223350254,47.94284852572385
Task_43933,1351,509,178,92,270,2.649019607843137,30.578732789489848
Task_43934,1319,790,90,28,118,1.6675094816687737,29.24078982908728
Task_43935,1687,689,100,86,186,2.444927536231884,35.75707583536663
Task_43936,941,804,138,26,164,1.168944099378882,23.753011738243714
Task_43937,2176,1009,109,125,234,2.1544554455445546,45.197852884451926
Task_43938,1117,1012,97,156,253,1.102665350444225,28.42316769652079
Task_43939,1981,688,193,122,315,2.8751814223512335,41.46672534854513
Task_43940,2992,269,169,71,240,11.08148148148148,55.23757489835219
Task_43941,2721,77,176,50,226,34.88461538461539,48.914272371407584
Task_43942,2119,471,176,84,260,4.489406779661017,42.36569892669197
Task_43943,2853,77,35,143,178,36.57692307692308,51.49538162172778
Task_43944,2834,280,158,179,337,10.08540925266904,53.81208310188803
Task_43945,2854,991,195,48,243,2.877016129032258,55.12487691191752
Task_43946,2507,158,200,89,289,15.767295597484276,47.40340476273021
Task_43947,2924,520,40,125,165,5.612284069097889,55.13059873662902
Task_43948,2616,869,10,55,65,3.0068965517241377,49.57317512579984
Task_43949,573,580,43,72,115,0.9862306368330465,17.267631805545786
Task_43950,2720,600,57,40,97,4.525790349417638,50.51888819989637
Task_43951,1853,1006,117,27,144,1.840119165839126,38.54887232781831
Task_43952,821,639,155,22,177,1.2828125,21.23696949987345
Task_43953,2113,494,187,194,381,4.268686868686869,43.34504817158125
Task_43954,1792,189,112,114,226,9.43157894736842,36.43221473919228
Task_43955,2694,581,92,33,125,4.628865979381444,50.576951507946184
Task_43956,1996,537,143,128,271,3.7100371747211898,41.03761650666811
Task_43957,1157,751,80,116,196,1.538563829787234,28.153630506020345
Task_43958,503,199,190,108,298,2.515,16.442334244890887
Task_43959,2155,362,25,19,44,5.9366391184573,39.939553193739954
Task_43960,2843,246,50,195,245,11.510121457489879,53.62613494539965
Task_43961,1386,276,17,78,95,5.003610108303249,28.89455305342845
Task_43962,1996,793,192,98,290,2.513853904282116,41.88870992365202
Task_43963,1122,562,100,200,300,1.9928952042628774,27.51372462015475
Task_43964,1007,91,111,149,260,10.945652173913043,23.210222690516645
Task_43965,2692,805,86,16,102,3.339950372208437,50.71009740287306
Task_43966,1880,790,84,131,215,2.3767383059418457,39.79593188377507
Task_43967,1392,692,73,22,95,2.0086580086580086,29.917466027094942
Task_43968,1672,1008,148,76,224,1.6570862239841426,36.730992239899344
Task_43969,2785,534,100,45,145,5.205607476635514,51.89110811488566
Task_43970,1037,944,159,102,261,1.0973544973544973,26.890395778808923
Task_43971,980,190,52,63,115,5.130890052356021,22.677325802600762
Task_43972,804,329,73,39,112,2.4363636363636365,19.59141043554398
Task_43973,2059,163,71,105,176,12.554878048780488,39.9332541717428
Task_43974,572,411,165,191,356,1.3883495145631068,18.50515789121655
Task_43975,1474,725,44,148,192,2.0303030303030303,33.048776979095514
Task_43976,2643,451,178,156,334,5.847345132743363,51.32768229795363
Task_43977,900,258,145,102,247,3.474903474903475,22.651391251711118
Task_43978,2178,923,113,80,193,2.357142857142857,44.42394829465595
Task_43979,2267,92,185,51,236,24.376344086021504,42.19179956166562
Task_43980,2780,215,182,16,198,12.87037037037037,51.02298835388428
Task_43981,2344,936,119,186,305,2.501600853788687,48.04224788318021
Task_43982,844,1004,22,104,126,0.8398009950248756,23.19295009990076
Task_43983,2676,907,52,165,217,2.947136563876652,52.95487883185765
Task_43984,1944,697,121,98,219,2.7851002865329515,40.44433176598526
Task_43985,1734,276,155,44,199,6.259927797833935,34.88371228195576
Task_43986,662,649,187,51,238,1.0184615384615385,19.4816372797017
Task_43987,1746,570,53,111,164,3.0577933450087564,36.73099505260808
Task_43988,1813,82,187,20,207,21.843373493975903,34.517210584421285
Task_43989,1287,552,157,169,326,2.3273056057866186,30.166803451286338
Task_43990,678,901,34,51,85,0.7516629711751663,19.343415521162587
Task_43991,1762,123,121,82,203,14.209677419354838,34.91840083802695
Task_43992,2977,867,196,92,288,3.4297235023041477,57.541441081832765
Task_43993,1259,208,68,89,157,6.023923444976076,27.401005202154284
Task_43994,1543,678,58,21,79,2.272459499263623,31.6348830888645
Task_43995,2759,322,178,99,277,8.541795665634675,52.373353301064036
Task_43996,1364,966,157,122,279,1.4105480868665978,32.32679846714546
Task_43997,575,866,147,20,167,0.6632064590542099,18.21194466870135
Task_43998,2389,203,93,157,250,11.71078431372549,46.178343059689134
Task_43999,1579,871,101,125,226,1.8107798165137614,35.272722494865384
Task_44000,786,670,100,43,143,1.1713859910581221,20.636899743929906
Task_44001,1112,389,41,198,239,2.8512820512820514,26.544090437083387
Task_44002,1211,317,152,95,247,3.808176100628931,27.72252021641042
Task_44003,2747,222,108,79,187,12.318385650224215,51.054795901769005
Task_44004,2870,630,71,164,235,4.5483359746434235,55.191994549094716
Task_44005,1045,70,139,115,254,14.71830985915493,23.56812088058179
Task_44006,673,711,104,64,168,0.9452247191011236,19.460013821122317
Task_44007,2183,293,107,136,243,7.425170068027211,43.08058535920247
Task_44008,2056,612,49,108,157,3.3539967373572592,41.521825904490484
Task_44009,1406,958,148,177,325,1.4661105318039624,33.27004126844799
Task_44010,2603,853,75,73,148,3.048009367681499,50.51952152323431
Task_44011,1084,1006,50,26,76,1.0764647467725919,25.50292064767682
Task_44012,1953,573,123,135,258,3.402439024390244,40.422745321162566
Task_44013,1257,868,162,89,251,1.4464902186421174,29.96956272194726
Task_44014,611,159,96,199,295,3.81875,17.900542834705558
Task_44015,950,958,19,182,201,0.9906152241918665,25.35595738713467
Task_44016,662,140,120,31,151,4.695035460992908,16.68923028017121
Task_44017,680,1007,159,200,359,0.6746031746031746,22.219488763518118
Task_44018,1602,993,38,105,143,1.6116700201207244,35.322416781469656
Task_44019,2109,213,97,80,177,9.855140186915888,40.78900415280065
Task_44020,1453,645,173,45,218,2.2492260061919507,31.681024559999873
Task_44021,1932,756,109,191,300,2.5521796565389696,40.93720549600888
Task_44022,601,124,185,187,372,4.808,17.760820704765795
Task_44023,1696,254,119,133,252,6.650980392156863,35.283828524324925
Task_44024,1307,743,151,94,245,1.756720430107527,30.53645974765641
Task_44025,2977,600,65,17,82,4.953410981697171,54.28775529076421
Task_44026,2149,780,181,18,199,2.7516005121638925,42.83158515901829
Task_44027,953,958,92,40,132,0.9937434827945777,24.376016257910308
Task_44028,1282,1012,81,144,225,1.265547877591313,31.011245148458084
Task_44029,1284,810,175,173,348,1.5832305795314427,30.98669053815782
Task_44030,2740,68,167,96,263,39.710144927536234,50.107983385599255
Task_44031,2812,227,50,100,150,12.333333333333334,52.153524863975946
Task_44032,1200,204,179,12,191,5.853658536585366,26.036626921989665
Task_44033,2046,300,45,199,244,6.79734219269103,41.03581391258285
Task_44034,2511,977,35,110,145,2.567484662576687,49.7559050623989
Task_44035,2103,747,191,151,342,2.8114973262032086,43.74863867675261
Task_44036,2576,384,35,147,182,6.6909090909090905,49.19801065491013
Task_44037,1236,589,55,132,187,2.094915254237288,28.915902475082447
Task_44038,647,773,153,54,207,0.8359173126614987,19.563656052769776
Task_44039,1885,877,20,105,125,2.146924829157175,39.401294361651416
Task_44040,2332,407,143,91,234,5.715686274509804,45.56899901602102
Task_44041,2676,413,168,43,211,6.463768115942029,50.30835350687173
Task_44042,2769,356,184,190,374,7.756302521008403,53.234292954675915
Task_44043,709,388,182,194,376,1.8226221079691516,20.76369679478083
Task_44044,1185,1006,27,76,103,1.1767626613704072,28.18205726846023
Task_44045,1993,908,44,111,155,2.1925192519251926,41.307662155623696
Task_44046,2216,441,95,99,194,5.013574660633484,43.877441630281815
Task_44047,1833,83,31,126,157,21.821428571428573,35.16601513942692
Task_44048,1787,258,27,97,124,6.899613899613899,35.938526036627124
Task_44049,1659,776,124,154,278,2.135135135135135,36.52134979630208
Task_44050,992,465,146,169,315,2.128755364806867,25.173271266618013
Task_44051,1675,116,15,87,102,14.316239316239317,32.520477488120726
Task_44052,2962,933,164,40,204,3.171306209850107,56.47158923747045
Task_44053,2511,855,60,164,224,2.933411214953271,50.16608741678643
Task_44054,2333,390,193,132,325,5.966751918158568,46.14499627322984
Task_44055,1050,205,18,169,187,5.097087378640777,24.60685813946427
Task_44056,2643,192,49,94,143,13.694300518134716,49.31838977144394
Task_44057,885,589,74,179,253,1.5,23.695844599944692
Task_44058,595,456,163,62,225,1.301969365426696,17.791542984987192
Task_44059,1468,481,10,82,92,3.045643153526971,30.979090192739662
Task_44060,873,282,24,80,104,3.0848056537102475,21.02026525188209
Task_44061,1841,216,135,133,268,8.483870967741936,37.51031904881011
Task_44062,503,580,160,64,224,0.8657487091222031,16.797424002819252
Task_44063,2533,122,200,44,244,20.59349593495935,46.72686798113464
Task_44064,2928,542,186,125,311,5.392265193370166,55.98649649228878
Task_44065,2557,182,126,191,317,13.972677595628415,48.81964748334957
Task_44066,1387,456,115,25,140,3.035010940919037,29.39775333494579
Task_44067,2715,108,188,51,239,24.908256880733944,49.439414337069046
Task_44068,1444,169,63,49,112,8.494117647058824,28.678827796655998
Task_44069,1359,92,110,167,277,14.612903225806452,28.83247445958555
Task_44070,958,208,96,132,228,4.583732057416268,23.41139617481312
Task_44071,2045,829,132,136,268,2.463855421686747,42.7307454807378
Task_44072,2641,341,188,102,290,7.722222222222222,50.65067050789346
Task_44073,1540,738,163,145,308,2.0838971583220567,34.63963905531519
Task_44074,1821,552,133,150,283,3.2929475587703436,38.40066431476175
Task_44075,1523,847,128,128,256,1.7959905660377358,34.45043938987494
Task_44076,2981,125,188,61,249,23.658730158730158,54.08585384943634
Task_44077,2851,285,136,190,326,9.968531468531468,54.065514737617264
Task_44078,2668,143,13,127,140,18.52777777777778,48.91395953152891
Task_44079,2748,963,18,164,182,2.8506224066390042,53.73713168016576
Task_44080,1350,983,15,65,80,1.3719512195121952,30.24122718593264
Task_44081,2349,134,90,67,157,17.4,43.31706155898602
Task_44082,2430,901,117,123,240,2.694013303769401,48.9104657419206
Task_44083,2581,179,12,87,99,14.338888888888889,47.129144920302586
Task_44084,649,425,91,120,211,1.5234741784037558,19.088871784136686
Task_44085,2506,949,169,123,292,2.6378947368421053,50.498908270825495
Task_44086,1812,438,67,199,266,4.12756264236902,38.01158552641835
Task_44087,1365,860,88,99,187,1.5853658536585367,31.557413194619304
Task_44088,1341,546,165,180,345,2.4515539305301646,31.104743470434226
Task_44089,743,825,101,86,187,0.8995157384987893,21.29447177091263
Task_44090,2955,223,139,100,239,13.191964285714286,54.94976898533823
Task_44091,1991,680,91,152,243,2.923641703377386,41.36871484367816
Task_44092,848,78,85,92,177,10.734177215189874,19.9108263517904
Task_44093,775,111,95,46,141,6.919642857142857,18.11291018533164
Task_44094,1697,704,138,30,168,2.40709219858156,35.36053224956811
Task_44095,836,499,158,45,203,1.672,21.384976284932026
Task_44096,1353,506,97,132,229,2.668639053254438,30.599163855256574
Task_44097,2472,89,59,80,139,27.466666666666665,45.12085525418976
Task_44098,654,177,28,81,109,3.6741573033707864,16.79208500268796
Task_44099,2877,753,166,17,183,3.815649867374005,54.037798574912735
Task_44100,2402,791,101,191,292,3.032828282828283,48.45672451398489
Task_44101,598,849,131,88,219,0.7035294117647058,19.394299275838037
Task_44102,2599,583,164,72,236,4.450342465753424,50.07684249028346
Task_44103,1982,902,107,76,183,2.194905869324474,40.932621843817934
Task_44104,853,220,121,150,271,3.8597285067873304,21.96144831110689
Task_44105,1633,737,107,23,130,2.2127371273712737,34.19824945075451
Task_44106,2330,271,92,124,216,8.566176470588236,45.26502297744884
Task_44107,1220,661,30,192,222,1.8429003021148036,29.052786900042605
Task_44108,2070,876,71,43,114,2.3603192702394526,41.43319280218829
Task_44109,1536,242,50,187,237,6.320987654320987,32.91510671942354
Task_44110,1565,566,154,194,348,2.760141093474427,34.748698344937196
Task_44111,1658,595,30,177,207,2.7818791946308723,35.69332427570624
Task_44112,2408,501,54,171,225,4.796812749003984,47.460065285107994
Task_44113,1172,980,102,174,276,1.1946992864424058,29.376657693011847
Task_44114,2514,734,132,142,274,3.4204081632653063,49.89899680502117
Task_44115,1976,622,109,171,280,3.171749598715891,41.093845238692815
Task_44116,1885,958,161,36,197,1.9655891553701772,39.455414699578114
Task_44117,2256,314,31,185,216,7.161904761904762,44.29265729557267
Task_44118,2147,718,48,12,60,2.9860917941585536,41.128882303874164
Task_44119,2433,548,108,52,160,4.4316939890710385,46.68956287425866
Task_44120,2102,188,11,168,179,11.121693121693122,41.01029080708447
Task_44121,506,604,44,128,172,0.8363636363636363,16.949233068427244
Task_44122,2869,783,66,65,131,3.6594387755102042,54.45217168220699
Task_44123,2928,197,74,125,199,14.787878787878787,54.45152566454622
Task_44124,781,317,42,179,221,2.4559748427672954,20.97054470800245
Task_44125,1408,424,54,37,91,3.3129411764705883,29.158976790598775
Task_44126,1568,348,153,70,223,4.492836676217765,32.90886540922964
Task_44127,1259,431,88,183,271,2.9143518518518516,29.13352949365506
Task_44128,518,261,66,127,193,1.9770992366412214,16.54053119784845
Task_44129,2764,498,16,136,152,5.539078156312625,52.1605759406911
Task_44130,2771,317,21,44,65,8.713836477987421,49.90848775747682
Task_44131,1297,273,152,172,324,4.733576642335766,29.424883131977822
Task_44132,569,600,120,136,256,0.9467554076539102,18.515287881575098
Task_44133,1884,813,178,64,242,2.3144963144963144,39.45204652217841
Task_44134,2855,439,95,13,108,6.488636363636363,52.35478173825968
Task_44135,2151,419,110,99,209,5.121428571428571,42.77447642425519
Task_44136,1812,524,195,79,274,3.4514285714285715,37.731824105639745
Task_44137,1677,772,40,200,240,2.169469598965071,36.70262149064091
Task_44138,1082,92,10,121,131,11.634408602150538,23.23265241080975
Task_44139,607,359,63,13,76,1.6861111111111111,15.628333864729754
Task_44140,1198,811,37,180,217,1.4753694581280787,29.06030264451175
Task_44141,941,208,35,128,163,4.502392344497608,22.651309281899756
Task_44142,1882,874,163,92,255,2.150857142857143,40.06463543088314
Task_44143,2860,344,108,127,235,8.289855072463768,53.91366560836523
Task_44144,812,472,128,40,168,1.7167019027484143,20.598336574584255
Task_44145,595,223,80,126,206,2.65625,17.69617737625786
Task_44146,1626,850,69,200,269,1.9106933019976498,36.377357572171746
Task_44147,2819,442,139,77,216,6.363431151241535,53.07746217064261
Task_44148,2865,783,102,12,114,3.6543367346938775,53.58303343580119
Task_44149,1224,404,15,63,78,3.022222222222222,26.236039896194058
Task_44150,1884,862,66,45,111,2.183082271147161,38.27678621416915
Task_44151,561,392,79,53,132,1.4274809160305344,16.59338839507414
Task_44152,731,674,121,120,241,1.082962962962963,21.142491857729656
Task_44153,1108,972,93,88,181,1.1387461459403905,27.442588496575695
Task_44154,2337,176,101,140,241,13.203389830508474,44.66016405660599
Task_44155,677,888,105,158,263,0.7615298087739033,21.19520577382173
Task_44156,2407,317,87,25,112,7.569182389937107,44.84780382263809
Task_44157,2646,846,19,176,195,3.12396694214876,52.016237650354576
Task_44158,2888,133,181,138,319,21.55223880597015,53.49238308821912
Task_44159,1548,320,171,173,344,4.822429906542056,33.64119262769551
Task_44160,1405,178,98,136,234,7.849162011173185,29.961693156463777
Task_44161,1324,720,93,42,135,1.8363384188626908,29.4388080139921
Task_44162,612,428,70,52,122,1.4265734265734267,17.231407118865302
Task_44163,2868,441,48,156,204,6.48868778280543,54.39335728617284
Task_44164,1541,175,124,183,307,8.755681818181818,32.48399939835914
Task_44165,2662,950,174,173,347,2.7991587802313354,53.2952207450377
Task_44166,1102,721,67,117,184,1.5263157894736843,26.957619049600023
Task_44167,2415,223,147,193,340,10.78125,47.013369873788214
Task_44168,616,360,15,33,48,1.706371191135734,15.958640383534414
Task_44169,1263,856,178,132,310,1.4737456242707119,30.554278975669522
Task_44170,2358,998,174,35,209,2.3603603603603602,47.13328962805326
Task_44171,1876,808,181,185,366,2.318912237330037,40.501156487724316
Task_44172,1901,184,142,26,168,10.275675675675675,36.82897985876165
Task_44173,2420,903,127,12,139,2.6769911504424777,47.07511455539938
Task_44174,742,966,91,94,185,0.7673216132368149,21.79058257976114
Task_44175,2755,398,171,78,249,6.904761904761905,52.12945190021142
Task_44176,992,672,134,70,204,1.473997028231798,24.706221675003246
Task_44177,2886,953,47,170,217,3.0251572327044025,56.31420879186953
Task_44178,2216,145,70,22,92,15.178082191780822,40.784512954121105
Task_44179,2138,531,82,43,125,4.018796992481203,41.46453967766063
Task_44180,1897,747,181,130,311,2.536096256684492,40.31474071511197
Task_44181,1282,536,60,87,147,2.387337057728119,28.7860483971161
Task_44182,791,150,100,133,233,5.23841059602649,20.235610716226063
Task_44183,1869,155,133,140,273,11.98076923076923,37.43544491092915
Task_44184,2447,261,149,144,293,9.33969465648855,47.376880551961335
Task_44185,2242,149,48,188,236,14.946666666666667,43.30233196767232
Task_44186,2491,706,75,17,92,3.5233380480905234,47.22118717094562
Task_44187,917,899,154,40,194,1.018888888888889,23.902216135223295
Task_44188,2884,172,128,13,141,16.670520231213874,51.74079529460075
Task_44189,2238,632,68,133,201,3.5355450236966823,44.98537303333405
Task_44190,1709,900,48,35,83,1.8967813540510543,35.41413184571753
Task_44191,1956,520,116,134,250,3.7543186180422263,40.264273045231974
Task_44192,2711,718,27,47,74,3.7705146036161334,50.297304350391705
Task_44193,1254,510,93,58,151,2.4540117416829745,27.874008217454925
Task_44194,767,227,71,52,123,3.3640350877192984,19.168927664300018
Task_44195,1959,493,134,51,185,3.965587044534413,39.20831856499145
Task_44196,2166,919,128,48,176,2.3543478260869564,43.5292801359447
Task_44197,680,655,12,60,72,1.0365853658536586,18.166984999852428
Task_44198,2081,549,73,198,271,3.7836363636363637,42.65129190286839
Task_44199,2833,176,73,82,155,16.005649717514125,51.62766609236553
Task_44200,911,492,114,40,154,1.8478701825557808,22.05767224945065
Task_44201,1632,874,181,194,375,1.8651428571428572,36.89451973745823
Task_44202,1210,193,173,177,350,6.237113402061856,27.905024460601776
Task_44203,1883,181,85,43,128,10.346153846153847,36.14086321572993
Task_44204,2792,180,139,46,185,15.425414364640885,50.83918234056022
Task_44205,1574,292,98,199,297,5.3720136518771335,33.799053135189254
Task_44206,2713,606,43,20,63,4.469522240527183,49.72231048242545
Task_44207,638,532,57,56,113,1.1969981238273921,17.969522423228963
Task_44208,1736,208,143,36,179,8.30622009569378,34.42234649228819
Task_44209,915,753,164,168,332,1.2135278514588859,24.803946089784407
Task_44210,2074,955,67,115,182,2.1694560669456067,43.104399133261836
Task_44211,1830,424,187,24,211,4.305882352941176,36.89457134350464
Task_44212,2689,271,50,39,89,9.886029411764707,48.899426714304724
Task_44213,2502,361,23,189,212,6.911602209944752,48.392173914292584
Task_44214,652,326,193,77,270,1.9938837920489296,18.65826251365112
Task_44215,551,763,192,107,299,0.7212041884816754,18.98605972950902
Task_44216,2636,829,125,99,224,3.175903614457831,51.82708613029905
Task_44217,639,425,113,135,248,1.5,19.066060152071284
Task_44218,1878,546,46,28,74,3.43327239488117,36.539161813627544
Task_44219,1879,918,166,87,253,2.044613710554951,39.984196204530484
Task_44220,594,577,10,167,177,1.027681660899654,18.229767680157128
Task_44221,2584,909,192,125,317,2.8395604395604397,51.725620499852276
Task_44222,671,1023,91,96,187,0.6552734375,21.271809761033087
Task_44223,1011,227,152,19,171,4.434210526315789,22.729497972192224
Task_44224,1635,647,164,91,255,2.5231481481481484,35.39566425102013
Task_44225,1634,665,96,79,175,2.4534534534534536,34.887619310372855
Task_44226,1804,539,104,90,194,3.3407407407407406,37.43441620564244
Task_44227,690,453,190,124,314,1.5198237885462555,20.24220307585664
Task_44228,1325,187,151,42,193,7.047872340425532,28.26776803885778
Task_44229,2270,812,96,47,143,2.7921279212792127,44.645919349671374
Task_44230,1679,722,95,74,169,2.322268326417704,35.57756510290245
Task_44231,1940,510,43,99,142,3.796477495107632,39.14073238289195
Task_44232,658,550,44,51,95,1.1941923774954628,18.078731541273587
Task_44233,1453,172,130,154,284,8.398843930635838,30.96411803508578
Task_44234,1753,162,140,51,191,10.754601226993865,34.733344552682354
Task_44235,2932,111,181,149,330,26.178571428571427,53.83863785923267
Task_44236,2835,705,143,153,296,4.015580736543909,55.00766876544409
Task_44237,1534,596,71,54,125,2.5695142378559463,32.48467138535481
Task_44238,570,524,97,77,174,1.0857142857142856,17.40603866034962
Task_44239,1971,916,169,26,195,2.149400218102508,40.632007897461925
Task_44240,1971,922,25,170,195,2.1354279523293607,41.617484236800614
Task_44241,1427,370,113,199,312,3.8463611859838274,31.784823850404365
Task_44242,2622,604,86,170,256,4.333884297520661,51.19994991112216
Task_44243,1938,821,31,58,89,2.3576642335766422,39.065419949264246
Task_44244,2619,483,105,184,289,5.411157024793388,50.89048437981287
Task_44245,1423,889,25,34,59,1.598876404494382,30.40295055223684
Task_44246,1029,775,27,107,134,1.3260309278350515,25.496187454738177
Task_44247,2175,634,24,168,192,3.425196850393701,43.92531291294824
Task_44248,2654,609,103,84,187,4.350819672131148,50.90163977516672
Task_44249,856,379,77,145,222,2.2526315789473683,22.421066130003954
Task_44250,2247,73,53,18,71,30.364864864864863,39.351942032184105
Task_44251,2637,82,69,142,211,31.771084337349397,48.52287603820383
Task_44252,912,942,110,73,183,0.9671261930010604,24.06581930193052
Task_44253,1493,520,189,19,208,2.8656429942418424,31.690116525921823
Task_44254,2270,452,188,194,382,5.011037527593819,45.69915430148243
Task_44255,1306,803,174,42,216,1.6243781094527363,29.89019469791837
Task_44256,2157,229,151,89,240,9.378260869565217,42.170657560493744
Task_44257,816,747,132,57,189,1.0909090909090908,21.92849244424403
Task_44258,2565,669,165,115,280,3.828358208955224,50.489135166321795
Task_44259,2215,180,136,109,245,12.237569060773481,42.754651816774185
Task_44260,715,452,70,24,94,1.5783664459161149,18.456475779472374
Task_44261,630,223,150,115,265,2.8125,18.371415692197804
Task_44262,2710,450,167,200,367,6.008869179600887,52.598102218592544
Task_44263,2530,339,182,171,353,7.4411764705882355,49.2732690550028
Task_44264,2918,351,191,101,292,8.289772727272727,55.07402517200645
Task_44265,2607,556,69,150,219,4.6804308797127465,50.692303216482564
Task_44266,2936,815,135,179,314,3.5980392156862746,57.07392101374948
Task_44267,1058,150,145,174,319,7.006622516556291,24.890840775290666
Task_44268,2133,589,86,138,224,3.6152542372881356,43.217102381417796
Task_44269,1244,341,168,137,305,3.6374269005847952,28.6736033537168
Task_44270,1091,382,99,149,248,2.848563968668407,26.147489607751144
Task_44271,1668,1009,42,112,154,1.6514851485148514,36.41897838008847
Task_44272,1551,965,132,69,201,1.6055900621118013,34.46124700335064
Task_44273,821,463,195,177,372,1.769396551724138,22.71544806721727
Task_44274,2187,678,13,94,107,3.2209131075110458,43.35177456794806
Task_44275,1423,344,157,184,341,4.12463768115942,31.745746607215835
Task_44276,1027,902,200,35,235,1.1373200442967886,25.911887908594903
Task_44277,1842,816,195,23,218,2.254589963280294,38.361253279411336
Task_44278,2555,1022,139,147,286,2.4975562072336266,51.511039486107926
Task_44279,1955,170,132,154,286,11.432748538011696,38.89368795460667
Task_44280,592,518,102,187,289,1.140655105973025,18.8338981912347
Task_44281,1047,975,15,52,67,1.0727459016393444,25.072165563425596
Task_44282,1819,522,166,138,304,3.478011472275335,38.35081963570614
Task_44283,1381,468,136,96,232,2.9445628997867805,30.882772442159666
Task_44284,1991,552,140,32,172,3.600361663652803,39.67236252772606
Task_44285,2981,254,123,44,167,11.690196078431372,54.19698258562335
Task_44286,2132,379,85,44,129,5.610526315789474,40.95525301262112
Task_44287,2776,553,118,108,226,5.0108303249097474,53.20716945158839
Task_44288,820,572,118,171,289,1.431064572425829,22.602344267831267
Task_44289,2199,207,119,108,227,10.572115384615385,42.90719694588288
Task_44290,2935,732,190,11,201,4.004092769440655,55.25010686510985
Task_44291,1504,345,143,128,271,4.3468208092485545,32.632623437536466
Task_44292,638,910,152,182,334,0.7003293084522503,21.079566378186644
Task_44293,1599,590,195,56,251,2.7055837563451774,34.297335628359725
Task_44294,693,862,95,154,249,0.8030127462340672,21.362621337117414
Task_44295,2429,396,138,98,236,6.1183879093199,47.23620985863212
Task_44296,1639,521,167,174,341,3.1398467432950192,35.717303255987716
Task_44297,973,858,53,146,199,1.1327124563445867,25.5709720811613
Task_44298,1828,637,138,69,207,2.865203761755486,37.84832330053646
Task_44299,1809,288,94,47,141,6.259515570934256,35.68658348740144
Task_44300,2711,451,191,70,261,5.997787610619469,51.50435753832861
Task_44301,1230,834,174,83,257,1.473053892215569,29.363170679667775
Task_44302,836,883,155,130,285,0.9457013574660633,23.742921883429148
Task_44303,2382,102,15,192,207,23.12621359223301,44.67749291217633
Task_44304,2031,336,34,196,230,6.026706231454006,40.880931950127085
Task_44305,940,281,158,27,185,3.3333333333333335,22.115118522058037
Task_44306,1789,499,72,24,96,3.578,35.58202416322455
Task_44307,1457,193,169,125,294,7.510309278350515,31.474460853803915
Task_44308,2487,105,144,97,241,23.462264150943398,46.334606343557596
Task_44309,590,806,115,165,280,0.7311028500619579,19.641689154061904
Task_44310,2718,818,105,177,282,3.318681318681319,53.48230338820607
Task_44311,532,973,177,89,266,0.5462012320328542,18.940754138601275
Task_44312,2071,622,48,28,76,3.3242375601926164,39.84089168420966
Task_44313,1254,77,86,186,272,16.076923076923077,27.066951807861386
Task_44314,1082,72,130,104,234,14.821917808219178,24.03971574584645
Task_44315,1210,382,133,34,167,3.1592689295039165,26.65405935781529
Task_44316,540,903,80,32,112,0.5973451327433629,17.577112123036077
Task_44317,540,726,130,130,260,0.7427785419532325,18.397840574441833
Task_44318,2314,554,162,176,338,4.169369369369369,46.499365080037514
Task_44319,979,184,110,135,245,5.291891891891892,23.536921580419833
Task_44320,2510,84,179,43,222,29.529411764705884,45.64988596701978
Task_44321,2509,217,65,33,98,11.509174311926605,45.89918298159093
Task_44322,2135,308,81,103,184,6.909385113268608,41.98494037073571
Task_44323,1123,356,26,30,56,3.145658263305322,24.014679854909016
Task_44324,767,402,29,67,96,1.903225806451613,19.49083028826089
Task_44325,1949,970,47,181,228,2.007209062821833,41.58480327451267
Task_44326,2147,985,115,154,269,2.1774847870182557,44.86391788917938
Task_44327,2790,110,11,169,180,25.135135135135137,50.73733192766185
Task_44328,2429,402,63,173,236,6.027295285359801,47.49073478966659
Task_44329,2201,257,175,34,209,8.531007751937985,42.26458288886334
Task_44330,1901,790,174,40,214,2.4032869785082176,39.258563635335065
Task_44331,1022,591,105,191,296,1.7263513513513513,25.976184017563927
Task_44332,1786,71,63,13,76,24.805555555555557,32.163302243466724
Task_44333,1902,517,147,48,195,3.671814671814672,38.336909281940365
Task_44334,1921,350,88,92,180,5.472934472934473,38.51718101286627
Task_44335,2774,108,82,162,244,25.44954128440367,51.04047865857274
Task_44336,2447,923,198,194,392,2.648268398268398,50.03766556924145
Task_44337,2342,400,148,195,343,5.840399002493766,46.49398373555584
Task_44338,913,207,171,64,235,4.389423076923077,22.121363684465607
Task_44339,1199,686,32,40,72,1.745269286754003,26.277162258680548
Task_44340,2598,364,36,117,153,7.117808219178082,49.11678487897251
Task_44341,819,248,109,25,134,3.289156626506024,19.76921728031018
Task_44342,1624,878,72,71,143,1.8475540386803186,35.047424049853014
Task_44343,2259,139,124,65,189,16.135714285714286,42.553558394158486
Task_44344,1009,227,75,85,160,4.425438596491228,23.458181492676463
Task_44345,1682,306,137,76,213,5.478827361563518,34.61936595980911
Task_44346,1058,661,50,93,143,1.5981873111782476,25.818826466266795
Task_44347,897,720,199,198,397,1.2441054091539527,24.75338174462438
Task_44348,2610,348,149,110,259,7.478510028653295,50.05629786276429
Task_44349,2934,354,157,123,280,8.264788732394367,55.31561415817555
Task_44350,2068,655,41,101,142,3.152439024390244,41.64188137419064
Task_44351,2880,95,11,163,174,30.0,52.09534169056638
Task_44352,1239,229,117,22,139,5.386956521739131,26.29402815132723
Task_44353,2585,372,109,125,234,6.93029490616622,49.651482174043586
Task_44354,1994,611,183,170,353,3.258169934640523,41.671734691459214
Task_44355,2020,670,141,33,174,3.0104321907600595,40.52219159282979
Task_44356,939,650,183,94,277,1.4423963133640554,24.50721102739618
Task_44357,2656,887,125,109,234,2.990990990990991,52.40015545243532
Task_44358,2855,452,68,99,167,6.30242825607064,53.770802454591006
Task_44359,1361,764,70,110,180,1.7790849673202613,31.20200773442257
Task_44360,844,383,124,172,296,2.1979166666666665,22.4910699392989
Task_44361,2496,215,81,30,111,11.555555555555555,45.90210872886566
Task_44362,1300,880,114,86,200,1.4755959137343928,30.391764970659413
Task_44363,607,306,32,20,52,1.977198697068404,15.50877398750437
Task_44364,2562,507,118,165,283,5.043307086614173,50.01101392445222
Task_44365,1813,420,174,142,316,4.306413301662708,37.98885436435603
Task_44366,2804,897,143,99,242,3.1224944320712695,54.783129454444484
Task_44367,802,339,13,60,73,2.3588235294117648,19.174906419592077
Task_44368,2604,771,87,71,158,3.373056994818653,50.087117405611885
Task_44369,2587,222,151,125,276,11.600896860986547,49.33765293107181
Task_44370,805,635,79,71,150,1.2657232704402517,21.231574796204463
Task_44371,1075,310,145,158,303,3.4565916398713825,25.922073305222426
Task_44372,1254,104,51,99,150,11.942857142857143,26.210184659271302
Task_44373,2778,738,27,162,189,3.7591339648173205,53.75404891538273
Task_44374,2806,619,149,185,334,4.525806451612903,54.49330510082094
Task_44375,976,258,122,183,305,3.7683397683397684,24.232489567967935
Task_44376,2921,695,91,81,172,4.19683908045977,55.31309246311782
Task_44377,984,246,167,94,261,3.983805668016194,23.934768675329973
Task_44378,1596,611,13,64,77,2.607843137254902,32.70398886893967
Task_44379,686,553,126,141,267,1.2382671480144405,20.223356444465637
Task_44380,1873,860,166,142,308,2.175377468060395,40.29130709731209
Task_44381,2458,501,194,52,246,4.896414342629482,47.600516145451074
Task_44382,1128,330,54,129,183,3.40785498489426,26.21848902666706
Task_44383,2629,439,32,169,201,5.975,50.52592199150274
Task_44384,927,543,178,181,359,1.7040441176470589,24.591237277759813
Task_44385,652,460,26,155,181,1.4143167028199566,18.901210372300422
Task_44386,2733,261,35,76,111,10.431297709923664,50.46508560369393
Task_44387,1794,719,49,94,143,2.4916666666666667,37.652976501695086
Task_44388,1931,591,106,157,263,3.261824324324324,40.18612114928641
Task_44389,2183,927,47,151,198,2.3523706896551726,44.97982498282769
Task_44390,1153,290,178,197,375,3.9621993127147768,27.471579148721066
Task_44391,775,863,52,124,176,0.8969907407407407,22.11725047100725
Task_44392,668,390,48,22,70,1.7084398976982098,16.866448029790348
Task_44393,1902,484,23,71,94,3.9216494845360823,37.791347030571536
Task_44394,1146,540,18,63,81,2.1182994454713495,25.685339183350212
Task_44395,1834,865,36,23,59,2.1177829099307157,36.78417272078442
Task_44396,2501,132,39,88,127,18.804511278195488,45.88234093339191
Task_44397,955,546,180,90,270,1.7458866544789762,24.34871088017138
Task_44398,1568,941,143,162,305,1.664543524416136,35.71268507379914
Task_44399,2008,992,181,183,364,2.0221550855991945,43.15364856205026
Task_44400,1357,850,199,189,388,1.5945945945945945,32.50054278552391
Task_44401,2019,126,35,47,82,15.89763779527559,37.35220466392073
Task_44402,2735,412,131,41,172,6.62227602905569,50.98908406822818
Task_44403,1061,593,89,149,238,1.7861952861952861,26.3302911659421
Task_44404,936,182,55,105,160,5.114754098360656,22.250631920109498
Task_44405,2095,323,157,190,347,6.466049382716049,42.339918786859215
Task_44406,1480,498,180,162,342,2.9659318637274548,33.11404198882522
Task_44407,804,400,192,46,238,2.0049875311720697,20.760875251924343
Task_44408,678,995,77,96,173,0.6807228915662651,21.229378310847306
Task_44409,2038,431,176,180,356,4.717592592592593,41.821320873759475
Task_44410,2146,960,160,147,307,2.2330905306971904,44.93130103762002
Task_44411,562,283,30,174,204,1.9788732394366197,17.34291468285285
Task_44412,2906,330,71,37,108,8.779456193353475,52.814889785059385
Task_44413,742,734,116,78,194,1.0095238095238095,20.973076975084325
Task_44414,2996,728,86,174,260,4.109739368998628,57.541401421361144
Task_44415,2345,335,44,195,239,6.979166666666667,45.86864430270307
Task_44416,1174,598,182,18,200,1.9599332220367278,26.822624799769248
Task_44417,616,104,93,113,206,5.866666666666666,16.84179435570556
Task_44418,1247,497,96,37,133,2.504016064257028,27.478237515195044
Task_44419,2994,469,187,78,265,6.370212765957447,56.21953956199939
Task_44420,1241,361,51,21,72,3.4281767955801103,25.804708801358213
Task_44421,2270,84,82,81,163,26.705882352941178,42.06616711050853
Task_44422,1217,875,31,171,202,1.389269406392694,29.431444850752467
Task_44423,1826,632,150,189,339,2.8846761453396526,39.04200667988047
Task_44424,2191,461,162,66,228,4.742424242424242,43.13344479272735
Task_44425,2578,77,29,189,218,33.05128205128205,47.59514818480318
Task_44426,1293,755,51,37,88,1.7103174603174602,28.375936002690324
Task_44427,1098,819,199,195,394,1.3390243902439025,28.309588307669355
Task_44428,1607,917,36,147,183,1.7505446623093681,35.514524334443166
Task_44429,1536,627,70,65,135,2.445859872611465,32.849307820116834
Task_44430,1702,635,91,42,133,2.6761006289308176,35.05255399039496
Task_44431,2783,326,192,190,382,8.510703363914374,53.38828758803796
Task_44432,2383,771,126,47,173,3.0867875647668392,46.571254955069094
Task_44433,2047,515,131,169,300,3.9670542635658914,41.96571851036234
Task_44434,1294,221,90,112,202,5.828828828828829,28.611572038421073
Task_44435,1464,720,42,107,149,2.030513176144244,32.310682817471054
Task_44436,2483,729,102,98,200,3.4013698630136986,48.99744274696028
Task_44437,557,453,153,84,237,1.2268722466960353,17.375836158584757
Task_44438,2845,872,46,198,244,3.258877434135166,55.55771079106311
Task_44439,1909,932,173,76,249,2.0460878885316185,40.36173796961665
Task_44440,2809,253,69,159,228,11.059055118110237,52.918054946842524
Task_44441,2731,852,95,15,110,3.201641266119578,51.688874627885525
Task_44442,2547,857,58,196,254,2.9685314685314683,50.95142487503711
Task_44443,1035,1019,50,116,166,1.0147058823529411,26.600322838779693
Task_44444,1965,721,18,107,125,2.721606648199446,40.17808007910377
Task_44445,2020,969,194,188,382,2.082474226804124,43.36077385541415
Task_44446,714,532,106,191,297,1.3395872420262664,20.892576426908498
Task_44447,2896,817,197,33,230,3.5403422982885084,55.18321069231438
Task_44448,561,410,45,88,133,1.364963503649635,16.80608559860714
Task_44449,2834,906,134,156,290,3.1245865490628444,55.601351718230624
Task_44450,1890,414,96,43,139,4.554216867469879,37.31014119935214
Task_44451,1382,439,123,81,204,3.140909090909091,30.31142836820901
Task_44452,1376,799,34,126,160,1.72,31.23875057380809
Task_44453,1201,147,30,79,109,8.114864864864865,25.224350075549264
Task_44454,1331,529,118,61,179,2.5113207547169814,29.250004787737748
Task_44455,1754,637,186,93,279,2.749216300940439,37.440910619976876
Task_44456,2989,249,49,139,188,11.956,55.53932252749082
Task_44457,2088,163,150,128,278,12.731707317073171,40.94653923911199
Task_44458,1129,692,160,177,337,1.6291486291486292,28.1499169986328
Task_44459,723,607,197,191,388,1.1891447368421053,21.63693545878489
Task_44460,715,837,128,52,180,0.8532219570405728,20.592047370711917
Task_44461,1263,940,111,138,249,1.3421891604675877,30.5619424704384
Task_44462,2875,728,134,175,309,3.943758573388203,55.80488706872571
Task_44463,1163,818,13,49,62,1.42002442002442,26.203352125497293
Task_44464,2472,848,42,18,60,2.911660777385159,46.61327037754944
Task_44465,919,335,156,89,245,2.7351190476190474,22.985670071982458
Task_44466,2663,167,147,82,229,15.851190476190476,49.53864323931463
Task_44467,1207,431,180,79,259,2.7939814814814814,27.79157676857926
Task_44468,885,489,184,125,309,1.8061224489795917,23.463302811199668
Task_44469,1901,442,162,114,276,4.291196388261851,39.23134962059876
Task_44470,2844,492,73,17,90,5.768762677484787,52.02982739495868
Task_44471,1296,914,118,62,180,1.4163934426229507,29.915551857094524
Task_44472,1763,248,194,111,305,7.080321285140562,36.52804665139622
Task_44473,1745,804,143,194,337,2.1677018633540373,38.29570047590436
Task_44474,1297,112,119,141,260,11.47787610619469,27.84395302419354
Task_44475,1428,424,155,21,176,3.36,30.157966079028068
Task_44476,2773,740,115,19,134,3.7422402159244266,52.095485513704936
Task_44477,1411,309,85,131,216,4.551612903225807,30.84727281925005
Task_44478,2656,913,134,105,239,2.9059080962800876,52.49812805355123
Task_44479,2178,1002,17,183,200,2.1714855433698905,45.0773457477626
Task_44480,2409,642,95,63,158,3.7465007776049766,46.61642521907732
Task_44481,2397,106,141,137,278,22.401869158878505,45.14575566283895
Task_44482,2248,1002,81,126,207,2.2412761714855436,46.30053348089577
Task_44483,1731,954,36,10,46,1.8125654450261781,35.18093817802598
Task_44484,625,179,99,25,124,3.4722222222222223,16.072157703199107
Task_44485,2105,641,101,196,297,3.278816199376947,43.31015798065405
Task_44486,2181,628,153,69,222,3.4674085850556438,43.47832757309853
Task_44487,2526,305,134,25,159,8.254901960784315,46.99991681738725
Task_44488,1214,502,143,43,186,2.4135188866799204,27.207764688332123
Task_44489,1670,663,97,174,271,2.5150602409638556,36.36378829173738
Task_44490,2842,142,110,23,133,19.874125874125873,50.93703753162464
Task_44491,2226,695,149,156,305,3.1982758620689653,45.374315499578586
Task_44492,2258,206,65,132,197,10.908212560386474,43.860028981141674
Task_44493,1615,768,71,90,161,2.1001300390117037,34.86516345560386
Task_44494,1729,472,12,156,168,3.6553911205073994,35.99747369292732
Task_44495,2607,896,152,95,247,2.9063545150501673,51.66182508890579
Task_44496,2302,110,73,191,264,20.73873873873874,43.800286266398444
Task_44497,2013,719,157,51,208,2.7958333333333334,41.01817705152209
Task_44498,2907,722,101,44,145,4.020746887966805,54.452067569376055
Task_44499,1100,459,123,159,282,2.391304347826087,26.700472171089853
Task_44500,1050,1023,91,142,233,1.025390625,27.292134193646685
Task_44501,2580,150,178,131,309,17.08609271523179,48.767179091795576
Task_44502,1472,916,171,49,220,1.6052344601962922,32.9698386879739
Task_44503,1087,355,154,20,174,3.053370786516854,24.533574140497223
Task_44504,2209,851,94,27,121,2.5927230046948355,43.63720439212354
Task_44505,1826,824,184,25,209,2.2133333333333334,38.08882616247421
Task_44506,1348,565,131,169,300,2.381625441696113,31.056374220709703
Task_44507,650,408,27,177,204,1.5892420537897312,19.094678513066143
Task_44508,2298,92,86,88,174,24.70967741935484,42.79435778029127
Task_44509,707,368,151,13,164,1.915989159891599,18.561570026479618
Task_44510,797,67,34,20,54,11.720588235294118,16.713711224203777
Task_44511,901,983,167,139,306,0.915650406504065,25.182199466423253
Task_44512,571,130,44,169,213,4.358778625954199,16.558501350288683
Task_44513,2411,1006,51,37,88,2.394240317775571,46.8879138538777
Task_44514,1424,596,57,32,89,2.3852596314907872,29.89763253199605
Task_44515,1092,460,55,200,255,2.368763557483731,26.674088578879765
Task_44516,1345,384,90,187,277,3.4935064935064934,30.40661008651092
Task_44517,1210,279,150,129,279,4.321428571428571,27.803911995809926
Task_44518,2626,573,152,123,275,4.574912891986063,51.13896034770522
Task_44519,1610,228,69,109,178,7.03056768558952,33.404735359075964
Task_44520,1368,109,102,178,280,12.436363636363636,29.07230325968483
Task_44521,2031,636,127,184,311,3.1883830455259026,42.16786764471052
Task_44522,2209,365,160,47,207,6.03551912568306,42.74621830566971
Task_44523,2101,788,77,49,126,2.6628643852978455,41.913574393128755
Task_44524,1058,171,59,178,237,6.151162790697675,24.670954275815834
Task_44525,1136,598,174,182,356,1.8964941569282137,28.074046388655578
Task_44526,2652,700,197,134,331,3.783166904422254,52.2229587824321
Task_44527,769,986,193,192,385,0.779128672745694,23.556274474328433
Task_44528,2225,773,154,198,352,2.8746770025839794,45.87683132728703
Task_44529,2114,613,147,162,309,3.44299674267101,43.368470095976214
Task_44530,1241,628,112,184,296,1.972972972972973,29.56320415413121
Task_44531,2135,992,115,65,180,2.1500503524672707,43.531627246430354
Task_44532,1102,609,50,197,247,1.8065573770491803,27.290154977513993
Task_44533,2555,257,102,118,220,9.9031007751938,48.70175841658395
Task_44534,1030,837,73,155,228,1.2291169451073987,26.517679998642915
Task_44535,1800,1022,98,100,198,1.7595307917888563,39.081233271175314
Task_44536,1801,983,187,139,326,1.8302845528455285,39.609628643276466
Task_44537,580,990,172,50,222,0.5852674066599395,19.385774193996653
Task_44538,877,896,170,40,210,0.9777034559643255,23.440244035326696
Task_44539,2981,1011,18,55,73,2.9456521739130435,55.83213514791597
Task_44540,1538,105,86,175,261,14.50943396226415,31.6100823602555
Task_44541,1648,848,133,10,143,1.9411071849234394,34.71061492748526
Task_44542,1506,247,179,142,321,6.07258064516129,32.58166108984137
Task_44543,868,506,148,111,259,1.7120315581854044,22.988097352891092
Task_44544,2719,938,53,113,166,2.895633652822151,53.25249995921522
Task_44545,2284,115,88,182,270,19.689655172413794,43.63933500469128
Task_44546,827,785,63,24,87,1.0521628498727735,21.066761887509273
Task_44547,2084,704,169,186,355,2.956028368794326,43.42262510271621
Task_44548,738,595,144,178,322,1.238255033557047,21.479515910942485
Task_44549,1151,500,162,27,189,2.2974051896207586,26.274022855984743
Task_44550,2990,707,70,104,174,4.22316384180791,56.92215345014154
Task_44551,2770,308,45,138,183,8.964401294498382,51.964261673298815
Task_44552,2583,254,173,156,329,10.129411764705882,49.6801009852104
Task_44553,1615,211,125,122,247,7.617924528301887,33.81281600313702
Task_44554,1880,274,83,186,269,6.836363636363636,38.46910155923024
Task_44555,2607,483,57,175,232,5.386363636363637,50.589102805326235
Task_44556,2608,611,102,133,235,4.261437908496732,50.809608759968704
Task_44557,1211,327,118,30,148,3.692073170731707,26.31695378535876
Task_44558,1060,237,130,43,173,4.453781512605042,23.916317086643772
Task_44559,793,372,85,195,280,2.1260053619302948,21.658291737411304
Task_44560,550,586,80,135,215,0.9369676320272572,18.049863827709384
Task_44561,2198,429,61,96,157,5.111627906976744,43.18016813649626
Task_44562,827,620,19,53,72,1.3317230273752012,20.4647423776494
Task_44563,1252,350,24,183,207,3.566951566951567,28.49791359641473
Task_44564,647,581,141,126,267,1.111683848797251,19.635017182776583
Task_44565,1075,305,142,49,191,3.5130718954248366,24.617139762673215
Task_44566,1927,445,166,78,244,4.320627802690583,39.15777252530805
Task_44567,630,742,147,162,309,0.847913862718708,20.189852201475617
Task_44568,1975,776,43,173,216,2.541827541827542,41.28963634247439
Task_44569,1241,937,140,57,197,1.3230277185501067,29.38872570629346
Task_44570,1574,507,97,183,280,3.0984251968503935,34.40576639859285
Task_44571,1350,777,188,130,318,1.7352185089974292,31.760799998298285
Task_44572,1300,887,195,100,295,1.4639639639639639,31.10768212131329
Task_44573,1704,354,169,110,279,4.8,35.835392052314454
Task_44574,1319,221,13,72,85,5.941441441441442,27.555751823223037
Task_44575,757,371,57,137,194,2.03494623655914,20.72431941590547
Task_44576,1114,76,101,142,243,14.467532467532468,24.650459622858595
Task_44577,1003,612,87,49,136,1.636215334420881,23.950055694088636
Task_44578,2439,366,46,66,112,6.645776566757493,46.006285298799305
Task_44579,1174,239,51,69,120,4.891666666666667,25.782849657723542
Task_44580,1634,582,104,126,230,2.8027444253859346,35.260250831154586
Task_44581,1739,511,73,97,170,3.396484375,36.37277584041936
Task_44582,829,808,23,119,142,1.0247218788627936,22.404986431334038
Task_44583,1832,143,125,168,293,12.722222222222221,36.937333037301016
Task_44584,1909,501,182,89,271,3.802788844621514,39.30071034324998
Task_44585,2394,651,194,139,333,3.6717791411042944,47.99776466753352
Task_44586,2155,272,133,66,199,7.893772893772894,41.80080653995019
Task_44587,2542,777,120,110,230,3.2673521850899743,50.23258817960317
Task_44588,1346,766,109,27,136,1.754889178617992,29.744046488997967
Task_44589,1844,329,133,139,272,5.587878787878788,37.97785112412912
Task_44590,1678,526,80,141,221,3.1840607210626186,35.888700438618386
Task_44591,2586,199,51,133,184,12.93,48.86548225488584
Task_44592,1812,721,79,73,152,2.509695290858726,37.50299933888894
Task_44593,705,554,85,59,144,1.2702702702702702,19.18636129395393
Task_44594,2046,529,159,23,182,3.860377358490566,40.34837663896729
Task_44595,2138,605,18,123,141,3.5280528052805282,42.57185783463076
Task_44596,1563,772,108,30,138,2.021992238033635,33.22782859352894
Task_44597,2454,94,192,58,250,25.83157894736842,45.2848343220573
Task_44598,945,181,184,188,372,5.1923076923076925,23.434166389778266
Task_44599,2239,885,187,55,242,2.5270880361173815,45.317543600571234
Task_44600,1212,823,59,68,127,1.470873786407767,28.28042256919174
Task_44601,961,666,160,106,266,1.4407796101949026,24.92898700872296
Task_44602,1916,893,159,160,319,2.1431767337807606,41.151366502350236
Task_44603,618,299,193,65,258,2.06,17.881770103906277
Task_44604,2977,512,131,193,324,5.803118908382066,56.82331358677548
Task_44605,2364,251,85,120,205,9.380952380952381,45.64438124229514
Task_44606,2726,169,68,17,85,16.03529411764706,48.86772762702082
Task_44607,1899,683,74,20,94,2.776315789473684,37.77022549738263
Task_44608,892,686,14,58,72,1.2983988355167395,21.671773363620144
Task_44609,2912,669,125,64,189,4.3462686567164175,55.013262959739
Task_44610,2105,505,103,70,173,4.160079051383399,41.59667469292383
Task_44611,1955,414,31,46,77,4.710843373493976,37.3455857309043
Task_44612,781,906,30,92,122,0.8610804851157663,21.759653614350125
Task_44613,733,347,130,113,243,2.1063218390804597,20.29566618462112
Task_44614,1730,127,57,192,249,13.515625,35.095457143481504
Task_44615,2478,372,184,11,195,6.64343163538874,46.82506625976034
Task_44616,2586,1022,42,92,134,2.527859237536657,50.96407036292641
Task_44617,644,311,185,58,243,2.0641025641025643,18.181328818844758
Task_44618,1759,154,178,180,358,11.348387096774193,36.13915771090508
Task_44619,527,284,43,19,62,1.8491228070175438,14.089007980040146
Task_44620,1445,393,46,160,206,3.66751269035533,31.64329049636885
Task_44621,2446,87,105,166,271,27.795454545454547,45.760582509357796
Task_44622,1830,64,145,138,283,28.153846153846153,36.00973037103302
Task_44623,1598,333,55,32,87,4.7844311377245505,31.775421596815903
Task_44624,2567,632,40,68,108,4.055292259083728,48.871769068210796
Task_44625,1830,402,83,106,189,4.540942928039702,37.60105640133191
Task_44626,776,866,143,140,283,0.895040369088812,22.7491489974972
Task_44627,990,862,70,25,95,1.1471610660486675,24.272567673860376
Task_44628,1279,91,90,63,153,13.902173913043478,25.978106392328737
Task_44629,1853,868,144,151,295,2.132336018411968,39.95393400704005
Task_44630,2039,304,38,67,105,6.685245901639345,39.370211689683565
Task_44631,2020,988,128,87,215,2.042467138523761,42.26489270195469
Task_44632,834,443,71,46,117,1.8783783783783783,20.491637192356084
Task_44633,1588,342,141,187,328,4.629737609329446,34.29480642290344
Task_44634,2954,501,192,103,295,5.884462151394422,56.16072354308195
Task_44635,867,837,107,177,284,1.0346062052505967,24.09559480967108
Task_44636,1834,126,184,148,332,14.440944881889763,36.95206172462998
Task_44637,2403,825,31,114,145,2.9092009685230025,47.58152516260093
Task_44638,2446,64,177,132,309,37.63076923076923,45.74037646473503
Task_44639,1561,540,29,119,148,2.88539741219963,33.31227087157775
Task_44640,850,716,83,185,268,1.185495118549512,23.47720825575028
Task_44641,999,187,48,26,74,5.3138297872340425,21.749699760116737
Task_44642,2813,187,191,101,292,14.962765957446809,52.9046463354021
Task_44643,930,791,115,140,255,1.1742424242424243,24.812443013396635
Task_44644,2110,662,21,154,175,3.1825037707390647,42.76290059892009
Task_44645,2144,131,185,58,243,16.242424242424242,40.92162573111157
Task_44646,2577,468,118,47,165,5.494669509594883,48.659276350070144
Task_44647,2020,604,103,174,277,3.3388429752066116,41.72469510220295
Task_44648,2338,604,84,129,213,3.8644628099173555,46.453681483890286
Task_44649,2734,625,158,108,266,4.36741214057508,52.95277722488779
Task_44650,1139,155,45,84,129,7.301282051282051,24.72558043799239
Task_44651,794,1017,190,62,252,0.7799607072691552,22.83461290098259
Task_44652,2585,556,108,26,134,4.640933572710951,48.7310557405078
Task_44653,2609,926,142,150,292,2.81445523193096,52.09883824179112
Task_44654,2203,207,32,143,175,10.591346153846153,42.765202390688906
Task_44655,2113,229,71,98,169,9.18695652173913,41.297856512404515
Task_44656,2168,548,46,91,137,3.948998178506375,42.822129734985744
Task_44657,1299,938,99,126,225,1.3833865814696487,30.97420513566101
Task_44658,1685,886,128,128,256,1.8996617812852312,37.138518148902875
Task_44659,2309,531,164,22,186,4.340225563909774,44.561315328671704
Task_44660,1054,989,92,57,149,1.0646464646464646,26.11437557113192
Task_44661,1065,898,58,199,257,1.1846496106785318,27.49826612923155
Task_44662,2095,596,125,98,223,3.509212730318258,42.535619042892314
Task_44663,1899,951,136,11,147,1.9947478991596639,39.04325522714786
Task_44664,784,78,15,185,200,9.924050632911392,19.377224436997395
Task_44665,2947,578,127,15,142,5.089810017271157,54.37764672084207
Task_44666,1593,646,196,111,307,2.462132921174652,35.13712334084035
Task_44667,669,165,84,162,246,4.030120481927711,18.545684473938955
Task_44668,2793,624,187,98,285,4.4688,53.95827610146372
Task_44669,1176,983,132,31,163,1.1951219512195121,28.01226671487063
Task_44670,2213,621,44,61,105,3.557877813504823,42.908040139663875
Task_44671,1229,128,103,103,206,9.527131782945736,26.776850684405655
Task_44672,1714,271,13,111,124,6.301470588235294,34.826912705063194
Task_44673,2676,808,41,154,195,3.30778739184178,52.37207498051058
Task_44674,2976,1003,107,181,288,2.9641434262948207,58.182341863145574
Task_44675,790,870,172,188,360,0.9070034443168772,23.396250536713477
Task_44676,2528,554,153,72,225,4.554954954954955,48.81017327630497
Task_44677,1998,729,177,107,284,2.736986301369863,41.702953524749404
Task_44678,2338,621,155,96,251,3.7588424437299035,46.60680064430128
Task_44679,2185,820,140,80,220,2.661388550548112,44.337085091054774
Task_44680,1641,642,147,86,233,2.552099533437014,35.250565872270485
Task_44681,888,568,184,130,314,1.5606326889279438,23.744859708464627
Task_44682,730,140,167,185,352,5.177304964539007,19.834234847147446
Task_44683,1454,922,106,103,209,1.5752979414951247,33.29884010494208
Task_44684,742,190,84,79,163,3.884816753926702,19.24508971126851
Task_44685,2892,256,106,77,183,11.252918287937744,53.24267187932849
Task_44686,2649,931,12,37,49,2.842274678111588,49.98870566375991
Task_44687,514,436,79,33,112,1.1762013729977117,15.469813847611166
Task_44688,1044,550,82,126,208,1.894736842105263,25.810359786656445
Task_44689,2151,842,166,187,353,2.5516014234875444,44.90865994895817
Task_44690,1504,976,90,90,180,1.5394063459570113,33.809046731251584
Task_44691,2180,939,169,18,187,2.3191489361702127,43.7245872198123
Task_44692,1763,422,80,48,128,4.167848699763593,35.462944064019794
Task_44693,1800,138,192,83,275,12.949640287769784,35.94833902830332
Task_44694,1733,147,139,33,172,11.70945945945946,33.95702960548365
Task_44695,1097,623,94,108,202,1.7580128205128205,26.80226344483583
Task_44696,2895,846,38,28,66,3.4179456906729633,53.57240467918868
Task_44697,1121,249,95,91,186,4.484,25.592709639847058
Task_44698,1373,792,126,200,326,1.7313997477931904,32.310504816346246
Task_44699,2870,809,91,86,177,3.54320987654321,54.84434957585353
Task_44700,1202,233,178,30,208,5.136752136752137,26.397737328790313
Task_44701,1894,128,88,67,155,14.682170542635658,36.0642605740444
Task_44702,2059,78,17,189,206,26.063291139240505,39.312072207044686
Task_44703,2392,361,35,179,214,6.607734806629834,46.579673369546526
Task_44704,1936,100,114,127,241,19.168316831683168,37.708032807954446
Task_44705,555,589,176,72,248,0.940677966101695,17.819492891736353
Task_44706,2212,91,197,130,327,24.043478260869566,42.39276519834907
Task_44707,1205,523,184,171,355,2.299618320610687,28.910941207974606
Task_44708,2700,434,39,55,94,6.206896551724138,50.06498626341872
Task_44709,1620,610,173,101,274,2.65139116202946,35.28833061653173
Task_44710,2850,672,135,76,211,4.234769687964339,54.28326565149539
Task_44711,2390,581,16,150,166,4.106529209621993,46.76797466859005
Task_44712,2015,959,52,111,163,2.0989583333333335,42.147227095578415
Task_44713,1492,886,90,106,196,1.6820744081172492,33.813589010848716
Task_44714,1747,599,55,194,249,2.9116666666666666,37.44730412186059
Task_44715,2788,404,85,53,138,6.883950617283951,51.73909769829916
Task_44716,1465,361,112,187,299,4.04696132596685,32.28058928720056
Task_44717,604,450,54,133,187,1.3392461197339247,18.40215060141197
Task_44718,2945,932,61,148,209,3.1564844587352625,57.19276640382003
Task_44719,1081,738,128,63,191,1.462787550744249,26.229083311514866
Task_44720,1486,773,127,122,249,1.9198966408268734,33.5936390369053
Task_44721,524,421,40,194,234,1.2417061611374407,17.112618279487823
Task_44722,2304,132,118,136,254,17.32330827067669,43.9968774499224
Task_44723,1542,909,167,29,196,1.6945054945054945,33.86110189062199
Task_44724,2171,462,135,121,256,4.688984881209503,43.4896637621678
Task_44725,1449,609,116,127,243,2.375409836065574,32.475460617880856
Task_44726,1076,691,15,87,102,1.5549132947976878,25.516463114016656
Task_44727,1926,242,131,46,177,7.925925925925926,37.52285155441002
Task_44728,1687,414,145,19,164,4.065060240963855,34.12743712991772
Task_44729,1737,838,171,180,351,2.070321811680572,38.31747259433169
Task_44730,749,677,96,67,163,1.1047197640117994,20.512021307171477
Task_44731,2879,497,55,141,196,5.781124497991968,54.7285226539857
Task_44732,1133,104,172,38,210,10.790476190476191,24.280523152669527
Task_44733,2405,520,199,117,316,4.616122840690979,47.64563520740649
Task_44734,1085,907,159,179,338,1.1949339207048457,28.05885379523359
Task_44735,2310,649,71,37,108,3.5538461538461537,44.424015686492446
Task_44736,966,625,163,173,336,1.5431309904153354,25.319920312601507
Task_44737,739,902,27,145,172,0.8183831672203765,21.620363820700828
Task_44738,2123,902,48,112,160,2.3510520487264674,43.471460447337826
Task_44739,2088,758,112,126,238,2.7509881422924902,43.04009715290886
Task_44740,2816,668,27,88,115,4.2092675635276535,53.3132275508577
Task_44741,923,931,20,99,119,0.990343347639485,24.006626375064513
Task_44742,2091,228,21,99,120,9.131004366812228,40.40840684157551
Task_44743,530,592,116,129,245,0.893760539629005,17.80523522917387
Task_44744,1793,428,159,92,251,4.17948717948718,37.231237234673664
Task_44745,858,314,47,139,186,2.723809523809524,21.868949346062795
Task_44746,1956,980,113,106,219,1.9938837920489296,41.52592546653114
Task_44747,520,471,124,42,166,1.1016949152542372,15.970180300124015
Task_44748,660,82,88,12,100,7.951807228915663,15.524316421076081
Task_44749,578,790,104,91,195,0.7307206068268015,18.792307406120464
Task_44750,1095,810,52,78,130,1.3501849568434032,26.652157350804384
Task_44751,1765,334,68,151,219,5.268656716417911,36.64602886525653
Task_44752,923,318,160,91,251,2.8934169278996866,23.065694788679306
Task_44753,1427,817,155,48,203,1.7444987775061125,31.778648249442686
Task_44754,2289,800,150,122,272,2.857677902621723,46.503379479492054
Task_44755,1986,777,178,118,296,2.5526992287917736,41.73333226405237
Task_44756,2228,1021,54,126,180,2.1800391389432487,45.79465958472317
Task_44757,1385,697,13,58,71,1.984240687679083,29.52616556637011
Task_44758,533,407,60,155,215,1.3063725490196079,17.308942247765216
Task_44759,562,821,147,73,220,0.683698296836983,18.689759964587385
Task_44760,2637,675,184,140,324,3.9008875739644973,51.88352382641094
Task_44761,738,618,66,162,228,1.1922455573505655,21.259628272289977
Task_44762,1375,882,148,94,242,1.5571913929784824,32.002939396560755
Task_44763,1939,450,53,64,117,4.299334811529934,38.52055446856996
Task_44764,1146,447,147,164,311,2.5580357142857144,27.52866381020544
Task_44765,977,777,54,189,243,1.255784061696658,25.59864554301302
Task_44766,758,828,129,153,282,0.9143546441495778,22.349504226526378
Task_44767,2315,991,92,23,115,2.3336693548387095,45.67115104279396
Task_44768,2535,266,193,131,324,9.49438202247191,48.906408583736294
Task_44769,1093,942,106,46,152,1.159066808059385,26.328640656599607
Task_44770,2081,962,60,99,159,2.1609553478712358,42.953826109692166
Task_44771,1896,522,190,94,284,3.625239005736138,39.35974464939168
Task_44772,891,627,32,16,48,1.4187898089171975,20.87502944750123
Task_44773,1683,958,20,20,40,1.7549530761209593,34.30560415270748
Task_44774,2472,427,58,183,241,5.775700934579439,48.3174343839947
Task_44775,1259,840,112,66,178,1.497027348394768,29.12568768796837
Task_44776,1918,967,144,135,279,1.9814049586776858,41.19629101576684
Task_44777,1009,554,75,191,266,1.818018018018018,25.669006733227643
Task_44778,1467,259,132,159,291,5.642307692307693,31.896400903794042
Task_44779,1613,824,88,103,191,1.955151515151515,35.494861196802155
Task_44780,2870,895,116,45,161,3.203125,54.36621525163304
Task_44781,962,579,112,81,193,1.6586206896551725,24.04206501383453
Task_44782,1595,329,81,50,131,4.833333333333333,32.45385631259061
Task_44783,2465,400,171,70,241,6.14713216957606,47.35277574892467
Task_44784,2709,872,17,185,202,3.1030927835051547,53.09794968034939
Task_44785,2028,979,25,68,93,2.0693877551020408,41.26290640459987
Task_44786,1570,852,39,131,170,1.8405627198124268,34.651682968774246
Task_44787,1521,962,193,148,341,1.5794392523364487,35.14549621771016
Task_44788,1330,260,140,114,254,5.095785440613027,29.502154384141026
Task_44789,2734,133,173,156,329,20.402985074626866,51.139067488164045
Task_44790,1582,574,178,130,308,2.751304347826087,34.76900790044313
Task_44791,2827,739,70,128,198,3.8202702702702704,54.65049637276213
Task_44792,2966,255,42,68,110,11.5859375,53.95473019757182
Task_44793,2674,494,178,163,341,5.402020202020202,52.00049407813865
Task_44794,1384,415,194,135,329,3.326923076923077,31.232100099061274
Task_44795,2919,372,68,73,141,7.825737265415549,53.95083392711201
Task_44796,2584,418,176,158,334,6.167064439140812,50.28818738614668
Task_44797,2076,314,26,171,197,6.59047619047619,41.34593556383326
Task_44798,679,168,185,42,227,4.017751479289941,17.83967215743139
Task_44799,1072,65,99,99,198,16.242424242424242,23.75009781556375
Task_44800,2937,449,144,183,327,6.526666666666666,55.98252066256106
Task_44801,2034,200,16,70,86,10.119402985074627,38.71419078728548
Task_44802,2508,503,79,113,192,4.976190476190476,48.78752329546859
Task_44803,891,722,157,174,331,1.2323651452282158,24.33189285786221
Task_44804,1037,224,124,62,186,4.608888888888889,23.732493472270004
Task_44805,818,315,19,13,32,2.588607594936709,18.62765724448029
Task_44806,1610,241,36,178,214,6.652892561983471,33.78322582878196
Task_44807,1767,396,54,151,205,4.45088161209068,36.85509495871302
Task_44808,1710,738,21,14,35,2.313937753721245,33.9871771887888
Task_44809,2966,362,128,178,306,8.170798898071626,56.04711431954089
Task_44810,1002,235,25,14,39,4.245762711864407,21.276063039806647
Task_44811,2533,241,89,10,99,10.46694214876033,46.33068758684501
Task_44812,2052,231,196,148,344,8.844827586206897,41.26233794833952
Task_44813,1488,485,115,170,285,3.0617283950617282,32.95427964579895
Task_44814,1219,1024,96,161,257,1.1892682926829268,30.193689818421547
Task_44815,812,430,99,122,221,1.8839907192575407,21.723313660873018
Task_44816,1898,819,164,52,216,2.3146341463414632,39.60078847720201
Task_44817,2434,180,128,43,171,13.447513812154696,45.036358658258784
Task_44818,2949,888,200,104,304,3.3172103487064115,57.35405216566969
Task_44819,2871,379,68,148,216,7.5552631578947365,54.27472902883448
Task_44820,1622,558,195,163,358,2.901610017889088,35.62567334592226
Task_44821,2155,218,71,48,119,9.840182648401827,40.66288756518172
Task_44822,2551,323,165,38,203,7.8734567901234565,48.028667616732186
Task_44823,2474,723,74,76,150,3.4171270718232045,48.076995018818415
Task_44824,2416,160,200,23,223,15.006211180124224,45.076032357848895
Task_44825,1476,747,38,51,89,1.9732620320855614,31.541657492041793
Task_44826,1165,702,171,61,232,1.6571834992887624,27.596664332212736
Task_44827,1081,440,114,78,192,2.45124716553288,25.5155886508142
Task_44828,2846,233,178,66,244,12.162393162393162,52.77765074945027
Task_44829,2154,480,42,132,174,4.478170478170478,42.87353094826693
Task_44830,1870,663,62,96,158,2.816265060240964,38.73747678720685
Task_44831,2882,312,182,145,327,9.207667731629392,54.59081848036419
Task_44832,1808,248,113,140,253,7.261044176706827,37.047169591968405
Task_44833,2301,820,12,142,154,2.802679658952497,45.9111051105074
Task_44834,649,583,33,162,195,1.1113013698630136,19.386948922927473
Task_44835,1944,228,120,121,241,8.489082969432314,39.04172615407913
Task_44836,1741,374,37,54,91,4.642666666666667,34.585486204372664
Task_44837,1180,72,198,178,376,16.164383561643834,26.32161085660552
Task_44838,614,1000,139,34,173,0.6133866133866134,19.631833399635124
Task_44839,2563,149,116,75,191,17.086666666666666,47.5227867171096
Task_44840,2156,221,150,90,240,9.711711711711711,42.149107605309105
Task_44841,2517,952,84,176,260,2.6411332633788036,50.6633587070084
Task_44842,2694,926,99,132,231,2.9061488673139158,53.14610233587164
Task_44843,2542,272,181,167,348,9.311355311355312,49.199724212127556
Task_44844,2368,418,105,104,209,5.651551312649165,46.227403241572766
Task_44845,1763,469,133,126,259,3.751063829787234,37.07479854325902
Task_44846,2308,147,169,161,330,15.594594594594595,44.5985173774655
Task_44847,2963,584,179,168,347,5.064957264957265,56.90130308245214
Task_44848,1028,990,188,102,290,1.0373360242179617,27.037099496377255
Task_44849,1468,167,36,40,76,8.738095238095237,28.857941708134774
Task_44850,2693,217,105,155,260,12.353211009174313,50.963748660985935
Task_44851,1738,927,152,33,185,1.8728448275862069,36.84183236129895
Task_44852,1257,271,156,76,232,4.6213235294117645,27.86918284857913
Task_44853,2627,415,82,176,258,6.314903846153846,50.73499950513528
Task_44854,1900,362,106,126,232,5.234159779614325,38.77388547859509
Task_44855,1967,277,54,97,151,7.075539568345324,39.02943128630201
Task_44856,1538,501,28,162,190,3.0637450199203187,33.38630992868016
Task_44857,1240,466,132,135,267,2.6552462526766596,28.83584511396795
Task_44858,1651,870,174,156,330,1.8955223880597014,36.924610221282826
Task_44859,2384,351,106,98,204,6.7727272727272725,46.229462181526976
Task_44860,1168,407,35,112,147,2.8627450980392157,26.671376923595602
Task_44861,2918,243,167,197,364,11.959016393442623,55.149342791437675
Task_44862,2553,163,63,20,83,15.567073170731707,45.90074403527661
Task_44863,937,582,72,131,203,1.6072041166380788,24.221914720607497
Task_44864,2913,271,76,176,252,10.709558823529411,54.778435885197446
Task_44865,2254,671,109,51,160,3.3541666666666665,44.18175701108809
Task_44866,1373,611,154,100,254,2.2434640522875817,31.288116691732345
Task_44867,1293,320,43,132,175,4.02803738317757,28.735208861201162
Task_44868,1656,475,178,151,329,3.4789915966386555,35.75236029526094
Task_44869,2321,397,59,62,121,5.831658291457287,44.25945663305831
Task_44870,2363,982,48,113,161,2.4038657171922684,47.543913635195416
Task_44871,759,307,60,58,118,2.4642857142857144,19.08683492426669
Task_44872,1685,971,11,10,21,1.7335390946502058,34.356954805412805
Task_44873,1009,453,39,184,223,2.2224669603524227,25.024317399965863
Task_44874,846,446,137,43,180,1.8926174496644295,21.137275793552583
Task_44875,1974,287,63,171,234,6.854166666666667,39.894533890877476
Task_44876,1457,77,18,100,118,18.67948717948718,28.797029074902152
Task_44877,2053,391,20,23,43,5.237244897959184,38.64467082145982
Task_44878,1038,854,152,148,300,1.2140350877192982,26.892133768682722
Task_44879,1856,751,77,97,174,2.4680851063829787,39.11834501186035
Task_44880,908,322,23,104,127,2.8111455108359134,22.28851785106532
Task_44881,2463,156,105,132,237,15.687898089171975,46.66052255635802
Task_44882,1327,949,71,90,161,1.3968421052631579,30.795267924728588
Task_44883,2597,197,160,102,262,13.116161616161616,49.34439257069533
Task_44884,2702,127,41,194,235,21.109375,50.21358689093927
Task_44885,1732,70,37,166,203,24.3943661971831,34.19679461477709
Task_44886,1499,662,163,157,320,2.2609351432880844,33.8244206477784
Task_44887,755,155,42,130,172,4.839743589743589,19.297960300120348
Task_44888,2465,910,96,188,284,2.7058177826564216,49.83960128486367
Task_44889,2013,68,110,132,242,29.17391304347826,38.660371960425316
Task_44890,2598,777,122,174,296,3.339331619537275,51.5110540494832
Task_44891,1732,460,22,84,106,3.75704989154013,35.20512909770226
Task_44892,1916,459,34,105,139,4.165217391304348,38.598293322563386
Task_44893,2127,366,182,127,309,5.795640326975477,42.72670629379727
Task_44894,1432,305,110,57,167,4.6797385620915035,30.12393780922746
Task_44895,629,627,157,122,279,1.0015923566878981,19.553275861012068
Task_44896,2419,934,94,43,137,2.5871657754010697,47.42039010411121
Task_44897,2133,727,35,95,130,2.9299450549450547,42.95193080440104
Task_44898,2929,311,27,24,51,9.387820512820513,52.411652689253565
Task_44899,1842,853,166,89,255,2.1569086651053864,39.27425775647185
Task_44900,2869,151,147,141,288,18.875,53.246440747049526
Task_44901,1288,206,136,86,222,6.222222222222222,28.20275607488433
Task_44902,2291,420,128,164,292,5.441805225653207,45.477463445861964
Task_44903,844,622,79,128,207,1.3547351524879614,22.8562489125307
Task_44904,1959,799,184,83,267,2.44875,40.89896485629819
Task_44905,1130,648,30,110,140,1.7411402157164868,26.77692892795029
Task_44906,2734,167,96,105,201,16.273809523809526,50.83271509376624
Task_44907,518,158,45,66,111,3.257861635220126,14.465981001653782
Task_44908,1221,502,172,180,352,2.427435387673956,29.09782092597642
Task_44909,1550,599,67,29,96,2.5833333333333335,32.109700692198054
Task_44910,713,868,139,90,229,0.8204833141542003,21.25279540599082
Task_44911,515,175,95,193,288,2.9261363636363638,16.314114645824336
Task_44912,1391,813,97,185,282,1.7088452088452089,32.4643597465973
Task_44913,1525,359,158,144,302,4.236111111111111,33.17371424257794
Task_44914,1908,297,191,104,295,6.402684563758389,38.93418200915965
Task_44915,1971,126,59,108,167,15.51968503937008,38.16964290026939
Task_44916,992,913,103,14,117,1.0853391684901532,24.254198774158965
Task_44917,2425,561,84,61,145,4.314946619217082,46.55690954425412
Task_44918,2411,712,93,22,115,3.3814866760168303,46.33347718209993
Task_44919,1070,74,134,37,171,14.266666666666667,22.548496333522948
Task_44920,2200,361,188,10,198,6.077348066298343,42.39975157072525
Task_44921,560,985,185,17,202,0.5679513184584178,18.695670259001165
Task_44922,862,357,190,95,285,2.4078212290502794,22.50274652487572
Task_44923,1287,344,92,102,194,3.7304347826086954,28.889389497126157
Task_44924,2849,285,183,144,327,9.961538461538462,53.970975030138845
Task_44925,1862,962,124,171,295,1.933541017653167,40.41823760950265
Task_44926,981,783,174,102,276,1.2512755102040816,25.593412708612394
Task_44927,2811,365,160,68,228,7.680327868852459,52.65187456611637
Task_44928,2183,737,177,77,254,2.9579945799457996,44.12087748040282
Task_44929,2862,435,68,42,110,6.564220183486238,52.43040280646668
Task_44930,2747,452,191,100,291,6.06401766004415,52.70118045362053
Task_44931,1432,481,151,197,348,2.970954356846473,32.37861632096475
Task_44932,1694,680,119,62,181,2.487518355359765,35.522922941747126
Task_44933,895,472,163,62,225,1.8921775898520083,22.604676991866167
Task_44934,1663,1005,15,35,50,1.6530815109343937,34.68297102567695
Task_44935,2978,457,70,186,256,6.502183406113537,56.482709203138306
Task_44936,1141,161,41,60,101,7.04320987654321,24.21081483290429
Task_44937,2683,848,197,196,393,3.160188457008245,53.550001233791455
Task_44938,1871,756,100,177,277,2.4715984147952446,39.84665998892723
Task_44939,2998,481,200,140,340,6.219917012448133,57.04895151209121
Task_44940,1103,266,25,101,126,4.131086142322097,25.185305856210448
Task_44941,1667,400,93,86,179,4.157107231920199,34.554829365665384
Task_44942,2540,1009,122,76,198,2.514851485148515,50.37071478962548
Task_44943,2824,362,140,10,150,7.779614325068871,51.78032690506701
Task_44944,2155,294,68,54,122,7.305084745762712,41.25669455972343
Task_44945,828,245,154,128,282,3.3658536585365852,21.666868647757166
Task_44946,806,435,159,96,255,1.848623853211009,21.781106676501945
Task_44947,1717,335,127,126,253,5.1101190476190474,35.88456281160817
Task_44948,2038,630,51,93,144,3.2297939778129954,41.25862683096309
Task_44949,1325,344,174,115,289,3.8405797101449277,29.860152824877645
Task_44950,677,836,23,88,111,0.8088410991636799,19.762187171886573
Task_44951,1190,539,176,169,345,2.2037037037037037,28.675714227828653
Task_44952,894,469,51,63,114,1.902127659574468,22.08541338940782
Task_44953,1168,823,130,158,288,1.4174757281553398,28.871173021698166
Task_44954,1189,511,71,38,109,2.322265625,26.274455960874917
Task_44955,1238,101,27,53,80,12.137254901960784,25.105578749605456
Task_44956,913,142,101,192,293,6.384615384615385,22.490560393147117
Task_44957,1810,761,158,30,188,2.3753280839895012,37.57900605634358
Task_44958,711,347,49,43,92,2.043103448275862,18.01054783255312
Task_44959,2082,216,26,84,110,9.59447004608295,40.05243029233602
Task_44960,529,205,37,152,189,2.5679611650485437,16.422603797695583
Task_44961,1809,72,154,125,279,24.78082191780822,35.64875451245165
Task_44962,711,272,16,191,207,2.6043956043956045,19.623524107171917
Task_44963,1128,733,30,95,125,1.5367847411444142,26.937398668988532
Task_44964,1951,550,47,79,126,3.540834845735027,39.34553934875998
Task_44965,512,779,114,63,177,0.6564102564102564,17.286491407368327
Task_44966,863,104,107,71,178,8.219047619047618,19.875629690834657
Task_44967,1256,451,34,39,73,2.7787610619469025,26.373541992838515
Task_44968,2191,596,152,38,190,3.6700167504187604,43.15397641205931
Task_44969,866,627,119,110,229,1.3789808917197452,23.142118825124328
Task_44970,1297,609,183,144,327,2.1262295081967215,30.471756338128454
Task_44971,2654,296,15,133,148,8.936026936026936,49.83207603697747
Task_44972,1372,104,150,123,273,13.066666666666666,28.984183931650332
Task_44973,1812,632,11,114,125,2.862559241706161,37.525470422293864
Task_44974,1410,371,93,95,188,3.7903225806451615,30.839685306968136
Task_44975,1798,327,83,32,115,5.4817073170731705,35.30541252209654
Task_44976,990,106,18,62,80,9.25233644859813,21.18274490385802
Task_44977,1891,306,147,153,300,6.159609120521172,38.790385257091806
Task_44978,986,422,199,84,283,2.33096926713948,24.380127851836487
Task_44979,2305,600,140,93,233,3.8352745424292847,45.843082546094934
Task_44980,889,834,93,64,157,1.0646706586826347,23.070897898049363
Task_44981,1995,142,189,197,386,13.951048951048952,39.96143654939743
Task_44982,594,152,194,92,286,3.8823529411764706,17.175831183932356
Task_44983,1227,457,176,120,296,2.6790393013100435,28.71029201822267
Task_44984,2625,932,166,58,224,2.8135048231511255,51.41789163248175
Task_44985,1406,523,186,105,291,2.683206106870229,31.70811745098642
Task_44986,1987,904,87,77,164,2.1955801104972377,41.05231806690864
Task_44987,574,997,13,40,53,0.5751503006012024,17.6378387093262
Task_44988,523,525,36,196,232,0.9942965779467681,17.418823091361123
Task_44989,2546,375,169,109,278,6.7712765957446805,49.21942058563722
Task_44990,2964,848,10,21,31,3.491166077738516,54.446735398119806
Task_44991,2579,844,84,196,280,3.05207100591716,51.42769304994249
Task_44992,534,477,191,10,201,1.1171548117154813,16.356588140916763
Task_44993,1087,922,162,144,306,1.1776814734561214,27.941449891825354
Task_44994,2441,878,200,21,221,2.777019340159272,48.00203191101871
Task_44995,997,836,142,199,341,1.1911589008363201,26.48747266573621
Task_44996,743,669,113,18,131,1.108955223880597,19.62223822020235
Task_44997,1839,283,46,134,180,6.475352112676056,37.173671233581885
Task_44998,2667,408,168,129,297,6.52078239608802,51.359201495528715
Task_44999,2006,504,72,175,247,3.9722772277227723,41.17833414256844
Task_45000,1128,600,82,161,243,1.8768718801996673,27.505939388864206
Task_45001,2068,575,45,160,205,3.5902777777777777,42.048087271530896
Task_45002,1863,911,25,15,40,2.0427631578947367,37.053887097685426
Task_45003,1930,779,173,11,184,2.4743589743589745,39.215890732793135
Task_45004,1403,937,13,112,125,1.495735607675906,31.975222594787454
Task_45005,2673,364,10,47,57,7.323287671232877,48.61919384544819
Task_45006,1683,369,82,114,196,4.548648648648649,35.276557582580004
Task_45007,2884,997,185,63,248,2.8897795591182365,55.89130992987858
Task_45008,2078,172,14,38,52,12.011560693641618,38.55795638844391
Task_45009,1356,361,194,49,243,3.74585635359116,29.477505430183076
Task_45010,2795,86,25,135,160,32.12643678160919,50.37295179716633
Task_45011,1093,168,158,108,266,6.4674556213017755,25.219667605595603
Task_45012,2519,373,14,73,87,6.735294117647059,47.07329473971284
Task_45013,716,74,38,77,115,9.546666666666667,17.21386862197652
Task_45014,2991,611,39,128,167,4.887254901960785,56.383476077692045
Task_45015,1417,723,29,198,227,1.957182320441989,32.39796132044062
Task_45016,1185,269,140,53,193,4.388888888888889,26.469082216459043
Task_45017,2911,159,81,121,202,18.19375,53.66123639782466
Task_45018,1113,113,194,135,329,9.763157894736842,25.384826802531162
Task_45019,2881,89,28,95,123,32.01111111111111,51.43371954111214
Task_45020,1835,820,84,53,137,2.2350791717417784,38.02031122649202
Task_45021,1315,230,31,60,91,5.692640692640692,27.336917124632823
Task_45022,1186,923,84,198,282,1.2835497835497836,29.507980331713696
Task_45023,1244,980,72,199,271,1.2680937818552498,30.62704608048811
Task_45024,804,894,169,107,276,0.8983240223463688,23.199442940624877
Task_45025,821,371,82,35,117,2.206989247311828,20.025678533765042
Task_45026,2571,535,33,20,53,4.7966417910447765,47.35005060938462
Task_45027,890,991,167,49,216,0.8971774193548387,24.015309116703747
Task_45028,1739,195,75,29,104,8.872448979591837,33.946884788945106
Task_45029,2190,296,135,82,217,7.373737373737374,42.72201107335875
Task_45030,534,149,144,126,270,3.56,16.348324953010707
Task_45031,2060,372,147,145,292,5.522788203753351,41.63641512627776
Task_45032,2831,952,96,138,234,2.9706190975865687,55.471726712227486
Task_45033,2131,450,164,170,334,4.725055432372505,43.24105998189861
Task_45034,503,66,164,88,252,7.507462686567164,15.005682874895115
Task_45035,738,823,147,118,265,0.8956310679611651,21.90073374508306
Task_45036,2959,906,17,195,212,3.262403528114664,57.22542886699102
Task_45037,1996,221,195,184,379,8.99099099099099,40.551486766609536
Task_45038,2968,233,149,48,197,12.683760683760683,54.24032647099927
Task_45039,2222,671,168,167,335,3.306547619047619,45.38668620100274
Task_45040,1772,690,24,143,167,2.564399421128799,37.38236537548615
Task_45041,1778,319,50,158,208,5.55625,36.82953045832
Task_45042,2229,810,164,16,180,2.74845869297164,44.00933195121024
Task_45043,620,598,89,137,226,1.0350584307178632,19.10403452189614
Task_45044,2612,175,89,176,265,14.840909090909092,49.2178738239565
Task_45045,2282,308,77,145,222,7.385113268608414,44.74221499467118
Task_45046,1020,473,96,173,269,2.151898734177215,25.493057633967826
Task_45047,2886,120,124,191,315,23.85123966942149,53.44536957346929
Task_45048,861,285,131,104,235,3.0104895104895104,22.07193882483163
Task_45049,2179,120,129,108,237,18.00826446280992,41.84916385354499
Task_45050,1650,515,98,138,236,3.197674418604651,35.36032862243237
Task_45051,2106,222,156,142,298,9.443946188340806,41.865695434589774
Task_45052,1533,303,159,164,323,5.042763157894737,33.23965813790941
Task_45053,2812,204,73,166,239,13.717073170731707,52.838421444345954
Task_45054,716,622,10,63,73,1.1492776886035314,18.81476658779547
Task_45055,1119,956,41,64,105,1.1692789968652038,26.826054430392073
Task_45056,1259,906,130,55,185,1.388092613009923,29.428574810668696
Task_45057,2431,303,39,21,60,7.996710526315789,44.395981966835315
Task_45058,542,788,14,75,89,0.6869455006337135,17.412820664943172
Task_45059,1223,675,62,72,134,1.8091715976331362,28.08814043051187
Task_45060,953,785,186,186,372,1.2124681933842238,25.711830831042978
Task_45061,2775,982,66,50,116,2.822990844354018,53.01571555744692
Task_45062,1878,613,38,23,61,3.0586319218241043,36.69625933726429
Task_45063,2038,217,139,87,226,9.34862385321101,40.1138089425375
Task_45064,1812,744,102,134,236,2.4322147651006714,38.626647930438516
Task_45065,2139,892,69,38,107,2.395296752519597,42.46463709207003
Task_45066,1023,674,137,196,333,1.5155555555555555,26.39542320036273
Task_45067,2269,735,129,11,140,3.082880434782609,44.1661995575304
Task_45068,966,336,169,69,238,2.8664688427299705,23.38860726321293
Task_45069,2870,96,134,128,262,29.587628865979383,52.35087595006334
Task_45070,896,950,194,181,375,0.9421661409043113,25.375071628963454
Task_45071,2441,171,28,50,78,14.19186046511628,44.28570184433977
Task_45072,1876,88,165,131,296,21.078651685393258,36.94730457240885
Task_45073,2393,239,64,191,255,9.970833333333333,46.46831050579292
Task_45074,1735,763,10,15,25,2.270942408376963,34.529215504309676
Task_45075,1877,646,31,19,50,2.901081916537867,36.64896665912672
Task_45076,840,942,29,186,215,0.8907741251325557,23.688769777347023
Task_45077,766,1021,91,59,150,0.7495107632093934,21.599319709687965
Task_45078,931,320,84,60,144,2.9003115264797508,22.0573186116653
Task_45079,940,405,26,79,105,2.315270935960591,22.47283506429447
Task_45080,2204,934,55,180,235,2.3572192513368986,45.65196927945285
Task_45081,1339,539,36,135,171,2.47962962962963,30.015152753159114
Task_45082,2698,969,23,185,208,2.781443298969072,53.41227648234791
Task_45083,856,102,132,165,297,8.310679611650485,21.05011898757763
Task_45084,1113,472,162,100,262,2.3530655391120505,26.770641553188426
Task_45085,2461,598,158,107,265,4.108514190317195,48.53730695267412
Task_45086,2059,863,71,61,132,2.3831018518518516,41.7272628147365
Task_45087,2112,210,140,86,226,10.009478672985782,41.24438176584488
Task_45088,1412,907,84,162,246,1.5550660792951543,32.88588538241532
Task_45089,1919,865,158,89,247,2.215935334872979,40.49561054255193
Task_45090,1368,738,158,112,270,1.851150202976996,31.695263532883292
Task_45091,1261,624,179,100,279,2.0176,29.667699625365568
Task_45092,2535,603,180,174,354,4.197019867549669,50.224479921876444
Task_45093,1982,248,140,182,322,7.959839357429719,40.16884508820043
Task_45094,1353,410,86,191,277,3.291970802919708,30.61529451212105
Task_45095,2131,672,187,179,366,3.166419019316493,44.105765467124115
Task_45096,2997,893,169,123,292,3.3523489932885906,58.104056432362974
Task_45097,1714,766,199,183,382,2.2346805736636246,37.8727266310999
Task_45098,2378,75,79,63,142,31.289473684210527,43.293791798518875
Task_45099,1236,113,196,179,375,10.842105263157896,27.59078484551748
Task_45100,1806,1014,130,121,251,1.7793103448275862,39.407241129316056
Task_45101,2002,714,85,185,270,2.8,41.81784028234031
Task_45102,2918,976,96,155,251,2.986693961105425,57.02688562136075
Task_45103,930,437,170,88,258,2.1232876712328768,23.47615998852846
Task_45104,2932,618,193,10,203,4.736672051696284,54.84533097483845
Task_45105,2411,720,186,183,369,3.3439667128987516,48.711551900245546
Task_45106,971,865,101,176,277,1.1212471131639723,25.766193523976643
Task_45107,2594,124,26,20,46,20.752,45.86514366653926
Task_45108,1644,567,31,69,100,2.8943661971830985,33.940158816043635
Task_45109,2817,164,172,191,363,17.072727272727274,52.92068050500826
Task_45110,2855,163,35,150,185,17.408536585365855,52.50940705676615
Task_45111,850,926,188,115,303,0.9169363538295577,24.149175362950583
Task_45112,2830,888,71,41,112,3.1833520809898763,53.4330027478455
Task_45113,1432,179,109,84,193,7.955555555555556,29.949152434300743
Task_45114,2641,691,80,70,150,3.816473988439306,50.44934096048348
Task_45115,1164,459,86,134,220,2.5304347826086957,27.439457818477113
Task_45116,2656,228,121,133,254,11.59825327510917,50.36325016379942
Task_45117,2203,813,61,10,71,2.7063882063882065,42.27070737251661
Task_45118,1672,797,62,64,126,2.0952380952380953,35.474535276452045
Task_45119,1791,394,183,189,372,4.534177215189874,37.877619025947524
Task_45120,1147,677,149,109,258,1.691740412979351,27.93259055238614
Task_45121,651,801,179,33,212,0.8117206982543641,19.51639316294711
Task_45122,1427,920,25,74,99,1.5494028230184582,31.550881106427894
Task_45123,2396,875,73,100,173,2.7351598173515983,48.00969280942373
Task_45124,2039,179,110,89,199,11.327777777777778,39.61134903801251
Task_45125,1155,325,194,180,374,3.542944785276074,27.58811850003268
Task_45126,1637,317,173,56,229,5.147798742138365,33.92292058329517
Task_45127,2880,763,61,72,133,3.769633507853403,54.637092757319635
Task_45128,2499,815,41,10,51,3.0625,47.01067889268402
Task_45129,2267,272,179,127,306,8.304029304029305,44.605388992794154
Task_45130,1954,626,147,188,335,3.116427432216906,41.03084594692011
Task_45131,2188,791,115,15,130,2.7626262626262625,43.03978247172987
Task_45132,1585,634,71,190,261,2.4960629921259843,35.00824310273647
Task_45133,507,171,17,40,57,2.947674418604651,13.664901683416316
Task_45134,1573,433,30,52,82,3.6244239631336406,32.07553297247757
Task_45135,631,577,10,180,190,1.0916955017301038,19.06037261214904
Task_45136,2499,276,63,189,252,9.021660649819495,48.26204671630098
Task_45137,1796,987,55,180,235,1.8178137651821862,39.35144885295708
Task_45138,2605,770,129,90,219,3.378728923476005,50.964966948646975
Task_45139,517,869,20,70,90,0.5942528735632184,17.10026554051002
Task_45140,2516,208,139,81,220,12.038277511961722,47.52141495264417
Task_45141,921,205,24,187,211,4.470873786407767,22.811058120248727
Task_45142,1587,276,104,27,131,5.729241877256317,32.01230343071992
Task_45143,1124,929,80,129,209,1.2086021505376343,28.209765705250618
Task_45144,684,836,148,108,256,0.8172043010752689,21.025616371083974
Task_45145,700,506,77,79,156,1.3806706114398422,19.33514804489644
Task_45146,2434,841,106,146,252,2.8907363420427554,48.87409397390254
Task_45147,2786,951,198,19,217,2.926470588235294,53.56579881655347
Task_45148,2118,559,147,115,262,3.782142857142857,42.97977871006853
Task_45149,1268,752,105,22,127,1.6839309428950864,28.38342998464726
Task_45150,2748,838,61,116,177,3.2753277711561384,53.40395491465875
Task_45151,1160,579,159,122,281,2.0,27.968706123452435
Task_45152,1515,590,140,112,252,2.563451776649746,33.47958483974423
Task_45153,1127,235,26,181,207,4.77542372881356,26.137512261854383
Task_45154,1742,997,189,156,345,1.745490981963928,38.81524452037942
Task_45155,1423,826,67,64,131,1.720677146311971,31.64624495146106
Task_45156,2214,682,158,98,256,3.2415812591508053,44.840723161699735
Task_45157,2881,836,107,34,141,3.4420549581839905,54.33094589086917
Task_45158,1714,758,195,133,328,2.2582345191040845,37.53107579108202
Task_45159,954,762,76,13,89,1.2503276539973787,23.041219744793427
Task_45160,918,437,125,64,189,2.095890410958904,22.704825647498435
Task_45161,2805,209,126,110,236,13.357142857142858,52.52583419282744
Task_45162,1350,832,138,12,150,1.6206482593037215,29.93847261965061
Task_45163,2776,498,20,64,84,5.56312625250501,51.385989827010604
Task_45164,1925,885,102,129,231,2.172686230248307,40.82699865007008
Task_45165,2182,724,44,112,156,3.009655172413793,43.73295389079424
Task_45166,2774,731,77,63,140,3.789617486338798,52.68866771757217
Task_45167,807,215,109,137,246,3.736111111111111,21.086596571955667
Task_45168,923,370,146,48,194,2.487870619946092,22.369300095071395
Task_45169,2040,880,118,160,278,2.315550510783201,42.89086595036114
Task_45170,580,665,115,40,155,0.8708708708708709,17.403544461919967
Task_45171,1701,992,109,192,301,1.7129909365558913,38.00446680009433
Task_45172,2278,162,134,128,262,13.975460122699387,43.86569513537571
Task_45173,1705,450,162,200,362,3.7804878048780486,36.66856560468123
Task_45174,2361,599,29,43,72,3.935,44.395136255285536
Task_45175,1790,590,33,89,122,3.0287648054145517,36.896279370544335
Task_45176,2332,1009,175,92,267,2.3089108910891087,47.66966279312114
Task_45177,2859,466,175,61,236,6.122055674518201,53.686022693092134
Task_45178,1393,81,69,127,196,16.98780487804878,28.929673617693705
Task_45179,1462,452,137,61,198,3.227373068432671,31.35698068758109
Task_45180,2606,147,23,75,98,17.60810810810811,47.221309474665524
Task_45181,1969,989,195,192,387,1.988888888888889,42.643153523776704
Task_45182,991,246,135,55,190,4.012145748987854,23.286576811660794
Task_45183,2942,950,140,182,322,3.0935856992639326,57.632677787378235
Task_45184,2994,643,76,194,270,4.649068322981367,57.41031480726306
Task_45185,2779,1009,186,57,243,2.7514851485148513,54.19471953562091
Task_45186,1253,594,144,51,195,2.1058823529411765,28.530312030628437
Task_45187,1342,800,124,100,224,1.6754057428214733,31.23793329111544
Task_45188,1278,279,132,83,215,4.564285714285714,28.229515890404784
Task_45189,1764,947,25,38,63,1.860759493670886,36.03914865922336
Task_45190,2643,342,129,70,199,7.705539358600583,49.784140843847375
Task_45191,2442,535,153,154,307,4.5559701492537314,48.293311006357975
Task_45192,1611,611,111,68,179,2.6323529411764706,34.03342415411373
Task_45193,704,598,120,164,284,1.1752921535893155,20.799767792600957
Task_45194,2165,401,179,117,296,5.385572139303482,43.370337302577035
Task_45195,2034,773,60,13,73,2.627906976744186,39.48028232094533
Task_45196,739,187,26,98,124,3.9308510638297873,19.11181499672611
Task_45197,1793,535,111,30,141,3.345149253731343,36.153010279514696
Task_45198,1583,220,12,103,115,7.16289592760181,32.43493880897055
Task_45199,2831,102,131,63,194,27.485436893203882,51.09758993280431
Task_45200,2140,488,200,137,337,4.376278118609407,43.471329297444846
Task_45201,1947,67,183,12,195,28.63235294117647,36.3222513948228
Task_45202,910,454,116,147,263,2.0,23.574104132114133
Task_45203,1269,708,176,103,279,1.7898448519040904,30.060921811458837
Task_45204,1870,225,122,32,154,8.274336283185841,36.37324880527179
Task_45205,1699,899,164,155,319,1.8877777777777778,37.72428916461808
Task_45206,1641,399,151,40,191,4.1025,33.80133247248779
Task_45207,2690,430,127,182,309,6.241299303944316,51.927882553337746
Task_45208,1237,634,49,158,207,1.948031496062992,29.240150936994883
Task_45209,2883,236,119,70,189,12.164556962025317,53.1179471331455
Task_45210,2963,801,182,147,329,3.6945137157107233,57.47833809740251
Task_45211,2215,688,123,147,270,3.2148040638606674,45.00709632063266
Task_45212,2661,905,181,35,216,2.937086092715232,51.67616350161382
Task_45213,2965,327,116,45,161,9.039634146341463,54.03443916579558
Task_45214,2898,796,178,177,355,3.6361355081555833,56.59396055865676
Task_45215,2355,898,20,135,155,2.6195773081201335,47.01362253850164
Task_45216,1283,542,129,130,259,2.3627992633517496,29.712895686436692
Task_45217,2734,443,192,195,387,6.157657657657658,53.03774995181374
Task_45218,2612,623,115,25,140,4.185897435897436,49.325126587126
Task_45219,2109,505,12,184,196,4.16798418972332,42.47055310614201
Task_45220,1208,309,177,173,350,3.8967741935483873,28.25563671902121
Task_45221,2712,388,189,161,350,6.97172236503856,52.29020101547852
Task_45222,854,444,106,34,140,1.9191011235955056,20.991007700789375
Task_45223,1123,516,106,125,231,2.172147001934236,26.964365225260604
Task_45224,1465,378,45,115,160,3.865435356200528,31.27961876992012
Task_45225,2486,798,67,24,91,3.111389236545682,47.44006248074442
Task_45226,1767,440,44,77,121,4.006802721088436,35.89124950411851
Task_45227,1165,624,109,70,179,1.864,27.009754273434712
Task_45228,515,819,153,176,329,0.6280487804878049,18.91308968770512
Task_45229,850,400,156,101,257,2.119700748129676,22.359906021960246
Task_45230,508,530,17,31,48,0.9566854990583804,14.89262432731867
Task_45231,964,568,54,24,78,1.6942003514938488,22.08774174058819
Task_45232,1939,134,24,152,176,14.362962962962962,37.78312858276394
Task_45233,918,984,174,23,197,0.9319796954314721,24.269747509075344
Task_45234,2454,809,188,102,290,3.0296296296296297,49.197517736210614
Task_45235,1715,211,138,70,208,8.089622641509434,34.69512274487038
Task_45236,2621,314,188,37,225,8.320634920634921,49.18855789394113
Task_45237,630,390,55,20,75,1.6112531969309463,16.036260262610245
Task_45238,2894,229,88,180,268,12.582608695652175,54.27778330993977
Task_45239,1736,586,19,119,138,2.9574105621805793,36.115123348010904
Task_45240,1043,643,135,194,329,1.6195652173913044,26.624036970597462
Task_45241,2787,1019,138,96,234,2.7323529411764707,54.89274940329105
Task_45242,507,833,167,25,192,0.6079136690647482,17.558916817400306
Task_45243,2626,271,197,183,380,9.654411764705882,50.691400889083525
Task_45244,2038,753,13,176,189,2.702917771883289,42.11388467636657
Task_45245,2562,241,14,156,170,10.586776859504132,48.44102892650472
Task_45246,1546,621,25,192,217,2.485530546623794,34.075993570182355
Task_45247,2900,580,88,174,262,4.991394148020654,55.536119620119024
Task_45248,585,227,29,126,155,2.5657894736842106,16.921056561972545
Task_45249,1609,318,89,140,229,5.043887147335423,34.07229858451276
Task_45250,2954,1021,105,170,275,2.8904109589041096,57.81516280890647
Task_45251,1443,1024,20,72,92,1.4078048780487804,32.05279946700838
Task_45252,1014,145,140,27,167,6.945205479452055,22.431181660873648
Task_45253,1713,752,80,74,154,2.2749003984063747,36.069637756410835
Task_45254,1424,116,73,71,144,12.17094017094017,28.868000310675118
Task_45255,1752,922,196,17,213,1.8981581798483207,37.07335174553663
Task_45256,1698,739,139,177,316,2.2945945945945945,37.22868045998643
Task_45257,2104,590,59,178,237,3.560067681895093,42.99086484238817
Task_45258,1579,240,91,106,197,6.551867219917012,33.14818073404182
Task_45259,1820,433,173,63,236,4.193548387096774,37.20416368090941
Task_45260,1600,689,136,118,254,2.318840579710145,35.15404921455869
Task_45261,890,724,145,170,315,1.2275862068965517,24.24427953377243
Task_45262,2765,846,185,11,196,3.2644628099173554,52.89314479869039
Task_45263,644,263,28,194,222,2.4393939393939394,18.685347817764395
Task_45264,1253,584,89,98,187,2.141880341880342,29.004028772189105
Task_45265,2236,743,87,131,218,3.0053763440860215,45.26336254690194
Task_45266,2693,862,78,117,195,3.1205098493626884,52.87481844010022
Task_45267,1174,486,70,10,80,2.410677618069815,25.481510237539478
Task_45268,2043,883,40,182,222,2.3110859728506785,42.740026202883676
Task_45269,2200,829,21,180,201,2.6506024096385543,44.929517745091765
Task_45270,2373,586,73,190,263,4.042589437819421,47.34515162848691
Task_45271,719,822,20,33,53,0.8736330498177399,19.28699930691596
Task_45272,1354,608,198,162,360,2.2233169129720856,31.546449701121883
Task_45273,2413,255,64,133,197,9.42578125,46.49692251119837
Task_45274,586,803,89,70,159,0.7288557213930348,18.344580175671613
Task_45275,1110,371,133,76,209,2.9838709677419355,25.76701709925368
Task_45276,2492,759,16,125,141,3.278947368421053,48.65689791699348
Task_45277,1980,83,136,37,173,23.571428571428573,37.08095584445642
Task_45278,2368,981,196,89,285,2.4114052953156824,48.142936529335806
Task_45279,2143,555,86,138,224,3.8543165467625897,43.267401437132285
Task_45280,1884,920,12,147,159,2.045602605863192,39.67628668286665
Task_45281,1791,215,107,93,200,8.291666666666666,36.28667857861015
Task_45282,2184,579,31,140,171,3.7655172413793103,43.55560911331114
Task_45283,593,553,129,159,288,1.0703971119133573,18.850501855273595
Task_45284,2521,651,85,174,259,3.8665644171779143,49.77437159766108
Task_45285,1624,963,196,189,385,1.6846473029045643,37.06848792708328
Task_45286,1359,450,58,100,158,3.0133037694013303,29.95775759912972
Task_45287,842,104,125,69,194,8.019047619047619,19.780546132302817
Task_45288,1123,158,143,163,306,7.062893081761007,25.904512423977604
Task_45289,1725,454,92,191,283,3.791208791208791,36.7062184844892
Task_45290,2868,728,33,113,146,3.934156378600823,54.62380219966669
Task_45291,1884,424,101,176,277,4.432941176470588,38.99948575462541
Task_45292,2970,259,60,196,256,11.423076923076923,55.67161041601391
Task_45293,1764,410,153,170,323,4.291970802919708,37.253646203009005
Task_45294,569,773,82,13,95,0.7351421188630491,17.240265702568678
Task_45295,1757,910,41,142,183,1.928649835345774,37.87558718886802
Task_45296,1935,387,14,87,101,4.987113402061856,38.24398706914452
Task_45297,1331,1012,74,124,198,1.313919052319842,31.724005218984928
Task_45298,1022,700,158,135,293,1.4579172610556348,26.16511288794122
Task_45299,1709,815,14,17,31,2.094362745098039,34.29517971372838
Task_45300,2095,823,113,168,281,2.5424757281553396,43.60969427235037
Task_45301,2361,473,168,158,326,4.981012658227848,46.90255533102913
Task_45302,2403,390,29,192,221,6.145780051150895,46.912750061633375
Task_45303,1073,164,133,97,230,6.503030303030303,24.68990741785996
Task_45304,1016,925,122,16,138,1.0971922246220303,24.78563532063369
Task_45305,2697,491,60,173,233,5.4817073170731705,52.01074018446949
Task_45306,1241,110,42,133,175,11.18018018018018,26.51205907379889
Task_45307,2711,80,28,193,221,33.46913580246913,49.751344424202756
Task_45308,1046,694,88,125,213,1.5050359712230217,26.194091920794932
Task_45309,1143,190,84,106,190,5.984293193717278,26.048402404962577
Task_45310,1432,158,122,37,159,9.0062893081761,29.003044204805292
Task_45311,2487,300,135,154,289,8.262458471760798,48.14492467618555
Task_45312,1223,305,12,85,97,3.996732026143791,26.55972322407622
Task_45313,707,997,63,14,77,0.7084168336673347,19.58477605382708
Task_45314,1253,233,134,32,166,5.354700854700854,26.8607018375926
Task_45315,2628,822,20,75,95,3.193195625759417,50.30141682584108
Task_45316,1152,743,176,128,304,1.5483870967741935,28.423022783266294
Task_45317,2942,762,186,95,281,3.855832241153342,56.702036889965605
Task_45318,2868,611,23,74,97,4.686274509803922,53.5369269119598
Task_45319,2447,489,51,199,250,4.993877551020408,48.22925082162845
Task_45320,1937,259,93,78,171,7.45,38.25082625432699
Task_45321,2506,992,19,108,127,2.523665659617321,49.582964894360565
Task_45322,2518,826,32,128,160,3.0447400241837967,49.44432646172199
Task_45323,1243,85,14,151,165,14.453488372093023,26.333154669732
Task_45324,524,445,108,196,304,1.1748878923766817,17.6109839150625
Task_45325,2411,73,65,132,197,32.58108108108108,44.757369191307475
Task_45326,922,804,63,121,184,1.1453416149068323,24.296396617041555
Task_45327,1922,867,99,168,267,2.2142857142857144,40.94451137309846
Task_45328,2539,526,74,120,194,4.817836812144212,49.37287723151881
Task_45329,1576,127,153,186,339,12.3125,32.955767053727975
Task_45330,2022,866,54,196,250,2.332179930795848,42.64769706475571
Task_45331,2582,759,50,145,195,3.3973684210526316,50.89273219067109
Task_45332,2484,917,74,51,125,2.7058823529411766,48.54669226698846
Task_45333,2604,882,121,91,212,2.9490373725934313,51.28890816211077
Task_45334,2154,130,106,189,295,16.442748091603054,41.88765712522502
Task_45335,2161,812,33,83,116,2.658056580565806,43.37660335879348
Task_45336,1399,866,120,125,245,1.6136101499423299,32.47735872573181
Task_45337,1463,961,138,150,288,1.5207900207900207,33.987360659987296
Task_45338,2768,221,153,93,246,12.468468468468469,51.94462287919779
Task_45339,2364,272,126,67,193,8.659340659340659,45.09831512650379
Task_45340,793,242,160,39,199,3.263374485596708,19.879256921130406
Task_45341,1950,564,105,103,208,3.4513274336283186,40.07444629067842
Task_45342,1235,756,61,153,214,1.631439894319683,29.566599259645344
Task_45343,1960,681,39,21,60,2.873900293255132,38.16778644042381
Task_45344,2989,635,161,128,289,4.699685534591195,57.156287501956456
Task_45345,1622,974,165,17,182,1.6635897435897435,34.828402009497914
Task_45346,2946,597,73,131,204,4.926421404682274,56.10202943453876
Task_45347,706,164,120,117,237,4.278787878787878,18.959436231721188
Task_45348,1710,907,126,66,192,1.8832599118942732,36.755890058631444
Task_45349,2098,663,67,148,215,3.1596385542168677,42.95092924009086
Task_45350,1653,173,172,57,229,9.5,33.44349202876202
Task_45351,1430,157,180,95,275,9.050632911392405,30.4504792998587
Task_45352,506,955,21,59,80,0.5292887029288703,16.471130346695542
Task_45353,2883,270,32,56,88,10.638376383763838,52.298875751947605
Task_45354,1314,1008,192,155,347,1.3022794846382557,32.020877346039825
Task_45355,2584,154,140,13,153,16.670967741935485,46.966742984094225
Task_45356,2864,950,38,90,128,3.0115667718191377,55.22395983699162
Task_45357,1644,825,39,54,93,1.9903147699757868,34.56149166993523
Task_45358,1375,754,53,43,96,1.8211920529801324,29.72971056653891
Task_45359,2271,841,10,186,196,2.697149643705463,46.09975728962936
Task_45360,1605,776,21,39,60,2.0656370656370657,32.86253683188436
Task_45361,2566,421,64,25,89,6.080568720379147,47.333657908533354
Task_45362,1249,423,141,39,180,2.9457547169811322,27.412755667585106
Task_45363,1050,121,149,155,304,8.60655737704918,24.46078326633376
Task_45364,1433,841,100,24,124,1.7019002375296912,31.20958546025568
Task_45365,738,632,137,193,330,1.1658767772511849,21.693650378550746
Task_45366,933,665,45,60,105,1.4009009009009008,22.614068516497877
Task_45367,2054,783,96,192,288,2.6198979591836733,42.95466645384022
Task_45368,2180,925,63,133,196,2.3542116630669545,44.96826864517405
Task_45369,1701,690,20,92,112,2.4616497829232995,35.71035654562738
Task_45370,1004,494,169,128,297,2.0282828282828285,25.313164960357465
Task_45371,693,780,52,122,174,0.8873239436619719,20.640308168176478
Task_45372,1660,373,167,139,306,4.438502673796791,35.36575677954507
Task_45373,1570,880,44,69,113,1.7820658342792282,34.01801074675155
Task_45374,1466,292,88,20,108,5.003412969283277,29.723397881508134
Task_45375,2500,173,79,168,247,14.367816091954023,47.4663888303661
Task_45376,697,698,195,17,212,0.9971387696709585,19.732772901418745
Task_45377,1902,350,91,198,289,5.418803418803419,39.17750625355263
Task_45378,2655,823,90,175,265,3.2220873786407767,52.46955486970797
Task_45379,1369,466,170,14,184,2.931477516059957,29.318863000342798
Task_45380,1660,295,13,199,212,5.608108108108108,34.82771068833021
Task_45381,2223,738,77,102,179,3.0081190798376185,44.75907588272932
Task_45382,2692,653,170,154,324,4.116207951070336,52.70544922228254
Task_45383,1767,586,167,132,299,3.0102214650766608,37.69881763848496
Task_45384,635,162,45,54,99,3.895705521472393,16.13481416624943
Task_45385,1844,559,23,119,142,3.2928571428571427,37.900424826475366
Task_45386,2218,351,141,28,169,6.301136363636363,42.43755421608575
Task_45387,2164,124,146,117,263,17.312,41.763580668660616
Task_45388,2062,459,164,130,294,4.482608695652174,41.939106203481224
Task_45389,1425,761,71,14,85,1.8700787401574803,30.357598708362904
Task_45390,829,976,120,14,134,0.8485158648925282,22.137028277278024
Task_45391,736,546,188,105,293,1.3455210237659962,21.140424522308752
Task_45392,946,755,45,132,177,1.2513227513227514,24.2906183724639
Task_45393,892,757,173,130,303,1.1767810026385224,24.306733176250802
Task_45394,1005,625,119,39,158,1.6054313099041533,24.00072444579692
Task_45395,632,771,128,12,140,0.8186528497409327,18.388306448925512
Task_45396,1463,314,180,23,203,4.644444444444445,30.700161789752077
Task_45397,1670,667,153,196,349,2.5,36.73644288336343
Task_45398,1454,812,107,143,250,1.7884378843788438,33.24333292230926
Task_45399,815,166,147,58,205,4.880239520958084,20.076617046665714
Task_45400,2114,922,126,133,259,2.2903575297941496,44.069062430369
Task_45401,2347,219,131,147,278,10.668181818181818,45.577310366702115
Task_45402,617,243,34,169,203,2.528688524590164,18.058761294851482
Task_45403,2287,573,120,56,176,3.984320557491289,44.627895581489206
Task_45404,1194,661,92,95,187,1.8036253776435045,28.303323320101907
Task_45405,711,927,24,52,76,0.7661637931034483,19.558831142229447
Task_45406,2303,683,31,108,139,3.3669590643274856,45.45040734409917
Task_45407,725,636,100,28,128,1.1381475667189953,19.65985447917412
Task_45408,2768,615,184,116,300,4.4935064935064934,53.624339304036575
Task_45409,1313,323,198,168,366,4.052469135802469,30.026616104784143
Task_45410,1663,938,54,178,232,1.7710330138445154,37.0622884481584
Task_45411,2816,674,174,21,195,4.1718518518518515,53.184038348570276
Task_45412,1904,234,156,26,182,8.102127659574467,37.140745634193514
Task_45413,1442,147,35,148,183,9.743243243243244,30.016162535570757
Task_45414,1012,955,161,184,345,1.0585774058577406,27.034725541350355
Task_45415,2309,643,68,78,146,3.5854037267080745,45.33954013929815
Task_45416,1856,886,181,126,307,2.092446448703495,40.074945506746715
Task_45417,2217,499,64,65,129,4.434,43.23463328900434
Task_45418,1162,845,15,74,89,1.3735224586288417,27.0675906142344
Task_45419,592,603,197,149,346,0.9801324503311258,19.30415911211729
Task_45420,1964,312,153,24,177,6.274760383386582,38.30951280048331
Task_45421,2657,367,17,154,171,7.220108695652174,50.275399487372624
Task_45422,2808,1008,42,172,214,2.7829534192269576,55.20254977297977
Task_45423,2827,734,34,49,83,3.8462585034013603,52.67015543210055
Task_45424,1408,443,80,130,210,3.171171171171171,31.284991265679555
Task_45425,935,388,45,179,224,2.403598971722365,23.63263027568638
Task_45426,1130,950,45,163,208,1.188222923238696,28.250725310880714
Task_45427,1905,90,169,101,270,20.934065934065934,37.269361140395276
Task_45428,2684,852,85,152,237,3.1465416178194605,52.858096809408835
Task_45429,685,143,74,172,246,4.756944444444445,18.798772440923372
Task_45430,627,801,112,173,285,0.7817955112219451,20.256204896223576
Task_45431,1285,128,45,31,76,9.96124031007752,25.517074163920896
Task_45432,2334,639,24,68,92,3.646875,45.04304604715292
Task_45433,1560,491,155,175,330,3.1707317073170733,34.32328313613905
Task_45434,869,380,81,90,171,2.2808398950131235,21.91670876393576
Task_45435,1475,325,35,196,231,4.524539877300613,32.05713496005484
Task_45436,2850,283,40,51,91,10.035211267605634,51.79797856270085
Task_45437,1909,408,200,48,248,4.667481662591687,38.33592463999522
Task_45438,2682,380,11,21,32,7.039370078740157,48.48445106836172
Task_45439,1228,813,33,32,65,1.5085995085995085,27.113704067195062
Task_45440,805,755,161,67,228,1.0648148148148149,22.048220012505848
Task_45441,2787,910,111,65,176,3.0592755214050493,53.59873708184406
Task_45442,2939,335,134,168,302,8.74702380952381,55.49402310517761
Task_45443,689,265,57,22,79,2.5902255639097747,16.869463309100887
Task_45444,2572,423,104,63,167,6.066037735849057,48.589208514893954
Task_45445,1150,889,29,195,224,1.2921348314606742,28.519112999264127
Task_45446,2474,613,128,120,248,4.029315960912052,48.73333798231315
Task_45447,2571,163,13,78,91,15.676829268292684,46.909380860731574
Task_45448,2716,692,60,88,148,3.919191919191919,51.96197923733172
Task_45449,1442,657,113,73,186,2.1914893617021276,31.62165930642955
Task_45450,2820,491,165,52,217,5.7317073170731705,53.16822913092034
Task_45451,1116,762,122,132,254,1.4626474442988204,27.666642585996367
Task_45452,1448,107,175,167,342,13.407407407407407,30.569103249123696
Task_45453,954,872,73,84,157,1.092783505154639,24.420655988927166
Task_45454,1237,202,196,148,344,6.093596059113301,28.288307882242147
Task_45455,2408,814,11,77,88,2.954601226993865,46.70222239850676
Task_45456,1178,485,107,91,198,2.4238683127572016,27.392817410236855
Task_45457,632,726,53,70,123,0.8693259972489684,18.740529838104443
Task_45458,2279,419,189,159,348,5.4261904761904765,45.52934683369691
Task_45459,769,592,162,119,281,1.296795952782462,21.720951955022752
Task_45460,1059,787,27,137,164,1.3439086294416243,26.349675795220538
Task_45461,1735,819,104,33,137,2.1158536585365852,36.13888878567226
Task_45462,2836,175,111,137,248,16.113636363636363,52.57709350669446
Task_45463,2351,672,194,93,287,3.4933135215453195,47.042966905154564
Task_45464,2114,334,63,21,84,6.3104477611940295,39.83086442810504
Task_45465,2514,784,67,84,151,3.202547770700637,48.9949382020009
Task_45466,1411,888,48,165,213,1.5871766029246344,32.74782402664844
Task_45467,616,670,142,121,263,0.9180327868852459,19.478471148747616
Task_45468,1760,886,69,25,94,1.984216459977452,36.3286495414867
Task_45469,2807,119,168,22,190,23.391666666666666,50.722474127790996
Task_45470,1089,872,110,65,175,1.2474226804123711,26.610528619307292
Task_45471,2345,775,22,23,45,3.0219072164948453,44.52009198578341
Task_45472,2890,544,181,187,368,5.302752293577981,55.7390598610948
Task_45473,717,104,192,14,206,6.828571428571428,17.63785822488153
Task_45474,1890,261,194,94,288,7.213740458015267,38.423408781105586
Task_45475,1348,601,65,51,116,2.2392026578073088,29.371101269737014
Task_45476,1292,837,109,186,295,1.541766109785203,30.977464405396432
Task_45477,1797,122,38,108,146,14.609756097560975,34.93657030067473
Task_45478,2053,632,103,17,120,3.2432859399684046,40.11981035960492
Task_45479,1014,658,121,14,135,1.5386949924127467,23.979490913095628
Task_45480,1542,391,112,31,143,3.933673469387755,31.7399148632214
Task_45481,2370,931,19,13,32,2.5429184549356223,45.14186620399931
Task_45482,1384,598,165,176,341,2.310517529215359,31.92509391284945
Task_45483,2904,964,196,44,240,3.0093264248704665,55.79502309591877
Task_45484,2726,999,189,200,389,2.726,54.69116232329949
Task_45485,2431,576,33,78,111,4.213171577123051,46.81036144910964
Task_45486,1226,802,45,123,168,1.526774595267746,28.973930650529525
Task_45487,2485,348,69,197,266,7.1203438395415475,48.35966885034287
Task_45488,1544,580,92,139,231,2.657487091222031,33.92981706863863
Task_45489,2267,766,37,17,54,2.955671447196871,43.18457328822219
Task_45490,1694,517,124,177,301,3.27027027027027,36.39951556625258
Task_45491,1742,593,186,40,226,2.9326599326599325,36.17627251052857
Task_45492,1708,694,112,67,179,2.4575539568345324,35.828369170394474
Task_45493,706,235,29,125,154,2.9915254237288136,18.816426963248777
Task_45494,718,928,198,167,365,0.7728740581270183,22.442207628198833
Task_45495,2238,817,191,93,284,2.7359413202933984,45.6948147733137
Task_45496,2159,671,38,56,94,3.212797619047619,42.25775297131212
Task_45497,1671,803,174,10,184,2.078358208955224,35.18340980827805
Task_45498,561,488,78,24,102,1.147239263803681,16.272665053921717
Task_45499,877,288,21,49,70,3.0346020761245676,19.978375488541587
Task_45500,524,537,95,176,271,0.9739776951672863,17.785815383533166
Task_45501,1932,475,100,84,184,4.0588235294117645,38.87365173414974
Task_45502,1333,259,37,46,83,5.126923076923077,27.40431069798463
Task_45503,1945,172,35,170,205,11.242774566473988,38.414858256632655
Task_45504,1845,694,43,145,188,2.6546762589928057,38.768964408201896
Task_45505,1727,187,61,160,221,9.186170212765957,35.64420539715919
Task_45506,2174,448,12,137,149,4.841870824053452,42.72941729850145
Task_45507,2661,774,56,79,135,3.4335483870967742,51.364835071768795
Task_45508,1481,434,84,126,210,3.4045977011494255,32.325783415858055
Task_45509,1157,537,135,95,230,2.150557620817844,27.49200420560209
Task_45510,2122,800,25,48,73,2.6491885143570535,41.29291027050204
Task_45511,824,205,134,194,328,4.0,21.77449023506611
Task_45512,2238,553,137,160,297,4.03971119133574,45.08451625250395
Task_45513,1520,664,187,124,311,2.2857142857142856,34.07436134541914
Task_45514,1367,859,32,39,71,1.5895348837209302,29.42326698164419
Task_45515,1813,960,138,34,172,1.886576482830385,38.13281087911857
Task_45516,2108,342,79,169,248,6.145772594752186,42.2633410869959
Task_45517,1977,1009,147,79,226,1.9574257425742574,41.64794996266827
Task_45518,2358,671,195,32,227,3.5089285714285716,46.18620301577292
Task_45519,984,675,170,20,190,1.455621301775148,24.058668907430256
Task_45520,2691,367,169,92,261,7.3125,51.28414808220245
Task_45521,752,512,189,163,352,1.46588693957115,21.625316616916923
Task_45522,1508,641,115,67,182,2.3489096573208723,32.51133461596745
Task_45523,1230,898,102,33,135,1.3681868743047831,28.37130052304991
Task_45524,2166,337,141,21,162,6.408284023668639,41.421452015214406
Task_45525,1214,695,55,45,100,1.7442528735632183,26.942481957850685
Task_45526,952,547,92,124,216,1.7372262773722629,24.34903498187751
Task_45527,1789,370,67,11,78,4.822102425876011,34.52496375925542
Task_45528,2891,948,137,111,248,3.0463645943097997,56.38066728016353
Task_45529,2064,156,193,159,352,13.146496815286625,40.929181580884695
Task_45530,1081,682,128,83,211,1.582723279648609,26.33421666395681
Task_45531,512,243,89,116,205,2.098360655737705,16.3432047155067
Task_45532,2490,600,127,120,247,4.143094841930116,48.94086323954613
Task_45533,1983,715,65,48,113,2.7695530726256985,39.51788528413477
Task_45534,832,713,63,15,78,1.165266106442577,20.478476636963595
Task_45535,707,643,31,144,175,1.0978260869565217,20.276679033701978
Task_45536,1030,998,24,10,34,1.031031031031031,24.131621492820372
Task_45537,2959,851,146,160,306,3.473004694835681,57.48754038841398
Task_45538,1458,796,93,27,120,1.8293601003764115,31.55306333917346
Task_45539,2273,820,73,119,192,2.7685749086479903,46.07450408919977
Task_45540,622,820,62,148,210,0.7576126674786845,19.92007014101167
Task_45541,2627,808,119,71,190,3.2472187886279356,50.990072914919104
Task_45542,736,690,48,199,247,1.065123010130246,21.452061234820068
Task_45543,692,342,108,100,208,2.0174927113702625,19.454509914202703
Task_45544,2555,266,50,154,204,9.569288389513108,48.90483118107621
Task_45545,2378,896,143,76,219,2.6510590858416947,47.54592557114035
Task_45546,856,81,13,33,46,10.439024390243903,18.210253640907364
Task_45547,1191,379,143,23,166,3.1342105263157896,26.296301712977453
Task_45548,792,915,185,111,296,0.8646288209606987,23.158055436325473
Task_45549,1544,471,166,187,353,3.2711864406779663,34.12764181094819
Task_45550,1956,431,52,107,159,4.527777777777778,39.371091235770656
Task_45551,1535,641,13,170,183,2.3909657320872273,33.60769725769211
Task_45552,1968,536,67,75,142,3.664804469273743,39.48924964207396
Task_45553,1905,670,116,24,140,2.8390461997019374,38.272297111300766
Task_45554,2002,169,39,198,237,11.776470588235295,39.58531647153621
Task_45555,820,1019,57,101,158,0.803921568627451,23.052501354280892
Task_45556,679,200,11,89,100,3.3781094527363185,17.705092355475603
Task_45557,2881,306,104,43,147,9.384364820846905,52.63302471797727
Task_45558,2537,381,34,64,98,6.641361256544503,47.41748902015281
Task_45559,2742,148,13,149,162,18.40268456375839,50.327274611905445
Task_45560,2715,92,67,68,135,29.193548387096776,48.64844707495794
Task_45561,1577,508,100,63,163,3.0982318271119844,33.11414969736289
Task_45562,966,236,85,15,100,4.075949367088608,21.542913404433733
Task_45563,644,256,96,82,178,2.5058365758754864,17.8414547270042
Task_45564,2529,591,128,44,172,4.27195945945946,48.296088763034874
Task_45565,610,89,128,22,150,6.777777777777778,15.293808692083786
Task_45566,1396,830,99,80,179,1.6799037304452467,31.481282299369983
Task_45567,2908,384,56,57,113,7.5532467532467535,53.388246248803966
Task_45568,2613,263,72,103,175,9.897727272727273,49.476643984557334
Task_45569,2850,175,44,159,203,16.193181818181817,52.65629870120333
Task_45570,2213,888,13,196,209,2.489313835770529,45.45474094117079
Task_45571,899,78,144,199,343,11.379746835443038,21.8166828475246
Task_45572,1049,150,74,18,92,6.947019867549669,22.372327425894742
Task_45573,997,787,73,173,246,1.265228426395939,25.96463775646713
Task_45574,2401,981,93,199,292,2.445010183299389,49.15813360844905
Task_45575,602,582,137,88,225,1.032590051457976,18.475809119679436
Task_45576,2379,163,37,72,109,14.50609756097561,43.96246933000247
Task_45577,1179,1017,18,101,119,1.1581532416502947,28.379503902311356
Task_45578,2318,123,130,148,278,18.693548387096776,44.29466915193791
Task_45579,2638,986,34,133,167,2.67274569402229,51.998472972706516
Task_45580,649,224,124,89,213,2.8844444444444446,18.214771243503886
Task_45581,923,939,101,11,112,0.9819148936170212,23.41743373461639
Task_45582,876,611,48,27,75,1.4313725490196079,20.856554278641216
Task_45583,1751,306,59,182,241,5.703583061889251,36.508026280428524
Task_45584,2186,196,160,23,183,11.096446700507615,41.40615816186206
Task_45585,731,365,67,172,239,1.9972677595628416,20.511692522206292
Task_45586,2397,683,98,46,144,3.504385964912281,46.19030488689496
Task_45587,550,309,182,87,269,1.7741935483870968,17.09665010727928
Task_45588,1987,403,65,105,170,4.9183168316831685,39.911922897517904
Task_45589,2107,678,170,30,200,3.1030927835051547,42.11807667608375
Task_45590,2561,392,53,13,66,6.516539440203562,46.621160240766585
Task_45591,1014,446,152,112,264,2.2684563758389262,25.148202875640845
Task_45592,1313,384,67,67,134,3.4103896103896103,28.535401963587805
Task_45593,1230,564,38,118,156,2.1769911504424777,28.16021218606016
Task_45594,1714,506,27,74,101,3.380670611439842,34.97927733023755
Task_45595,1053,320,117,101,218,3.2803738317757007,25.139964237918367
Task_45596,2826,515,81,169,250,5.476744186046512,54.177376277639326
Task_45597,1193,808,112,190,302,1.4746600741656366,29.34521529253787
Task_45598,2496,260,165,174,339,9.563218390804598,48.398863701022954
Task_45599,2191,567,99,101,200,3.857394366197183,43.86290840527693
Task_45600,861,884,12,176,188,0.9728813559322034,23.67651648770925
Task_45601,1921,987,149,99,248,1.944331983805668,41.098682567717205
Task_45602,2483,499,49,164,213,4.966,48.578302919719846
Task_45603,603,668,47,76,123,0.9013452914798207,18.116377992378304
Task_45604,715,963,172,42,214,0.741701244813278,20.998185498281845
Task_45605,734,177,68,80,148,4.123595505617978,18.483836765123986
Task_45606,1370,663,54,126,180,2.0632530120481927,31.085234528870103
Task_45607,2603,509,96,57,153,5.103921568627451,49.15801129440131
Task_45608,2013,964,154,25,179,2.0860103626943007,41.170535804004565
Task_45609,2674,805,139,16,155,3.3176178660049627,50.82912854940822
Task_45610,860,274,55,33,88,3.1272727272727274,19.94443635240266
Task_45611,1798,819,81,93,174,2.1926829268292685,38.262268714258454
Task_45612,2496,315,67,44,111,7.89873417721519,46.23165512459775
Task_45613,1028,603,113,68,181,1.7019867549668874,24.77904207876925
Task_45614,1789,682,150,177,327,2.6193265007320643,38.54135800698043
Task_45615,1509,783,29,103,132,1.9247448979591837,33.23324624137772
Task_45616,2383,542,112,96,208,4.388581952117864,46.87394731866211
Task_45617,2210,190,57,48,105,11.570680628272251,41.34189971363193
Task_45618,1642,511,136,44,180,3.20703125,33.93355094107503
Task_45619,2202,164,19,125,144,13.345454545454546,41.57266619410917
Task_45620,588,477,78,146,224,1.2301255230125523,18.37167481269561
Task_45621,2867,585,168,25,193,4.892491467576792,53.752648309291914
Task_45622,2003,210,176,88,264,9.492890995260664,39.709802519229385
Task_45623,2487,137,83,30,113,18.02173913043478,45.08737678677418
Task_45624,2928,288,83,123,206,10.131487889273357,54.708165912139684
Task_45625,959,363,123,72,195,2.6346153846153846,23.227132202322576
Task_45626,1622,778,56,117,173,2.0821566110397947,35.50102686203113
Task_45627,946,126,139,148,287,7.448818897637795,22.77318986813971
Task_45628,1150,104,63,25,88,10.952380952380953,23.24532870638846
Task_45629,1123,899,167,41,208,1.2477777777777779,27.234534738172652
Task_45630,2062,916,19,22,41,2.248636859323882,40.40997329342739
Task_45631,2359,334,184,132,316,7.04179104477612,46.32771446287078
Task_45632,2911,76,174,175,349,37.8051948051948,53.31454393680843
Task_45633,1051,731,143,56,199,1.435792349726776,25.794539438728574
Task_45634,1682,124,30,37,67,13.456,31.787283363898947
Task_45635,575,941,26,54,80,0.6104033970276008,18.028034292530297
Task_45636,1497,499,121,121,242,2.994,32.87553412411761
Task_45637,1759,896,192,83,275,1.9609810479375698,38.06846367855985
Task_45638,2412,280,180,39,219,8.583629893238435,45.684328002449014
Task_45639,1596,157,157,25,182,10.10126582278481,31.756028675042284
Task_45640,2950,955,44,193,237,3.085774058577406,57.42174409327362
Task_45641,922,171,96,104,200,5.3604651162790695,22.206765904929288
Task_45642,2533,438,51,109,160,5.769931662870159,48.56202318891342
Task_45643,1642,874,43,50,93,1.8765714285714286,34.48700936383307
Task_45644,1878,68,177,137,314,27.217391304347824,36.88154056766435
Task_45645,2179,228,144,46,190,9.51528384279476,41.697351158440334
Task_45646,2451,262,154,159,313,9.319391634980988,47.55585654797153
Task_45647,1229,418,105,21,126,2.9331742243436754,26.70102679720409
Task_45648,1118,836,179,101,280,1.3357228195937874,28.027578042423272
Task_45649,2063,197,29,161,190,10.419191919191919,40.703625061559244
Task_45650,1680,424,80,117,197,3.9529411764705884,35.4512749248668
Task_45651,2567,348,120,193,313,7.355300859598854,49.74118970478338
Task_45652,1543,1002,197,151,348,1.538384845463609,35.654088091153795
Task_45653,2483,247,11,140,151,10.012096774193548,46.92301212186923
Task_45654,1505,450,147,132,279,3.337028824833703,33.02922557755859
Task_45655,1275,849,69,169,238,1.5,30.589350950375437
Task_45656,2129,898,22,86,108,2.368186874304783,42.93946004456035
Task_45657,2893,317,95,115,210,9.09748427672956,54.28125053483182
Task_45658,1555,868,30,167,197,1.7894131185270425,34.85494834279066
Task_45659,2248,668,83,150,233,3.3602391629297457,45.358025840580105
Task_45660,1648,614,98,136,234,2.6796747967479675,35.62928073257567
Task_45661,2590,999,128,10,138,2.59,50.05180868261584
Task_45662,2255,985,26,109,135,2.287018255578093,45.65503278490983
Task_45663,652,116,116,178,294,5.572649572649572,18.081753076550587
Task_45664,2058,802,147,38,185,2.5628891656288917,41.549917139379566
Task_45665,2262,878,175,144,319,2.573378839590444,46.563526499106615
Task_45666,1362,900,194,30,224,1.51165371809101,31.117793683706946
Task_45667,2910,344,170,53,223,8.434782608695652,54.134533130081735
Task_45668,2452,830,16,41,57,2.950661853188929,46.64679053121984
Task_45669,2739,893,116,45,161,3.063758389261745,52.28423547895852
Task_45670,1605,261,127,60,187,6.125954198473282,32.90000806197842
Task_45671,1112,510,138,23,161,2.176125244618395,25.31774049918245
Task_45672,1161,831,143,53,196,1.3954326923076923,27.84812516499537
Task_45673,2574,397,129,22,151,6.467336683417085,48.03641558405139
Task_45674,2590,488,24,146,170,5.296523517382413,49.71391752767057
Task_45675,741,364,53,170,223,2.03013698630137,20.63926372293619
Task_45676,2354,96,184,175,359,24.2680412371134,44.75552270794706
Task_45677,2374,500,42,169,211,4.738522954091817,46.70707793628451
Task_45678,1495,277,185,18,203,5.377697841726619,30.887070579372743
Task_45679,2666,930,141,116,257,2.8635875402792696,52.806956547147365
Task_45680,2245,744,45,164,209,3.0134228187919465,45.40852040621106
Task_45681,2556,598,47,83,130,4.267111853088481,49.07158015290103
Task_45682,740,900,22,195,217,0.8213096559378469,21.91876393972957
Task_45683,1744,556,12,160,172,3.1310592459605027,36.64250998649634
Task_45684,1237,868,140,185,325,1.4234752589182968,30.310345081580383
Task_45685,2406,965,140,197,337,2.4906832298136647,49.27545024581921
Task_45686,2142,297,129,128,257,7.1879194630872485,42.4976205803642
Task_45687,524,948,177,199,376,0.5521601685985248,19.56578119731656
Task_45688,2109,902,89,88,177,2.335548172757475,43.09334741203157
Task_45689,2143,274,86,76,162,7.792727272727273,41.358908398514345
Task_45690,731,254,120,148,268,2.8666666666666667,20.129937151454943
Task_45691,2873,743,49,15,64,3.861559139784946,52.70586936474634
Task_45692,611,167,18,150,168,3.636904761904762,16.863005410394077
Task_45693,852,310,106,18,124,2.739549839228296,20.14519778768259
Task_45694,2747,781,23,151,174,3.5127877237851663,53.33507671973141
Task_45695,1028,258,179,126,305,3.969111969111969,24.970636442776208
Task_45696,1033,865,161,29,190,1.1928406466512702,25.674825904582715
Task_45697,1994,424,57,169,226,4.691764705882353,40.65887117464584
Task_45698,998,64,114,146,260,15.353846153846154,22.921498842193945
Task_45699,898,771,196,138,334,1.1632124352331605,24.596624990541883
Task_45700,612,91,40,41,81,6.6521739130434785,14.859408852906938
Task_45701,1857,569,149,84,233,3.2578947368421054,38.40874387376902
Task_45702,2104,532,94,65,159,3.947467166979362,41.44986892955488
Task_45703,1599,733,65,167,232,2.178474114441417,35.37371512228994
Task_45704,2878,475,16,44,60,6.046218487394958,52.185324477676716
Task_45705,2640,893,26,118,144,2.953020134228188,51.51543822430631
Task_45706,1283,559,163,119,282,2.2910714285714286,29.853845027891353
Task_45707,1555,577,20,90,110,2.690311418685121,32.907076964493555
Task_45708,1280,592,54,116,170,2.1585160202360876,29.37155491564629
Task_45709,582,325,195,28,223,1.7852760736196318,16.921080115784637
Task_45710,1705,119,65,144,209,14.208333333333334,34.41251157479645
Task_45711,2177,386,100,175,275,5.625322997416021,43.501158010207206
Task_45712,696,370,106,20,126,1.876010781671159,18.018652383417948
Task_45713,757,708,77,119,196,1.0677009873060648,21.531934982894114
Task_45714,1619,77,38,182,220,20.756410256410255,32.572441290351534
Task_45715,1409,478,40,196,236,2.941544885177453,31.51117324029539
Task_45716,669,1000,96,69,165,0.6683316683316683,20.61413844733746
Task_45717,1499,119,70,139,209,12.491666666666667,31.176629420581335
Task_45718,1226,906,176,45,221,1.3517089305402425,28.93157813375276
Task_45719,678,454,116,151,267,1.4901098901098901,19.883140199654385
Task_45720,2955,894,167,86,253,3.3016759776536313,56.94759748434643
Task_45721,2574,319,139,43,182,8.04375,48.06698295492831
Task_45722,2507,198,138,11,149,12.597989949748744,46.251168251590855
Task_45723,2517,852,169,116,285,2.950762016412661,50.32834501013696
Task_45724,2272,570,124,142,266,3.978984238178634,45.51098375798014
Task_45725,2533,879,15,111,126,2.878409090909091,49.78522382186824
Task_45726,1507,222,23,120,143,6.757847533632287,31.473036565503374
Task_45727,2442,924,84,190,274,2.64,49.47117800374326
Task_45728,2793,641,162,176,338,4.350467289719626,54.36234441432907
Task_45729,1899,917,142,24,166,2.0686274509803924,39.191592219435144
Task_45730,1275,963,18,164,182,1.3226141078838174,30.31737247867531
Task_45731,2302,1018,169,41,210,2.2590775269872423,46.3010794066142
Task_45732,1771,150,186,104,290,11.728476821192054,35.89333607836726
Task_45733,2599,276,199,132,331,9.382671480144404,49.98715454408424
Task_45734,2438,552,159,188,347,4.4086799276672695,48.51458452158683
Task_45735,1196,959,125,40,165,1.2458333333333333,28.309704764453667
Task_45736,2872,492,101,16,117,5.825557809330629,52.71293524359137
Task_45737,2791,331,51,138,189,8.406626506024097,52.75517770915598
Task_45738,2139,241,58,78,136,8.838842975206612,41.34009515618553
Task_45739,1208,296,51,86,137,4.0673400673400675,26.88039282407799
Task_45740,580,249,34,117,151,2.32,16.854583214680936
Task_45741,2519,850,165,34,199,2.9600470035252644,49.17531816230516
Task_45742,802,724,144,15,159,1.1062068965517242,20.86793092473683
Task_45743,1509,89,80,35,115,16.766666666666666,29.160354201525994
Task_45744,763,245,137,133,270,3.1016260162601625,20.593193288448585
Task_45745,1839,82,39,31,70,22.156626506024097,33.738018790965576
Task_45746,2455,92,155,92,247,26.397849462365592,45.70167269547354
Task_45747,604,718,145,132,277,0.8400556328233658,19.507110632376868
Task_45748,1237,497,176,55,231,2.4839357429718874,28.180879264419662
Task_45749,1818,465,112,198,310,3.9012875536480687,38.26798917306623
Task_45750,564,691,13,146,159,0.815028901734104,17.997865135521874
Task_45751,2766,364,43,35,78,7.578082191780822,50.08370058063966
Task_45752,2439,260,145,49,194,9.344827586206897,46.03726945169478
Task_45753,2595,1006,20,151,171,2.576961271102284,51.36849128282673
Task_45754,2650,94,53,42,95,27.894736842105264,46.753266456500995
Task_45755,936,169,24,71,95,5.5058823529411764,21.09701414555043
Task_45756,2074,948,70,125,195,2.185458377239199,43.35641491193848
Task_45757,1384,296,119,188,307,4.65993265993266,30.823673025854337
Task_45758,581,792,182,155,337,0.7326607818411097,19.6980874221472
Task_45759,2131,348,159,113,272,6.106017191977077,42.54262878783057
Task_45760,1286,759,135,13,148,1.6921052631578948,28.68606371296427
Task_45761,2108,120,182,178,360,17.421487603305785,41.38912766089103
Task_45762,2358,772,198,16,214,3.0504527813712805,46.26863821052809
Task_45763,2635,856,177,27,204,3.074679113185531,50.9946201525079
Task_45764,1246,723,54,180,234,1.7209944751381216,29.799027976752786
Task_45765,2034,546,123,148,271,3.7184643510054847,41.69726604300207
Task_45766,2273,473,109,174,283,4.79535864978903,45.339204917901725
Task_45767,1518,169,111,123,234,8.929411764705883,31.79807616301127
Task_45768,2727,914,124,26,150,2.980327868852459,52.12095066040857
Task_45769,2117,338,26,188,214,6.244837758112094,42.1771019638263
Task_45770,2743,377,81,181,262,7.256613756613756,52.480008682361095
Task_45771,2277,987,147,81,228,2.304655870445344,46.31528313541812
Task_45772,2537,86,149,111,260,29.160919540229884,47.08226736988282
Task_45773,1428,719,170,121,291,1.9833333333333334,32.69435695768995
Task_45774,2232,770,58,123,181,2.894941634241245,45.069888486925294
Task_45775,1084,758,193,107,300,1.4281949934123848,27.317952181847605
Task_45776,1879,243,102,75,177,7.700819672131147,37.150757304323285
Task_45777,2343,871,111,170,281,2.686926605504587,47.69194008950307
Task_45778,2516,181,29,199,228,13.824175824175825,47.55738375642466
Task_45779,1510,401,59,24,83,3.756218905472637,30.56046031608022
Task_45780,509,726,35,181,216,0.7001375515818432,17.909518131736004
Task_45781,1889,111,154,35,189,16.866071428571427,36.02295446598594
Task_45782,2261,913,95,138,233,2.473741794310722,46.33060287126913
Task_45783,1687,154,63,38,101,10.883870967741936,32.33221278888771
Task_45784,1789,529,160,116,276,3.3754716981132074,37.739631309986486
Task_45785,931,273,123,12,135,3.397810218978102,21.541242210806114
Task_45786,2628,986,119,132,251,2.662613981762918,52.37597168760067
Task_45787,1218,561,22,35,57,2.167259786476868,26.160120013835378
Task_45788,2458,289,97,16,113,8.475862068965517,45.534130299637305
Task_45789,1585,784,96,44,140,2.0191082802547773,33.65443042852716
Task_45790,1872,187,184,90,274,9.957446808510639,37.8550790000121
Task_45791,1390,823,132,57,189,1.6868932038834952,31.32265321659195
Task_45792,2246,224,68,139,207,9.982222222222223,43.79183606786114
Task_45793,2021,347,103,122,225,5.807471264367816,40.600709827957566
Task_45794,2182,930,69,59,128,2.343716433941998,43.96343573437016
Task_45795,941,79,111,34,145,11.7625,20.370742190139573
Task_45796,2180,904,74,145,219,2.408839779005525,45.02790853688416
Task_45797,1595,551,42,165,207,2.8894927536231885,34.51204572280228
Task_45798,709,807,113,56,169,0.8774752475247525,20.322366809987727
Task_45799,941,257,14,14,28,3.647286821705426,20.41263147033915
Task_45800,1639,812,36,120,156,2.015990159901599,35.41637771494234
Task_45801,2928,755,70,138,208,3.873015873015873,56.36074250579284
Task_45802,515,215,105,116,221,2.384259259259259,16.332490836652713
Task_45803,1063,888,111,115,226,1.1957255343082114,27.052818133236656
Task_45804,569,820,105,90,195,0.6930572472594397,18.81292327093218
Task_45805,1360,728,166,92,258,1.8655692729766804,31.353267940618434
Task_45806,922,342,133,12,145,2.688046647230321,21.720405056895242
Task_45807,771,497,121,156,277,1.5481927710843373,21.54210733100078
Task_45808,1895,526,55,152,207,3.5958254269449714,39.30885146623202
Task_45809,968,150,17,134,151,6.410596026490066,22.0380375109204
Task_45810,2974,774,43,152,195,3.8374193548387097,56.98456421501729
Task_45811,2738,767,58,149,207,3.5651041666666665,53.41430323843121
Task_45812,516,349,32,138,170,1.4742857142857142,16.382711714392688
Task_45813,2497,858,15,10,25,2.9068684516880094,46.921064872186946
Task_45814,1980,860,111,134,245,2.299651567944251,41.690994703883796
Task_45815,1984,671,177,164,341,2.9523809523809526,41.63956729563811
Task_45816,1480,337,24,40,64,4.378698224852071,29.56905356770061
Task_45817,2418,604,82,102,184,3.996694214876033,47.41756325583546
Task_45818,2887,581,19,26,45,4.9604810996563575,52.517651822293374
Task_45819,575,669,139,112,251,0.8582089552238806,18.758026200393946
Task_45820,1140,739,108,35,143,1.5405405405405406,26.46465582280014
Task_45821,1009,132,26,185,211,7.586466165413534,23.501384353560198
Task_45822,2921,787,16,16,32,3.7068527918781724,53.45714829765163
Task_45823,1362,64,167,33,200,20.953846153846154,27.387237814260818
Task_45824,1469,672,128,72,200,2.1827637444279344,32.29907099079549
Task_45825,1087,147,24,20,44,7.344594594594595,22.260816566460193
Task_45826,2237,946,76,61,137,2.362196409714889,44.81497848086682
Task_45827,590,437,197,54,251,1.3470319634703196,17.80691509346137
Task_45828,1309,541,97,164,261,2.415129151291513,30.20396833163125
Task_45829,2865,467,172,60,232,6.121794871794871,53.76977576253984
Task_45830,2054,912,139,81,220,2.249726177437021,42.51203571535885
Task_45831,2875,280,181,165,346,10.231316725978647,54.48020053833532
Task_45832,2181,627,129,49,178,3.4729299363057327,42.91171354146079
Task_45833,1523,560,126,55,181,2.714795008912656,32.49795242134972
Task_45834,998,68,199,192,391,14.46376811594203,23.55076968358806
Task_45835,881,997,59,113,172,0.8827655310621243,24.267940632303894
Task_45836,2513,926,35,38,73,2.7108953613807985,47.8746648768598
Task_45837,2962,322,99,173,272,9.170278637770897,55.68602912942828
Task_45838,1596,761,11,97,108,2.094488188976378,34.26332467480952
Task_45839,678,320,126,124,250,2.1121495327102804,19.3877596013704
Task_45840,2871,86,22,148,170,33.0,51.77533619021987
Task_45841,1858,284,167,166,333,6.519298245614035,38.36138096963892
Task_45842,2697,809,142,31,173,3.3296296296296295,51.669169889008636
Task_45843,2597,1013,48,183,231,2.5611439842209074,52.07680141988996
Task_45844,1027,104,18,171,189,9.780952380952382,23.158185036918315
Task_45845,2462,685,190,87,277,3.5889212827988337,48.599471627010224
Task_45846,2240,614,31,139,170,3.6422764227642275,44.55757740581765
Task_45847,1130,357,169,90,259,3.1564245810055866,26.481006547981604
Task_45848,2005,326,106,73,179,6.131498470948012,39.39288838157749
Task_45849,1271,557,111,63,174,2.2777777777777777,28.54216185475381
Task_45850,1135,763,137,37,174,1.4856020942408377,26.80577423443842
Task_45851,1120,568,191,104,295,1.968365553602812,27.337576294470153
Task_45852,1897,115,138,169,307,16.353448275862068,37.70348900522293
Task_45853,2014,624,160,65,225,3.2224,40.8586814252529
Task_45854,2688,670,33,64,97,4.0059612518628915,50.75853850637287
Task_45855,1313,671,76,163,239,1.9538690476190477,30.688379506704862
Task_45856,595,1013,199,171,370,0.5867850098619329,20.900218558824488
Task_45857,2083,941,165,22,187,2.2112526539278132,42.368843238922814
Task_45858,831,612,156,33,189,1.3556280587275693,21.63556522868676
Task_45859,2538,902,30,118,148,2.8106312292358804,49.923217573742484
Task_45860,2251,436,133,143,276,5.151029748283753,44.79384068497456
Task_45861,844,147,153,196,349,5.702702702702703,21.668102928671868
Task_45862,1607,316,196,192,388,5.069400630914826,34.78706902003289
Task_45863,1548,149,150,73,223,10.32,31.638675485510902
Task_45864,1088,129,107,69,176,8.36923076923077,23.678139633116142
Task_45865,1480,816,193,33,226,1.8115055079559363,32.72764118469358
Task_45866,1131,975,180,151,331,1.158811475409836,28.925644127238034
Task_45867,2841,66,49,81,130,42.40298507462686,50.60053900392646
Task_45868,1405,362,60,28,88,3.8705234159779613,28.78271915599358
Task_45869,1748,958,133,145,278,1.8227320125130344,38.484590977438806
Task_45870,2026,400,186,62,248,5.052369077306733,40.377947969325575
Task_45871,1922,946,33,121,154,2.0295670538542767,40.312874833111344
Task_45872,1847,526,23,30,53,3.504743833017078,36.12756219028251
Task_45873,2873,560,65,163,228,5.121212121212121,54.9806130787343
Task_45874,1516,227,91,155,246,6.649122807017544,32.39998949213417
Task_45875,2394,443,113,181,294,5.391891891891892,47.2167842334031
Task_45876,2824,980,151,57,208,2.8786952089704383,54.65960651979058
Task_45877,1922,325,120,193,313,5.895705521472393,39.461947286873574
Task_45878,688,439,107,45,152,1.5636363636363637,18.286140799114207
Task_45879,2809,598,51,60,111,4.689482470784641,52.47518521649567
Task_45880,2167,617,39,43,82,3.5064724919093853,41.77022673988358
Task_45881,1869,1016,145,171,316,1.8377581120943953,40.791506880440714
Task_45882,616,907,19,105,124,0.6784140969162996,19.338339608794765
Task_45883,648,975,42,127,169,0.6639344262295082,20.39218924348391
Task_45884,2847,592,171,113,284,4.801011804384486,54.72541104900794
Task_45885,2219,189,123,64,187,11.678947368421053,42.52951284078866
Task_45886,2337,119,36,99,135,19.475,43.326408652693175
Task_45887,1913,370,157,22,179,5.15633423180593,37.692153567216195
Task_45888,2887,304,58,181,239,9.465573770491803,54.452165223048105
Task_45889,1894,458,124,40,164,4.126361655773421,37.785732451057534
Task_45890,1396,536,60,170,230,2.5996275605214154,31.5391261040081
Task_45891,1124,126,61,83,144,8.850393700787402,24.370495940413335
Task_45892,1279,293,38,158,196,4.350340136054422,28.62188998518599
Task_45893,2252,259,70,64,134,8.661538461538461,42.96503557876969
Task_45894,1433,355,77,68,145,4.025280898876405,30.367318582869956
Task_45895,2795,644,47,54,101,4.333333333333333,52.222565136884036
Task_45896,2549,483,130,42,172,5.266528925619835,48.27377235351012
Task_45897,1927,458,40,134,174,4.198257080610022,39.21114256668833
Task_45898,2539,733,178,193,371,3.4591280653950953,50.80382734324022
Task_45899,1618,220,144,153,297,7.321266968325792,34.16355015148708
Task_45900,1263,551,80,89,169,2.2880434782608696,28.703355520937432
Task_45901,1386,306,178,136,314,4.514657980456026,30.843762934996196
Task_45902,1331,66,57,111,168,19.865671641791046,27.669876126609264
Task_45903,2421,527,130,102,232,4.5852272727272725,47.52087195662231
Task_45904,1632,593,167,83,250,2.7474747474747474,34.99697560449153
Task_45905,1369,826,87,97,184,1.6553808948004838,31.438880762339355
Task_45906,1024,438,166,65,231,2.3325740318906605,24.623558546392672
Task_45907,2194,189,37,157,194,11.547368421052632,42.721453609041305
Task_45908,994,732,122,180,302,1.3560709413369714,25.95539027768611
Task_45909,610,233,164,56,220,2.606837606837607,17.372959735473305
Task_45910,888,296,76,45,121,2.98989898989899,20.859735170157716
Task_45911,2694,983,141,190,331,2.7378048780487805,53.858091959674745
Task_45912,2349,852,131,92,223,2.753810082063306,47.25117119893091
Task_45913,2036,511,91,90,181,3.9765625,40.815954080764946
Task_45914,903,370,161,88,249,2.4339622641509435,22.79635606201713
Task_45915,920,647,111,174,285,1.4197530864197532,24.40582652807684
Task_45916,2226,838,81,146,227,2.6531585220500595,45.56015580620909
Task_45917,2791,686,123,95,218,4.0625909752547305,53.78582480572831
Task_45918,1014,954,38,54,92,1.0617801047120419,24.88395787382125
Task_45919,1016,407,72,108,180,2.4901960784313726,24.617270304141115
Task_45920,1515,718,147,189,336,2.1070931849791377,34.3718932694231
Task_45921,2303,68,145,151,296,33.3768115942029,43.46563681069878
Task_45922,747,885,41,168,209,0.8431151241534989,21.931158454440766
Task_45923,2347,948,40,148,188,2.4731296101159117,47.519273818155305
Task_45924,613,262,44,32,76,2.3307984790874525,15.616898346593175
Task_45925,1289,1011,85,196,281,1.273715415019763,31.405199994290474
Task_45926,1158,848,182,193,375,1.3639575971731448,29.24066792162283
Task_45927,2327,169,124,42,166,13.688235294117646,43.36829505896616
Task_45928,1467,282,80,104,184,5.18374558303887,31.360892334097667
Task_45929,834,533,97,115,212,1.5617977528089888,22.322587439022016
Task_45930,2305,778,19,170,189,2.958921694480103,46.3377983999058
Task_45931,1248,668,41,19,60,1.8654708520179373,26.670857740507785
Task_45932,2866,953,125,48,173,3.0041928721174003,54.803968783979
Task_45933,1985,961,96,47,143,2.0634095634095635,40.594742173053525
Task_45934,755,151,118,148,266,4.967105263157895,19.842619607972583
Task_45935,2666,414,107,130,237,6.424096385542168,51.09435550020078
Task_45936,1580,385,105,16,121,4.0932642487046635,31.93852463526403
Task_45937,2491,171,135,10,145,14.482558139534884,45.64757271049012
Task_45938,2839,624,155,139,294,4.5424,54.78417849727301
Task_45939,1622,338,75,83,158,4.784660766961652,33.47111894304628
Task_45940,709,1017,63,13,76,0.6964636542239686,19.69642543393143
Task_45941,1148,974,153,34,187,1.1774358974358974,27.783412749822656
Task_45942,591,192,59,56,115,3.062176165803109,16.326989864582064
Task_45943,1732,866,123,86,209,1.9976931949250287,37.28353452224971
Task_45944,2810,602,28,158,186,4.660033167495854,53.71038580967733
Task_45945,1331,509,37,144,181,2.6098039215686275,29.87919826564999
Task_45946,1167,80,189,26,215,14.407407407407407,24.565804789856205
Task_45947,940,181,173,67,240,5.164835164835165,22.314100045772804
Task_45948,1674,270,66,117,183,6.177121771217712,34.59738545423571
Task_45949,1716,441,117,67,184,3.8823529411764706,35.180575313750815
Task_45950,1624,333,77,131,208,4.862275449101796,34.33749611395339
Task_45951,1947,698,177,38,215,2.7854077253218885,39.73503457443184
Task_45952,2840,594,133,58,191,4.773109243697479,53.609304870596134
Task_45953,759,627,111,30,141,1.2085987261146496,20.088642760794944
Task_45954,2380,209,197,130,327,11.333333333333334,46.25548099296308
Task_45955,2143,572,50,181,231,3.7399650959860384,43.56350181191865
Task_45956,1696,544,179,169,348,3.1119266055045873,36.71687581055117
Task_45957,2928,831,111,69,180,3.519230769230769,55.56974331503036
Task_45958,1235,561,27,70,97,2.197508896797153,27.37884019237566
Task_45959,1517,741,71,146,217,2.0444743935309972,34.002945557901484
Task_45960,1767,553,179,94,273,3.1895306859205776,37.36606776072199
Task_45961,787,787,199,133,332,0.998730964467005,22.855948785270474
Task_45962,1260,286,199,163,362,4.390243902439025,29.04142226155344
Task_45963,900,544,199,96,295,1.651376146788991,23.777391557813882
Task_45964,2032,860,146,77,223,2.3600464576074334,41.97357253662886
Task_45965,859,255,188,70,258,3.35546875,21.551799229148912
Task_45966,1943,460,99,154,253,4.214750542299349,39.91081023672786
Task_45967,1509,963,177,16,193,1.5653526970954357,33.278926638207
Task_45968,873,641,75,53,128,1.3598130841121496,22.407012789849944
Task_45969,2448,408,19,44,63,5.985330073349633,45.12714102375488
Task_45970,1895,549,115,99,214,3.4454545454545453,39.162335866984044
Task_45971,627,422,150,108,258,1.4822695035460993,18.872251150110177
Task_45972,3000,709,54,89,143,4.225352112676056,56.58568536051453
Task_45973,2308,139,37,78,115,16.485714285714284,42.79211616113315
Task_45974,2527,438,180,45,225,5.75626423690205,48.05735998776572
Task_45975,1927,126,129,188,317,15.173228346456693,38.406800007767885
Task_45976,1949,530,44,135,179,3.670433145009416,39.69866404933634
Task_45977,1815,947,182,71,253,1.9145569620253164,38.85515682041044
Task_45978,963,653,53,54,107,1.4724770642201834,23.220374563800316
Task_45979,2739,908,123,44,167,3.0132013201320134,52.506140614466055
Task_45980,2014,803,31,55,86,2.5049751243781095,40.26345115482369
Task_45981,2090,241,43,42,85,8.636363636363637,39.32530341730281
Task_45982,1624,612,163,165,328,2.6492659053833605,35.6951651390623
Task_45983,1783,700,29,103,132,2.543509272467903,37.314642705629645
Task_45984,2186,824,40,19,59,2.64969696969697,42.004051903347666
Task_45985,1169,887,102,184,286,1.3164414414414414,29.130289415715865
Task_45986,2239,859,37,113,150,2.603488372093023,45.01609797285073
Task_45987,2173,409,59,115,174,5.3,43.05972356961939
Task_45988,969,895,55,149,204,1.0814732142857142,25.55655403162505
Task_45989,1197,385,154,106,260,3.1010362694300517,27.8235565063486
Task_45990,1240,291,65,37,102,4.2465753424657535,26.168077912735626
Task_45991,691,901,16,54,70,0.7660753880266076,19.268941838313797
Task_45992,2153,577,170,108,278,3.7249134948096887,43.653086370790675
Task_45993,2269,426,25,193,218,5.313817330210773,44.90651126183534
Task_45994,2263,223,23,146,169,10.102678571428571,43.68491776158785
Task_45995,664,893,109,130,239,0.7427293064876958,20.78377409653108
Task_45996,2911,882,83,175,258,3.2967157417893547,56.68351090863643
Task_45997,826,896,63,111,174,0.9208472686733556,23.07021144179245
Task_45998,2727,250,10,54,64,10.864541832669323,49.2605457295792
Task_45999,1943,574,194,45,239,3.3791304347826085,39.3122857678323
Task_46000,1806,590,164,83,247,3.0558375634517767,37.7294954481295
Task_46001,1788,526,85,98,183,3.3927893738140416,37.134167638111464
Task_46002,2224,67,115,36,151,32.705882352941174,40.31158840044803
Task_46003,2773,877,176,76,252,3.1583143507972666,53.89403408556586
Task_46004,543,739,186,39,225,0.7337837837837838,17.699452419887226
Task_46005,2308,521,57,15,72,4.421455938697318,42.99980866669977
Task_46006,2680,886,45,179,224,3.0214205186020293,52.83500646202591
Task_46007,2110,563,159,50,209,3.7411347517730498,41.89489884787656
Task_46008,2098,347,74,173,247,6.028735632183908,42.12439414810887
Task_46009,1343,505,69,152,221,2.6541501976284585,30.528760748452182
Task_46010,1020,824,33,34,67,1.2363636363636363,23.845968069055132
Task_46011,2153,735,162,74,236,2.9252717391304346,43.55554360174184
Task_46012,1534,161,154,164,318,9.469135802469136,32.436835283660564
Task_46013,2899,459,22,68,90,6.302173913043478,53.29106322569199
Task_46014,1293,358,113,31,144,3.6016713091922004,27.698329551300557
Task_46015,2125,862,17,22,39,2.46234067207416,41.1912451718056
Task_46016,2134,464,65,127,192,4.589247311827957,42.756131542711536
Task_46017,2175,655,143,41,184,3.3155487804878048,42.85761160140037
Task_46018,2010,549,160,182,342,3.6545454545454548,41.69663446645123
Task_46019,597,748,85,29,114,0.7970627503337784,17.755004134904464
Task_46020,664,241,127,189,316,2.743801652892562,19.30552626769462
Task_46021,2453,712,68,39,107,3.44039270687237,46.78605077620813
Task_46022,637,182,199,32,231,3.480874316939891,17.43552352893869
Task_46023,2392,160,188,164,352,14.857142857142858,46.121108314528435
Task_46024,1901,382,43,163,206,4.9634464751958225,38.80621344615948
Task_46025,1949,104,23,30,53,18.561904761904763,35.92007425227066
Task_46026,972,873,161,34,195,1.1121281464530892,24.68662545168984
Task_46027,2326,306,32,73,105,7.576547231270358,44.0002363961765
Task_46028,1251,363,192,94,286,3.4368131868131866,28.651243414119715
Task_46029,986,727,54,163,217,1.3543956043956045,25.52988132857098
Task_46030,2905,931,170,155,325,3.116952789699571,56.96089601285894
Task_46031,1878,572,86,109,195,3.277486910994764,38.95191508329227
Task_46032,556,550,20,89,109,1.0090744101633393,16.797400916672235
Task_46033,1190,182,175,73,248,6.502732240437158,26.53362181533808
Task_46034,2735,66,60,53,113,40.82089552238806,48.469937119142635
Task_46035,1016,646,94,181,275,1.5703245749613601,26.00184434759758
Task_46036,941,611,125,29,154,1.5375816993464053,22.928166880509412
Task_46037,2097,91,165,51,216,22.793478260869566,39.43661959585459
Task_46038,1072,164,43,152,195,6.496969696969697,24.625952988079842
Task_46039,1235,948,181,88,269,1.3013698630136987,29.860378452420267
Task_46040,2802,126,56,146,202,22.062992125984252,51.721716184028104
Task_46041,1837,253,43,46,89,7.232283464566929,35.3891463810285
Task_46042,1504,965,155,30,185,1.556935817805383,33.25645608395203
Task_46043,2114,249,48,121,169,8.456,41.41412243327235
Task_46044,1772,136,144,113,257,12.934306569343066,35.686060897339495
Task_46045,2294,108,105,179,284,21.045871559633028,43.64273974250715
Task_46046,2017,262,192,154,346,7.669201520912548,40.83879859383959
Task_46047,2389,874,86,170,256,2.7302857142857144,48.35953894297433
Task_46048,791,400,94,49,143,1.972568578553616,20.058348016172875
Task_46049,2934,599,20,168,188,4.89,55.71669573430062
Task_46050,2396,496,159,131,290,4.82092555331992,47.329174171284514
Task_46051,2868,126,104,162,266,22.58267716535433,52.9490364692907
Task_46052,2076,130,110,44,154,15.84732824427481,38.78085521729481
Task_46053,1171,738,83,168,251,1.584573748308525,28.580377291072733
Task_46054,2072,561,151,111,262,3.6868327402135233,42.25187907278187
Task_46055,2172,342,83,18,101,6.332361516034985,40.88745370263876
Task_46056,1640,568,24,36,60,2.882249560632689,32.80757107630299
Task_46057,954,548,58,144,202,1.7377049180327868,24.427078096325868
Task_46058,1641,912,187,126,313,1.7973713033953997,36.776098958842006
Task_46059,2647,433,187,61,248,6.099078341013825,50.27607222984211
Task_46060,2693,415,177,16,193,6.4735576923076925,50.33619351834573
Task_46061,2490,908,153,67,220,2.7392739273927393,49.26986618916417
Task_46062,2523,296,150,73,223,8.494949494949495,47.87695301669445
Task_46063,2430,563,175,51,226,4.308510638297872,47.210496249550516
Task_46064,2986,743,46,30,76,4.013440860215054,54.705583927321726
Task_46065,2238,293,20,144,164,7.612244897959184,43.47453813436704
Task_46066,2993,428,177,56,233,6.976689976689976,55.76344611581695
Task_46067,989,986,75,81,156,1.0020263424518743,25.34897517333344
Task_46068,2507,203,155,91,246,12.28921568627451,47.66818322011022
Task_46069,1121,74,143,109,252,14.946666666666667,24.776104465060897
Task_46070,2543,736,94,11,105,3.4504748982360924,48.29274458253929
Task_46071,1651,823,172,52,224,2.003640776699029,35.735938439085345
Task_46072,1594,725,57,18,75,2.1955922865013773,32.29474438051204
Task_46073,2575,828,124,172,296,3.106151990349819,51.303796904753085
Task_46074,2819,72,83,116,199,38.61643835616438,51.128460237138825
Task_46075,915,855,196,103,299,1.0689252336448598,24.855081116275688
Task_46076,786,325,13,156,169,2.411042944785276,20.664845417749618
Task_46077,876,911,71,86,157,0.9605263157894737,23.387612196214103
Task_46078,2074,348,15,182,197,5.9426934097421205,41.44655479435877
Task_46079,584,479,156,185,341,1.2166666666666666,18.776134154974443
Task_46080,2576,876,70,92,162,2.937286202964652,50.544461779665774
Task_46081,1405,167,183,81,264,8.363095238095237,29.811329963172312
Task_46082,1397,561,118,85,203,2.48576512455516,30.984609182103483
Task_46083,2492,627,112,27,139,3.968152866242038,47.43194100562673
Task_46084,1348,608,192,179,371,2.213464696223317,31.52592619423602
Task_46085,718,959,19,176,195,0.7479166666666667,21.65157405398179
Task_46086,2152,750,83,106,189,2.8655126498002663,43.805498827424834
Task_46087,1875,473,135,64,199,3.9556962025316458,38.0439903699047
Task_46088,1636,638,84,79,163,2.560250391236307,34.6927120513576
Task_46089,655,537,12,29,41,1.2174721189591078,17.05257196436269
Task_46090,2887,655,100,183,283,4.400914634146342,55.65807942972733
Task_46091,1657,704,197,186,383,2.350354609929078,36.78495526294813
Task_46092,1041,695,200,16,216,1.4956896551724137,25.13569239036713
Task_46093,1833,107,28,74,102,16.97222222222222,34.6396248373452
Task_46094,2658,131,73,197,270,20.136363636363637,49.843317270920956
Task_46095,1196,432,124,47,171,2.7621247113163974,26.567690879781953
Task_46096,2896,955,109,106,215,3.0292887029288704,56.325715335060885
Task_46097,705,966,70,131,201,0.7290589451913133,21.727357774267727
Task_46098,1501,917,173,134,307,1.6350762527233116,34.544501851663235
Task_46099,1781,566,76,50,126,3.1410934744268078,36.15733156530192
Task_46100,2538,553,39,36,75,4.581227436823105,46.99118445630302
Task_46101,612,421,157,180,337,1.4502369668246446,19.067727608134064
Task_46102,2530,661,110,144,254,3.821752265861027,49.83476599902129
Task_46103,2388,782,196,28,224,3.049808429118774,46.95931753164226
Task_46104,2285,182,86,150,236,12.486338797814208,44.15371802626572
Task_46105,967,263,62,162,224,3.662878787878788,23.838893449931263
Task_46106,1370,131,151,25,176,10.378787878787879,27.949355524881184
Task_46107,511,199,187,21,208,2.555,15.250174127649048
Task_46108,1449,949,61,143,204,1.5252631578947369,33.47103786367617
Task_46109,2484,257,129,43,172,9.627906976744185,46.480442118485854
Task_46110,2411,759,148,84,232,3.1723684210526315,47.77789158805779
Task_46111,1593,822,179,178,357,1.9356014580801943,36.010258163583295
Task_46112,1507,739,187,112,299,2.0364864864864867,34.03105121199861
Task_46113,2620,863,105,14,119,3.0324074074074074,49.889588092943114
Task_46114,2593,501,102,76,178,5.165338645418327,49.318937306726276
Task_46115,1832,363,16,117,133,5.032967032967033,36.96362493158437
Task_46116,2756,523,127,52,179,5.259541984732825,51.90349026439779
Task_46117,1639,956,40,87,127,1.7126436781609196,35.62731791833435
Task_46118,2220,494,53,18,71,4.484848484848484,41.52157077030957
Task_46119,2910,794,163,176,339,3.660377358490566,56.70420231679757
Task_46120,2563,158,167,163,330,16.11949685534591,48.71248189677279
Task_46121,951,119,166,82,248,7.925,22.312510114083864
Task_46122,980,807,170,165,335,1.2128712871287128,26.01023353617477
Task_46123,920,428,121,180,301,2.1445221445221447,23.870138333153808
Task_46124,1552,621,75,88,163,2.495176848874598,33.48486768880162
Task_46125,1637,329,59,80,139,4.960606060606061,33.69979099580194
Task_46126,1196,545,115,105,220,2.1904761904761907,28.132350884047295
Task_46127,539,504,130,61,191,1.0673267326732674,16.80914088684796
Task_46128,2831,364,183,143,326,7.756164383561644,53.95715404930839
Task_46129,2334,126,126,74,200,18.37795275590551,43.764065119823236
Task_46130,1491,417,120,88,208,3.5669856459330145,32.065582858738075
Task_46131,1717,604,86,66,152,2.83801652892562,35.41935578394804
Task_46132,599,585,25,19,44,1.022184300341297,16.171206433333243
Task_46133,1874,567,151,103,254,3.2992957746478875,39.08782063474714
Task_46134,2860,684,36,173,209,4.175182481751825,54.98325384522397
Task_46135,2432,719,81,39,120,3.3777777777777778,46.57820947529882
Task_46136,737,652,167,165,332,1.1286370597243491,21.63088491827465
Task_46137,841,452,186,101,287,1.8565121412803531,22.51641939849185
Task_46138,2863,606,47,37,84,4.716639209225701,52.78748672491026
Task_46139,2281,991,122,112,234,2.2993951612903225,46.78674748208465
Task_46140,2221,486,179,51,230,4.560574948665297,43.67242808942058
Task_46141,2460,355,143,200,343,6.910112359550562,48.21788368939169
Task_46142,2423,566,51,36,87,4.27336860670194,45.62953348351414
Task_46143,2953,296,29,104,133,9.942760942760943,54.52108619910491
Task_46144,1974,563,56,127,183,3.5,40.35016059565491
Task_46145,1977,918,130,12,142,2.1512513601741023,40.125718769881104
Task_46146,927,128,41,50,91,7.186046511627907,20.239540314899525
Task_46147,2876,430,171,98,269,6.672853828306264,54.571437193241195
Task_46148,1983,714,200,175,375,2.7734265734265735,41.92813086922222
Task_46149,2440,782,184,142,326,3.1162196679438057,49.11192924027112
Task_46150,1643,691,81,31,112,2.3742774566473988,33.97703625112434
Task_46151,2040,106,153,186,339,19.065420560747665,39.88203696126666
Task_46152,1290,876,169,170,339,1.4709236031927024,31.230536004830892
Task_46153,1039,677,178,119,297,1.5324483775811208,26.38305930183643
Task_46154,620,692,64,73,137,0.8946608946608947,18.611997687887904
Task_46155,1831,563,68,160,228,3.24645390070922,38.482841472130346
Task_46156,1709,476,102,192,294,3.5828092243186584,36.49688260292344
Task_46157,1419,208,102,161,263,6.7894736842105265,30.83681303433242
Task_46158,1116,276,101,175,276,4.028880866425993,26.362101265302908
Task_46159,865,285,128,80,208,3.0244755244755246,21.693067323750494
Task_46160,2349,835,39,88,127,2.8098086124401913,46.513383683177075
Task_46161,1119,890,119,109,228,1.2558922558922558,27.905396063023797
Task_46162,1687,177,67,52,119,9.47752808988764,33.03038003947598
Task_46163,1641,713,101,111,212,2.2983193277310923,35.678998289133226
Task_46164,1813,834,42,103,145,2.17125748502994,38.22045040989062
Task_46165,2059,404,188,70,258,5.083950617283951,41.01815138686813
Task_46166,2509,639,71,93,164,3.9203125,48.914379476331426
Task_46167,1512,479,178,173,351,3.15,33.61700787935544
Task_46168,650,911,49,134,183,0.7127192982456141,20.434831813525147
Task_46169,721,761,122,34,156,0.9461942257217848,20.041409119053323
Task_46170,565,234,14,183,197,2.404255319148936,17.216209028080556
Task_46171,2819,117,152,69,221,23.889830508474578,51.30305250254299
Task_46172,2933,408,135,58,193,7.1711491442542785,54.48377012758863
Task_46173,948,655,165,133,298,1.4451219512195121,24.87267822635502
Task_46174,738,371,83,199,282,1.9838709677419355,20.806181541319905
Task_46175,639,640,115,145,260,0.9968798751950078,19.74928089694789
Task_46176,2020,933,182,137,319,2.1627408993576016,42.89008846399523
Task_46177,1012,853,125,74,199,1.1850117096018735,25.662803090892435
Task_46178,985,722,197,139,336,1.3623789764868603,25.853994436562285
Task_46179,516,111,31,28,59,4.607142857142857,13.136448195468155
Task_46180,1901,154,60,81,141,12.264516129032257,36.76311491426625
Task_46181,2862,773,149,185,334,3.697674418604651,55.868275671688174
Task_46182,1090,228,32,124,156,4.759825327510917,24.905032917003528
Task_46183,2155,426,100,59,159,5.046838407494145,41.774815640288615
Task_46184,1668,619,155,96,251,2.6903225806451614,35.9894157091822
Task_46185,2711,562,73,21,94,4.815275310834814,50.356491733941205
Task_46186,726,423,139,157,296,1.7122641509433962,20.714511848132215
Task_46187,1384,258,198,126,324,5.343629343629344,30.681776478110976
Task_46188,2013,541,184,133,317,3.7140221402214024,41.53417718781946
Task_46189,888,401,55,175,230,2.208955223880597,23.109824439186905
Task_46190,1268,143,27,152,179,8.805555555555555,27.307906955723592
Task_46191,1415,706,23,120,143,2.0014144271570014,31.577059238306727
Task_46192,1306,603,36,27,63,2.162251655629139,27.6542250263433
Task_46193,2587,638,90,67,157,4.048513302034428,49.38980395851664
Task_46194,2103,1018,95,110,205,2.0637880274779197,43.98641687308953
Task_46195,696,463,98,137,235,1.5,20.04535686427327
Task_46196,2628,333,47,148,195,7.868263473053892,50.10718700266418
Task_46197,2443,134,40,127,167,18.096296296296295,45.524138049786565
Task_46198,906,452,59,88,147,2.0,22.58168590608142
Task_46199,883,194,24,39,63,4.528205128205128,19.787138303040773
Task_46200,1842,239,34,13,47,7.675,34.68622493408205
Task_46201,2103,971,193,82,275,2.1635802469135803,43.761308943969276
Task_46202,1109,219,65,68,133,5.040909090909091,24.783847433924723
Task_46203,2220,568,130,40,170,3.9015817223198592,43.21364003227518
Task_46204,570,253,170,43,213,2.2440944881889764,16.484736726492017
Task_46205,1163,157,20,81,101,7.360759493670886,24.69173858400784
Task_46206,1006,368,169,145,314,2.7262872628726287,25.04793652898842
Task_46207,2341,115,143,52,195,20.18103448275862,43.66860139382427
Task_46208,1632,134,33,72,105,12.088888888888889,31.735638987395138
Task_46209,686,72,116,188,304,9.397260273972602,18.282096904158696
Task_46210,2775,810,32,17,49,3.4217016029593097,51.31911734147721
Task_46211,842,201,67,121,188,4.1683168316831685,21.391979513417443
Task_46212,859,947,175,113,288,0.9061181434599156,24.29315294879646
Task_46213,2168,426,69,72,141,5.07728337236534,42.23057905142677
Task_46214,816,933,42,151,193,0.8736616702355461,23.100398804810396
Task_46215,564,1018,97,43,140,0.5534838076545633,18.4794657510234
Task_46216,2803,813,137,104,241,3.4434889434889433,54.52149650079497
Task_46217,1122,978,133,89,222,1.146067415730337,28.019525309533176
Task_46218,2704,727,157,141,298,3.7142857142857144,52.99347223782261
Task_46219,2961,763,47,45,92,3.8756544502617802,54.899400722435466
Task_46220,1754,490,44,103,147,3.5723014256619146,36.17842799084271
Task_46221,715,724,110,125,235,0.9862068965517241,21.091845944424488
Task_46222,2160,579,104,56,160,3.7241379310344827,42.451785105918844
Task_46223,1027,407,167,94,261,2.517156862745098,25.135104406120423
Task_46224,634,238,104,70,174,2.6527196652719667,17.47744460572817
Task_46225,2076,418,162,52,214,4.954653937947494,41.1405330606147
Task_46226,2316,221,195,140,335,10.432432432432432,45.34206857377575
Task_46227,2108,141,76,126,202,14.845070422535212,40.90125999068608
Task_46228,1610,920,29,18,47,1.748099891422367,33.145647997534155
Task_46229,1722,494,48,62,110,3.478787878787879,34.9837872350253
Task_46230,1205,497,173,152,325,2.4196787148594376,28.66602556881618
Task_46231,1600,986,176,38,214,1.6210739614994933,35.14735897694088
Task_46232,1028,383,161,190,351,2.6770833333333335,25.676550615277918
Task_46233,2748,707,115,166,281,3.8813559322033897,53.58732243276783
Task_46234,2752,530,57,11,68,5.182674199623352,50.05382766734943
Task_46235,2346,869,100,98,198,2.696551724137931,47.25688653877513
Task_46236,2548,335,116,161,277,7.583333333333333,49.18706297270927
Task_46237,2680,683,199,165,364,3.91812865497076,52.806885179530035
Task_46238,2663,916,103,94,197,2.9040348964013085,52.357452015519776
Task_46239,753,406,67,171,238,1.8501228501228502,20.983110049931216
Task_46240,1012,752,134,87,221,1.343957503320053,25.5510829478827
Task_46241,2165,725,27,114,141,2.982093663911846,43.4314623660232
Task_46242,2509,576,52,122,174,4.348353552859619,48.94360050974293
Task_46243,1913,506,86,34,120,3.7731755424063116,37.76056228016683
Task_46244,957,527,113,105,218,1.8125,24.282727437356233
Task_46245,2424,557,195,56,251,4.344086021505376,47.2568359784855
Task_46246,1439,884,62,125,187,1.6259887005649718,32.996303940368726
Task_46247,2268,379,20,144,164,5.968421052631579,44.240789861693294
Task_46248,2337,532,34,186,220,4.384615384615385,46.30384957265583
Task_46249,579,171,172,62,234,3.366279069767442,16.503301157541674
Task_46250,1238,476,159,48,207,2.5953878406708597,27.74896836909169
Task_46251,2110,797,66,28,94,2.644110275689223,41.55280858004581
Task_46252,2296,606,145,92,237,3.782537067545305,45.70078972432926
Task_46253,818,589,136,182,318,1.3864406779661016,22.7703954605368
Task_46254,1735,491,171,86,257,3.5264227642276422,36.37010533147811
Task_46255,1439,490,139,126,265,2.930753564154786,32.03980224318715
Task_46256,626,603,52,90,142,1.0364238410596027,18.441607901586952
Task_46257,521,582,85,84,169,0.8936535162950258,16.77348503491378
Task_46258,2244,1014,188,185,373,2.210837438423645,47.005447037563904
Task_46259,1465,600,193,12,205,2.437603993344426,31.575016428487277
Task_46260,2717,130,148,146,294,20.740458015267176,50.683191676269495
Task_46261,1779,631,89,15,104,2.814873417721519,35.71238656557746
Task_46262,1060,142,176,179,355,7.4125874125874125,25.06658440768598
Task_46263,2803,67,26,99,125,41.220588235294116,50.00802442322967
Task_46264,2603,734,59,12,71,3.5414965986394558,48.38219480664313
Task_46265,2457,620,14,162,176,3.9565217391304346,48.113261166802346
Task_46266,1170,207,74,170,244,5.625,26.96161851519113
Task_46267,2628,707,52,145,197,3.711864406779661,51.446879469362024
Task_46268,2502,608,58,42,100,4.108374384236453,47.11025338739315
Task_46269,2206,745,107,178,285,2.9571045576407506,45.156737294346634
Task_46270,1720,335,147,44,191,5.119047619047619,34.82499016509784
Task_46271,1848,120,192,175,367,15.272727272727273,37.32578991995557
Task_46272,1362,641,87,84,171,2.121495327102804,30.311635696334807
Task_46273,2596,396,59,93,152,6.53904282115869,49.262802756818786
Task_46274,891,243,183,145,328,3.651639344262295,22.887818207993462
Task_46275,2039,820,101,159,260,2.4835566382460414,42.605238891365694
Task_46276,1334,286,166,174,340,4.648083623693379,30.128177255617498
Task_46277,1780,210,62,112,174,8.436018957345972,36.133202272579254
Task_46278,2226,1013,157,84,241,2.195266272189349,45.680386444896534
Task_46279,739,259,155,169,324,2.8423076923076924,20.555779621093894
Task_46280,2239,974,187,119,306,2.2964102564102564,46.40304576366744
Task_46281,2822,66,168,20,188,42.11940298507463,50.01911537418752
Task_46282,2572,356,91,123,214,7.204481792717087,49.34792918771839
Task_46283,2330,614,52,157,209,3.7886178861788617,46.504225146916774
Task_46284,2862,802,56,164,220,3.564134495641345,55.57365351761595
Task_46285,1146,348,155,137,292,3.2836676217765044,27.08755761936428
Task_46286,1146,346,62,85,147,3.3025936599423633,26.020944135531703
Task_46287,554,538,160,30,190,1.0278293135435992,17.02176104148765
Task_46288,1717,114,189,181,370,14.930434782608696,35.15038587146366
Task_46289,2733,799,172,77,249,3.41625,53.00632875634022
Task_46290,2941,280,115,89,204,10.466192170818506,54.584534750927844
Task_46291,2497,227,45,25,70,10.951754385964913,45.21331581590038
Task_46292,1082,246,96,165,261,4.380566801619433,25.695553009433862
Task_46293,969,87,113,43,156,11.011363636363637,20.84499885486797
Task_46294,913,240,93,47,140,3.788381742738589,21.40531490013933
Task_46295,2498,469,68,56,124,5.314893617021276,47.34284114263466
Task_46296,1922,717,42,90,132,2.6768802228412256,39.47005780706934
Task_46297,1345,320,170,110,280,4.190031152647975,30.050202816813638
Task_46298,2742,121,56,106,162,22.475409836065573,50.09360884996233
Task_46299,829,936,135,36,171,0.8847385272145144,22.37071723048655
Task_46300,1060,115,128,62,190,9.137931034482758,23.497277990629545
Task_46301,1871,417,168,55,223,4.476076555023924,37.92442031667947
Task_46302,1552,232,148,97,245,6.660944206008583,32.881056654381496
Task_46303,654,775,85,145,230,0.8427835051546392,20.281525705427658
Task_46304,666,1019,102,25,127,0.6529411764705882,19.961474811548957
Task_46305,897,449,150,126,276,1.9933333333333334,23.38042388695656
Task_46306,1386,171,120,58,178,8.05813953488372,28.71765406562574
Task_46307,566,612,151,21,172,0.9233278955954323,17.290358321962163
Task_46308,1444,808,58,28,86,1.784919653893696,30.848741077400234
Task_46309,2745,940,112,168,280,2.917109458023379,54.26991647039389
Task_46310,1866,450,172,178,350,4.137472283813747,39.130516814619256
Task_46311,1216,542,97,114,211,2.2394106813996317,28.435924291424033
Task_46312,2074,428,30,47,77,4.834498834498834,39.2761569689544
Task_46313,2795,618,106,17,123,4.51534733441034,51.93423831627018
Task_46314,2779,393,83,174,257,7.053299492385787,53.02061929601345
Task_46315,843,149,27,115,142,5.62,20.125531429228545
Task_46316,1305,128,59,52,111,10.116279069767442,26.487414147876805
Task_46317,2457,348,48,171,219,7.040114613180516,47.66865506563574
Task_46318,554,122,143,171,314,4.504065040650406,16.72904061839409
Task_46319,729,538,76,176,252,1.3525046382189239,21.05439405570291
Task_46320,2759,973,73,59,132,2.8326488706365502,53.17126252535528
Task_46321,680,647,124,147,271,1.0493827160493827,20.442122566870115
Task_46322,2361,288,90,80,170,8.16955017301038,45.043280896446596
Task_46323,2862,298,128,95,223,9.57190635451505,53.65460705596976
Task_46324,1299,656,22,134,156,1.9771689497716896,29.520434115597656
Task_46325,2411,527,100,10,110,4.566287878787879,45.522245744871725
Task_46326,2282,449,183,73,256,5.071111111111111,44.7272062357895
Task_46327,841,1016,18,25,43,0.8269419862340216,21.598286385983602
Task_46328,1083,521,22,197,219,2.074712643678161,26.367680606491078
Task_46329,642,841,26,182,208,0.7624703087885986,20.22525062749884
Task_46330,2820,132,99,134,233,21.203007518796994,52.02509296708096
Task_46331,1330,546,13,12,25,2.4314442413162705,27.48558984264029
Task_46332,1628,283,87,82,169,5.732394366197183,33.39559061716307
Task_46333,2509,173,51,174,225,14.419540229885058,47.55167078973176
Task_46334,1172,570,159,10,169,2.052539404553415,26.462306105544712
Task_46335,2052,85,140,22,162,23.86046511627907,37.913821182963225
Task_46336,1971,370,87,71,158,5.3126684636118595,38.78219540480483
Task_46337,1034,808,170,105,275,1.2781211372064276,26.541609282344723
Task_46338,1013,621,152,155,307,1.6286173633440515,25.924026235353917
Task_46339,1157,907,25,122,147,1.274229074889868,27.94789792224981
Task_46340,1833,362,13,167,180,5.049586776859504,37.417563767924314
Task_46341,2981,688,70,95,165,4.32656023222061,56.65637555347083
Task_46342,1764,83,40,181,221,21.0,34.91509227649366
Task_46343,1466,171,110,185,295,8.523255813953488,31.27168286921236
Task_46344,2292,341,67,62,129,6.701754385964913,43.8099206047335
Task_46345,1942,726,129,95,224,2.671251719394773,40.49029688138963
Task_46346,1061,156,141,112,253,6.75796178343949,24.60430880455884
Task_46347,1891,897,72,137,209,2.1057906458797326,40.365174996053184
Task_46348,2406,384,66,67,133,6.249350649350649,45.84673716747529
Task_46349,2096,991,160,90,250,2.1129032258064515,43.73013556831129
Task_46350,2394,259,85,132,217,9.207692307692307,46.2192713647541
Task_46351,2056,952,23,141,164,2.157397691500525,42.81142919977045
Task_46352,1811,131,30,27,57,13.719696969696969,33.88131796847832
Task_46353,1770,222,148,98,246,7.937219730941704,36.26395145393182
Task_46354,1150,292,14,24,38,3.9249146757679183,24.023773405386194
Task_46355,2420,659,43,181,224,3.6666666666666665,48.01881793141478
Task_46356,699,134,199,150,349,5.177777777777778,19.18246142174879
Task_46357,2248,188,12,85,97,11.894179894179894,42.40362072481589
Task_46358,1023,814,193,117,310,1.2552147239263804,26.530154305022595
Task_46359,915,823,28,74,102,1.1104368932038835,23.24194043500883
Task_46360,2211,980,163,14,177,2.253822629969419,44.23192384993403
Task_46361,950,704,42,112,154,1.3475177304964538,24.00878053888933
Task_46362,1514,619,165,24,189,2.4419354838709677,32.38181563494317
Task_46363,919,683,11,60,71,1.3435672514619883,22.038266046514575
Task_46364,1169,533,52,141,193,2.189138576779026,27.76805205016841
Task_46365,1927,523,114,128,242,3.677480916030534,39.769836800029935
Task_46366,1007,458,147,163,310,2.1938997821350763,25.357328422563313
Task_46367,1540,836,133,185,318,1.8399044205495818,35.04857969619152
Task_46368,1668,192,148,47,195,8.642487046632125,33.64844530152255
Task_46369,2799,605,13,136,149,4.618811881188119,53.182495041404025
Task_46370,1118,893,93,104,197,1.250559284116331,27.85571282560197
Task_46371,2571,887,19,33,52,2.89527027027027,48.654163803185774
Task_46372,2435,115,149,182,331,20.99137931034483,46.2918646002641
Task_46373,1070,516,110,195,305,2.0696324951644103,26.56138816887101
Task_46374,1814,194,124,173,297,9.302564102564103,37.11885622539378
Task_46375,2584,891,21,23,44,2.896860986547085,48.64643896935061
Task_46376,2508,821,54,131,185,3.051094890510949,49.68910992291243
Task_46377,1481,603,102,103,205,2.4519867549668874,32.75696096312225
Task_46378,515,178,147,181,328,2.877094972067039,16.399792672977853
Task_46379,2502,424,60,84,144,5.8870588235294115,47.68820821330733
Task_46380,1134,609,157,44,201,1.859016393442623,26.468472777915593
Task_46381,2284,615,132,117,249,3.707792207792208,45.73073373267127
Task_46382,2161,571,84,13,97,3.777972027972028,41.552622825000626
Task_46383,639,754,137,26,163,0.8463576158940397,18.77795772326758
Task_46384,1919,482,159,104,263,3.9730848861283645,39.57165453280714
Task_46385,2126,943,129,86,215,2.2521186440677967,43.79331176682924
Task_46386,929,952,23,200,223,0.974816369359916,25.2467621682796
Task_46387,1520,1024,46,120,166,1.4829268292682927,34.35613098535725
Task_46388,2629,984,66,149,215,2.669035532994924,52.37089289745247
Task_46389,2948,838,193,102,295,3.5137067938021453,57.137828574976425
Task_46390,634,261,59,84,143,2.4198473282442747,17.62542870048963
Task_46391,2015,214,106,174,280,9.372093023255815,40.36449253604593
Task_46392,730,672,29,128,157,1.0846953937592867,20.381977779722593
Task_46393,542,679,153,42,195,0.7970588235294118,17.355032563588004
Task_46394,1984,973,25,183,208,2.0369609856262834,42.05974624782647
Task_46395,2064,704,63,96,159,2.927659574468085,41.93571622158449
Task_46396,992,984,100,195,295,1.0071065989847716,26.588428777712526
Task_46397,700,316,166,172,338,2.2082018927444795,20.189911552416827
Task_46398,1194,482,41,86,127,2.472049689440994,27.098660990155278
Task_46399,1025,166,45,161,206,6.137724550898204,23.925370433065016
Task_46400,2774,608,82,176,258,4.555008210180624,53.68809446752513
Task_46401,2594,653,152,31,183,3.9663608562691133,49.48878427616906
Task_46402,658,799,134,176,310,0.8225,20.826319584496005
Task_46403,1939,241,170,167,337,8.012396694214877,39.5100078755764
Task_46404,836,865,31,58,89,0.9653579676674365,21.78319255229293
Task_46405,2307,779,98,100,198,2.957692307692308,46.370890185415305
Task_46406,1175,549,32,61,93,2.1363636363636362,26.24940700501475
Task_46407,2257,485,120,140,260,4.6440329218107,44.97118523625388
Task_46408,2283,194,26,32,58,11.707692307692307,41.92952443127939
Task_46409,685,659,141,125,266,1.0378787878787878,20.503737653168596
Task_46410,1425,933,21,95,116,1.525695931477516,32.07259348812341
Task_46411,776,604,19,82,101,1.2826446280991735,20.437655759979137
Task_46412,949,373,33,168,201,2.537433155080214,23.734374793808183
Task_46413,895,521,126,154,280,1.71455938697318,23.620165943008697
Task_46414,1697,183,75,133,208,9.222826086956522,34.84261728053361
Task_46415,1877,961,73,15,88,1.9511434511434511,38.223694302760435
Task_46416,1887,278,62,72,134,6.763440860215054,37.32207138013258
Task_46417,2376,547,27,95,122,4.335766423357664,46.13069788479921
Task_46418,2566,525,136,168,304,4.8783269961977185,50.23146645007571
Task_46419,1781,239,195,17,212,7.420833333333333,35.341391955699244
Task_46420,2242,703,71,131,202,3.184659090909091,45.27904282374362
Task_46421,1576,686,131,188,319,2.2940320232896654,35.16007920857381
Task_46422,517,263,164,147,311,1.9583333333333333,16.96962205695505
Task_46423,2926,786,128,91,219,3.717916137229987,56.12092304415256
Task_46424,1152,605,82,179,261,1.900990099009901,28.00915673390752
Task_46425,1136,591,108,84,192,1.9189189189189189,26.873669982434667
Task_46426,1201,223,196,73,269,5.361607142857143,26.93851955603724
Task_46427,1198,224,72,126,198,5.3244444444444445,27.1861281898847
Task_46428,2519,146,143,149,292,17.13605442176871,47.69209481521478
Task_46429,2950,64,162,121,283,45.38461538461539,53.47982418924993
Task_46430,2343,769,142,152,294,3.0428571428571427,47.404847604304244
Task_46431,2096,681,119,176,295,3.0733137829912023,43.25531380848768
Task_46432,704,827,105,11,116,0.8502415458937198,19.52024974841282
Task_46433,1718,624,79,13,92,2.7488,34.783294190786684
Task_46434,1987,227,42,197,239,8.714912280701755,39.83322825346571
Task_46435,561,680,139,53,192,0.8237885462555066,17.904438249845075
Task_46436,571,405,41,67,108,1.4064039408866995,16.416012275225224
Task_46437,1974,224,76,112,188,8.773333333333333,39.34965635250702
Task_46438,1568,387,137,127,264,4.041237113402062,33.74880498443438
Task_46439,559,152,62,44,106,3.65359477124183,14.369758326844087
Task_46440,1899,330,66,62,128,5.737160120845921,37.627356842578486
Task_46441,2661,501,35,54,89,5.300796812749004,49.522348879029344
Task_46442,2029,840,37,61,98,2.412604042806183,40.66704722377096
Task_46443,1675,208,55,184,239,8.014354066985646,34.96262082584366
Task_46444,2065,349,87,30,117,5.9,39.65163530575024
Task_46445,2237,392,54,138,192,5.692111959287532,44.201105034341936
Task_46446,2458,557,63,184,247,4.405017921146953,48.51869202799079
Task_46447,1254,1018,192,184,376,1.2306182531894014,31.217911986910494
Task_46448,2072,697,104,74,178,2.968481375358166,41.693390243113406
Task_46449,932,844,125,21,146,1.1029585798816568,23.410057605822075
Task_46450,1965,456,130,100,230,4.299781181619256,40.061640305785886
Task_46451,1872,401,171,28,199,4.656716417910448,37.46441016192776
Task_46452,2267,930,184,152,336,2.435016111707841,46.89328868052388
Task_46453,577,158,156,179,335,3.6289308176100628,17.451664282180907
Task_46454,1773,820,119,192,311,2.1595615103532277,38.66907767075679
Task_46455,2700,244,158,91,249,11.020408163265307,50.88928906192937
Task_46456,2862,355,115,76,191,8.039325842696629,53.34669767934287
Task_46457,1179,461,39,112,151,2.551948051948052,26.978322279131145
Task_46458,746,272,125,157,282,2.7326007326007327,20.50163936690994
Task_46459,1998,776,118,91,209,2.5714285714285716,41.34249628756542
Task_46460,581,189,90,87,177,3.057894736842105,16.761148884724026
Task_46461,2113,350,52,182,234,6.01994301994302,42.36428202974809
Task_46462,1336,118,69,59,128,11.22689075630252,27.372441018749555
Task_46463,1816,535,133,159,292,3.388059701492537,38.3213272728802
Task_46464,1576,625,95,102,197,2.5175718849840254,34.36316218506493
Task_46465,2139,235,192,61,253,9.063559322033898,41.584708965105975
Task_46466,1629,349,100,132,232,4.654285714285714,34.45301880298246
Task_46467,2172,608,191,87,278,3.5665024630541873,43.7673193264315
Task_46468,1893,452,110,183,293,4.178807947019868,39.31473841360869
Task_46469,1124,972,120,62,182,1.1551901336073997,27.39723629452192
Task_46470,544,750,152,102,254,0.7243675099866844,18.624842390646823
Task_46471,730,460,83,167,250,1.5835140997830803,20.72396793212589
Task_46472,653,326,122,121,243,1.996941896024465,18.975509625611583
Task_46473,2640,386,157,47,204,6.821705426356589,49.62175791288607
Task_46474,1817,253,51,100,151,7.153543307086614,36.550125130062106
Task_46475,2790,415,44,13,57,6.706730769230769,50.373803944206436
Task_46476,2243,436,49,103,152,5.132723112128146,43.859974284168665
Task_46477,2834,234,65,32,97,12.059574468085106,51.11526245924198
Task_46478,1313,401,167,137,304,3.2661691542288556,29.953998871376545
Task_46479,2602,89,29,125,154,28.91111111111111,47.20158077201606
Task_46480,2660,433,38,44,82,6.129032258064516,48.95748064960471
Task_46481,2265,198,155,17,172,11.381909547738694,42.60508424897447
Task_46482,839,400,18,30,48,2.092269326683292,19.54799754095488
Task_46483,791,91,193,34,227,8.597826086956522,18.833426774153708
Task_46484,1304,492,115,150,265,2.6450304259634887,29.944158998371915
Task_46485,1061,413,89,89,178,2.5628019323671496,25.032093290500583
Task_46486,2973,665,145,85,230,4.463963963963964,56.394728338641045
Task_46487,1455,314,100,73,173,4.619047619047619,30.73331307316542
Task_46488,879,404,167,169,336,2.1703703703703705,23.287169747811642
Task_46489,1626,933,156,82,238,1.740899357601713,35.90844007801857
Task_46490,2590,605,103,71,174,4.273927392739274,49.61838256460472
Task_46491,1167,970,10,138,148,1.2018537590113285,28.320843102586196
Task_46492,1688,787,75,118,193,2.1421319796954315,36.71527562452344
Task_46493,1746,986,50,156,206,1.7689969604863223,38.40749233712918
Task_46494,2095,578,164,82,246,3.618307426597582,42.272152456992906
Task_46495,993,545,56,107,163,1.8186813186813187,24.649672214502186
Task_46496,2963,229,63,124,187,12.882608695652173,54.99148981208025
Task_46497,2279,171,54,188,242,13.25,43.9965912451741
Task_46498,1064,193,97,102,199,5.484536082474227,24.83408447365329
Task_46499,1227,523,185,175,360,2.3416030534351147,29.28766009493666
Task_46500,2561,333,189,34,223,7.667664670658683,48.2856057493238
Task_46501,2362,516,50,121,171,4.568665377176015,46.29556038695004
Task_46502,2266,893,100,100,200,2.534675615212528,46.07287798562945
Task_46503,2447,984,70,172,242,2.484263959390863,49.65996938590542
Task_46504,2626,814,96,86,182,3.222085889570552,51.025461398190565
Task_46505,1243,594,30,98,128,2.089075630252101,28.57104917000541
Task_46506,2302,545,35,115,150,4.216117216117216,45.03674869129119
Task_46507,2630,336,30,104,134,7.804154302670623,49.51253159661048
Task_46508,2567,747,200,149,349,3.4318181818181817,51.12781601646318
Task_46509,2207,965,31,166,197,2.2846790890269153,45.48079204619997
Task_46510,1314,413,77,43,120,3.1739130434782608,27.99091995661618
Task_46511,1398,647,178,33,211,2.1574074074074074,30.834093533880672
Task_46512,1939,594,200,92,292,3.2588235294117647,40.257009117508126
Task_46513,2691,322,146,199,345,8.3312693498452,51.765867531452294
Task_46514,2507,395,50,144,194,6.33080808080808,48.53140781902889
Task_46515,1150,955,177,20,197,1.202928870292887,27.642650688615806
Task_46516,2092,462,48,146,194,4.518358531317495,42.11972239606184
Task_46517,1071,1009,141,175,316,1.0603960396039604,27.99277585820006
Task_46518,947,600,144,153,297,1.5757071547420964,24.73603533520277
Task_46519,1131,186,73,61,134,6.048128342245989,25.205390944538834
Task_46520,1671,839,133,25,158,1.9892857142857143,35.1736702516368
Task_46521,1721,415,68,182,250,4.137019230769231,36.40015604668149
Task_46522,2355,190,105,12,117,12.329842931937172,43.66163264900916
Task_46523,1717,345,188,97,285,4.96242774566474,36.052963123559465
Task_46524,2319,278,31,104,135,8.311827956989248,44.39250654717836
Task_46525,1281,173,101,151,252,7.362068965517241,28.09909292712361
Task_46526,1366,595,159,143,302,2.291946308724832,31.406479855523425
Task_46527,2467,572,107,51,158,4.305410122164049,47.22949526209076
Task_46528,2195,345,13,59,72,6.34393063583815,41.22148411500914
Task_46529,2795,653,139,26,165,4.273700305810397,52.665004987617635
Task_46530,2507,308,138,78,216,8.11326860841424,47.750934753481936
Task_46531,1190,737,128,115,243,1.6124661246612466,28.741653296454388
Task_46532,1116,647,22,146,168,1.7222222222222223,26.78159491995969
Task_46533,624,708,118,161,279,0.8801128349788434,19.852925973732663
Task_46534,798,566,101,118,219,1.4074074074074074,21.842057827970237
Task_46535,2619,960,84,83,167,2.72528616024974,51.276349364678644
Task_46536,2474,479,109,80,189,5.154166666666667,47.66174954533392
Task_46537,2786,529,133,89,222,5.256603773584906,53.05473784554059
Task_46538,2803,505,15,130,145,5.5395256916996045,52.93270425452284
Task_46539,1404,181,74,19,93,7.714285714285714,28.160583629796943
Task_46540,727,859,193,78,271,0.8453488372093023,21.57091167289561
Task_46541,1154,429,155,132,287,2.683720930232558,27.44315097598592
Task_46542,2478,325,119,155,274,7.601226993865031,48.023316258283046
Task_46543,542,529,77,110,187,1.0226415094339623,17.500444327628465
Task_46544,2098,418,176,169,345,5.007159904534606,42.6628448504125
Task_46545,1157,307,53,117,170,3.7564935064935066,26.530936028247282
Task_46546,2655,633,18,49,67,4.187697160883281,49.22022798584441
Task_46547,2454,611,78,78,156,4.009803921568627,47.50224086533808
Task_46548,2297,888,127,114,241,2.5838020247469067,46.7537855992216
Task_46549,1384,554,91,136,227,2.4936936936936935,31.263709343254988
Task_46550,1563,985,153,92,245,1.5851926977687627,35.2668990326172
Task_46551,1293,1013,75,163,238,1.2751479289940828,31.32713276348389
Task_46552,1399,594,62,121,183,2.3512605042016808,31.303006243237235
Task_46553,2280,97,109,140,249,23.26530612244898,43.058953868015315
Task_46554,2625,987,136,162,298,2.6568825910931175,52.58735813154001
Task_46555,1250,611,173,80,253,2.042483660130719,29.02110498729998
Task_46556,2197,722,43,110,153,3.0387275242047025,43.91188135573603
Task_46557,1828,381,172,151,323,4.785340314136126,38.14405610349678
Task_46558,2014,181,78,152,230,11.065934065934066,39.7252877194628
Task_46559,1886,866,48,116,164,2.1753171856978084,39.8368587449315
Task_46560,2131,229,53,185,238,9.265217391304347,42.249015030875114
Task_46561,2366,1021,142,27,169,2.315068493150685,46.888692496427126
Task_46562,2192,458,75,130,205,4.775599128540305,43.72850806959972
Task_46563,2805,1010,102,96,198,2.7744807121661723,54.987682720252955
Task_46564,2670,804,109,176,285,3.3167701863354035,52.68991964116583
Task_46565,1463,557,155,63,218,2.621863799283154,31.86612599537051
Task_46566,884,1011,41,157,198,0.8735177865612648,24.434101300089846
Task_46567,1156,576,74,115,189,2.003466204506066,27.576015812293445
Task_46568,1199,528,182,141,323,2.2665406427221173,28.643459445754633
Task_46569,1033,492,28,127,155,2.0953346855983774,24.85144141344033
Task_46570,1226,175,42,35,77,6.965909090909091,25.02429040280259
Task_46571,1799,253,15,23,38,7.082677165354331,34.145202591588735
Task_46572,1800,587,139,25,164,3.061224489795918,36.643083510640096
Task_46573,2538,508,75,171,246,4.986247544204322,49.612373963966405
Task_46574,2571,168,117,90,207,15.21301775147929,48.12243769036167
Task_46575,1131,692,172,87,259,1.632034632034632,27.447979379484124
Task_46576,2489,618,87,173,260,4.021001615508886,49.127088726560686
Task_46577,2514,321,10,183,193,7.807453416149069,48.25680719792478
Task_46578,2633,963,185,61,246,2.7313278008298756,51.72798274979869
Task_46579,1883,778,159,97,256,2.417201540436457,39.92721453188308
Task_46580,2793,454,198,98,296,6.138461538461539,53.45874206618868
Task_46581,1273,560,95,111,206,2.269162210338681,29.414506792284186
Task_46582,504,217,54,175,229,2.311926605504587,16.446939026842507
Task_46583,2402,527,13,172,185,4.549242424242424,47.040480910771265
Task_46584,1730,154,184,54,238,11.161290322580646,34.62089246840042
Task_46585,1472,131,130,50,180,11.151515151515152,29.583736181110407
Task_46586,1205,836,85,188,273,1.4396654719235364,29.51994301338536
Task_46587,2734,426,46,198,244,6.402810304449648,52.37579991798324
Task_46588,2568,786,68,73,141,3.263024142312579,49.72806819758852
Task_46589,1944,995,35,143,178,1.9518072289156627,41.10313559800258
Task_46590,1279,201,28,17,45,6.3316831683168315,25.5877634015478
Task_46591,997,795,29,164,193,1.2525125628140703,25.57509831845059
Task_46592,1942,607,79,95,174,3.1940789473684212,39.97845717109889
Task_46593,959,550,176,36,212,1.7404718693284937,23.57219679879242
Task_46594,1155,669,197,101,298,1.7238805970149254,28.202938709511226
Task_46595,2381,566,71,139,210,4.199294532627866,47.09444252769136
Task_46596,2178,604,93,112,205,3.6,43.92346420619358
Task_46597,1829,624,19,55,74,2.9264,36.351150335028386
Task_46598,1218,408,68,152,220,2.97799511002445,28.2387129133804
Task_46599,1764,79,137,152,289,22.05,35.10204453513639
Task_46600,1942,829,161,55,216,2.3397590361445784,40.319841633663906
Task_46601,2499,895,91,110,201,2.7890625,49.83947571245097
Task_46602,2350,300,191,82,273,7.807308970099668,45.51792571559846
Task_46603,2267,853,40,51,91,2.6545667447306793,44.41918436369162
Task_46604,1530,247,126,199,325,6.169354838709677,33.06242843968281
Task_46605,2055,617,93,114,207,3.325242718446602,42.028595710259616
Task_46606,2889,422,10,160,170,6.829787234042553,54.20941615064899
Task_46607,750,1003,18,112,130,0.7470119521912351,21.705648414241832
Task_46608,2923,698,57,128,185,4.1816881258941345,55.87125652128245
Task_46609,800,282,29,16,45,2.8268551236749118,18.36378801616959
Task_46610,2730,505,192,33,225,5.395256916996048,51.53871511342433
Task_46611,2571,722,197,185,382,3.5560165975103732,51.31393136740049
Task_46612,941,153,188,55,243,6.1103896103896105,22.20059859835635
Task_46613,1805,1024,168,135,303,1.7609756097560976,39.67731141004952
Task_46614,1556,754,170,28,198,2.060927152317881,33.573764606045465
Task_46615,1595,156,126,39,165,10.159235668789808,31.744212487384768
Task_46616,596,262,28,21,49,2.2661596958174903,15.253823969263424
Task_46617,600,806,149,60,209,0.7434944237918215,18.80955108516054
Task_46618,1912,805,52,66,118,2.372208436724566,39.22298355021889
Task_46619,2793,643,44,200,244,4.336956521739131,53.993865052263665
Task_46620,1997,585,43,89,132,3.407849829351536,40.230040979116545
Task_46621,915,517,28,73,101,1.7664092664092663,22.32781045325105
Task_46622,1580,863,186,125,311,1.8287037037037037,35.6468002638715
Task_46623,917,355,180,144,324,2.5758426966292136,23.642142611285408
Task_46624,2896,240,128,155,283,12.016597510373444,54.36358877268011
Task_46625,631,755,196,29,225,0.8346560846560847,19.127395125439765
Task_46626,1006,419,84,40,124,2.395238095238095,23.144320578456895
Task_46627,2576,449,43,133,176,5.724444444444444,49.37228068961026
Task_46628,2730,598,115,34,149,4.557595993322204,51.24351654199936
Task_46629,843,947,48,98,146,0.8892405063291139,23.14538807301449
Task_46630,2742,964,43,196,239,2.8414507772020725,54.167224946341285
Task_46631,2711,209,19,40,59,12.90952380952381,48.55949403517574
Task_46632,752,966,44,123,167,0.7776628748707343,21.861893221515214
Task_46633,2222,351,175,123,298,6.3125,44.123959105491416
Task_46634,1101,441,128,160,288,2.490950226244344,26.68791655983165
Task_46635,2795,691,188,29,217,4.039017341040463,53.135110477509805
Task_46636,2111,630,162,167,329,3.345483359746434,43.47217027872889
Task_46637,1529,229,88,108,196,6.647826086956521,32.28848616466575
Task_46638,1539,715,36,138,174,2.149441340782123,33.88501208033593
Task_46639,1747,255,171,37,208,6.82421875,35.089984609429386
Task_46640,1943,329,159,180,339,5.887878787878788,39.905617520506716
Task_46641,2527,86,101,83,184,29.04597701149425,46.1657974516204
Task_46642,2952,945,97,174,271,3.120507399577167,57.55760211138287
Task_46643,1895,949,41,144,185,1.9947368421052631,40.24789175267175
Task_46644,1375,600,136,170,306,2.2878535773710484,31.62229393806544
Task_46645,1610,494,11,160,171,3.2525252525252526,34.19314559771714
Task_46646,2385,825,171,28,199,2.887409200968523,46.93385308933474
Task_46647,972,493,196,42,238,1.9676113360323886,23.715239088252
Task_46648,2989,566,38,22,60,5.271604938271605,54.11519154824712
Task_46649,2383,271,91,54,145,8.761029411764707,44.9990234562525
Task_46650,2855,587,163,117,280,4.855442176870748,54.82391440535455
Task_46651,2482,848,191,52,243,2.923439340400471,49.065940502305295
Task_46652,2131,920,161,158,319,2.3137893593919654,44.6392812323435
Task_46653,2044,366,177,29,206,5.569482288828338,40.1489783835161
Task_46654,1281,958,98,169,267,1.3357664233576643,31.043413641324353
Task_46655,2921,982,34,66,100,2.9715157680569684,55.437813822303106
Task_46656,1632,771,165,27,192,2.1139896373056994,34.78388852384119
Task_46657,1291,276,62,161,223,4.6606498194945845,28.996729879478796
Task_46658,2223,807,83,35,118,2.751237623762376,43.56676770936658
Task_46659,674,69,176,84,260,9.628571428571428,17.55498583656963
Task_46660,1318,420,147,43,190,3.130641330166271,28.73479101923604
Task_46661,593,470,83,192,275,1.2590233545647558,18.660668709486618
Task_46662,1918,890,139,25,164,2.1526374859708195,39.46105227238048
Task_46663,2621,614,86,85,171,4.261788617886179,50.22005124116375
Task_46664,2381,970,129,17,146,2.45211122554068,46.657456632541276
Task_46665,2044,967,72,48,120,2.1115702479338845,41.32347807267301
Task_46666,839,352,194,41,235,2.376770538243626,21.15642850877918
Task_46667,699,261,200,46,246,2.66793893129771,18.693417569377026
Task_46668,2968,169,113,190,303,17.458823529411763,55.07400696594917
Task_46669,2185,644,124,24,148,3.387596899224806,42.671011767817106
Task_46670,1719,826,28,132,160,2.0785973397823456,36.78787670810802
Task_46671,2015,232,32,159,191,8.648068669527897,40.047749135193094
Task_46672,2607,131,83,78,161,19.75,47.6809890381885
Task_46673,2451,155,145,193,338,15.711538461538462,46.979491025428125
Task_46674,1310,218,55,20,75,5.981735159817352,26.19058189675387
Task_46675,2244,334,102,70,172,6.6985074626865675,43.23122742180518
Task_46676,1773,735,72,123,195,2.4089673913043477,37.90675275257717
Task_46677,2667,86,131,165,296,30.655172413793103,49.3623143346443
Task_46678,2815,70,140,172,312,39.647887323943664,51.59768870190202
Task_46679,872,669,177,176,353,1.3014925373134327,23.999616946108286
Task_46680,1730,622,200,196,396,2.7768860353130016,37.757287402674095
Task_46681,1730,899,41,22,63,1.9222222222222223,35.254711089394895
Task_46682,2212,674,111,189,300,3.277037037037037,45.11225184274493
Task_46683,567,388,144,83,227,1.4575835475578407,17.325043787990033
Task_46684,988,274,19,128,147,3.5927272727272728,23.365510073509387
Task_46685,926,727,90,42,132,1.271978021978022,23.038687771636607
Task_46686,2984,194,73,136,209,15.302564102564103,55.2482442940794
Task_46687,1715,596,198,200,398,2.8726968174204357,37.45275377788256
Task_46688,948,567,135,176,311,1.6690140845070423,24.775048737567072
Task_46689,1496,232,57,177,234,6.420600858369099,32.18929130629851
Task_46690,2421,164,166,91,257,14.672727272727272,45.907799218828075
Task_46691,1872,680,47,122,169,2.748898678414097,38.919218203010026
Task_46692,2136,156,157,103,260,13.605095541401274,41.56734030040758
Task_46693,1896,573,40,144,184,3.303135888501742,39.03842536395165
Task_46694,1511,946,25,92,117,1.5955649419218585,33.63654282835338
Task_46695,1244,715,71,123,194,1.7374301675977655,29.44647732300784
Task_46696,1047,396,177,168,345,2.63727959697733,25.95925844861903
Task_46697,1396,403,99,92,191,3.4554455445544554,30.599188263156663
Task_46698,1633,550,51,95,146,2.9637023593466423,34.64245366600769
Task_46699,1396,409,22,60,82,3.4048780487804877,29.0795036788157
Task_46700,1537,144,54,49,103,10.6,29.965105499916294
Task_46701,2934,948,171,75,246,3.0916754478398314,56.63603134634824
Task_46702,2499,880,41,58,99,2.836549375709421,48.18609530850011
Task_46703,774,172,55,169,224,4.473988439306359,20.112922483469028
Task_46704,772,753,95,59,154,1.023872679045093,20.834486601015914
Task_46705,1871,585,157,158,315,3.1928327645051193,39.452821818153176
Task_46706,2101,982,135,22,157,2.1373346897253307,42.419379323063374
Task_46707,1809,405,45,77,122,4.455665024630542,36.438998845298556
Task_46708,1153,533,105,146,251,2.1591760299625467,27.61366018708273
Task_46709,1085,450,57,96,153,2.4057649667405765,25.61897082111479
Task_46710,619,865,194,106,300,0.7147806004618937,20.38156475997033
Task_46711,655,180,128,49,177,3.6187845303867405,17.08248735052278
Task_46712,767,676,71,93,164,1.1329394387001477,21.322499773499615
Task_46713,1540,860,131,120,251,1.7886178861788617,34.72594071167074
Task_46714,1519,201,91,141,232,7.51980198019802,32.2702865665618
Task_46715,1817,254,18,129,147,7.125490196078432,36.393731606932505
Task_46716,1242,138,160,139,299,8.93525179856115,27.566068184466044
Task_46717,1232,190,114,100,214,6.450261780104712,27.51780240166273
Task_46718,1801,566,144,68,212,3.17636684303351,37.24743647639449
Task_46719,1228,501,17,58,75,2.446215139442231,26.318514408664655
Task_46720,580,527,74,33,107,1.0984848484848484,16.7023289386272
Task_46721,1720,228,149,153,302,7.510917030567685,35.82570577042658
Task_46722,2139,601,20,148,168,3.553156146179402,42.866273387803176
Task_46723,2551,217,51,81,132,11.70183486238532,47.825545107704436
Task_46724,2341,334,156,58,214,6.988059701492538,44.96295791332388
Task_46725,2595,444,47,164,211,5.831460674157303,50.052724634271215
Task_46726,1368,271,56,141,197,5.029411764705882,30.08116820214914
Task_46727,2750,833,106,131,237,3.2973621103117505,53.766129932863215
Task_46728,1237,872,52,169,221,1.4169530355097366,29.96190423363004
Task_46729,575,587,99,177,276,0.9778911564625851,18.708241634592003
Task_46730,1052,856,180,155,335,1.2275379229871646,27.288159474937398
Task_46731,1694,586,162,118,280,2.885860306643952,36.436636426017394
Task_46732,1547,675,104,95,199,2.2884615384615383,33.96100491283413
Task_46733,1149,157,100,121,221,7.272151898734177,25.86680133423881
Task_46734,2107,803,106,95,201,2.620646766169154,43.241596904182266
Task_46735,1854,406,127,18,145,4.555282555282555,36.535037775058505
Task_46736,871,563,194,35,229,1.5443262411347518,22.307040413241072
Task_46737,1888,529,79,138,217,3.5622641509433963,39.204151514004344
Task_46738,1680,461,137,10,147,3.6363636363636362,34.03243103975178
Task_46739,2867,551,52,26,78,5.193840579710145,52.25575647580917
Task_46740,640,829,114,102,216,0.7710843373493976,20.133635319720693
Task_46741,2888,660,23,167,190,4.369137670196672,55.33203890525176
Task_46742,2294,346,10,60,70,6.610951008645533,42.70749939363605
Task_46743,1993,769,22,182,204,2.588311688311688,41.46783002296642
Task_46744,938,370,183,169,352,2.5283018867924527,24.18498616990024
Task_46745,957,64,88,19,107,14.723076923076922,19.91396984584806
Task_46746,1444,677,128,131,259,2.129793510324484,32.68712001104877
Task_46747,2768,468,151,176,327,5.901918976545843,53.359720466377176
Task_46748,1001,133,98,141,239,7.470149253731344,23.424603339297978
Task_46749,2986,347,127,16,143,8.580459770114942,54.2586151064597
Task_46750,1141,419,77,200,277,2.716666666666667,27.386180630446848
Task_46751,2889,646,26,96,122,4.4652241112828435,54.61982780597859
Task_46752,2983,646,134,152,286,4.6105100463678514,57.118005028790776
Task_46753,2647,125,83,62,145,21.00793650793651,48.08603263406791
Task_46754,625,524,197,179,376,1.1904761904761905,19.755426253543064
Task_46755,1070,84,145,94,239,12.588235294117647,23.9730279411325
Task_46756,2847,836,30,91,121,3.401433691756272,54.41933719728951
Task_46757,837,557,169,60,229,1.5,21.92030096107045
Task_46758,1700,206,91,130,221,8.21256038647343,35.08021572706337
Task_46759,1499,502,168,68,236,2.9801192842942346,32.371310933379995
Task_46760,969,906,85,38,123,1.0683572216097024,24.132810891910285
Task_46761,1533,627,200,196,396,2.4410828025477707,34.652985500142655
Task_46762,2436,336,96,26,122,7.228486646884273,45.53436962098644
Task_46763,560,995,70,33,103,0.5622489959839357,17.879971676779984
Task_46764,1301,375,67,33,100,3.4601063829787235,27.472156194712113
Task_46765,956,163,168,116,284,5.829268292682927,23.10800847720159
Task_46766,1204,356,120,186,306,3.372549019607843,28.165730442260855
Task_46767,1976,878,94,181,275,2.248009101251422,41.97161370943945
Task_46768,1699,115,116,29,145,14.64655172413793,32.836845043368726
Task_46769,1705,924,167,152,319,1.8432432432432433,37.892655115137345
Task_46770,1755,680,187,56,243,2.5770925110132157,37.01468362053346
Task_46771,2551,697,180,57,237,3.654727793696275,49.5772086641115
Task_46772,1760,257,28,197,225,6.821705426356589,36.31867043620361
Task_46773,2284,898,23,183,206,2.5406006674082313,46.618579006425364
Task_46774,1341,705,200,47,247,1.8994334277620397,30.26838282753143
Task_46775,2131,934,177,165,342,2.279144385026738,44.79680659334006
Task_46776,766,64,140,125,265,11.784615384615385,19.289283101976206
Task_46777,1175,647,104,181,285,1.8132716049382716,28.523233415904496
Task_46778,2571,998,193,123,316,2.5735735735735736,51.789867017038524
Task_46779,2520,854,51,50,101,2.9473684210526314,48.327650416940294
Task_46780,2083,827,176,65,241,2.5157004830917873,42.66076543903523
Task_46781,856,848,100,91,191,1.0082449941107186,23.229952919620647
Task_46782,988,623,51,92,143,1.5833333333333333,24.528670189829132
Task_46783,1399,811,143,109,252,1.7229064039408868,32.31458415668183
Task_46784,1605,218,109,20,129,7.328767123287672,31.947718407098176
Task_46785,939,430,171,170,341,2.1786542923433876,24.342768160233998
Task_46786,1615,1021,152,75,227,1.5802348336594911,35.84689040277696
Task_46787,1038,895,74,152,226,1.1584821428571428,26.8449971793053
Task_46788,1607,139,187,161,348,11.478571428571428,33.57246794687046
Task_46789,846,231,126,139,265,3.646551724137931,21.844427763691556
Task_46790,1372,489,73,31,104,2.8,29.008754385083382
Task_46791,2827,235,134,109,243,11.978813559322035,53.00656120970543
Task_46792,2587,727,88,132,220,3.5535714285714284,50.79493395073127
Task_46793,1145,73,110,189,299,15.472972972972974,25.426420914982373
Task_46794,684,103,126,40,166,6.576923076923077,16.85208773677066
Task_46795,2420,518,133,158,291,4.66281310211946,47.82411597931323
Task_46796,1960,561,123,86,209,3.487544483985765,39.9387823602617
Task_46797,1505,309,164,48,212,4.854838709677419,31.457692465469282
Task_46798,1164,85,119,142,261,13.534883720930232,25.59558054883654
Task_46799,1528,992,139,150,289,1.5387713997985901,35.11800325361349
Task_46800,2188,852,45,109,154,2.5650644783118404,44.16406979915965
Task_46801,1900,873,24,193,217,2.1739130434782608,40.46710416034918
Task_46802,2653,548,91,169,260,4.832422586520948,51.53540038959988
Task_46803,1139,791,20,66,86,1.4381313131313131,26.3475260037804
Task_46804,2207,684,171,129,300,3.221897810218978,44.97660654784812
Task_46805,2466,757,91,54,145,3.253298153034301,47.89701100832918
Task_46806,1547,679,96,179,275,2.275,34.520177539027095
Task_46807,2189,697,73,100,173,3.1361031518624642,44.17235911677833
Task_46808,2232,919,176,73,249,2.4260869565217393,45.38961660480681
Task_46809,1207,582,88,187,275,2.0703259005145798,28.810236458905745
Task_46810,1180,156,185,134,319,7.515923566878981,26.80976110170063
Task_46811,1009,877,141,26,167,1.1492027334851935,25.005160203481356
Task_46812,807,570,17,110,127,1.4133099824868651,21.20449342612103
Task_46813,2425,580,13,125,138,4.173838209982788,47.09675732734249
Task_46814,1186,180,54,29,83,6.552486187845304,24.641944475541482
Task_46815,535,565,178,72,250,0.9452296819787986,17.43238041310329
Task_46816,1687,593,170,189,359,2.84006734006734,36.80798310576654
Task_46817,2537,970,69,95,164,2.612770339855819,50.44294569246884
Task_46818,1602,299,175,173,348,5.34,34.443077583358566
Task_46819,2099,784,47,84,131,2.6738853503184714,42.430148080361874
Task_46820,1886,906,117,109,226,2.079382579933848,40.22255035346429
Task_46821,1217,895,27,101,128,1.3582589285714286,29.010370176021283
Task_46822,1167,256,161,42,203,4.5408560311284045,25.881340026124366
Task_46823,1327,950,145,34,179,1.3953732912723449,30.32247524005173
Task_46824,1031,775,122,114,236,1.3286082474226804,26.28077317571409
Task_46825,2004,913,172,26,198,2.192560175054705,41.15909474872576
Task_46826,530,214,43,169,212,2.4651162790697674,16.616852704081765
Task_46827,2917,146,180,69,249,19.843537414965986,53.23537240895467
Task_46828,817,325,87,154,241,2.5061349693251533,21.613796012140398
Task_46829,2761,539,122,114,236,5.112962962962963,52.978429823472275
Task_46830,2369,451,145,82,227,5.241150442477876,46.116786806886886
Task_46831,2854,911,184,94,278,3.129385964912281,55.73338870608577
Task_46832,2196,238,66,160,226,9.188284518828452,43.17109906425696
Task_46833,2706,382,48,165,213,7.065274151436031,51.6868161887428
Task_46834,1616,166,121,158,279,9.676646706586826,33.5349727224116
Task_46835,2836,274,133,64,197,10.312727272727273,52.56700050996958
Task_46836,1640,679,145,94,239,2.411764705882353,35.59800560560844
Task_46837,1371,425,89,95,184,3.2183098591549295,30.15145762249412
Task_46838,2772,293,89,67,156,9.428571428571429,51.16472029511243
Task_46839,2932,917,19,121,140,3.1938997821350763,56.1303787014434
Task_46840,1560,624,178,136,314,2.496,34.613656026710416
Task_46841,1165,466,78,97,175,2.4946466809421843,27.289565255623998
Task_46842,2535,324,20,138,158,7.8,48.039978186410025
Task_46843,2291,788,30,56,86,2.903675538656527,44.60307225934077
Task_46844,1269,446,44,199,243,2.838926174496644,29.230752540632654
Task_46845,1474,937,57,49,106,1.5714285714285714,31.931666382672717
Task_46846,2213,695,100,197,297,3.1795977011494254,45.19243884444768
Task_46847,1401,504,164,197,361,2.774257425742574,32.01929412179934
Task_46848,1022,892,58,130,188,1.1444568868980962,26.33751627186965
Task_46849,913,156,52,11,63,5.8152866242038215,19.791844210331735
Task_46850,643,71,61,12,73,8.930555555555555,14.131711233008083
Task_46851,711,850,160,118,278,0.8354876615746181,21.59444088888498
Task_46852,549,199,97,109,206,2.745,16.778901513082612
Task_46853,686,551,120,171,291,1.2427536231884058,20.36928149560509
Task_46854,2086,536,125,84,209,3.8845437616387337,41.821793514747455
Task_46855,1630,941,103,183,286,1.7303609341825903,36.64029029222567
Task_46856,2129,728,182,160,342,2.9204389574759944,44.11411537012095
Task_46857,690,1012,24,112,136,0.6811451135241856,21.0017744594355
Task_46858,2332,668,21,51,72,3.485799701046338,44.40398100862988
Task_46859,2212,214,74,103,177,10.288372093023256,42.85679561478903
Task_46860,2088,574,74,63,137,3.631304347826087,41.38294061782678
Task_46861,1270,82,66,107,173,15.301204819277109,26.85572544571703
Task_46862,2472,422,93,100,193,5.843971631205674,47.92038445159688
Task_46863,1030,121,136,182,318,8.442622950819672,24.24878708897191
Task_46864,781,545,145,100,245,1.4304029304029304,21.59828013484321
Task_46865,2298,316,74,96,170,7.249211356466877,44.57459899693331
Task_46866,1073,67,178,98,276,15.779411764705882,24.103209657194054
Task_46867,1552,924,159,161,320,1.6778378378378378,35.47252913733018
Task_46868,2448,142,46,19,65,17.11888111888112,43.8810934800191
Task_46869,2478,162,129,137,266,15.202453987730062,47.05015247043061
Task_46870,1720,359,146,80,226,4.777777777777778,35.536841944028886
Task_46871,556,579,85,37,122,0.9586206896551724,16.6221859473666
Task_46872,2501,414,60,69,129,6.026506024096386,47.46756912301414
Task_46873,549,66,164,49,213,8.194029850746269,14.790205827558303
Task_46874,1655,963,109,104,213,1.716804979253112,36.659910717885616
Task_46875,2828,185,34,62,96,15.204301075268818,51.20002800299219
Task_46876,1121,891,34,194,228,1.256726457399103,28.022730774876077
Task_46877,1273,869,168,126,294,1.4632183908045977,30.65764750075613
Task_46878,971,757,62,145,207,1.2810026385224274,25.25364878321997
Task_46879,739,930,54,106,160,0.7937701396348013,21.556398287757215
Task_46880,754,826,98,111,209,0.9117291414752116,21.907443656355753
Task_46881,2883,976,115,147,262,2.9508700102354144,56.457252037604725
Task_46882,612,367,54,132,186,1.6630434782608696,18.231447881148966
Task_46883,931,111,113,198,311,8.3125,22.364718680153157
Task_46884,1337,301,31,54,85,4.427152317880795,27.894214446186506
Task_46885,1418,135,55,15,70,10.426470588235293,27.421022262938674
Task_46886,1113,282,85,116,201,3.932862190812721,25.95727745036675
Task_46887,1692,852,78,191,269,1.9835873388042204,37.42532879843011
Task_46888,871,553,58,18,76,1.5722021660649819,20.29817552835037
Task_46889,1066,317,80,72,152,3.352201257861635,24.375412636555563
Task_46890,2843,267,33,72,105,10.60820895522388,52.006148826648776
Task_46891,760,309,68,37,105,2.4516129032258065,18.69555162225264
Task_46892,2686,389,123,51,174,6.887179487179488,50.39006536330606
Task_46893,960,507,135,95,230,1.889763779527559,24.278881143406682
Task_46894,2187,244,151,198,349,8.926530612244898,43.5383367244709
Task_46895,2145,117,16,164,180,18.177966101694917,40.78354704983379
Task_46896,1989,515,162,51,213,3.854651162790698,40.015946810229615
Task_46897,2567,758,111,20,131,3.3820816864295127,48.9248720617886
Task_46898,1922,80,131,40,171,23.728395061728396,35.953108839493574
Task_46899,1685,195,188,128,316,8.596938775510203,35.11922568930418
Task_46900,549,349,84,17,101,1.5685714285714285,15.25193375641819
Task_46901,585,1010,55,40,95,0.5786350148367952,18.28169781314182
Task_46902,2732,918,97,158,255,2.9727965179542983,53.891513701949656
Task_46903,2462,496,84,30,114,4.953722334004024,46.40996478556321
Task_46904,2102,423,106,48,154,4.9575471698113205,40.69675153674372
Task_46905,1523,675,175,118,293,2.252958579881657,34.06637256287432
Task_46906,1600,733,169,76,245,2.1798365122615806,34.82799599663501
Task_46907,2258,1018,32,200,232,2.215897939156035,46.66585674837404
Task_46908,2356,718,153,116,269,3.2767732962447846,47.28508461943445
Task_46909,2846,360,104,101,205,7.883656509695291,53.57386378707478
Task_46910,1563,832,21,148,169,1.8763505402160865,34.470649294913066
Task_46911,1685,102,81,143,224,16.359223300970875,33.77879689802315
Task_46912,1151,994,42,65,107,1.1567839195979899,27.492005613196387
Task_46913,1865,810,53,49,102,2.2996300863131935,37.74561382915337
Task_46914,1001,903,19,137,156,1.1073008849557522,25.35193969726994
Task_46915,2694,414,14,97,111,6.491566265060241,50.65437216821197
Task_46916,656,430,151,29,180,1.5220417633410672,18.100383940046683
Task_46917,2283,276,74,192,266,8.24187725631769,44.919292647913345
Task_46918,2010,949,62,192,254,2.1157894736842104,42.69705948756569
Task_46919,1059,700,89,155,244,1.5106990014265336,26.622549216334857
Task_46920,2192,490,19,122,141,4.464358452138493,43.06491721362564
Task_46921,2544,871,164,156,320,2.9174311926605503,51.031981150661046
Task_46922,1002,502,79,77,156,1.9920477137176937,24.094707088257042
Task_46923,2586,931,16,200,216,2.774678111587983,51.444008466146585
Task_46924,503,368,120,180,300,1.3631436314363143,17.0172701537613
Task_46925,1408,392,104,111,215,3.5826972010178118,30.989057448783555
Task_46926,1076,132,162,134,296,8.090225563909774,24.849128892732057
Task_46927,1584,354,184,178,362,4.461971830985916,34.41094911373711
Task_46928,627,255,190,27,217,2.44921875,17.362277344339443
Task_46929,2407,269,151,80,231,8.914814814814815,46.11517701274162
Task_46930,1818,114,165,91,256,15.808695652173913,35.95745404794466
Task_46931,1399,252,142,30,172,5.529644268774703,29.335798159410885
Task_46932,1153,510,190,87,277,2.2563600782778863,27.31788242234479
Task_46933,2584,478,34,16,50,5.3945720250521925,47.34437544970069
Task_46934,1054,152,40,94,134,6.888888888888889,23.45353073137444
Task_46935,544,1015,47,155,202,0.5354330708661418,19.26609926965278
Task_46936,1505,676,144,144,288,2.2230428360413588,33.79996713286662
Task_46937,2195,858,43,124,167,2.5552968568102443,44.54841188274435
Task_46938,1757,201,189,141,330,8.698019801980198,36.41950831688144
Task_46939,1688,394,54,198,252,4.273417721518987,35.87930853462699
Task_46940,2089,253,17,116,133,8.224409448818898,40.624874929264756
Task_46941,767,69,184,163,347,10.957142857142857,19.703932997466463
Task_46942,1071,952,184,130,314,1.123819517313746,27.71932309652198
Task_46943,2068,64,70,71,141,31.815384615384616,38.266952838740885
Task_46944,2383,897,137,157,294,2.653674832962138,48.44647097142073
Task_46945,1173,514,34,82,116,2.2776699029126215,26.80059154197784
Task_46946,2194,749,173,86,259,2.925333333333333,44.46305766422382
Task_46947,2590,636,100,58,158,4.065934065934066,49.351157837030826
Task_46948,851,456,14,35,49,1.8621444201312911,20.049544938546802
Task_46949,2144,930,180,181,361,2.3029001074113857,45.099435519250484
Task_46950,1084,233,166,91,257,4.632478632478633,25.357850926738053
Task_46951,1669,797,178,87,265,2.091478696741855,36.33423350814099
Task_46952,1753,663,200,122,322,2.6400602409638556,37.80837877404068
Task_46953,872,311,41,81,122,2.7948717948717947,21.372246556696364
Task_46954,1210,782,186,180,366,1.5453384418901661,29.818718336678824
Task_46955,1069,200,192,53,245,5.318407960199005,24.636528321199744
Task_46956,2697,268,35,16,51,10.026022304832713,48.42261461922583
Task_46957,1125,732,148,156,304,1.534788540245566,28.00215742493202
Task_46958,818,1015,123,86,209,0.8051181102362205,23.209190940853574
Task_46959,2315,76,141,15,156,30.064935064935064,41.722071125977266
Task_46960,553,847,54,83,137,0.652122641509434,18.254304380830224
Task_46961,994,444,28,46,74,2.2337078651685394,22.23723586799095
Task_46962,943,783,28,70,98,1.2028061224489797,23.4993013215188
Task_46963,911,345,157,126,283,2.632947976878613,23.304136638677402
Task_46964,2059,484,148,84,232,4.245360824742268,41.331557752171264
Task_46965,749,400,109,143,252,1.8678304239401495,20.800764010714953
Task_46966,1133,940,73,22,95,1.20403825717322,26.7631952162199
Task_46967,1973,701,179,127,306,2.8105413105413106,41.347587427163695
Task_46968,1716,967,133,92,225,1.7727272727272727,37.57474582089541
Task_46969,2406,569,134,145,279,4.221052631578948,47.69269811523998
Task_46970,1110,381,179,39,218,2.905759162303665,25.426505750221846
Task_46971,1967,730,37,90,127,2.6908344733242133,40.180604489890946
Task_46972,835,360,131,132,263,2.3130193905817173,22.068388637298295
Task_46973,1435,755,94,159,253,1.8981481481481481,32.885678754730826
Task_46974,2845,173,131,196,327,16.350574712643677,53.170944172687996
Task_46975,2683,678,33,133,166,3.95139911634757,51.77620205020344
Task_46976,2810,793,24,56,80,3.53904282115869,52.68695774376536
Task_46977,2292,753,74,150,224,3.0397877984084882,46.36007941496482
Task_46978,1248,446,93,63,156,2.791946308724832,27.628008120578922
Task_46979,2156,752,177,177,354,2.863213811420983,44.6961266840302
Task_46980,989,517,46,80,126,1.9092664092664093,24.003772512333995
Task_46981,631,1022,127,145,272,0.6168132942326491,21.075477662981932
Task_46982,2986,707,138,73,211,4.2175141242937855,56.49868126960174
Task_46983,1116,846,119,64,183,1.3175914994096811,26.911292248515327
Task_46984,1726,590,167,69,236,2.9204737732656514,36.215609886356496
Task_46985,1425,901,152,125,277,1.5798226164079823,33.112894668660914
Task_46986,1612,507,122,173,295,3.173228346456693,35.036635791407925
Task_46987,2228,431,82,168,250,5.157407407407407,44.425400841637725
Task_46988,1465,426,117,190,307,3.430913348946136,32.53064609320598
Task_46989,839,355,95,196,291,2.356741573033708,22.40592290316755
Task_46990,999,936,17,162,179,1.0661686232657417,25.656599465192517
Task_46991,657,194,152,29,181,3.3692307692307693,17.349023672184963
Task_46992,2952,329,21,193,214,8.945454545454545,55.29914467438335
Task_46993,1069,471,101,84,185,2.264830508474576,25.249204806048027
Task_46994,2798,350,46,176,222,7.971509971509971,53.001180684505734
Task_46995,769,826,59,111,170,0.9298669891172914,21.81726041742
Task_46996,1926,603,65,157,222,3.1887417218543046,40.085399449639446
Task_46997,1017,863,16,93,109,1.1770833333333333,25.280604296599176
Task_46998,2386,856,87,148,235,2.7841306884480748,48.09532619301151
Task_46999,2468,405,178,153,331,6.078817733990148,48.38866387737121
Task_47000,1889,1009,35,75,110,1.8702970297029704,39.48935978663222
Task_47001,1997,580,96,79,175,3.4371772805507743,40.36890551669451
Task_47002,1534,959,93,178,271,1.5979166666666667,35.21192912758994
Task_47003,1973,959,60,105,165,2.0552083333333333,41.53747035978107
Task_47004,798,768,17,90,107,1.0377113133940181,21.228534093854794
Task_47005,1351,456,52,26,78,2.9562363238512037,27.950857582948363
Task_47006,2277,821,154,84,238,2.77007299270073,45.87633333621479
Task_47007,574,64,138,76,214,8.830769230769231,15.605963527966642
Task_47008,2263,75,171,114,285,29.776315789473685,42.78093114479524
Task_47009,660,140,49,30,79,4.680851063829787,16.112347902174594
Task_47010,2673,661,185,62,247,4.037764350453172,51.45531721207853
Task_47011,1146,348,61,182,243,3.2836676217765044,27.06066428346732
Task_47012,2640,466,113,138,251,5.653104925053533,50.928811001474934
Task_47013,1432,589,78,23,101,2.4271186440677965,30.277858967686456
Task_47014,1472,829,187,109,296,1.7734939759036144,33.72543879132291
Task_47015,943,337,43,43,86,2.789940828402367,21.535127341924653
Task_47016,1569,707,177,146,323,2.2161016949152543,35.07131141245065
Task_47017,2471,947,18,106,124,2.6065400843881856,48.87084793038346
Task_47018,2375,542,138,101,239,4.373848987108656,46.870727558403566
Task_47019,2991,832,70,127,197,3.590636254501801,57.535648860351984
Task_47020,2331,253,143,14,157,9.17716535433071,43.60438473682456
Task_47021,1780,156,36,131,167,11.337579617834395,35.29940002990677
Task_47022,2391,644,121,54,175,3.7069767441860466,46.56063662444057
Task_47023,2074,258,119,189,308,8.007722007722007,41.605382939165644
Task_47024,2114,837,165,191,356,2.522673031026253,44.32620046548731
Task_47025,2217,512,119,142,261,4.321637426900585,44.432225885530876
Task_47026,2478,692,98,154,252,3.5757575757575757,49.12867049592069
Task_47027,2633,120,194,26,220,21.760330578512395,48.204786026459324
Task_47028,1055,533,150,124,274,1.9756554307116105,26.133410718897625
Task_47029,1264,325,61,174,235,3.8773006134969323,28.804606234634765
Task_47030,2485,273,71,48,119,9.069343065693431,46.07888779420872
Task_47031,2086,551,161,68,229,3.778985507246377,41.789327249351686
Task_47032,2608,520,99,40,139,5.005758157389636,48.9508125947965
Task_47033,1609,941,133,152,285,1.708067940552017,36.25757314679174
Task_47034,1065,547,66,76,142,1.9434306569343065,25.225617969492077
Task_47035,1890,969,126,145,271,1.9484536082474226,40.737405514260516
Task_47036,1639,644,138,135,273,2.5410852713178294,35.74135822701572
Task_47037,2910,1015,77,151,228,2.8641732283464565,56.98538543593343
Task_47038,2588,262,93,189,282,9.840304182509506,49.737070093663526
Task_47039,2317,591,92,175,267,3.9138513513513513,46.42081567119959
Task_47040,2820,305,132,172,304,9.215686274509803,53.52158904119049
Task_47041,1454,640,162,15,177,2.268330733229329,31.179395326969146
Task_47042,1722,351,60,151,211,4.892045454545454,35.99185524145188
Task_47043,817,933,66,167,233,0.8747323340471093,23.487895423871592
Task_47044,662,874,119,197,316,0.7565714285714286,21.174519852707853
Task_47045,562,1009,154,42,196,0.5564356435643565,18.94184498682534
Task_47046,2703,117,182,152,334,22.906779661016948,50.54609714604501
Task_47047,2416,687,50,33,83,3.511627906976744,45.951671621442784
Task_47048,1310,865,71,134,205,1.51270207852194,30.999000000066598
Task_47049,955,151,186,49,235,6.282894736842105,22.124447156731303
Task_47050,1479,642,153,97,250,2.300155520995334,33.075196013634645
Task_47051,1991,827,83,57,140,2.404589371980676,40.42999187520282
Task_47052,2420,512,10,124,134,4.717348927875244,46.767078578826585
Task_47053,1444,1023,44,176,220,1.41015625,33.54442835945542
Task_47054,2729,752,52,108,160,3.6241699867197874,52.64300152566119
Task_47055,1947,813,166,188,354,2.391891891891892,41.59195435121722
Task_47056,1230,790,141,43,184,1.5549936788874843,28.303640177266274
Task_47057,1645,859,25,38,63,1.9127906976744187,33.8800214054547
Task_47058,2455,396,126,11,137,6.183879093198993,46.04933424756711
Task_47059,2550,125,193,161,354,20.238095238095237,48.321538736314245
Task_47060,2181,490,14,128,142,4.441955193482689,42.98080246995257
Task_47061,2093,162,151,125,276,12.840490797546012,41.00765309024185
Task_47062,642,902,179,37,216,0.7109634551495017,19.927024865711633
Task_47063,999,295,44,55,99,3.375,22.644632484195977
Task_47064,1668,548,126,150,276,3.0382513661202184,35.93381903136462
Task_47065,946,461,61,179,240,2.0476190476190474,24.237175945225392
Task_47066,2190,561,124,70,194,3.8967971530249113,43.30729010085704
Task_47067,1489,871,155,19,174,1.7075688073394495,32.47405698688289
Task_47068,1274,556,180,149,329,2.287253141831239,29.957722983337163
Task_47069,2670,620,162,41,203,4.299516908212561,50.850881824726194
Task_47070,603,710,136,119,255,0.8481012658227848,19.356725292612996
Task_47071,2299,399,194,136,330,5.7475,45.66519186819513
Task_47072,2091,443,193,188,381,4.70945945945946,42.82348491461972
Task_47073,2863,270,120,112,232,10.564575645756458,53.662347698803366
Task_47074,2658,384,191,82,273,6.903896103896104,50.676219831242555
Task_47075,2214,181,38,33,71,12.164835164835164,40.668147496504275
Task_47076,1478,716,73,66,139,2.0613668061366806,32.1287750348663
Task_47077,2152,952,147,44,191,2.2581322140608604,43.6202940773917
Task_47078,1010,993,49,104,153,1.0160965794768613,25.850213521494087
Task_47079,2308,74,190,55,245,30.773333333333333,42.81193511630446
Task_47080,2334,528,180,109,289,4.4120982986767485,46.41377612948978
Task_47081,790,262,172,76,248,3.0038022813688214,20.531169509653136
Task_47082,2988,879,11,193,204,3.3954545454545455,57.62555482107468
Task_47083,2841,442,109,35,144,6.413092550790068,52.47390217447407
Task_47084,1250,529,67,62,129,2.358490566037736,27.927476126797263
Task_47085,1898,378,20,162,182,5.007915567282322,38.4241013775877
Task_47086,2501,758,30,133,163,3.2951251646903823,49.126579047791665
Task_47087,1362,693,69,148,217,1.962536023054755,31.395332205975837
Task_47088,651,593,144,158,302,1.095959595959596,19.954790550732188
Task_47089,2473,713,143,121,264,3.4635854341736696,49.10750469606501
Task_47090,861,989,99,48,147,0.8696969696969697,22.848984115737675
Task_47091,1752,674,174,81,255,2.5955555555555554,37.141827727315984
Task_47092,1236,849,55,199,254,1.4541176470588235,30.06682711915914
Task_47093,2610,786,133,158,291,3.3163913595933927,51.683457692711535
Task_47094,888,920,121,166,287,0.9641693811074918,24.72938822368881
Task_47095,2781,313,134,16,150,8.856687898089172,50.89950975883047
Task_47096,2355,622,108,166,274,3.780096308186196,47.0618858978436
Task_47097,2073,560,157,164,321,3.695187165775401,42.608144429955274
Task_47098,2622,993,190,103,293,2.6378269617706236,52.44949909228988
Task_47099,918,420,195,170,365,2.1805225653206652,24.08703579280953
Task_47100,1639,585,124,136,260,2.7969283276450514,35.498753550325524
Task_47101,2144,965,175,148,323,2.219461697722567,44.98874620549398
Task_47102,2540,614,114,145,259,4.130081300813008,49.86799507801273
Task_47103,995,938,21,157,178,1.0596379126730564,25.627776435759046
Task_47104,1502,572,123,16,139,2.6212914485165792,31.45441647696552
Task_47105,1878,799,147,107,254,2.3475,39.885621477985886
Task_47106,2048,690,137,133,270,2.963820549927641,42.347593258659465
Task_47107,1944,274,100,16,116,7.069090909090909,37.297752110509016
Task_47108,1360,134,141,153,294,10.074074074074074,29.347172909927277
Task_47109,1727,79,122,141,263,21.5875,34.389095201821725
Task_47110,2192,817,87,172,259,2.6797066014669926,45.04300173839572
Task_47111,1181,179,26,104,130,6.561111111111111,25.4303531495939
Task_47112,649,944,14,65,79,0.6867724867724868,19.10486478945715
Task_47113,1134,281,104,16,120,4.0212765957446805,24.519475750249256
Task_47114,2833,880,62,155,217,3.2156640181611804,55.30159943465052
Task_47115,2410,527,135,157,292,4.5643939393939394,47.69775789169709
Task_47116,1503,845,179,80,259,1.7765957446808511,33.77591302499642
Task_47117,546,684,92,163,255,0.7970802919708029,18.524600636377414
Task_47118,723,474,71,196,267,1.5221052631578946,20.855233982167587
Task_47119,2888,338,135,193,328,8.519174041297935,54.85166660875942
Task_47120,1190,644,26,171,197,1.8449612403100775,28.381128378506762
Task_47121,2007,606,91,110,201,3.3064250411861615,41.13804583402407
Task_47122,2266,947,87,136,223,2.390295358649789,46.4061831397915
Task_47123,2426,295,144,155,299,8.195945945945946,47.209502174308035
Task_47124,648,1008,91,190,281,0.6422200198216056,21.406186235757364
Task_47125,1206,748,128,157,285,1.610146862483311,29.28018847462681
Task_47126,2855,85,148,63,211,33.19767441860465,51.346550546508006
Task_47127,2675,407,17,103,120,6.556372549019608,50.25739991953656
Task_47128,1732,342,111,143,254,5.049562682215743,36.17441320479882
Task_47129,2682,106,24,68,92,25.065420560747665,47.89229834788753
Task_47130,1085,445,176,159,335,2.4327354260089686,26.657696738545827
Task_47131,1469,1005,158,190,348,1.4602385685884691,34.52225583899446
Task_47132,1981,101,158,34,192,19.42156862745098,37.537442356424
Task_47133,1071,486,54,177,231,2.1991786447638604,26.28214361130409
Task_47134,2283,249,110,14,124,9.132,42.65999213582362
Task_47135,763,94,177,18,195,8.031578947368422,18.04166918509129
Task_47136,2067,119,115,83,198,17.225,39.64878834006238
Task_47137,2567,334,85,101,186,7.6626865671641795,48.89933679733065
Task_47138,2035,516,163,101,264,3.9361702127659575,41.51699143290817
Task_47139,2964,918,176,99,275,3.2252448313384114,57.53287256555427
Task_47140,2209,797,183,116,299,2.7681704260651627,45.33943606007323
Task_47141,1995,811,40,152,192,2.456896551724138,41.57569724678751
Task_47142,1780,254,130,34,164,6.980392156862745,35.310460032118776
Task_47143,1667,480,166,23,189,3.4656964656964657,34.37212848826295
Task_47144,2689,539,173,126,299,4.979629629629629,52.13994547523117
Task_47145,2163,478,149,157,306,4.515657620041754,43.69282316031801
Task_47146,2101,823,60,58,118,2.549757281553398,41.960253290017654
Task_47147,1611,102,33,139,172,15.640776699029127,32.27083424083455
Task_47148,2314,962,100,147,247,2.402907580477674,47.32929995597252
Task_47149,915,637,42,64,106,1.4341692789968652,22.485444039330492
Task_47150,722,756,171,26,197,0.9537648612945839,20.47688436776606
Task_47151,1355,262,16,37,53,5.152091254752852,27.4853062460389
Task_47152,2391,892,196,19,215,2.677491601343785,47.113459115828896
Task_47153,2525,432,28,111,139,5.831408775981524,48.16682978761053
Task_47154,959,912,48,21,69,1.0503833515881709,23.17605433066497
Task_47155,987,117,142,200,342,8.364406779661017,23.660962802807394
Task_47156,2614,976,165,166,331,2.6755373592630503,52.53334095190045
Task_47157,1344,753,101,125,226,1.7824933687002653,31.169089013358615
Task_47158,2545,246,12,162,174,10.303643724696355,48.3004774685864
Task_47159,894,111,42,108,150,7.982142857142857,20.436418852123357
Task_47160,1412,322,106,118,224,4.371517027863777,30.87563346669172
Task_47161,1881,815,57,133,190,2.3051470588235294,39.88007740712538
Task_47162,596,175,29,27,56,3.3863636363636362,15.069479365526805
Task_47163,1371,800,138,141,279,1.7116104868913857,32.00537416638978
Task_47164,2141,201,167,99,266,10.599009900990099,42.1160649055908
Task_47165,709,404,178,88,266,1.7506172839506173,19.901568606809153
Task_47166,2166,795,59,186,245,2.721105527638191,44.66581338859903
Task_47167,1609,637,151,83,234,2.5219435736677114,34.698888734376006
Task_47168,2679,458,132,147,279,5.836601307189542,51.65935753769736
Task_47169,1859,598,30,171,201,3.1035058430717863,38.85006614779
Task_47170,1127,117,57,149,206,9.55084745762712,25.287376639707997
Task_47171,2854,1011,175,12,187,2.8201581027667983,54.74479819442061
Task_47172,2332,384,99,72,171,6.057142857142857,44.69835354673118
Task_47173,1114,817,118,196,314,1.3618581907090463,28.176867186432073
Task_47174,832,377,169,58,227,2.201058201058201,21.292239244703396
Task_47175,1749,350,41,105,146,4.982905982905983,35.64355038820549
Task_47176,1073,297,66,196,262,3.6006711409395975,25.841657601876378
Task_47177,861,375,189,190,379,2.2898936170212765,23.135158172028365
Task_47178,2808,679,44,143,187,4.129411764705883,53.96802470985997
Task_47179,1186,584,64,84,148,2.0273504273504273,27.367967549037065
Task_47180,2541,712,94,131,225,3.5638148667601683,50.10419307049222
Task_47181,934,899,164,188,352,1.0377777777777777,25.6716329090273
Task_47182,913,502,111,84,195,1.8151093439363817,23.0777138202068
Task_47183,2147,526,200,188,388,4.074003795066414,44.00861557456073
Task_47184,812,714,175,164,339,1.1356643356643357,23.11820929465812
Task_47185,2051,847,30,115,145,2.418632075471698,42.07590329969216
Task_47186,1735,310,137,21,158,5.578778135048232,34.45701195820714
Task_47187,1378,999,111,126,237,1.378,32.46744583111911
Task_47188,2375,611,109,63,172,3.880718954248366,46.17867522746974
Task_47189,2329,841,158,81,239,2.7660332541567696,46.7334475650174
Task_47190,638,266,42,80,122,2.3895131086142323,17.558529978258104
Task_47191,885,776,126,102,228,1.138996138996139,23.87564597826248
Task_47192,850,310,87,194,281,2.733118971061093,22.3264808410387
Task_47193,976,379,139,180,319,2.568421052631579,24.68221044277504
Task_47194,1741,878,182,180,362,1.9806598407281002,38.554930442225775
Task_47195,1563,1024,88,74,162,1.5248780487804878,34.49107103735089
Task_47196,823,332,39,23,62,2.4714714714714714,19.12531602469446
Task_47197,2108,678,93,30,123,3.1045655375552283,41.6525284626719
Task_47198,1264,318,176,199,375,3.9623824451410656,29.321387923983778
Task_47199,1978,299,29,181,210,6.593333333333334,39.818458244149355
Task_47200,884,623,106,117,223,1.4166666666666667,23.39797253642804
Task_47201,2825,212,196,186,382,13.262910798122066,53.62323960342627
Task_47202,2474,263,70,133,203,9.371212121212121,47.52949912690923
Task_47203,2106,682,16,86,102,3.0834553440702783,41.820528780455724
Task_47204,2231,258,175,158,333,8.613899613899614,44.153528004216746
Task_47205,986,767,108,188,296,1.2838541666666667,25.87033115386529
Task_47206,1707,781,77,69,146,2.182864450127877,36.01302152994004
Task_47207,539,618,53,71,124,0.8707592891760905,16.973155211956946
Task_47208,2905,380,59,101,160,7.624671916010499,54.202072945038516
Task_47209,1805,255,157,54,211,7.05078125,36.253153053755064
Task_47210,1183,620,27,180,207,1.9049919484702094,28.253597166511224
Task_47211,2472,459,198,145,343,5.373913043478261,48.671644397982526
Task_47212,1564,86,195,38,233,17.977011494252874,30.91385467594507
Task_47213,1215,156,74,171,245,7.738853503184713,27.230984731676546
Task_47214,589,104,114,71,185,5.609523809523809,15.632906997895333
Task_47215,1968,915,115,155,270,2.148471615720524,41.81563107200269
Task_47216,811,878,157,83,240,0.9226393629124005,22.805170474846523
Task_47217,2646,614,92,170,262,4.302439024390244,51.674419759955136
Task_47218,668,381,199,190,389,1.7486910994764397,20.132261176481858
Task_47219,840,662,78,148,226,1.2669683257918551,22.966670574027678
Task_47220,1511,616,80,99,179,2.4489465153970826,33.07773379201136
Task_47221,2602,188,26,44,70,13.767195767195767,46.98918076317319
Task_47222,744,215,124,27,151,3.4444444444444446,18.510905709290295
Task_47223,2626,410,114,141,255,6.3892944038929445,50.54534290007592
Task_47224,613,770,71,190,261,0.795071335927367,19.958663693870296
Task_47225,1753,323,42,63,105,5.410493827160494,34.84796934372551
Task_47226,959,213,125,92,217,4.481308411214953,23.18247463746007
Task_47227,1486,505,68,84,152,2.9367588932806323,31.816521131999774
Task_47228,1393,355,10,158,168,3.912921348314607,30.306633585109125
Task_47229,1891,443,117,76,193,4.259009009009009,38.283117473324104
Task_47230,1158,480,49,98,147,2.4074844074844073,26.867961028323705
Task_47231,2036,383,84,72,156,5.302083333333333,39.92018178257707
Task_47232,1173,280,114,133,247,4.174377224199288,27.084017573072362
Task_47233,2959,364,23,166,189,8.106849315068493,55.467625122215026
Task_47234,2150,673,115,112,227,3.1899109792284865,43.68516623517956
Task_47235,2405,237,18,29,47,10.105042016806722,43.75814470680774
Task_47236,2881,541,132,87,219,5.31549815498155,54.51451674835894
Task_47237,533,493,132,141,273,1.0789473684210527,17.620082718329915
Task_47238,1347,582,130,83,213,2.3104631217838767,30.28237481893501
Task_47239,1566,369,188,163,351,4.232432432432432,34.103598499425146
Task_47240,539,486,59,91,150,1.106776180698152,16.722774681285085
Task_47241,2929,419,155,75,230,6.973809523809524,54.79657764311287
Task_47242,948,848,184,111,295,1.11660777385159,25.334984234380972
Task_47243,696,262,147,124,271,2.6463878326996197,19.581151417446076
Task_47244,2547,816,108,59,167,3.1175030599755202,49.38404904104117
Task_47245,841,680,108,195,303,1.234948604992658,23.31413136512114
Task_47246,696,528,45,91,136,1.3156899810964082,19.347945080665998
Task_47247,2133,998,117,78,195,2.135135135135135,43.937815209317215
Task_47248,2826,803,39,19,58,3.514925373134328,52.11980773894991
Task_47249,1182,616,122,65,187,1.9157212317666126,27.43733767777249
Task_47250,902,214,159,163,322,4.195348837209302,22.963904440187367
Task_47251,689,1011,114,131,245,0.6808300395256917,21.7595048101128
Task_47252,1213,233,163,136,299,5.183760683760684,27.796855958395128
Task_47253,514,427,133,77,210,1.2009345794392523,16.51584996234229
Task_47254,2709,828,131,191,322,3.267792521109771,53.57189923975028
Task_47255,886,894,151,12,163,0.9899441340782122,23.09984852434979
Task_47256,666,950,24,166,190,0.7003154574132492,20.962809699707524
Task_47257,2251,146,143,94,237,15.312925170068027,43.063231155155755
Task_47258,1329,477,52,164,216,2.780334728033473,30.261941423007297
Task_47259,2349,552,24,96,120,4.247739602169982,45.69679735397413
Task_47260,2642,481,179,171,350,5.481327800829876,51.50394685481823
Task_47261,538,695,88,134,222,0.7729885057471264,18.16997080287073
Task_47262,1723,119,136,198,334,14.358333333333333,35.230224553831384
Task_47263,1939,650,139,197,336,2.978494623655914,40.88658660917698
Task_47264,746,94,63,24,87,7.852631578947369,16.7186494393472
Task_47265,2457,927,120,185,305,2.6476293103448274,49.80329720039513
Task_47266,2434,857,72,123,195,2.836829836829837,48.76051161702509
Task_47267,2405,916,137,152,289,2.6226826608505998,48.82450832931702
Task_47268,1511,309,197,105,302,4.874193548387097,32.73064738989839
Task_47269,1478,934,91,184,275,1.5807486631016043,34.18587364655236
Task_47270,2061,914,56,171,227,2.2524590163934426,43.27448395534486
Task_47271,1048,384,90,38,128,2.722077922077922,24.018969982808272
Task_47272,2374,474,68,178,246,4.997894736842105,46.90255096605429
Task_47273,1326,86,74,113,187,15.241379310344827,27.852623516919568
Task_47274,1602,508,169,30,199,3.1473477406679766,33.579349139182504
Task_47275,753,932,152,72,224,0.8070739549839229,21.87835458740432
Task_47276,730,760,170,23,193,0.9592641261498029,20.583488676609754
Task_47277,638,70,191,105,296,8.985915492957746,17.37686439790404
Task_47278,2112,470,80,66,146,4.484076433121019,41.42242257065599
Task_47279,1845,731,25,81,106,2.5204918032786887,37.83748059924891
Task_47280,1647,574,60,169,229,2.8643478260869566,35.627407552996566
Task_47281,2629,293,15,101,116,8.9421768707483,49.25816725955542
Task_47282,919,790,133,166,299,1.161820480404551,24.87149618408886
Task_47283,2114,888,111,63,174,2.377952755905512,42.930870158888865
Task_47284,567,587,143,10,153,0.9642857142857143,16.905059365523382
Task_47285,2607,853,120,36,156,3.0526932084309135,50.10192235985905
Task_47286,873,72,43,113,156,11.95890410958904,20.019411365292488
Task_47287,1036,199,128,134,262,5.18,24.731091590170504
Task_47288,1161,464,79,73,152,2.496774193548387,26.386151616389345
Task_47289,2555,909,83,50,133,2.8076923076923075,49.4758815089171
Task_47290,842,584,159,19,178,1.4393162393162393,21.25063048129597
Task_47291,2926,163,30,128,158,17.841463414634145,53.16072561930839
Task_47292,2082,987,75,185,260,2.1072874493927127,43.981031876193846
Task_47293,670,81,95,42,137,8.170731707317072,16.09059868171885
Task_47294,1918,359,28,84,112,5.3277777777777775,37.99288488126846
Task_47295,2637,453,133,190,323,5.808370044052864,51.239532992406204
Task_47296,2812,1009,167,71,238,2.784158415841584,54.77972018705882
Task_47297,2504,97,80,96,176,25.551020408163264,46.16611497315373
Task_47298,2587,685,194,154,348,3.771137026239067,51.25187459019287
Task_47299,1010,99,21,194,215,10.1,23.095224083921646
Task_47300,2386,304,130,128,258,7.822950819672132,46.3841738336518
Task_47301,1630,879,59,23,82,1.8522727272727273,33.973800875950154
Task_47302,2302,537,98,198,296,4.278810408921933,46.11187160041947
Task_47303,1188,688,151,91,242,1.7242380261248185,28.37165821927235
Task_47304,1128,778,135,185,320,1.44801026957638,28.28159226608918
Task_47305,1515,868,116,17,133,1.7433831990794015,32.55723072512774
Task_47306,1703,130,172,84,256,13.0,34.249871130694
Task_47307,2990,513,183,79,262,5.817120622568093,56.29300853074276
Task_47308,1718,554,24,94,118,3.0954954954954954,35.71211495487408
Task_47309,1462,548,151,45,196,2.663023679417122,31.41980193937373
Task_47310,1438,927,45,10,55,1.5495689655172413,30.529054129258526
Task_47311,1480,252,87,36,123,5.849802371541502,30.137342056410827
Task_47312,2211,767,110,187,297,2.87890625,45.37221977586424
Task_47313,829,107,38,26,64,7.675925925925926,18.15131787683161
Task_47314,2837,961,49,13,62,2.949064449064449,52.852580917196214
Task_47315,1939,89,98,56,154,21.544444444444444,36.45903686312876
Task_47316,2337,775,126,116,242,3.01159793814433,47.041475919796305
Task_47317,1893,944,127,84,211,2.003174603174603,40.05369075996189
Task_47318,2378,708,29,76,105,3.3540197461212977,46.15429485791492
Task_47319,2295,194,39,136,175,11.76923076923077,44.05994076142543
Task_47320,701,456,173,197,370,1.5339168490153172,20.785104307597283
Task_47321,566,332,120,175,295,1.6996996996996998,17.918680766287615
Task_47322,686,530,155,86,241,1.2919020715630884,19.7250755314305
Task_47323,2826,674,161,55,216,4.1866666666666665,53.83676142140069
Task_47324,1717,65,97,47,144,26.015151515151516,32.283539704873554
Task_47325,2826,145,78,97,175,19.356164383561644,52.0215131727947
Task_47326,550,108,170,142,312,5.045871559633028,16.301937433462363
Task_47327,1626,347,75,183,258,4.672413793103448,34.726997598277414
Task_47328,2350,236,184,20,204,9.915611814345992,44.31586241422758
Task_47329,1046,1020,19,166,185,1.0244857982370226,26.783808584811236
Task_47330,2144,803,31,33,64,2.6666666666666665,41.572915929363056
Task_47331,667,400,196,100,296,1.6633416458852868,19.625087361856185
Task_47332,2583,246,77,39,116,10.45748987854251,47.47194272532707
Task_47333,656,300,151,61,212,2.179401993355482,18.183719107688376
Task_47334,2454,673,73,135,208,3.6409495548961424,48.575409450908644
Task_47335,932,937,138,180,318,0.9936034115138592,25.64372935081516
Task_47336,2118,684,181,127,308,3.091970802919708,43.599990192813756
Task_47337,1228,804,196,175,371,1.5254658385093167,30.187426499701672
Task_47338,2142,391,126,152,278,5.464285714285714,42.94367914226194
Task_47339,1472,732,75,171,246,2.00818553888131,33.43844405140373
Task_47340,2241,880,164,104,268,2.543700340522134,45.94853008147933
Task_47341,2479,113,50,13,63,21.74561403508772,43.998352856701125
Task_47342,1769,331,26,102,128,5.328313253012048,36.04268805092527
Task_47343,868,323,132,143,275,2.6790123456790123,22.542516372270313
Task_47344,2875,511,138,135,273,5.615234375,54.8903110235637
Task_47345,1783,648,59,191,250,2.7473035439137132,38.16773523273969
Task_47346,675,584,172,93,265,1.1538461538461537,20.03759435514714
Task_47347,916,387,89,180,269,2.3608247422680413,23.57276452953876
Task_47348,1237,685,166,151,317,1.8032069970845481,29.723999410145296
Task_47349,1148,749,177,183,360,1.5306666666666666,28.711323446988942
Task_47350,2917,993,161,42,203,2.9346076458752517,55.93307566532218
Task_47351,1043,463,187,194,381,2.247844827586207,26.30836063962882
Task_47352,2141,377,171,127,298,5.664021164021164,42.935109426086036
Task_47353,2793,75,20,35,55,36.75,48.44759699123196
Task_47354,1028,421,160,123,283,2.4360189573459716,25.39251680366824
Task_47355,776,763,96,90,186,1.0157068062827226,21.553343157970474
Task_47356,1331,961,192,154,346,1.3835758835758836,32.1372566993007
Task_47357,1239,536,30,124,154,2.3072625698324023,28.206297580769316
Task_47358,2073,638,131,35,166,3.244131455399061,41.15141903239252
Task_47359,1259,340,184,148,332,3.69208211143695,29.0454246665368
Task_47360,1916,100,84,110,194,18.97029702970297,37.1456101681446
Task_47361,1087,759,154,134,288,1.430263157894737,27.354077829399184
Task_47362,1685,158,75,138,213,10.59748427672956,34.460997000998496
Task_47363,630,1020,130,75,205,0.6170421155729677,20.42758810420094
Task_47364,2782,1009,115,157,272,2.7544554455445542,55.01942345066434
Task_47365,875,726,55,112,167,1.203576341127923,23.219469582233643
Task_47366,609,249,70,154,224,2.436,18.13699684703211
Task_47367,1778,272,17,124,141,6.512820512820513,35.755289554015995
Task_47368,1548,287,54,74,128,5.375,32.258755246839485
Task_47369,2194,779,64,15,79,2.812820512820513,42.14415440891258
Task_47370,1930,169,71,150,221,11.352941176470589,38.400671467340736
Task_47371,2288,873,60,38,98,2.6178489702517163,44.51705221975168
Task_47372,949,952,124,81,205,0.9958027282266527,25.01467891327538
Task_47373,1943,824,39,21,60,2.355151515151515,38.34607376207651
Task_47374,978,990,156,66,222,0.9868819374369324,25.61213718790964
Task_47375,2572,790,51,187,238,3.2515802781289507,51.09355894213554
Task_47376,1199,996,73,67,140,1.2026078234704112,28.618327356738792
Task_47377,1930,512,70,86,156,3.7621832358674463,38.96214551108473
Task_47378,1145,296,165,51,216,3.855218855218855,25.967759328010235
Task_47379,2002,152,120,43,163,13.084967320261438,38.10171985913566
Task_47380,2227,759,159,19,178,2.930263157894737,43.73288354190089
Task_47381,1177,204,62,35,97,5.741463414634146,24.768815739378542
Task_47382,2547,584,121,66,187,4.3538461538461535,48.931980029285995
Task_47383,1584,877,77,171,248,1.8041002277904328,35.66308923546378
Task_47384,853,484,142,171,313,1.7587628865979381,23.013095980026417
Task_47385,2624,399,53,196,249,6.56,50.70048053444108
Task_47386,1800,673,11,48,59,2.6706231454005933,35.77502085383101
Task_47387,2912,725,131,193,324,4.011019283746556,56.47551652674309
Task_47388,1766,909,24,16,40,1.9406593406593406,35.5306468448462
Task_47389,2133,561,16,81,97,3.795373665480427,41.69764554968682
Task_47390,2357,444,182,109,291,5.296629213483146,46.51537106794541
Task_47391,2005,920,83,133,216,2.176981541802389,42.19547085590671
Task_47392,2397,761,138,119,257,3.145669291338583,48.020078991344995
Task_47393,1449,604,110,184,294,2.3950413223140496,32.77319097729087
Task_47394,1124,632,19,162,181,1.7756714060031595,26.960432696258593
Task_47395,2751,862,77,160,237,3.1877172653534185,54.041325954051416
Task_47396,535,229,17,38,55,2.3260869565217392,14.350752387897463
Task_47397,529,462,171,165,336,1.142548596112311,17.84187181905548
Task_47398,849,94,61,159,220,8.936842105263159,20.535490121697087
Task_47399,1036,423,147,62,209,2.443396226415094,24.609839887067267
Task_47400,2282,107,149,102,251,21.12962962962963,43.171645885314454
Task_47401,908,640,66,127,193,1.4165366614664587,23.831692208306976
Task_47402,1482,219,115,77,192,6.736363636363636,31.06710624130326
Task_47403,1810,511,15,33,48,3.53515625,35.33438754460749
Task_47404,1697,319,115,106,221,5.303125,35.34151753296435
Task_47405,2984,967,50,135,185,3.0826446280991737,57.72454410417823
Task_47406,2506,743,116,52,168,3.368279569892473,48.58491503950513
Task_47407,2661,64,132,162,294,40.93846153846154,49.07516530367291
Task_47408,2230,122,188,113,301,18.130081300813007,42.95689738320552
Task_47409,1432,576,101,150,251,2.481802426343154,32.17240128034283
Task_47410,1929,643,55,136,191,2.9953416149068324,40.12189834560843
Task_47411,1143,344,11,171,182,3.3130434782608695,26.40457197213426
Task_47412,1282,703,173,183,356,1.8210227272727273,30.715585817369128
Task_47413,1605,1012,81,146,227,1.5844027640671274,36.21713314810797
Task_47414,1448,850,13,57,70,1.701527614571093,31.019369723368726
Task_47415,1929,974,172,124,296,1.9784615384615385,41.452851137896
Task_47416,512,539,151,40,191,0.9481481481481482,16.47740990968666
Task_47417,1113,616,48,91,139,1.8038897893030794,26.397557120141283
Task_47418,964,386,10,49,59,2.490956072351421,21.63285421699185
Task_47419,1046,350,171,84,255,2.9800569800569803,24.974045515938744
Task_47420,701,140,194,59,253,4.971631205673759,18.316445978170826
Task_47421,1988,168,125,74,199,11.763313609467456,38.68438314740925
Task_47422,1972,832,44,158,202,2.36734693877551,41.33193200644772
Task_47423,740,719,173,52,225,1.0277777777777777,20.936704446724917
Task_47424,1313,843,140,76,216,1.5556872037914693,30.46398642927282
Task_47425,2570,1014,175,163,338,2.5320197044334973,51.98165683417236
Task_47426,2983,349,189,166,355,8.522857142857143,56.474513297133285
Task_47427,2267,625,91,85,176,3.621405750798722,44.70992664286356
Task_47428,1066,345,156,80,236,3.0809248554913293,25.191319659356015
Task_47429,2072,194,36,134,170,10.625641025641025,40.39916249249708
Task_47430,1526,895,195,94,289,1.703125,34.67702753282444
Task_47431,2617,333,182,34,216,7.835329341317365,49.13973172505866
Task_47432,2134,589,36,200,236,3.616949152542373,43.34477417572739
Task_47433,1927,271,160,169,329,7.084558823529412,39.39340127360897
Task_47434,891,914,169,78,247,0.9737704918032787,24.237137532509536
Task_47435,2488,643,141,117,258,3.8633540372670807,49.09096576604551
Task_47436,1816,556,15,125,140,3.2603231597845603,37.389556895600066
Task_47437,1883,243,110,31,141,7.717213114754099,36.60512853642323
Task_47438,1125,637,90,168,258,1.7633228840125392,27.595213273260622
Task_47439,1511,308,57,13,70,4.889967637540453,29.710920010740892
Task_47440,1774,221,158,41,199,7.990990990990991,35.33459100117497
Task_47441,2447,337,22,155,177,7.239644970414201,46.928318797548435
Task_47442,2460,516,177,47,224,4.758220502901354,47.28889523969445
Task_47443,553,682,61,104,165,0.8096632503660323,18.054518359498008
Task_47444,1181,433,154,90,244,2.7211981566820276,27.462987324111523
Task_47445,1655,941,148,173,321,1.756900212314225,37.17953009928356
Task_47446,715,527,31,23,54,1.3541666666666667,18.19313837032301
Task_47447,2088,813,171,181,352,2.5651105651105652,43.80660257132977
Task_47448,1389,599,119,123,242,2.315,31.48352041100999
Task_47449,2767,746,14,95,109,3.7041499330655956,52.821123628784115
Task_47450,2820,545,171,96,267,5.164835164835165,54.06890028437625
Task_47451,955,325,134,124,258,2.9294478527607364,23.82031322738929
Task_47452,945,157,36,129,165,5.981012658227848,22.250516660641406
Task_47453,830,164,63,88,151,5.03030303030303,20.074378864348713
Task_47454,1974,195,153,98,251,10.071428571428571,39.34670717154377
Task_47455,1525,1006,140,182,322,1.5143992055610724,35.30949668679147
Task_47456,1089,886,130,185,315,1.2277339346110485,27.921177588375812
Task_47457,2280,187,169,182,351,12.127659574468085,44.8790809143583
Task_47458,675,818,42,82,124,0.8241758241758241,19.75655821564274
Task_47459,1062,782,107,40,147,1.3563218390804597,25.3922389374094
Task_47460,529,798,191,160,351,0.6620775969962454,19.087764942430386
Task_47461,2941,342,165,74,239,8.574344023323615,54.771341882638076
Task_47462,1047,889,26,43,69,1.1764044943820224,24.570825851570145
Task_47463,2815,384,74,68,142,7.311688311688312,52.27923006795555
Task_47464,2140,915,73,138,211,2.336244541484716,44.37721473798589
Task_47465,1146,462,43,181,224,2.475161987041037,27.222545349133625
Task_47466,719,519,182,196,378,1.3826923076923077,21.275706259241158
Task_47467,1122,499,166,114,280,2.244,27.09981017464503
Task_47468,2902,927,113,144,257,3.127155172413793,56.57823991239669
Task_47469,1355,580,106,22,128,2.332185886402754,29.385044788314445
Task_47470,1239,530,163,145,308,2.3333333333333335,29.22132717704552
Task_47471,2072,352,89,113,202,5.8696883852691215,41.34705496013651
Task_47472,2194,145,78,105,183,15.027397260273972,41.97555532822543
Task_47473,2419,691,158,109,267,3.495664739884393,48.178680799728454
Task_47474,2209,72,29,161,190,30.26027397260274,41.60619846167628
Task_47475,1995,823,45,162,207,2.421116504854369,41.68316624266375
Task_47476,2284,536,58,154,212,4.253258845437617,45.52120962483821
Task_47477,930,726,38,76,114,1.2792297111416782,23.387191938235492
Task_47478,639,565,125,89,214,1.1289752650176679,18.974898203777816
Task_47479,2337,406,20,103,123,5.742014742014742,45.024372710295815
Task_47480,1109,624,146,46,192,1.7744,26.07355903943221
Task_47481,1307,471,126,93,219,2.7690677966101696,29.568992898064234
Task_47482,1252,633,134,139,273,1.974763406940063,29.583415660487773
Task_47483,664,159,71,58,129,4.15,17.10950541477361
Task_47484,1197,355,86,185,271,3.3623595505617976,27.934607163431092
Task_47485,513,732,38,165,203,0.6998635743519782,17.885941119576454
Task_47486,2178,349,195,169,364,6.222857142857142,43.78615537689686
Task_47487,1394,307,13,79,92,4.525974025974026,29.248739280168735
Task_47488,2333,505,155,15,170,4.6106719367588935,44.62064135088402
Task_47489,1581,908,72,42,114,1.7392739273927393,33.7597701128673
Task_47490,1794,562,41,68,109,3.186500888099467,36.436708149890926
Task_47491,974,209,113,101,214,4.6380952380952385,23.506027122565147
Task_47492,1807,732,135,26,161,2.4652114597544337,37.039482268754156
Task_47493,1347,104,181,120,301,12.82857142857143,28.713163500431524
Task_47494,1152,919,45,178,223,1.2521739130434784,28.535706242835428
Task_47495,1090,594,62,164,226,1.8319327731092436,26.84875627659496
Task_47496,2347,218,104,47,151,10.71689497716895,43.8605626567533
Task_47497,1576,731,77,63,140,2.1530054644808745,33.71083423398162
Task_47498,2764,999,193,163,356,2.764,55.09037793232483
Task_47499,2155,221,95,15,110,9.707207207207206,40.50889201514815
Task_47500,1587,663,99,184,283,2.3900602409638556,35.095894183456274
Task_47501,1335,968,74,168,242,1.3777089783281733,31.904571312885967
Task_47502,2654,94,152,103,255,27.936842105263157,48.886451106698495
Task_47503,649,345,128,28,156,1.8757225433526012,17.465772185529406
Task_47504,670,748,90,34,124,0.8945260347129506,18.98939867340003
Task_47505,2353,798,151,168,319,2.944931163954944,47.79033574120592
Task_47506,1453,187,153,100,253,7.7287234042553195,31.267931322913196
Task_47507,2566,597,63,43,106,4.290969899665551,48.0332418968808
Task_47508,812,925,98,141,239,0.8768898488120951,23.30685861726809
Task_47509,2696,715,125,140,265,3.7653631284916202,52.67866156794116
Task_47510,1479,427,112,125,237,3.455607476635514,32.344633470074726
Task_47511,1504,477,122,173,295,3.1464435146443517,33.231615095294806
Task_47512,2959,731,12,169,181,4.0423497267759565,56.38263774093016
Task_47513,2979,97,87,174,261,30.397959183673468,54.08641569932882
Task_47514,547,966,43,43,86,0.5656670113753878,17.313021837261317
Task_47515,1220,817,166,28,194,1.4914425427872862,28.430073481282765
Task_47516,1850,892,113,41,154,2.0716685330347144,38.17556821461864
Task_47517,2995,432,59,81,140,6.916859122401847,55.506122444555125
Task_47518,1952,431,133,123,256,4.518518518518518,39.92599390642465
Task_47519,1122,772,137,173,310,1.4514877102199224,28.105246832060853
Task_47520,2129,133,49,174,223,15.888059701492537,41.273397479450615
Task_47521,2928,678,154,71,225,4.312223858615611,55.519182726130204
Task_47522,1379,604,87,38,125,2.2793388429752066,29.72529712730857
Task_47523,2055,250,51,46,97,8.187250996015937,38.88907470300057
Task_47524,2784,529,153,101,254,5.252830188679245,53.37238762389586
Task_47525,2058,139,61,108,169,14.7,39.591252153382904
Task_47526,2697,361,51,11,62,7.4502762430939224,48.68493407291404
Task_47527,839,899,74,85,159,0.9322222222222222,22.7667009866978
Task_47528,2588,664,183,61,244,3.8917293233082706,50.067319257683884
Task_47529,1622,832,97,191,288,1.9471788715486193,36.2326049201779
Task_47530,854,526,15,166,181,1.6204933586337762,22.42175386658177
Task_47531,938,501,189,170,359,1.8685258964143425,24.631271196401816
Task_47532,2837,765,47,106,153,3.7036553524804177,54.214833524022765
Task_47533,2251,728,155,128,283,3.0877914951989025,45.73391301271403
Task_47534,1358,719,187,198,385,1.886111111111111,32.1220320705907
Task_47535,2691,223,53,15,68,12.013392857142858,48.060016001752864
Task_47536,2501,813,196,27,223,3.0724815724815726,48.82243389282869
Task_47537,2600,497,197,176,373,5.220883534136546,51.00200995947284
Task_47538,2071,946,115,145,260,2.1869060190073917,43.484500270752896
Task_47539,2970,973,81,60,141,3.0492813141683777,56.434459869320925
Task_47540,2135,74,36,73,109,28.466666666666665,39.262193744833816
Task_47541,2158,400,89,129,218,5.381546134663342,42.9621272107403
Task_47542,1757,105,44,58,102,16.57547169811321,33.2952180818273
Task_47543,2762,227,37,97,134,12.114035087719298,51.24633838947536
Task_47544,1643,272,44,91,135,6.018315018315018,33.605941940790785
Task_47545,2305,947,101,92,193,2.431434599156118,46.71327260542605
Task_47546,1149,760,45,109,154,1.5098554533508541,27.37199484225988
Task_47547,2484,240,88,198,286,10.307053941908714,47.951217415615105
Task_47548,756,431,170,10,180,1.75,19.50413981291272
Task_47549,1119,323,94,183,277,3.4537037037037037,26.66331509436131
Task_47550,980,570,49,42,91,1.7162872154115587,22.873597051813306
Task_47551,1025,126,71,140,211,8.070866141732283,23.781373041318492
Task_47552,2303,476,176,146,322,4.828092243186583,45.95852945355012
Task_47553,1011,114,134,58,192,8.791304347826086,22.662281364819098
Task_47554,2715,766,165,110,275,3.5397653194263365,53.141546996139404
Task_47555,857,141,180,162,342,6.035211267605634,21.7562500657051
Task_47556,2128,141,27,134,161,14.985915492957746,40.49177509007119
Task_47557,2163,551,45,68,113,3.9184782608695654,42.390009073982846
Task_47558,1435,684,110,171,281,2.0948905109489053,32.724224033930646
Task_47559,2694,893,171,183,354,3.0134228187919465,53.67036471246022
Task_47560,770,387,46,89,135,1.9845360824742269,20.14529023420281
Task_47561,880,604,20,168,188,1.4545454545454546,23.107014346330477
Task_47562,1622,248,51,65,116,6.514056224899599,32.89580947752369
Task_47563,2031,138,87,101,188,14.611510791366907,39.36652379383815
Task_47564,717,142,125,88,213,5.013986013986014,18.694993683972474
Task_47565,808,908,123,103,226,0.8888888888888888,23.062727939468218
Task_47566,2813,802,101,68,169,3.503113325031133,53.624924013634114
Task_47567,1066,891,115,125,240,1.195067264573991,27.187401033183736
Task_47568,1872,560,118,190,308,3.336898395721925,39.40488979036834
Task_47569,1138,262,14,111,125,4.326996197718631,25.709005424457658
Task_47570,820,505,70,130,200,1.6205533596837944,22.127414239731937
Task_47571,806,228,23,126,149,3.519650655021834,20.44592391598665
Task_47572,1543,661,159,66,225,2.3308157099697886,33.49390354023465
Task_47573,2246,833,90,57,147,2.693045563549161,44.560101122930156
Task_47574,1526,689,149,58,207,2.2115942028985507,33.170231233167875
Task_47575,1891,607,27,137,164,3.1101973684210527,39.05696644017921
Task_47576,1586,857,29,174,203,1.8484848484848484,35.34923814779559
Task_47577,2888,406,17,115,132,7.0958230958230954,53.78156744480331
Task_47578,2948,887,191,175,366,3.31981981981982,57.718589803202576
Task_47579,1399,197,49,77,126,7.065656565656566,29.572339261031516
Task_47580,1515,555,102,95,197,2.7248201438848922,33.0684597806697
Task_47581,1900,872,96,51,147,2.176403207331042,39.24090524472177
Task_47582,2563,377,183,143,326,6.78042328042328,49.76127432103933
Task_47583,1722,375,122,112,234,4.579787234042553,35.98908700527297
Task_47584,2719,626,64,16,80,4.33652312599681,50.20051752048732
Task_47585,1042,127,157,200,357,8.140625,24.652380760770125
Task_47586,598,724,94,145,239,0.8248275862068966,19.362719391928067
Task_47587,1225,327,136,128,264,3.7347560975609757,28.129639386149638
Task_47588,2580,246,107,129,236,10.445344129554655,49.14419852374268
Task_47589,1879,258,19,139,158,7.254826254826255,37.441070368465226
Task_47590,1292,208,121,57,178,6.181818181818182,27.604985764728994
Task_47591,2785,962,29,53,82,2.8920041536863965,52.91808130220796
Task_47592,1150,789,59,87,146,1.4556962025316456,27.40916190275276
Task_47593,902,357,58,123,181,2.5195530726256985,22.70815764692229
Task_47594,2791,641,45,34,79,4.3473520249221185,51.42603897918516
Task_47595,2462,642,36,57,93,3.828926905132193,46.90580094705351
Task_47596,1680,458,149,173,322,3.6601307189542482,36.078632806946395
Task_47597,778,455,76,198,274,1.706140350877193,21.73703066191406
Task_47598,2721,108,136,133,269,24.96330275229358,50.21942795259799
Task_47599,1843,821,170,63,233,2.2420924574209247,38.779479227416395
Task_47600,2638,352,172,194,366,7.473087818696884,51.118234200724636
Task_47601,1853,96,94,198,292,19.103092783505154,36.66790676423512
Task_47602,2611,682,145,128,273,3.822840409956076,51.2463974159671
Task_47603,1356,153,158,54,212,8.805194805194805,28.60505214782361
Task_47604,2539,694,64,185,249,3.6532374100719425,50.247227449008165
Task_47605,1897,578,92,187,279,3.2763385146804835,39.80018361057933
Task_47606,660,939,75,144,219,0.7021276595744681,21.091552396840157
Task_47607,569,857,138,46,184,0.6631701631701632,18.356567183026232
Task_47608,2699,689,103,47,150,3.911594202898551,50.98532827713254
Task_47609,676,205,156,132,288,3.2815533980582523,19.166943185294006
Task_47610,1068,394,11,159,170,2.7037974683544306,25.300691645572844
Task_47611,2785,792,20,10,30,3.511979823455233,51.253743091526815
Task_47612,1756,413,200,109,309,4.241545893719807,36.984245500359215
Task_47613,2307,267,51,55,106,8.60820895522388,43.320072096601415
Task_47614,1882,102,158,24,182,18.271844660194176,35.76736894012566
Task_47615,2426,836,96,26,122,2.898446833930705,46.981633182500055
Task_47616,2050,929,10,72,82,2.204301075268817,41.28560901027492
Task_47617,2024,812,198,161,359,2.4895448954489545,42.791730955287925
Task_47618,2130,525,41,114,155,4.0494296577946765,42.27691397445391
Task_47619,2563,291,91,51,142,8.777397260273972,47.781459237842505
Task_47620,1723,155,124,105,229,11.044871794871796,34.884598066565786
Task_47621,2807,369,17,89,106,7.5864864864864865,51.919541611499
Task_47622,2663,917,154,45,199,2.900871459694989,51.61560280075168
Task_47623,1036,590,85,57,142,1.7529610829103215,24.546742159808897
Task_47624,2619,227,154,30,184,11.486842105263158,48.46998780853098
Task_47625,986,352,91,35,126,2.7932011331444757,22.783463639705047
Task_47626,1452,425,89,161,250,3.408450704225352,32.06209620578763
Task_47627,2528,317,161,172,333,7.949685534591195,49.077202288318254
Task_47628,2849,400,42,52,94,7.104738154613466,52.29599671971287
Task_47629,1267,654,78,190,268,1.9343511450381679,30.069516988629065
Task_47630,2818,825,164,134,298,3.4116222760290555,55.09772476909742
Task_47631,2577,226,57,61,118,11.352422907488986,47.61218879187934
Task_47632,1612,838,107,174,281,1.9213349225268177,36.01268173073141
Task_47633,2816,926,43,167,210,3.0377562028047467,55.04789689373018
Task_47634,1296,483,153,175,328,2.677685950413223,30.109656435805444
Task_47635,848,886,188,48,236,0.9560315670800451,23.083269091524404
Task_47636,2611,702,176,47,223,3.7140825035561877,50.26813690128359
Task_47637,1833,741,131,61,192,2.4703504043126685,38.11574606040629
Task_47638,2136,577,103,15,118,3.6955017301038064,41.33297412555551
Task_47639,2161,492,153,52,205,4.383367139959432,42.68488183910576
Task_47640,1172,143,83,130,213,8.13888888888889,26.166154694663536
Task_47641,2261,84,154,195,349,26.6,43.2625763087953
Task_47642,1639,224,182,141,323,7.2844444444444445,34.60914280960158
Task_47643,2603,641,165,53,218,4.054517133956386,50.224495780159
Task_47644,1414,230,158,67,225,6.121212121212121,30.08566753278585
Task_47645,2532,775,92,187,279,3.2628865979381443,50.479116202413756
Task_47646,1794,889,154,41,195,2.0157303370786517,37.782285558968745
Task_47647,1726,168,183,198,381,10.21301775147929,35.852073778713326
Task_47648,1065,360,47,38,85,2.9501385041551247,23.55572427818068
Task_47649,2543,449,155,19,174,5.651111111111111,47.84416103517035
Task_47650,2485,681,128,69,197,3.6436950146627565,48.34815610560565
Task_47651,624,214,180,93,273,2.902325581395349,18.185616540302128
Task_47652,2770,355,190,129,319,7.780898876404494,52.909384558359875
Task_47653,1232,831,177,185,362,1.4807692307692308,30.30871340471218
Task_47654,672,760,83,30,113,0.8830486202365309,18.97304676924506
Task_47655,1940,663,169,182,351,2.9216867469879517,40.98894195359345
Task_47656,1978,404,31,118,149,4.883950617283951,39.488721292028636
Task_47657,1450,222,196,181,377,6.502242152466367,31.919260949572845
Task_47658,2348,557,28,90,118,4.207885304659499,45.579386639986545
Task_47659,1565,1000,145,98,243,1.5634365634365635,35.44888093387384
Task_47660,2793,99,90,177,267,27.93,51.33178398050424
Task_47661,2503,713,64,70,134,3.5056022408963585,48.40940700267683
Task_47662,1650,819,33,117,150,2.0121951219512195,35.59292978641988
Task_47663,586,593,124,158,282,0.9865319865319865,18.902868205239496
Task_47664,1839,376,27,48,75,4.877984084880636,35.420590029831466
Task_47665,2067,562,144,149,293,3.6714031971580816,42.37130678644342
Task_47666,2947,306,42,46,88,9.599348534201955,53.1116825935251
Task_47667,2250,122,34,177,211,18.29268292682927,42.94643576550155
Task_47668,1517,835,14,129,143,1.8145933014354068,33.559654668048495
Task_47669,2844,179,120,115,235,15.8,52.63689597767976
Task_47670,2809,111,93,49,142,25.080357142857142,50.08344892581555
Task_47671,2482,277,184,182,366,8.928057553956835,48.37248557355766
Task_47672,2742,215,84,95,179,12.694444444444445,51.091085640394766
Task_47673,639,361,24,30,54,1.7651933701657458,16.416303831473375
Task_47674,2584,530,134,98,232,4.866290018832392,50.1087331085414
Task_47675,1260,776,119,193,312,1.6216216216216217,30.39717279648166
Task_47676,1014,171,102,35,137,5.895348837209302,22.309961003439565
Task_47677,1786,319,143,107,250,5.58125,36.881096144395435
Task_47678,1106,702,67,150,217,1.57325746799431,27.332802243427782
Task_47679,868,177,123,114,237,4.876404494382022,21.435790071197882
Task_47680,907,556,136,124,260,1.628366247755835,23.78539816467376
Task_47681,1544,211,169,111,280,7.283018867924528,32.82444042880403
Task_47682,700,442,74,79,153,1.580135440180587,19.1304989848922
Task_47683,789,726,49,114,163,1.0852819807427785,21.755282036042853
Task_47684,2844,576,196,76,272,4.92894280762565,54.15684902600117
Task_47685,1396,762,11,136,147,1.8296199213630406,31.404856472691765
Task_47686,975,790,71,167,238,1.2326169405815424,25.546931072212658
Task_47687,2837,67,55,112,167,41.720588235294116,51.145406299642126
Task_47688,2228,213,97,19,116,10.411214953271028,41.49852983635005
Task_47689,1921,748,198,36,234,2.5647530040053406,39.53796137966361
Task_47690,1148,851,26,149,175,1.3474178403755868,28.075384875167476
Task_47691,1234,600,93,187,280,2.05324459234609,29.40903079041314
Task_47692,2316,790,123,166,289,2.9279393173198485,47.040933430312776
Task_47693,1624,919,51,101,152,1.7652173913043478,35.597595129769154
Task_47694,2855,989,125,107,232,2.8838383838383836,55.86028249034007
Task_47695,1236,1008,34,162,196,1.2249752229930624,30.016140323434737
Task_47696,880,733,158,83,241,1.1989100817438691,23.434156828282855
Task_47697,904,432,145,169,314,2.087759815242494,23.671996391149605
Task_47698,1644,1016,89,10,99,1.6165191740412979,34.75739993068367
Task_47699,1050,491,10,16,26,2.1341463414634148,22.846003779645514
Task_47700,2066,158,167,153,320,12.9937106918239,40.8181685389058
Task_47701,1564,530,162,47,209,2.945386064030132,33.07984360419891
Task_47702,1692,293,107,79,186,5.755102040816326,34.53462237585836
Task_47703,592,691,155,199,354,0.8554913294797688,19.6871566909151
Task_47704,991,683,41,113,154,1.4488304093567252,24.57189660840845
Task_47705,1008,348,86,77,163,2.8882521489971347,23.760561753721475
Task_47706,1897,874,111,151,262,2.168,40.52105387480393
Task_47707,1871,230,83,156,239,8.0995670995671,37.9919399989873
Task_47708,2454,912,193,162,355,2.687842278203724,49.90058191496644
Task_47709,1574,555,70,108,178,2.8309352517985613,33.92293200320233
Task_47710,2859,768,18,94,112,3.717815344603381,54.320549180719844
Task_47711,2030,116,179,73,252,17.35042735042735,39.037590121358726
Task_47712,1373,308,27,131,158,4.44336569579288,29.661320325142082
Task_47713,1614,116,172,91,263,13.794871794871796,32.82691145864177
Task_47714,2961,882,110,64,174,3.3533408833522085,56.34020210717862
Task_47715,1350,884,100,10,110,1.5254237288135593,29.789757832796038
Task_47716,1260,256,128,154,282,4.902723735408561,28.567332068208298
Task_47717,1276,490,165,29,194,2.5987780040733197,28.340410631204918
Task_47718,519,982,114,182,296,0.5279755849440488,19.303669162604184
Task_47719,2203,714,155,160,315,3.081118881118881,45.12068381759796
Task_47720,846,366,199,39,238,2.3051771117166213,21.29219959457342
Task_47721,2111,401,175,105,280,5.251243781094527,42.42615869012638
Task_47722,2743,922,184,81,265,2.971830985915493,53.663688945006705
Task_47723,1299,1011,80,147,227,1.283596837944664,31.334225234076907
Task_47724,2729,797,178,24,202,3.419799498746867,52.27572769634696
Task_47725,944,680,109,148,257,1.3861967694566812,24.7242014357399
Task_47726,941,662,108,144,252,1.4193061840120664,24.5923731283933
Task_47727,1218,681,99,120,219,1.7859237536656891,28.925131096185222
Task_47728,1594,72,176,116,292,21.835616438356166,32.330028213039945
Task_47729,2154,96,166,105,271,22.20618556701031,41.11619649494353
Task_47730,2740,352,132,109,241,7.762039660056657,52.04370284783469
Task_47731,1038,711,44,133,177,1.4578651685393258,25.710890000653603
Task_47732,902,265,75,136,211,3.3909774436090228,22.729611197632142
Task_47733,1266,670,186,99,285,1.886736214605067,29.901322600922995
Task_47734,747,598,31,159,190,1.2470784641068446,20.965698021671454
Task_47735,2079,814,198,11,209,2.550920245398773,41.98269540934843
Task_47736,610,255,140,148,288,2.3828125,18.311376540841362
Task_47737,1545,172,156,121,277,8.93063583815029,32.335196139712146
Task_47738,927,481,141,197,338,1.9232365145228216,24.33934149742056
Task_47739,1040,476,18,112,130,2.180293501048218,24.777555461787756
Task_47740,2283,634,143,81,224,3.5952755905511813,45.28648326439559
Task_47741,1473,205,15,132,147,7.150485436893204,30.86404375435393
Task_47742,2602,547,173,53,226,4.748175182481752,49.944677458557095
Task_47743,1613,702,94,22,116,2.294452347083926,33.6499568119471
Task_47744,1703,512,111,60,171,3.3196881091617936,35.03052018285172
Task_47745,2265,752,53,95,148,3.00796812749004,45.25336883928632
Task_47746,869,715,60,10,70,1.2136871508379887,20.886274754812536
Task_47747,1785,427,91,186,277,4.170560747663552,37.506347717383
Task_47748,2807,229,60,150,210,12.204347826086957,52.70665836214107
Task_47749,875,873,57,187,244,1.0011441647597255,24.23193822524249
Task_47750,848,806,156,194,350,1.050805452292441,24.020995325306973
Task_47751,2923,404,178,63,241,7.217283950617284,54.58654190929288
Task_47752,564,608,73,196,269,0.9261083743842364,18.673333900100143
Task_47753,2605,957,128,71,199,2.719206680584551,51.161450818139826
Task_47754,2013,654,19,128,147,3.073282442748092,40.801694816223964
Task_47755,2908,220,67,154,221,13.158371040723981,54.315769943639935
Task_47756,1639,533,121,32,153,3.0692883895131087,33.72738892637991
Task_47757,1252,882,187,189,376,1.4178935447338619,30.827154610400452
Task_47758,2079,881,111,109,220,2.357142857142857,43.1757639590845
Task_47759,1831,341,167,45,212,5.353801169590644,36.66629815932827
Task_47760,2915,839,87,130,217,3.4702380952380953,56.31613454086608
Task_47761,951,464,100,185,285,2.0451612903225804,24.409380696409197
Task_47762,1161,977,26,162,188,1.187116564417178,28.731827364812347
Task_47763,2583,827,199,103,302,3.119565217391304,51.35330786742446
Task_47764,1777,189,200,174,374,9.352631578947369,36.95051592537164
Task_47765,2624,943,90,32,122,2.7796610169491527,50.48248926665547
Task_47766,662,983,90,97,187,0.6727642276422764,21.009005875877577
Task_47767,2325,478,65,100,165,4.853862212943633,45.587828209898134
Task_47768,695,132,73,137,210,5.225563909774436,18.579814937944775
Task_47769,1684,204,196,162,358,8.214634146341464,35.43534466932618
Task_47770,2656,517,84,116,200,5.127413127413128,51.132947223870495
Task_47771,2156,850,167,108,275,2.533490011750881,44.54550525089174
Task_47772,2486,564,155,65,220,4.4,48.12030781976036
Task_47773,2417,412,92,184,276,5.852300242130751,47.479826980048244
Task_47774,1685,66,132,165,297,25.149253731343283,33.91056229883705
Task_47775,1011,547,81,42,123,1.844890510948905,23.652180479919874
Task_47776,1350,412,32,183,215,3.2687651331719128,30.280629503061817
Task_47777,710,294,139,105,244,2.406779661016949,19.755873752536914
Task_47778,2240,129,17,190,207,17.23076923076923,42.71968022033548
Task_47779,1045,273,40,140,180,3.8138686131386863,24.57669128402254
Task_47780,1026,477,89,65,154,2.1464435146443517,24.122790864509664
Task_47781,2996,1011,122,151,273,2.960474308300395,58.412675589813375
Task_47782,1361,602,42,153,195,2.257048092868988,30.895286089058743
Task_47783,582,416,185,112,297,1.39568345323741,18.29732439546844
Task_47784,2659,389,13,169,182,6.817948717948718,50.58677023892238
Task_47785,632,782,93,22,115,0.8071519795657727,18.456465960081225
Task_47786,2111,717,80,144,224,2.9401114206128134,43.366448400016615
Task_47787,1880,1024,81,93,174,1.8341463414634147,40.199124895633915
Task_47788,1226,833,101,163,264,1.4700239808153477,29.73479781381828
Task_47789,2575,270,113,61,174,9.501845018450185,48.16705131722704
Task_47790,2367,396,93,116,209,5.962216624685139,46.26853781824071
Task_47791,2267,865,199,48,247,2.6177829099307157,45.44803473796768
Task_47792,639,890,62,131,193,0.7171717171717171,20.44066151029055
Task_47793,532,596,13,116,129,0.8911222780569514,17.159510932419263
Task_47794,2174,745,48,21,69,2.9142091152815013,41.80396191183638
Task_47795,912,678,31,165,196,1.3431516936671575,23.97385194633029
Task_47796,1341,613,184,23,207,2.1840390879478826,29.74122442937673
Task_47797,2013,505,13,117,130,3.9782608695652173,40.36758709694809
Task_47798,1626,740,114,20,134,2.194331983805668,33.95905733469014
Task_47799,2302,649,44,119,163,3.5415384615384617,45.57931392453512
Task_47800,518,307,117,48,165,1.6818181818181819,15.569682709900187
Task_47801,2895,854,104,34,138,3.3859649122807016,54.57584341385631
Task_47802,2484,339,148,123,271,7.305882352941176,48.10576907927187
Task_47803,1163,112,119,45,164,10.29203539823009,24.395852004956396
Task_47804,1259,634,167,111,278,1.9826771653543307,29.678896076565824
Task_47805,2483,586,192,40,232,4.229982964224872,47.91567537321486
Task_47806,530,754,145,62,207,0.7019867549668874,17.75695407454387
Task_47807,2405,923,96,145,241,2.6028138528138527,48.672599829604216
Task_47808,771,473,61,131,192,1.6265822784810127,21.2045964989669
Task_47809,2649,816,68,87,155,3.2423500611995104,51.31358446804103
Task_47810,1866,285,144,91,235,6.524475524475524,37.793517280198316
Task_47811,837,333,179,116,295,2.5059880239520957,22.13481103083348
Task_47812,1496,748,111,58,169,1.9973297730307076,32.512323010387945
Task_47813,1523,719,68,128,196,2.1152777777777776,33.90355020106278
Task_47814,2608,283,68,93,161,9.183098591549296,49.099364496607855
Task_47815,1735,74,56,196,252,23.133333333333333,34.60784456383961
Task_47816,2718,935,64,145,209,2.9038461538461537,53.600723374557354
Task_47817,855,825,24,142,166,1.0351089588377724,23.049773902310303
Task_47818,2751,739,46,194,240,3.7175675675675675,53.62646381406444
Task_47819,1981,842,65,24,89,2.3499406880189797,39.465052898862005
Task_47820,1525,640,47,166,213,2.3790951638065523,33.74864512726723
Task_47821,2475,267,114,127,241,9.235074626865671,47.581850231395265
Task_47822,1120,126,166,59,225,8.818897637795276,24.696006846852224
Task_47823,2884,881,170,43,213,3.2698412698412698,55.10641409528127
Task_47824,702,517,13,130,143,1.3552123552123552,19.635073671403557
Task_47825,510,394,181,83,264,1.2911392405063291,16.609366984888926
Task_47826,2177,159,126,194,320,13.60625,42.631348018516974
Task_47827,1905,283,33,72,105,6.707746478873239,37.2374864072726
Task_47828,2418,802,168,165,333,3.0112079701120797,48.89137541348555
Task_47829,2275,645,32,171,203,3.521671826625387,45.59461238482246
Task_47830,1617,302,156,191,347,5.336633663366337,34.712177576144136
Task_47831,1853,773,48,177,225,2.3940568475452197,39.5035877266636
Task_47832,2813,407,176,172,348,6.894607843137255,53.959099137706424
Task_47833,1975,343,24,47,71,5.741279069767442,37.452964634145324
Task_47834,1507,521,19,82,101,2.8869731800766285,31.802944317612397
Task_47835,2346,669,33,71,104,3.5014925373134327,45.4631995014445
Task_47836,1297,639,131,102,233,2.0265625,30.08035654875898
Task_47837,2657,123,24,70,94,21.427419354838708,47.70461255257786
Task_47838,1924,627,78,188,266,3.0636942675159236,40.3785947486978
Task_47839,2032,649,156,125,281,3.126153846153846,42.00299081051374
Task_47840,2202,706,53,49,102,3.1145685997171144,42.758692171125006
Task_47841,547,87,56,119,175,6.215909090909091,15.56780028956174
Task_47842,2315,424,61,32,93,5.447058823529412,43.51271403818122
Task_47843,1402,387,183,31,214,3.61340206185567,30.086266946547386
Task_47844,2607,330,40,126,166,7.876132930513595,49.389269545987325
Task_47845,2208,213,37,120,157,10.317757009345794,42.485000140608385
Task_47846,2067,867,170,33,203,2.3813364055299537,42.08330136115652
Task_47847,2198,868,16,25,41,2.529344073647871,42.479337506876576
Task_47848,1441,963,11,43,54,1.4948132780082988,31.04631738091891
Task_47849,1148,786,128,45,173,1.4587039390088945,27.00761057187356
Task_47850,982,837,195,130,325,1.171837708830549,26.07965065433228
Task_47851,706,963,43,168,211,0.7323651452282157,21.613119674541746
Task_47852,1212,91,95,18,113,13.173913043478262,24.462703490899006
Task_47853,1821,555,177,170,347,3.2751798561151078,38.7279405973791
Task_47854,1656,850,52,162,214,1.945945945945946,36.597395787105896
Task_47855,998,737,29,195,224,1.3523035230352303,25.695268904510655
Task_47856,2463,302,52,145,197,8.128712871287128,47.5144301656137
Task_47857,2652,285,45,80,125,9.272727272727273,49.476233466241375
Task_47858,1972,169,107,144,251,11.6,39.0651315534459
Task_47859,2855,329,30,81,111,8.651515151515152,52.68432115804804
Task_47860,2292,196,189,52,241,11.634517766497462,43.884295394664036
Task_47861,1014,525,30,42,72,1.9277566539923954,22.84114926314862
Task_47862,2181,802,33,34,67,2.7160647571606478,42.18011847438495
Task_47863,2959,546,165,111,276,5.409506398537477,56.312002799297545
Task_47864,2056,262,109,135,244,7.817490494296578,40.96753909598318
Task_47865,1825,1012,38,59,97,1.8015794669299112,37.962465920280486
Task_47866,2300,812,64,27,91,2.8290282902829027,44.428706347685875
Task_47867,1602,214,62,85,147,7.4511627906976745,32.78309369709276
Task_47868,571,810,21,93,114,0.7040690505548706,18.273913917262032
Task_47869,2636,178,103,187,290,14.726256983240223,49.69569973985898
Task_47870,1780,463,12,106,118,3.836206896551724,36.36106770033922
Task_47871,975,695,119,119,238,1.4008620689655173,25.13370265615076
Task_47872,2944,445,123,81,204,6.6008968609865475,55.05305532137626
Task_47873,1920,757,196,197,393,2.532981530343008,41.178182520128914
Task_47874,2201,945,81,106,187,2.3266384778012683,45.221573966386444
Task_47875,2293,459,40,194,234,4.984782608695652,45.43131491200842
Task_47876,1353,279,25,92,117,4.832142857142857,29.017431659442618
Task_47877,943,713,93,39,132,1.3207282913165266,23.40706412882356
Task_47878,2426,84,105,101,206,28.541176470588237,45.06706577369254
Task_47879,2820,116,95,123,218,24.102564102564102,51.8223226595085
Task_47880,2905,935,149,82,231,3.1036324786324787,56.15942508569009
Task_47881,877,513,98,92,190,1.706225680933852,22.7167497693884
Task_47882,1977,693,74,168,242,2.8487031700288186,41.28930205067814
Task_47883,2559,1007,73,161,234,2.5386904761904763,51.44084698535386
Task_47884,874,603,133,69,202,1.4470198675496688,22.56654791102063
Task_47885,571,97,66,58,124,5.826530612244898,14.801851567693197
Task_47886,2071,952,82,51,133,2.1731374606505773,42.155979399930544
Task_47887,1653,104,158,184,342,15.742857142857142,33.7998949163095
Task_47888,1983,194,175,35,210,10.169230769230769,38.58107673770098
Task_47889,1659,808,136,13,149,2.050679851668727,34.774729528162666
Task_47890,2552,394,120,41,161,6.460759493670886,47.77140762652461
Task_47891,772,157,116,82,198,4.886075949367089,19.537483540203485
Task_47892,983,369,158,138,296,2.656756756756757,24.595874436872407
Task_47893,1364,714,96,41,137,1.9076923076923078,29.96706545684094
Task_47894,1716,529,30,157,187,3.237735849056604,36.246443681684866
Task_47895,536,674,76,51,127,0.794074074074074,17.00655584371816
Task_47896,2749,908,53,84,137,3.024202420242024,53.171724464505694
Task_47897,2223,954,111,133,244,2.3277486910994765,45.82832377343374
Task_47898,2197,922,101,53,154,2.380281690140845,44.09059210391471
Task_47899,2240,697,177,177,354,3.2091690544412605,45.85400380614698
Task_47900,613,359,156,12,168,1.7027777777777777,16.946953704213342
Task_47901,1590,210,72,103,175,7.535545023696683,33.123221467166296
Task_47902,2442,744,102,154,256,3.2778523489932887,48.72633959382521
Task_47903,939,561,20,72,92,1.6708185053380782,22.726948857004416
Task_47904,1139,355,191,66,257,3.199438202247191,26.27481095663587
Task_47905,2613,496,191,57,248,5.257545271629779,49.966880505976384
Task_47906,1963,616,156,26,182,3.1815235008103726,39.328937516971784
Task_47907,660,997,128,42,170,0.6613226452905812,20.12037771797478
Task_47908,1603,840,157,196,353,1.906064209274673,36.23306664564419
Task_47909,2056,981,68,92,160,2.0936863543788187,42.571315270465
Task_47910,2359,692,134,58,192,3.404040404040404,46.30676632138272
Task_47911,2776,582,131,200,331,4.761578044596913,53.90838605256469
Task_47912,2850,639,163,200,363,4.453125,55.40661349949706
Task_47913,1684,549,21,76,97,3.061818181818182,34.49080661887002
Task_47914,2304,721,98,45,143,3.1911357340720223,44.79807410843267
Task_47915,2340,485,199,65,264,4.814814814814815,45.75316367999972
Task_47916,1307,219,162,167,329,5.9409090909090905,29.41363437236809
Task_47917,1063,410,145,169,314,2.586374695863747,26.118667180113892
Task_47918,1017,460,190,90,280,2.2060737527114966,25.114894176404608
Task_47919,912,449,179,138,317,2.026666666666667,23.820221168816573
Task_47920,2805,506,12,80,92,5.5325443786982245,52.205884747713945
Task_47921,962,920,101,107,208,1.0445168295331162,25.412513150920436
Task_47922,882,921,11,163,174,0.9566160520607375,24.002680506613043
Task_47923,648,603,137,43,180,1.0728476821192052,18.441592911518814
Task_47924,2030,581,44,174,218,3.4879725085910653,41.55796269718305
Task_47925,2778,480,95,156,251,5.775467775467775,53.25552262996851
Task_47926,1249,258,191,144,335,4.822393822393822,28.624472747837885
Task_47927,708,217,24,141,165,3.2477064220183487,19.141611275593007
Task_47928,2692,190,26,124,150,14.094240837696335,49.974268184139724
Task_47929,615,910,138,141,279,0.6750823271130626,20.443030631396798
Task_47930,1575,345,105,29,134,4.5520231213872835,32.11387638864731
Task_47931,745,712,37,112,149,1.0448807854137447,20.70547302317346
Task_47932,2292,131,62,159,221,17.363636363636363,43.78292788880836
Task_47933,1459,925,138,181,319,1.5755939524838012,33.99749302459857
Task_47934,950,361,96,70,166,2.6243093922651934,22.834997343770425
Task_47935,2540,424,64,19,83,5.976470588235294,46.733745714253665
Task_47936,1555,126,195,103,298,12.244094488188976,32.34173099559962
Task_47937,2575,550,14,41,55,4.673321234119782,47.71700312519431
Task_47938,2161,561,96,185,281,3.8451957295373664,43.90813433960246
Task_47939,2037,479,65,174,239,4.24375,41.549743197680414
Task_47940,2389,206,14,172,186,11.541062801932368,45.727927244467104
Task_47941,1572,807,44,121,165,1.9455445544554455,34.61986602492746
Task_47942,2315,849,96,17,113,2.723529411764706,45.036263026063175
Task_47943,2837,721,80,91,171,3.9293628808864267,54.209884949122646
Task_47944,1963,512,194,176,370,3.8265107212475633,40.95198808999554
Task_47945,766,489,158,15,173,1.563265306122449,19.861214882301592
Task_47946,715,921,85,37,122,0.7754880694143167,20.138538629631793
Task_47947,919,730,44,107,151,1.2571819425444597,23.51707825010459
Task_47948,1774,209,197,176,373,8.447619047619048,36.96283167826888
Task_47949,1276,607,164,60,224,2.098684210526316,29.021676825714255
Task_47950,994,288,16,75,91,3.4394463667820068,22.70925095894782
Task_47951,1633,664,97,66,163,2.4556390977443607,34.52695930640599
Task_47952,1745,779,46,63,109,2.2371794871794872,36.27836241371456
Task_47953,987,352,33,44,77,2.7960339943342776,21.81616814901463
Task_47954,680,371,93,160,253,1.8279569892473118,19.759057674451324
Task_47955,1247,645,65,125,190,1.9303405572755419,29.261078881806082
Task_47956,775,542,124,135,259,1.427255985267035,21.60833212932286
Task_47957,1810,150,47,102,149,11.986754966887418,35.44950852291151
Task_47958,2718,827,166,174,340,3.282608695652174,53.767562408514245
Task_47959,1593,871,13,138,151,1.826834862385321,34.904112719336915
Task_47960,1281,866,148,79,227,1.4775086505190311,30.13059468260899
Task_47961,2899,654,73,186,259,4.425954198473282,55.86817156281543
Task_47962,2132,106,25,124,149,19.925233644859812,39.972687937203276
Task_47963,2568,146,172,189,361,17.46938775510204,48.83374601254872
Task_47964,1602,936,110,31,141,1.7097118463180363,34.362886063367135
Task_47965,2721,982,11,142,153,2.768056968463886,53.067727745005584
Task_47966,2329,283,101,166,267,8.200704225352112,45.50573189254154
Task_47967,1069,778,180,134,314,1.3722721437740693,27.252050858673453
Task_47968,1370,965,18,75,93,1.4182194616977226,30.725059117377853
Task_47969,1655,89,158,46,204,18.38888888888889,32.25398736536184
Task_47970,1741,671,44,175,219,2.5907738095238093,37.27050947356533
Task_47971,1109,923,150,176,326,1.2002164502164503,28.430201598495955
Task_47972,1179,266,101,155,256,4.415730337078652,27.205151507611887
Task_47973,511,482,56,98,154,1.0579710144927537,16.359147984285535
Task_47974,2795,133,26,132,158,20.85820895522388,50.817392316540605
Task_47975,1160,79,112,159,271,14.5,25.56893558414697
Task_47976,1663,130,127,85,212,12.694656488549619,33.442255998690825
Task_47977,1658,488,160,151,311,3.390593047034765,35.74433107042193
Task_47978,1428,176,101,138,239,8.067796610169491,30.309815759603012
Task_47979,1022,160,77,157,234,6.3478260869565215,24.12390181590814
Task_47980,813,250,148,100,248,3.239043824701195,21.25201537005121
Task_47981,634,457,16,38,54,1.3842794759825328,16.714438360499553
Task_47982,1624,400,67,167,234,4.049875311720698,34.72260613003997
Task_47983,1748,926,79,115,194,1.8856526429341964,38.09332977181126
Task_47984,2159,945,133,132,265,2.2822410147991543,44.87932644529701
Task_47985,2444,373,146,193,339,6.53475935828877,47.997057345862366
Task_47986,695,581,22,37,59,1.1941580756013745,18.03880793413566
Task_47987,877,192,108,90,198,4.544041450777202,21.7169783266333
Task_47988,2643,395,42,65,107,6.674242424242424,49.24731409437073
Task_47989,2890,746,138,63,201,3.8688085676037485,54.987306259441766
Task_47990,2256,457,56,194,250,4.925764192139738,45.05753966524977
Task_47991,1576,998,26,100,126,1.5775775775775776,34.943588770174664
Task_47992,2768,392,68,163,231,7.043256997455471,52.77849990574901
Task_47993,1690,175,179,189,368,9.602272727272727,35.11794972847246
Task_47994,2670,293,130,160,290,9.081632653061224,51.026688894217955
Task_47995,2906,140,27,10,37,20.609929078014183,50.843985227523355
Task_47996,2932,865,121,14,135,3.3856812933025404,55.05898326033915
Task_47997,2683,901,39,133,172,2.97450110864745,52.56834841587241
Task_47998,2867,497,124,178,302,5.757028112449799,54.911858866719264
Task_47999,2300,150,183,94,277,15.2317880794702,44.07962059319514
Task_48000,940,293,61,30,91,3.197278911564626,21.257673126371927
Task_48001,2871,384,75,155,230,7.457142857142857,54.37885279332442
Task_48002,1325,386,69,82,151,3.4237726098191215,28.91676810971219
Task_48003,2509,693,100,38,138,3.615273775216138,47.97649574021801
Task_48004,2173,506,168,15,183,4.285996055226825,42.17118180264569
Task_48005,667,227,15,152,167,2.925438596491228,18.43711979546086
Task_48006,2634,115,81,82,163,22.70689655172414,48.23107600454778
Task_48007,1559,643,107,200,307,2.420807453416149,34.7196784007736
Task_48008,2367,166,18,146,164,14.173652694610778,44.603327347004345
Task_48009,2512,949,119,149,268,2.6442105263157893,50.523929226211145
Task_48010,2397,668,70,19,89,3.5829596412556053,45.456769165584205
Task_48011,512,588,148,198,346,0.8692699490662139,18.06362589386515
Task_48012,1998,606,59,74,133,3.2915980230642505,40.28528561353833
Task_48013,774,658,180,127,307,1.1745068285280729,22.14412451265098
Task_48014,2931,709,189,172,361,4.128169014084507,56.86183539325388
Task_48015,2550,409,138,150,288,6.219512195121951,49.501296204793924
Task_48016,2234,987,99,53,152,2.2611336032388665,44.865483257408364
Task_48017,2103,967,114,23,137,2.1725206611570247,42.367991340869715
Task_48018,2989,448,61,129,190,6.657015590200445,56.222273482265685
Task_48019,681,631,164,110,274,1.0775316455696202,20.35126933444162
Task_48020,1414,967,194,111,305,1.4607438016528926,33.22331908817775
Task_48021,1615,153,172,22,194,10.487012987012987,32.237534215599105
Task_48022,972,339,68,76,144,2.8588235294117648,23.11443536351886
Task_48023,2601,73,25,154,179,35.148648648648646,47.538905457260334
Task_48024,2066,839,59,21,80,2.4595238095238097,40.643366987042604
Task_48025,2122,654,192,138,330,3.23969465648855,43.68413278278073
Task_48026,2373,465,14,10,24,5.092274678111588,43.72412704891195
Task_48027,2479,486,181,12,193,5.090349075975359,47.2134170294292
Task_48028,2361,718,159,166,325,3.2837273991655076,47.68997965114699
Task_48029,1255,190,147,196,343,6.570680628272251,28.602888081323737
Task_48030,894,206,167,85,252,4.318840579710145,22.10584114828627
Task_48031,739,876,88,79,167,0.8426453819840365,21.150324187327637
Task_48032,2104,174,193,38,231,12.022857142857143,40.31783045036603
Task_48033,695,873,135,34,169,0.7951945080091534,20.056099522311246
Task_48034,1490,659,143,53,196,2.257575757575758,32.55372459228021
Task_48035,1583,595,177,80,257,2.6560402684563758,34.262569317477684
Task_48036,2064,505,100,29,129,4.07905138339921,40.37828308654506
Task_48037,2880,201,116,58,174,14.257425742574258,52.73071624093922
Task_48038,2281,764,11,135,146,2.981699346405229,45.425448879466124
Task_48039,1798,926,155,140,295,1.9395900755124056,39.2467664853351
Task_48040,1789,506,142,34,176,3.5285996055226825,36.25809688132554
Task_48041,1880,774,15,161,176,2.425806451612903,39.45669283508587
Task_48042,1107,225,156,159,315,4.898230088495575,26.201122913053894
Task_48043,665,346,72,157,229,1.9164265129682998,19.34529309437617
Task_48044,2226,981,154,81,235,2.2668024439918533,45.519974599690705
Task_48045,1328,505,127,25,152,2.624505928853755,28.645264937148863
Task_48046,1123,202,170,101,271,5.532019704433497,26.090880514903102
Task_48047,1974,396,100,158,258,4.972292191435768,40.22051084146788
Task_48048,766,180,23,154,177,4.232044198895028,19.440670174669403
Task_48049,1083,1009,132,79,211,1.0722772277227723,27.332452882581453
Task_48050,1220,933,147,196,343,1.3062098501070665,30.341130933033416
Task_48051,2917,297,122,87,209,9.788590604026846,54.219673255072216
Task_48052,2527,126,33,111,144,19.89763779527559,46.438989331778096
Task_48053,519,447,27,158,185,1.1584821428571428,16.782126591599724
Task_48054,728,458,23,164,187,1.5860566448801743,20.40802933987691
Task_48055,943,666,97,92,189,1.4137931034482758,24.173195189152338
Task_48056,504,387,41,11,52,1.2989690721649485,14.081027231304674
Task_48057,2611,254,125,57,182,10.239215686274509,48.626884818872874
Task_48058,1598,280,196,16,212,5.686832740213523,32.649295238711446
Task_48059,820,596,57,70,127,1.373534338358459,21.32258824456672
Task_48060,933,733,113,81,194,1.271117166212534,24.019855524919674
Task_48061,1739,453,127,21,148,3.8303964757709252,34.96020867473802
Task_48062,2573,596,117,60,177,4.309882747068677,49.12381549021439
Task_48063,2941,677,169,11,180,4.337758112094395,54.8948432471326
Task_48064,1438,81,178,62,240,17.536585365853657,29.21028085049325
Task_48065,1835,659,124,55,179,2.7803030303030303,37.738273639679434
Task_48066,1045,94,160,90,250,11.0,23.51557866856911
Task_48067,2691,101,35,166,201,26.38235294117647,49.47724104537278
Task_48068,839,553,52,90,142,1.5144404332129964,21.85053824246113
Task_48069,2824,943,108,200,308,2.9915254237288136,55.70423675532478
Task_48070,2085,807,82,168,250,2.5804455445544554,43.353960500596486
Task_48071,1863,995,102,63,165,1.8704819277108433,39.26848769359827
Task_48072,705,611,154,190,344,1.1519607843137254,21.164515129839177
Task_48073,1992,475,47,194,241,4.184873949579832,40.787925110753314
Task_48074,2854,586,77,185,262,4.862010221465076,54.94933499998718
Task_48075,1961,278,118,143,261,7.028673835125448,39.610549555034325
Task_48076,2506,730,187,95,282,3.4281805745554035,49.69869455000415
Task_48077,706,621,177,128,305,1.135048231511254,20.944737209050626
Task_48078,1880,613,41,67,108,3.0618892508143323,37.92564655046064
Task_48079,2872,443,94,41,135,6.468468468468468,53.02253502283593
Task_48080,2941,386,162,174,336,7.5994832041343665,55.86269893491211
Task_48081,631,413,31,79,110,1.5241545893719808,17.69072636884367
Task_48082,1432,135,31,171,202,10.529411764705882,30.117264466469866
Task_48083,1729,786,67,48,115,2.1969504447268107,35.77872778099053
Task_48084,1332,507,174,161,335,2.622047244094488,30.766429535506443
Task_48085,2362,1019,35,161,196,2.315686274509804,48.087488436223424
Task_48086,2427,536,180,35,215,4.5195530726256985,46.80001753602912
Task_48087,3000,718,84,17,101,4.172461752433936,55.25494498533072
Task_48088,1634,94,146,159,305,17.2,33.18291386647266
Task_48089,652,915,51,112,163,0.7117903930131004,20.39098517975444
Task_48090,2645,817,177,46,223,3.2334963325183375,51.1597464697034
Task_48091,2046,266,141,135,276,7.662921348314606,40.96787286365289
Task_48092,2936,252,123,177,300,11.604743083003953,55.15035923358382
Task_48093,1604,974,17,70,87,1.6451282051282052,34.344202329581094
Task_48094,2668,755,39,143,182,3.5291005291005293,51.82164101678999
Task_48095,755,948,66,199,265,0.7955742887249737,22.785482038835642
Task_48096,1055,733,104,35,139,1.4373297002724796,25.04494921643933
Task_48097,1015,290,96,68,164,3.4879725085910653,23.680293298069717
Task_48098,2829,967,132,184,316,2.9225206611570247,55.871049625937985
Task_48099,2467,453,154,66,220,5.433920704845815,47.44002264003094
Task_48100,2548,899,56,100,156,2.831111111111111,50.19828758345293
Task_48101,1789,123,154,105,259,14.42741935483871,35.82176302668987
Task_48102,571,491,162,165,327,1.160569105691057,18.556448499945812
Task_48103,2251,561,126,156,282,4.005338078291815,45.24240735515815
Task_48104,1254,355,195,94,289,3.5224719101123596,28.686400804749862
Task_48105,2048,312,18,109,127,6.543130990415335,40.15834949828237
Task_48106,1512,174,50,13,63,8.64,29.322208527224607
Task_48107,2355,708,87,48,135,3.321579689703808,45.59625732028584
Task_48108,1227,220,168,114,282,5.552036199095022,27.864285899315618
Task_48109,1883,512,184,133,317,3.6705653021442495,39.383513427844825
Task_48110,1127,265,128,109,237,4.2368421052631575,26.226962832657502
Task_48111,1300,156,136,130,266,8.280254777070065,28.456521591189148
Task_48112,1117,911,125,104,229,1.224780701754386,27.93592203215893
Task_48113,2893,937,133,34,167,3.0842217484008527,55.05915227991422
Task_48114,2813,591,190,156,346,4.7516891891891895,54.52624969014651
Task_48115,1446,81,167,181,348,17.634146341463413,30.431472421466683
Task_48116,1398,846,94,167,261,1.6505312868949233,32.616876757097025
Task_48117,907,293,20,135,155,3.0850340136054424,22.17636261045334
Task_48118,1786,448,101,103,204,3.977728285077951,37.0898851390908
Task_48119,1057,542,28,152,180,1.9465930018416207,25.67349374522348
Task_48120,1992,86,62,92,154,22.896551724137932,37.61989628865383
Task_48121,1085,623,144,39,183,1.7387820512820513,25.445457273514577
Task_48122,535,976,51,81,132,0.5475946775844421,18.44357177409157
Task_48123,646,110,70,116,186,5.81981981981982,17.135923330088243
Task_48124,1685,216,169,141,310,7.764976958525345,35.24806922816189
Task_48125,766,112,31,12,43,6.778761061946903,16.92453255685344
Task_48126,2833,66,70,23,93,42.28358208955224,48.990207148620556
Task_48127,2138,469,133,82,215,4.548936170212766,42.46465801549407
Task_48128,1882,288,122,146,268,6.5121107266435985,38.43222509859274
Task_48129,1761,435,71,88,159,4.0389908256880735,36.03871092233694
Task_48130,1965,611,158,168,326,3.2107843137254903,41.08783776303191
Task_48131,614,622,145,83,228,0.985553772070626,18.82531903085442
Task_48132,1087,447,147,112,259,2.4263392857142856,26.2842395568543
Task_48133,2463,994,179,42,221,2.4753768844221105,48.8228100593336
Task_48134,2722,234,161,135,296,11.582978723404254,51.621114825092604
Task_48135,2241,916,109,125,234,2.4438386041439477,45.9383615653607
Task_48136,2701,808,114,40,154,3.338689740420272,51.40039933673979
Task_48137,1483,843,70,76,146,1.7571090047393365,32.81391428472333
Task_48138,2833,969,78,71,149,2.9206185567010308,54.487569680058506
Task_48139,563,650,117,123,240,0.8648233486943164,18.475682707118096
Task_48140,2454,880,183,108,291,2.7854710556186153,49.433020136320955
Task_48141,670,451,185,58,243,1.4823008849557522,19.017673284403422
Task_48142,819,838,97,61,158,0.9761620977353993,21.95156532483429
Task_48143,2296,908,134,60,194,2.525852585258526,45.985472457346305
Task_48144,610,787,131,50,181,0.7741116751269036,18.582950726870106
Task_48145,1712,652,32,113,145,2.621745788667688,36.095754006568924
Task_48146,1001,450,177,161,338,2.2195121951219514,25.360411135202636
Task_48147,2343,466,163,143,306,5.017130620985011,46.48279892292933
Task_48148,2775,666,64,58,122,4.160419790104948,52.16994623861848
Task_48149,1708,225,146,87,233,7.557522123893805,34.963447125730276
Task_48150,2622,308,141,91,232,8.485436893203884,49.81211243606075
Task_48151,1588,700,80,34,114,2.265335235378031,33.282102237569426
Task_48152,1895,347,117,85,202,5.445402298850575,38.1750217842438
Task_48153,1889,200,29,190,219,9.398009950248756,38.11180188643204
Task_48154,1317,570,156,187,343,2.306479859894921,30.80137862092891
Task_48155,2266,454,153,107,260,4.98021978021978,44.96494398583038
Task_48156,2806,905,152,193,345,3.097130242825607,55.45667785996278
Task_48157,2383,282,174,169,343,8.420494699646643,46.702720422345465
Task_48158,2396,701,127,114,241,3.4131054131054133,47.73603699012042
Task_48159,1907,168,16,108,124,11.284023668639053,36.741528904056416
Task_48160,1935,892,35,11,46,2.1668533034714446,38.2514309780937
Task_48161,2171,771,25,100,125,2.812176165803109,43.671839388076656
Task_48162,1664,216,172,180,352,7.668202764976958,35.16294151928938
Task_48163,689,999,59,69,128,0.689,20.910437648449722
Task_48164,987,961,14,179,193,1.025987525987526,25.948376170707764
Task_48165,2205,920,91,48,139,2.3941368078175898,43.88466310555558
Task_48166,760,661,50,153,203,1.148036253776435,21.63406972773549
Task_48167,688,936,23,170,193,0.7342582710779082,21.24532814018553
Task_48168,2224,595,196,129,325,3.7315436241610738,45.077212620145666
Task_48169,758,853,64,191,255,0.8875878220140515,22.44028353341261
Task_48170,2713,330,141,105,246,8.196374622356496,51.55758178663249
Task_48171,1845,916,84,68,152,2.0119956379498363,38.468198764150536
Task_48172,1689,209,95,145,240,8.042857142857143,35.04611946724271
Task_48173,1499,420,40,35,75,3.5605700712589075,30.113251980982835
Task_48174,2222,468,71,183,254,4.73773987206823,44.52520213904546
Task_48175,664,141,24,92,116,4.676056338028169,16.98447236239323
Task_48176,2961,948,190,126,316,3.120126448893572,57.81836900534631
Task_48177,894,248,157,44,201,3.5903614457831323,21.523916692747502
Task_48178,1351,825,79,137,216,1.6355932203389831,31.607106497331856
Task_48179,1438,843,166,62,228,1.7037914691943128,32.36690459368892
Task_48180,2784,473,157,177,334,5.8734177215189876,53.66236609535601
Task_48181,2881,494,39,78,117,5.820202020202021,53.73719498917629
Task_48182,2639,407,78,199,277,6.4681372549019605,51.055982752066
Task_48183,1022,308,89,118,207,3.307443365695793,24.626031217653917
Task_48184,1206,753,22,186,208,1.5994694960212201,28.960655827276756
Task_48185,2458,653,20,135,155,3.758409785932722,47.87607648068703
Task_48186,2814,730,81,22,103,3.849521203830369,52.482182680802076
Task_48187,1971,331,95,19,114,5.936746987951807,37.96501957276056
Task_48188,2512,215,166,101,267,11.62962962962963,48.05021942517134
Task_48189,1108,919,172,98,270,1.2043478260869565,28.038527997584577
Task_48190,1629,343,21,37,58,4.7354651162790695,32.00300358333137
Task_48191,2545,141,49,33,82,17.922535211267604,45.92531391628606
Task_48192,2110,72,188,61,249,28.904109589041095,39.701499021624564
Task_48193,708,747,188,50,238,0.946524064171123,20.512445279519536
Task_48194,1500,697,160,151,311,2.1489971346704873,33.90032701342329
Task_48195,864,367,79,52,131,2.347826086956522,21.32130704942967
Task_48196,680,431,46,20,66,1.5740740740740742,16.968995290973282
Task_48197,1334,576,13,186,199,2.3119584055459272,30.494891589510505
Task_48198,2432,507,20,29,49,4.78740157480315,45.17201533726341
Task_48199,1794,941,191,107,298,1.9044585987261147,39.195146576379805
Task_48200,699,149,149,183,332,4.66,19.311357715831097
Task_48201,2145,86,150,57,207,24.655172413793103,40.216950654832935
Task_48202,2985,207,123,19,142,14.350961538461538,53.634472960593634
Task_48203,1286,925,62,181,243,1.388768898488121,31.014610673034536
Task_48204,1679,262,106,148,254,6.38403041825095,35.07397048351228
Task_48205,711,67,187,167,354,10.455882352941176,18.869531645585415
Task_48206,1692,718,13,42,55,2.35326842837274,34.27566393242736
Task_48207,1758,397,108,33,141,4.417085427135678,35.15011999630091
Task_48208,1733,420,66,163,229,4.116389548693586,36.48413802272554
Task_48209,2504,429,53,98,151,5.823255813953488,47.99356351550799
Task_48210,2220,389,26,158,184,5.6923076923076925,43.62715734732989
Task_48211,765,224,191,134,325,3.4,20.80499152988098
Task_48212,1801,994,46,10,56,1.8100502512562815,36.50558397939315
Task_48213,892,327,99,104,203,2.7195121951219514,22.55489751098573
Task_48214,1694,712,194,70,264,2.375876577840112,36.24515282526399
Task_48215,1527,518,155,29,184,2.9421965317919074,32.17890467569159
Task_48216,2632,101,36,23,59,25.80392156862745,46.40834287379263
Task_48217,1879,453,191,46,237,4.138766519823789,37.938250971399924
Task_48218,2929,687,95,97,192,4.257267441860465,55.99251998315549
Task_48219,2555,1019,158,20,178,2.5049019607843137,49.77598303276189
Task_48220,889,1012,175,28,203,0.8775913129318855,23.871614312071866
Task_48221,1408,779,64,163,227,1.8051282051282052,32.465536246709384
Task_48222,2546,73,36,166,202,34.4054054054054,46.924302590640075
Task_48223,2468,949,121,119,240,2.5978947368421053,49.6565216442879
Task_48224,1957,915,146,11,157,2.13646288209607,39.85655991881736
Task_48225,1977,180,188,54,242,10.922651933701658,38.68710083168251
Task_48226,684,762,42,131,173,0.8964613368283093,20.28272703265798
Task_48227,2231,289,141,25,166,7.6931034482758625,42.44170594138472
Task_48228,798,530,143,120,263,1.502824858757062,21.95673450416488
Task_48229,1413,590,192,99,291,2.3908629441624365,32.00622060220995
Task_48230,1789,876,85,198,283,2.039908779931585,39.02690584548515
Task_48231,892,620,188,11,199,1.4363929146537842,22.48967159857186
Task_48232,978,201,41,196,237,4.841584158415841,23.79701510276652
Task_48233,2995,966,81,186,267,3.097207859358842,58.38421043207715
Task_48234,2190,833,25,18,43,2.6258992805755397,41.98354009199023
Task_48235,2071,372,172,173,345,5.552278820375335,42.090360997095736
Task_48236,671,575,21,75,96,1.1649305555555556,18.587111778869616
Task_48237,2328,909,129,120,249,2.558241758241758,47.355370002162964
Task_48238,1460,969,79,39,118,1.5051546391752577,32.034565779277706
Task_48239,2250,685,54,149,203,3.2798833819241984,45.412105162649425
Task_48240,786,528,107,153,260,1.4858223062381852,21.795351518112323
Task_48241,2630,754,30,31,61,3.4834437086092715,49.09938090329839
Task_48242,749,483,114,38,152,1.5475206611570247,19.485643557019703
Task_48243,665,84,169,200,369,7.823529411764706,18.33868981372444
Task_48244,1526,921,174,199,373,1.6550976138828633,35.345807469332584
Task_48245,1341,170,159,29,188,7.842105263157895,28.024763010339157
Task_48246,2596,482,122,134,256,5.374741200828157,50.30111040869042
Task_48247,1800,522,196,144,340,3.4416826003824093,38.22104873557429
Task_48248,2490,200,104,189,293,12.388059701492537,47.88934858741922
Task_48249,2218,416,42,169,211,5.3189448441247,43.96501056184233
Task_48250,2917,1018,68,12,80,2.86261040235525,54.72623352864681
Task_48251,2798,496,35,35,70,5.629778672032193,50.97250304997979
Task_48252,2675,921,197,54,251,2.901301518438178,52.34761801913893
Task_48253,809,844,110,31,141,0.9573964497041421,21.61953245871781
Task_48254,2164,992,66,154,220,2.179254783484391,45.05688345190389
Task_48255,1809,264,161,175,336,6.826415094339622,37.54447532511212
Task_48256,2964,417,130,57,187,7.090909090909091,54.941705944565115
Task_48257,2504,493,172,167,339,5.068825910931174,49.30284281132375
Task_48258,1353,203,80,137,217,6.632352941176471,29.66175073837492
Task_48259,2067,579,162,12,174,3.5637931034482757,40.82783762772201
Task_48260,2443,142,91,32,123,17.083916083916083,44.63890643298881
Task_48261,1018,333,40,85,125,3.0479041916167664,23.835345356775463
Task_48262,2458,257,148,118,266,9.527131782945736,47.37631403688035
Task_48263,2733,755,128,200,328,3.615079365079365,53.762866743198536
Task_48264,1171,485,56,145,201,2.409465020576132,27.679486581151753
Task_48265,1532,975,80,74,154,1.569672131147541,33.862531230022284
Task_48266,1368,761,61,155,216,1.795275590551181,31.714517756486188
Task_48267,1273,89,130,67,197,14.144444444444444,26.499743369704685
Task_48268,710,672,60,172,232,1.0549777117384844,20.927652525950702
Task_48269,1336,148,111,91,202,8.966442953020135,28.47071011284595
Task_48270,2912,638,23,45,68,4.557120500782473,53.27023159656047
Task_48271,928,385,54,95,149,2.4041450777202074,22.92906126330526
Task_48272,2558,342,194,90,284,7.457725947521866,49.13186846473288
Task_48273,2181,232,138,17,155,9.360515021459227,41.08213646174876
Task_48274,1143,243,33,18,51,4.684426229508197,23.75164407924194
Task_48275,550,478,49,75,124,1.1482254697286012,16.830390510408254
Task_48276,781,206,61,200,261,3.7729468599033815,20.93385073334395
Task_48277,2235,843,32,62,94,2.6481042654028437,44.01875709549463
Task_48278,1873,225,140,29,169,8.287610619469026,36.59274986374195
Task_48279,2836,399,92,22,114,7.09,52.02593480875992
Task_48280,1503,520,77,34,111,2.8848368522072936,31.265620195061327
Task_48281,1801,446,141,144,285,4.029082774049217,37.74604154286773
Task_48282,669,636,74,184,258,1.0502354788069075,20.305243211945278
Task_48283,757,344,92,127,219,2.1942028985507247,20.655631601343636
Task_48284,540,689,113,103,216,0.782608695652174,18.118081862786205
Task_48285,705,696,193,41,234,1.011477761836442,20.041795770262187
Task_48286,804,898,43,200,243,0.8943270300333704,23.099262361284378
Task_48287,697,889,52,76,128,0.7831460674157303,20.67739222814968
Task_48288,1835,410,87,69,156,4.464720194647202,36.68192814559598
Task_48289,1519,994,141,139,280,1.5266331658291457,34.92489179716832
Task_48290,1855,899,31,190,221,2.061111111111111,39.84098873331339
Task_48291,2121,443,93,178,271,4.777027027027027,42.89982533315597
Task_48292,2967,362,157,11,168,8.173553719008265,54.19948065116296
Task_48293,1535,114,41,25,66,13.347826086956522,29.34942208490582
Task_48294,940,918,30,44,74,1.0228509249183895,22.894694875195267
Task_48295,2256,403,187,88,275,5.584158415841584,44.42776157252785
Task_48296,2928,685,116,19,135,4.2682215743440235,54.37036540925691
Task_48297,2632,514,49,110,159,5.110679611650485,50.33635509242043
Task_48298,2331,317,107,26,133,7.330188679245283,43.93584476533118
Task_48299,631,139,115,44,159,4.507142857142857,16.132884224788338
Task_48300,918,252,184,176,360,3.6284584980237153,23.53382592075168
Task_48301,1972,136,11,84,95,14.394160583941606,37.321664503167916
Task_48302,2367,287,35,65,100,8.21875,44.45103711000908
Task_48303,1967,760,123,178,301,2.5847568988173455,41.48964173206023
Task_48304,1344,344,24,113,137,3.8956521739130436,29.220416327712584
Task_48305,2657,1021,38,19,57,2.599804305283757,50.12913126937983
Task_48306,2953,908,192,38,230,3.2486248624862486,56.39913738109711
Task_48307,2200,533,11,179,190,4.119850187265918,43.95521901358424
Task_48308,1277,1005,74,38,112,1.2693836978131212,29.25922124275951
Task_48309,2274,241,121,139,260,9.396694214876034,44.41415214891066
Task_48310,561,987,14,87,101,0.5678137651821862,18.413493064284143
Task_48311,1219,267,130,167,297,4.548507462686567,28.0430278317007
Task_48312,568,101,138,114,252,5.568627450980392,16.263610489181655
Task_48313,996,307,26,142,168,3.2337662337662336,23.887683211698995
Task_48314,1492,836,76,149,225,1.7825567502986859,33.940911784052595
Task_48315,2051,1004,114,144,258,2.0407960199004975,43.337440368981504
Task_48316,875,862,123,26,149,1.0139049826187718,22.597558380415535
Task_48317,2121,878,175,198,373,2.4129692832764507,44.651941302319244
Task_48318,2860,513,132,193,325,5.56420233463035,54.97871336371785
Task_48319,2553,464,153,82,235,5.490322580645161,49.107650973002954
Task_48320,1279,503,14,68,82,2.5376984126984126,27.775536498242644
Task_48321,1740,540,57,68,125,3.2162661737523104,35.78197072127154
Task_48322,2514,71,137,21,158,34.916666666666664,44.824526598268164
Task_48323,1897,242,91,152,243,7.806584362139918,38.453694622390465
Task_48324,1763,693,120,107,227,2.5403458213256482,37.610679647224174
Task_48325,2924,983,66,54,120,2.9715447154471546,55.56895797453186
Task_48326,2379,991,33,113,146,2.3981854838709675,47.69992871944161
Task_48327,2880,319,77,21,98,9.0,52.193627632897034
Task_48328,2214,258,183,110,293,8.548262548262548,43.63424850620396
Task_48329,1096,830,54,99,153,1.3188929001203369,26.84489876180396
Task_48330,947,520,157,161,318,1.817658349328215,24.635287448872305
Task_48331,2337,947,145,31,176,2.4651898734177213,46.32017707237447
Task_48332,767,252,77,137,214,3.0316205533596836,20.558650789838207
Task_48333,999,534,73,105,178,1.8672897196261682,24.73457877748667
Task_48334,1862,703,65,27,92,2.6448863636363638,37.28701845814284
Task_48335,711,424,198,101,299,1.6729411764705882,20.411695703527084
Task_48336,1580,918,23,31,54,1.719260065288357,33.12118446153006
Task_48337,1933,748,16,88,104,2.5807743658210947,39.30434737634519
Task_48338,1857,1003,96,95,191,1.849601593625498,39.9089442968299
Task_48339,536,704,155,147,302,0.7602836879432624,18.552345465855563
Task_48340,903,832,75,106,181,1.084033613445378,23.961438681533988
Task_48341,1631,447,80,165,245,3.640625,35.0363536606119
Task_48342,2484,823,18,191,209,3.0145631067961167,49.45619135735012
Task_48343,2397,242,17,169,186,9.864197530864198,45.88291458637634
Task_48344,1544,306,200,174,374,5.029315960912052,33.66810603948993
Task_48345,2985,1011,21,137,158,2.949604743083004,57.36594992701561
Task_48346,1390,315,40,161,201,4.39873417721519,30.47648833225837
Task_48347,635,404,194,122,316,1.5679012345679013,19.224379739539156
Task_48348,2061,703,26,140,166,2.9275568181818183,42.005935656327665
Task_48349,1502,561,85,58,143,2.6725978647686834,31.86195240337771
Task_48350,2582,642,193,85,278,4.015552099533437,50.34504864731969
Task_48351,2346,290,85,141,226,8.061855670103093,45.62499411113745
Task_48352,784,413,69,47,116,1.893719806763285,19.605515672518838
Task_48353,2650,538,192,113,305,4.916512059369202,51.527201399818956
Task_48354,1428,360,21,35,56,3.955678670360111,28.862250866518483
Task_48355,1931,550,192,180,372,3.50453720508167,40.5811929051734
Task_48356,1036,793,21,20,41,1.3047858942065491,23.60322779356262
Task_48357,2017,147,71,137,208,13.628378378378379,39.54977969999157
Task_48358,1347,539,63,54,117,2.4944444444444445,29.12423104692382
Task_48359,2277,947,119,189,308,2.401898734177215,47.03276056804884
Task_48360,2605,446,32,72,104,5.827740492170022,48.84383911000061
Task_48361,2438,984,87,26,113,2.4751269035532997,47.56051336237044
Task_48362,2928,342,176,176,352,8.536443148688047,55.58145666579575
Task_48363,2307,481,15,186,201,4.786307053941909,45.59371204200735
Task_48364,870,313,70,199,269,2.770700636942675,22.737521876495766
Task_48365,993,250,187,124,311,3.956175298804781,24.41515023000366
Task_48366,2435,636,66,46,112,3.8226059654631084,46.358734046198315
Task_48367,1964,111,135,144,279,17.535714285714285,38.38236236231044
Task_48368,1127,630,167,39,206,1.786053882725832,26.425500268747243
Task_48369,2548,800,19,28,47,3.1810237203495633,47.85062165955602
Task_48370,2940,1021,87,166,253,2.8767123287671232,57.496804280336384
Task_48371,1909,166,185,125,310,11.431137724550899,38.24648573396855
Task_48372,2005,442,83,77,160,4.525959367945824,39.71905326672249
Task_48373,2737,910,34,160,194,3.004390779363337,53.677906262680466
Task_48374,2532,694,56,160,216,3.643165467625899,49.98165567897694
Task_48375,1464,296,151,166,317,4.929292929292929,32.10127475077228
Task_48376,536,387,200,70,270,1.3814432989690721,16.87528869444355
Task_48377,2060,619,105,22,127,3.3225806451612905,40.51310063120156
Task_48378,2842,387,88,126,214,7.324742268041237,53.69908030647454
Task_48379,2085,216,25,35,60,9.608294930875577,38.67727001456978
Task_48380,2756,900,102,144,246,3.0588235294117645,54.13073657178719
Task_48381,1494,861,27,192,219,1.7331786542923433,33.98905331094955
Task_48382,2360,769,13,15,28,3.064935064935065,44.529077261517614
Task_48383,2394,749,127,61,188,3.192,46.96372264316278
Task_48384,2400,163,196,95,291,14.634146341463415,45.831665669369904
Task_48385,1277,421,89,45,134,3.0260663507109005,27.575827757913363
Task_48386,2744,199,138,187,325,13.72,52.05188596130685
Task_48387,2078,82,138,125,263,25.03614457831325,39.87808775816754
Task_48388,1592,298,167,103,270,5.3244147157190636,33.82745571373757
Task_48389,786,808,136,180,316,0.9715698393077874,22.918047901277806
Task_48390,2625,155,77,76,153,16.826923076923077,48.113704087455034
Task_48391,664,77,25,125,150,8.512820512820513,16.779846900716823
Task_48392,1053,581,23,62,85,1.809278350515464,24.364503009011283
Task_48393,1168,909,144,36,180,1.2835164835164836,27.672814351075118
Task_48394,2096,272,49,54,103,7.677655677655678,39.98416042651187
Task_48395,968,245,130,181,311,3.934959349593496,24.087094006042776
Task_48396,1253,908,190,63,253,1.3784378437843785,29.76299842808949
Task_48397,1115,705,134,184,318,1.5793201133144477,27.863935961201104
Task_48398,2397,472,16,164,180,5.067653276955602,46.60507257195432
Task_48399,750,439,43,70,113,1.7045454545454546,19.667447065040708
Task_48400,2048,319,157,133,290,6.4,41.24264765764894
Task_48401,2471,192,37,138,175,12.803108808290155,46.9084942520635
Task_48402,1479,898,147,57,204,1.6451612903225807,33.07821630938839
Task_48403,2368,831,62,154,216,2.8461538461538463,47.77455888554872
Task_48404,2168,190,68,44,112,11.350785340314136,40.796492921871824
Task_48405,1055,327,200,185,385,3.216463414634146,26.07003966814899
Task_48406,2446,195,170,75,245,12.479591836734693,46.39292741912399
Task_48407,1448,633,198,83,281,2.2839116719242902,32.34826050133037
Task_48408,1169,446,92,164,256,2.615212527964206,27.71915910012783
Task_48409,1897,979,85,185,270,1.9357142857142857,40.980846845865884
Task_48410,592,590,83,125,208,1.0016920473773265,18.534323678505913
Task_48411,1877,1004,43,95,138,1.8676616915422886,39.694654224595084
Task_48412,2679,132,179,62,241,20.142857142857142,49.35340966443818
Task_48413,1728,636,177,26,203,2.7127158555729984,35.94342024573303
Task_48414,1003,908,57,41,98,1.1034103410341034,24.327495784043062
Task_48415,640,192,109,132,241,3.316062176165803,18.348923780392145
Task_48416,1522,927,133,90,223,1.6400862068965518,34.30447655800195
Task_48417,2984,540,190,84,274,5.515711645101663,56.346142090511414
Task_48418,2439,581,63,129,192,4.190721649484536,47.965970671594256
Task_48419,2288,508,53,135,188,4.495088408644401,45.33666531670036
Task_48420,1114,195,160,42,202,5.683673469387755,24.817926472959495
Task_48421,2136,644,76,92,168,3.311627906976744,42.92031808404354
Task_48422,1984,254,117,120,237,7.780392156862745,39.74786217533616
Task_48423,1573,172,47,89,136,9.092485549132949,31.647254497653083
Task_48424,1178,632,106,133,239,1.8609794628751974,28.246250896567165
Task_48425,1571,726,53,106,159,2.160935350756534,34.206975753256025
Task_48426,1182,751,88,16,104,1.571808510638298,26.581746892794197
Task_48427,1545,1021,158,37,195,1.5117416829745598,34.266298861547796
Task_48428,2150,922,37,122,159,2.3293607800650054,43.87783844620028
Task_48429,2905,130,159,128,287,22.17557251908397,53.58486198249449
Task_48430,626,506,58,85,143,1.2347140039447733,18.108282469066257
Task_48431,622,378,46,122,168,1.641160949868074,18.14540913641339
Task_48432,1386,577,150,194,344,2.397923875432526,31.93076655428186
Task_48433,895,226,32,117,149,3.94273127753304,21.7796594549547
Task_48434,1218,477,67,200,267,2.5481171548117154,28.739881321293236
Task_48435,957,849,38,92,130,1.1258823529411766,24.43468243695553
Task_48436,2493,279,171,108,279,8.903571428571428,48.05292116827034
Task_48437,872,549,156,187,343,1.5854545454545454,23.646492456041127
Task_48438,1599,678,41,18,59,2.3549337260677468,32.24858813941173
Task_48439,1582,1012,187,151,338,1.5616979269496545,36.25805282421772
Task_48440,2874,632,16,155,171,4.540284360189573,54.60174054050524
Task_48441,1329,634,25,151,176,2.0929133858267717,30.282484286206124
Task_48442,2426,649,182,112,294,3.732307692307692,48.28291465875359
Task_48443,1171,538,168,97,265,2.1725417439703154,27.9392322910744
Task_48444,889,447,192,172,364,1.984375,23.711565085913065
Task_48445,2091,181,140,199,339,11.489010989010989,41.38115630786726
Task_48446,2025,791,54,117,171,2.5568181818181817,41.79098793963089
Task_48447,1430,717,110,130,240,1.9916434540389971,32.503133482148236
Task_48448,2669,149,198,183,381,17.793333333333333,50.57508686185772
Task_48449,2241,841,87,156,243,2.661520190023753,45.798806877474476
Task_48450,1597,828,45,116,161,1.9264173703256937,34.808163428909836
Task_48451,883,329,52,173,225,2.675757575757576,22.787384036857276
Task_48452,2448,567,54,101,155,4.309859154929577,47.565070258758254
Task_48453,675,676,33,91,124,0.9970457902511078,19.400467689754596
Task_48454,1966,150,175,145,320,13.019867549668874,39.16155813752981
Task_48455,2634,160,33,92,125,16.36024844720497,48.26258337971317
Task_48456,1538,654,40,148,188,2.348091603053435,33.784082266436315
Task_48457,984,115,18,15,33,8.482758620689655,20.319196629206136
Task_48458,2595,662,26,105,131,3.914027149321267,50.05519387543083
Task_48459,827,474,113,17,130,1.7410526315789474,20.413245012558487
Task_48460,2265,518,169,186,355,4.364161849710983,45.699585830598714
Task_48461,1048,847,73,50,123,1.2358490566037736,25.29444115546893
Task_48462,2340,984,118,146,264,2.3756345177664975,47.88497520860151
Task_48463,1921,728,66,76,142,2.635116598079561,39.34991422018479
Task_48464,1959,665,100,167,267,2.9414414414414414,40.89559238649388
Task_48465,1516,73,107,63,170,20.486486486486488,29.911648204942804
Task_48466,2661,992,50,50,100,2.6797583081570995,51.0018266630369
Task_48467,2986,808,102,149,251,3.6909765142150803,57.51614618201065
Task_48468,885,159,113,74,187,5.53125,21.066316205924245
Task_48469,1067,614,197,35,232,1.7349593495934958,25.576329063077875
Task_48470,2775,66,32,67,99,41.417910447761194,48.75348713222345
Task_48471,590,706,81,14,95,0.8345120226308345,17.281131835048594
Task_48472,1665,424,12,104,116,3.9176470588235293,34.41243473238453
Task_48473,2643,817,147,135,282,3.2310513447432765,52.229331990047534
Task_48474,2444,832,186,51,237,2.9339735894357744,48.33108586743942
Task_48475,2592,360,76,84,160,7.18005540166205,48.90530104981392
Task_48476,1568,414,190,73,263,3.778313253012048,33.345450641573926
Task_48477,1019,812,115,189,304,1.2533825338253382,26.539083488490657
Task_48478,1917,119,17,62,79,15.975,35.80022420387846
Task_48479,1297,121,23,126,149,10.631147540983607,27.16067165633942
Task_48480,2767,128,70,192,262,21.449612403100776,51.50692380343322
Task_48481,908,292,13,46,59,3.098976109215017,20.471839397199126
Task_48482,2201,970,101,17,118,2.266735324407827,43.527382738994525
Task_48483,2858,651,50,151,201,4.383435582822086,54.95902313417259
Task_48484,1877,949,165,97,262,1.9757894736842105,40.3919292522471
Task_48485,999,860,150,112,262,1.1602787456445993,26.109902595299577
Task_48486,2669,175,156,58,214,15.164772727272727,49.380357716405115
Task_48487,1362,834,19,68,87,1.6311377245508982,30.11724439672741
Task_48488,1428,825,190,110,300,1.728813559322034,33.03537271499594
Task_48489,583,514,151,189,340,1.1320388349514563,18.904537455269633
Task_48490,1704,840,38,57,95,2.0261593341260404,35.5045145806561
Task_48491,2466,961,66,120,186,2.5634095634095635,49.413034846701784
Task_48492,2071,592,117,191,308,3.4924114671163573,42.659012761971006
Task_48493,1672,887,179,105,284,1.882882882882883,37.02812392010461
Task_48494,2376,376,104,104,208,6.30238726790451,46.210383023561896
Task_48495,2566,717,180,128,308,3.573816155988858,50.80188094326322
Task_48496,620,632,151,13,164,0.9794628751974723,18.128527446897138
Task_48497,806,835,49,153,202,0.9641148325358851,22.833756888094843
Task_48498,1335,566,168,148,316,2.3544973544973544,30.89498993219598
Task_48499,811,440,145,100,245,1.8390022675736961,21.813144014497514
Task_48500,2832,328,12,163,175,8.60790273556231,53.13795032222104
Task_48501,902,70,75,85,160,12.704225352112676,20.60707950530607
Task_48502,2949,1004,50,138,188,2.934328358208955,57.39602420523294
Task_48503,2476,272,31,176,207,9.06959706959707,47.569506535223915
Task_48504,926,966,130,95,225,0.9576008273009308,25.071394614448867
Task_48505,2353,280,119,92,211,8.373665480427047,45.4129074175909
Task_48506,1857,709,141,187,328,2.6154929577464787,39.722289635271025
Task_48507,1007,1002,46,130,176,1.003988035892323,26.022637843992797
Task_48508,2298,875,109,169,278,2.6232876712328768,46.97643193799832
Task_48509,1273,338,39,17,56,3.7551622418879056,26.049967534664926
Task_48510,936,680,107,41,148,1.3744493392070485,23.03002167008242
Task_48511,2246,561,106,85,191,3.99644128113879,44.37226668911395
Task_48512,1928,689,148,149,297,2.794202898550725,40.58880088058197
Task_48513,1524,204,38,166,204,7.434146341463415,32.23378617344389
Task_48514,2902,194,191,184,375,14.882051282051282,54.65738200383844
Task_48515,634,74,30,21,51,8.453333333333333,14.36554670583817
Task_48516,2409,209,102,192,294,11.471428571428572,46.65547964802113
Task_48517,983,139,38,21,59,7.021428571428571,20.810461895167382
Task_48518,2520,330,113,26,139,7.613293051359516,46.917041814119614
Task_48519,934,810,159,137,296,1.1516646115906288,25.11507408000638
Task_48520,1645,852,37,27,64,1.928487690504103,33.775664270775714
Task_48521,1161,703,149,99,248,1.6491477272727273,28.160773867125993
Task_48522,2629,427,176,53,229,6.142523364485982,49.99548810093608
Task_48523,2744,787,45,172,217,3.482233502538071,53.496689926532895
Task_48524,2080,885,64,66,130,2.3476297968397293,42.22781236887755
Task_48525,617,149,84,108,192,4.113333333333333,17.31437497472052
Task_48526,981,810,82,96,178,1.2096177558569667,25.182256033689445
Task_48527,1335,840,168,101,269,1.587395957193817,31.42628638598759
Task_48528,1561,340,71,167,238,4.577712609970675,33.55320628381799
Task_48529,1308,175,137,104,241,7.431818181818182,28.3955447195081
Task_48530,1088,922,64,105,169,1.1787648970747562,27.197924897004825
Task_48531,2125,820,104,165,269,2.5883069427527405,44.017147053199274
Task_48532,2182,822,20,139,159,2.651275820170109,44.05369985677265
Task_48533,798,909,38,173,211,0.8769230769230769,22.838201301063034
Task_48534,1578,806,105,105,210,1.9553903345724908,34.953248684054124
Task_48535,2289,71,153,54,207,31.791666666666668,42.31273682831102
Task_48536,2192,90,136,138,274,24.087912087912088,41.84458738178861
Task_48537,1979,541,114,102,216,3.651291512915129,40.495174007195665
Task_48538,2261,256,70,85,155,8.797665369649806,43.32946112175794
Task_48539,1813,282,189,141,330,6.406360424028269,37.59301484272128
Task_48540,2342,176,73,150,223,13.231638418079097,44.81401641017556
Task_48541,715,925,179,34,213,0.7721382289416847,20.940977776277233
Task_48542,1386,412,18,91,109,3.3559322033898304,29.74131873563608
Task_48543,2522,341,169,128,297,7.374269005847953,48.83814180210761
Task_48544,1734,927,119,61,180,1.8685344827586208,36.88738869411615
Task_48545,574,609,37,155,192,0.940983606557377,18.247776164451718
Task_48546,2312,714,163,86,249,3.2335664335664336,46.17730096488045
Task_48547,2362,788,39,47,86,2.993662864385298,45.40212637104676
Task_48548,2056,961,67,10,77,2.137214137214137,40.56412297883764
Task_48549,2544,98,88,147,235,25.696969696969695,47.13732184015709
Task_48550,1567,965,49,193,242,1.6221532091097308,35.693592648100854
Task_48551,977,436,24,31,55,2.2356979405034325,21.9440720801632
Task_48552,2776,425,103,51,154,6.516431924882629,51.60615529113992
Task_48553,1415,282,93,34,127,5.0,29.443933524332788
Task_48554,1511,538,97,120,217,2.803339517625232,33.130099366968416
Task_48555,1365,570,61,59,120,2.3905429071803854,29.506320609315026
Task_48556,1134,186,24,87,111,6.064171122994653,25.087597364161244
Task_48557,1721,198,29,157,186,8.64824120603015,35.17851898081798
Task_48558,2085,579,115,109,224,3.5948275862068964,42.34070116418353
Task_48559,1146,844,127,75,202,1.3562130177514793,27.750624947863287
Task_48560,2079,357,16,50,66,5.807262569832402,39.2948459847027
Task_48561,2406,862,117,102,219,2.7879490150637314,48.282906057729924
Task_48562,2362,642,28,151,179,3.6734059097978227,46.64879406906354
Task_48563,730,319,105,116,221,2.28125,20.064453793454295
Task_48564,1932,398,190,190,380,4.842105263157895,40.15924589471702
Task_48565,621,476,81,18,99,1.3018867924528301,16.78373614946064
Task_48566,1367,198,13,155,168,6.869346733668341,29.463794877235145
Task_48567,1915,225,146,100,246,8.473451327433628,38.564477035052825
Task_48568,924,412,163,33,196,2.23728813559322,22.52354892036534
Task_48569,1331,235,189,99,288,5.639830508474576,29.549019642212333
Task_48570,1414,483,122,84,206,2.9214876033057853,31.000654250789484
Task_48571,1712,1005,189,125,314,1.7017892644135189,38.179490962129215
Task_48572,931,345,20,101,121,2.6907514450867054,22.54192002293165
Task_48573,605,294,107,12,119,2.0508474576271185,16.23614759970261
Task_48574,894,965,46,50,96,0.9254658385093167,22.958241140562148
Task_48575,2410,64,170,131,301,37.07692307692308,45.140514294087865
Task_48576,1018,423,126,152,278,2.400943396226415,25.260567920095905
Task_48577,1786,811,98,31,129,2.1995073891625614,36.942568589626674
Task_48578,2275,507,93,35,128,4.478346456692913,43.93598837726986
Task_48579,2696,579,37,198,235,4.6482758620689655,52.21631143471382
Task_48580,2118,370,165,73,238,5.708894878706199,41.791583512232535
Task_48581,2438,959,168,60,228,2.5395833333333333,48.54785731159512
Task_48582,2248,200,167,55,222,11.18407960199005,43.127194796627634
Task_48583,834,249,97,12,109,3.336,19.690785116052414
Task_48584,975,384,108,135,243,2.5324675324675323,24.27378840940679
Task_48585,1215,647,147,170,317,1.875,29.28487367179928
Task_48586,2297,459,25,16,41,4.993478260869566,42.545451594233306
Task_48587,2228,315,182,97,279,7.050632911392405,44.00665649582183
Task_48588,2174,584,103,24,127,3.7162393162393164,42.209022157853155
Task_48589,2598,482,57,59,116,5.37888198757764,48.81034450450994
Task_48590,1586,161,51,181,232,9.790123456790123,33.05843221036547
Task_48591,2340,484,100,123,223,4.824742268041237,46.090192973061015
Task_48592,858,126,140,92,232,6.755905511811024,20.927397996637605
Task_48593,1107,322,21,67,88,3.4272445820433437,24.47919487591804
Task_48594,2975,64,124,112,236,45.76923076923077,53.645312676145814
Task_48595,2323,169,78,174,252,13.66470588235294,44.776448007692544
Task_48596,2500,898,72,95,167,2.7808676307007785,49.57459196590012
Task_48597,2961,717,69,74,143,4.123955431754875,55.79817995311578
Task_48598,1562,630,173,39,212,2.4754358161648176,33.34199460565478
Task_48599,862,145,154,67,221,5.904109589041096,20.803158218197186
Task_48600,2294,673,69,27,96,3.4035608308605343,44.15135922847395
Task_48601,1794,465,68,80,148,3.8497854077253217,36.61763148517203
Task_48602,1524,589,134,104,238,2.5830508474576273,33.544139656720596
Task_48603,1996,994,82,118,200,2.006030150753769,42.22767547389457
Task_48604,545,566,194,91,285,0.9611992945326279,17.93714154237297
Task_48605,1361,598,181,131,312,2.2721202003338896,31.364184332333267
Task_48606,698,160,140,38,178,4.3354037267080745,17.65426124883005
Task_48607,2500,937,69,64,133,2.6652452025586353,49.07456370351577
Task_48608,1644,935,56,12,68,1.7564102564102564,33.79196149383303
Task_48609,1899,621,140,47,187,3.053054662379421,38.53242435126489
Task_48610,1153,814,127,20,147,1.4147239263803681,26.729109491096732
Task_48611,1065,738,125,25,150,1.4411366711772666,25.209279581850804
Task_48612,2957,388,148,12,160,7.6015424164524426,54.03507815062897
Task_48613,532,1018,130,183,313,0.5220804710500491,19.71630328104235
Task_48614,2686,584,164,151,315,4.591452991452991,52.345623862432944
Task_48615,2864,997,35,195,230,2.869739478957916,56.1772980899073
Task_48616,1255,782,54,109,163,1.602809706257982,29.52792788389881
Task_48617,2401,623,171,188,359,3.84775641025641,48.20893401367399
Task_48618,2523,351,102,181,283,7.167613636363637,48.902606293997145
Task_48619,1712,282,167,137,304,6.049469964664311,35.87344659569193
Task_48620,530,996,123,144,267,0.5315947843530592,19.298729046798204
Task_48621,2925,857,28,100,128,3.409090909090909,56.025016329772996
Task_48622,627,819,40,161,201,0.7646341463414634,19.811306235628777
Task_48623,954,874,58,199,257,1.0902857142857143,25.561928323523365
Task_48624,1261,406,129,74,203,3.098280098280098,28.242675969529746
Task_48625,2831,528,126,35,161,5.351606805293006,52.660553513681656
Task_48626,1404,307,10,200,210,4.558441558441558,30.758768544103674
Task_48627,2775,151,26,13,39,18.25657894736842,48.91455674639638
Task_48628,2516,827,101,39,140,3.0386473429951693,48.467559653154154
Task_48629,1411,131,112,133,245,10.68939393939394,29.88783311841787
Task_48630,1226,1009,190,56,246,1.2138613861386138,29.62790522801491
Task_48631,2027,420,46,52,98,4.814726840855107,39.33005784340416
Task_48632,1968,256,24,163,187,7.657587548638133,39.34539703991508
Task_48633,2102,488,94,73,167,4.298568507157464,41.519930659190635
Task_48634,2527,455,90,123,213,5.541666666666667,48.9602455693958
Task_48635,1827,251,148,99,247,7.25,37.25602049508953
Task_48636,2688,527,29,168,197,5.090909090909091,51.72823186224178
Task_48637,858,533,13,186,199,1.6067415730337078,22.810183313486647
Task_48638,1424,356,163,173,336,3.988795518207283,31.761993138741058
Task_48639,1976,939,117,82,199,2.1021276595744682,41.30675346812222
Task_48640,1787,939,76,139,215,1.901063829787234,38.889029966416786
Task_48641,1453,530,37,137,174,2.736346516007533,31.952242224234368
Task_48642,2109,637,165,15,180,3.30564263322884,41.56351077797424
Task_48643,2481,846,176,123,299,2.9291617473435654,49.812532916471206
Task_48644,2281,1006,189,193,382,2.2651439920556107,47.61920190081495
Task_48645,590,915,84,162,246,0.6441048034934498,19.995288217488504
Task_48646,2458,967,103,130,233,2.5392561983471076,49.538750377681744
Task_48647,706,226,22,84,106,3.1101321585903086,18.220458728164427
Task_48648,756,973,194,160,354,0.7761806981519507,23.123496395113932
Task_48649,2050,318,103,45,148,6.4263322884012535,39.47685492127232
Task_48650,1595,705,47,197,244,2.2592067988668556,35.245991871428
Task_48651,1957,195,42,81,123,9.98469387755102,38.177078811483895
Task_48652,2203,193,96,68,164,11.355670103092784,42.22371119696739
Task_48653,2717,421,62,116,178,6.438388625592417,51.58445930013192
Task_48654,1385,92,16,42,58,14.89247311827957,26.700973817400293
Task_48655,2016,329,14,131,145,6.109090909090909,39.899924513321075
Task_48656,2099,536,143,98,241,3.908752327746741,42.489380751690774
Task_48657,2185,320,14,18,32,6.806853582554517,40.25281689871316
Task_48658,2568,1011,28,61,89,2.5375494071146245,49.62954877006593
Task_48659,1415,847,127,103,230,1.6686320754716981,32.57200778417388
Task_48660,2092,996,140,63,203,2.0982948846539617,43.13456240918203
Task_48661,1349,348,98,52,150,3.865329512893983,28.85369560350963
Task_48662,2525,829,154,35,189,3.0421686746987953,49.131727513859325
Task_48663,2495,736,82,51,133,3.385345997286296,48.19841554722671
Task_48664,1883,885,198,151,349,2.125282167042889,40.725592204850464
Task_48665,1621,666,160,141,301,2.4302848575712144,35.66022562272197
Task_48666,2868,521,115,90,205,5.494252873563219,54.27468621437193
Task_48667,1521,760,15,53,68,1.9986859395532195,31.918783303704277
Task_48668,1170,721,125,119,244,1.6204986149584488,28.385435108302488
Task_48669,2703,579,141,192,333,4.660344827586207,52.74005819188852
Task_48670,1362,909,48,163,211,1.4967032967032967,32.025330020971985
Task_48671,1901,436,137,148,285,4.350114416475972,39.302373531004925
Task_48672,1719,364,149,122,271,4.7095890410958905,36.087045700562456
Task_48673,565,601,78,179,257,0.9385382059800664,18.59113172075645
Task_48674,1386,718,81,53,134,1.9276773296244785,30.63524835514062
Task_48675,785,383,26,125,151,2.0442708333333335,20.54321093226587
Task_48676,935,515,107,141,248,1.812015503875969,24.084833220469903
Task_48677,1056,187,134,15,149,5.617021276595745,23.429656795150937
Task_48678,882,432,160,93,253,2.0369515011547343,22.87213988169475
Task_48679,2574,942,13,23,36,2.7295864262990457,48.574228282519364
Task_48680,2035,346,103,148,251,5.8645533141210375,40.97411156990255
Task_48681,768,174,96,186,282,4.388571428571429,20.254247099638697
Task_48682,1571,455,126,143,269,3.4451754385964914,34.060897212639425
Task_48683,1646,854,148,164,312,1.9251461988304093,36.7262229989562
Task_48684,2140,738,101,156,257,2.8958051420838973,43.93078378644778
Task_48685,612,465,69,62,131,1.3133047210300428,17.622176371175453
Task_48686,2843,814,116,166,282,3.4883435582822084,55.434052051574724
Task_48687,2814,308,174,60,234,9.106796116504855,52.433797061736165
Task_48688,920,767,78,43,121,1.1979166666666667,22.967229203817656
Task_48689,1244,813,113,191,304,1.5282555282555284,30.19034674349524
Task_48690,1104,323,37,182,219,3.4074074074074074,26.099436455715736
Task_48691,1804,824,161,34,195,2.1866666666666665,37.74762296253436
Task_48692,1116,344,138,50,188,3.234782608695652,25.326645395157357
Task_48693,725,160,108,134,242,4.503105590062112,19.301132359020496
Task_48694,1499,374,97,42,139,3.997333333333333,30.937746161573372
Task_48695,1800,695,131,177,308,2.586206896551724,38.670716323501445
Task_48696,1036,306,17,76,93,3.3745928338762217,23.429434215377217
Task_48697,1140,178,198,121,319,6.368715083798882,26.1305338285902
Task_48698,2783,601,192,64,256,4.622923588039867,53.087440699030935
Task_48699,818,729,31,197,228,1.1205479452054794,22.704038456840962
Task_48700,2898,463,199,76,275,6.245689655172414,54.65870435345064
Task_48701,2011,716,49,173,222,2.804741980474198,41.84622818889651
Task_48702,2263,716,52,58,110,3.1562064156206415,44.132928901706016
Task_48703,987,858,76,183,259,1.1490104772991852,26.121840082585035
Task_48704,2082,312,85,190,275,6.651757188498403,41.81975843310558
Task_48705,2218,320,200,60,260,6.909657320872274,43.16826668774001
Task_48706,1585,758,46,96,142,2.0882740447957837,34.3861532698423
Task_48707,1957,287,146,185,331,6.795138888888889,39.955516676635355
Task_48708,1167,877,147,56,203,1.3291571753986333,28.129815229794435
Task_48709,827,369,184,137,321,2.235135135135135,22.239130973011424
Task_48710,2800,577,109,19,128,4.844290657439446,52.08740803626234
Task_48711,2030,94,104,193,297,21.36842105263158,39.41272575751176
Task_48712,1342,500,127,147,274,2.6786427145708585,30.60718450719492
Task_48713,960,607,52,192,244,1.5789473684210527,24.95542155117975
Task_48714,2936,594,152,54,206,4.934453781512605,55.247305772276526
Task_48715,1783,414,43,102,145,4.296385542168674,36.41796009789521
Task_48716,2518,693,97,80,177,3.628242074927954,48.8511258415413
Task_48717,2156,425,144,194,338,5.061032863849765,43.608663467889784
Task_48718,1580,200,167,156,323,7.8606965174129355,33.612344483542905
Task_48719,1183,669,15,132,147,1.7656716417910447,27.76692902129793
Task_48720,2288,430,145,97,242,5.3085846867749416,45.17276399402741
Task_48721,2834,600,125,30,155,4.715474209650583,52.905999261329775
Task_48722,2150,916,60,60,120,2.3446019629225736,43.026827731520534
Task_48723,2528,864,176,197,373,2.922543352601156,51.05554464400078
Task_48724,2524,516,166,77,243,4.882011605415861,48.770541514066174
Task_48725,835,389,97,55,152,2.141025641025641,20.829622262057956
Task_48726,1360,752,16,126,142,1.8061088977423638,30.717148594760214
Task_48727,2726,574,43,156,199,4.740869565217391,52.44517743347956
Task_48728,1253,604,65,122,187,2.0710743801652893,29.18406630632984
Task_48729,1139,132,146,41,187,8.563909774436091,24.52201898867541
Task_48730,2581,130,40,34,74,19.702290076335878,45.953436233485036
Task_48731,2186,637,30,164,194,3.426332288401254,44.110241077936045
Task_48732,1142,539,150,63,213,2.1148148148148147,26.704266214097796
Task_48733,1191,813,118,37,155,1.4631449631449631,27.53988467613262
Task_48734,2602,979,49,99,148,2.6551020408163266,51.25576678157692
Task_48735,1387,656,66,111,177,2.111111111111111,31.260650866886067
Task_48736,2179,693,181,53,234,3.139769452449568,43.74511822814144
Task_48737,526,101,43,43,86,5.1568627450980395,13.712757861059709
Task_48738,2455,352,69,155,224,6.954674220963173,47.64783127232812
Task_48739,2380,625,110,74,184,3.801916932907348,46.37489935101388
Task_48740,2423,289,21,199,220,8.355172413793104,46.82985231238818
Task_48741,2541,202,148,135,283,12.517241379310345,48.57823774680792
Task_48742,1852,750,149,31,180,2.466045272969374,38.02977546854341
Task_48743,1272,540,70,52,122,2.3512014787430684,28.132837561850405
Task_48744,1904,851,174,187,361,2.2347417840375585,41.059279439790416
Task_48745,2631,149,60,160,220,17.54,49.30883423694442
Task_48746,2893,266,51,64,115,10.835205992509364,53.04406469517536
Task_48747,1480,106,188,13,201,13.83177570093458,29.63624284438357
Task_48748,1027,814,61,138,199,1.2601226993865031,26.257414910931868
Task_48749,571,615,53,198,251,0.926948051948052,18.71174259238077
Task_48750,2547,991,126,135,261,2.567540322580645,51.15742955336348
Task_48751,1285,220,89,92,181,5.8144796380090495,28.038617257165257
Task_48752,1058,756,73,39,112,1.3976221928665786,24.921537443152673
Task_48753,1315,999,146,100,246,1.315,31.487307268369893
Task_48754,2132,952,12,89,101,2.237145855194124,43.12936910269275
Task_48755,2970,182,150,134,284,16.229508196721312,55.10315022376569
Task_48756,581,932,120,35,155,0.6227224008574491,18.621844938444756
Task_48757,2104,223,184,112,296,9.392857142857142,41.784858609366346
Task_48758,752,628,177,113,290,1.1955484896661368,21.60540651492201
Task_48759,2078,212,90,25,115,9.755868544600938,39.32741322592744
Task_48760,2984,710,71,179,250,4.19690576652602,57.34151285751068
Task_48761,2572,690,77,35,112,3.7221418234442836,48.74614160154144
Task_48762,926,127,93,150,243,7.234375,22.32521957585466
Task_48763,1575,307,135,185,320,5.113636363636363,33.9343431095329
Task_48764,1330,201,44,35,79,6.584158415841584,26.902695337512345
Task_48765,736,101,175,134,309,7.215686274509804,19.188844789993663
Task_48766,872,331,41,199,240,2.6265060240963853,22.568161910528687
Task_48767,1968,171,57,97,154,11.44186046511628,38.06467019959313
Task_48768,747,153,105,25,130,4.85064935064935,17.968590368195333
Task_48769,1538,606,78,105,183,2.5337726523887976,33.52123554214862
Task_48770,1663,961,65,65,130,1.7286902286902286,35.88418473051678
Task_48771,2132,486,97,90,187,4.37782340862423,42.40989225345061
Task_48772,2111,647,182,131,313,3.257716049382716,43.40094909145381
Task_48773,858,292,196,41,237,2.9283276450511946,21.273625286393877
Task_48774,1269,970,145,94,239,1.3069001029866116,30.55838080929126
Task_48775,1905,278,86,72,158,6.827956989247312,37.4912142378333
Task_48776,2211,912,92,51,143,2.4216867469879517,44.305279392589334
Task_48777,1639,211,29,159,188,7.731132075471698,33.983714701244345
Task_48778,1135,908,138,166,304,1.2486248624862486,28.640765926042437
Task_48779,1231,298,122,59,181,4.117056856187291,26.940438665372934
Task_48780,1651,850,14,134,148,1.9400705052878966,35.73711968900714
Task_48781,2551,911,102,105,207,2.7971491228070176,50.683872323231505
Task_48782,2345,924,184,111,295,2.535135135135135,47.865664416996445
Task_48783,1894,623,124,166,290,3.03525641025641,39.83606354268232
Task_48784,674,531,22,198,220,1.2669172932330828,19.781728745784424
Task_48785,860,82,45,57,102,10.36144578313253,19.074166040906007
Task_48786,2032,97,134,36,170,20.73469387755102,37.84301282390124
Task_48787,1595,604,27,67,94,2.6363636363636362,33.22476630962502
Task_48788,1675,538,86,99,185,3.1076066790352503,35.422580438443866
Task_48789,2369,527,53,172,225,4.486742424242424,46.938420439585464
Task_48790,2053,689,24,91,115,2.97536231884058,41.370372376076766
Task_48791,1461,574,138,161,299,2.5408695652173914,32.857804908413854
Task_48792,1070,874,188,150,338,1.2228571428571429,27.635312582333103
Task_48793,2661,123,41,24,65,21.45967741935484,47.15288946577879
Task_48794,616,673,64,161,225,0.913946587537092,19.43163419584424
Task_48795,1718,896,200,67,267,1.915273132664437,37.21170643349653
Task_48796,1824,999,16,121,137,1.824,38.81367229170545
Task_48797,2486,445,63,131,194,5.573991031390134,48.283428986483166
Task_48798,1361,531,79,42,121,2.558270676691729,29.16968853013041
Task_48799,1600,96,131,82,213,16.49484536082474,31.901643475055664
Task_48800,1745,233,170,15,185,7.457264957264957,34.54607948288275
Task_48801,1499,406,193,98,291,3.6830466830466833,32.80081799445693
Task_48802,587,546,94,146,240,1.0731261425959782,18.57847106382579
Task_48803,760,457,39,198,237,1.6593886462882097,21.165849559170415
Task_48804,1407,905,47,31,78,1.5529801324503312,30.284178181333473
Task_48805,737,448,31,80,111,1.641425389755011,19.59086816923683
Task_48806,2141,789,149,151,300,2.710126582278481,44.292891465278274
Task_48807,731,734,47,68,115,0.9945578231292517,20.24170287479603
Task_48808,1785,970,45,122,167,1.8383110195674561,38.383997635853454
Task_48809,2999,929,28,163,191,3.224731182795699,57.89288854273838
Task_48810,632,794,167,76,243,0.7949685534591195,19.70746476539563
Task_48811,1201,615,45,65,110,1.9496753246753247,27.16124511865959
Task_48812,2950,972,23,163,186,3.0318602261048304,57.15726445091183
Task_48813,1537,753,175,106,281,2.0384615384615383,34.460036761418586
Task_48814,2516,667,185,90,275,3.7664670658682633,49.48270153857178
Task_48815,2166,483,64,97,161,4.475206611570248,42.891417173995286
Task_48816,1430,729,124,140,264,1.9589041095890412,32.66338273519992
Task_48817,1234,965,180,58,238,1.2774327122153208,29.516630360619846
Task_48818,687,94,185,127,312,7.231578947368421,18.30245761678514
Task_48819,1728,332,74,71,145,5.1891891891891895,35.03244449006686
Task_48820,2578,885,119,133,252,2.909706546275395,51.27429689814687
Task_48821,2659,231,99,53,152,11.461206896551724,49.137282709598736
Task_48822,2144,216,83,126,209,9.880184331797235,42.0721967788354
Task_48823,569,129,22,10,32,4.376923076923077,13.940797482570751
Task_48824,540,138,45,104,149,3.884892086330935,15.30618210549838
Task_48825,659,1011,172,44,216,0.6511857707509882,20.587374098897396
Task_48826,1865,781,141,193,334,2.3849104859335037,40.11009123087565
Task_48827,2905,472,168,89,257,6.141649048625792,54.91092072966145
Task_48828,2197,253,142,65,207,8.649606299212598,42.45400677947893
Task_48829,2921,430,188,121,309,6.7772621809744775,55.49432464671046
Task_48830,2432,260,142,137,279,9.31800766283525,47.0628447630813
Task_48831,2429,366,47,87,134,6.618528610354224,46.316823068480396
Task_48832,2629,270,184,92,276,9.70110701107011,50.03233759011663
Task_48833,2642,476,182,86,268,5.538784067085954,50.729402299405194
Task_48834,2587,506,199,35,234,5.102564102564102,49.32225311656783
Task_48835,567,764,38,132,170,0.7411764705882353,18.27300084519746
Task_48836,1010,322,106,67,173,3.126934984520124,23.67959554514111
Task_48837,725,233,113,168,281,3.0982905982905984,20.054439435776697
Task_48838,1707,826,18,82,100,2.064087061668682,35.87513112939153
Task_48839,532,679,108,93,201,0.7823529411764706,17.811980099057198
Task_48840,1971,100,17,181,198,19.514851485148515,38.06298416682021
Task_48841,1658,804,66,168,234,2.0596273291925464,36.53764417695397
Task_48842,915,734,87,95,182,1.2448979591836735,23.701676187059054
Task_48843,1999,857,95,117,212,2.3298368298368297,41.87916570738961
Task_48844,1332,794,190,198,388,1.6754716981132076,31.94366891841985
Task_48845,994,551,48,169,217,1.8007246376811594,25.15627813098872
Task_48846,2819,874,112,115,227,3.2217142857142855,54.91941999097261
Task_48847,2437,483,146,34,180,5.035123966942149,46.451635617634366
Task_48848,1266,493,174,30,204,2.562753036437247,28.235065663684747
Task_48849,1085,928,83,166,249,1.1679224973089344,27.73128233820211
Task_48850,559,959,30,76,106,0.5822916666666667,18.33041408266949
Task_48851,2342,845,48,21,69,2.768321513002364,44.778747937313845
Task_48852,1242,400,74,147,221,3.0972568578553616,28.59971677691947
Task_48853,2979,720,185,60,245,4.1317614424410545,56.4461405294422
Task_48854,690,536,70,191,261,1.2849162011173185,20.439732765007726
Task_48855,2964,627,28,146,174,4.719745222929936,56.2221332622395
Task_48856,2380,1022,173,148,321,2.326490713587488,48.896960916176546
Task_48857,1146,649,38,161,199,1.763076923076923,27.652223580632622
Task_48858,579,153,58,126,184,3.75974025974026,16.5847466207277
Task_48859,1262,970,188,156,344,1.2996910401647785,31.041950398251075
Task_48860,1520,964,138,29,167,1.5751295336787565,33.39115023578689
Task_48861,1442,332,135,116,251,4.33033033033033,31.501678439832446
Task_48862,2305,764,143,112,255,3.0130718954248366,46.55274250441774
Task_48863,667,172,73,192,265,3.8554913294797686,18.670640815440525
Task_48864,2641,273,119,185,304,9.638686131386862,50.59613566301007
Task_48865,1467,900,35,138,173,1.6281908990011098,33.31639745991054
Task_48866,1292,525,112,10,122,2.456273764258555,27.89998833877013
Task_48867,2386,855,43,85,128,2.7873831775700935,47.29996522392107
Task_48868,1942,257,122,32,154,7.5271317829457365,37.62554668710893
Task_48869,1226,198,43,40,83,6.160804020100502,25.560398184148266
Task_48870,1633,938,61,112,173,1.739084132055378,36.12154281287513
Task_48871,837,1004,27,121,148,0.8328358208955224,23.131853221493827
Task_48872,1716,899,72,24,96,1.9066666666666667,35.68052956246924
Task_48873,773,345,23,125,148,2.2341040462427744,20.286962290071212
Task_48874,1346,743,189,128,317,1.8091397849462365,31.59760765495557
Task_48875,2968,102,65,185,250,28.815533980582526,54.128834692737776
Task_48876,1851,215,41,145,186,8.569444444444445,37.19501872347896
Task_48877,2704,896,168,155,323,3.0144927536231885,53.657437664808036
Task_48878,2007,401,145,111,256,4.992537313432836,40.68112938083139
Task_48879,2488,408,133,10,143,6.083129584352078,46.61693863536396
Task_48880,1540,802,12,22,34,1.917808219178082,31.663693617101387
Task_48881,1213,604,82,37,119,2.0049586776859503,26.952744389206817
Task_48882,1012,219,192,58,250,4.6,23.727512028266357
Task_48883,1329,764,59,54,113,1.7372549019607844,29.597868469853058
Task_48884,2576,358,186,186,372,7.1754874651810585,50.173195717165356
Task_48885,586,343,24,117,141,1.7034883720930232,17.22708599833501
Task_48886,930,472,77,96,173,1.9661733615221988,23.55857737689838
Task_48887,1847,765,148,33,181,2.411227154046997,38.00147486240534
Task_48888,1813,109,168,154,322,16.48181818181818,36.22165826777325
Task_48889,2305,78,69,178,247,29.17721518987342,43.46905081330379
Task_48890,1652,120,184,100,284,13.652892561983471,33.75816121130955
Task_48891,2042,138,196,188,384,14.690647482014388,40.62059954727089
Task_48892,1643,590,138,115,253,2.7800338409475467,35.51551446748943
Task_48893,1150,696,170,94,264,1.6499282639885222,27.988774787695196
Task_48894,2343,659,43,175,218,3.55,46.76338353824423
Task_48895,2366,269,105,69,174,8.762962962962963,44.92372543100205
Task_48896,1079,960,112,31,143,1.1227887617065557,26.15308915466461
Task_48897,2020,187,170,141,311,10.74468085106383,40.53615000134133
Task_48898,1379,118,135,123,258,11.588235294117647,29.350124563357568
Task_48899,1368,855,147,92,239,1.5981308411214954,31.775900393355045
Task_48900,1320,475,116,140,256,2.773109243697479,30.088441857178353
Task_48901,2798,724,64,103,167,3.8593103448275863,53.76458826066486
Task_48902,1296,150,194,171,365,8.582781456953642,28.84429202573243
Task_48903,1226,933,28,75,103,1.3126338329764453,28.540615359768115
Task_48904,851,768,18,101,119,1.106631989596879,22.32860402033444
Task_48905,2493,370,51,138,189,6.7196765498652296,48.174573751513144
Task_48906,1907,353,181,142,323,5.387005649717514,39.28843693689691
Task_48907,2959,351,61,126,187,8.40625,55.376651697470884
Task_48908,1473,736,168,52,220,1.9986431478968791,32.62685267997244
Task_48909,2530,699,61,49,110,3.6142857142857143,47.98669294193929
Task_48910,1113,462,126,44,170,2.4038876889848813,25.334467198007715
Task_48911,2337,488,75,40,115,4.779141104294479,44.4558128918679
Task_48912,2817,665,66,83,149,4.22972972972973,53.44673960883197
Task_48913,2855,957,111,27,138,2.980167014613779,54.21450565003149
Task_48914,1606,262,11,66,77,6.106463878326996,31.659199429861747
Task_48915,1292,892,126,134,260,1.446808510638298,30.888520430534015
Task_48916,1729,905,82,151,233,1.9083885209713025,37.917246869859746
Task_48917,777,191,108,68,176,4.046875,19.584491055700177
Task_48918,2950,544,51,49,100,5.412844036697248,54.1253996981085
Task_48919,855,298,158,31,189,2.859531772575251,21.00478887602694
Task_48920,1597,367,50,110,160,4.3396739130434785,33.5142008527869
Task_48921,1698,96,60,101,161,17.50515463917526,33.15262654921121
Task_48922,2235,850,167,57,224,2.6263219741480612,44.99271386026786
Task_48923,2891,1001,199,53,252,2.885229540918164,56.07178042198106
Task_48924,2972,161,12,189,201,18.34567901234568,54.60163593763917
Task_48925,2128,154,25,107,132,13.729032258064516,40.37898269302887
Task_48926,2821,238,66,37,103,11.803347280334728,51.00341148186866
Task_48927,1703,742,194,162,356,2.292059219380888,37.475554729721644
Task_48928,592,110,76,163,239,5.333333333333333,16.78863815861728
Task_48929,1681,994,108,75,183,1.6894472361809045,36.43582301012747
Task_48930,1858,792,79,112,191,2.343001261034048,39.401006998219756
Task_48931,2762,722,25,179,204,3.8201936376210237,53.577081236609416
Task_48932,644,412,52,45,97,1.5593220338983051,17.07014765989769
Task_48933,1920,321,18,58,76,5.962732919254658,36.70075778233342
Task_48934,1064,218,94,101,195,4.858447488584475,24.956041889455566
Task_48935,2088,545,11,169,180,3.8241758241758244,41.99364443656476
Task_48936,872,281,196,34,230,3.0921985815602837,21.43704895870488
Task_48937,1245,522,101,191,292,2.3804971319311665,29.28647603470868
Task_48938,1486,996,194,30,224,1.4904714142427282,33.38035256399815
Task_48939,1113,826,21,133,154,1.3458282950423217,26.990952249104065
Task_48940,2365,910,107,54,161,2.5960482985729967,46.72544151658576
Task_48941,1215,251,191,93,284,4.821428571428571,27.693668309160003
Task_48942,1735,658,21,170,191,2.6327769347496206,36.96798051085446
Task_48943,514,79,191,167,358,6.425,15.852563990530548
Task_48944,641,206,144,76,220,3.0966183574879227,17.867732949329937
Task_48945,970,404,131,196,327,2.3950617283950617,24.726160020426846
Task_48946,2871,635,13,112,125,4.514150943396227,54.358393149362485
Task_48947,2822,962,123,114,237,2.930425752855659,55.28583742721753
Task_48948,2367,251,76,129,205,9.392857142857142,45.795855064006425
Task_48949,2660,1015,88,21,109,2.6181102362204722,51.02456544838629
Task_48950,1962,762,140,64,204,2.5714285714285716,40.3571818381028
Task_48951,2336,967,102,54,156,2.4132231404958677,46.411777484542405
Task_48952,2786,238,172,153,325,11.656903765690377,52.80456117582171
Task_48953,2056,357,97,173,270,5.743016759776537,41.488940052338315
Task_48954,2512,911,10,159,169,2.754385964912281,49.79123037171728
Task_48955,2144,503,165,44,209,4.253968253968254,42.162225931587464
Task_48956,2756,260,188,89,277,10.559386973180077,51.91596176264187
Task_48957,2218,669,40,115,155,3.31044776119403,44.12880119363471
Task_48958,1222,77,27,106,133,15.666666666666666,25.386891993660495
Task_48959,1762,218,10,133,143,8.045662100456621,35.415841102859545
Task_48960,2948,880,137,40,177,3.3461975028376845,55.78008596471907
Task_48961,1934,584,103,173,276,3.305982905982906,40.29353241775699
Task_48962,1848,278,103,72,175,6.623655913978495,36.83132532041633
Task_48963,2689,741,164,123,287,3.623989218328841,52.7240444931788
Task_48964,1570,863,76,19,95,1.8171296296296295,33.098263633254014
Task_48965,1777,75,41,73,114,23.38157894736842,33.81991675793348
Task_48966,570,436,99,155,254,1.3043478260869565,18.04232643282273
Task_48967,2915,950,60,162,222,3.0651945320715037,56.85279280200829
Task_48968,713,72,95,174,269,9.767123287671232,18.567428104517905
Task_48969,2007,993,129,45,174,2.0191146881287727,41.275474317326946
Task_48970,1149,436,19,54,73,2.6292906178489703,24.964967866462697
Task_48971,2651,650,189,76,265,4.072196620583718,51.30485566987437
Task_48972,2674,168,28,137,165,15.822485207100591,49.586415361664216
Task_48973,2653,909,26,194,220,2.9153846153846152,52.52387897022774
Task_48974,1811,354,149,30,179,5.101408450704225,36.11816222308984
Task_48975,2352,554,134,14,148,4.237837837837838,44.91564547310558
Task_48976,1333,324,141,108,249,4.101538461538461,29.730893697278294
Task_48977,2520,646,20,124,144,3.894899536321484,48.78573667548611
Task_48978,2085,1019,184,54,238,2.0441176470588234,43.244878951407635
Task_48979,2772,76,116,60,176,36.0,49.59943530739803
Task_48980,2459,899,159,115,274,2.732222222222222,49.5052467683304
Task_48981,2449,194,196,179,375,12.558974358974359,47.50079248253183
Task_48982,1600,193,40,155,195,8.24742268041237,33.34439446632701
Task_48983,621,422,101,13,114,1.4680851063829787,16.82847719900001
Task_48984,521,355,108,183,291,1.4634831460674158,17.21810079557611
Task_48985,2055,457,97,62,159,4.486899563318778,40.349424323824586
Task_48986,1500,453,109,40,149,3.303964757709251,31.278343919591823
Task_48987,2095,509,88,114,202,4.107843137254902,42.203765353250866
Task_48988,861,472,15,98,113,1.8202959830866807,21.91002937434385
Task_48989,2810,288,183,118,301,9.72318339100346,53.210008911466275
Task_48990,512,902,103,65,168,0.5669988925802879,17.62367977125682
Task_48991,2809,898,93,163,256,3.124582869855395,55.14915741455647
Task_48992,2323,468,174,93,267,4.953091684434968,45.858295963432454
Task_48993,1658,284,84,153,237,5.817543859649123,34.79545838383529
Task_48994,1362,832,57,193,250,1.6350540216086435,32.06642744124145
Task_48995,1439,145,160,121,281,9.856164383561644,30.644598912652118
Task_48996,1695,934,37,59,96,1.8128342245989304,35.65456981403221
Task_48997,552,399,90,22,112,1.38,15.78300132633963
Task_48998,2008,342,108,163,271,5.854227405247814,40.645807372117936
Task_48999,582,931,157,179,336,0.6244635193133047,20.356347585984498
Task_49000,2543,125,65,66,131,20.182539682539684,46.43051750196437
Task_49001,1098,75,157,89,246,14.447368421052632,24.259974626159664
Task_49002,2426,128,135,195,330,18.8062015503876,46.31223318871715
Task_49003,2141,407,61,151,212,5.247549019607843,42.809490927871906
Task_49004,2310,248,185,125,310,9.27710843373494,45.213453566267084
Task_49005,2175,94,110,143,253,22.894736842105264,41.41719071107767
Task_49006,1395,796,116,102,218,1.7503136762860727,32.0410684940031
Task_49007,749,140,119,172,291,5.3120567375886525,19.839518165404197
Task_49008,2747,973,109,100,209,2.820328542094456,53.98497225807504
Task_49009,2248,865,159,13,172,2.595842956120092,44.56258798290554
Task_49010,1565,202,162,11,173,7.70935960591133,31.621251305087853
Task_49011,2552,885,47,166,213,2.880361173814898,50.78530125910771
Task_49012,2554,818,50,173,223,3.1184371184371185,50.801659814065744
Task_49013,1733,607,66,38,104,2.8503289473684212,35.0329368927999
Task_49014,2186,84,123,82,205,25.71764705882353,41.05554863243946
Task_49015,2824,454,64,73,137,6.206593406593407,52.73799768249652
Task_49016,2314,532,11,86,97,4.341463414634147,44.560169449117524
Task_49017,2099,1008,132,15,147,2.0802775024777005,42.35316585594031
Task_49018,2813,771,118,157,275,3.643782383419689,54.77873537599385
Task_49019,2289,565,104,30,134,4.044169611307421,44.12290568817556
Task_49020,558,331,91,183,274,1.680722891566265,17.755340794727974
Task_49021,2117,251,149,178,327,8.40079365079365,42.32927475737855
Task_49022,2413,164,179,127,306,14.624242424242425,46.19995050653707
Task_49023,581,720,83,191,274,0.8058252427184466,19.234036104816685
Task_49024,1082,139,11,86,97,7.728571428571429,23.35104856905237
Task_49025,2905,640,42,177,219,4.53198127925117,55.61180633830444
Task_49026,2083,1010,172,138,310,2.060336300692384,44.08876610642992
Task_49027,1734,66,173,102,275,25.880597014925375,34.484816390231714
Task_49028,2843,795,64,169,233,3.571608040201005,55.2858467806538
Task_49029,2194,514,174,103,277,4.260194174757282,44.08944341144016
Task_49030,902,504,180,35,215,1.7861386138613862,22.553912311722986
Task_49031,2629,538,75,112,187,4.877551020408164,50.76014946379553
Task_49032,2537,349,57,15,72,7.248571428571428,46.058897285061185
Task_49033,1952,315,38,157,195,6.177215189873418,39.33045897131593
Task_49034,585,763,123,23,146,0.7657068062827225,17.798106686217455
Task_49035,1790,286,20,175,195,6.2369337979094075,36.66498364828071
Task_49036,1226,746,200,149,349,1.641231593038822,29.867528717906026
Task_49037,2321,536,111,121,232,4.322160148975791,45.9942675748801
Task_49038,959,347,190,87,277,2.7557471264367814,23.731346317981245
Task_49039,1976,331,17,98,115,5.951807228915663,38.924338522455756
Task_49040,2572,613,72,120,192,4.188925081433225,50.15996139919192
Task_49041,957,132,198,165,363,7.195488721804511,23.32296254814216
Task_49042,1937,811,119,142,261,2.3854679802955663,40.94068837038158
Task_49043,1399,95,55,105,160,14.572916666666666,28.446523184179103
Task_49044,1564,373,129,22,151,4.181818181818182,31.977189638843043
Task_49045,761,287,74,69,143,2.642361111111111,19.466757833053006
Task_49046,1513,68,69,103,172,21.92753623188406,30.49377606925547
Task_49047,2107,549,70,87,157,3.830909090909091,41.90881405058352
Task_49048,1322,714,59,68,127,1.848951048951049,29.72388741743256
Task_49049,2602,340,151,31,182,7.6304985337243405,48.59087848968611
Task_49050,2956,925,61,61,122,3.1922246220302375,55.879868421159046
Task_49051,2791,895,65,158,223,3.114955357142857,54.71185875108447
Task_49052,1804,747,178,86,264,2.411764705882353,38.30104684441929
Task_49053,961,949,18,21,39,1.0115789473684211,23.155820465936717
Task_49054,700,512,112,49,161,1.364522417153996,18.90520250290894
Task_49055,2068,470,77,22,99,4.3906581740976645,39.8627878057982
Task_49056,559,828,108,43,151,0.6743063932448733,17.856200446468176
Task_49057,1682,148,74,137,211,11.288590604026846,34.32083510921148
Task_49058,657,447,105,12,117,1.4665178571428572,17.497358031878324
Task_49059,2021,234,188,45,233,8.6,39.39469194753098
Task_49060,1838,919,104,106,210,1.9978260869565216,39.425891226073254
Task_49061,2197,114,94,77,171,19.104347826086958,41.06607048313842
Task_49062,1891,477,78,176,254,3.9560669456066946,39.30808265153856
Task_49063,538,405,32,28,60,1.3251231527093597,14.92606825593869
Task_49064,1655,829,96,102,198,1.9939759036144578,36.239178242559085
Task_49065,905,252,101,144,245,3.5770750988142295,22.763197469370358
Task_49066,2933,230,113,89,202,12.696969696969697,54.25972415640706
Task_49067,2228,628,76,15,91,3.5421303656597773,42.774826040421935
Task_49068,2698,119,46,12,58,22.483333333333334,47.60918751440108
Task_49069,1135,140,151,29,180,8.049645390070921,24.41283195388263
Task_49070,2148,79,89,142,231,26.85,40.84843682657233
Task_49071,1431,460,19,32,51,3.10412147505423,29.22952489584816
Task_49072,1607,251,118,100,218,6.376984126984127,33.66551452185474
Task_49073,1302,415,51,45,96,3.1298076923076925,27.49371161715109
Task_49074,2927,223,140,133,273,13.066964285714286,54.70919434876339
Task_49075,2163,705,101,113,214,3.0637393767705383,43.934656692725355
Task_49076,2551,973,92,49,141,2.6190965092402463,49.69676339595562
Task_49077,1734,284,119,20,139,6.08421052631579,34.167505965029356
Task_49078,636,274,185,14,199,2.3127272727272725,17.362455825145737
Task_49079,965,941,176,22,198,1.0244161358811041,24.740267744435414
Task_49080,2134,1016,100,12,112,2.0983284169124876,42.71181821883329
Task_49081,2264,712,108,36,144,3.1753155680224405,44.19316707451327
Task_49082,2092,607,99,27,126,3.4407894736842106,41.038844439718986
Task_49083,2480,435,107,198,305,5.6880733944954125,48.62621394473829
Task_49084,2015,148,112,62,174,13.523489932885907,38.65963428191488
Task_49085,1046,279,178,124,302,3.7357142857142858,25.307972192993322
Task_49086,1974,380,117,32,149,5.181102362204724,38.568737169241054
Task_49087,1281,376,152,182,334,3.3978779840848805,29.568608057722724
Task_49088,1837,299,11,115,126,6.123333333333333,36.87534808848168
Task_49089,1228,71,147,102,249,17.055555555555557,26.395692725502936
Task_49090,1957,920,77,36,113,2.1248642779587406,39.80409795521367
Task_49091,2251,806,133,89,222,2.7893432465923174,45.45889565314612
Task_49092,1290,149,143,44,187,8.6,27.07504024605458
Task_49093,900,286,116,184,300,3.1358885017421603,23.101919240968133
Task_49094,2013,498,33,185,218,4.034068136272545,41.07477025153512
Task_49095,519,368,24,175,199,1.4065040650406504,16.799714609710193
Task_49096,1433,101,48,44,92,14.049019607843137,27.904954745027073
Task_49097,2975,458,115,13,128,6.481481481481482,54.5495858076448
Task_49098,2070,541,94,91,185,3.819188191881919,41.564123835021114
Task_49099,770,65,98,148,246,11.666666666666666,19.30547099185807
Task_49100,1608,524,161,22,183,3.0628571428571427,33.38190002570069
Task_49101,2937,67,99,109,208,43.19117647058823,52.923295493553844
Task_49102,1080,334,72,82,154,3.2238805970149254,24.865248665080255
Task_49103,1940,855,134,129,263,2.2663551401869158,41.115428589923674
Task_49104,2042,809,85,59,144,2.5209876543209875,41.18707001181857
Task_49105,1057,338,120,159,279,3.117994100294985,25.62128290717838
Task_49106,1633,1015,57,122,179,1.6072834645669292,36.32265117692895
Task_49107,2091,752,195,30,225,2.7768924302788847,42.2096669406166
Task_49108,995,569,80,32,112,1.7456140350877194,23.382974107918717
Task_49109,2064,885,150,194,344,2.329571106094808,43.634035854818535
Task_49110,2146,785,10,185,195,2.7302798982188294,43.93819189348822
Task_49111,2015,541,150,65,215,3.717712177121771,40.566414084223815
Task_49112,1546,206,107,123,230,7.468599033816425,32.63010437625676
Task_49113,1362,999,120,161,281,1.362,32.47052171972036
Task_49114,2336,979,115,108,223,2.3836734693877553,47.56552650532752
Task_49115,2317,214,158,121,279,10.776744186046512,45.05073446917026
Task_49116,1859,869,32,44,76,2.136781609195402,37.2341399142943
Task_49117,755,542,80,120,200,1.3904235727440146,21.135322067556356
Task_49118,1434,964,71,129,200,1.4860103626943004,33.24100709795287
Task_49119,2549,283,177,53,230,8.975352112676056,48.2435093270281
Task_49120,1528,229,189,122,311,6.643478260869565,32.79190710995318
Task_49121,2805,230,88,127,215,12.142857142857142,52.559428548222634
Task_49122,2382,343,25,69,94,6.924418604651163,44.816226646692535
Task_49123,2157,775,189,70,259,2.779639175257732,43.754476309692144
Task_49124,2878,589,103,173,276,4.877966101694915,55.25861645563227
Task_49125,1747,531,141,44,185,3.2838345864661656,35.72390017935856
Task_49126,1478,774,54,186,240,1.9070967741935483,33.68237215199978
Task_49127,1785,339,122,26,148,5.25,35.38440555325242
Task_49128,2255,530,35,129,164,4.246704331450094,44.55306698923092
Task_49129,2639,454,85,177,262,5.8,51.02779614759496
Task_49130,1691,339,127,16,143,4.973529411764706,33.748511038154824
Task_49131,2226,341,60,90,150,6.508771929824562,43.10486239941289
Task_49132,2725,333,179,19,198,8.158682634730539,50.529538705460915
Task_49133,1606,305,78,22,100,5.248366013071895,32.079829045593755
Task_49134,1621,933,163,73,236,1.7355460385438972,35.684068375584225
Task_49135,2030,720,193,121,314,2.8155339805825244,42.33738121851888
Task_49136,735,69,138,143,281,10.5,18.876737426039863
Task_49137,1408,162,130,37,167,8.63803680981595,28.795646444710908
Task_49138,819,966,67,159,226,0.8469493278179938,23.569424117421182
Task_49139,1102,427,195,143,338,2.574766355140187,26.859836675485116
Task_49140,589,317,147,168,315,1.8522012578616351,18.328298205911334
Task_49141,2676,663,12,96,108,4.030120481927711,51.06178470990929
Task_49142,951,288,167,142,309,3.290657439446367,23.89363058921389
Task_49143,1267,795,151,187,338,1.5917085427135678,30.67550474853842
Task_49144,1855,933,97,104,201,1.9860813704496787,39.71898916856993
Task_49145,2523,773,192,131,323,3.25968992248062,50.36895548100341
Task_49146,1034,979,58,200,258,1.0551020408163265,27.16955996558389
Task_49147,1140,370,39,143,182,3.07277628032345,26.406467693172754
Task_49148,1027,489,12,189,201,2.095918367346939,25.320315129727884
Task_49149,913,232,174,149,323,3.9184549356223175,23.18209679746934
Task_49150,1180,449,200,101,301,2.6222222222222222,27.935716074230672
Task_49151,1293,91,140,102,242,14.054347826086957,27.548006092770464
Task_49152,2564,905,43,59,102,2.8300220750551874,49.33740011592372
Task_49153,1463,942,51,156,207,1.5514316012725344,33.7716949320437
Task_49154,623,878,162,183,345,0.7087599544937428,20.800783461818664
Task_49155,2039,755,51,181,232,2.697089947089947,42.50395354960646
Task_49156,626,280,63,107,170,2.227758007117438,17.99236640093746
Task_49157,2085,593,185,60,245,3.51010101010101,41.884029815109955
Task_49158,1964,346,38,34,72,5.659942363112392,37.25889461449632
Task_49159,2341,1007,42,49,91,2.322420634920635,45.880876902589925
Task_49160,1637,714,140,99,239,2.2895104895104894,35.70806362516536
Task_49161,2114,1020,17,17,34,2.0705190989226248,41.18276641604625
Task_49162,2361,919,162,128,290,2.5663043478260867,48.10598580243894
Task_49163,2152,929,104,74,178,2.313978494623656,43.68621744150195
Task_49164,1486,307,102,138,240,4.824675324675325,32.097643374719745
Task_49165,1362,701,100,14,114,1.9401709401709402,29.471576027221747
Task_49166,1164,833,108,98,206,1.39568345323741,28.38453973596047
Task_49167,1709,652,194,87,281,2.6171516079632466,36.58664313209077
Task_49168,2502,717,187,62,249,3.4846796657381613,48.93272962828979
Task_49169,2725,676,158,40,198,4.025110782865584,51.88124063414066
Task_49170,2181,994,64,33,97,2.191959798994975,43.18479491426396
Task_49171,2567,748,105,36,141,3.427236315086782,49.072571870360456
Task_49172,1511,611,24,71,95,2.468954248366013,31.943896689962703
Task_49173,1278,333,81,174,255,3.8263473053892216,29.117925467259592
Task_49174,2560,966,57,98,155,2.6473629782833505,50.597977170609
Task_49175,1413,143,87,80,167,9.8125,29.164369875536988
Task_49176,1620,304,95,71,166,5.311475409836065,33.271070569888515
Task_49177,1505,516,37,54,91,2.9110251450676983,31.305847421099596
Task_49178,1535,503,101,69,170,3.0456349206349205,32.41913565277722
Task_49179,1435,914,177,188,365,1.5683060109289617,33.80065782392979
Task_49180,1521,572,143,62,205,2.654450261780105,32.740172814755134
Task_49181,576,565,69,87,156,1.017667844522968,17.524210307044108
Task_49182,973,764,108,74,182,1.2718954248366012,24.447486162706838
Task_49183,2309,352,151,145,296,6.541076487252124,45.52673252687919
Task_49184,2460,843,140,193,333,2.914691943127962,49.72626938120917
Task_49185,1843,198,168,191,359,9.261306532663317,38.01651566521833
Task_49186,957,743,195,71,266,1.2862903225806452,24.647828949688147
Task_49187,1042,652,41,193,234,1.5957120980091883,26.219012732920234
Task_49188,1689,335,113,77,190,5.026785714285714,34.714076856511994
Task_49189,1431,467,63,169,232,3.0576923076923075,31.882454435295312
Task_49190,2382,174,137,32,169,13.611428571428572,44.173238469205096
Task_49191,2257,485,156,178,334,4.6440329218107,45.36041231388254
Task_49192,2515,436,183,142,325,5.755148741418764,49.19148135410315
Task_49193,2151,415,40,140,180,5.170673076923077,42.53626670853827
Task_49194,2290,657,89,75,164,3.480243161094225,45.11206318764974
Task_49195,2658,1017,66,144,210,2.611001964636542,52.90345148428273
Task_49196,2279,381,115,120,235,5.965968586387435,44.83751321791767
Task_49197,2550,224,81,38,119,11.333333333333334,46.866162086850004
Task_49198,1415,462,66,52,118,3.0561555075593954,30.066364238574266
Task_49199,753,574,59,115,174,1.3095652173913044,21.017923065483597
Task_49200,888,78,186,19,205,11.240506329113924,19.93961244549568
Task_49201,2853,106,80,30,110,26.66355140186916,50.45213169134299
Task_49202,2139,711,87,68,155,3.0042134831460676,42.46362561506897
Task_49203,1605,905,108,56,164,1.771523178807947,34.89386491334843
Task_49204,1209,531,71,57,128,2.2725563909774436,27.28130581356675
Task_49205,647,522,129,40,169,1.2370936902485659,18.13050174512429
Task_49206,1359,587,176,154,330,2.311224489795918,31.412856206160786
Task_49207,2601,968,137,90,227,2.6842105263157894,51.55744309729158
Task_49208,1463,130,119,148,267,11.16793893129771,30.823231308841844
Task_49209,2986,683,182,18,200,4.3654970760233915,55.789505510428654
Task_49210,1486,556,48,151,199,2.66786355475763,32.85497317730702
Task_49211,2621,190,123,114,237,13.722513089005236,49.5608798446357
Task_49212,932,835,40,73,113,1.1148325358851674,23.753739775164206
Task_49213,2820,895,109,107,216,3.1473214285714284,54.939733226428
Task_49214,1533,152,59,20,79,10.019607843137255,29.53476363364388
Task_49215,544,947,134,55,189,0.5738396624472574,18.570729584712854
Task_49216,1616,660,200,19,219,2.4447806354009076,34.12800222474112
Task_49217,1433,937,105,19,124,1.5277185501066097,31.34067082091236
Task_49218,1516,713,162,49,211,2.123249299719888,32.97942266446062
Task_49219,2946,465,193,174,367,6.3218884120171674,56.34480627228879
Task_49220,2129,388,129,23,152,5.473007712082262,40.949983628795316
Task_49221,2266,789,33,165,198,2.868354430379747,45.8818971164348
Task_49222,2166,714,153,26,179,3.0293706293706295,42.83606102912089
Task_49223,1959,1000,48,135,183,1.957042957042957,41.45684876386024
Task_49224,1511,913,170,57,227,1.6531728665207877,33.73549291934765
Task_49225,2799,901,146,101,247,3.1031042128603104,54.75668746522789
Task_49226,625,231,142,23,165,2.6939655172413794,16.950908397262165
Task_49227,668,857,24,33,57,0.7785547785547785,18.546909736937952
Task_49228,1720,394,24,134,158,4.3544303797468356,35.43790882496887
Task_49229,2412,179,155,162,317,13.4,46.26044198498018
Task_49230,1672,160,124,121,245,10.385093167701863,34.22503294155904
Task_49231,1985,917,116,51,167,2.162309368191721,40.844317250653084
Task_49232,1461,621,93,22,115,2.3488745980707395,31.000237074945574
Task_49233,2886,542,115,68,183,5.314917127071824,54.02533252966361
Task_49234,2617,437,115,76,191,5.974885844748859,49.74500770575224
Task_49235,840,568,122,91,213,1.476274165202109,22.315149483341212
Task_49236,2687,342,158,184,342,7.833819241982507,51.736247566310304
Task_49237,1910,929,70,152,222,2.053763440860215,40.85983055798935
Task_49238,1402,226,47,126,173,6.176211453744493,30.154009839942987
Task_49239,721,163,114,188,302,4.396341463414634,19.589489681617753
Task_49240,2339,178,100,142,242,13.067039106145252,44.72827538816822
Task_49241,1338,368,25,182,207,3.6260162601626016,29.920766177013274
Task_49242,1103,403,168,128,296,2.73019801980198,26.58815656424107
Task_49243,1828,548,132,109,241,3.3296903460837886,38.249424848775874
Task_49244,725,997,26,110,136,0.7264529058116233,21.379511102577442
Task_49245,507,703,84,192,276,0.7201704545454546,18.173158961797043
Task_49246,2805,630,46,25,71,4.445324881141046,51.462608254410185
Task_49247,1888,139,60,79,139,13.485714285714286,36.48861729996838
Task_49248,1581,184,44,94,138,8.545945945945945,32.2526794120162
Task_49249,1378,328,175,195,370,4.188449848024316,31.128540041564168
Task_49250,2584,691,138,126,264,3.7341040462427744,50.80368318245555
Task_49251,1925,523,18,55,73,3.6736641221374047,37.56877385660574
Task_49252,2704,290,56,16,72,9.292096219931272,48.52233602914859
Task_49253,805,761,14,165,179,1.0564304461942258,22.174858540092085
Task_49254,2054,894,189,21,210,2.2949720670391063,41.87035785297085
Task_49255,2999,678,164,138,302,4.41678939617084,57.524863789415214
Task_49256,2233,776,44,160,204,2.873873873873874,45.30386219266099
Task_49257,1693,745,187,181,368,2.2694369973190347,37.40844635570115
Task_49258,722,308,169,79,248,2.336569579288026,19.677477905988294
Task_49259,1217,442,59,200,259,2.7471783295711063,28.60962548175755
Task_49260,1935,770,125,90,215,2.509727626459144,40.332563281525076
Task_49261,883,109,13,112,125,8.027272727272727,20.162944919656642
Task_49262,2102,265,70,172,242,7.902255639097745,41.89077241304549
Task_49263,2049,662,82,13,95,3.090497737556561,40.0606764701528
Task_49264,2578,811,53,152,205,3.1748768472906406,51.02835838611446
Task_49265,2947,629,20,167,187,4.677777777777778,56.01254315733241
Task_49266,1817,760,52,73,125,2.3876478318002627,37.807697645430636
Task_49267,1209,323,172,125,297,3.7314814814814814,28.007920357901355
Task_49268,2771,194,186,115,301,14.21025641025641,52.15526601557571
Task_49269,2822,439,52,116,168,6.413636363636364,53.29609354831177
Task_49270,2182,89,190,110,300,24.244444444444444,41.75655826762727
Task_49271,694,562,97,117,214,1.2326820603907638,20.115571651947164
Task_49272,1321,558,102,127,229,2.363148479427549,30.22527277457007
Task_49273,1409,1006,65,142,207,1.3992055610724925,32.992591553348255
Task_49274,1453,332,143,169,312,4.363363363363363,32.02827253300307
Task_49275,2188,612,59,48,107,3.569331158238173,42.23884339537621
Task_49276,2013,339,66,151,217,5.920588235294118,40.57652226319117
Task_49277,2083,518,152,13,165,4.0134874759152215,40.840652969799706
Task_49278,2251,550,177,196,373,4.08529945553539,45.67609763898454
Task_49279,1443,564,87,77,164,2.5539823008849556,31.371679684999062
Task_49280,848,839,57,16,73,1.0095238095238095,20.997467648995446
Task_49281,2232,405,86,136,222,5.497536945812808,44.18005544563618
Task_49282,2358,168,117,87,204,13.95266272189349,44.69386860992969
Task_49283,861,312,45,70,115,2.7507987220447285,20.99699767304273
Task_49284,2140,779,122,187,309,2.7435897435897436,44.33908344239986
Task_49285,2787,89,170,173,343,30.966666666666665,51.53385255075657
Task_49286,2370,926,185,126,311,2.55663430420712,48.36214764098116
Task_49287,1349,126,148,50,198,10.622047244094489,27.938583339853647
Task_49288,1042,546,97,192,289,1.9049360146252285,26.159261085453096
Task_49289,2345,695,15,42,57,3.3692528735632186,44.53521386748991
Task_49290,935,460,33,110,143,2.0281995661605206,23.147476979711726
Task_49291,727,103,105,32,137,6.990384615384615,17.297176694097573
Task_49292,1347,739,25,98,123,1.8202702702702702,30.475384582661704
Task_49293,1357,421,125,50,175,3.2156398104265405,29.299464178927895
Task_49294,2031,729,142,180,322,2.782191780821918,42.50399239531629
Task_49295,2202,922,198,52,250,2.3856988082340194,44.89196228540677
Task_49296,1180,113,167,198,365,10.350877192982455,26.69298517138199
Task_49297,2978,172,137,40,177,17.213872832369944,53.56595498330601
Task_49298,2513,702,29,58,87,3.5746799431009957,47.75880109979198
Task_49299,2723,136,66,168,234,19.875912408759124,50.74124810699296
Task_49300,2910,907,131,68,199,3.2048458149779737,55.82893350294839
Task_49301,1044,179,122,52,174,5.8,23.569060844888423
Task_49302,1921,830,164,130,294,2.3116726835138386,40.87762154138425
Task_49303,2232,333,105,136,241,6.682634730538922,43.983555298140836
Task_49304,2381,538,51,102,153,4.417439703153989,46.4111840104778
Task_49305,1810,405,194,124,318,4.458128078817734,37.87537382384855
Task_49306,2744,253,115,75,190,10.803149606299213,51.09762647976245
Task_49307,1106,314,28,11,39,3.511111111111111,23.181916782179357
Task_49308,1345,466,142,186,328,2.880085653104925,30.847588099775948
Task_49309,2340,270,138,119,257,8.634686346863468,45.519440998973984
Task_49310,630,564,93,172,265,1.1150442477876106,19.483755489804963
Task_49311,1814,431,92,101,193,4.199074074074074,37.50328172433233
Task_49312,622,823,182,181,363,0.7548543689320388,20.57156664820388
Task_49313,2263,710,61,130,191,3.182841068917018,45.58368112602667
Task_49314,2746,296,163,80,243,9.245791245791246,51.62456724801195
Task_49315,2097,681,117,109,226,3.0747800586510263,42.86195069396356
Task_49316,2922,754,19,187,206,3.8701986754966886,56.1653764579495
Task_49317,1751,752,40,186,226,2.3253652058432936,37.7288819522787
Task_49318,1299,316,121,39,160,4.097791798107256,27.665474218810548
Task_49319,670,92,138,43,181,7.204301075268817,16.542018933521913
Task_49320,2839,101,166,38,204,27.833333333333332,51.083761022871364
Task_49321,2410,626,182,199,381,3.843700159489633,48.47626947911281
Task_49322,2894,700,178,187,365,4.128388017118402,56.28724721343381
Task_49323,2781,573,129,124,253,4.844947735191638,53.49574890649976
Task_49324,2956,514,198,16,214,5.739805825242718,54.91877154404717
Task_49325,1477,158,131,14,145,9.28930817610063,29.5781083283314
Task_49326,718,139,184,133,317,5.128571428571429,19.38967710198808
Task_49327,1591,636,124,115,239,2.497645211930926,34.77346739639491
Task_49328,1066,955,93,50,143,1.1150627615062763,26.117292280538607
Task_49329,1009,790,103,14,117,1.2756005056890012,24.083949529944704
Task_49330,2815,800,52,132,184,3.5143570536828963,54.4508974351045
Task_49331,2755,168,78,19,97,16.301775147928993,49.44091056297419
Task_49332,2441,920,51,66,117,2.6503800217155264,47.998209435393285
Task_49333,2440,275,153,167,320,8.840579710144928,47.472162025233054
Task_49334,840,762,179,140,319,1.1009174311926606,23.522758666011217
Task_49335,640,140,116,97,213,4.539007092198582,17.677443273838627
Task_49336,2169,339,58,60,118,6.379411764705883,41.54417449716744
Task_49337,686,495,142,177,319,1.3830645161290323,20.384649505042585
Task_49338,2597,960,48,138,186,2.7023933402705516,51.512857865580024
Task_49339,1040,954,52,10,62,1.0890052356020943,24.3905075128139
Task_49340,1482,114,88,176,264,12.88695652173913,30.9669145018257
Task_49341,713,798,162,115,277,0.8923654568210263,21.465387365370646
Task_49342,2772,994,74,82,156,2.785929648241206,53.790285985855256
Task_49343,1382,796,112,122,234,1.7340025094102887,31.936540303242463
Task_49344,615,916,199,137,336,0.6706652126499455,20.71340763025641
Task_49345,716,122,130,19,149,5.821138211382114,17.288388378159727
Task_49346,2646,504,37,77,114,5.23960396039604,50.001529689153074
Task_49347,729,918,92,78,170,0.7932535364526659,21.232570021539534
Task_49348,2063,402,15,116,131,5.119106699751861,40.82068078852447
Task_49349,2322,665,100,48,148,3.4864864864864864,44.95820696760487
Task_49350,678,89,51,59,110,7.533333333333333,16.37734860839289
Task_49351,601,571,186,112,298,1.0506993006993006,19.025594238303402
Task_49352,1844,856,87,33,120,2.15169194865811,37.7483073903537
Task_49353,1972,298,67,53,120,6.595317725752508,38.34645824756917
Task_49354,2276,559,78,147,225,4.064285714285714,45.49251568187416
Task_49355,1410,227,90,171,261,6.184210526315789,30.816915843723034
Task_49356,2607,951,123,140,263,2.7384453781512605,51.9998313556658
Task_49357,1418,639,184,171,355,2.215625,32.6477844236341
Task_49358,640,616,79,17,96,1.0372771474878444,17.70366618024614
Task_49359,532,525,184,154,338,1.0114068441064639,18.013563900058042
Task_49360,1175,274,117,32,149,4.2727272727272725,25.582688121927763
Task_49361,1458,158,180,38,218,9.169811320754716,30.0341676197534
Task_49362,1969,590,86,93,179,3.3316412859560067,40.089921270891175
Task_49363,1824,783,20,107,127,2.326530612244898,38.123426503843675
Task_49364,1882,911,178,118,296,2.06359649122807,40.503412730558985
Task_49365,1842,877,136,108,244,2.0979498861047836,39.5147697705004
Task_49366,1956,218,193,71,264,8.931506849315069,38.78891569251606
Task_49367,2587,485,20,99,119,5.323045267489712,49.12217586950026
Task_49368,796,751,110,13,123,1.0585106382978724,20.79558259206367
Task_49369,1511,404,171,117,288,3.730864197530864,32.99530663164138
Task_49370,1825,808,125,165,290,2.2558714462299134,39.32129261190993
Task_49371,2796,946,26,54,80,2.9524815205913413,52.91332825637513
Task_49372,2188,791,183,166,349,2.7626262626262625,45.28660079097377
Task_49373,2062,660,26,152,178,3.1195158850226927,41.95099976618652
Task_49374,871,270,174,188,362,3.2140221402214024,22.876763457793473
Task_49375,2595,75,166,95,261,34.14473684210526,47.85682924806671
Task_49376,2314,83,115,64,179,27.547619047619047,42.5273713681457
Task_49377,1114,871,192,143,335,1.2775229357798166,28.330520934790016
Task_49378,1214,197,134,13,147,6.1313131313131315,25.83166074437217
Task_49379,2895,146,111,70,181,19.693877551020407,52.368482066536224
Task_49380,1900,437,169,22,191,4.337899543378995,37.940944363356074
Task_49381,986,253,103,70,173,3.8818897637795278,23.075603230194094
Task_49382,1766,429,110,165,275,4.1069767441860465,37.12304893959365
Task_49383,2537,69,102,59,161,36.24285714285714,45.69803984221378
Task_49384,2381,782,147,65,212,3.0408684546615583,47.11050360912424
Task_49385,1830,329,77,117,194,5.545454545454546,37.49854760772506
Task_49386,2109,243,97,59,156,8.64344262295082,40.439369756844904
Task_49387,1881,803,168,124,292,2.33955223880597,40.141825471070966
Task_49388,2293,817,27,162,189,2.8031784841075793,46.31861468700013
Task_49389,2157,130,61,164,225,16.46564885496183,41.67787437219308
Task_49390,775,483,176,119,295,1.6012396694214877,21.617850518027808
Task_49391,1296,921,114,67,181,1.405639913232104,29.97593529108231
Task_49392,1366,289,136,90,226,4.710344827586207,29.84229234739043
Task_49393,884,459,78,153,231,1.9217391304347826,23.17356453749836
Task_49394,1125,448,51,79,130,2.505567928730512,26.07752359412092
Task_49395,1872,267,50,77,127,6.985074626865671,37.20466528001602
Task_49396,1203,798,31,108,139,1.5056320400500627,28.3456323578001
Task_49397,1334,568,48,188,236,2.3444639718804923,30.706828484364852
Task_49398,1847,897,45,150,195,2.056792873051225,39.49711854803927
Task_49399,1890,922,141,197,338,2.047670639219935,40.96949820487214
Task_49400,2619,284,53,17,70,9.189473684210526,47.12239800261738
Task_49401,1356,149,72,143,215,9.04,29.19745978095503
Task_49402,2731,237,110,80,190,11.474789915966387,50.917963557808974
Task_49403,1290,683,143,90,233,1.8859649122807018,29.92446050757479
Task_49404,998,197,107,112,219,5.040404040404041,23.92782402741706
Task_49405,2436,894,70,60,130,2.7217877094972067,47.7843454563536
Task_49406,2755,570,78,191,269,4.824868651488616,53.37544880749761
Task_49407,2740,196,20,72,92,13.908629441624365,50.01375321594478
Task_49408,2275,482,62,153,215,4.7101449275362315,45.19067411155877
Task_49409,2014,701,137,161,298,2.868945868945869,42.01082555337217
Task_49410,1161,177,153,60,213,6.522471910112359,25.5798291734216
Task_49411,1541,435,168,81,249,3.5344036697247705,33.01793003231518
Task_49412,863,432,45,10,55,1.9930715935334873,19.88105358914561
Task_49413,1874,332,139,183,322,5.627627627627628,38.752187633868665
Task_49414,1031,556,132,30,162,1.8509874326750448,24.28283299536824
Task_49415,2913,205,152,88,240,14.140776699029127,53.948199631212155
Task_49416,2156,369,196,99,295,5.827027027027027,43.07651701162134
Task_49417,1779,714,72,113,185,2.488111888111888,37.746431296886776
Task_49418,1032,675,129,168,297,1.5266272189349113,26.33778970734261
Task_49419,1468,793,30,45,75,1.848866498740554,30.794896057698043
Task_49420,918,720,132,29,161,1.273231622746186,22.947571073259045
Task_49421,1271,964,47,26,73,1.317098445595855,28.278197145944457
Task_49422,2371,659,173,138,311,3.5924242424242423,47.55815241444151
Task_49423,1382,331,50,57,107,4.162650602409639,28.9228162009007
Task_49424,704,903,115,184,299,0.7787610619469026,21.870604165860666
Task_49425,1298,169,123,154,277,7.635294117647059,28.567888290599484
Task_49426,1623,944,29,57,86,1.7174603174603174,34.42200515745137
Task_49427,2052,232,32,88,120,8.806866952789699,39.789873387865825
Task_49428,618,259,14,83,97,2.376923076923077,16.851253403050077
Task_49429,1044,115,105,165,270,9.0,24.115695979456035
Task_49430,1443,241,117,14,131,5.962809917355372,29.488377498905223
Task_49431,2795,921,71,88,159,3.031453362255965,53.951341362483866
Task_49432,2012,389,125,87,212,5.158974358974359,40.233216667434
Task_49433,1677,652,77,35,112,2.568147013782542,34.45026306023855
Task_49434,2366,367,57,46,103,6.429347826086956,44.17055234596461
Task_49435,1349,1004,112,134,246,1.3422885572139303,32.10358226857391
Task_49436,1507,592,168,104,272,2.5413153456998314,33.43759620206516
Task_49437,2372,706,30,178,208,3.355021216407355,47.35766590675641
Task_49438,2672,122,151,52,203,21.723577235772357,49.014815418877454
Task_49439,2230,256,93,137,230,8.67704280155642,43.747465857565224
Task_49440,2891,771,109,66,175,3.744818652849741,54.88218305074427
Task_49441,2815,572,137,12,149,4.912739965095986,52.365491042536604
Task_49442,2032,550,37,167,204,3.6878402903811254,41.42420277053865
Task_49443,2211,83,88,106,194,26.321428571428573,41.636289831315686
Task_49444,1768,510,93,54,147,3.459882583170254,36.11171602201565
Task_49445,2549,460,55,51,106,5.5292841648590025,47.723372312232605
Task_49446,939,684,25,117,142,1.3708029197080291,23.805622317300305
Task_49447,1479,170,165,47,212,8.649122807017545,30.296684719425585
Task_49448,537,955,59,106,165,0.5617154811715481,18.755384314226543
Task_49449,1381,620,148,161,309,2.2238325281803544,31.78031533707525
Task_49450,1589,433,120,171,291,3.661290322580645,34.41556557016494
Task_49451,2739,690,68,108,176,3.963820549927641,52.798742707497205
Task_49452,2588,216,147,86,233,11.926267281105991,48.81488445583983
Task_49453,1203,733,127,164,291,1.6389645776566757,29.223318623764005
Task_49454,2247,267,102,140,242,8.384328358208956,44.002096519369275
Task_49455,1810,580,121,176,297,3.1153184165232357,38.41629494272645
Task_49456,740,222,172,115,287,3.318385650224215,20.204435732000572
Task_49457,924,639,62,188,250,1.44375,24.433696275049247
Task_49458,774,1009,84,193,277,0.7663366336633664,23.230159749784463
Task_49459,1995,73,55,74,129,26.95945945945946,37.328096253327445
Task_49460,1354,580,86,164,250,2.3304647160068845,31.00784939677979
Task_49461,2412,343,97,135,232,7.011627906976744,46.84608452269806
Task_49462,1809,713,89,72,161,2.533613445378151,37.38403691178454
Task_49463,755,573,169,132,301,1.3153310104529616,21.588812348314026
Task_49464,1660,261,184,17,201,6.33587786259542,33.45716045568846
Task_49465,1595,491,169,27,196,3.241869918699187,33.33611487790238
Task_49466,833,795,147,97,244,1.0464824120603016,23.16295638017804
Task_49467,977,163,184,146,330,5.9573170731707314,23.69041264634841
Task_49468,1651,664,127,192,319,2.482706766917293,36.285020589237455
Task_49469,2671,314,195,63,258,8.47936507936508,50.36908350157256
Task_49470,2074,927,149,35,184,2.2349137931034484,42.12050865562588
Task_49471,2883,216,120,115,235,13.285714285714286,53.78860550383545
Task_49472,684,742,23,74,97,0.9205921938088829,19.3749682677345
Task_49473,2016,454,197,164,361,4.430769230769231,41.546671716800695
Task_49474,975,121,171,188,359,7.991803278688525,23.577017694750964
Task_49475,1330,359,69,46,115,3.6944444444444446,28.066646203112782
Task_49476,2578,103,26,126,152,24.78846153846154,46.955365636048775
Task_49477,2278,823,128,196,324,2.7645631067961167,46.74393396133894
Task_49478,717,833,109,84,193,0.8597122302158273,20.953782724865437
Task_49479,2090,799,73,44,117,2.6125,41.46922692930277
Task_49480,1844,122,51,161,212,14.991869918699187,36.68175158989484
Task_49481,762,162,160,22,182,4.674846625766871,18.61096549821372
Task_49482,1002,384,28,182,210,2.602597402597403,24.662102597687166
Task_49483,1832,914,87,154,241,2.0021857923497266,39.53387464473362
Task_49484,2390,939,21,198,219,2.5425531914893615,48.39095672014087
Task_49485,2553,743,190,109,299,3.431451612903226,50.60945196765823
Task_49486,1059,83,72,185,257,12.607142857142858,24.08691385543824
Task_49487,2895,944,107,67,174,3.0634920634920637,55.507155793026755
Task_49488,1286,198,55,152,207,6.4623115577889445,28.643975200387672
Task_49489,2491,285,143,164,307,8.70979020979021,48.250987407800835
Task_49490,2641,802,15,172,187,3.2889165628891655,51.78174014712629
Task_49491,2613,76,77,105,182,33.935064935064936,47.79634864068074
Task_49492,1447,749,84,132,216,1.9293333333333333,32.81427586555862
Task_49493,1474,812,127,190,317,1.813038130381304,33.93107174577532
Task_49494,2413,222,91,149,240,10.820627802690582,46.51200277821416
Task_49495,718,497,155,103,258,1.4417670682730923,20.51411531443393
Task_49496,831,190,175,69,244,4.350785340314136,20.89267479357873
Task_49497,1180,186,19,134,153,6.310160427807487,26.184443682085345
Task_49498,2048,330,60,88,148,6.187311178247734,40.21662989856187
Task_49499,2144,935,72,183,255,2.2905982905982905,44.767169542581264
Task_49500,1988,640,131,188,319,3.1014040561622465,41.5413597427435
Task_49501,2675,418,111,131,242,6.384248210023866,51.27405080854351
Task_49502,2894,361,198,94,292,7.994475138121547,54.66291145912631
Task_49503,1201,380,32,84,116,3.152230971128609,26.804033998516235
Task_49504,2084,395,70,140,210,5.262626262626263,41.85547377470079
Task_49505,514,136,45,144,189,3.7518248175182483,15.592759140220524
Task_49506,1034,706,71,164,235,1.4625176803394626,26.28056515653985
Task_49507,1982,919,87,26,113,2.1543478260869566,40.132236544781286
Task_49508,2210,765,180,117,297,2.8851174934725847,45.24749544785283
Task_49509,2815,747,26,69,95,3.763368983957219,52.977490821570804
Task_49510,2156,922,65,22,87,2.335861321776815,42.44017207230395
Task_49511,981,574,84,135,219,1.7060869565217391,24.892030730673056
Task_49512,1112,544,173,119,292,2.0403669724770643,27.144197360799847
Task_49513,1379,628,128,30,158,2.192368839427663,29.96502407951402
Task_49514,1959,88,63,199,262,22.01123595505618,38.23524554801201
Task_49515,1740,863,140,19,159,2.013888888888889,36.16733427757065
Task_49516,2169,986,158,18,176,2.197568389057751,43.50328148476026
Task_49517,2349,311,88,28,116,7.528846153846154,43.97608767229439
Task_49518,1588,76,159,113,272,20.623376623376622,32.16068651157465
Task_49519,2524,997,156,139,295,2.529058116232465,50.97074813747398
Task_49520,1203,904,153,50,203,1.329281767955801,28.590045803906804
Task_49521,1504,847,129,160,289,1.7735849056603774,34.33161523215541
Task_49522,1319,1000,187,76,263,1.3176823176823176,31.24230886822923
Task_49523,1853,258,17,52,69,7.154440154440154,35.512167358663895
Task_49524,1508,800,91,37,128,1.8826466916354556,32.587961517364626
Task_49525,2153,631,137,72,209,3.4066455696202533,43.044408595349374
Task_49526,1927,596,53,187,240,3.2278056951423784,40.24869587047315
Task_49527,2907,674,84,41,125,4.306666666666667,54.08123316705676
Task_49528,1161,530,10,171,181,2.1864406779661016,27.27536328929952
Task_49529,2228,820,169,43,212,2.7137637028014616,44.51708215514025
Task_49530,2034,494,13,113,126,4.109090909090909,40.682761253295844
Task_49531,1564,868,173,83,256,1.7997698504027617,34.8060148759408
Task_49532,1477,885,67,55,122,1.6670428893905191,32.43932095561703
Task_49533,1049,87,186,188,374,11.920454545454545,24.34671213281632
Task_49534,828,347,122,107,229,2.3793103448275863,21.72643714492453
Task_49535,1657,394,81,106,187,4.19493670886076,34.86824648296506
Task_49536,1703,510,54,58,112,3.3326810176125243,34.62204033015424
Task_49537,2379,203,187,14,201,11.661764705882353,44.654729826789804
Task_49538,1929,600,24,46,70,3.2096505823627286,37.54379978368119
Task_49539,2185,835,39,79,118,2.6136363636363638,43.80304933282728
Task_49540,1296,338,34,135,169,3.8230088495575223,28.71372638154881
Task_49541,1690,848,90,200,290,1.9905771495877502,37.40757914859231
Task_49542,2871,164,130,135,265,17.4,53.24833459310286
Task_49543,2552,606,98,48,146,4.204283360790774,48.46824606001479
Task_49544,2397,413,59,178,237,5.7898550724637685,47.059198389487925
Task_49545,1810,645,142,63,205,2.801857585139319,37.579720336191876
Task_49546,888,79,77,92,169,11.1,20.670230988996277
Task_49547,594,262,68,44,112,2.258555133079848,16.00840836555485
Task_49548,1319,235,172,124,296,5.588983050847458,29.446968659296335
Task_49549,2342,618,101,132,233,3.7835218093699514,46.608683908034635
Task_49550,2018,821,105,41,146,2.4549878345498786,40.66099499858123
Task_49551,1944,671,200,60,260,2.892857142857143,39.964586960698874
Task_49552,1682,303,149,189,338,5.532894736842105,35.69974776787
Task_49553,2040,410,40,129,169,4.963503649635037,40.69123618334434
Task_49554,1720,490,158,60,218,3.5030549898167007,35.65576841773136
Task_49555,506,431,119,19,138,1.1712962962962963,15.200833753785028
Task_49556,511,90,164,170,334,5.615384615384615,15.78744171701178
Task_49557,2030,766,14,119,133,2.646675358539765,41.46900624165736
Task_49558,1491,261,66,130,196,5.690839694656488,31.934456334295046
Task_49559,1091,89,64,41,105,12.122222222222222,22.153208288814387
Task_49560,2433,884,170,171,341,2.7491525423728813,49.430480410656095
Task_49561,1540,476,197,34,231,3.2285115303983227,32.635451254435665
Task_49562,2203,391,29,157,186,5.619897959183674,43.41618802121855
Task_49563,1480,932,62,125,187,1.5862808145766345,33.76922821863845
Task_49564,758,442,10,144,154,1.7110609480812642,20.279564114256186
Task_49565,1569,873,56,57,113,1.7951945080091534,33.74253907837687
Task_49566,1118,344,88,36,124,3.2405797101449276,24.718804280092332
Task_49567,2475,269,182,96,278,9.166666666666666,47.73399487041889
Task_49568,626,609,59,126,185,1.0262295081967212,18.983341873321
Task_49569,631,123,34,25,59,5.088709677419355,15.160548742297578
Task_49570,833,333,159,25,184,2.4940119760479043,20.531263644108385
Task_49571,689,847,77,197,274,0.8125,21.42492353261977
Task_49572,2980,949,45,191,236,3.136842105263158,57.857448778991944
Task_49573,2983,536,126,122,248,5.554934823091248,56.549592310306615
Task_49574,2098,577,58,178,236,3.629757785467128,42.849994661189506
Task_49575,2645,1012,130,122,252,2.611056268509378,52.71625992087426
Task_49576,2036,578,104,195,299,3.516407599309154,42.025681848773466
Task_49577,1030,409,169,130,299,2.5121951219512195,25.46851214342222
Task_49578,1246,201,144,128,272,6.1683168316831685,28.072994182714073
Task_49579,2445,188,33,143,176,12.936507936507937,46.42452301803802
Task_49580,2555,439,186,152,338,5.806818181818182,49.907655885832334
Task_49581,2279,294,188,148,336,7.725423728813559,45.038507555258114
Task_49582,1716,187,156,186,342,9.127659574468085,35.94501101004142
Task_49583,1550,272,47,101,148,5.677655677655678,32.25164554478761
Task_49584,2020,107,62,97,159,18.703703703703702,38.296232778877275
Task_49585,2516,988,171,134,305,2.5439838220424673,50.85367323382551
Task_49586,2848,251,148,177,325,11.301587301587302,53.86880955891602
Task_49587,2971,960,155,41,196,3.0915712799167534,56.6586927579591
Task_49588,1583,970,25,188,213,1.6302780638516994,35.7123899194261
Task_49589,626,1006,134,90,224,0.6216484607745779,20.499920845453477
Task_49590,502,886,184,125,309,0.5659526493799324,18.645078253253935
Task_49591,878,797,36,138,174,1.100250626566416,23.420021052499084
Task_49592,863,782,96,159,255,1.1021711366538953,23.73766504342484
Task_49593,1712,172,57,133,190,9.895953757225433,34.66211656739294
Task_49594,2626,691,134,110,244,3.7947976878612715,51.35536831479531
Task_49595,2938,363,136,103,239,8.071428571428571,55.19568081489174
Task_49596,2945,862,62,55,117,3.4125144843568944,55.492264281482186
Task_49597,1401,632,124,87,211,2.213270142180095,31.33026486249273
Task_49598,1834,426,59,26,85,4.295081967213115,35.79612735823965
Task_49599,1402,606,71,126,197,2.3097199341021417,31.639907752747856
Task_49600,2188,641,12,183,195,3.4080996884735204,44.14796214583606
Task_49601,529,607,171,102,273,0.8700657894736842,17.921971603478738
Task_49602,655,86,160,15,175,7.528735632183908,16.213035329804008
Task_49603,2738,174,200,29,229,15.645714285714286,50.31693454550747
Task_49604,1180,657,146,12,158,1.7933130699088147,26.75408394358172
Task_49605,605,742,56,172,228,0.8142664872139973,19.516525577998582
Task_49606,1467,82,45,44,89,17.674698795180724,28.08827204145854
Task_49607,1827,608,115,61,176,3.0,37.35483201386197
Task_49608,1937,741,91,166,257,2.6105121293800537,40.78827817812346
Task_49609,1700,416,24,194,218,4.07673860911271,35.86509043873303
Task_49610,1799,758,120,158,278,2.370223978919631,38.688942340824724
Task_49611,533,357,85,18,103,1.488826815642458,15.014664205001473
Task_49612,2696,570,57,115,172,4.7215411558669,51.84895935183474
Task_49613,681,70,132,64,196,9.591549295774648,17.162838956023734
Task_49614,2019,521,114,15,129,3.867816091954023,39.52661253703905
Task_49615,1649,488,149,11,160,3.372188139059305,33.65425452457676
Task_49616,2908,371,31,172,203,7.817204301075269,54.722518592344706
Task_49617,1471,1019,148,120,268,1.442156862745098,34.13414391005268
Task_49618,1092,668,158,157,315,1.6322869955156951,27.360661171929248
Task_49619,538,692,193,31,224,0.7763347763347763,17.448540325773678
Task_49620,2767,174,167,15,182,15.811428571428571,50.22777382368909
Task_49621,2691,936,23,199,222,2.871931696905016,53.281944585878016
Task_49622,2395,228,168,162,330,10.458515283842795,46.626059390512694
Task_49623,2995,460,158,21,179,6.496746203904555,55.074632229952414
Task_49624,2374,149,107,179,286,15.826666666666666,45.492498405701106
Task_49625,1911,620,134,137,271,3.077294685990338,39.967697173760875
Task_49626,2828,90,192,99,291,31.076923076923077,51.85503641305926
Task_49627,1576,938,42,45,87,1.678381256656017,33.38048590704025
Task_49628,1884,691,183,114,297,2.722543352601156,39.84681156630891
Task_49629,1871,479,117,95,212,3.8979166666666667,38.53100989200176
Task_49630,2151,311,53,122,175,6.894230769230769,42.41416151694498
Task_49631,1504,101,175,48,223,14.745098039215685,30.183745967657984
Task_49632,2754,492,31,132,163,5.586206896551724,52.27851993983371
Task_49633,2846,527,143,107,250,5.390151515151516,54.33833370031825
Task_49634,824,377,30,152,182,2.17989417989418,21.47477818897892
Task_49635,866,367,19,166,185,2.3532608695652173,22.133466102367446
Task_49636,1391,176,129,43,172,7.858757062146893,28.647194725753593
Task_49637,1583,97,124,17,141,16.153061224489797,30.434546331859607
Task_49638,787,975,138,162,300,0.8063524590163934,23.364607474901874
Task_49639,1176,713,154,55,209,1.6470588235294117,27.796395462069004
Task_49640,2861,404,154,133,287,7.064197530864197,54.37651468365772
Task_49641,935,674,70,83,153,1.385185185185185,23.5465954245077
Task_49642,2393,637,10,98,108,3.750783699059561,46.47409441365903
Task_49643,585,153,200,58,258,3.7987012987012987,16.638711291211347
Task_49644,948,373,142,20,162,2.53475935828877,22.17575687314876
Task_49645,635,124,84,179,263,5.08,17.821544073749962
Task_49646,2014,573,168,11,179,3.508710801393728,39.8727174521693
Task_49647,749,322,78,170,248,2.318885448916409,20.70604341160262
Task_49648,2207,703,129,134,263,3.1349431818181817,44.876976870646864
Task_49649,859,601,11,42,53,1.4269102990033222,20.655022401695934
Task_49650,988,609,161,79,240,1.619672131147541,24.789180685067112
Task_49651,2176,228,117,143,260,9.502183406113538,42.823822541690795
Task_49652,2819,173,188,69,257,16.201149425287355,51.912675002468006
Task_49653,1474,325,150,175,325,4.521472392638037,32.40476061815787
Task_49654,2925,808,172,162,334,3.61557478368356,56.94284745360229
Task_49655,1561,423,12,108,120,3.681603773584906,32.76445928039174
Task_49656,884,300,129,159,288,2.9368770764119603,22.803572036561985
Task_49657,1153,738,29,41,70,1.5602165087956699,25.69305323853943
Task_49658,2555,639,141,39,180,3.9921875,48.77735429186538
Task_49659,903,796,53,73,126,1.1329987452948558,23.469938379141997
Task_49660,2964,261,184,119,303,11.312977099236642,55.55528857264371
Task_49661,1762,791,96,27,123,2.224747474747475,36.367474936677596
Task_49662,628,570,44,176,220,1.0998248686514887,19.08855719894217
Task_49663,1936,575,165,48,213,3.361111111111111,39.14063776999023
Task_49664,2501,931,44,189,233,2.6834763948497855,50.20799106566792
Task_49665,2158,611,193,56,249,3.526143790849673,43.20727595787247
Task_49666,565,64,39,179,218,8.692307692307692,16.035410948590787
Task_49667,670,728,85,120,205,0.9190672153635117,20.237185312097928
Task_49668,1450,184,42,43,85,7.837837837837838,29.140154374762897
Task_49669,1840,698,193,114,307,2.632331902718169,39.216868625301025
Task_49670,1326,568,196,108,304,2.330404217926186,30.646034443663456
Task_49671,557,780,30,176,206,0.7131882202304738,18.793882631926298
Task_49672,2702,452,59,135,194,5.964679911699779,51.757695802403795
Task_49673,1102,552,43,114,157,1.9927667269439422,26.095634578928443
Task_49674,2252,763,101,152,253,2.9476439790575917,45.7595920796173
Task_49675,1590,933,173,171,344,1.702355460385439,36.2254359519
Task_49676,2190,307,31,116,147,7.1103896103896105,42.5203551427628
Task_49677,566,464,73,125,198,1.217204301075269,17.831215586810988
Task_49678,1815,342,115,103,218,5.291545189504373,37.2663230570333
Task_49679,1351,783,131,38,169,1.7232142857142858,30.14046739939623
Task_49680,732,837,119,50,169,0.8735083532219571,20.59186397642047
Task_49681,1821,331,38,105,143,5.484939759036145,36.70435150247309
Task_49682,1020,935,198,66,264,1.0897435897435896,26.15363479647645
Task_49683,2808,648,178,156,334,4.326656394453004,54.574842688044725
Task_49684,1981,942,147,132,279,2.1007423117709436,42.11248322569457
Task_49685,2015,951,42,120,162,2.116596638655462,41.87652962676123
Task_49686,942,933,100,170,270,1.0085653104925054,25.489095961510483
Task_49687,2379,173,188,123,311,13.672413793103448,45.64193508744733
Task_49688,1582,86,195,179,374,18.183908045977013,32.71963474051889
Task_49689,1593,762,105,19,124,2.0878112712975097,33.334561254324434
Task_49690,2570,729,199,86,285,3.5205479452054793,50.473763723430544
Task_49691,578,271,150,20,170,2.125,16.06626332875831
Task_49692,1368,978,21,70,91,1.397344228804903,30.608736516043212
Task_49693,587,848,181,133,314,0.6914016489988222,19.94642167165062
Task_49694,1008,156,137,181,318,6.420382165605096,24.1630032463942
Task_49695,1227,257,93,96,189,4.755813953488372,27.66218132609775
Task_49696,1202,762,54,175,229,1.5753604193971167,29.167740643406166
Task_49697,2612,782,127,93,220,3.3358876117496807,51.22195328716649
Task_49698,2186,927,111,110,221,2.355603448275862,45.020547735550934
Task_49699,1593,251,104,13,117,6.321428571428571,31.692782978843514
Task_49700,2324,614,123,97,220,3.778861788617886,46.2346328942989
Task_49701,1978,122,61,23,84,16.08130081300813,36.54198413220022
Task_49702,1594,948,154,85,239,1.679662802950474,35.46536072308393
Task_49703,1898,917,186,54,240,2.0675381263616557,39.97349170968743
Task_49704,2270,686,60,97,157,3.304221251819505,45.153420278220416
Task_49705,585,340,195,71,266,1.715542521994135,17.53015324520401
Task_49706,743,503,117,132,249,1.4742063492063493,20.9450710581409
Task_49707,1571,860,136,169,305,1.8246225319396052,35.53233040339809
Task_49708,2747,719,103,97,200,3.8152777777777778,53.176791400957136
Task_49709,2518,404,131,64,195,6.217283950617284,47.975945636614675
Task_49710,844,897,198,187,385,0.9398663697104677,24.443936404183052
Task_49711,711,419,137,160,297,1.6928571428571428,20.47347884689713
Task_49712,533,87,97,79,176,6.056818181818182,14.787958424416054
Task_49713,2964,411,104,150,254,7.194174757281553,55.90604890484735
Task_49714,1891,429,85,23,108,4.397674418604651,37.02013777421921
Task_49715,1592,591,12,94,106,2.689189189189189,33.573310162042766
Task_49716,2768,743,27,128,155,3.7204301075268815,53.12116463562208
Task_49717,1919,206,161,105,266,9.270531400966183,38.654416039986174
Task_49718,1681,660,107,90,197,2.5431164901664145,35.88346854661231
Task_49719,1210,70,77,117,194,17.04225352112676,26.07754152194238
Task_49720,1717,146,19,62,81,11.680272108843537,33.06061118154367
Task_49721,1797,654,125,91,216,2.7435114503816793,37.807716274409024
Task_49722,2924,420,160,188,348,6.945368171021378,55.782502675042586
Task_49723,2192,191,123,200,323,11.416666666666666,43.29102520015457
Task_49724,2881,342,126,84,210,8.39941690962099,53.76948578623612
Task_49725,1873,928,114,34,148,2.016146393972013,38.68789088983494
Task_49726,2971,236,175,134,309,12.535864978902953,55.61921918877099
Task_49727,565,949,157,162,319,0.5947368421052631,19.96450508078682
Task_49728,1504,497,183,162,345,3.0200803212851404,33.504341747082144
Task_49729,1223,922,38,165,203,1.3250270855904658,29.657038485573292
Task_49730,1854,227,24,123,147,8.131578947368421,36.941758142868046
Task_49731,2709,133,79,63,142,20.21641791044776,49.15561774724518
Task_49732,1390,269,88,32,120,5.148148148148148,28.702627794191972
Task_49733,546,984,24,61,85,0.5543147208121827,17.41920225769493
Task_49734,617,1005,177,23,200,0.6133200795228628,19.87342719585669
Task_49735,2486,567,82,59,141,4.376760563380282,47.48394394806588
Task_49736,1066,606,185,158,343,1.7561779242174629,26.883265377194732
Task_49737,2078,889,101,86,187,2.3348314606741574,42.69010687548322
Task_49738,672,752,57,78,135,0.8924302788844621,19.738181625610473
Task_49739,881,522,33,181,214,1.684512428298279,23.191597062457475
Task_49740,1171,559,112,141,253,2.0910714285714285,27.9819082753617
Task_49741,2942,453,27,114,141,6.4801762114537445,54.86524278353462
Task_49742,1119,362,85,182,267,3.0826446280991737,26.706090762175535
Task_49743,1637,608,195,145,340,2.6880131362889985,35.91323621720964
Task_49744,672,477,90,13,103,1.405857740585774,17.698659613971092
Task_49745,1147,230,12,147,159,4.965367965367966,25.817404011307428
Task_49746,2303,476,158,162,320,4.828092243186583,45.97296969631922
Task_49747,2709,750,168,85,253,3.607190412782956,52.58552034778837
Task_49748,737,380,183,135,318,1.9343832020997376,20.833593443204247
Task_49749,2141,770,123,29,152,2.776913099870298,42.428258575663904
Task_49750,2539,870,169,163,332,2.9150401836969,51.01397559081985
Task_49751,2055,563,94,137,231,3.643617021276596,41.97122749204174
Task_49752,1369,865,112,193,305,1.5808314087759816,32.33972689903218
Task_49753,2528,222,115,61,176,11.336322869955158,47.15626635887986
Task_49754,1239,944,125,182,307,1.3111111111111111,30.507783709033053
Task_49755,2551,507,159,119,278,5.021653543307087,49.74689768985555
Task_49756,2151,210,158,60,218,10.19431279620853,41.526151009666265
Task_49757,1441,873,27,88,115,1.6487414187643021,32.1729777709908
Task_49758,2934,437,57,10,67,6.698630136986301,52.62239363407778
Task_49759,2070,139,123,199,322,14.785714285714286,40.803382422709674
Task_49760,2211,681,26,48,74,3.2419354838709675,42.31458565871171
Task_49761,1143,346,170,165,335,3.2939481268011526,27.26850559904197
Task_49762,2878,893,68,100,168,3.21923937360179,55.55991460264449
Task_49763,997,536,49,101,150,1.856610800744879,24.450635050723804
Task_49764,720,913,94,74,168,0.787746170678337,20.995178397533397
Task_49765,2350,442,153,115,268,5.3047404063205414,46.30318594521359
Task_49766,1233,260,29,104,133,4.724137931034483,27.20856715809676
Task_49767,737,651,25,103,128,1.1303680981595092,20.582535142347243
Task_49768,570,784,71,112,183,0.7261146496815286,18.709640080318977
Task_49769,863,366,52,65,117,2.35149863760218,21.255462148451908
Task_49770,1552,497,92,70,162,3.1164658634538154,32.6759934879941
Task_49771,2978,435,116,74,190,6.830275229357798,55.437650700000894
Task_49772,1532,289,166,47,213,5.2827586206896555,31.81228279897948
Task_49773,971,125,53,120,173,7.7063492063492065,22.62737567367491
Task_49774,531,890,30,125,155,0.5959595959595959,18.16200751036578
Task_49775,760,556,120,164,284,1.3644524236983842,21.576596069899022
Task_49776,514,377,170,146,316,1.3597883597883598,17.26268056200423
Task_49777,2265,941,47,65,112,2.4044585987261144,45.11022393864294
Task_49778,2246,83,35,102,137,26.738095238095237,41.475500247924195
Task_49779,1137,199,122,125,247,5.685,26.244481503096562
Task_49780,2791,522,115,17,132,5.336520076481835,51.68361307776553
Task_49781,2763,802,24,148,172,3.4408468244084682,53.58163704095157
Task_49782,1353,588,174,73,247,2.297113752122241,30.421287779772566
Task_49783,2937,915,33,160,193,3.2063318777292578,56.87813581146063
Task_49784,1735,600,68,112,180,2.886855241264559,36.6110174973978
Task_49785,2529,998,192,174,366,2.5315315315315314,51.42440667164485
Task_49786,993,684,192,153,345,1.4496350364963504,25.916769596859652
Task_49787,1957,192,161,168,329,10.139896373056995,39.58215084916821
Task_49788,982,694,113,166,279,1.4129496402877697,25.495163279121765
Task_49789,682,423,27,195,222,1.6084905660377358,19.781324415817576
Task_49790,2332,325,43,198,241,7.153374233128834,45.64234293585046
Task_49791,2081,462,192,190,382,4.494600431965443,42.73411215123716
Task_49792,1559,121,179,100,279,12.778688524590164,32.2759449131632
Task_49793,2451,322,129,149,278,7.588235294117647,47.595232530075954
Task_49794,1494,398,82,114,196,3.744360902255639,32.380344343356704
Task_49795,2131,437,41,154,195,4.865296803652968,42.561355974073244
Task_49796,2854,534,37,28,65,5.3345794392523365,51.92637514234119
Task_49797,1702,768,77,117,194,2.213263979193758,36.87069190080672
Task_49798,853,399,138,93,231,2.1325,22.209970345872208
Task_49799,1977,488,149,57,206,4.042944785276074,39.68338040331551
Task_49800,2521,556,30,64,94,4.526032315978456,47.72917446136376
Task_49801,584,617,78,180,258,0.9449838187702265,18.952624752722084
Task_49802,2893,864,147,84,231,3.344508670520231,55.73945100876626
Task_49803,2702,305,75,183,258,8.830065359477125,51.600711997497484
Task_49804,1688,172,11,57,68,9.757225433526012,32.50446705482049
Task_49805,1709,950,42,105,147,1.797055730809674,36.91018487139279
Task_49806,1123,378,65,150,215,2.9630606860158313,26.617363261788636
Task_49807,1826,936,49,75,124,1.9487726787620063,38.54024842096519
Task_49808,2998,894,122,197,319,3.3497206703910614,58.35320330983592
Task_49809,2021,290,10,58,68,6.945017182130584,38.19441600425682
Task_49810,1268,885,79,198,277,1.4311512415349887,30.792002134098038
Task_49811,937,301,103,84,187,3.1026490066225167,22.737678133307995
Task_49812,2932,822,199,139,338,3.5625759416767924,57.08208997214484
Task_49813,1281,731,142,67,209,1.75,29.504689891701094
Task_49814,2189,648,92,81,173,3.3728813559322033,43.60273346499164
Task_49815,1686,928,90,96,186,1.814854682454252,36.8707173199162
Task_49816,914,568,155,158,313,1.6063268892794376,24.222404855193755
Task_49817,1799,540,90,174,264,3.325323475046211,38.013075746716865
Task_49818,2299,178,78,57,135,12.843575418994414,42.9463273402798
Task_49819,2487,88,189,65,254,27.9438202247191,45.82797640946604
Task_49820,1614,571,118,156,274,2.8216783216783217,35.15115540071714
Task_49821,2350,992,68,49,117,2.366565961732125,46.3073513694674
Task_49822,889,86,84,116,200,10.218390804597702,21.000001997450397
Task_49823,1938,687,14,149,163,2.816860465116279,40.02133817486412
Task_49824,513,403,21,135,156,1.2698019801980198,16.135411933343605
Task_49825,2925,620,150,26,176,4.7101449275362315,54.561978376654
Task_49826,2643,624,49,39,88,4.2288,49.339930710053075
Task_49827,1253,520,93,56,149,2.404990403071017,28.012069595422606
Task_49828,1583,479,143,16,159,3.2979166666666666,32.53859112336726
Task_49829,720,936,104,69,173,0.768409818569904,21.021411548834845
Task_49830,2262,561,119,15,134,4.02491103202847,43.49381519158203
Task_49831,1732,951,29,48,77,1.819327731092437,35.547767871968
Task_49832,2197,995,168,183,351,2.2058232931726907,46.09945518578425
Task_49833,1540,78,90,193,283,19.49367088607595,31.593939414168915
Task_49834,2479,187,55,164,219,13.186170212765957,47.549434969214666
Task_49835,2059,214,114,148,262,9.576744186046511,40.93999181337776
Task_49836,1572,672,124,27,151,2.335809806835067,33.06820921609452
Task_49837,2000,984,169,102,271,2.030456852791878,42.46411722816952
Task_49838,2377,776,140,179,319,3.0592020592020592,48.117708479797464
Task_49839,1462,538,144,69,213,2.712430426716141,31.767528477499724
Task_49840,2922,890,109,37,146,3.2794612794612794,55.237347549605374
Task_49841,1720,855,66,135,201,2.0093457943925235,37.48166697379077
Task_49842,1769,669,28,176,204,2.6402985074626866,37.66891610183851
Task_49843,1033,879,68,157,225,1.1738636363636363,26.720845739898895
Task_49844,567,606,134,150,284,0.9341021416803954,18.645636125896132
Task_49845,887,383,107,47,154,2.3098958333333335,21.33218645068618
Task_49846,1117,104,71,110,181,10.638095238095238,24.43916537716382
Task_49847,1716,791,26,138,164,2.1666666666666665,36.86318241124015
Task_49848,2181,412,102,28,130,5.280871670702179,41.86725048331894
Task_49849,2380,502,156,189,345,4.731610337972167,47.42813942462493
Task_49850,2684,612,186,102,288,4.378466557911909,52.20984400416012
Task_49851,1276,83,157,146,303,15.19047619047619,27.535153998930372
Task_49852,2497,952,160,156,316,2.620146904512067,50.522193303258746
Task_49853,1334,710,94,167,261,1.8762306610407877,31.193273050721643
Task_49854,2411,83,39,28,67,28.702380952380953,42.70822449370133
Task_49855,1259,534,69,80,149,2.353271028037383,28.37964500636941
Task_49856,1029,864,72,30,102,1.1895953757225433,24.878622534121025
Task_49857,1331,314,36,108,144,4.2253968253968255,28.90816389825279
Task_49858,748,904,147,69,216,0.8265193370165745,21.63586450041477
Task_49859,1261,309,196,200,396,4.067741935483871,29.340576166197142
Task_49860,2746,903,29,24,53,3.0376106194690267,51.480308432153436
Task_49861,2610,840,87,103,190,3.103448275862069,51.3142248417437
Task_49862,1887,203,34,59,93,9.25,36.34634961149151
Task_49863,1501,586,161,56,217,2.557069846678024,32.57958022796266
Task_49864,1691,999,129,168,297,1.691,37.81450351772091
Task_49865,1461,943,130,31,161,1.5476694915254237,32.24154459075077
Task_49866,2153,882,94,87,181,2.4382785956964894,43.77481558953331
Task_49867,1009,1008,162,19,181,1.0,25.183685093300724
Task_49868,1480,369,101,176,277,4.0,32.42859337402608
Task_49869,1224,745,119,91,210,1.6407506702412868,28.97510606523326
Task_49870,1983,814,101,191,292,2.4331288343558284,41.89039989142168
Task_49871,2471,604,118,52,170,4.084297520661157,47.599973508661726
Task_49872,2728,116,79,152,231,23.316239316239315,50.53444473153454
Task_49873,1534,122,61,23,84,12.471544715447154,29.555747252228112
Task_49874,2273,833,188,168,356,2.725419664268585,46.79917170586841
Task_49875,987,598,37,101,138,1.647746243739566,24.300408117064404
Task_49876,1273,349,190,80,270,3.637142857142857,28.631698119192652
Task_49877,1236,915,16,134,150,1.3493449781659388,29.19584807640483
Task_49878,1994,1017,100,115,215,1.9587426326129667,42.23821995266394
Task_49879,2806,879,75,163,238,3.1886363636363635,54.985101617430196
Task_49880,2277,736,154,118,272,3.08955223880597,46.10668411930474
Task_49881,1630,884,90,81,171,1.8418079096045197,35.32010323833402
Task_49882,2874,597,103,59,162,4.806020066889632,53.759442538356744
Task_49883,1296,88,186,101,287,14.561797752808989,27.764961081320788
Task_49884,1576,891,137,56,193,1.7668161434977578,34.60156377277643
Task_49885,2943,791,161,158,319,3.715909090909091,57.10104567310867
Task_49886,555,572,37,41,78,0.9685863874345549,15.877646487948
Task_49887,1227,527,193,114,307,2.3238636363636362,28.971946784914905
Task_49888,1852,175,157,196,353,10.522727272727273,37.6158819788789
Task_49889,704,897,80,96,176,0.7839643652561247,21.12363076323916
Task_49890,503,412,11,78,89,1.2179176755447942,15.322071002705934
Task_49891,1087,898,194,78,272,1.2091212458286986,27.39818682543554
Task_49892,2486,755,73,67,140,3.2883597883597884,48.247966847432515
Task_49893,2435,408,41,109,150,5.9535452322738385,46.66836441581842
Task_49894,586,263,137,149,286,2.2196969696969697,17.95029342039052
Task_49895,2037,269,71,27,98,7.544444444444444,38.76944439319828
Task_49896,705,103,83,173,256,6.778846153846154,18.5101163967193
Task_49897,1287,97,178,200,378,13.13265306122449,28.13612065082586
Task_49898,1090,890,39,189,228,1.22334455667789,27.499242881325628
Task_49899,737,891,38,154,192,0.8262331838565022,21.686482677329433
Task_49900,2834,417,194,149,343,6.779904306220096,54.268526648000886
Task_49901,2066,398,101,93,194,5.177944862155388,41.231760612538004
Task_49902,1641,633,190,23,213,2.588328075709779,34.582241836764496
Task_49903,2109,356,165,166,331,5.907563025210084,42.564985393187996
Task_49904,777,697,114,88,202,1.1131805157593124,21.462519597809536
Task_49905,1300,697,86,190,276,1.8624641833810889,30.673750960277612
Task_49906,712,710,82,106,188,1.0014064697609002,20.69732929627236
Task_49907,1793,289,23,149,172,6.182758620689655,36.62864076256703
Task_49908,2588,484,81,163,244,5.336082474226804,50.273074898842594
Task_49909,1750,985,110,141,251,1.7748478701825559,38.45912654090639
Task_49910,2244,1022,167,123,290,2.193548387096774,46.56535047151001
Task_49911,1882,484,177,143,320,3.8804123711340206,39.306414754984374
Task_49912,2180,646,151,97,248,3.3693972179289027,44.18145225871316
Task_49913,516,680,87,171,258,0.7577092511013216,17.95959186578131
Task_49914,2570,751,200,128,328,3.4175531914893615,51.06249839411604
Task_49915,2145,1006,55,160,215,2.1300893743793448,44.821613676192214
Task_49916,2081,254,94,112,206,8.16078431372549,41.21290570135298
Task_49917,1181,527,73,194,267,2.2367424242424243,28.307600598144248
Task_49918,2123,355,172,94,266,5.963483146067416,42.32905475453352
Task_49919,2863,458,173,167,340,6.237472766884531,54.87604513439258
Task_49920,1779,809,23,130,153,2.196296296296296,37.67303918150855
Task_49921,1623,687,92,188,280,2.359011627906977,35.80942211600917
Task_49922,2654,654,57,78,135,4.051908396946565,50.868611473773825
Task_49923,1474,749,93,169,262,1.9653333333333334,33.56820647404139
Task_49924,548,323,102,89,191,1.691358024691358,16.82540839233324
Task_49925,2909,516,50,12,62,5.626692456479691,52.582486423418175
Task_49926,1922,902,143,39,182,2.1284606866002216,39.58066551520838
Task_49927,1635,380,111,129,240,4.291338582677166,34.68090715385899
Task_49928,2321,337,137,165,302,6.866863905325443,45.722185283743215
Task_49929,950,715,34,36,70,1.3268156424581006,22.424951503015112
Task_49930,1594,977,36,104,140,1.6298568507157465,35.11449215785674
Task_49931,1943,613,124,178,302,3.1644951140065145,40.652225827045335
Task_49932,1478,693,191,49,240,2.1296829971181555,32.44573228644431
Task_49933,1300,885,79,125,204,1.4672686230248306,30.8775128579822
Task_49934,2824,268,156,129,285,10.49814126394052,53.302389500912774
Task_49935,2863,957,127,61,188,2.988517745302714,55.04625674427351
Task_49936,2133,330,180,158,338,6.444108761329305,42.87710526143596
Task_49937,1292,709,51,105,156,1.819718309859155,29.750817345903357
Task_49938,2710,813,89,144,233,3.329238329238329,53.11043868807068
Task_49939,1649,78,117,127,244,20.873417721518987,33.01254410656937
Task_49940,2283,483,57,85,142,4.716942148760331,44.44660764326492
Task_49941,2380,660,160,80,240,3.600605143721634,47.0136101240557
Task_49942,1143,998,111,52,163,1.1441441441441442,27.810464467358248
Task_49943,1299,871,34,64,98,1.489678899082569,29.34198519190127
Task_49944,2894,233,64,51,115,12.367521367521368,52.54559225096386
Task_49945,1887,720,74,96,170,2.6171983356449378,39.37040369136448
Task_49946,1238,528,152,98,250,2.340264650283554,28.87218907952641
Task_49947,816,956,61,61,122,0.8526645768025078,22.014624153617547
Task_49948,794,394,39,21,60,2.010126582278481,18.802744278986875
Task_49949,2045,820,55,136,191,2.490864799025579,42.51427441430025
Task_49950,2832,984,121,15,136,2.8751269035532996,53.852694026757995
Task_49951,2816,784,54,73,127,3.5872611464968154,53.708014477545866
Task_49952,2964,172,111,150,261,17.13294797687861,54.6857262299464
Task_49953,2999,494,131,190,321,6.058585858585858,57.094995665468765
Task_49954,2268,118,83,148,231,19.058823529411764,43.285148196626984
Task_49955,766,879,180,58,238,0.8704545454545455,21.891039737443062
Task_49956,1058,98,164,179,343,10.686868686868687,24.38758015946226
Task_49957,2670,596,135,157,292,4.472361809045226,52.035732602356326
Task_49958,2952,205,58,115,173,14.330097087378642,54.63638970744828
Task_49959,1909,399,118,185,303,4.7725,39.44419984251238
Task_49960,1284,550,148,166,314,2.3303085299455537,30.054534492124308
Task_49961,2658,742,89,181,270,3.5773889636608343,52.284311444589754
Task_49962,2364,712,166,53,219,3.3155680224403925,46.66779046803264
Task_49963,612,442,68,80,148,1.381489841986456,17.76755392441444
Task_49964,958,1008,186,132,318,0.9494549058473737,26.214215181769433
Task_49965,577,736,88,59,147,0.7829036635006784,17.814637597034352
Task_49966,2567,70,174,128,302,36.15492957746479,47.60914605371167
Task_49967,734,400,103,180,283,1.8304239401496258,20.757368686675978
Task_49968,1848,870,156,145,301,2.121699196326062,39.89918549348255
Task_49969,2999,329,106,84,190,9.087878787878788,55.48708902500914
Task_49970,2359,203,114,95,209,11.563725490196079,45.28900716151659
Task_49971,1735,944,96,151,247,1.835978835978836,38.15703775901458
Task_49972,1655,601,103,144,247,2.749169435215947,35.75565210593713
Task_49973,1894,251,29,73,102,7.515873015873016,36.95742771399467
Task_49974,597,144,81,23,104,4.117241379310345,15.21312457522936
Task_49975,2127,695,20,95,115,3.0560344827586206,42.53658174370354
Task_49976,1228,835,127,105,232,1.4688995215311005,29.543443682158706
Task_49977,1251,110,12,169,181,11.27027027027027,26.56030031806981
Task_49978,1384,503,151,44,195,2.746031746031746,30.067161844339306
Task_49979,2489,995,17,26,43,2.498995983935743,47.45729689909365
Task_49980,1341,454,17,91,108,2.9472527472527474,29.09802537718024
Task_49981,1783,511,176,180,356,3.482421875,38.04179582995997
Task_49982,603,922,128,137,265,0.6533044420368364,20.2232627118263
Task_49983,1638,878,161,182,343,1.863481228668942,36.84020735072355
Task_49984,1675,80,35,197,232,20.679012345679013,33.56999789431051
Task_49985,2851,483,56,198,254,5.890495867768595,54.58455303981768
Task_49986,2035,822,106,173,279,2.4726609963547994,42.65426706211832
Task_49987,686,497,70,132,202,1.3775100401606426,19.936662761665243
Task_49988,797,976,66,23,89,0.8157625383828045,21.42623147132832
Task_49989,2064,521,38,82,120,3.954022988505747,40.91788869799512
Task_49990,2501,94,39,138,177,26.326315789473686,46.01554414614795
Task_49991,1072,672,113,55,168,1.5928677563150073,25.64568881981153
Task_49992,2286,237,69,189,258,9.605042016806722,44.774699849784724
Task_49993,1674,804,162,11,173,2.079503105590062,35.290344022260356
Task_49994,1776,805,104,90,194,2.203473945409429,37.82622963715391
Task_49995,1312,921,30,96,126,1.4229934924078091,30.484508813284794
Task_49996,799,929,54,35,89,0.8591397849462366,21.1866520462258
Task_49997,2199,670,34,198,232,3.277198211624441,44.62830818577382
Task_49998,1743,311,88,70,158,5.586538461538462,34.94851121371005
Task_49999,1023,830,177,164,341,1.2310469314079422,26.78835804800291
Task_50000,735,732,69,76,145,1.0027285129604366,20.53625638609608
