TaskID,Instructions,Memory_MB,Input_MB,Output_MB,IO_MB_Total,Inst_per_MB,Predicted_Cost
Task_1,991,161,15,104,119,6.117283950617284,22.008434500020417
Task_2,2979,635,50,179,229,4.683962264150943,56.49895981160693
Task_3,2998,371,153,41,194,8.059139784946236,54.96542330654762
Task_4,1726,522,25,157,182,3.30019120458891,35.90640094854036
Task_5,2550,77,140,142,282,32.69230769230769,47.24706983420745
Task_6,1229,782,35,137,172,1.5696040868454662,28.77025052014051
Task_7,2242,1016,134,133,267,2.2045231071779745,46.024536609649374
Task_8,2661,1021,82,40,122,2.6037181996086107,51.07536743525184
Task_9,920,226,146,168,314,4.052863436123348,22.858396495821506
Task_10,597,403,13,69,82,1.4777227722772277,16.38990272136103
Task_11,1893,834,150,129,279,2.2670658682634732,39.97593669052596
Task_12,2933,857,53,176,229,3.4184149184149186,56.44141699115098
Task_13,1266,1009,88,75,163,1.2534653465346535,29.709377133662127
Task_14,753,668,130,22,152,1.1255605381165918,19.98716412542284
Task_15,678,126,36,191,227,5.338582677165355,18.03263725575557
Task_16,978,479,122,103,225,2.0375,24.091840619120305
Task_17,920,976,108,68,176,0.9416581371545547,24.213052256701356
Task_18,2715,450,183,123,306,6.019955654101995,51.88797689982547
Task_19,846,677,200,59,259,1.247787610619469,22.377252856018334
Task_20,2263,195,116,49,165,11.545918367346939,42.74504381511218
Task_21,2228,660,34,159,193,3.3706505295007565,44.40586623492195
Task_22,1493,632,184,171,355,2.358609794628752,33.41225370374041
Task_23,736,413,152,152,304,1.7777777777777777,20.468621418580355
Task_24,2285,363,91,191,282,6.277472527472527,44.78622418471313
Task_25,1019,489,163,98,261,2.0795918367346937,24.934752759150914
Task_26,1076,545,70,111,181,1.9706959706959708,25.698493190415366
Task_27,2403,683,152,45,197,3.513157894736842,46.56289625985459
Task_28,2161,191,79,184,263,11.255208333333334,42.16298467712489
Task_29,1152,160,86,82,168,7.15527950310559,25.101415326077937
Task_30,1229,623,60,183,243,1.9695512820512822,28.78510436624694
Task_31,2834,662,82,72,154,4.2745098039215685,53.361358228162466
Task_32,1825,189,61,56,117,9.605263157894736,35.40287417591586
Task_33,1736,517,137,115,252,3.3513513513513513,36.35128406620978
Task_34,1824,93,147,24,171,19.404255319148938,34.54086611951425
Task_35,1061,248,119,187,306,4.261044176706827,25.151224749961074
Task_36,2239,198,56,15,71,11.251256281407036,40.84137238418676
Task_37,2503,1015,30,58,88,2.463582677165354,48.45144265162016
Task_38,1697,719,41,153,194,2.3569444444444443,36.17657301133293
Task_39,2189,162,106,183,289,13.429447852760736,42.368439345092106
Task_40,1683,844,183,129,312,1.991715976331361,36.82857730430931
Task_41,1430,261,19,172,191,5.458015267175573,30.47054068856836
Task_42,2723,985,40,93,133,2.761663286004057,52.806586239118865
Task_43,608,422,63,186,249,1.4373522458628842,18.304207692892707
Task_44,2505,537,74,34,108,4.656133828996283,46.96398890344927
Task_45,2585,862,149,77,226,2.995365005793743,50.546333626075096
Task_46,1110,269,82,190,272,4.111111111111111,25.88864204299112
Task_47,980,236,64,25,89,4.135021097046414,21.556705763266226
Task_48,870,424,77,115,192,2.0470588235294116,22.145162720063052
Task_49,781,294,131,147,278,2.647457627118644,20.691689845794183
Task_50,1608,534,114,164,278,3.005607476635514,34.56758792534979
Task_51,1710,560,183,112,295,3.0481283422459895,36.26527590815502
Task_52,940,364,117,197,314,2.5753424657534247,23.665835729105922
Task_53,1032,818,99,184,283,1.26007326007326,26.323930628336196
Task_54,1633,993,190,65,255,1.6428571428571428,35.89210101523233
Task_55,1998,433,59,160,219,4.6036866359447,40.21643371146656
Task_56,984,1024,142,60,202,0.96,25.462195574678447
Task_57,1892,819,58,28,86,2.3073170731707315,37.85584217039614
Task_58,1009,295,119,49,168,3.4087837837837838,23.196563163228586
Task_59,2243,816,186,21,207,2.745410036719706,44.412910545856256
Task_60,2871,440,172,98,270,6.510204081632653,54.13271638674763
Task_61,657,664,39,113,152,0.98796992481203,18.99066595007767
Task_62,1798,68,43,129,172,26.057971014492754,34.80952147381928
Task_63,1297,275,176,140,316,4.699275362318841,28.947149395682846
Task_64,2435,476,183,78,261,5.10482180293501,47.14903924587614
Task_65,2029,1005,17,78,95,2.0168986083499005,41.18459837540404
Task_66,1469,1019,171,79,250,1.4401960784313725,33.476747285715035
Task_67,2910,433,171,101,272,6.7050691244239635,54.73265828623304
Task_68,2163,394,38,61,99,5.4759493670886075,41.18580500074774
Task_69,700,350,94,126,220,1.9943019943019944,19.307418669366577
Task_70,1341,337,27,152,179,3.967455621301775,29.215290535922943
Task_71,2360,698,58,13,71,3.376251788268956,44.382199666385624
Task_72,1224,1008,22,43,65,1.2130822596630326,27.654865880560674
Task_73,1987,175,29,97,126,11.289772727272727,37.93831809467155
Task_74,1050,472,125,58,183,2.219873150105708,24.613183553347792
Task_75,573,281,56,188,244,2.0319148936170213,17.33840073089796
Task_76,1735,931,190,24,214,1.861587982832618,36.771299170349856
Task_77,941,389,61,19,80,2.4128205128205127,21.258980601989368
Task_78,1007,695,146,31,177,1.4468390804597702,24.39095163907194
Task_79,1761,477,150,101,251,3.6841004184100417,36.59456740334509
Task_80,1322,404,110,130,240,3.2641975308641977,29.405848231628408
Task_81,1583,669,56,85,141,2.3626865671641792,33.76608987871752
Task_82,1046,499,85,107,192,2.092,25.09431225662544
Task_83,1865,594,18,173,191,3.134453781512605,38.43223900159106
Task_84,880,65,48,70,118,13.333333333333334,19.505419718423983
Task_85,1689,548,45,183,228,3.0765027322404372,35.7250016079084
Task_86,2282,985,74,28,102,2.314401622718053,44.79936902825201
Task_87,1339,606,79,17,96,2.2059308072487642,28.551165507627164
Task_88,2571,989,15,82,97,2.596969696969697,49.81946929846411
Task_89,2271,274,40,62,102,8.258181818181818,42.56549705502219
Task_90,2858,725,123,139,262,3.9366391184573004,54.860041875707054
Task_91,2051,294,159,47,206,6.952542372881356,39.80494109307718
Task_92,1923,431,75,61,136,4.451388888888889,38.06979639475525
Task_93,2169,704,19,61,80,3.076595744680851,42.061085463254294
Task_94,2071,615,136,52,188,3.362012987012987,41.3103910144518
Task_95,1863,959,187,84,271,1.940625,39.71300029341209
Task_96,1680,154,139,57,196,10.838709677419354,33.4067609267403
Task_97,1912,266,109,46,155,7.1610486891385765,37.127501499992334
Task_98,1096,758,113,52,165,1.4440052700922266,26.232157134865957
Task_99,1633,802,102,100,202,2.0336239103362392,35.36732227184026
Task_100,1162,909,104,87,191,1.2769230769230768,28.047883005377546
Task_101,2268,469,107,131,238,4.825531914893617,44.579803245430696
Task_102,2305,1024,79,69,148,2.2487804878048783,46.1185864372834
Task_103,717,890,190,34,224,0.8047138047138047,20.66473330574242
Task_104,1295,846,48,91,139,1.5289256198347108,29.69535832360542
Task_105,1633,245,121,77,198,6.638211382113822,33.36387908906473
Task_106,2848,655,26,108,134,4.341463414634147,53.64679932903172
Task_107,721,914,134,135,269,0.7879781420765027,21.61821630047416
Task_108,1659,814,103,94,197,2.0355828220858894,35.77866143518891
Task_109,2669,764,161,159,320,3.488888888888889,52.27969728181521
Task_110,2022,851,67,112,179,2.3732394366197185,41.64591424401564
Task_111,1071,551,60,181,241,1.940217391304348,26.04587105463874
Task_112,2101,918,173,137,310,2.2861806311207835,43.68487503885611
Task_113,2354,298,26,158,184,7.872909698996655,45.11780945819388
Task_114,638,508,105,173,278,1.2534381139489195,19.077075510012822
Task_115,1152,329,57,58,115,3.4909090909090907,25.206392256279912
Task_116,2826,895,123,132,255,3.154017857142857,54.84576811513468
Task_117,861,208,179,192,371,4.119617224880383,22.158168484168254
Task_118,1837,922,125,150,275,1.990249187432286,39.3753735415268
Task_119,2577,596,44,65,109,4.316582914572864,48.72192527134447
Task_120,516,854,50,31,81,0.6035087719298246,16.684657535778587
Task_121,914,213,127,57,184,4.271028037383178,21.630325830125724
Task_122,1600,101,80,34,114,15.686274509803921,30.75704155019456
Task_123,1360,179,144,91,235,7.555555555555555,28.859900483808357
Task_124,1842,733,30,65,95,2.5095367847411443,37.3145726901549
Task_125,536,732,86,196,282,0.7312414733969986,18.254491426359408
Task_126,912,193,193,119,312,4.701030927835052,22.53427194279082
Task_127,1042,468,199,27,226,2.2217484008528783,24.435905495835005
Task_128,1961,759,37,56,93,2.580263157894737,39.158442864947084
Task_129,850,259,64,32,96,3.269230769230769,19.680898372839494
Task_130,2817,248,49,23,72,11.313253012048193,50.27730080057953
Task_131,1513,769,152,106,258,1.964935064935065,33.624572893215685
Task_132,1870,88,141,195,336,21.01123595505618,36.991490292329864
Task_133,1849,254,11,125,136,7.250980392156863,36.52339802573949
Task_134,1320,754,172,178,350,1.7483443708609272,31.027105085672854
Task_135,2136,469,70,11,81,4.54468085106383,40.66440050754424
Task_136,2163,613,84,118,202,3.522801302931596,43.20615224861879
Task_137,2783,235,73,16,89,11.792372881355933,50.11150724920353
Task_138,2870,1007,74,191,265,2.8472222222222223,56.085131222811775
Task_139,1381,655,89,16,105,2.105182926829268,29.423513544311174
Task_140,2103,915,99,29,128,2.2958515283842793,42.19494345836528
Task_141,2573,611,123,53,176,4.204248366013072,49.20578292751524
Task_142,2384,797,121,19,140,2.987468671679198,46.1551736273993
Task_143,1577,700,150,195,345,2.2496433666191153,34.94568257589264
Task_144,1549,211,45,112,157,7.306603773584905,31.785522519473215
Task_145,1943,833,182,83,265,2.3297362110311752,40.562571265592545
Task_146,2061,69,71,62,133,29.442857142857143,38.0765679188434
Task_147,986,245,13,64,77,4.008130081300813,21.77184231418684
Task_148,2125,158,21,110,131,13.364779874213836,40.097056809510626
Task_149,2623,265,69,166,235,9.860902255639099,49.61464834922038
Task_150,2424,78,153,29,182,30.68354430379747,44.015660192618874
Task_151,1837,418,23,63,86,4.384248210023866,36.12907994864307
Task_152,2705,586,129,65,194,4.608177172061329,51.316326542920145
Task_153,2838,878,135,116,251,3.2286689419795223,54.94118102324658
Task_154,1344,417,192,167,359,3.215311004784689,30.386158733393785
Task_155,1483,911,66,90,156,1.6260964912280702,33.02222686235946
Task_156,580,180,186,37,223,3.2044198895027622,16.071549725004342
Task_157,1962,230,180,161,341,8.493506493506494,39.44122050826574
Task_158,2988,903,128,175,303,3.3053097345132745,57.71713150817961
Task_159,2843,193,182,90,272,14.654639175257731,52.7782569189587
Task_160,891,228,181,126,307,3.890829694323144,22.313960911786477
Task_161,1016,452,155,38,193,2.2428256070640176,23.871192981633925
Task_162,2444,592,167,175,342,4.12141652613828,48.29424993825762
Task_163,1299,520,113,101,214,2.4932821497120923,29.25019767897847
Task_164,676,996,10,161,171,0.6780341023069207,20.772617603638505
Task_165,1890,648,11,195,206,2.9121725731895225,39.07420350709845
Task_166,2979,158,75,89,164,18.735849056603772,54.10225615656412
Task_167,1684,908,121,142,263,1.8525852585258527,36.841668780894125
Task_168,2635,676,51,22,73,3.8921713441654355,48.78054857400528
Task_169,1993,104,148,160,308,18.98095238095238,38.866998374663474
Task_170,1650,317,71,55,126,5.188679245283019,33.29148638814834
Task_171,2546,912,69,132,201,2.7886089813800656,50.291289638383574
Task_172,2473,598,161,128,289,4.128547579298831,48.464838896394234
Task_173,2203,233,16,126,142,9.414529914529915,42.08998150566686
Task_174,2759,783,153,31,184,3.5191326530612246,52.44405407027332
Task_175,1327,958,26,160,186,1.383733055265902,30.923101333183485
Task_176,2376,445,85,91,176,5.327354260089686,45.80975207654862
Task_177,2289,560,86,108,194,4.080213903743315,44.93276334491003
Task_178,2336,795,195,146,341,2.9346733668341707,47.17705014004042
Task_179,2653,427,80,57,137,6.1985981308411215,49.56293183081974
Task_180,2023,619,95,62,157,3.2629032258064514,40.27793595549244
Task_181,1736,395,39,66,105,4.383838383838384,34.70212923235408
Task_182,675,880,132,162,294,0.7661748013620885,20.93656324886937
Task_183,828,286,153,164,317,2.8850174216027873,21.609592277331235
Task_184,2191,731,41,159,200,2.9931693989071038,44.07550843957259
Task_185,2591,867,122,145,267,2.9850230414746544,51.10770671767676
Task_186,1119,445,190,127,317,2.508968609865471,26.666335410402763
Task_187,1286,622,31,104,135,2.0642054574638844,28.811907427535726
Task_188,2311,340,34,162,196,6.777126099706745,44.702623076176735
Task_189,2287,336,176,54,230,6.786350148367952,43.99671403975822
Task_190,2036,295,154,70,224,6.878378378378378,39.90194711177653
Task_191,2055,743,95,79,174,2.7620967741935485,41.59442065226448
Task_192,2086,998,29,62,91,2.088088088088088,41.87829735885705
Task_193,562,821,189,120,309,0.683698296836983,19.058132782362915
Task_194,2775,157,163,158,321,17.563291139240505,51.70075584751918
Task_195,2499,816,145,16,161,3.05875152998776,48.146400114985916
Task_196,1002,462,17,99,116,2.16414686825054,23.60697377988583
Task_197,920,826,102,20,122,1.1124546553808947,22.893205295556683
Task_198,518,749,93,158,251,0.6906666666666667,18.01829296909337
Task_199,2906,793,104,131,235,3.6599496221662466,55.70152278507586
Task_200,837,479,101,50,151,1.74375,20.875149427122413
Task_201,764,124,51,105,156,6.112,18.612979249275416
Task_202,1284,363,150,191,341,3.5274725274725274,29.21745850834336
Task_203,2152,784,105,16,121,2.74140127388535,42.16590528166924
Task_204,2522,618,61,197,258,4.074313408723748,49.33302859879958
Task_205,636,499,152,40,192,1.272,17.993310524410962
Task_206,2032,371,62,175,237,5.462365591397849,40.651885675538296
Task_207,2045,427,105,76,181,4.77803738317757,40.3695018642786
Task_208,2421,594,44,200,244,4.06890756302521,47.54799683363444
Task_209,1708,339,25,40,65,5.023529411764706,33.101972376595306
Task_210,2110,247,64,47,111,8.508064516129032,39.702907339549164
Task_211,571,577,188,110,298,0.9878892733564014,18.26621032169328
Task_212,1943,614,128,100,228,3.159349593495935,39.80605988045718
Task_213,1940,86,27,94,121,22.298850574712645,36.47033990887934
Task_214,1010,356,125,35,160,2.8291316526610646,23.195211476721965
Task_215,2626,629,34,92,126,4.1682539682539685,50.10220902625096
Task_216,2993,269,91,102,193,11.085185185185185,55.12068701012834
Task_217,2555,568,17,179,196,4.490333919156415,49.28143811267816
Task_218,648,787,124,162,286,0.8223350253807107,20.154780018575497
Task_219,2977,372,193,21,214,7.981233243967829,54.63980670960458
Task_220,695,111,23,165,188,6.205357142857143,17.897219540097577
Task_221,2774,119,116,12,128,23.116666666666667,49.610400623554874
Task_222,1655,594,25,81,106,2.7815126050420167,34.22252407808353
Task_223,2530,672,72,42,114,3.7592867756315007,47.88905389879317
Task_224,938,228,96,129,225,4.096069868995633,22.69879171983679
Task_225,1914,425,136,138,274,4.492957746478873,39.006814703296264
Task_226,1878,595,113,157,270,3.151006711409396,38.98953081619689
Task_227,2651,332,59,39,98,7.960960960960961,48.378005225577446
Task_228,1589,702,10,163,173,2.260312944523471,34.251785529550325
Task_229,1831,764,154,174,328,2.3934640522875816,39.061986084465524
Task_230,1607,901,104,41,145,1.7815964523281596,34.31057802624799
Task_231,1104,636,180,22,202,1.7331240188383046,25.775839155041083
Task_232,2502,399,52,107,159,6.255,47.53724790012705
Task_233,1295,92,70,52,122,13.924731182795698,26.088055830067812
Task_234,1195,877,55,110,165,1.3610478359908884,28.493836534918515
Task_235,1872,386,129,93,222,4.837209302325581,37.89846025618075
Task_236,645,867,174,155,329,0.7430875576036866,20.504942642629697
Task_237,2762,564,21,81,102,4.888495575221239,51.58353705798388
Task_238,582,505,176,199,375,1.150197628458498,18.652119545656515
Task_239,2408,534,47,80,127,4.500934579439252,46.31590653062696
Task_240,2957,906,31,62,93,3.2601984564498347,55.41233031271718
Task_241,676,565,103,159,262,1.1943462897526502,19.76821889463652
Task_242,1442,251,58,154,212,5.722222222222222,30.778939112380403
Task_243,595,455,36,175,211,1.3048245614035088,17.93366242818271
Task_244,763,921,126,103,229,0.8275488069414316,22.047634010658232
Task_245,1729,943,103,104,207,1.8315677966101696,37.35536473766287
Task_246,1414,104,53,77,130,13.466666666666667,28.381784330726337
Task_247,2454,551,85,163,248,4.445652173913044,47.88644703055656
Task_248,869,331,57,54,111,2.6174698795180724,20.610042688402558
Task_249,1207,884,153,170,323,1.3638418079096044,29.473615802880783
Task_250,1136,72,119,40,159,15.561643835616438,23.318664798977334
Task_251,2884,266,144,48,192,10.801498127340825,52.818031022054726
Task_252,2182,243,106,38,144,8.942622950819672,41.276135237832136
Task_253,878,170,117,189,306,5.1345029239766085,21.80107249667491
Task_254,1079,621,127,33,160,1.734726688102894,25.10763217440591
Task_255,2963,657,165,55,220,4.503039513677812,55.69021825072651
Task_256,2911,772,191,170,361,3.7658473479948253,56.33964567508949
Task_257,2542,405,23,12,35,6.261083743842365,46.192938160511154
Task_258,1373,737,51,189,240,1.8604336043360434,31.44573363623059
Task_259,1110,99,177,188,365,11.1,25.229413343192295
Task_260,2276,597,184,131,315,3.8060200668896322,45.46345680215478
Task_261,2666,455,180,85,265,5.8464912280701755,50.81129302781647
Task_262,1624,744,70,23,93,2.1798657718120804,33.55043071540551
Task_263,1619,273,135,85,220,5.908759124087592,33.43944316121116
Task_264,1739,877,72,69,141,1.9806378132118452,36.66596729632719
Task_265,2287,88,33,175,208,25.696629213483146,42.9123358603973
Task_266,1433,595,148,116,264,2.4043624161073827,31.855208488134124
Task_267,2886,645,52,89,141,4.46749226006192,54.337281168989314
Task_268,2159,891,20,30,50,2.4204035874439462,41.9602965883822
Task_269,2557,386,192,120,312,6.607235142118863,49.19822938390163
Task_270,1071,295,128,118,246,3.6182432432432434,25.09294746413315
Task_271,1323,463,38,85,123,2.851293103448276,28.83324625946021
Task_272,1951,594,71,100,171,3.2789915966386554,39.61385174289956
Task_273,2603,603,124,116,240,4.309602649006623,50.301088781149154
Task_274,579,154,153,131,284,3.735483870967742,16.859354943272677
Task_275,775,635,110,33,143,1.2185534591194969,20.268621924168325
Task_276,2601,580,24,30,54,4.476764199655766,47.98998494744772
Task_277,2632,773,68,72,140,3.400516795865633,50.550211076246946
Task_278,1725,400,41,31,72,4.301745635910224,33.60691749586274
Task_279,963,782,13,141,154,1.2298850574712643,24.220285303539516
Task_280,1608,557,72,89,161,2.881720430107527,33.91125015272513
Task_281,1410,366,88,93,181,3.8419618528610355,30.27121575467288
Task_282,1045,121,100,49,149,8.565573770491802,22.543024173547753
Task_283,2237,321,21,39,60,6.947204968944099,41.388889487738645
Task_284,1767,382,100,143,243,4.613577023498695,36.408454865388386
Task_285,1049,581,30,164,194,1.802405498281787,25.48839959292067
Task_286,964,262,187,96,283,3.665399239543726,23.45621907715602
Task_287,2673,681,166,103,269,3.9193548387096775,51.7691591827122
Task_288,1804,66,174,119,293,26.925373134328357,35.57476851568482
Task_289,742,310,114,44,158,2.3858520900321545,18.777657885218368
Task_290,2202,962,27,117,144,2.2866043613707165,44.44101327821286
Task_291,2326,266,33,149,182,8.711610486891386,44.560497362886075
Task_292,2279,811,161,187,348,2.8066502463054186,46.41574602679912
Task_293,2385,504,120,58,178,4.7227722772277225,45.83458256855925
Task_294,1937,979,171,119,290,1.976530612244898,41.15932961638624
Task_295,607,368,37,28,65,1.6449864498644986,15.783867381096615
Task_296,1824,856,88,135,223,2.128354725787631,38.66644063305117
Task_297,2213,965,62,70,132,2.290890269151139,44.46206929714748
Task_298,946,346,94,200,294,2.7262247838616713,23.627834543837025
Task_299,1667,1016,39,13,52,1.6391347099311702,34.431701017648464
Task_300,2571,571,198,14,212,4.494755244755245,48.830565330805705
Task_301,1373,742,21,101,122,1.847913862718708,30.43333083326073
Task_302,1719,895,179,15,194,1.9185267857142858,36.27282403924574
Task_303,1216,464,25,169,194,2.6150537634408604,27.754635051792032
Task_304,2362,224,153,196,349,10.497777777777777,45.8236834402524
Task_305,2121,554,141,152,293,3.8216216216216217,42.80386621994008
Task_306,738,171,178,57,235,4.290697674418604,18.792968950090938
Task_307,2160,650,130,46,176,3.3179723502304146,42.524535458813226
Task_308,2592,616,75,59,134,4.2009724473257695,49.24915116094022
Task_309,2497,700,123,161,284,3.5620542082738944,49.19399814722235
Task_310,1910,936,44,107,151,2.038420490928495,39.766546757100976
Task_311,2517,965,98,56,154,2.6055900621118013,49.16502742434876
Task_312,1795,470,95,37,132,3.81104033970276,35.88819387988973
Task_313,1193,988,93,84,177,1.2062689585439839,28.695826262144788
Task_314,1877,269,14,196,210,6.951851851851852,37.681582628828274
Task_315,2944,1009,65,64,129,2.9148514851485148,56.208590792161914
Task_316,1296,718,105,17,122,1.8025034770514603,28.429119919034264
Task_317,2987,905,193,162,355,3.2969094922737305,57.92286264759728
Task_318,1668,882,19,16,35,1.8890147225368064,33.849509792180804
Task_319,2386,471,48,61,109,5.055084745762712,45.11325147566129
Task_320,544,149,103,73,176,3.6266666666666665,15.357614828712874
Task_321,1428,409,128,121,249,3.4829268292682927,31.126605979874995
Task_322,2927,987,126,191,317,2.9625506072874495,57.099788706505954
Task_323,1629,476,197,61,258,3.4150943396226414,34.14604598797269
Task_324,974,300,140,189,329,3.2358803986710964,24.053821181167365
Task_325,1667,861,29,90,119,1.9338747099767981,35.443826008952215
Task_326,679,403,67,146,213,1.6806930693069306,19.190768266323882
Task_327,831,719,193,176,369,1.1541666666666666,23.19927204516881
Task_328,979,539,93,58,151,1.8129629629629629,23.523377724653102
Task_329,2599,842,26,138,164,3.0830367734282325,50.620780369661695
Task_330,862,732,191,131,322,1.1759890859481583,23.461959793361178
Task_331,760,883,183,182,365,0.8597285067873304,22.61215714987165
Task_332,876,105,17,29,46,8.264150943396226,18.774881961724827
Task_333,1216,566,41,157,198,2.144620811287478,28.103273022466222
Task_334,2090,901,35,31,66,2.317073170731707,40.9316556167747
Task_335,1305,277,32,68,100,4.694244604316546,27.440445183482268
Task_336,2906,902,26,83,109,3.2181616832779625,55.092528309531325
Task_337,864,520,133,11,144,1.6583493282149713,21.222046068113926
Task_338,2388,573,36,161,197,4.160278745644599,46.687432304401455
Task_339,2057,500,78,17,95,4.105788423153693,39.5784637625626
Task_340,2677,503,31,199,230,5.311507936507937,51.22568343276413
Task_341,1271,424,147,155,302,2.9905882352941178,28.978748967507542
Task_342,2852,319,148,64,212,8.9125,52.825691226044775
Task_343,966,307,179,153,332,3.1363636363636362,23.91076273811659
Task_344,2107,842,198,53,251,2.4994068801897984,42.902004169147794
Task_345,2028,683,164,160,324,2.9649122807017543,41.89029407422196
Task_346,1460,395,172,79,251,3.686868686868687,31.43318800101567
Task_347,886,816,18,188,206,1.084455324357405,23.59494881289848
Task_348,2735,416,137,101,238,6.5587529976019185,51.75345418079803
Task_349,2441,436,98,48,146,5.585812356979405,46.10515842375062
Task_350,1530,719,88,22,110,2.125,32.06111457446297
Task_351,2507,1004,92,77,169,2.4945273631840794,49.463874429504756
Task_352,1969,919,117,98,215,2.140217391304348,41.11854322961565
Task_353,1898,630,139,86,225,3.007923930269414,39.04345662066377
Task_354,2997,444,179,173,352,6.734831460674157,56.61219067642588
Task_355,1008,737,102,141,243,1.3658536585365855,25.461727334478326
Task_356,1182,356,200,91,291,3.310924369747899,27.15445467530247
Task_357,1174,190,195,64,259,6.146596858638744,26.132165667660683
Task_358,1048,594,117,111,228,1.761344537815126,25.57207965449581
Task_359,2433,696,92,167,259,3.490674318507891,48.07138139875275
Task_360,656,414,69,132,201,1.580722891566265,18.758980197218197
Task_361,1311,343,163,45,208,3.811046511627907,28.23998914830042
Task_362,2776,464,114,179,293,5.969892473118279,52.92294875068355
Task_363,2067,532,53,120,173,3.8780487804878048,41.33097009383606
Task_364,2827,1011,154,191,345,2.7934782608695654,55.716181715024184
Task_365,522,274,52,143,195,1.8981818181818182,16.225615764682995
Task_366,1369,603,23,19,42,2.2665562913907285,28.3413467308245
Task_367,885,197,105,23,128,4.46969696969697,20.61234046926469
Task_368,1351,300,114,127,241,4.488372093023256,29.526858833327683
Task_369,749,993,170,74,244,0.7535211267605634,21.925421750790335
Task_370,1028,229,153,76,229,4.469565217391304,23.884635172163836
Task_371,2328,340,36,56,92,6.826979472140763,43.61570408400069
Task_372,2372,225,100,10,110,10.495575221238939,43.77297987087919
Task_373,1778,314,175,31,206,5.644444444444445,35.524972403796276
Task_374,2117,866,174,94,268,2.4417531718569783,43.5173404491348
Task_375,2939,1011,188,94,282,2.9041501976284585,57.058295825006915
Task_376,583,1021,15,98,113,0.5704500978473581,18.84179107950866
Task_377,2118,89,129,122,251,23.533333333333335,40.402129539790806
Task_378,2223,1015,175,187,362,2.187992125984252,46.22765862951757
Task_379,1679,94,54,124,178,17.673684210526314,33.1595416539485
Task_380,1441,164,62,61,123,8.733333333333333,28.991566477407016
Task_381,1986,674,77,127,204,2.942222222222222,40.67445659509895
Task_382,2651,312,133,197,330,8.46964856230032,50.62642641195214
Task_383,1418,888,94,46,140,1.5950506186726658,31.2874628035744
Task_384,2098,814,164,45,209,2.5742331288343556,42.19650024321869
Task_385,2630,894,110,162,272,2.9385474860335195,51.8575788851633
Task_386,1036,997,195,52,247,1.0380761523046091,26.378819567278203
Task_387,2394,581,138,89,227,4.11340206185567,46.78045646667767
Task_388,2443,856,95,78,173,2.8506417736289382,48.06078271865064
Task_389,2338,955,98,198,296,2.4456066945606696,47.58619433738124
Task_390,2064,505,130,105,235,4.07905138339921,41.41463174515632
Task_391,1216,747,156,53,209,1.625668449197861,28.30539859475164
Task_392,1306,333,70,63,133,3.910179640718563,28.08650200332147
Task_393,832,529,147,29,176,1.569811320754717,21.08967774961747
Task_394,2024,778,54,16,70,2.5982028241335047,39.303604906298176
Task_395,2624,200,182,23,205,13.054726368159203,48.41256476560616
Task_396,1723,182,138,163,301,9.415300546448087,35.23171864031837
Task_397,2450,173,45,125,170,14.080459770114942,45.75164630854645
Task_398,1646,692,12,199,211,2.375180375180375,35.37961088795591
Task_399,2615,459,170,180,350,5.684782608695652,50.616522871354164
Task_400,2797,766,61,44,105,3.646675358539765,52.140630238775856
Task_401,2251,780,174,108,282,2.882202304737516,45.46178804923079
Task_402,2981,860,41,18,59,3.4622531939605112,54.80234319126748
Task_403,2666,279,103,101,204,9.521428571428572,50.03770222119228
Task_404,2062,588,61,55,116,3.500848896434635,40.38835392235283
Task_405,507,885,19,179,198,0.572234762979684,17.949694032587942
Task_406,2259,950,127,134,261,2.3753943217665614,46.06295833923872
Task_407,1112,652,157,91,248,1.7029096477794794,26.772476320729435
Task_408,918,131,130,126,256,6.954545454545454,21.913706009093787
Task_409,2171,93,129,109,238,23.095744680851062,41.17019833343716
Task_410,1980,542,152,57,209,3.6464088397790055,39.70277221082014
Task_411,1474,703,30,55,85,2.09375,31.168967549139666
Task_412,1970,665,15,91,106,2.957957957957958,39.4404557886812
Task_413,1804,213,72,34,106,8.429906542056075,34.76920788840095
Task_414,1681,190,21,55,76,8.801047120418849,32.57328308378903
Task_415,1244,272,17,166,183,4.556776556776557,27.46216032456286
Task_416,921,212,31,80,111,4.323943661971831,21.5076253782145
Task_417,551,220,183,30,213,2.493212669683258,15.848209147562834
Task_418,624,244,50,76,126,2.546938775510204,17.18472458032323
Task_419,936,512,24,133,157,1.8245614035087718,23.068468255620378
Task_420,1799,992,25,11,36,1.811681772406848,36.27363339520601
Task_421,647,192,85,71,156,3.3523316062176165,17.297477607292404
Task_422,1873,931,137,89,226,2.009656652360515,39.620969273912465
Task_423,1928,753,154,137,291,2.557029177718833,40.34327025737343
Task_424,675,885,107,130,237,0.7618510158013544,20.650595327677863
Task_425,1548,562,16,26,42,2.74955595026643,31.1463725189676
Task_426,969,665,189,56,245,1.454954954954955,24.23248429738366
Task_427,2884,887,80,44,124,3.2477477477477477,54.20650312700979
Task_428,1682,660,27,40,67,2.5446293494704992,33.71414312703826
Task_429,646,951,92,70,162,0.6785714285714286,19.83691236856271
Task_430,1199,694,180,107,287,1.725179856115108,28.53552435173295
Task_431,787,917,58,90,148,0.8572984749455338,21.9321160799477
Task_432,2944,67,178,145,323,43.294117647058826,53.55540851344153
Task_433,2696,650,172,55,227,4.141321044546851,51.47057457659975
Task_434,1154,833,50,54,104,1.3836930455635492,26.59978782425664
Task_435,1375,234,42,90,132,5.851063829787234,29.06001833496387
Task_436,1275,1011,79,173,252,1.2598814229249011,30.666863415879863
Task_437,886,303,168,64,232,2.914473684210526,21.774851562666857
Task_438,1580,1021,185,75,260,1.5459882583170255,35.22724226927464
Task_439,2502,835,188,10,198,2.992822966507177,48.51656263179462
Task_440,725,326,91,50,141,2.217125382262997,18.601026684746824
Task_441,1192,94,20,195,215,12.547368421052632,25.77768143252131
Task_442,2213,771,189,125,314,2.866580310880829,45.0007161706966
Task_443,2725,466,54,182,236,5.835117773019272,51.93973743851001
Task_444,1335,327,33,188,221,4.070121951219512,29.36827563407145
Task_445,2962,93,175,41,216,31.51063829787234,52.69797415691071
Task_446,594,543,30,138,168,1.0919117647058822,17.864105595094884
Task_447,1146,645,138,177,315,1.7739938080495357,27.772143390324004
Task_448,679,938,174,59,233,0.7231096911608094,20.567261339372916
Task_449,2324,207,103,45,148,11.173076923076923,43.382499891676936
Task_450,1076,774,79,28,107,1.3883870967741936,25.05404264934609
Task_451,788,1009,43,187,230,0.7801980198019802,22.83964710098462
Task_452,2086,861,196,76,272,2.4199535962877032,42.83719629402432
Task_453,1419,683,170,112,282,2.074561403508772,31.984223995188145
Task_454,1007,864,53,61,114,1.1641618497109827,24.626519532689382
Task_455,1546,204,48,128,176,7.541463414634146,32.01935035518838
Task_456,2080,922,27,193,220,2.2535211267605635,43.03104826118054
Task_457,2522,489,106,65,171,5.146938775510204,47.94179190133923
Task_458,2281,170,118,143,261,13.339181286549708,43.65711365306024
Task_459,2499,900,126,127,253,2.7735849056603774,49.66366486245204
Task_460,933,564,162,66,228,1.6513274336283186,23.332490044793076
Task_461,2546,969,69,58,127,2.624742268041237,49.5644005037847
Task_462,2770,186,11,135,146,14.81283422459893,50.90039539889815
Task_463,2118,263,171,127,298,8.022727272727273,41.78107008604284
Task_464,1390,503,113,141,254,2.757936507936508,30.876179331475594
Task_465,2035,137,98,120,218,14.746376811594203,39.3536525531744
Task_466,841,697,25,17,42,1.2048710601719197,20.36338347004857
Task_467,1153,899,161,197,358,1.281111111111111,28.847502269382108
Task_468,1964,633,73,31,104,3.0977917981072554,38.67748165257651
Task_469,1567,589,29,143,172,2.6559322033898307,33.55737961801227
Task_470,2423,653,191,132,323,3.7048929663608563,48.006623236203296
Task_471,1737,858,128,17,145,2.0221187427240976,36.17083842188732
Task_472,2344,520,126,17,143,4.499040307101727,44.66012234659371
Task_473,2251,564,45,54,99,3.984070796460177,43.08446124301141
Task_474,1349,300,104,92,196,4.48172757475083,29.18931716999826
Task_475,2475,125,125,52,177,19.642857142857142,45.5105061754013
Task_476,2293,104,180,42,222,21.83809523809524,42.42679090779835
Task_477,697,605,81,139,220,1.1501650165016502,20.033614566273037
Task_478,2470,237,91,190,281,10.378151260504202,47.2627961004217
Task_479,592,1002,23,192,215,0.5902293120638086,19.766023167037133
Task_480,1643,480,176,10,186,3.415800415800416,33.72419179486517
Task_481,2633,612,81,184,265,4.295269168026101,51.070536689945015
Task_482,729,547,10,103,113,1.3302919708029197,19.51745800854446
Task_483,890,877,110,123,233,1.0136674259681093,23.922949474240095
Task_484,2699,699,189,185,374,3.855714285714286,52.83139673581562
Task_485,585,980,119,185,304,0.5963302752293578,20.00039675159035
Task_486,684,1003,29,83,112,0.6812749003984063,20.358800828706435
Task_487,2551,342,143,95,238,7.437317784256559,48.59797325535854
Task_488,2691,1019,65,165,230,2.638235294117647,53.09921892968123
Task_489,2277,615,108,195,303,3.6964285714285716,45.576135550334904
Task_490,2213,427,122,105,227,5.170560747663552,43.48505914296968
Task_491,1098,883,154,176,330,1.242081447963801,27.76618227177242
Task_492,2590,929,71,138,209,2.78494623655914,51.07394295796448
Task_493,2637,704,31,53,84,3.7404255319148936,49.60716981197245
Task_494,1849,539,51,149,200,3.424074074074074,38.12393999609993
Task_495,1524,895,193,164,357,1.7008928571428572,34.708520739099406
Task_496,2403,459,89,28,117,5.223913043478261,45.17071374607516
Task_497,1123,974,85,139,224,1.1517948717948718,27.896980675727917
Task_498,2989,769,110,193,303,3.881818181818182,57.33819550299662
Task_499,2377,503,98,196,294,4.716269841269841,46.767050026996436
Task_500,1790,706,39,86,125,2.531824611032532,37.05132074098386
Task_501,2211,102,17,189,206,21.466019417475728,41.808540471866394
Task_502,1944,399,90,98,188,4.86,38.937155372178715
Task_503,1846,281,31,152,183,6.546099290780142,37.02664561942548
Task_504,1092,966,99,162,261,1.1292657704239917,27.58435923128574
Task_505,773,350,154,133,287,2.202279202279202,20.76406209861642
Task_506,545,540,178,55,233,1.0073937153419594,17.03025269441495
Task_507,636,627,183,26,209,1.0127388535031847,18.403841391660098
Task_508,1636,864,180,79,259,1.891329479768786,35.73174071046129
Task_509,2699,129,113,26,139,20.76153846153846,48.54272722366124
Task_510,2284,168,71,101,172,13.514792899408285,43.23159170319707
Task_511,2644,791,29,61,90,3.3383838383838382,50.015586835610065
Task_512,2897,306,135,162,297,9.436482084690553,54.29495378120041
Task_513,2452,753,71,126,197,3.2519893899204244,48.26457512630612
Task_514,2713,455,48,124,172,5.949561403508772,51.29805687312062
Task_515,741,94,128,97,225,7.8,18.618855067962787
Task_516,2879,174,87,133,220,16.451428571428572,52.84723469050676
Task_517,2977,439,122,97,219,6.765909090909091,55.596608618433955
Task_518,1078,109,31,23,54,9.8,22.055457303134812
Task_519,1212,759,55,157,212,1.5947368421052632,28.748557393814195
Task_520,1801,91,113,188,301,19.57608695652174,35.76418932655012
Task_521,2082,447,64,14,78,4.647321428571429,39.31002246820099
Task_522,1396,922,15,183,198,1.512459371614301,32.033944163681674
Task_523,1577,195,96,150,246,8.045918367346939,32.799176221934104
Task_524,2933,774,170,180,350,3.784516129032258,56.659564852475874
Task_525,750,675,166,119,285,1.1094674556213018,21.30809829287327
Task_526,2457,154,183,116,299,15.851612903225806,46.50449572718301
Task_527,2912,277,155,95,250,10.474820143884893,54.130791545391496
Task_528,705,158,120,75,195,4.433962264150943,18.142233964609915
Task_529,2505,639,164,152,316,3.9140625,49.25878971828016
Task_530,2484,474,68,42,110,5.229473684210526,46.458142822206845
Task_531,1372,427,177,171,348,3.205607476635514,30.81750933046956
Task_532,2403,940,40,157,197,2.5536663124335814,48.06877638995706
Task_533,1761,543,155,165,320,3.2371323529411766,37.20938843035629
Task_534,2903,225,180,96,276,12.845132743362832,53.924263202611854
Task_535,2539,438,33,38,71,5.783599088838269,46.62843199300332
Task_536,1068,253,124,71,195,4.2047244094488185,24.3640904273512
Task_537,2817,732,64,61,125,3.8431105047748977,52.98317480151769
Task_538,1966,371,69,82,151,5.28494623655914,38.91358769687023
Task_539,778,896,153,154,307,0.867335562987737,22.63509289040883
Task_540,955,68,93,148,241,13.840579710144928,22.100183173459232
Task_541,2384,541,102,170,272,4.398523985239852,46.85844940020081
Task_542,2671,951,54,133,187,2.805672268907563,52.316228908923996
Task_543,2237,88,110,15,125,25.134831460674157,40.547623984128805
Task_544,619,881,114,13,127,0.7018140589569161,18.643643044917102
Task_545,2342,853,186,45,231,2.7423887587822016,46.283466519391574
Task_546,741,94,50,144,194,7.8,18.59018809446435
Task_547,1197,671,87,88,175,1.78125,27.793795261872262
Task_548,2505,669,45,108,153,3.7388059701492535,48.35995950296235
Task_549,598,189,48,196,244,3.1473684210526316,17.421177292910095
Task_550,2106,594,138,100,238,3.5394957983193276,42.36926852951127
Task_551,870,527,30,82,112,1.6477272727272727,21.730983644700512
Task_552,1629,932,127,178,305,1.7459807073954985,36.273348091023884
Task_553,1735,950,151,185,336,1.8243953732912723,38.172331712971236
Task_554,604,977,11,57,68,0.6175869120654397,18.09108111210858
Task_555,869,609,199,144,343,1.4245901639344263,23.31035317022641
Task_556,2195,775,31,137,168,2.8286082474226806,44.040568650293956
Task_557,2840,872,193,127,320,3.2531500572737686,55.281181007434725
Task_558,2926,589,133,180,313,4.959322033898305,55.79431199354419
Task_559,2441,352,148,149,297,6.915014164305949,47.223642271373485
Task_560,2248,409,66,166,232,5.482926829268293,44.16935229593329
Task_561,1198,380,90,112,202,3.1443569553805775,27.163629565256144
Task_562,1435,466,156,80,236,3.0728051391862956,31.20128641289499
Task_563,1207,783,23,197,220,1.5395408163265305,28.73077910028813
Task_564,2717,670,115,78,193,4.049180327868853,51.927148749233545
Task_565,1729,190,23,39,62,9.052356020942408,33.08496341585409
Task_566,1942,887,194,46,240,2.186936936936937,40.11244543067859
Task_567,980,654,41,10,51,1.4961832061068703,22.41926014409061
Task_568,924,893,41,200,241,1.0335570469798658,24.63590095746064
Task_569,854,102,178,119,297,8.29126213592233,20.842314037374774
Task_570,2073,765,101,160,261,2.706266318537859,42.576431434653536
Task_571,898,137,109,101,210,6.507246376811594,21.383770407636657
Task_572,2443,348,95,42,137,7.0,45.720430715571304
Task_573,2187,172,162,71,233,12.641618497109826,41.70970154930169
Task_574,2226,608,132,133,265,3.6551724137931036,44.48410144759083
Task_575,1963,248,199,74,273,7.883534136546185,38.90965681055235
Task_576,1363,743,24,100,124,1.831989247311828,30.33960099533807
Task_577,720,343,80,146,226,2.0930232558139537,19.700955331478678
Task_578,2389,307,23,186,209,7.7564935064935066,45.89220542813695
Task_579,2734,263,82,192,274,10.356060606060606,51.5449536100804
Task_580,2859,934,159,18,177,3.057754010695187,54.38259195393869
Task_581,913,478,118,127,245,1.9060542797494782,23.1850774388047
Task_582,1698,123,196,178,374,13.693548387096774,34.740621913206276
Task_583,2715,935,125,177,302,2.9006410256410255,53.48980459990177
Task_584,582,858,70,164,234,0.6775320139697323,19.302227855074182
Task_585,2830,817,13,124,137,3.4596577017114916,53.88606084987156
Task_586,1547,1009,84,17,101,1.5316831683168317,33.100524117122724
Task_587,731,877,96,76,172,0.8325740318906606,20.941604904555838
Task_588,2836,951,61,11,72,2.9789915966386555,52.72011263968904
Task_589,1760,816,187,30,217,2.1542227662178703,36.88262469660277
Task_590,1676,876,147,84,231,1.911060433295325,36.31158371240633
Task_591,1827,127,48,200,248,14.2734375,36.291505096103926
Task_592,2508,255,36,148,184,9.796875,47.41242252802787
Task_593,2968,901,166,162,328,3.2904656319290466,57.487578895516776
Task_594,2452,907,97,196,293,2.700440528634361,49.22991758675503
Task_595,2467,265,21,42,63,9.274436090225564,44.89794680186796
Task_596,2207,67,153,133,286,32.455882352941174,41.85083632680589
Task_597,1976,689,159,144,303,2.863768115942029,40.96737220893846
Task_598,2863,869,65,79,144,3.2908045977011495,54.66681205039678
Task_599,2578,927,159,119,278,2.7780172413793105,51.10074027063795
Task_600,2149,875,106,38,144,2.4531963470319633,42.79851084391735
Task_601,2058,863,67,200,267,2.3819444444444446,42.805156077363286
Task_602,2390,181,121,16,137,13.131868131868131,43.9495874250963
Task_603,1705,360,164,160,324,4.7229916897506925,35.74557343713402
Task_604,2149,790,96,79,175,2.7168141592920354,43.23453610493127
Task_605,1833,659,70,112,182,2.7772727272727273,38.05048500351923
Task_606,1273,211,117,154,271,6.004716981132075,28.166766095398845
Task_607,2851,606,155,48,203,4.696869851729819,53.485899321896575
Task_608,2841,714,90,20,110,3.9734265734265732,52.82431882261892
Task_609,2148,972,72,180,252,2.2076053442959918,44.45930281978013
Task_610,2372,291,47,66,113,8.123287671232877,44.609124820313184
Task_611,1238,504,78,122,200,2.4514851485148514,28.268647910054792
Task_612,2414,339,198,104,302,7.1,46.70902416453655
Task_613,2625,894,156,187,343,2.9329608938547485,52.13500217906392
Task_614,1596,252,94,49,143,6.308300395256917,32.19263370513492
Task_615,1566,909,65,130,195,1.720879120879121,34.70726579520848
Task_616,1551,342,62,46,108,4.521865889212828,31.129832897887727
Task_617,2055,808,78,123,201,2.5401730531520395,42.16804125599995
Task_618,2646,705,42,33,75,3.7478753541076486,49.16750142920514
Task_619,1023,690,176,118,294,1.4804630969609263,25.75360759028051
Task_620,2831,758,90,107,197,3.729907773386034,54.19096650539629
Task_621,553,484,175,126,301,1.1402061855670103,17.687138832439228
Task_622,504,774,131,183,314,0.6503225806451612,18.111258834621157
Task_623,1610,442,123,59,182,3.63431151241535,33.368345544439755
Task_624,2249,313,17,143,160,7.162420382165605,43.19641831516759
Task_625,2615,180,193,50,243,14.447513812154696,48.302221657259345
Task_626,1929,331,13,89,102,5.8102409638554215,37.6469381841191
Task_627,1539,381,189,179,368,4.028795811518324,33.41403015103426
Task_628,1670,495,162,78,240,3.3669354838709675,35.00516552406575
Task_629,1493,711,135,38,173,2.0969101123595504,32.12776337804809
Task_630,2409,856,99,151,250,2.8109684947491247,48.123457425311386
Task_631,1763,446,107,51,158,3.9440715883668904,35.59206492567646
Task_632,2343,213,161,116,277,10.948598130841122,45.03958234891767
Task_633,1573,841,153,197,350,1.868171021377672,35.347340843976475
Task_634,2806,585,140,130,270,4.78839590443686,53.61406994747889
Task_635,2409,253,145,10,155,9.484251968503937,44.84162518606042
Task_636,789,281,93,171,264,2.797872340425532,20.786792419209096
Task_637,1622,547,48,119,167,2.95985401459854,34.273653275028764
Task_638,2650,239,15,72,87,11.041666666666666,48.42165609714661
Task_639,2648,837,101,10,111,3.159904534606205,50.16499945430889
Task_640,2194,510,61,31,92,4.293542074363992,41.72514107968133
Task_641,606,840,71,104,175,0.7205707491082045,19.203357836520947
Task_642,828,727,42,64,106,1.1373626373626373,21.37642385674609
Task_643,1290,296,48,140,188,4.343434343434343,28.375714585291206
Task_644,2620,827,84,17,101,3.1642512077294684,49.56615157891077
Task_645,1455,755,54,18,72,1.9246031746031746,30.23943023821121
Task_646,622,483,151,134,285,1.2851239669421488,18.72355921802134
Task_647,1662,279,11,30,41,5.935714285714286,32.02996746575143
Task_648,2674,432,163,109,272,6.175519630484988,51.00603330109144
Task_649,1965,398,111,64,175,4.924812030075188,38.86720825964921
Task_650,2315,929,170,140,310,2.489247311827957,47.114538579503204
Task_651,2997,640,53,104,157,4.675507020280811,56.14727915388184
Task_652,1445,354,14,133,147,4.070422535211268,30.58004780715731
Task_653,725,208,83,102,185,3.4688995215311005,19.043140760501597
Task_654,2862,800,78,53,131,3.5730337078651684,54.127236353957215
Task_655,1935,773,30,84,114,2.5,39.4070428023072
Task_656,816,839,133,139,272,0.9714285714285714,22.87681976573224
Task_657,2248,696,134,99,233,3.225251076040172,44.91045358218392
Task_658,826,324,139,153,292,2.5415384615384617,21.57133957741718
Task_659,1385,500,82,144,226,2.7644710578842315,30.707775404197633
Task_660,1522,174,46,145,191,8.697142857142858,31.324883198922077
Task_661,1678,608,198,120,318,2.755336617405583,36.02528759738636
Task_662,1053,86,33,156,189,12.10344827586207,23.426477768254234
Task_663,2769,860,26,170,196,3.21602787456446,53.6084100340213
Task_664,1014,827,53,115,168,1.2246376811594204,25.458302216968832
Task_665,806,776,116,112,228,1.0373230373230373,22.259323319725947
Task_666,2336,705,146,10,156,3.308781869688385,45.17547584354703
Task_667,1492,418,12,52,64,3.560859188544153,30.161779705757265
Task_668,2006,432,38,62,100,4.6327944572748265,38.92213276420495
Task_669,714,800,18,190,208,0.8913857677902621,20.86309035645453
Task_670,2489,777,94,128,222,3.1992287917737787,48.992103280404315
Task_671,1595,596,15,22,37,2.6716917922948076,31.899112078381165
Task_672,1790,869,11,76,87,2.057471264367816,36.87789936623975
Task_673,2782,438,68,87,155,6.337129840546697,52.09175687110942
Task_674,1609,139,117,89,206,11.492857142857142,32.474088212117444
Task_675,1940,248,120,109,229,7.791164658634538,38.577637192065346
Task_676,1178,813,77,195,272,1.4471744471744472,28.665003246162854
Task_677,930,291,44,197,241,3.184931506849315,22.960745920040356
Task_678,2968,653,153,135,288,4.538226299694189,56.485364036705015
Task_679,2431,217,100,50,150,11.15137614678899,45.21449440785986
Task_680,637,337,154,77,231,1.8846153846153846,18.071074228846722
Task_681,1763,85,94,182,276,20.5,35.01131104896187
Task_682,2247,713,170,15,185,3.1470588235294117,44.015006467439946
Task_683,2566,736,24,82,106,3.4816824966078697,49.13480209275792
Task_684,2520,532,179,173,352,4.727954971857411,49.347883816625234
Task_685,531,639,30,61,91,0.8296875,16.118866227259293
Task_686,2135,720,38,77,115,2.9611650485436893,42.367231049344205
Task_687,843,583,90,62,152,1.4434931506849316,21.405677859590696
Task_688,1921,646,32,89,121,2.9690880989180837,38.82441271780378
Task_689,2075,733,12,200,212,2.826975476839237,42.3096926266792
Task_690,2944,492,125,194,319,5.971602434077079,55.81315192233126
Task_691,2336,366,136,31,167,6.3651226158038146,44.337029020627256
Task_692,2576,303,185,64,249,8.473684210526315,48.57202956420514
Task_693,2129,131,69,145,214,16.12878787878788,40.89087168961918
Task_694,1270,605,119,141,260,2.0957095709570956,29.32380973611959
Task_695,2920,360,130,99,229,8.088642659279778,54.442290711368535
Task_696,2846,172,141,147,288,16.45086705202312,52.69293069076186
Task_697,705,325,161,143,304,2.1625766871165646,19.70041196367115
Task_698,2415,129,95,50,145,18.576923076923077,44.221251479426144
Task_699,2499,458,176,57,233,5.444444444444445,47.75707494933537
Task_700,654,707,109,176,285,0.923728813559322,20.02179972013097
Task_701,2903,808,186,151,337,3.5883807169344872,56.19023156197039
Task_702,999,216,58,72,130,4.6036866359447,22.914126724578452
Task_703,722,117,68,138,206,6.11864406779661,18.587396106518714
Task_704,2498,492,17,69,86,5.0669371196754565,46.82916752741238
Task_705,1348,690,106,66,172,1.950795947901592,30.00555960488512
Task_706,543,694,151,79,230,0.781294964028777,17.759462323532485
Task_707,2487,983,169,153,322,2.527439024390244,50.08154898965582
Task_708,2827,565,114,66,180,4.9946996466431095,53.084147903004634
Task_709,658,125,115,37,152,5.222222222222222,16.402743470758057
Task_710,1462,333,198,129,327,4.377245508982036,31.781405032742615
Task_711,1776,156,160,50,210,11.312101910828025,34.77934824292077
Task_712,1445,667,18,24,42,2.163173652694611,29.82567772608766
Task_713,583,226,13,51,64,2.5682819383259914,15.151503997687785
Task_714,690,291,108,89,197,2.363013698630137,18.750763862872976
Task_715,1090,414,154,192,346,2.6265060240963853,26.33511433932219
Task_716,2749,193,136,142,278,14.170103092783505,51.40557368510067
Task_717,755,512,154,56,210,1.4717348927875245,20.20929818417937
Task_718,2426,551,134,103,237,4.394927536231884,47.299534261865894
Task_719,2543,878,87,61,148,2.8930602957906713,49.29844766757608
Task_720,1905,722,171,156,327,2.6348547717842323,40.07196920066094
Task_721,1179,798,190,172,362,1.4755944931163956,28.934945885682875
Task_722,712,849,43,190,233,0.8376470588235294,21.121038021557233
Task_723,2865,494,101,196,297,5.787878787878788,54.47281275524855
Task_724,1812,880,164,72,236,2.0567536889897844,38.3379030674873
Task_725,1412,364,108,61,169,3.8684931506849316,29.91358179812708
Task_726,823,959,67,57,124,0.8572916666666667,22.16486706061576
Task_727,894,796,196,42,238,1.121706398996236,23.213788792679935
Task_728,979,890,77,97,174,1.0987654320987654,25.132393621103603
Task_729,2537,961,125,180,305,2.637214137214137,50.76825883484535
Task_730,2675,252,40,124,164,10.57312252964427,49.8967972381569
Task_731,2306,421,111,164,275,5.464454976303317,45.240044343901694
Task_732,1092,485,32,77,109,2.246913580246914,24.988637343393975
Task_733,2403,750,172,63,235,3.199733688415446,47.21538897706026
Task_734,746,474,59,26,85,1.5705263157894738,18.645574106434715
Task_735,2612,810,20,155,175,3.220715166461159,50.82477874337061
Task_736,1961,83,152,75,227,23.345238095238095,37.35555201159896
Task_737,745,879,64,43,107,0.8465909090909091,20.147799077102285
Task_738,1230,716,116,114,230,1.715481171548117,28.84844101876671
Task_739,770,425,26,194,220,1.807511737089202,20.726442291274772
Task_740,2618,103,103,86,189,25.173076923076923,47.909715377706114
Task_741,2113,268,164,198,362,7.855018587360595,42.112304952761974
Task_742,870,786,138,77,215,1.105463786531131,23.050143198601315
Task_743,1861,733,188,24,212,2.535422343324251,38.14144930397257
Task_744,1200,271,53,36,89,4.411764705882353,25.199843893268234
Task_745,774,727,154,52,206,1.0631868131868132,21.2072211094593
Task_746,728,598,10,37,47,1.2153589315525877,18.40875436071892
Task_747,1167,96,123,32,155,12.030927835051546,24.111104019784836
Task_748,2468,393,50,130,180,6.2639593908629445,47.30548367222906
Task_749,2985,289,17,152,169,10.293103448275861,54.94720709999646
Task_750,1835,917,157,196,353,1.9989106753812635,39.747116990901645
Task_751,691,592,117,10,127,1.1652613827993255,18.631830928232315
Task_752,536,843,163,92,255,0.6350710900473934,18.418686682380024
Task_753,805,327,132,147,279,2.4542682926829267,21.181434431854168
Task_754,975,629,72,133,205,1.5476190476190477,24.48793749590548
Task_755,2869,305,106,159,265,9.375816993464053,53.70005203917052
Task_756,676,742,58,122,180,0.9098250336473755,19.924863705871655
Task_757,2853,103,142,111,253,27.432692307692307,52.05814243993493
Task_758,1045,226,140,52,192,4.60352422907489,23.852901103544813
Task_759,2533,424,86,167,253,5.96,48.7078293820336
Task_760,2802,860,143,96,239,3.254355400696864,54.259264529328
Task_761,1173,641,172,63,235,1.8271028037383177,27.39056826977642
Task_762,1724,894,118,85,203,1.9262569832402234,37.00096102030903
Task_763,1914,174,48,123,171,10.937142857142858,37.3363215006249
Task_764,2949,542,40,36,76,5.430939226519337,53.444264969021894
Task_765,2131,1015,20,121,141,2.09744094488189,43.466484377953655
Task_766,2438,839,188,53,241,2.9023809523809523,48.091940185152716
Task_767,2199,468,153,101,254,4.688699360341151,43.51248700308037
Task_768,2891,308,99,78,177,9.35598705501618,53.401425307285564
Task_769,2956,1007,36,55,91,2.9325396825396823,55.67879600324792
Task_770,821,491,106,73,179,1.66869918699187,21.137304246345035
Task_771,1445,428,106,186,292,3.3682983682983685,31.745598389062824
Task_772,1703,415,188,112,300,4.09375,35.71437113584766
Task_773,1909,400,198,80,278,4.760598503740648,38.67998511516644
Task_774,1166,948,108,198,306,1.2286617492096945,28.969045414998675
Task_775,2385,122,59,40,99,19.390243902439025,42.909363137117985
Task_776,1892,169,22,96,118,11.129411764705882,36.2265268301906
Task_777,1173,97,31,146,177,11.96938775510204,25.210967899586056
Task_778,1066,216,127,81,208,4.912442396313364,24.420660122782845
Task_779,2398,674,86,130,216,3.5525925925925925,47.152117335938556
Task_780,1427,959,153,105,258,1.4864583333333334,32.80805371823737
Task_781,2906,90,102,57,159,31.934065934065934,51.61160746843924
Task_782,741,634,133,148,281,1.1669291338582677,21.0721825141371
Task_783,1683,813,180,37,217,2.0675675675675675,35.67135663648383
Task_784,1789,530,99,122,221,3.3691148775894537,37.103943541213496
Task_785,2625,628,181,193,374,4.17329093799682,51.44592289560992
Task_786,758,670,163,87,250,1.1296572280178838,21.156828529238876
Task_787,1950,809,166,25,191,2.4074074074074074,39.70388395691066
Task_788,847,808,157,106,263,1.0469715698393078,23.1569108845493
Task_789,2805,85,12,120,132,32.616279069767444,50.14511237109096
Task_790,2618,201,155,18,173,12.96039603960396,48.12362119917688
Task_791,1594,805,190,146,336,1.977667493796526,35.43015972791732
Task_792,724,502,75,32,107,1.4393638170974155,18.655845002956063
Task_793,868,710,40,70,110,1.2208157524613221,22.07287611915721
Task_794,2935,447,84,185,269,6.551339285714286,55.29419618771633
Task_795,2227,431,61,58,119,5.155092592592593,42.53068729657169
Task_796,1916,795,14,47,61,2.407035175879397,37.91979413794596
Task_797,1982,295,114,69,183,6.695945945945946,38.82007559455769
Task_798,697,516,97,43,140,1.3481624758220503,18.626521452617233
Task_799,2534,434,54,27,81,5.825287356321839,46.815995179365984
Task_800,1340,816,65,29,94,1.6401468788249693,29.24970949570616
Task_801,801,635,173,165,338,1.259433962264151,22.315183206231087
Task_802,791,911,25,118,143,0.8673245614035088,21.884114626810135
Task_803,1757,229,93,166,259,7.639130434782609,35.875945165097825
Task_804,615,769,140,32,172,0.7987012987012987,18.43507752309892
Task_805,2597,626,162,161,323,4.1419457735247205,50.71933876714411
Task_806,806,351,92,150,242,2.289772727272727,21.11899358867459
Task_807,1369,234,107,141,248,5.825531914893617,29.640429181175055
Task_808,2174,655,119,116,235,3.3140243902439024,43.64902160924035
Task_809,2895,796,124,86,210,3.6323713927227104,55.291724905023806
Task_810,1810,375,90,119,209,4.8138297872340425,36.87179468874056
Task_811,2177,790,126,93,219,2.752212389380531,43.99838707132729
Task_812,2078,853,91,191,282,2.433255269320843,43.070118205479424
Task_813,1072,666,109,95,204,1.6071964017991005,26.05849967358318
Task_814,2588,749,190,190,380,3.4506666666666668,51.26514987048184
Task_815,2932,633,67,34,101,4.624605678233438,53.98491945291162
Task_816,2117,254,133,66,199,8.301960784313726,40.91983205490819
Task_817,2041,305,51,148,199,6.669934640522876,40.39286324468477
Task_818,563,730,72,50,122,0.7701778385772914,17.141712951624708
Task_819,2700,401,150,152,302,6.7164179104477615,51.51285637550128
Task_820,2527,696,42,45,87,3.625538020086083,47.602618137734645
Task_821,1449,763,102,155,257,1.8965968586387434,32.6593007804474
Task_822,1352,940,130,31,161,1.436769394261424,30.451753167497017
Task_823,548,362,23,27,50,1.5096418732782368,14.82668152328118
Task_824,2961,676,148,200,348,4.373707533234859,56.813357278769296
Task_825,1040,569,66,158,224,1.8245614035087718,25.50900833399501
Task_826,2718,186,88,156,244,14.53475935828877,50.76968983448521
Task_827,2329,91,57,114,171,25.315217391304348,43.27673641346334
Task_828,524,501,121,69,190,1.043824701195219,16.46469160111224
Task_829,2114,455,43,192,235,4.635964912280702,42.189421633680716
Task_830,2353,163,159,127,286,14.347560975609756,44.861174838059306
Task_831,575,221,121,120,241,2.59009009009009,16.994014611095132
Task_832,2489,655,84,139,223,3.794207317073171,48.6277433240806
Task_833,1204,69,92,138,230,17.2,25.93143819262674
Task_834,2736,479,37,192,229,5.7,52.093297979915526
Task_835,2335,668,77,188,265,3.490284005979073,46.547833413342666
Task_836,2543,837,37,43,80,3.0346062052505967,48.242358518180765
Task_837,926,957,105,178,283,0.9665970772442589,25.091449708028126
Task_838,2528,870,140,157,297,2.902411021814007,50.27168183520907
Task_839,931,379,127,84,211,2.45,22.86670123486995
Task_840,640,215,42,145,187,2.962962962962963,17.797169457321733
Task_841,2610,492,10,63,73,5.294117647058823,48.21651915509176
Task_842,2747,560,86,95,181,4.896613190730838,52.09508542528965
Task_843,1474,538,198,61,259,2.7346938775510203,31.893212825857535
Task_844,2851,715,100,86,186,3.9818435754189943,54.19369859696832
Task_845,1193,738,125,189,314,1.6143437077131257,28.819306332931102
Task_846,2158,899,67,27,94,2.397777777777778,42.4980498180952
Task_847,1137,948,142,142,284,1.1981032665964173,28.333023967849684
Task_848,1242,836,36,54,90,1.4838709677419355,27.938291774224624
Task_849,1452,232,194,46,240,6.23175965665236,30.2615941544104
Task_850,2637,1023,59,100,159,2.5751953125,51.63937688425158
Task_851,1477,691,123,177,300,2.134393063583815,33.10433683628644
Task_852,2715,261,176,138,314,10.36259541984733,51.2963920398077
Task_853,1057,334,118,40,158,3.1552238805970148,23.838193171634444
Task_854,1473,644,35,190,225,2.2837209302325583,32.58922063627633
Task_855,1363,470,125,90,215,2.8938428874734607,30.06198307551991
Task_856,1814,1015,12,162,174,1.7854330708661417,38.8040435078307
Task_857,2054,948,44,76,120,2.164383561643836,41.78105531523304
Task_858,1305,994,40,133,173,1.3115577889447236,30.598470764643338
Task_859,2769,846,92,74,166,3.269185360094451,53.13346648247682
Task_860,1425,1015,81,50,131,1.4025590551181102,31.803203008073922
Task_861,1231,720,170,92,262,1.7073509015256587,28.93691361351271
Task_862,2213,220,172,63,235,10.013574660633484,42.464201594513135
Task_863,2973,405,48,109,157,7.322660098522167,54.99785214911634
Task_864,1422,441,135,87,222,3.2171945701357467,30.901113894866892
Task_865,987,582,92,10,102,1.6929674099485421,22.95012742785823
Task_866,1634,675,41,121,162,2.4171597633136095,34.723982432302826
Task_867,2965,1002,62,31,93,2.9561316051844466,55.50316282272225
Task_868,1617,360,64,118,182,4.479224376731302,33.684393700551176
Task_869,1137,518,129,163,292,2.1907514450867054,27.121477820355153
Task_870,1617,193,179,58,237,8.335051546391753,32.97633067707623
Task_871,575,588,47,161,208,0.9762308998302207,18.014225003457856
Task_872,1618,479,143,89,232,3.370833333333333,34.19147770117544
Task_873,825,135,72,88,160,6.0661764705882355,19.681081875332296
Task_874,1629,473,94,164,258,3.4367088607594938,34.62647506595414
Task_875,616,514,46,68,114,1.196116504854369,17.557500126988714
Task_876,1435,396,52,28,80,3.6146095717884132,29.234184516758848
Task_877,911,857,125,21,146,1.0617715617715617,23.136750489550433
Task_878,1353,680,150,108,258,1.986784140969163,30.815403542904775
Task_879,584,895,193,59,252,0.6517857142857143,19.056482362588024
Task_880,2935,443,162,29,191,6.61036036036036,54.18543592781348
Task_881,1042,524,150,58,208,1.9847619047619047,24.790984789896257
Task_882,1769,922,157,46,203,1.9165763813651138,37.31332123275653
Task_883,1692,322,188,56,244,5.238390092879257,34.59556006126848
Task_884,996,752,52,100,152,1.3227091633466135,24.69352835915906
Task_885,1787,415,87,163,250,4.295673076923077,36.85334164404319
Task_886,1398,288,134,149,283,4.837370242214533,30.45155567584449
Task_887,1272,187,67,171,238,6.76595744680851,28.044874228645224
Task_888,1949,494,21,90,111,3.937373737373737,38.679778808687544
Task_889,1006,496,81,86,167,2.024144869215292,24.286445616491818
Task_890,1036,147,147,117,264,7.0,23.934897250564905
Task_891,1337,888,50,151,201,1.5039370078740157,31.074795044097872
Task_892,670,384,18,15,33,1.7402597402597402,16.485656137043872
Task_893,2363,684,34,159,193,3.44963503649635,46.6199073217774
Task_894,1351,144,194,150,344,9.317241379310344,29.27349112857213
Task_895,1836,393,74,135,209,4.659898477157361,37.431682697752606
Task_896,1410,800,186,77,263,1.7602996254681649,31.894375509502805
Task_897,2636,212,78,92,170,12.375586854460094,49.11830650703643
Task_898,1642,240,60,182,242,6.813278008298755,34.07630301385976
Task_899,874,838,175,142,317,1.0417163289630513,23.973705427889914
Task_900,1194,301,157,186,343,3.9536423841059603,27.59410691254958
Task_901,748,873,156,115,271,0.8558352402745996,21.86923137780859
Task_902,1692,934,46,70,116,1.8096256684491978,35.89380257215226
Task_903,2966,657,159,71,230,4.507598784194529,55.8690525202583
Task_904,937,755,180,76,256,1.2394179894179893,24.195098168205817
Task_905,2668,871,96,43,139,3.0596330275229358,50.95725221104514
Task_906,2447,606,25,195,220,4.031301482701812,47.85141820130261
Task_907,2558,543,190,133,323,4.702205882352941,49.79556346588083
Task_908,569,275,39,49,88,2.0615942028985508,15.398741079384054
Task_909,2586,955,14,67,81,2.705020920502092,49.65670019368264
Task_910,2489,276,80,151,231,8.985559566787003,47.47749036974068
Task_911,1411,691,38,120,158,2.0390173410404624,31.161971027744723
Task_912,790,928,95,41,136,0.8503767491926802,21.4389663369696
Task_913,2053,602,189,154,343,3.4046434494195688,42.10766877655871
Task_914,1053,543,28,34,62,1.9356617647058822,23.367224514496552
Task_915,2085,213,123,179,302,9.742990654205608,41.17099712723177
Task_916,2815,844,59,133,192,3.331360946745562,54.299083969098525
Task_917,2453,984,52,21,73,2.4903553299492387,46.85233011329199
Task_918,2021,721,21,38,59,2.799168975069252,39.286784735626085
Task_919,1063,431,182,66,248,2.4606481481481484,25.057636929161333
Task_920,1182,729,128,153,281,1.6191780821917807,28.415555274954716
Task_921,2497,602,94,180,274,4.140961857379768,48.87657162660668
Task_922,2128,319,157,13,170,6.65,40.775134857324055
Task_923,1358,478,18,162,180,2.835073068893528,29.949910444420837
Task_924,1000,327,131,88,219,3.048780487804878,23.84927650822809
Task_925,1141,211,44,146,190,5.382075471698113,25.719456903119383
Task_926,2883,747,42,173,215,3.8542780748663104,55.18023400526592
Task_927,529,681,149,124,273,0.7756598240469208,17.858085360396675
Task_928,2195,107,158,79,237,20.324074074074073,41.37094011271355
Task_929,2598,285,57,168,225,9.083916083916083,49.24368667719628
Task_930,1876,329,57,114,171,5.684848484848485,37.59884141103267
Task_931,1511,890,67,57,124,1.6958473625140291,32.79136786927117
Task_932,2131,971,195,24,219,2.19238683127572,43.193301390646546
Task_933,1319,854,68,105,173,1.5426900584795322,30.43268479536353
Task_934,2991,960,83,77,160,3.1123829344432883,56.897993823230614
Task_935,2210,917,95,92,187,2.4074074074074074,44.73274336292645
Task_936,1722,476,199,161,360,3.610062893081761,36.553233716957614
Task_937,1158,475,74,18,92,2.4327731092436973,25.258115921362972
Task_938,1220,193,170,105,275,6.288659793814433,27.20772524756393
Task_939,1176,600,124,52,176,1.956738768718802,27.037719747877404
Task_940,1313,605,100,177,277,2.1666666666666665,30.134184236770867
Task_941,1573,896,105,75,180,1.7536231884057971,34.36687264177951
Task_942,1555,67,144,75,219,22.86764705882353,30.93945353759588
Task_943,2901,579,183,77,260,5.001724137931035,54.810273040301176
Task_944,1513,386,181,19,200,3.909560723514212,31.456144645595533
Task_945,2580,481,124,172,296,5.352697095435684,49.87910512764088
Task_946,2691,892,110,182,292,3.013437849944009,52.937337316779725
Task_947,2507,530,120,139,259,4.721280602636535,48.66662424431886
Task_948,2763,475,28,88,116,5.804621848739496,51.5614992241417
Task_949,1315,120,46,85,131,10.867768595041323,27.10400308151139
Task_950,2492,999,64,165,229,2.492,49.879328334986894
Task_951,865,784,162,111,273,1.1019108280254777,23.416359758569218
Task_952,1263,245,191,112,303,5.134146341463414,28.2090682571921
Task_953,1918,385,174,173,347,4.9689119170984455,39.32007708184806
Task_954,973,65,190,173,363,14.742424242424242,22.986487315126524
Task_955,2457,84,71,82,153,28.905882352941177,44.7769919243596
Task_956,2618,829,120,98,218,3.1542168674698794,51.13424967110291
Task_957,1591,726,160,175,335,2.1884456671251717,35.174297551038606
Task_958,2754,548,126,126,252,5.016393442622951,52.58483423575067
Task_959,1947,835,187,172,359,2.3289473684210527,41.258226501607105
Task_960,767,289,145,85,230,2.6448275862068966,20.0700279269571
Task_961,2056,887,32,199,231,2.315315315315315,42.607549068356846
Task_962,2180,395,45,179,224,5.505050505050505,42.98095321777091
Task_963,1830,164,180,71,251,11.090909090909092,36.1403834763034
Task_964,1074,886,162,69,231,1.2108229988726043,26.557356034722474
Task_965,1751,795,130,196,326,2.199748743718593,37.914588332406474
Task_966,642,1004,64,180,244,0.6388059701492538,20.74707243156907
Task_967,2148,956,116,66,182,2.2445141065830723,43.553971360821144
Task_968,2660,409,65,145,210,6.487804878048781,50.551389516097025
Task_969,504,414,50,171,221,1.2144578313253012,16.493562743440545
Task_970,1778,831,40,82,122,2.137019230769231,37.16815412797515
Task_971,2049,663,23,99,122,3.085843373493976,40.90167526299409
Task_972,1330,695,166,193,359,1.910919540229885,31.077700843896157
Task_973,2006,749,122,133,255,2.6746666666666665,41.398294618348935
Task_974,1520,670,42,71,113,2.2652757078986587,32.4206395491919
Task_975,1753,410,55,152,207,4.265206812652068,36.198506948262356
Task_976,703,999,178,31,209,0.703,20.8832326372408
Task_977,832,470,46,117,163,1.7664543524416136,21.45453552237771
Task_978,1249,700,126,106,232,1.781740370898716,29.096870481123528
Task_979,2204,268,116,114,230,8.193308550185874,42.8324227292365
Task_980,2857,874,40,182,222,3.265142857142857,55.20561865448286
Task_981,1853,638,155,88,243,2.899843505477308,38.447195625612245
Task_982,992,341,32,152,184,2.9005847953216373,23.72626816695031
Task_983,918,843,52,163,215,1.0876777251184835,24.286061788265545
Task_984,1145,818,68,119,187,1.398046398046398,27.655831552544722
Task_985,1232,819,46,148,194,1.502439024390244,29.09664880605091
Task_986,906,321,66,71,137,2.813664596273292,21.755766379838033
Task_987,1352,771,30,51,81,1.7512953367875648,29.415060517654393
Task_988,1468,816,157,147,304,1.7968176254589963,33.32536735165284
Task_989,1904,373,140,38,178,5.090909090909091,37.59107135233652
Task_990,516,829,114,46,160,0.6216867469879518,17.202609789460215
Task_991,1790,249,165,76,241,7.16,36.045301423517735
Task_992,2150,465,143,118,261,4.613733905579399,42.7836348994378
Task_993,2704,826,79,29,108,3.2696493349455866,51.02242150097231
Task_994,1420,85,10,85,95,16.511627906976745,27.87799706980221
Task_995,1065,184,175,153,328,5.756756756756757,24.966479538191795
Task_996,1233,437,103,172,275,2.815068493150685,28.321937209897925
Task_997,1555,883,91,145,236,1.759049773755656,34.58858375962344
Task_998,2959,384,92,151,243,7.685714285714286,55.294047899775904
Task_999,2118,967,153,37,190,2.18801652892562,42.918675626549174
Task_1000,1296,771,112,11,123,1.6787564766839378,28.61794646148258
Task_1001,1871,571,52,198,250,3.270979020979021,38.84479832622308
Task_1002,1533,213,173,74,247,7.163551401869159,31.875176627966074
Task_1003,726,564,130,35,165,1.2849557522123893,19.50621068218079
Task_1004,677,661,84,183,267,1.0226586102719033,20.094634760808265
Task_1005,2580,965,170,200,370,2.670807453416149,51.78440816998161
Task_1006,592,469,107,109,216,1.2595744680851064,17.857387182993133
Task_1007,2872,833,181,187,368,3.4436450839328536,55.97014166838019
Task_1008,1126,309,46,198,244,3.632258064516129,26.150241465679468
Task_1009,939,803,87,17,104,1.1679104477611941,22.87257141261335
Task_1010,1960,627,98,55,153,3.121019108280255,39.26890092469903
Task_1011,597,201,182,172,354,2.9554455445544554,17.861259829572464
Task_1012,822,549,117,72,189,1.4945454545454546,21.391152221292362
Task_1013,1059,223,125,45,170,4.727678571428571,23.645370907929472
Task_1014,528,789,146,165,311,0.6683544303797468,18.496421449248405
Task_1015,2359,229,30,139,169,10.256521739130434,44.859103527867404
Task_1016,2780,252,80,133,213,10.988142292490119,51.88070354997226
Task_1017,2260,471,64,77,141,4.788135593220339,43.77083043733338
Task_1018,2989,809,31,36,67,3.6901234567901233,54.88296296855182
Task_1019,2629,739,184,181,365,3.5527027027027027,51.802363601426975
Task_1020,2531,598,11,114,125,4.225375626043406,48.422991866630724
Task_1021,2720,750,131,71,202,3.621837549933422,52.1405738959049
Task_1022,2608,818,23,39,62,3.184371184371184,48.88594943876395
Task_1023,1860,453,35,20,55,4.096916299559472,35.77843958890864
Task_1024,2682,496,13,165,178,5.396378269617706,50.95434645464337
Task_1025,2538,418,72,67,139,6.05727923627685,47.85182333615044
Task_1026,764,199,170,90,260,3.82,19.924512864495057
Task_1027,1515,790,69,56,125,1.9152970922882426,32.60391105970016
Task_1028,664,596,51,16,67,1.1122278056951425,17.298603798700388
Task_1029,1638,321,157,135,292,5.086956521739131,34.37622172653024
Task_1030,2207,350,114,174,288,6.287749287749287,43.5115625576851
Task_1031,2752,428,124,66,190,6.414918414918415,51.51198199606264
Task_1032,2309,469,40,29,69,4.912765957446808,43.0551339187982
Task_1033,1673,538,62,38,100,3.103896103896104,33.644196517520754
Task_1034,2270,393,173,71,244,5.761421319796955,44.06000662191774
Task_1035,1024,959,132,103,235,1.0666666666666667,26.298106375897447
Task_1036,2570,177,113,163,276,14.438202247191011,48.2949679515101
Task_1037,2329,303,116,197,313,7.661184210526316,45.427043611485715
Task_1038,508,612,122,124,246,0.8287112561174551,17.159703845695166
Task_1039,2642,259,83,158,241,10.161538461538461,49.871384280648755
Task_1040,1007,176,79,66,145,5.6892655367231635,22.607262152491405
Task_1041,1211,691,53,180,233,1.75,28.651935251562183
Task_1042,1494,789,171,35,206,1.8911392405063292,32.53942119208502
Task_1043,569,598,124,167,291,0.9499165275459098,18.35823823963957
Task_1044,872,716,167,46,213,1.2161785216178522,22.507091016240043
Task_1045,2702,252,63,25,88,10.679841897233201,48.806849174205915
Task_1046,2207,567,15,182,197,3.88556338028169,43.801939567226064
Task_1047,504,785,22,97,119,0.6412213740458015,16.859109141452805
Task_1048,1889,955,137,173,310,1.9759414225941423,40.493415273225196
Task_1049,2447,374,147,40,187,6.525333333333333,46.21245111715987
Task_1050,1795,236,26,188,214,7.5738396624472575,36.277900896641086
Task_1051,2027,409,137,56,193,4.943902439024391,39.95192766889054
Task_1052,588,414,41,135,176,1.416867469879518,17.47310736748939
Task_1053,2915,88,115,30,145,32.752808988764045,51.47181630292487
Task_1054,640,610,56,43,99,1.0474631751227497,17.514591880281937
Task_1055,827,587,16,110,126,1.4064625850340136,21.38241516006131
Task_1056,786,178,40,101,141,4.391061452513966,19.06514403747394
Task_1057,1635,857,11,38,49,1.9055944055944056,33.57022880790686
Task_1058,1955,98,112,164,276,19.747474747474747,38.03751813479669
Task_1059,1832,946,22,44,66,1.9345300950369588,36.99615164442795
Task_1060,555,976,94,47,141,0.5680655066530195,18.189377771346972
Task_1061,2587,702,11,95,106,3.6799431009957324,49.331666022671214
Task_1062,2898,224,38,178,216,12.88,53.67267290103922
Task_1063,1749,993,89,110,199,1.7595573440643864,37.765812169415845
Task_1064,784,395,94,65,159,1.97979797979798,20.00832444100665
Task_1065,2342,267,170,152,322,8.738805970149254,45.48017553456386
Task_1066,920,881,172,42,214,1.0430839002267573,23.780266637216794
Task_1067,802,87,131,63,194,9.113636363636363,18.949087690190872
Task_1068,1679,922,144,75,219,1.819068255687974,36.33291317546646
Task_1069,1411,647,111,138,249,2.177469135802469,31.634366137323397
Task_1070,2324,841,26,48,74,2.7600950118764844,44.56488296355027
Task_1071,2217,643,60,72,132,3.4425465838509317,43.58330985825429
Task_1072,2299,356,192,26,218,6.439775910364146,43.92702831796348
Task_1073,2431,846,58,158,216,2.8701298701298703,48.36590060853612
Task_1074,1239,635,187,21,208,1.9481132075471699,27.947093857823006
Task_1075,1728,859,166,61,227,2.0093023255813955,36.77676595694371
Task_1076,1985,851,89,31,120,2.32981220657277,39.803859539620575
Task_1077,624,786,92,150,242,0.7928843710292249,19.571358871214418
Task_1078,1007,798,49,136,185,1.260325406758448,25.40705054072807
Task_1079,634,351,103,33,136,1.8011363636363635,17.078943820968046
Task_1080,1250,269,32,115,147,4.62962962962963,27.2080296395882
Task_1081,660,565,169,37,206,1.1660777385159011,18.651208425978336
Task_1082,1190,179,130,173,303,6.611111111111111,26.679080070458138
Task_1083,2217,457,33,131,164,4.8406113537117905,43.35989786501572
Task_1084,1015,627,86,195,281,1.6162420382165605,25.474661389992406
Task_1085,2871,686,67,180,247,4.179039301310044,55.00948447268053
Task_1086,2178,80,33,187,220,26.88888888888889,41.205652951757465
Task_1087,2518,244,14,127,141,10.277551020408163,47.11325772476272
Task_1088,2771,240,88,48,136,11.49792531120332,50.532700798462685
Task_1089,2927,813,190,47,237,3.595823095823096,55.4894487142478
Task_1090,599,159,70,45,115,3.74375,15.379857482004981
Task_1091,2792,465,54,193,247,5.991416309012876,53.06270951479371
Task_1092,1005,86,40,82,122,11.551724137931034,21.797738864890523
Task_1093,2941,622,81,149,230,4.720706260032102,55.77127279227896
Task_1094,2562,908,32,130,162,2.8184818481848186,50.153630425037626
Task_1095,2159,206,69,55,124,10.429951690821255,40.849493825561346
Task_1096,508,740,44,85,129,0.6855600539811066,17.14209350288364
Task_1097,619,458,153,100,253,1.3485838779956427,18.4183037164928
Task_1098,2853,976,162,92,254,2.9201637666325486,55.411915712027195
Task_1099,2738,506,111,40,151,5.400394477317554,50.96591321611894
Task_1100,2404,474,196,33,229,5.0610526315789475,46.05586901229165
Task_1101,1886,506,100,195,295,3.719921104536489,39.00214292333435
Task_1102,2180,1019,90,165,255,2.1372549019607843,45.0384974587541
Task_1103,794,978,31,10,41,0.8110316649642493,20.602948514879724
Task_1104,1476,571,53,46,99,2.5804195804195804,30.561565049717107
Task_1105,1130,606,33,194,227,1.8616144975288302,27.045063006652367
Task_1106,591,805,185,64,249,0.7332506203473945,18.8239393825708
Task_1107,1207,275,178,55,233,4.3731884057971016,26.721010832735455
Task_1108,1198,119,144,185,329,9.983333333333333,26.659950716585872
Task_1109,2015,473,195,95,290,4.251054852320675,40.78294285526653
Task_1110,1580,733,45,160,205,2.1525885558583107,34.44208303306914
Task_1111,1266,397,127,118,245,3.180904522613065,28.502260911743765
Task_1112,1479,215,132,48,180,6.847222222222222,30.377342705441688
Task_1113,2964,475,116,176,292,6.226890756302521,55.926028624315165
Task_1114,2613,101,42,108,150,25.61764705882353,47.37820021279808
Task_1115,1082,546,86,61,147,1.9780621572212065,25.12780901762436
Task_1116,558,378,142,116,258,1.4722955145118735,17.241708937345205
Task_1117,2772,911,25,152,177,3.039473684210526,53.68144106087675
Task_1118,1508,156,120,155,275,9.605095541401274,31.51050155549478
Task_1119,1693,493,131,182,313,3.4271255060728745,35.967327691763685
Task_1120,1095,670,56,149,205,1.631892697466468,26.57503780223355
Task_1121,2991,337,51,34,85,8.849112426035504,53.74182756728794
Task_1122,1949,92,190,142,332,20.956989247311828,38.155714530853665
Task_1123,578,656,85,141,226,0.8797564687975646,18.30500243405376
Task_1124,1800,331,192,113,305,5.421686746987952,36.99781709343437
Task_1125,2485,669,152,24,176,3.708955223880597,47.65140363272027
Task_1126,2532,867,190,127,317,2.9170506912442398,50.37184050735849
Task_1127,664,537,157,140,297,1.2342007434944238,19.616257659253943
Task_1128,2246,658,67,37,104,3.4081942336874054,43.204415330900396
Task_1129,834,863,11,189,200,0.9652777777777778,22.894557402914092
Task_1130,2644,985,171,54,225,2.6815415821501016,51.697773116413906
Task_1131,2618,508,37,164,201,5.143418467583497,50.15219852356651
Task_1132,2158,840,58,106,164,2.5659928656361473,43.66372144065374
Task_1133,998,631,138,65,203,1.5791139240506329,24.450515590257506
Task_1134,2093,795,73,192,265,2.629396984924623,43.112040352327064
Task_1135,1399,568,193,31,224,2.4586994727592266,30.425427144185466
Task_1136,2809,966,152,126,278,2.904860392967942,54.893246776264526
Task_1137,2876,886,138,160,298,3.2423900789177003,55.84468547323005
Task_1138,2724,389,85,18,103,6.984615384615385,49.813982988691784
Task_1139,1945,978,180,63,243,1.9867211440245147,40.70659296466996
Task_1140,1872,827,176,15,191,2.260869565217391,38.47178749248345
Task_1141,694,354,105,42,147,1.9549295774647888,18.137705067766642
Task_1142,1516,250,11,178,189,6.039840637450199,31.763634987481492
Task_1143,2440,759,21,15,36,3.210526315789474,45.702347401517535
Task_1144,1805,442,85,159,244,4.074492099322799,37.23823745358417
Task_1145,892,750,50,90,140,1.1877496671105192,23.061021941222776
Task_1146,850,1023,145,154,299,0.830078125,24.131605078671214
Task_1147,2506,461,24,191,215,5.424242424242424,48.29285869549563
Task_1148,617,346,38,44,82,1.7780979827089338,16.242624169885108
Task_1149,871,228,138,111,249,3.8034934497816595,21.71468219142099
Task_1150,2944,823,69,86,155,3.5728155339805827,55.862660083894006
Task_1151,2340,421,107,65,172,5.545023696682464,44.872033862254995
Task_1152,2657,331,69,38,107,8.00301204819277,48.704771261644915
Task_1153,2827,821,121,28,149,3.4391727493917275,53.406265835136175
Task_1154,1672,912,67,112,179,1.8313253012048192,36.29007757612245
Task_1155,2568,70,12,86,98,36.16901408450704,45.74504083425788
Task_1156,705,365,159,38,197,1.9262295081967213,18.693321020444223
Task_1157,519,644,176,54,230,0.8046511627906977,17.03248516311764
Task_1158,1224,759,76,120,196,1.6105263157894736,28.80965887990536
Task_1159,861,577,49,13,62,1.4896193771626298,20.278202327799068
Task_1160,2017,976,94,22,116,2.0644831115660183,40.6657193991416
Task_1161,681,665,150,84,234,1.0225225225225225,19.847461122171527
Task_1162,2367,277,116,160,276,8.514388489208633,45.71543465176961
Task_1163,2611,434,153,48,201,6.002298850574713,49.120291881153655
Task_1164,2144,699,189,134,323,3.0628571428571427,43.735420069573344
Task_1165,1961,341,21,83,104,5.733918128654971,38.238027336484855
Task_1166,730,767,184,77,261,0.9505208333333334,21.043349059172332
Task_1167,1663,797,165,61,226,2.0839598997493733,35.54932636764086
Task_1168,1640,183,62,159,221,8.91304347826087,33.60839148659876
Task_1169,545,129,111,76,187,4.1923076923076925,15.32936804503369
Task_1170,2877,490,78,60,138,5.8594704684317716,53.34975226997678
Task_1171,950,474,192,73,265,2.0,23.53934678112763
Task_1172,1989,348,104,200,304,5.699140401146132,40.16682114480282
Task_1173,2895,670,153,25,178,4.3144560357675115,54.167244657183204
Task_1174,2128,314,162,155,317,6.7555555555555555,42.24317540046109
Task_1175,1500,876,37,39,76,1.710376282782212,31.53838657610994
Task_1176,855,175,40,112,152,4.857954545454546,20.22811526821977
Task_1177,2247,119,22,189,211,18.725,42.58332376828826
Task_1178,2329,171,70,18,88,13.540697674418604,42.58030549855986
Task_1179,2141,166,103,196,299,12.820359281437126,41.676360263652434
Task_1180,520,1023,25,118,143,0.5078125,18.113411715281142
Task_1181,1782,337,75,39,114,5.272189349112426,34.96360618674112
Task_1182,1587,522,54,85,139,3.0344168260038242,33.35396044114213
Task_1183,934,82,119,139,258,11.25301204819277,21.83953900597952
Task_1184,2073,626,170,100,270,3.3062200956937797,42.09210987013425
Task_1185,1137,259,131,128,259,4.373076923076923,26.09054116043994
Task_1186,1648,482,49,119,168,3.412008281573499,34.52192135380684
Task_1187,610,701,114,73,187,0.8689458689458689,18.520171519224274
Task_1188,1733,843,182,24,206,2.0533175355450237,36.429860253643454
Task_1189,1649,442,155,15,170,3.7223476297968396,33.590242200625276
Task_1190,2425,962,190,94,284,2.518172377985462,48.76922580741776
Task_1191,1539,239,127,13,140,6.4125,30.962021344274735
Task_1192,1877,388,130,194,324,4.825192802056555,38.60831384696342
Task_1193,2007,474,168,160,328,4.225263157894737,40.9125948667982
Task_1194,2371,372,50,185,235,6.35656836461126,46.05505860391575
Task_1195,2055,816,119,147,266,2.515299877600979,42.45423397316146
Task_1196,643,883,130,177,307,0.7273755656108597,20.54930965931487
Task_1197,2230,261,109,109,218,8.511450381679388,43.156903479193055
Task_1198,1699,968,113,160,273,1.7533539731682146,37.32372935977475
Task_1199,2109,927,131,157,288,2.2726293103448274,43.76983198087711
Task_1200,2681,571,147,102,249,4.687062937062937,51.454069226063744
Task_1201,2612,888,143,69,212,2.938132733408324,50.86253681600301
Task_1202,1639,844,186,194,380,1.9396449704142011,36.53319909528865
Task_1203,2604,842,98,194,292,3.088967971530249,51.4241464923731
Task_1204,2420,449,164,12,176,5.377777777777778,45.88406789448643
Task_1205,537,72,133,110,243,7.3561643835616435,15.513517061595692
Task_1206,1738,458,71,104,175,3.786492374727669,35.86515026968981
Task_1207,1379,173,25,48,73,7.925287356321839,27.448827412859416
Task_1208,2445,721,140,102,242,3.386426592797784,48.16069845633208
Task_1209,1864,473,134,30,164,3.932489451476793,37.2166345729812
Task_1210,892,243,166,135,301,3.6557377049180326,22.365807291951928
Task_1211,704,949,187,175,362,0.7410526315789474,21.876582967800413
Task_1212,817,617,158,63,221,1.3220064724919094,21.60733084624842
Task_1213,2255,802,182,38,220,2.808219178082192,44.714358491373865
Task_1214,1613,621,124,163,287,2.5932475884244375,34.96005462137574
Task_1215,2241,457,164,28,192,4.893013100436681,43.246319203950414
Task_1216,2461,361,26,64,90,6.798342541436464,45.860405326264214
Task_1217,2614,360,191,24,215,7.240997229916897,48.87841417447695
Task_1218,743,342,71,153,224,2.1661807580174925,20.06945976165495
Task_1219,1802,522,39,97,136,3.445506692160612,36.73993160048432
Task_1220,934,78,79,150,229,11.822784810126583,21.7885654368947
Task_1221,1560,743,116,147,263,2.096774193548387,34.37072334564796
Task_1222,1060,277,63,60,123,3.8129496402877696,23.65817232248192
Task_1223,2464,389,67,177,244,6.317948717948718,47.58833733435794
Task_1224,708,991,32,57,89,0.7137096774193549,20.243737493111617
Task_1225,1584,410,185,10,195,3.854014598540146,32.62039816842679
Task_1226,2060,599,115,96,211,3.433333333333333,41.55738356053218
Task_1227,737,91,14,189,203,8.01086956521739,18.59010153245366
Task_1228,1290,365,168,74,242,3.5245901639344264,28.522747349972462
Task_1229,1794,834,72,180,252,2.148502994011976,38.420402152379445
Task_1230,1821,908,52,21,73,2.0033003300330035,36.600993543824565
Task_1231,1934,828,198,146,344,2.332931242460796,40.92470034194266
Task_1232,775,163,18,45,63,4.725609756097561,17.794083563565962
Task_1233,1426,385,34,138,172,3.694300518134715,30.679232450743935
Task_1234,720,447,199,12,211,1.6071428571428572,19.12610501692347
Task_1235,1921,149,69,45,114,12.806666666666667,36.09621753305036
Task_1236,2713,498,150,134,284,5.43687374749499,51.93002194442588
Task_1237,2018,864,151,24,175,2.3329479768786126,40.86035604650015
Task_1238,1454,152,117,23,140,9.50326797385621,29.084718717955354
Task_1239,1373,425,84,85,169,3.223004694835681,29.79250605147605
Task_1240,1339,321,147,142,289,4.158385093167702,29.64461284606796
Task_1241,2404,149,43,164,207,16.026666666666667,45.26690360451931
Task_1242,1076,756,127,27,154,1.4214002642007926,25.403933349980367
Task_1243,2250,295,108,136,244,7.601351351351352,43.749815764227954
Task_1244,1549,271,76,71,147,5.694852941176471,31.805019103630087
Task_1245,1955,240,39,117,156,8.112033195020746,38.29526989384042
Task_1246,2065,970,168,118,286,2.126673532440783,43.14022747102359
Task_1247,2575,259,54,168,222,9.903846153846153,48.77602502192398
Task_1248,1217,158,170,167,337,7.654088050314465,27.230058874475265
Task_1249,1209,256,45,36,81,4.7042801556420235,25.345401744415344
Task_1250,587,78,173,23,196,7.430379746835443,15.227612678829104
Task_1251,1783,392,107,68,175,4.536895674300254,35.974296486025544
Task_1252,2176,167,98,28,126,12.952380952380953,40.53950491113972
Task_1253,2809,101,152,92,244,27.53921568627451,51.15985743651765
Task_1254,1490,883,93,71,164,1.6855203619909502,32.92805065682148
Task_1255,2656,402,180,70,250,6.590570719602978,50.18765245532895
Task_1256,2492,530,108,110,218,4.6930320150659135,48.20182663073454
Task_1257,1904,277,118,130,248,6.848920863309353,38.227018308339076
Task_1258,676,588,72,92,164,1.1477079796264855,19.290717885708265
Task_1259,2174,540,90,10,100,4.018484288354898,41.611808055894805
Task_1260,1354,452,89,56,145,2.988962472406181,29.173392793704423
Task_1261,1447,363,29,43,72,3.9752747252747254,29.097290846263544
Task_1262,1918,356,196,133,329,5.372549019607843,39.08477128328653
Task_1263,2280,355,50,36,86,6.404494382022472,42.57293765306258
Task_1264,1695,565,87,148,235,2.9946996466431095,35.78617038233665
Task_1265,1495,988,114,58,172,1.5116279069767442,33.205123227057896
Task_1266,1245,211,97,86,183,5.872641509433962,27.13318525157543
Task_1267,2852,148,111,179,290,19.140939597315437,52.75710014921066
Task_1268,1877,1021,116,81,197,1.8365949119373777,39.7599424993427
Task_1269,2990,368,129,87,216,8.102981029810298,55.4454672677808
Task_1270,951,393,200,29,229,2.4137055837563453,22.797267023746
Task_1271,2923,909,30,45,75,3.2120879120879122,54.176574810682695
Task_1272,1551,116,130,64,194,13.256410256410257,31.001935974102732
Task_1273,2629,463,104,62,166,5.665948275862069,49.54557279435787
Task_1274,1399,373,58,161,219,3.7406417112299466,30.545052651241534
Task_1275,2447,719,146,135,281,3.3986111111111112,48.410231545499045
Task_1276,535,1005,189,54,243,0.5318091451292246,18.682927687312624
Task_1277,1754,338,87,199,286,5.174041297935103,36.29425900972902
Task_1278,2609,949,66,60,126,2.7463157894736843,50.5167273221235
Task_1279,610,750,26,135,161,0.8122503328894807,18.64190206198219
Task_1280,802,575,26,162,188,1.3923611111111112,21.4452582194311
Task_1281,929,149,67,141,208,6.193333333333333,22.106267675135353
Task_1282,1363,307,147,62,209,4.425324675324675,29.18032586441807
Task_1283,3000,853,128,93,221,3.51288056206089,57.244238730645485
Task_1284,2924,144,117,143,260,20.16551724137931,53.66597573731409
Task_1285,587,388,29,177,206,1.5089974293059125,17.604855277433103
Task_1286,778,574,39,67,106,1.3530434782608696,20.097160092182687
Task_1287,1177,847,145,129,274,1.3879716981132075,28.59560262567807
Task_1288,2092,391,16,125,141,5.336734693877551,40.875042127115954
Task_1289,1948,216,107,143,250,8.976958525345623,38.73194464732739
Task_1290,583,99,101,144,245,5.83,16.347358636508066
Task_1291,1891,292,115,42,157,6.453924914675768,36.884552541639486
Task_1292,2528,243,93,59,152,10.360655737704919,47.01885181937328
Task_1293,1077,302,142,129,271,3.5544554455445545,25.339457993338687
Task_1294,2590,878,23,18,41,2.9465301478953356,48.53391122935708
Task_1295,2030,634,116,118,234,3.1968503937007875,41.300467878975255
Task_1296,2911,642,26,12,38,4.527216174183515,52.82395202297832
Task_1297,2763,562,60,166,226,4.907637655417407,52.783196355527686
Task_1298,2022,117,169,196,365,17.135593220338983,39.76720036131014
Task_1299,1543,950,62,135,197,1.622502628811777,34.483778113138776
Task_1300,1651,596,74,171,245,2.765494137353434,35.36623611653385
Task_1301,2141,172,36,35,71,12.375722543352602,39.41155176066294
Task_1302,1759,644,87,38,125,2.727131782945736,35.704520125497716
Task_1303,2903,228,69,16,85,12.676855895196507,51.95021927601305
Task_1304,2118,344,124,187,311,6.139130434782609,42.20638237483532
Task_1305,685,958,154,94,248,0.7142857142857143,21.088860930445037
Task_1306,2640,625,163,77,240,4.217252396166134,50.73376923545823
Task_1307,1875,961,96,187,283,1.949064449064449,40.196737704709946
Task_1308,1659,869,162,80,242,1.9068965517241379,36.039346196384905
Task_1309,2002,149,200,76,276,13.346666666666666,38.89928502297932
Task_1310,1849,419,121,106,227,4.402380952380953,37.69996710857887
Task_1311,629,363,123,112,235,1.728021978021978,18.248692952883427
Task_1312,2023,806,20,149,169,2.506815365551425,41.422325029491184
Task_1313,1603,572,104,126,230,2.7975567190226878,34.33637285764285
Task_1314,2583,516,110,137,247,4.996131528046422,49.76779486734853
Task_1315,502,227,101,87,188,2.2017543859649122,15.493536078024498
Task_1316,2524,554,180,159,339,4.5477477477477475,49.4027172787051
Task_1317,1022,412,167,58,225,2.4745762711864407,24.198189022217367
Task_1318,1981,384,72,11,83,5.1454545454545455,37.92179938416012
Task_1319,2907,664,33,134,167,4.371428571428571,54.9670067979745
Task_1320,1035,886,197,109,306,1.1668545659526495,26.56635459312462
Task_1321,2973,343,138,129,267,8.642441860465116,55.44323067608474
Task_1322,545,179,118,123,241,3.0277777777777777,16.15127688295308
Task_1323,706,650,170,131,301,1.0844854070660521,20.634005371196523
Task_1324,1697,499,146,161,307,3.394,35.99192665929536
Task_1325,2943,415,14,185,199,7.074519230769231,54.97267722374041
Task_1326,2495,905,87,34,121,2.753863134657837,48.07497734655041
Task_1327,1075,717,156,150,306,1.4972144846796658,26.76223826167457
Task_1328,1879,180,20,34,54,10.38121546961326,35.28925838060248
Task_1329,1398,214,195,86,281,6.502325581395349,30.030068081049862
Task_1330,2834,1014,135,12,147,2.7921182266009854,54.024367475293786
Task_1331,2137,612,199,116,315,3.4861337683523654,43.287710944735295
Task_1332,2304,319,116,176,292,7.2,44.96151011236443
Task_1333,1979,587,116,115,231,3.3656462585034013,40.326344608367194
Task_1334,531,954,48,139,187,0.556020942408377,18.476513607872665
Task_1335,1897,335,26,110,136,5.645833333333333,37.561991151001756
Task_1336,2881,909,19,160,179,3.165934065934066,55.422552665593095
Task_1337,2382,763,82,127,209,3.1178010471204187,47.22469494792889
Task_1338,1115,882,156,55,211,1.2627406568516422,27.070558458234572
Task_1339,1788,1017,125,126,251,1.756385068762279,38.73716859302289
Task_1340,635,534,149,134,283,1.1869158878504673,19.08062472007467
Task_1341,810,748,173,143,316,1.081441922563418,22.67037086680536
Task_1342,575,505,93,118,211,1.1363636363636365,17.713828285309813
Task_1343,829,158,165,194,359,5.213836477987422,21.252458635514802
Task_1344,2308,962,188,200,388,2.3966770508826585,47.54595106589102
Task_1345,2179,318,31,79,110,6.830721003134796,41.723402598213575
Task_1346,1366,286,114,75,189,4.7595818815331015,29.22539775294747
Task_1347,2714,554,41,106,147,4.89009009009009,51.30478803589639
Task_1348,2976,664,145,90,235,4.475187969924812,56.31051263649234
Task_1349,1947,831,161,183,344,2.340144230769231,41.1942673616319
Task_1350,2430,833,180,17,197,2.9136690647482015,47.36623871613068
Task_1351,1826,223,44,22,66,8.151785714285714,34.51065919812001
Task_1352,796,119,157,93,250,6.633333333333334,19.81039788834185
Task_1353,1785,546,91,66,157,3.263254113345521,36.292339290460255
Task_1354,1503,368,29,38,67,4.073170731707317,29.9541187900262
Task_1355,510,869,183,25,208,0.5862068965517241,17.475532296960363
Task_1356,1733,171,116,170,286,10.075581395348838,35.171029736264465
Task_1357,2457,333,131,184,315,7.3562874251497,47.5444993877148
Task_1358,1639,740,152,111,263,2.211875843454791,35.560071486243324
Task_1359,1108,738,30,32,62,1.4993234100135318,24.873990759344366
Task_1360,1825,682,185,80,265,2.67203513909224,38.189076111899205
Task_1361,562,845,114,78,192,0.6643026004728132,18.478380732365896
Task_1362,2713,763,67,156,223,3.5510471204188483,52.60651111843429
Task_1363,2538,968,91,20,111,2.6191950464396285,48.839008828755965
Task_1364,897,210,22,147,169,4.251184834123222,21.69407831063044
Task_1365,2105,659,12,18,30,3.1893939393939394,40.0553624835274
Task_1366,2339,668,149,73,222,3.4962630792227203,45.95200972384524
Task_1367,2476,608,67,110,177,4.06568144499179,48.06168986274297
Task_1368,2765,888,152,192,344,3.1102362204724407,54.34638313825334
Task_1369,1978,728,185,189,374,2.713305898491084,41.50737578562394
Task_1370,1965,522,36,135,171,3.75717017208413,39.61709165817157
Task_1371,2409,980,12,199,211,2.45565749235474,48.367363904772255
Task_1372,805,823,183,194,377,0.9769417475728155,23.20690195244718
Task_1373,2339,177,94,142,236,13.140449438202246,44.46471036325419
Task_1374,2569,964,90,37,127,2.6621761658031087,49.61458703412925
Task_1375,1592,523,45,198,243,3.0381679389312977,34.19962490114012
Task_1376,1492,994,132,77,209,1.499497487437186,33.532398736970016
Task_1377,1488,885,56,139,195,1.6794582392776525,33.40984695308097
Task_1378,728,653,84,170,254,1.1131498470948011,20.81956609913799
Task_1379,2219,178,122,70,192,12.396648044692737,42.026901418674846
Task_1380,2226,741,133,90,223,3.0,44.61938316779282
Task_1381,1179,644,140,186,326,1.827906976744186,28.367887627763945
Task_1382,2004,363,138,82,220,5.5054945054945055,39.83121525300919
Task_1383,1796,589,199,82,281,3.0440677966101695,37.54049171617712
Task_1384,1074,699,131,179,310,1.5342857142857143,26.750973341015293
Task_1385,1540,336,90,167,257,4.56973293768546,32.759449789769285
Task_1386,2364,775,117,17,134,3.0463917525773194,45.72069435051608
Task_1387,2552,946,87,121,208,2.6948257655755015,50.39575770319613
Task_1388,2265,696,47,110,157,3.249641319942611,44.70785361482468
Task_1389,1467,792,180,162,342,1.849936948297604,33.428114848296154
Task_1390,2146,249,52,16,68,8.584,39.53446815862527
Task_1391,1394,594,46,114,160,2.342857142857143,30.602197033645748
Task_1392,2515,433,22,98,120,5.7949308755760365,47.508281698542454
Task_1393,1207,485,32,145,177,2.483539094650206,27.556378694192503
Task_1394,726,576,89,19,108,1.2582322357019065,18.86904123826425
Task_1395,2704,694,39,31,70,3.8906474820143884,50.02996514900767
Task_1396,2078,328,53,171,224,6.316109422492401,41.17635463858286
Task_1397,2503,905,15,18,33,2.7626931567328916,47.136213923353466
Task_1398,1445,911,146,58,204,1.5844298245614035,32.34634104357066
Task_1399,2487,539,75,65,140,4.605555555555555,47.45570974126537
Task_1400,562,970,63,129,192,0.5787847579814624,19.084548541716604
Task_1401,2959,778,122,196,318,3.798459563543004,56.96330737519503
Task_1402,2434,681,148,124,272,3.56891495601173,48.02777919262146
Task_1403,1203,726,93,118,211,1.65474552957359,28.41055269620804
Task_1404,1410,988,59,14,73,1.4256825075834176,30.199825657491818
Task_1405,2568,284,68,120,188,9.010526315789473,48.521950016494735
Task_1406,2872,547,153,84,237,5.240875912408759,54.24625771147499
Task_1407,1267,64,24,26,50,19.49230769230769,24.19083518359982
Task_1408,2600,456,160,157,317,5.689277899343545,50.1868353440226
Task_1409,1537,296,151,157,308,5.175084175084175,32.80017119114408
Task_1410,2860,475,165,179,344,6.008403361344538,54.51850545555609
Task_1411,1545,651,56,101,157,2.3696319018404908,33.17782024346144
Task_1412,2444,172,150,118,268,14.127167630057803,46.22002946015029
Task_1413,2313,515,42,185,227,4.482558139534884,45.48673682675389
Task_1414,1416,607,108,78,186,2.3289473684210527,31.063375071676745
Task_1415,2343,483,71,143,214,4.840909090909091,45.78168948713935
Task_1416,579,379,112,138,250,1.5236842105263158,17.584403431792175
Task_1417,2498,409,77,57,134,6.092682926829268,47.06119841736123
Task_1418,782,397,35,60,95,1.964824120603015,19.343918693172
Task_1419,709,242,15,50,65,2.9176954732510287,17.142715938271667
Task_1420,2968,816,148,125,273,3.6328029375764994,56.918650192052745
Task_1421,1534,712,61,30,91,2.1514726507713884,31.894446417489686
Task_1422,1544,653,95,52,147,2.36085626911315,32.84695206672912
Task_1423,2061,701,135,130,265,2.9358974358974357,42.15968629847087
Task_1424,1048,1001,89,84,173,1.0459081836327346,26.328497716199433
Task_1425,2845,659,38,143,181,4.3106060606060606,54.05783749337602
Task_1426,1757,886,32,147,179,1.9808342728297632,37.53401306054203
Task_1427,2924,774,89,162,251,3.7729032258064517,56.023370855281335
Task_1428,1356,638,40,45,85,2.1220657276995305,28.861120710479977
Task_1429,1819,816,127,30,157,2.226438188494492,37.431522061176935
Task_1430,2086,794,110,57,167,2.6238993710691823,41.97846575946536
Task_1431,830,597,198,101,299,1.3879598662207357,22.393993975695107
Task_1432,720,667,52,126,178,1.0778443113772456,20.36064944696879
Task_1433,1316,662,122,39,161,1.9849170437405732,29.025448639404065
Task_1434,2654,447,70,170,240,5.924107142857143,50.756505209535256
Task_1435,1163,465,196,36,232,2.495708154506438,26.396171201927896
Task_1436,877,881,32,45,77,0.9943310657596371,21.82314560832383
Task_1437,2587,172,82,162,244,14.953757225433526,48.49293578648304
Task_1438,1071,720,174,58,232,1.4854368932038835,25.954012885432633
Task_1439,1950,637,100,119,219,3.0564263322884013,39.97674320833166
Task_1440,2623,150,52,30,82,17.370860927152318,47.03473261923312
Task_1441,792,687,166,107,273,1.1511627906976745,21.948431952170267
Task_1442,2403,89,153,184,337,26.7,45.351655313700284
Task_1443,1433,440,129,155,284,3.249433106575964,31.512522416583153
Task_1444,802,381,34,66,100,2.099476439790576,19.812546697804663
Task_1445,2996,324,136,21,157,9.218461538461538,54.41047612701329
Task_1446,2998,185,63,47,110,16.118279569892472,53.46256060926988
Task_1447,1936,361,152,35,187,5.348066298342541,38.0809614694381
Task_1448,2807,156,156,100,256,17.878980891719745,51.819715405740936
Task_1449,2829,575,145,28,173,4.911458333333333,52.83193985714192
Task_1450,1434,582,143,13,156,2.4596912521440824,30.50674316829367
Task_1451,2286,590,54,139,193,3.8680203045685277,45.13146772317898
Task_1452,1839,609,101,27,128,3.0147540983606556,37.03274723402628
Task_1453,2221,518,159,104,263,4.279383429672447,44.06664545992919
Task_1454,1051,681,160,51,211,1.5410557184750733,25.42183728883928
Task_1455,2375,514,155,79,234,4.611650485436893,46.222420820124995
Task_1456,2632,176,134,188,322,14.870056497175142,49.51255757558723
Task_1457,1831,849,91,82,173,2.1541176470588237,38.38332734840872
Task_1458,2281,533,154,48,202,4.271535580524344,44.221802103134756
Task_1459,2097,822,54,63,117,2.547995139732685,41.89491713236244
Task_1460,888,469,30,32,62,1.8893617021276596,20.54081279223384
Task_1461,641,1001,72,198,270,0.6397205588822356,20.8759512222167
Task_1462,1755,324,112,156,268,5.4,36.159077922774415
Task_1463,743,1011,82,174,256,0.7341897233201581,22.302955143221595
Task_1464,1609,644,143,128,271,2.4945736434108525,34.84547256409142
Task_1465,1336,611,63,141,204,2.183006535947712,30.202558490213093
Task_1466,1414,101,147,49,196,13.862745098039216,28.50335542678123
Task_1467,1593,801,62,150,212,1.986284289276808,34.91597024788245
Task_1468,2600,566,112,56,168,4.585537918871252,49.38324904075953
Task_1469,1874,1017,23,115,138,1.8408644400785854,39.3698561746815
Task_1470,2082,682,142,44,186,3.048316251830161,41.41767591492313
Task_1471,2770,259,143,53,196,10.653846153846153,51.2497677923758
Task_1472,801,189,48,34,82,4.21578947368421,18.79498660999784
Task_1473,2447,635,46,188,234,3.84748427672956,48.04443668115558
Task_1474,2241,986,75,51,126,2.270516717325228,44.741674285739
Task_1475,1640,709,200,36,236,2.3098591549295775,34.73407372352821
Task_1476,2758,226,76,85,161,12.14977973568282,50.9545670847126
Task_1477,696,466,108,89,197,1.4903640256959314,19.35923295624819
Task_1478,1476,186,146,171,317,7.893048128342246,31.550530865738825
Task_1479,1273,658,150,180,330,1.9317147192716237,29.909642760664706
Task_1480,1823,1002,67,162,229,1.8175473579262214,39.286803338401135
Task_1481,1880,303,90,194,284,6.184210526315789,38.18715389037358
Task_1482,1801,687,76,195,271,2.6177325581395348,38.18658786653809
Task_1483,1278,595,139,147,286,2.1442953020134228,29.54517174408424
Task_1484,986,204,167,115,282,4.809756097560975,23.603844235664155
Task_1485,1865,440,68,116,184,4.229024943310658,37.87731593208894
Task_1486,1348,653,189,25,214,2.0611620795107033,29.783841430069383
Task_1487,1520,831,175,158,333,1.8269230769230769,34.34271883301158
Task_1488,1364,658,172,188,360,2.069802731411229,31.49792009376291
Task_1489,2149,798,101,170,271,2.6896120150187737,43.94348329926902
Task_1490,1151,861,68,76,144,1.3352668213457077,27.43150227803085
Task_1491,1019,269,123,151,274,3.774074074074074,24.360241065212335
Task_1492,2753,421,121,113,234,6.523696682464455,52.05447571103415
Task_1493,2282,907,20,122,142,2.513215859030837,45.527363219890645
Task_1494,1985,236,187,23,210,8.375527426160337,38.483176130410726
Task_1495,574,129,95,26,121,4.415384615384616,14.984629822031858
Task_1496,1308,948,70,145,215,1.3782929399367756,30.818696441820233
Task_1497,1372,336,85,167,252,4.071216617210682,30.09149639564873
Task_1498,1963,246,11,73,84,7.947368421052632,37.561490906937216
Task_1499,1378,239,190,149,339,5.741666666666666,30.221761976440934
Task_1500,709,520,123,141,264,1.3608445297504799,20.14611662977055
Task_1501,1572,359,182,14,196,4.366666666666666,32.26156754488626
Task_1502,1925,607,57,93,150,3.1661184210526314,39.034386196400895
Task_1503,668,806,182,139,321,0.8277571251548946,20.654414999213664
Task_1504,1914,941,197,150,347,2.031847133757962,40.9790941035519
Task_1505,2717,881,136,51,187,3.080498866213152,52.32007836728696
Task_1506,1772,824,49,25,74,2.147878787878788,35.633571888121004
Task_1507,1694,896,54,42,96,1.8885172798216276,35.06123037508039
Task_1508,2834,255,44,118,162,11.0703125,52.330898772978365
Task_1509,1014,202,116,151,267,4.995073891625616,24.02409959221728
Task_1510,2258,308,50,145,195,7.307443365695793,43.81184787806574
Task_1511,1556,679,116,24,140,2.288235294117647,32.67911786380193
Task_1512,549,432,169,86,255,1.2678983833718245,17.14117276301468
Task_1513,958,546,41,71,112,1.7513711151736746,23.01818592749059
Task_1514,2956,144,125,79,204,20.386206896551723,53.64092632266891
Task_1515,1663,986,130,132,262,1.6849037487335359,36.718482185405094
Task_1516,2395,769,196,25,221,3.1103896103896105,46.76394415004139
Task_1517,863,903,178,21,199,0.9546460176991151,22.91389755860457
Task_1518,864,555,195,70,265,1.5539568345323742,22.362336621752025
Task_1519,1885,978,141,71,212,1.9254341164453523,39.66813763524317
Task_1520,1014,265,49,44,93,3.81203007518797,22.31614635186649
Task_1521,1189,952,155,118,273,1.2476390346274921,29.079887041580097
Task_1522,2885,738,20,105,125,3.903924221921516,54.47588785432657
Task_1523,656,886,28,129,157,0.7395715896279594,19.803231943653255
Task_1524,2240,904,23,170,193,2.4751381215469612,45.35227128380675
Task_1525,1056,215,25,41,66,4.888888888888889,22.39489779211552
Task_1526,1620,643,43,28,71,2.515527950310559,32.72734906552569
Task_1527,2074,567,48,18,66,3.6514084507042255,39.46911582156158
Task_1528,899,133,173,175,348,6.708955223880597,22.112110631362157
Task_1529,2134,850,13,127,140,2.5076380728554644,42.99204222470803
Task_1530,2769,996,110,39,149,2.777331995987964,53.04337261545407
Task_1531,2283,211,197,28,225,10.768867924528301,43.21221946786138
Task_1532,875,175,100,72,172,4.971590909090909,20.698850853010878
Task_1533,2780,560,104,133,237,4.955436720142602,52.97778654288263
Task_1534,1010,406,44,41,85,2.481572481572482,22.697436637760138
Task_1535,1176,763,186,111,297,1.5392670157068062,28.40745246125898
Task_1536,2043,453,101,178,279,4.5,41.220284862895966
Task_1537,1612,388,164,177,341,4.143958868894601,34.46710477410263
Task_1538,2691,729,137,32,169,3.686301369863014,51.10707549680339
Task_1539,1698,703,59,75,134,2.4119318181818183,35.57233383534789
Task_1540,2904,233,109,116,225,12.41025641025641,53.7427256455378
Task_1541,931,771,147,83,230,1.205958549222798,24.123108981472644
Task_1542,2202,818,132,42,174,2.688644688644689,43.698399569209606
Task_1543,2774,588,154,166,320,4.709677419354839,53.39505260224731
Task_1544,1539,441,14,36,50,3.481900452488688,30.747649324802694
Task_1545,1617,820,158,127,285,1.9695493300852618,35.583550336828054
Task_1546,2840,850,143,43,186,3.337250293772033,53.95973106107821
Task_1547,675,834,132,35,167,0.8083832335329342,19.56345644085886
Task_1548,1228,73,182,139,321,16.594594594594593,26.723845929851688
Task_1549,2458,239,138,106,244,10.241666666666667,46.791500572534595
Task_1550,1563,283,137,89,226,5.503521126760563,32.65561964177081
Task_1551,2345,313,23,174,197,7.468152866242038,45.14556026166648
Task_1552,804,204,190,180,370,3.921951219512195,21.222703044732874
Task_1553,529,546,69,56,125,0.9670932358318098,16.284141947147287
Task_1554,929,810,67,115,182,1.1454993834771887,24.12812253443376
Task_1555,2937,121,187,111,298,24.07377049180328,53.789675956100496
Task_1556,1120,954,164,86,250,1.1727748691099475,27.781810676972245
Task_1557,567,722,109,82,191,0.7842323651452282,18.087250530070868
Task_1558,2615,697,196,151,347,3.7464183381088825,51.322962462433
Task_1559,1168,946,25,118,143,1.2333685322069694,27.94329539378361
Task_1560,2725,268,91,48,139,10.130111524163569,49.95293463129116
Task_1561,2463,214,137,166,303,11.455813953488372,47.128683227750436
Task_1562,811,353,173,53,226,2.290960451977401,20.730569549915966
Task_1563,2215,500,148,195,343,4.421157684630739,44.407840949817945
Task_1564,1069,785,76,190,266,1.3600508905852418,26.81173874227701
Task_1565,2321,747,113,132,245,3.1029411764705883,46.33563746812961
Task_1566,2418,825,65,56,121,2.927360774818402,46.877719720672125
Task_1567,1703,952,22,163,185,1.7869884575026234,36.910635292222985
Task_1568,1869,521,76,120,196,3.5804597701149423,38.2916043292982
Task_1569,1226,791,17,51,68,1.547979797979798,27.094092302325787
Task_1570,2274,957,143,129,272,2.373695198329854,46.36470295064737
Task_1571,596,852,97,177,274,0.6987104337631888,19.609675654265175
Task_1572,2965,515,81,85,166,5.746124031007752,55.367256494446366
Task_1573,2112,541,102,10,112,3.896678966789668,40.73394365621915
Task_1574,2915,832,17,121,138,3.4993997599039615,55.2674827100465
Task_1575,1986,777,87,131,218,2.5526992287917736,40.95964770241722
Task_1576,2754,389,90,15,105,7.061538461538461,50.32843423221666
Task_1577,1433,817,15,47,62,1.7518337408312958,30.347820033732358
Task_1578,2042,422,15,131,146,4.8274231678487,40.23989483956884
Task_1579,2099,233,161,126,287,8.97008547008547,41.32145503920187
Task_1580,1591,263,41,144,185,6.026515151515151,32.947840525923716
Task_1581,1007,308,171,19,190,3.2588996763754046,23.151855265181414
Task_1582,2214,217,38,162,200,10.155963302752294,42.74832992843002
Task_1583,1534,964,49,79,128,1.589637305699482,34.01687646169513
Task_1584,1190,510,38,40,78,2.328767123287671,25.60178161901292
Task_1585,1720,290,125,154,279,5.9106529209622,35.53792208645773
Task_1586,958,230,41,88,129,4.147186147186147,22.452953668525197
Task_1587,1522,80,84,74,158,18.790123456790123,29.896319687565562
Task_1588,944,990,154,178,332,0.9525731584258325,25.71322054509201
Task_1589,1983,480,108,61,169,4.122661122661123,39.32397329779975
Task_1590,793,927,120,125,245,0.8545258620689655,22.64662540326522
Task_1591,1246,976,50,151,201,1.2753326509723644,29.875008980557094
Task_1592,1193,779,143,42,185,1.5294871794871794,27.637640280359985
Task_1593,2614,485,37,150,187,5.378600823045267,49.91716208176154
Task_1594,2364,285,166,184,350,8.265734265734265,46.06506925220245
Task_1595,1018,957,110,115,225,1.0626304801670146,26.169362538507087
Task_1596,2353,820,178,141,319,2.8660170523751525,47.41819910875239
Task_1597,1041,134,155,173,328,7.711111111111111,24.258848097416926
Task_1598,2677,446,70,98,168,5.988814317673378,50.64725111209908
Task_1599,2307,217,168,26,194,10.582568807339449,43.453049197198744
Task_1600,2449,483,28,128,156,5.059917355371901,46.91944574659769
Task_1601,1509,955,56,107,163,1.5784518828451883,33.683670645816186
Task_1602,1662,76,41,129,170,21.584415584415584,32.692681723555744
Task_1603,1962,270,155,103,258,7.239852398523985,39.124867429924215
Task_1604,1928,913,56,89,145,2.1094091903719914,40.03371718445403
Task_1605,1679,95,21,175,196,17.489583333333332,33.30880978873784
Task_1606,1522,271,155,45,200,5.595588235294118,31.301449539626258
Task_1607,1605,812,122,154,276,1.9741697416974169,35.3675365150497
Task_1608,858,672,42,51,93,1.274888558692422,21.404922236463637
Task_1609,2287,571,118,114,232,3.9982517482517483,45.15595261612467
Task_1610,2087,514,26,31,57,4.052427184466019,39.66075336206999
Task_1611,2037,745,67,118,185,2.7305630026809653,41.58051620756502
Task_1612,2323,694,122,94,216,3.3424460431654675,46.0075485145267
Task_1613,2777,579,136,110,246,4.787931034482758,52.9981166988149
Task_1614,1675,888,154,137,291,1.8841394825646793,36.75576672883085
Task_1615,1136,575,56,122,178,1.9722222222222223,26.754250147386234
Task_1616,2151,833,69,155,224,2.579136690647482,43.923211586342006
Task_1617,2060,720,29,49,78,2.857142857142857,40.131865677016876
Task_1618,1647,381,125,27,152,4.31151832460733,33.258484706776024
Task_1619,2591,116,29,99,128,22.145299145299145,47.125383664493995
Task_1620,1307,130,34,30,64,9.977099236641221,25.885693541218686
Task_1621,2326,857,111,74,185,2.710955710955711,46.19554432055556
Task_1622,1650,764,109,129,238,2.156862745098039,35.7229480469126
Task_1623,1435,829,131,151,282,1.7289156626506024,32.736227509814455
Task_1624,1042,839,86,79,165,1.2404761904761905,25.728049946950534
Task_1625,2543,470,71,110,181,5.399150743099788,48.67057661941257
Task_1626,1269,298,127,72,199,4.2441471571906355,27.733314438878065
Task_1627,1252,608,167,36,203,2.0558292282430215,28.123965682961956
Task_1628,2162,863,98,37,135,2.502314814814815,42.881179999388394
Task_1629,2070,920,162,24,186,2.247557003257329,41.90549717640446
Task_1630,2554,690,175,123,298,3.6960926193921853,50.07270624869316
Task_1631,1491,187,161,112,273,7.930851063829787,31.49630347676168
Task_1632,992,780,159,45,204,1.2701664532650447,24.549817270302743
Task_1633,1053,942,14,152,166,1.1166489925768823,26.39345943186183
Task_1634,1637,452,148,145,293,3.6136865342163356,34.80560277264217
Task_1635,2280,477,90,55,145,4.7698744769874475,43.92856249069961
Task_1636,900,891,101,187,288,1.0089686098654709,24.466413417901006
Task_1637,2994,104,98,75,173,28.514285714285716,53.45183585075594
Task_1638,1452,276,169,48,217,5.241877256317689,30.333505870495486
Task_1639,2673,563,68,67,135,4.73936170212766,50.470562674386464
Task_1640,1991,251,79,86,165,7.900793650793651,39.08565599164757
Task_1641,1149,906,39,91,130,1.2668136714443219,27.53584472271015
Task_1642,1213,286,104,74,178,4.2264808362369335,26.731665314558693
Task_1643,2192,597,199,167,366,3.6655518394648827,44.41582828606723
Task_1644,2774,906,195,181,376,3.058434399117971,54.67342273766542
Task_1645,1713,764,116,134,250,2.23921568627451,36.78242038392102
Task_1646,2188,290,137,136,273,7.518900343642612,42.88294980285042
Task_1647,1663,384,170,136,306,4.3194805194805195,35.04319174406153
Task_1648,1450,639,128,82,210,2.265625,31.897998675385598
Task_1649,2881,78,109,108,217,36.46835443037975,52.095132931937286
Task_1650,2955,644,19,175,194,4.5813953488372094,55.870880344022744
Task_1651,626,475,90,91,181,1.315126050420168,18.14728980509281
Task_1652,635,236,77,94,171,2.679324894514768,17.63994374201482
Task_1653,2741,885,115,119,234,3.0936794582392775,53.35392305573712
Task_1654,1120,79,68,56,124,14.0,23.28556524268069
Task_1655,2390,78,171,82,253,30.253164556962027,44.346420942101936
Task_1656,629,472,97,172,269,1.3298097251585623,18.793551620594577
Task_1657,2678,913,129,140,269,2.9299781181619258,52.63178914449649
Task_1658,2227,469,69,22,91,4.738297872340426,42.191210570249076
Task_1659,1468,545,139,10,149,2.688644688644689,30.927967094339667
Task_1660,2584,661,78,172,250,3.903323262839879,50.37857218527196
Task_1661,1618,396,129,82,211,4.075566750629723,33.791624430351106
Task_1662,2824,87,49,148,197,32.09090909090909,51.2971313617362
Task_1663,1971,161,140,99,239,12.166666666666666,38.571634051907914
Task_1664,1646,967,41,150,191,1.7004132231404958,36.10927080846582
Task_1665,2876,261,147,53,200,10.977099236641221,52.95031131248647
Task_1666,902,491,183,100,283,1.8333333333333333,23.18340181140239
Task_1667,1725,257,127,190,317,6.686046511627907,35.72757929392081
Task_1668,1452,994,154,61,215,1.4592964824120602,32.75443402647473
Task_1669,1435,595,88,38,126,2.4077181208053693,30.48497561681494
Task_1670,715,524,199,162,361,1.361904761904762,20.72154764102637
Task_1671,645,806,67,74,141,0.7992565055762082,19.282870068021218
Task_1672,2546,744,174,113,287,3.41744966442953,50.052027867329194
Task_1673,858,558,83,132,215,1.5348837209302326,22.428085313004118
Task_1674,2645,873,100,32,132,3.026315789473684,50.58232020867349
Task_1675,663,840,175,67,242,0.7883472057074911,20.025655984676657
Task_1676,1087,232,116,43,159,4.665236051502146,23.98499975551213
Task_1677,2737,183,115,175,290,14.875,51.20904023447603
Task_1678,2637,1023,12,178,190,2.5751953125,51.985920279112584
Task_1679,730,800,119,111,230,0.9113607990012484,21.174579744847993
Task_1680,2940,797,89,89,178,3.6842105263157894,55.85031022475599
Task_1681,2826,465,91,150,241,6.064377682403434,53.440141722313506
Task_1682,1902,142,58,132,190,13.3006993006993,37.24096140240062
Task_1683,1692,434,129,130,259,3.889655172413793,35.44312369813263
Task_1684,1972,399,29,93,122,4.93,38.87155542444632
Task_1685,1792,264,197,146,343,6.7622641509433965,36.863397258355214
Task_1686,1362,765,94,108,202,1.7780678851174934,30.96734373857143
Task_1687,2063,544,193,98,291,3.785321100917431,41.77299192588546
Task_1688,2710,647,72,12,84,4.182098765432099,50.31852385707878
Task_1689,2210,667,151,121,272,3.308383233532934,44.4311663904906
Task_1690,1570,575,50,197,247,2.7256944444444446,34.10213306904611
Task_1691,1996,471,170,54,224,4.228813559322034,39.809055700540306
Task_1692,1138,761,109,62,171,1.4934383202099737,26.81084049640739
Task_1693,2252,622,192,112,304,3.6147672552166936,45.08521748872145
Task_1694,2561,402,198,167,365,6.354838709677419,49.62263304267964
Task_1695,1460,915,143,100,243,1.5938864628820961,33.14887364266749
Task_1696,1282,818,130,104,234,1.5653235653235653,29.963438424394763
Task_1697,2697,174,176,140,316,15.411428571428571,50.45223003587105
Task_1698,1869,925,134,75,209,2.0183585313174945,39.30785780894978
Task_1699,2440,695,117,71,188,3.5057471264367814,47.44736364164297
Task_1700,1414,108,160,114,274,12.972477064220184,29.570321607384553
Task_1701,2689,798,167,139,306,3.365456821026283,52.61104394421702
Task_1702,2693,225,145,104,249,11.915929203539823,50.46943900477854
Task_1703,1171,404,149,88,237,2.891358024691358,26.882224693470075
Task_1704,2459,437,197,43,240,5.614155251141552,46.86711971150114
Task_1705,899,832,184,68,252,1.0792316926770709,23.70479754363568
Task_1706,2893,568,155,200,355,5.084358523725835,55.422902531793
Task_1707,2709,820,61,85,146,3.299634591961023,52.12567285827985
Task_1708,2482,723,171,31,202,3.4281767955801103,47.96708226881524
Task_1709,2506,393,14,135,149,6.3604060913705585,47.50798467215055
Task_1710,1849,130,82,31,113,14.114503816793894,34.94006958977261
Task_1711,1346,510,38,91,129,2.6340508806262233,29.49794729702444
Task_1712,2326,675,14,71,85,3.440828402366864,44.73215171733554
Task_1713,1138,210,165,88,253,5.393364928909953,25.79483919149472
Task_1714,856,291,187,56,243,2.9315068493150687,21.27075777484217
Task_1715,1708,773,37,107,144,2.20671834625323,36.05131622751625
Task_1716,1255,392,127,71,198,3.1933842239185752,27.789324847698197
Task_1717,1227,602,55,34,89,2.0348258706467663,26.67468632478683
Task_1718,1541,800,14,54,68,1.923845193508115,32.18321989945145
Task_1719,1495,216,43,100,143,6.889400921658986,30.86018821319963
Task_1720,2720,377,88,191,279,7.195767195767195,51.66105387713527
Task_1721,2368,385,25,72,97,6.134715025906735,44.565379748541
Task_1722,545,825,197,118,315,0.6598062953995157,18.826069805076433
Task_1723,723,100,69,102,171,7.158415841584159,18.119926354227093
Task_1724,1558,200,64,175,239,7.751243781094527,32.58315286893081
Task_1725,1177,964,117,85,202,1.2196891191709844,28.48555294838566
Task_1726,2413,587,82,172,254,4.10374149659864,47.428424841562816
Task_1727,955,383,144,27,171,2.4869791666666665,22.495545330372835
Task_1728,2767,576,91,132,223,4.795493934142114,52.75807590969276
Task_1729,2223,876,153,88,241,2.5347776510832385,45.04510820065028
Task_1730,1434,685,15,113,128,2.0903790087463556,31.49634967115701
Task_1731,1825,373,40,58,98,4.879679144385027,35.762575184074805
Task_1732,650,732,72,143,215,0.8867667121418826,19.695906235013087
Task_1733,1023,284,187,163,350,3.5894736842105264,24.832857957535243
Task_1734,1903,456,141,157,298,4.164113785557987,39.068861819625376
Task_1735,879,322,123,87,210,2.721362229102167,21.875373818557716
Task_1736,986,511,70,16,86,1.92578125,22.58430448374131
Task_1737,692,598,170,193,363,1.1552587646076795,20.620079930785867
Task_1738,2515,839,179,151,330,2.994047619047619,50.10862239062303
Task_1739,1538,432,95,90,185,3.551963048498845,32.552618707790096
Task_1740,2530,616,66,184,250,4.100486223662885,49.40854809714498
Task_1741,2713,828,73,32,105,3.272617611580217,51.16476499289204
Task_1742,1868,458,186,29,215,4.069716775599129,37.45416029733121
Task_1743,2694,118,98,136,234,22.638655462184875,49.67668731755841
Task_1744,2957,910,172,155,327,3.2458836443468715,57.32670086852886
Task_1745,935,619,53,22,75,1.5080645161290323,21.69324237486174
Task_1746,816,778,74,108,182,1.0474967907573813,22.19396488784085
Task_1747,2245,369,106,136,242,6.0675675675675675,43.91321859408037
Task_1748,593,338,55,115,170,1.7492625368731562,17.33327273588288
Task_1749,1774,622,92,193,285,2.8475120385232744,37.55565577931353
Task_1750,1114,421,113,172,285,2.639810426540284,26.432890398966006
Task_1751,591,368,144,62,206,1.6016260162601625,17.158183583231608
Task_1752,2053,978,84,200,284,2.097037793667007,43.09601165932236
Task_1753,2205,827,36,39,75,2.6630434782608696,42.555717979732194
Task_1754,1100,189,56,101,157,5.7894736842105265,24.63306818213132
Task_1755,1376,123,89,75,164,11.096774193548388,28.269204656245563
Task_1756,2078,550,43,185,228,3.7713248638838475,41.88233062700449
Task_1757,1012,935,17,107,124,1.0811965811965811,25.273836644526302
Task_1758,2885,772,22,85,107,3.7322121604139715,54.30832477080674
Task_1759,517,721,176,66,242,0.7160664819944599,17.442494509059856
Task_1760,748,785,40,128,168,0.9516539440203562,21.04630996376398
Task_1761,2424,553,91,129,220,4.375451263537906,47.23510453228355
Task_1762,1760,678,105,87,192,2.5920471281296025,36.86427287891286
Task_1763,814,786,126,177,303,1.0343074968233799,22.850340714764993
Task_1764,1840,316,31,40,71,5.804416403785489,35.14623509003394
Task_1765,2565,573,55,141,196,4.468641114982578,49.51146810635183
Task_1766,2303,518,153,128,281,4.4373795761079,45.481213973433704
Task_1767,649,595,92,37,129,1.0889261744966443,18.183181703131655
Task_1768,2484,223,109,139,248,11.089285714285714,47.20778324584
Task_1769,2866,947,147,103,250,3.023206751054852,55.57721471847634
Task_1770,1916,972,167,134,301,1.9691675231243577,40.87636550374675
Task_1771,1589,771,152,133,285,2.0582901554404147,34.99609468039602
Task_1772,2943,890,97,49,146,3.303030303030303,55.57318439800188
Task_1773,855,562,123,13,136,1.5186500888099468,21.10390953002169
Task_1774,1233,121,177,153,330,10.10655737704918,27.185213452066733
Task_1775,901,665,106,28,134,1.352852852852853,22.286184607403204
Task_1776,1602,343,142,56,198,4.656976744186046,33.03432368608254
Task_1777,2487,801,172,110,282,3.100997506234414,49.26947337763579
Task_1778,2184,508,147,59,206,4.2907662082514735,42.802791631544174
Task_1779,1297,263,89,190,279,4.912878787878788,28.79238844876983
Task_1780,1560,693,43,113,156,2.2478386167146973,33.51589328964294
Task_1781,1415,603,134,13,147,2.3427152317880795,30.25963199028071
Task_1782,597,992,14,169,183,0.6012084592145015,19.637640197308574
Task_1783,1410,389,115,68,183,3.6153846153846154,30.090694936747187
Task_1784,1348,129,57,33,90,10.36923076923077,26.696399557940165
Task_1785,1874,733,179,189,368,2.553133514986376,39.848504076784835
Task_1786,1656,657,104,37,141,2.5167173252279635,34.27148916945671
Task_1787,1801,309,51,122,173,5.809677419354839,36.424299466237805
Task_1788,1205,403,21,69,90,2.982673267326733,26.139700409707885
Task_1789,582,685,47,164,211,0.8483965014577259,18.45448107871543
Task_1790,2625,804,53,19,72,3.260869565217391,48.940797318946615
Task_1791,2544,683,111,63,174,3.719298245614035,48.935688349623
Task_1792,2439,396,184,132,316,6.143576826196473,47.40009573142088
Task_1793,1820,776,27,140,167,2.3423423423423424,38.093064039606894
Task_1794,1062,460,39,89,128,2.3036876355748372,24.941789799706328
Task_1795,2154,203,131,86,217,10.558823529411764,41.6361741307184
Task_1796,1263,902,75,30,105,1.398671096345515,28.424529956766005
Task_1797,1092,506,148,181,329,2.1538461538461537,26.564476563496157
Task_1798,552,857,137,38,175,0.6433566433566433,17.977434328074185
Task_1799,1404,930,59,82,141,1.5080558539205156,31.73079538592675
Task_1800,2192,790,16,77,93,2.771175726927939,43.0849737164279
Task_1801,1541,396,110,50,160,3.881612090680101,31.808909059207114
Task_1802,2111,731,89,108,197,2.883879781420765,42.68615049798142
Task_1803,1811,676,200,65,265,2.675036927621861,37.76420173567914
Task_1804,2345,334,74,120,194,7.0,45.19794488100709
Task_1805,1027,998,174,111,285,1.028028028028028,26.703325466710506
Task_1806,765,390,135,131,266,1.9565217391304348,20.66646640299673
Task_1807,2333,167,45,122,167,13.886904761904763,43.86950783817968
Task_1808,1738,598,44,91,135,2.9015025041736227,35.92070030258137
Task_1809,1507,564,55,127,182,2.6672566371681414,32.60792702837874
Task_1810,550,205,125,89,214,2.6699029126213594,16.337276763771698
Task_1811,1561,202,117,25,142,7.689655172413793,31.227152845828673
Task_1812,959,788,115,40,155,1.2154626108998732,23.703249254257344
Task_1813,1165,844,43,16,59,1.378698224852071,25.9556814643381
Task_1814,2363,394,109,173,282,5.982278481012658,46.09777531271042
Task_1815,1429,304,103,135,238,4.685245901639345,30.77156310319006
Task_1816,1270,391,10,58,68,3.239795918367347,26.56305803338923
Task_1817,911,522,111,152,263,1.7418738049713194,23.39560437319946
Task_1818,2903,494,188,91,279,5.864646464646465,54.78440359108915
Task_1819,2244,305,188,149,337,7.333333333333333,44.127827172357314
Task_1820,1006,160,61,100,161,6.248447204968944,22.767581401575047
Task_1821,694,377,129,41,170,1.835978835978836,18.38341306307466
Task_1822,1692,985,68,24,92,1.7160243407707911,35.31953782163695
Task_1823,2559,436,22,164,186,5.855835240274599,48.84415550001808
Task_1824,894,978,175,92,267,0.9131767109295199,24.422503694880817
Task_1825,2263,380,121,76,197,5.939632545931759,43.772177716944526
Task_1826,1882,1000,68,197,265,1.8801198801198802,40.42780800896298
Task_1827,1189,626,57,54,111,1.8963317384370015,26.604736688278532
Task_1828,2076,523,184,13,197,3.9618320610687023,40.78412040912503
Task_1829,1308,523,61,192,253,2.49618320610687,29.778438986785392
Task_1830,1803,591,24,177,201,3.045608108108108,37.494965149602535
Task_1831,2383,340,126,43,169,6.988269794721408,44.97914862220997
Task_1832,2016,409,117,170,287,4.917073170731707,40.67443365174181
Task_1833,618,131,43,195,238,4.681818181818182,17.17401890384768
Task_1834,520,657,96,38,134,0.790273556231003,16.33860296808779
Task_1835,1445,425,91,95,186,3.392018779342723,31.11372199319679
Task_1836,2064,503,157,194,351,4.095238095238095,42.061510727750836
Task_1837,2191,700,48,111,159,3.1255349500713265,43.573121973014686
Task_1838,1842,553,103,106,209,3.324909747292419,37.93687289126936
Task_1839,1872,945,159,163,322,1.9788583509513742,40.23237369915876
Task_1840,1818,247,162,84,246,7.330645161290323,36.611926778049174
Task_1841,2428,1017,112,126,238,2.3850687622789786,48.834278856406115
Task_1842,2484,637,54,22,76,3.8934169278996866,46.24841355845616
Task_1843,1225,789,131,139,270,1.5506329113924051,29.183864979969997
Task_1844,1619,526,199,19,218,3.0721062618595827,33.6624717415524
Task_1845,860,182,180,136,316,4.699453551912568,21.644421820340423
Task_1846,1414,807,182,74,256,1.75,31.931380948198434
Task_1847,1846,1001,100,14,114,1.842315369261477,37.95976182548575
Task_1848,782,716,165,131,296,1.090655509065551,22.023777898480578
Task_1849,1520,804,169,65,234,1.8881987577639752,33.414459827189766
Task_1850,1061,260,34,33,67,4.065134099616858,22.611707591232275
Task_1851,1137,246,43,61,104,4.603238866396761,24.54289109648876
Task_1852,2892,360,197,178,375,8.011080332409973,54.77916122569923
Task_1853,2411,673,132,196,328,3.577151335311573,47.99614271073915
Task_1854,2359,237,124,156,280,9.911764705882353,45.45567873481996
Task_1855,2495,450,110,179,289,5.532150776053215,48.411317449172316
Task_1856,792,454,65,150,215,1.7406593406593407,21.149305697654615
Task_1857,2212,654,80,160,240,3.3770992366412216,44.38807570436709
Task_1858,1874,870,23,144,167,2.151549942594719,39.24504532384429
Task_1859,1644,700,11,72,83,2.3452211126961484,33.96393315760441
Task_1860,2596,709,97,148,245,3.656338028169014,50.603468466039736
Task_1861,2124,170,44,87,131,12.421052631578947,40.210242324652214
Task_1862,2975,592,43,167,210,5.016863406408095,56.113281757380754
Task_1863,1924,256,194,182,376,7.4863813229571985,39.12278437528074
Task_1864,1304,272,173,125,298,4.7765567765567765,28.94463006178673
Task_1865,2050,925,107,86,193,2.2138228941684663,42.22816106129955
Task_1866,1749,671,49,90,139,2.6026785714285716,36.43833586233328
Task_1867,806,783,144,132,276,1.028061224489796,22.52665434765372
Task_1868,1911,999,140,90,230,1.911,40.46476700788605
Task_1869,1462,846,101,163,264,1.7260920897284533,33.15331276797229
Task_1870,2186,190,43,102,145,11.44502617801047,41.6752179643595
Task_1871,1191,75,75,93,168,15.671052631578947,25.326508870276243
Task_1872,1070,511,171,67,238,2.08984375,25.379934713271258
Task_1873,1682,412,29,19,48,4.072639225181598,32.717058841435325
Task_1874,1296,730,153,116,269,1.7729138166894665,30.116243204537977
Task_1875,2244,821,121,27,148,2.72992700729927,44.13251554079968
Task_1876,670,633,134,78,212,1.0567823343848581,19.445447885103352
Task_1877,2433,435,125,130,255,5.580275229357798,47.15586707259854
Task_1878,1165,953,12,188,200,1.221174004192872,28.43477229683502
Task_1879,840,986,65,159,224,0.851063829787234,23.56330164877264
Task_1880,2938,369,38,150,188,7.940540540540541,54.65012220377537
Task_1881,1850,796,66,46,112,2.3212045169385194,37.467335203165426
Task_1882,1182,340,190,80,270,3.466275659824047,26.947545655480045
Task_1883,871,760,24,40,64,1.1445466491458607,21.25335178469626
Task_1884,885,921,184,60,244,0.9598698481561823,23.7643103238494
Task_1885,2847,936,126,40,166,3.038420490928495,54.2716106758484
Task_1886,2372,306,88,54,142,7.726384364820847,44.69405076624989
Task_1887,1465,712,107,182,289,2.0546984572230014,32.93757418610233
Task_1888,1725,985,189,151,340,1.7494929006085194,38.07728497973677
Task_1889,2515,811,43,37,80,3.0972906403940885,47.72037831830091
Task_1890,2089,827,152,141,293,2.5229468599033815,43.140173010084176
Task_1891,1401,153,124,154,278,9.097402597402597,29.817730555996956
Task_1892,2083,708,61,80,141,2.9379407616361073,41.79096218370422
Task_1893,2443,455,165,183,348,5.357456140350878,47.87636147486711
Task_1894,1045,1018,112,97,209,1.0255152109911678,26.71573196691713
Task_1895,754,104,128,143,271,7.180952380952381,19.207127561302915
Task_1896,2633,495,27,39,66,5.308467741935484,48.21658738529667
Task_1897,1625,106,189,76,265,15.186915887850468,32.44900431526773
Task_1898,858,535,112,148,260,1.6007462686567164,22.57769527251283
Task_1899,2065,509,107,25,132,4.049019607843137,40.192712161360554
Task_1900,953,1009,91,123,214,0.9435643564356435,25.268093678453383
Task_1901,2394,387,92,85,177,6.170103092783505,45.85819924741188
Task_1902,1645,234,42,100,142,7.0,33.285344605632325
Task_1903,2043,884,137,58,195,2.3084745762711862,41.71308731777117
Task_1904,2760,912,177,135,312,3.023001095290252,54.114470808838156
Task_1905,985,248,64,190,254,3.9558232931726907,23.79075684799722
Task_1906,2838,702,153,85,238,4.0369843527738265,54.206121009389456
Task_1907,1119,774,196,126,322,1.4438709677419355,27.662154619692995
Task_1908,2820,558,162,165,327,5.0447227191413235,54.05728555286098
Task_1909,697,646,29,106,135,1.0772797527047913,19.4942030582372
Task_1910,1723,990,13,173,186,1.7386478304742685,37.346141086747025
Task_1911,1871,823,24,111,135,2.270631067961165,38.70227543362872
Task_1912,658,635,55,81,136,1.0345911949685536,18.914267037832456
Task_1913,1775,356,100,89,189,4.971988795518207,36.08244043896701
Task_1914,2917,923,127,124,251,3.156926406926407,56.34559128201274
Task_1915,1092,311,155,38,193,3.5,24.623333906038862
Task_1916,2423,374,13,160,173,6.461333333333333,46.4177989882947
Task_1917,936,681,165,177,342,1.3724340175953078,24.64625179969911
Task_1918,740,410,89,177,266,1.8004866180048662,20.380267687551566
Task_1919,1558,1003,77,73,150,1.551792828685259,34.209659936522094
Task_1920,1462,898,130,186,316,1.6262513904338154,33.58289038688201
Task_1921,2201,830,27,78,105,2.648616125150421,43.56492089600122
Task_1922,2746,1016,18,20,38,2.7000983284169124,51.396839686297476
Task_1923,782,773,33,42,75,1.0103359173126616,19.955179284271534
Task_1924,1519,836,53,41,94,1.8148148148148149,32.09276768185165
Task_1925,1932,181,18,166,184,10.615384615384615,37.72583196747681
Task_1926,1322,973,161,155,316,1.3572895277207393,31.518113410807263
Task_1927,2758,629,179,148,327,4.377777777777778,53.277729923263315
Task_1928,2586,958,141,149,290,2.6965589155370178,51.42232516608823
Task_1929,2252,216,152,169,321,10.377880184331797,43.890285627557965
Task_1930,1657,637,102,112,214,2.59717868338558,35.303384952597504
Task_1931,2525,848,100,161,261,2.974087161366313,49.998914667254134
Task_1932,805,87,169,20,189,9.147727272727273,18.608213613752383
Task_1933,750,538,151,196,347,1.391465677179963,21.299065980919526
Task_1934,2967,441,11,136,147,6.712669683257919,54.93025339953022
Task_1935,2039,143,65,194,259,14.159722222222221,39.84612599101212
Task_1936,2492,443,109,112,221,5.612612612612613,47.936238527773476
Task_1937,612,526,59,170,229,1.1612903225806452,18.551633965110074
Task_1938,1273,129,32,111,143,9.792307692307693,26.503121278507717
Task_1939,2190,306,125,114,239,7.133550488599348,42.78445941200122
Task_1940,1141,811,153,32,185,1.4051724137931034,26.905903197548028
Task_1941,1626,352,169,67,236,4.606232294617564,33.66200863543012
Task_1942,668,796,118,38,156,0.8381430363864492,19.178844723806765
Task_1943,1948,480,111,176,287,4.0498960498960495,39.83656962165994
Task_1944,2511,840,120,148,268,2.985731272294887,49.764541842366214
Task_1945,1185,108,129,177,306,10.871559633027523,26.20740251099298
Task_1946,1299,554,143,108,251,2.3405405405405406,29.5341900215393
Task_1947,1959,980,200,143,343,1.996941896024465,41.78512077204565
Task_1948,1614,548,87,29,116,2.939890710382514,32.96206939898869
Task_1949,724,120,196,171,367,5.983471074380165,19.367333269843805
Task_1950,1024,747,35,191,226,1.3689839572192513,25.743769885435864
Task_1951,1104,856,52,145,197,1.2882147024504085,27.20028751743473
Task_1952,1749,699,15,53,68,2.4985714285714287,35.169916903114505
Task_1953,1746,940,173,186,359,1.8554729011689692,38.420707004231765
Task_1954,1520,747,82,74,156,2.0320855614973263,32.90502443958935
Task_1955,830,489,192,190,382,1.6938775510204083,22.602031271784295
Task_1956,1888,750,185,30,215,2.5139813581890813,38.69540257144502
Task_1957,1815,811,68,71,139,2.2352216748768474,37.710838396113964
Task_1958,735,418,14,137,151,1.7541766109785202,19.52971286978398
Task_1959,765,437,85,192,277,1.7465753424657535,20.94591076345138
Task_1960,2537,917,50,105,155,2.763616557734205,49.75153459630406
Task_1961,2239,587,190,52,242,3.807823129251701,44.14116399821071
Task_1962,2482,810,48,179,227,3.060419235511714,49.131584130527195
Task_1963,2906,312,172,85,257,9.284345047923322,54.0883873707566
Task_1964,1400,492,15,77,92,2.839756592292089,29.602169334675622
Task_1965,2800,524,162,88,250,5.333333333333333,53.111876826703444
Task_1966,2586,390,82,21,103,6.6138107416879794,47.6273452895279
Task_1967,2931,950,10,149,159,3.082018927444795,56.038210744532144
Task_1968,1468,269,171,38,209,5.437037037037037,30.500183358864593
Task_1969,2692,564,141,139,280,4.764601769911504,51.79976818449546
Task_1970,2361,492,163,47,210,4.789046653144016,45.383427880813464
Task_1971,903,989,84,38,122,0.9121212121212121,23.20281008898642
Task_1972,2857,862,158,123,281,3.3105446118192354,55.3375509558014
Task_1973,637,450,70,182,252,1.4124168514412416,18.86367282754294
Task_1974,1341,157,120,29,149,8.487341772151899,27.448869248609224
Task_1975,2419,85,113,100,213,28.127906976744185,44.88524757002296
Task_1976,995,109,166,144,310,9.045454545454545,23.194312529224096
Task_1977,751,593,53,195,248,1.2643097643097643,21.09542160290827
Task_1978,2533,705,44,62,106,3.587818696883853,48.173841990024464
Task_1979,2449,250,161,197,358,9.756972111553784,47.33739905792177
Task_1980,2542,790,61,10,71,3.213653603034134,47.55164518597922
Task_1981,2141,226,77,142,219,9.431718061674008,41.74281234749206
Task_1982,2106,395,190,59,249,5.318181818181818,41.395599075194376
Task_1983,2967,207,131,117,248,14.264423076923077,54.738054424700714
Task_1984,1577,606,107,13,120,2.598023064250412,32.483632444203344
Task_1985,1363,287,111,125,236,4.732638888888889,29.647918462742663
Task_1986,1824,877,89,141,230,2.0774487471526197,38.7923528796288
Task_1987,1597,114,171,125,296,13.88695652173913,32.619129901777775
Task_1988,2462,612,76,111,187,4.0163132137031,47.90394771109599
Task_1989,648,344,186,177,363,1.8782608695652174,19.17490108831802
Task_1990,1101,1009,158,49,207,1.0900990099009902,27.112700229513084
Task_1991,2333,1023,66,66,132,2.2783203125,46.544948364429985
Task_1992,1929,587,153,176,329,3.2806122448979593,40.06565715995689
Task_1993,1075,825,86,52,138,1.3014527845036319,25.798793359353425
Task_1994,1970,625,109,17,126,3.146964856230032,38.95130287540888
Task_1995,633,725,98,97,195,0.871900826446281,19.251334240404194
Task_1996,1784,282,71,27,98,6.303886925795053,34.659211090837005
Task_1997,1080,363,140,28,168,2.967032967032967,24.420256503133697
Task_1998,1405,859,57,73,130,1.6337209302325582,31.390118649921828
Task_1999,1390,832,168,140,308,1.6686674669867947,32.133636487838864
Task_2000,2293,883,128,136,264,2.5938914027149322,46.40925141487477
Task_2001,1972,506,39,22,61,3.8895463510848125,37.76367775929114
Task_2002,1737,195,200,52,252,8.862244897959183,34.97808377979538
Task_2003,2105,394,126,172,298,5.329113924050633,42.086111015438
Task_2004,2604,892,141,58,199,2.916013437849944,50.64516888222499
Task_2005,872,1022,133,117,250,0.852394916911046,24.20279228650909
Task_2006,1116,739,153,51,204,1.508108108108108,26.600261905967667
Task_2007,2243,955,192,167,359,2.346234309623431,46.31505744646273
Task_2008,817,228,126,62,188,3.567685589519651,20.17590011315648
Task_2009,2723,685,45,87,132,3.9693877551020407,51.8572327020641
Task_2010,2267,848,183,115,298,2.67020023557126,46.01043411461768
Task_2011,1122,793,65,37,102,1.4130982367758187,25.769014961578936
Task_2012,2531,884,32,102,134,2.8598870056497177,49.35343820394439
Task_2013,1787,613,37,100,137,2.91042345276873,36.74185102210462
Task_2014,1478,398,100,81,181,3.7042606516290726,31.37787008553427
Task_2015,2824,531,138,197,335,5.30827067669173,54.11651577863478
Task_2016,2975,905,34,42,76,3.2836644591611477,55.04429600457893
Task_2017,1785,1010,74,30,104,1.7655786350148368,37.00027071282289
Task_2018,1090,330,137,126,263,3.293051359516616,25.595447632578686
Task_2019,2909,96,140,136,276,29.989690721649485,52.95401915791044
Task_2020,1578,910,48,77,125,1.7321624588364435,34.26009346529123
Task_2021,2605,211,153,40,193,12.287735849056604,48.167246911341486
Task_2022,2423,689,87,169,256,3.5115942028985505,47.83291635551431
Task_2023,522,643,181,124,305,0.8105590062111802,17.759376818236827
Task_2024,1556,971,42,31,73,1.6008230452674896,32.7622308699333
Task_2025,2712,449,48,12,60,6.026666666666666,49.1841282187614
Task_2026,2352,719,75,23,98,3.2666666666666666,45.02248858388709
Task_2027,602,456,103,111,214,1.3172866520787747,17.983327764609932
Task_2028,884,883,146,180,326,1.0,24.34915404476258
Task_2029,2699,825,99,156,255,3.267554479418886,52.650999037772614
Task_2030,574,763,158,198,356,0.7513089005235603,19.270210085589248
Task_2031,2293,249,160,49,209,9.172,43.5593900806829
Task_2032,2234,385,75,109,184,5.787564766839378,43.51836896377048
Task_2033,1609,1005,30,84,114,1.599403578528827,34.967528965827846
Task_2034,696,317,81,198,279,2.188679245283019,19.55388272215953
Task_2035,806,915,56,66,122,0.8799126637554585,21.783946564646982
Task_2036,738,119,199,131,330,6.15,19.348778152295694
Task_2037,1475,1022,147,136,283,1.4418377321603129,33.91092444559354
Task_2038,2187,723,179,61,240,3.020718232044199,43.68218706718363
Task_2039,1278,800,136,104,240,1.595505617977528,29.900491140883833
Task_2040,2181,343,80,128,208,6.340116279069767,42.70208368175023
Task_2041,1698,534,143,133,276,3.1738317757009344,35.93813182797652
Task_2042,1380,953,154,127,281,1.4465408805031446,32.16947490164373
Task_2043,1914,333,172,90,262,5.730538922155689,38.548205838116196
Task_2044,2934,876,84,81,165,3.345496009122007,55.94224366195582
Task_2045,1209,931,187,166,353,1.2972103004291846,29.76599972611068
Task_2046,1018,331,44,118,162,3.066265060240964,23.883857417322172
Task_2047,2440,314,63,49,112,7.746031746031746,45.2471511135654
Task_2048,1775,122,17,102,119,14.43089430894309,34.02967666643485
Task_2049,2537,351,23,132,155,7.207386363636363,47.87439168894289
Task_2050,1548,188,199,52,251,8.19047619047619,32.013003377131476
Task_2051,2668,960,177,39,216,2.7762747138397503,51.72205160951925
Task_2052,2421,629,175,71,246,3.842857142857143,47.22030861046074
Task_2053,747,538,163,103,266,1.385899814471243,20.750164333735835
Task_2054,1154,666,101,59,160,1.7301349325337332,26.649401131553436
Task_2055,2184,682,72,40,112,3.1976573938506587,42.38505939357683
Task_2056,1849,212,141,105,246,8.68075117370892,37.080159700046764
Task_2057,1341,818,179,187,366,1.6373626373626373,31.6441045551272
Task_2058,2727,110,135,71,206,24.56756756756757,49.50033596837528
Task_2059,974,621,69,187,256,1.5659163987138263,24.768702715367514
Task_2060,796,505,81,122,203,1.5731225296442688,21.229894189326803
Task_2061,2594,994,28,26,54,2.607035175879397,49.18168421670521
Task_2062,2274,453,182,54,236,5.008810572687224,44.20535268955934
Task_2063,1992,680,130,61,191,2.9251101321585904,40.23736187089869
Task_2064,1514,874,162,142,304,1.7302857142857142,34.21372183536244
Task_2065,1447,149,43,85,128,9.646666666666667,29.456753847769743
Task_2066,1974,486,73,57,130,4.053388090349076,39.0011247180465
Task_2067,2984,597,112,92,204,4.989966555183947,56.06640814785863
Task_2068,1599,789,33,158,191,2.0240506329113925,34.82992330122913
Task_2069,878,427,27,50,77,2.0514018691588785,20.42435614911881
Task_2070,2345,990,21,63,84,2.3662966700302723,45.95012627439389
Task_2071,1066,88,157,80,237,11.97752808988764,23.542517533828715
Task_2072,1561,206,159,11,170,7.541062801932367,31.416457794957083
Task_2073,2913,247,141,189,330,11.745967741935484,54.519258189775655
Task_2074,1760,561,23,21,44,3.131672597864769,34.47638140074083
Task_2075,2407,524,79,123,202,4.584761904761905,46.84370212106169
Task_2076,2411,527,163,171,334,4.566287878787879,47.52195084841492
Task_2077,2692,455,150,141,291,5.9035087719298245,51.49912388185811
Task_2078,2776,847,103,36,139,3.2735849056603774,52.5620279578232
Task_2079,2963,190,163,21,184,15.513089005235603,53.64605188365698
Task_2080,913,933,165,42,207,0.9775160599571735,23.87551503494974
Task_2081,2732,913,183,44,227,2.989059080962801,52.63835191375642
Task_2082,1006,424,145,40,185,2.367058823529412,23.56415531284127
Task_2083,2615,594,121,14,135,4.394957983193278,49.10570618952684
Task_2084,1305,443,12,96,108,2.939189189189189,28.260197942996342
Task_2085,2820,367,122,24,146,7.663043478260869,51.78808549942472
Task_2086,998,809,76,67,143,1.2320987654320987,24.719135070648388
Task_2087,1240,483,140,159,299,2.56198347107438,28.66754418558037
Task_2088,1146,358,164,161,325,3.1922005571030643,26.902207450930007
Task_2089,2180,774,198,60,258,2.8129032258064517,43.81591908443494
Task_2090,2342,502,30,197,227,4.656063618290259,45.908183200422805
Task_2091,1454,129,36,46,82,11.184615384615384,28.425875749937916
Task_2092,2572,750,67,41,108,3.4247669773635154,48.68719720631906
Task_2093,1833,779,134,64,198,2.35,38.11645036654293
Task_2094,2994,202,192,82,274,14.748768472906404,55.13806536821145
Task_2095,1615,795,22,10,32,2.028894472361809,32.73996515522539
Task_2096,1594,365,101,86,187,4.355191256830601,33.19248928761901
Task_2097,1302,619,168,69,237,2.1,29.38088620542319
Task_2098,524,200,122,125,247,2.6069651741293534,16.154535323557926
Task_2099,1345,834,17,54,71,1.6107784431137724,29.193215230561943
Task_2100,1793,793,189,108,297,2.2581863979848866,38.31404982473038
Task_2101,2580,994,108,127,235,2.592964824120603,51.159356744305875
Task_2102,767,301,27,16,43,2.5397350993377485,17.830751434624467
Task_2103,603,885,65,30,95,0.6805869074492099,18.24447135030364
Task_2104,2486,1009,87,192,279,2.4613861386138614,49.970322969366265
Task_2105,513,271,148,153,301,1.8860294117647058,16.49417817680835
Task_2106,2087,534,150,120,270,3.9009345794392525,42.05120325959923
Task_2107,2118,979,92,14,106,2.1612244897959183,42.15847346076614
Task_2108,2718,312,63,40,103,8.68370607028754,49.4213385645455
Task_2109,2529,498,122,59,181,5.0681362725450905,48.09137555638474
Task_2110,2254,995,164,55,219,2.2630522088353415,45.51376973245433
Task_2111,684,709,191,90,281,0.9633802816901409,20.320817512839216
Task_2112,1190,269,170,20,190,4.407407407407407,25.920107855583396
Task_2113,1831,1014,173,141,314,1.8039408866995075,39.72865263876501
Task_2114,1135,523,175,169,344,2.1660305343511452,27.348681521139355
Task_2115,1625,618,119,157,276,2.625201938610662,35.082305357034265
Task_2116,953,128,153,151,304,7.387596899224806,22.709502857062507
Task_2117,2023,342,42,187,229,5.8979591836734695,40.344143939595654
Task_2118,1172,1021,20,195,215,1.1467710371819961,28.84105441299738
Task_2119,1962,85,152,49,201,22.813953488372093,36.889491164536935
Task_2120,1489,88,181,164,345,16.730337078651687,31.010295661955936
Task_2121,2256,865,150,83,233,2.605080831408776,45.47747155254539
Task_2122,1375,883,44,155,199,1.5554298642533937,31.576005852831745
Task_2123,1567,662,36,157,193,2.363499245852187,33.942207459854224
Task_2124,1983,80,83,172,255,24.48148148148148,38.33233707132522
Task_2125,886,185,146,200,346,4.763440860215054,22.30498607439416
Task_2126,1815,247,113,98,211,7.318548387096774,36.50942622310658
Task_2127,2828,146,120,61,181,19.238095238095237,51.28966896060182
Task_2128,946,525,118,17,135,1.7984790874524714,22.468687943494388
Task_2129,1742,840,99,90,189,2.071343638525565,37.10879765293132
Task_2130,1805,359,10,63,73,5.013888888888889,35.042366883671654
Task_2131,1120,828,117,36,153,1.3510253317249699,26.343009865368455
Task_2132,981,167,197,93,290,5.839285714285714,23.16222909286387
Task_2133,927,506,181,78,259,1.8284023668639053,23.362813264232845
Task_2134,1288,776,160,57,217,1.6576576576576576,29.517584640438894
Task_2135,2128,992,44,17,61,2.1430010070493455,41.69321968700315
Task_2136,1323,356,155,50,205,3.7058823529411766,28.562803126708776
Task_2137,844,869,195,191,386,0.9701149425287356,24.003293399359773
Task_2138,1109,797,25,50,75,1.3897243107769424,25.228416285407334
Task_2139,778,673,80,155,235,1.1543026706231454,21.62441501432024
Task_2140,1974,69,109,49,158,28.2,36.45085023943496
Task_2141,1808,146,142,165,307,12.299319727891156,36.33206303376564
Task_2142,1684,341,102,20,122,4.923976608187134,33.38993505858547
Task_2143,2841,1016,74,36,110,2.793510324483776,53.812666700174994
Task_2144,2071,415,52,51,103,4.978365384615385,39.806935556083715
Task_2145,2952,353,17,142,159,8.338983050847459,54.443893857098395
Task_2146,748,646,103,87,190,1.1561051004636784,20.65578896176331
Task_2147,1474,518,108,19,127,2.840077071290944,30.774311007614816
Task_2148,1285,267,27,43,70,4.794776119402985,26.214554183930165
Task_2149,2796,421,166,74,240,6.625592417061611,52.52646866100898
Task_2150,2199,314,102,152,254,6.980952380952381,43.07754056375359
Task_2151,2251,979,116,168,284,2.296938775510204,46.17998206104475
Task_2152,1888,303,115,171,286,6.2105263157894735,38.29459683466174
Task_2153,1176,101,90,177,267,11.529411764705882,25.85679321344186
Task_2154,1722,442,130,102,232,3.8871331828442437,35.78091408366616
Task_2155,1442,599,16,106,122,2.4033333333333333,31.088160447102805
Task_2156,2819,799,93,44,137,3.52375,53.184258412287825
Task_2157,2906,446,197,40,237,6.501118568232662,53.9540869086224
Task_2158,1192,558,188,115,303,2.1323792486583186,28.097081283632903
Task_2159,1124,731,163,78,241,1.53551912568306,27.07442243050701
Task_2160,841,938,113,25,138,0.8956336528221512,22.222517183778795
Task_2161,2364,601,163,112,275,3.9269102990033224,46.66164439619521
Task_2162,2556,685,164,77,241,3.7259475218658893,49.5980648131883
Task_2163,837,487,144,68,212,1.7151639344262295,21.489923738800893
Task_2164,2658,540,140,66,206,4.913123844731977,50.466071045014836
Task_2165,1901,739,22,18,40,2.5689189189189188,37.14872404147423
Task_2166,687,144,72,136,208,4.7379310344827585,18.24472687861162
Task_2167,1903,1003,182,95,277,1.8954183266932272,40.61478866562921
Task_2168,553,998,67,186,253,0.5535535535535535,19.36492077531611
Task_2169,728,591,47,197,244,1.2297297297297298,20.671681543796854
Task_2170,936,109,33,32,65,8.50909090909091,19.87958532643196
Task_2171,1613,247,58,77,135,6.504032258064516,32.75780593841168
Task_2172,2956,585,63,172,235,5.044368600682594,55.960399386970835
Task_2173,2193,124,132,55,187,17.544,41.16555995511788
Task_2174,813,177,100,120,220,4.567415730337078,20.264058838079652
Task_2175,884,572,163,18,181,1.5427574171029668,21.953882208460907
Task_2176,2456,441,189,14,203,5.5565610859728505,46.549258904589244
Task_2177,1119,557,16,27,43,2.0053763440860215,24.353726583527024
Task_2178,1583,329,86,174,260,4.796969696969697,33.406151675138496
Task_2179,2640,1023,134,78,212,2.578125,51.90210511326225
Task_2180,2686,785,29,62,91,3.4173027989821882,50.719965521185934
Task_2181,1600,318,30,132,162,5.015673981191223,33.048700484879795
Task_2182,1687,265,130,117,247,6.342105263157895,34.73230735882351
Task_2183,1921,196,69,158,227,9.751269035532994,38.23924509177382
Task_2184,1619,692,152,91,243,2.336219336219336,34.918838903701904
Task_2185,1921,399,119,114,233,4.8025,38.81304793565766
Task_2186,2772,159,138,88,226,17.325,51.03163110924064
Task_2187,2599,739,158,39,197,3.5121621621621624,49.850629042952654
Task_2188,2665,547,72,44,116,4.863138686131387,49.58321562668655
Task_2189,2010,455,183,200,383,4.407894736842105,41.20539910248345
Task_2190,2737,184,89,17,106,14.794594594594594,49.35986567973461
Task_2191,1609,275,135,174,309,5.829710144927536,33.89682723834901
Task_2192,1130,1014,70,33,103,1.1133004926108374,26.722522133389806
Task_2193,2580,689,30,200,230,3.739130434782609,50.29098466423605
Task_2194,1581,619,136,123,259,2.55,34.26214214770241
Task_2195,610,272,190,168,358,2.2344322344322345,18.30934835282119
Task_2196,2423,958,14,43,57,2.5265901981230448,46.470055470563075
Task_2197,1388,908,108,128,236,1.526952695269527,31.966481126651576
Task_2198,1973,852,82,53,135,2.313012895662368,40.18013629336072
Task_2199,993,368,40,67,107,2.6910569105691056,22.884573046855348
Task_2200,2059,252,112,149,261,8.138339920948617,40.6750047821371
Task_2201,746,706,184,17,201,1.0551626591230552,20.296645022970726
Task_2202,2807,584,84,171,255,4.798290598290598,53.62907517997869
Task_2203,2124,315,128,92,220,6.7215189873417724,41.60200227614404
Task_2204,1370,540,189,108,297,2.532347504621072,30.821695938175264
Task_2205,1704,931,41,93,134,1.8283261802575108,36.45234708129169
Task_2206,2687,254,19,46,65,10.537254901960784,48.33996949344171
Task_2207,1267,177,100,90,190,7.117977528089888,27.194299597592686
Task_2208,1462,1000,194,79,273,1.4605394605394606,33.41061688060097
Task_2209,1575,816,13,103,116,1.9277845777233782,33.826969451369784
Task_2210,1582,769,158,171,329,2.0545454545454547,35.132978443319935
Task_2211,2561,597,133,57,190,4.282608695652174,48.98952431084509
Task_2212,1797,136,81,149,230,13.116788321167883,35.74342075480705
Task_2213,2700,685,28,13,41,3.935860058309038,49.65678134438664
Task_2214,2609,839,147,90,237,3.105952380952381,51.05764819552328
Task_2215,988,729,139,98,237,1.3534246575342466,25.037510025113235
Task_2216,989,518,194,143,337,1.905587668593449,24.951777328082596
Task_2217,1623,881,37,74,111,1.8401360544217686,34.70445686892033
Task_2218,2184,653,65,146,211,3.3394495412844036,43.806658090333265
Task_2219,1216,951,148,13,161,1.2773109243697478,28.21609545743742
Task_2220,1172,669,118,52,170,1.7492537313432837,27.12994615096648
Task_2221,1564,785,13,49,62,1.9898218829516539,32.36492642423389
Task_2222,2994,653,181,58,239,4.577981651376147,56.25073720124893
Task_2223,2279,521,78,130,208,4.365900383141763,44.85171834207129
Task_2224,1021,829,149,65,214,1.230120481927711,25.488908435217255
Task_2225,2396,983,102,123,225,2.434959349593496,48.15833033859351
Task_2226,531,533,28,197,225,0.9943820224719101,17.21888532468759
Task_2227,2907,625,20,161,181,4.643769968051118,54.9367771847105
Task_2228,1279,589,41,146,187,2.1677966101694914,29.093769108065043
Task_2229,971,560,85,103,188,1.7308377896613192,24.047048019693047
Task_2230,2651,497,122,16,138,5.323293172690763,49.37591645564563
Task_2231,1050,980,11,134,145,1.070336391437309,26.192866161291448
Task_2232,2901,980,82,122,204,2.9571865443425076,56.09750680519755
Task_2233,1019,260,200,108,308,3.9042145593869733,24.420719790950113
Task_2234,2875,740,104,73,177,3.8798920377867745,54.4398427153649
Task_2235,2370,350,169,11,180,6.752136752136752,44.78742177261321
Task_2236,1644,924,27,52,79,1.7772972972972974,34.31552268961714
Task_2237,3000,344,135,22,157,8.695652173913043,54.545133186824835
Task_2238,1918,739,19,97,116,2.591891891891892,39.02848102479887
Task_2239,1220,434,133,50,183,2.8045977011494254,27.0648730602144
Task_2240,1711,521,178,141,319,3.2777777777777777,36.308261704639385
Task_2241,538,939,105,114,219,0.5723404255319149,18.626216524365674
Task_2242,673,479,53,49,102,1.4020833333333333,17.687387650501503
Task_2243,1436,142,27,58,85,10.041958041958042,28.470274162919143
Task_2244,2298,788,39,32,71,2.91254752851711,43.89948847180051
Task_2245,1437,192,28,70,98,7.44559585492228,29.26351375502867
Task_2246,1582,797,56,97,153,1.9824561403508771,34.21910334259244
Task_2247,2935,172,152,118,270,16.965317919075144,53.97297936608741
Task_2248,2133,954,37,21,58,2.2335078534031414,41.75104563983548
Task_2249,2335,341,19,160,179,6.8274853801169595,44.956983287803816
Task_2250,1678,563,92,171,263,2.975177304964539,35.71796379856979
Task_2251,1430,505,25,124,149,2.8260869565217392,30.82766033309515
Task_2252,856,592,74,72,146,1.4435075885328836,21.8804522938685
Task_2253,2466,653,177,184,361,3.770642201834862,48.93518250873461
Task_2254,1723,673,119,136,255,2.556379821958457,36.68165718608141
Task_2255,2295,724,126,151,277,3.1655172413793102,46.02356339229281
Task_2256,2363,151,137,28,165,15.546052631578947,43.74911833200989
Task_2257,695,514,67,140,207,1.3495145631067962,19.714119313826178
Task_2258,2185,644,184,199,383,3.387596899224806,44.577239414944934
Task_2259,843,859,90,143,233,0.9802325581395349,23.16188091250828
Task_2260,1404,844,108,13,121,1.6615384615384616,30.493594075401845
Task_2261,1203,599,58,33,91,2.005,26.298491393438486
Task_2262,519,244,169,48,217,2.1183673469387756,15.484303731726321
Task_2263,2591,942,120,89,209,2.7476139978791094,50.956030608416576
Task_2264,1101,260,50,193,243,4.218390804597701,25.646337621615245
Task_2265,1993,133,178,182,360,14.873134328358208,39.401788210434184
Task_2266,2994,712,46,84,130,4.199158485273492,56.215346979986826
Task_2267,752,408,109,54,163,1.8386308068459658,19.641179291770154
Task_2268,2694,694,119,71,190,3.8762589928057554,51.49284405040333
Task_2269,1654,960,105,22,127,1.7211238293444329,35.00199755770632
Task_2270,2989,705,183,15,198,4.23371104815864,55.81578922364367
Task_2271,2036,802,46,47,93,2.535491905354919,40.258384079412785
Task_2272,2601,797,31,155,186,3.2593984962406015,50.66406996697307
Task_2273,1001,293,192,55,247,3.4047619047619047,23.586983922765864
Task_2274,1555,83,50,149,199,18.511904761904763,31.373780917153297
Task_2275,2997,238,28,57,85,12.539748953974895,53.71694537423568
Task_2276,683,717,174,30,204,0.9512534818941504,19.549287721661074
Task_2277,2526,610,89,60,149,4.134206219312603,48.210290576012085
Task_2278,2154,942,31,15,46,2.2841993637327676,41.84841918929445
Task_2279,504,181,99,96,195,2.769230769230769,15.304980059289166
Task_2280,2280,316,28,120,148,7.192429022082019,43.642224898416934
Task_2281,1833,353,125,103,228,5.177966101694915,37.231082269748626
Task_2282,2815,702,33,194,227,4.004267425320057,54.03534081928266
Task_2283,1099,1019,45,170,215,1.0774509803921568,27.6581087835023
Task_2284,2866,215,48,199,247,13.268518518518519,53.35174307678215
Task_2285,1416,445,27,151,178,3.1748878923766815,30.74365093364222
Task_2286,2686,550,178,42,220,4.874773139745916,50.73552701548783
Task_2287,2775,976,181,50,231,2.8403275332650972,53.63312874793156
Task_2288,2927,980,69,193,262,2.9836901121304793,56.90541476881362
Task_2289,1018,312,106,136,242,3.252396166134185,24.318620908028134
Task_2290,1226,361,66,120,186,3.386740331491713,27.534876816877176
Task_2291,1463,129,96,168,264,11.253846153846155,30.60019240023793
Task_2292,1927,612,134,156,290,3.143556280587276,39.90788176612872
Task_2293,2394,791,183,167,350,3.022727272727273,48.154750298745476
Task_2294,1948,276,146,82,228,7.0324909747292415,38.68735194147651
Task_2295,778,503,131,147,278,1.5436507936507937,21.26152545319023
Task_2296,1426,1004,32,38,70,1.418905472636816,30.772536211631365
Task_2297,2709,128,157,103,260,21.0,50.081535657426706
Task_2298,1496,798,185,136,321,1.872340425531915,33.773473351258914
Task_2299,2290,606,96,55,151,3.772652388797364,44.4482312646304
Task_2300,1217,604,151,18,169,2.0115702479338844,27.26985187297176
Task_2301,1949,168,99,15,114,11.532544378698224,36.69415830091804
Task_2302,1007,628,80,174,254,1.600953895071542,25.29163374518829
Task_2303,2350,995,180,26,206,2.359437751004016,46.71138999273276
Task_2304,1092,300,171,40,211,3.627906976744186,24.65805838901805
Task_2305,996,276,40,132,172,3.595667870036101,23.509990543461555
Task_2306,2973,1015,98,43,141,2.9261811023622046,56.23915697987735
Task_2307,2786,941,51,198,249,2.9575371549893843,54.52370259373412
Task_2308,2042,389,64,130,194,5.235897435897436,40.61281117007491
Task_2309,820,89,54,41,95,9.11111111111111,17.99802003452177
Task_2310,581,952,15,181,196,0.6096537250786989,19.362946774330894
Task_2311,1479,562,66,58,124,2.6269982238010656,31.278962246720123
Task_2312,2051,987,150,42,192,2.075910931174089,41.924499995845935
Task_2313,1879,532,80,180,260,3.525328330206379,38.84769515141472
Task_2314,2766,516,41,92,133,5.350096711798839,51.97324694963019
Task_2315,2598,120,149,36,185,21.47107438016529,47.27518381865792
Task_2316,2764,478,13,64,77,5.77035490605428,50.664682003177255
Task_2317,1714,177,163,35,198,9.629213483146067,33.81325839038437
Task_2318,1923,671,108,23,131,2.861607142857143,38.44434914718132
Task_2319,2570,614,148,180,328,4.178861788617886,50.30394489248844
Task_2320,2187,656,197,81,278,3.328767123287671,43.89644752017475
Task_2321,2346,209,166,24,190,11.17142857142857,43.985224676396875
Task_2322,2533,725,135,92,227,3.4889807162534434,49.43324821256032
Task_2323,1510,540,117,188,305,2.7911275415896486,33.191738096921455
Task_2324,2221,516,136,104,240,4.295938104448743,43.956571413366966
Task_2325,2894,737,171,68,239,3.921409214092141,54.984189977928516
Task_2326,2649,415,114,101,215,6.367788461538462,50.28552444825194
Task_2327,1208,361,198,100,298,3.3370165745856353,27.6815349601645
Task_2328,1159,364,98,196,294,3.175342465753425,27.0429693389836
Task_2329,1599,411,187,162,349,3.8810679611650487,34.34983086046001
Task_2330,1473,267,200,20,220,5.496268656716418,30.524206402420294
Task_2331,1901,327,65,27,92,5.795731707317073,36.56000866979742
Task_2332,2473,149,55,196,251,16.486666666666668,46.67411468770206
Task_2333,2638,252,124,30,154,10.42687747035573,48.52421753801511
Task_2334,2511,342,148,65,213,7.320699708454811,47.5334361998793
Task_2335,1422,405,168,199,367,3.502463054187192,31.664993974960236
Task_2336,2494,516,24,187,211,4.823984526112186,48.25721320206268
Task_2337,1894,695,34,38,72,2.721264367816092,37.23920280505488
Task_2338,500,330,48,108,156,1.5105740181268883,15.579766049274326
Task_2339,1450,457,156,168,324,3.165938864628821,32.03512584187366
Task_2340,849,498,177,108,285,1.7014028056112225,22.373595218911827
Task_2341,2099,282,71,96,167,7.41696113074205,40.967758322330404
Task_2342,1607,112,121,22,143,14.221238938053098,31.14429163923121
Task_2343,1957,988,187,94,281,1.9787664307381194,41.42038114749525
Task_2344,1222,967,141,50,191,1.262396694214876,28.821201849922527
Task_2345,1513,255,160,89,249,5.91015625,31.873629133102792
Task_2346,2611,950,108,119,227,2.7455310199789693,51.465597805977175
Task_2347,1087,157,18,81,99,6.879746835443038,23.25638639778876
Task_2348,1316,521,110,35,145,2.521072796934866,28.542102518524782
Task_2349,1524,519,97,145,242,2.9307692307692306,33.00774907194201
Task_2350,1029,965,136,179,315,1.065217391304348,26.867869277169046
Task_2351,1543,1010,196,148,344,1.5262116716122651,35.254997881538735
Task_2352,2101,326,142,53,195,6.425076452599388,40.90570021363533
Task_2353,2373,776,17,115,132,3.054054054054054,46.52678847401907
Task_2354,1948,712,22,159,181,2.732117812061711,40.015696921299984
Task_2355,720,222,17,184,201,3.2286995515695067,19.15887967489677
Task_2356,2677,813,67,34,101,3.288697788697789,50.51452381379155
Task_2357,2362,896,163,147,310,2.633221850613155,47.76659404860877
Task_2358,969,860,155,155,310,1.1254355400696865,25.516198213371755
Task_2359,681,716,72,44,116,0.9497907949790795,18.8278837285782
Task_2360,898,389,63,11,74,2.3025641025641024,20.286632619077334
Task_2361,2255,143,98,24,122,15.659722222222221,41.41215389637243
Task_2362,1558,283,20,142,162,5.485915492957746,32.26399232332525
Task_2363,2693,804,154,136,290,3.3453416149068325,52.61675357663952
Task_2364,1054,699,127,127,254,1.5057142857142858,26.105545283013218
Task_2365,2746,663,42,81,123,4.135542168674699,51.97611012270494
Task_2366,1236,944,170,70,240,1.307936507936508,29.35045235178514
Task_2367,2418,462,81,159,240,5.222462203023758,47.03480325474828
Task_2368,1238,434,66,70,136,2.845977011494253,27.33702158332974
Task_2369,1667,365,161,68,229,4.554644808743169,34.32146644475121
Task_2370,2324,561,44,152,196,4.135231316725979,45.620072049820074
Task_2371,507,337,59,63,122,1.5,15.175409321880084
Task_2372,1731,194,199,200,399,8.876923076923077,35.96825328554033
Task_2373,1356,1005,27,66,93,1.3479125248508945,30.43299664676451
Task_2374,1751,235,139,49,188,7.419491525423729,34.838197986622184
Task_2375,2142,106,45,70,115,20.018691588785046,39.572946886066816
Task_2376,2020,692,188,152,340,2.914862914862915,41.852244680666736
Task_2377,2829,593,109,168,277,4.762626262626263,54.09117651960241
Task_2378,607,807,110,43,153,0.7512376237623762,18.19917646914624
Task_2379,2809,97,113,39,152,28.663265306122447,49.76495159111473
Task_2380,2774,175,79,40,119,15.761363636363637,49.81981319387187
Task_2381,2169,305,33,84,117,7.088235294117647,41.61741787848894
Task_2382,2953,347,110,98,208,8.485632183908047,54.83690802611293
Task_2383,1357,561,21,85,106,2.4145907473309607,29.415228689765836
Task_2384,2896,178,196,130,326,16.178770949720672,53.618881350187486
Task_2385,801,827,119,163,282,0.967391304347826,22.68228877609557
Task_2386,2073,526,71,127,198,3.933586337760911,41.54970255705972
Task_2387,2597,917,158,84,242,2.8289760348583877,51.08241533073147
Task_2388,2985,262,165,161,326,11.34980988593156,55.65467320338062
Task_2389,2564,623,180,10,190,4.108974358974359,48.791416289762
Task_2390,1167,351,101,11,112,3.315340909090909,25.169910289234966
Task_2391,2993,373,36,59,95,8.002673796791443,54.25578112110915
Task_2392,2818,914,171,106,277,3.0797814207650274,54.839510097527295
Task_2393,1719,800,165,193,358,2.146067415730337,37.56303041292972
Task_2394,1706,473,26,176,202,3.5991561181434597,35.58589594565632
Task_2395,1728,315,179,73,252,5.468354430379747,35.278390136910225
Task_2396,1679,91,13,68,81,18.25,31.868559790714357
Task_2397,2336,751,96,57,153,3.106382978723404,45.60681664352308
Task_2398,1400,405,154,11,165,3.4482758620689653,29.570861640807745
Task_2399,691,378,85,90,175,1.8232189973614776,18.94779509964896
Task_2400,1662,585,24,146,170,2.83617747440273,35.01345206355719
Task_2401,685,1019,65,57,122,0.6715686274509803,20.12893434735522
Task_2402,2527,686,167,68,235,3.678311499272198,48.991504637694625
Task_2403,641,732,17,35,52,0.8744884038199181,17.5899267935188
Task_2404,2765,644,122,143,265,4.286821705426356,53.149565267399396
Task_2405,1071,1009,16,60,76,1.0603960396039604,25.436224941448625
Task_2406,2583,310,25,61,86,8.305466237942122,47.45507239035215
Task_2407,2115,885,196,200,396,2.3871331828442437,44.283834435131375
Task_2408,2397,85,63,30,93,27.872093023255815,42.61995332851484
Task_2409,1762,531,106,160,266,3.31203007518797,36.936455676620334
Task_2410,2981,839,196,37,233,3.5488095238095236,56.38998791974203
Task_2411,850,767,33,121,154,1.1067708333333333,22.365260087547217
Task_2412,639,217,161,161,322,2.9311926605504586,18.41673403475046
Task_2413,1400,379,162,70,232,3.6842105263157894,30.15790763600194
Task_2414,2757,975,131,122,253,2.824795081967213,53.97878184933588
Task_2415,1249,97,171,124,295,12.744897959183673,26.969944769446638
Task_2416,1339,977,11,11,22,1.369120654396728,28.87303766899079
Task_2417,2611,946,90,26,116,2.757127771911299,49.99967586494276
Task_2418,536,515,194,121,315,1.0387596899224807,17.57897194274024
Task_2419,2692,254,168,126,294,10.556862745098039,50.79922947351122
Task_2420,2921,964,125,167,292,3.026943005181347,56.78500504278154
Task_2421,639,957,111,198,309,0.6670146137787056,20.81324360212355
Task_2422,1698,164,88,126,214,10.290909090909091,34.18161250282568
Task_2423,2209,756,112,133,245,2.918097754293263,44.59106204779196
Task_2424,1466,181,37,168,205,8.054945054945055,30.565177538330655
Task_2425,1260,416,179,44,223,3.0215827338129495,27.741320333867908
Task_2426,1476,511,36,180,216,2.8828125,32.16350657386431
Task_2427,820,346,43,118,161,2.363112391930836,20.763073558597462
Task_2428,2468,407,135,29,164,6.049019607843137,46.55998070339871
Task_2429,800,577,76,74,150,1.3840830449826989,20.92021255591498
Task_2430,986,171,168,56,224,5.732558139534884,22.656862116785504
Task_2431,2058,307,178,138,316,6.681818181818182,41.082986926430785
Task_2432,1290,362,73,25,98,3.553719008264463,27.07968260260734
Task_2433,2490,915,21,104,125,2.7183406113537116,48.76823444688889
Task_2434,1859,967,82,145,227,1.9204545454545454,39.682218518625135
Task_2435,2468,996,16,166,182,2.4754262788365096,49.14746887585242
Task_2436,1240,367,186,96,282,3.369565217391304,28.157415452397682
Task_2437,1995,328,177,74,251,6.0638297872340425,39.59279517622424
Task_2438,1507,971,75,180,255,1.550411522633745,34.277798123424766
Task_2439,2625,325,127,54,181,8.052147239263803,49.0589938644758
Task_2440,1813,565,36,174,210,3.2031802120141344,37.63445240524429
Task_2441,1356,987,126,72,198,1.3724696356275303,31.256005057631214
Task_2442,2192,106,10,154,164,20.485981308411215,41.16213433639532
Task_2443,940,281,40,133,173,3.3333333333333335,22.64715576869358
Task_2444,967,1017,147,87,234,0.949901768172888,25.537503143064082
Task_2445,1693,570,124,24,148,2.9649737302977233,34.5834750077765
Task_2446,908,551,165,86,251,1.644927536231884,23.22564284748277
Task_2447,1315,432,200,83,283,3.0369515011547343,29.437493862693444
Task_2448,1537,99,200,16,216,15.37,30.289205747194625
Task_2449,1348,574,17,136,153,2.3443478260869566,29.705864351663664
Task_2450,786,572,109,106,215,1.3717277486910995,21.25514856853343
Task_2451,1887,997,168,80,248,1.8907815631262526,40.07700988324854
Task_2452,618,498,43,82,125,1.2384769539078155,17.761866562104412
Task_2453,2394,950,147,159,306,2.5173501577287065,48.441663031376514
Task_2454,986,727,148,85,233,1.3543956043956045,24.88206172764876
Task_2455,952,745,14,121,135,1.2761394101876675,23.860338363330957
Task_2456,2037,969,57,171,228,2.1,42.576145459642916
Task_2457,2152,113,178,155,333,18.87719298245614,41.5501583909865
Task_2458,810,478,36,24,60,1.6910229645093946,19.312024631504503
Task_2459,2310,1004,140,184,324,2.298507462686567,47.39648380758323
Task_2460,721,809,45,45,90,0.8901234567901235,19.540316101520826
Task_2461,2637,502,80,195,275,5.242544731610338,50.841971215764055
Task_2462,2519,292,48,120,168,8.597269624573379,47.63767799962381
Task_2463,1091,929,80,199,279,1.1731182795698925,27.64839024983534
Task_2464,1618,564,139,117,256,2.863716814159292,34.65265996032221
Task_2465,2073,502,101,196,297,4.121272365805169,41.96034054321521
Task_2466,1032,270,59,42,101,3.8081180811808117,22.635450668476043
Task_2467,2332,816,43,71,114,2.854345165238678,45.72775376620606
Task_2468,1963,726,100,173,273,2.700137551581843,40.78482255323845
Task_2469,1425,890,47,104,151,1.5993265993265993,31.944845612822323
Task_2470,2542,424,87,59,146,5.9811764705882355,47.86448524056535
Task_2471,859,202,54,195,249,4.231527093596059,21.630786273219258
Task_2472,2019,71,77,15,92,28.041666666666668,36.30331871540793
Task_2473,2567,72,170,109,279,35.16438356164384,47.43790515309959
Task_2474,2734,603,160,94,254,4.526490066225166,52.39990977132658
Task_2475,2226,769,12,196,208,2.890909090909091,44.79078838040649
Task_2476,630,871,166,46,212,0.7224770642201835,19.38461756234833
Task_2477,1015,664,22,127,149,1.5263157894736843,24.714210278432677
Task_2478,1563,95,189,96,285,16.28125,31.797369530459974
Task_2479,793,406,60,170,230,1.9484029484029484,21.12425101281472
Task_2480,691,159,89,24,113,4.31875,16.880167219720192
Task_2481,2404,949,173,18,191,2.5305263157894737,47.29341833101907
Task_2482,2863,386,12,111,123,7.397932816537468,52.91575139481862
Task_2483,2181,162,42,199,241,13.38036809815951,42.0157138886271
Task_2484,863,989,188,123,311,0.8717171717171717,24.241960270970523
Task_2485,570,186,55,157,212,3.0481283422459895,16.823940436002783
Task_2486,714,488,115,191,306,1.460122699386503,20.38107233758579
Task_2487,1177,207,100,127,227,5.658653846153846,26.399196638813915
Task_2488,1153,857,186,180,366,1.343822843822844,28.74276743817232
Task_2489,1464,743,128,175,303,1.967741935483871,33.07125658605325
Task_2490,820,368,182,95,277,2.2222222222222223,21.47736065353425
Task_2491,2340,282,182,59,241,8.268551236749117,44.67745501459391
Task_2492,1208,512,167,117,284,2.354775828460039,28.123211696794897
Task_2493,728,338,84,77,161,2.1474926253687316,19.095543022965433
Task_2494,1354,901,166,191,357,1.501108647450111,32.04373241181846
Task_2495,1885,631,81,69,150,2.982594936708861,38.178469986827714
Task_2496,1388,550,97,37,134,2.5190562613430125,29.653358003329647
Task_2497,1670,301,127,60,187,5.529801324503311,33.88919951709736
Task_2498,1486,530,113,10,123,2.7984934086629,30.889615308696435
Task_2499,580,280,40,191,231,2.0640569395017794,17.331945921615176
Task_2500,511,89,152,86,238,5.677777777777778,14.944394576059638
Task_2501,1503,538,64,41,105,2.7884972170686457,30.94452670607033
Task_2502,2107,303,125,86,211,6.930921052631579,41.22824450441233
Task_2503,1236,346,70,187,257,3.561959654178674,28.091206688618787
Task_2504,2830,733,36,75,111,3.8555858310626703,53.37102536198939
Task_2505,2520,196,67,22,89,12.791878172588833,45.88778365451187
Task_2506,1907,196,81,104,185,9.680203045685278,37.69700075875297
Task_2507,549,708,101,29,130,0.7743300423131171,16.89752176321659
Task_2508,612,201,123,120,243,3.0297029702970297,17.5215211397047
Task_2509,1111,839,101,38,139,1.3226190476190476,26.177135909186394
Task_2510,843,465,185,78,263,1.8090128755364807,21.922581166116625
Task_2511,1340,254,182,27,209,5.254901960784314,28.38049308706189
Task_2512,2408,197,104,12,116,12.16161616161616,44.28078331369835
Task_2513,1291,527,62,161,223,2.445075757575758,29.341223401462518
Task_2514,1685,974,42,78,120,1.7282051282051283,36.03874817353244
Task_2515,2466,935,95,42,137,2.6346153846153846,47.95928495920584
Task_2516,859,648,135,78,213,1.3235747303543914,22.48852211786475
Task_2517,642,180,26,67,93,3.546961325966851,16.312691123146486
Task_2518,1601,116,47,116,163,13.683760683760683,31.914782193088627
Task_2519,2457,329,69,195,264,7.445454545454545,47.38950203867615
Task_2520,2652,701,16,171,187,3.7777777777777777,51.18896031275529
Task_2521,2836,343,22,50,72,8.244186046511627,51.130319919260764
Task_2522,2060,818,84,23,107,2.515262515262515,40.76218696653352
Task_2523,1650,427,110,44,154,3.8551401869158877,33.477982207537025
Task_2524,1942,316,173,45,218,6.126182965299685,38.17498163083812
Task_2525,2128,807,152,161,313,2.633663366336634,43.815028582546255
Task_2526,1450,813,84,76,160,1.7813267813267812,31.986580694992753
Task_2527,1355,913,35,88,123,1.4824945295404814,30.67222640935027
Task_2528,2378,902,161,182,343,2.6334440753045403,48.23888715540155
Task_2529,1522,327,72,147,219,4.640243902439025,32.31014412414714
Task_2530,1189,227,52,61,113,5.214912280701754,25.515004774034832
Task_2531,2340,98,44,164,208,23.636363636363637,43.76293449528424
Task_2532,1539,860,196,169,365,1.7874564459930313,34.89427147813293
Task_2533,2474,206,14,144,158,11.951690821256038,46.37793152573903
Task_2534,2293,854,86,161,247,2.68187134502924,46.23897530408056
Task_2535,1179,476,119,192,311,2.4716981132075473,27.78226799526907
Task_2536,2921,100,173,181,354,28.92079207920792,53.61954985827375
Task_2537,2811,402,23,198,221,6.975186104218363,52.962438439506336
Task_2538,594,890,99,84,183,0.6666666666666666,19.09781014474486
Task_2539,1733,538,127,78,205,3.215213358070501,35.981405280756476
Task_2540,1777,475,168,168,336,3.7331932773109244,37.32276381572765
Task_2541,789,881,87,168,255,0.8945578231292517,22.474826953660955
Task_2542,2621,256,51,86,137,10.198443579766536,48.83753322098395
Task_2543,2814,609,160,162,322,4.613114754098361,54.09881847232621
Task_2544,2453,940,56,29,85,2.6068012752391074,47.136374777519585
Task_2545,1938,924,107,89,196,2.095135135135135,40.493963618196354
Task_2546,2828,288,123,41,164,9.785467128027681,51.85712719277336
Task_2547,1800,941,109,170,279,1.910828025477707,38.895480889451655
Task_2548,1023,383,29,40,69,2.6640625,22.41547156555104
Task_2549,1583,922,113,57,170,1.715059588299025,34.38101822525148
Task_2550,1690,81,163,65,228,20.609756097560975,32.99300056582876
Task_2551,2759,858,62,73,135,3.2118742724097786,52.81809565268809
Task_2552,858,990,31,48,79,0.8657921291624622,22.031332574008967
Task_2553,2256,122,111,139,250,18.341463414634145,42.90516206325086
Task_2554,2818,479,112,25,137,5.870833333333334,52.0006024347225
Task_2555,1342,260,85,42,127,5.14176245210728,27.91622183314225
Task_2556,2467,135,174,96,270,18.139705882352942,46.35947134093255
Task_2557,1343,561,87,124,211,2.389679715302491,30.056347405919563
Task_2558,1158,70,145,87,232,16.309859154929576,25.02603510490697
Task_2559,2501,421,140,188,328,5.92654028436019,48.60006571139947
Task_2560,2673,248,142,179,321,10.734939759036145,50.6759638761749
Task_2561,679,366,199,15,214,1.8501362397820162,18.239854675328456
Task_2562,2901,560,52,83,135,5.171122994652406,54.27634595597001
Task_2563,807,605,146,150,296,1.3316831683168318,22.119958509598337
Task_2564,2044,606,60,22,82,3.367380560131796,39.525356134829
Task_2565,982,293,86,188,274,3.3401360544217686,23.86846863508298
Task_2566,1656,169,82,37,119,9.741176470588234,32.14266602293995
Task_2567,1898,901,73,141,214,2.104212860310421,40.04844326431993
Task_2568,594,364,126,114,240,1.6273972602739726,17.72362277802439
Task_2569,2771,854,187,124,311,3.24093567251462,54.08652293132146
Task_2570,1553,795,101,83,184,1.9510050251256281,33.85757511532018
Task_2571,2361,163,177,35,212,14.396341463414634,44.02423776570714
Task_2572,664,719,46,101,147,0.9222222222222223,19.32200101706952
Task_2573,1696,992,155,180,335,1.7079556898288015,37.65942232532626
Task_2574,1791,112,43,105,148,15.849557522123893,34.498712541548336
Task_2575,1559,266,34,185,219,5.8389513108614235,32.69838557915816
Task_2576,2056,519,17,81,98,3.953846153846154,40.13561443930999
Task_2577,2453,462,78,21,99,5.29805615550756,45.71077499455521
Task_2578,812,782,77,188,265,1.037037037037037,22.675577054463947
Task_2579,2710,958,45,154,199,2.8258602711157454,53.01255009845829
Task_2580,755,688,137,59,196,1.0957910014513788,20.68160418347856
Task_2581,1654,515,124,147,271,3.205426356589147,35.17922641449721
Task_2582,2113,486,168,22,190,4.338809034907597,41.23259902222979
Task_2583,1735,212,111,197,308,8.145539906103286,35.69453112042576
Task_2584,1376,329,113,36,149,4.16969696969697,28.866695518834444
Task_2585,1352,311,200,27,227,4.333333333333333,28.841782952972384
Task_2586,2389,486,166,142,308,4.905544147843942,46.88184085617055
Task_2587,1173,423,165,115,280,2.766509433962264,27.26685846321894
Task_2588,2129,373,198,123,321,5.692513368983957,42.42834539109474
Task_2589,1106,410,111,79,190,2.6909975669099757,25.59966365219137
Task_2590,1496,939,189,148,337,1.5914893617021277,34.25744499700917
Task_2591,2703,936,88,85,173,2.8847385272145143,52.43417356487947
Task_2592,2459,221,14,177,191,11.076576576576576,46.58766698928175
Task_2593,2764,898,150,18,168,3.0745272525027807,52.692495196200916
Task_2594,2461,684,73,111,184,3.5927007299270075,48.0714009027375
Task_2595,521,700,98,60,158,0.7432239657631954,16.742720230059643
Task_2596,2153,153,191,167,358,13.980519480519481,42.04927481481612
Task_2597,855,89,19,198,217,9.5,20.51596183066436
Task_2598,984,1006,131,154,285,0.9771598808341608,26.135853001813246
Task_2599,1675,876,30,82,112,1.9099201824401368,35.569429573414865
Task_2600,2067,497,111,133,244,4.150602409638554,41.51809881358196
Task_2601,2762,663,85,187,272,4.159638554216867,53.264483766762076
Task_2602,2687,472,157,44,201,5.680761099365751,50.408697622177066
Task_2603,557,563,80,176,256,0.9875886524822695,17.914305493357826
Task_2604,2757,494,17,84,101,5.569696969696969,51.276793970750504
Task_2605,1601,471,55,160,215,3.391949152542373,34.03649977627765
Task_2606,2567,947,25,176,201,2.707805907172996,50.71102519220071
Task_2607,1183,577,15,152,167,2.046712802768166,27.39229346341713
Task_2608,1173,166,155,127,282,7.023952095808383,26.234691425885654
Task_2609,919,273,43,151,194,3.354014598540146,22.448972018807556
Task_2610,2372,323,73,20,93,7.320987654320987,43.982195522968844
Task_2611,1950,704,179,113,292,2.765957446808511,40.507591029118444
Task_2612,1732,343,120,68,188,5.034883720930233,35.071322194743864
Task_2613,1680,202,130,61,191,8.275862068965518,33.73387449894341
Task_2614,2892,81,157,149,306,35.26829268292683,52.748659892120976
Task_2615,1490,195,166,163,329,7.6020408163265305,31.811553205122053
Task_2616,1859,667,127,60,187,2.782934131736527,38.05612033159552
Task_2617,660,706,82,98,180,0.9335219236209336,19.50102847597169
Task_2618,1855,380,44,55,99,4.868766404199475,36.235390927500866
Task_2619,2836,78,197,65,262,35.89873417721519,51.1053567424924
Task_2620,870,571,110,52,162,1.520979020979021,21.95335377523678
Task_2621,668,664,134,120,254,1.0045112781954888,19.836741568115677
Task_2622,1936,804,64,100,164,2.404968944099379,40.02566122097762
Task_2623,1992,711,13,46,59,2.797752808988764,38.842977688983275
Task_2624,2289,530,143,190,333,4.3107344632768365,45.62328750873388
Task_2625,1761,491,81,49,130,3.5792682926829267,35.48434783080119
Task_2626,2076,788,159,109,268,2.6311787072243344,42.652725584553586
Task_2627,657,153,183,161,344,4.266233766233766,18.399620281812506
Task_2628,906,797,131,104,235,1.1353383458646618,23.919668590824255
Task_2629,1366,673,35,170,205,2.026706231454006,30.86567884865499
Task_2630,1599,739,36,169,205,2.1608108108108106,34.76149136965082
Task_2631,1640,700,200,32,232,2.339514978601997,34.69371142062207
Task_2632,2255,344,28,140,168,6.536231884057971,43.60539802890986
Task_2633,2452,888,87,93,180,2.7581552305961754,48.43163159980389
Task_2634,2835,674,32,65,97,4.2,52.87062542871726
Task_2635,1773,286,28,49,77,6.177700348432055,34.10475653881439
Task_2636,769,626,199,102,301,1.226475279106858,21.518008083201863
Task_2637,2678,819,84,85,169,3.265853658536585,51.70447003866186
Task_2638,1747,195,124,58,182,8.91326530612245,34.73086718861754
Task_2639,839,119,33,35,68,6.991666666666666,18.441658410603903
Task_2640,1782,92,42,89,131,19.161290322580644,34.186297378772714
Task_2641,1168,354,19,16,35,3.2901408450704226,24.27223467835806
Task_2642,2248,928,187,150,337,2.419806243272336,46.1861005062388
Task_2643,1299,568,195,157,352,2.282952548330404,30.105195548648513
Task_2644,1174,513,73,31,104,2.2840466926070038,25.78965158059167
Task_2645,842,164,194,189,383,5.1030303030303035,21.569223567289555
Task_2646,1209,957,124,37,161,1.2620041753653444,28.250620391635735
Task_2647,2375,403,14,133,147,5.878712871287129,45.45465155127558
Task_2648,2799,809,75,141,216,3.4555555555555557,54.05046000603548
Task_2649,2921,149,12,113,125,19.473333333333333,52.44337359185662
Task_2650,2380,665,170,81,251,3.5735735735735736,46.86009630537776
Task_2651,730,284,67,153,220,2.56140350877193,19.675163638107946
Task_2652,2505,835,104,39,143,2.9964114832535884,48.29755568812883
Task_2653,1570,561,177,60,237,2.793594306049822,33.39021627014816
Task_2654,1180,682,124,81,205,1.7276720351390922,27.689436285077907
Task_2655,1341,999,85,152,237,1.341,31.53173411576164
Task_2656,1378,117,70,125,195,11.677966101694915,28.836489634790492
Task_2657,2797,563,50,163,213,4.959219858156028,53.29060279301544
Task_2658,1090,963,24,193,217,1.1307053941908713,27.363380232392227
Task_2659,790,959,128,101,229,0.8229166666666666,22.589936466900426
Task_2660,2030,177,178,114,292,11.404494382022472,39.77711934408973
Task_2661,537,755,146,74,220,0.7103174603174603,17.856205012594888
Task_2662,1112,95,195,162,357,11.583333333333334,25.135444987574605
Task_2663,1557,441,72,86,158,3.52262443438914,32.68799014478807
Task_2664,547,235,23,98,121,2.3177966101694913,15.768761322521756
Task_2665,1590,278,136,94,230,5.698924731182796,33.12675332434797
Task_2666,2549,620,200,188,388,4.1046698872785825,50.27259858237225
Task_2667,2060,156,183,110,293,13.121019108280255,40.22655696365804
Task_2668,2931,365,133,189,322,8.008196721311476,55.19048226341183
Task_2669,2282,197,87,42,129,11.525252525252526,42.645527990751376
Task_2670,2012,976,112,148,260,2.059365404298874,42.245806097882735
Task_2671,1007,315,28,67,95,3.1867088607594938,22.777650092305976
Task_2672,1151,744,39,186,225,1.54496644295302,27.751269396602808
Task_2673,1066,705,166,174,340,1.5099150141643058,26.770789976934157
Task_2674,1460,688,27,174,201,2.1190130624092887,32.365109443595884
Task_2675,834,119,20,118,138,6.95,19.48548615749715
Task_2676,2637,674,130,16,146,3.9066666666666667,49.849663045268024
Task_2677,2444,116,190,80,270,20.88888888888889,45.58706385685314
Task_2678,2187,246,186,28,214,8.854251012145749,41.77760056467104
Task_2679,1262,581,35,179,214,2.1683848797250858,28.984536672849526
Task_2680,803,793,81,89,170,1.0113350125944585,21.873611483733978
Task_2681,1345,167,137,133,270,8.005952380952381,28.908222330313748
Task_2682,972,169,30,34,64,5.7176470588235295,20.91807511529579
Task_2683,2756,644,161,26,187,4.272868217054263,51.94298051602424
Task_2684,2992,648,35,172,207,4.610169491525424,56.55293121673726
Task_2685,927,997,111,131,242,0.9288577154308617,24.988724306094298
Task_2686,2946,572,132,158,290,5.141361256544503,55.92050664309287
Task_2687,932,86,77,133,210,10.71264367816092,21.703655556470554
Task_2688,878,456,109,126,235,1.9212253829321664,22.51544544521478
Task_2689,2918,645,65,52,117,4.5170278637770895,54.20591461258152
Task_2690,1770,275,26,32,58,6.413043478260869,33.85607453194254
Task_2691,1691,451,72,165,237,3.7411504424778763,35.49397559260442
Task_2692,2229,108,145,13,158,20.44954128440367,40.922994007324384
Task_2693,910,484,95,138,233,1.8762886597938144,23.128749648809457
Task_2694,1731,844,121,11,132,2.048520710059172,35.91452979798141
Task_2695,603,486,173,20,193,1.2381930184804928,17.347706477934146
Task_2696,1591,64,134,65,199,24.476923076923075,31.33072444297709
Task_2697,798,300,85,150,235,2.6511627906976742,20.796367204940264
Task_2698,2368,172,14,65,79,13.6878612716763,43.32786055353203
Task_2699,1358,934,123,183,306,1.4524064171122995,31.956735309091453
Task_2700,1260,142,146,148,294,8.811188811188812,27.59167656697632
Task_2701,1236,333,21,168,189,3.7005988023952097,27.620890424270318
Task_2702,2684,122,32,41,73,21.821138211382113,47.50560119429037
Task_2703,1777,424,137,65,202,4.181176470588236,36.14219954908975
Task_2704,2635,505,49,121,170,5.207509881422925,50.23288913370743
Task_2705,792,589,97,152,249,1.3423728813559321,21.619352111413388
Task_2706,598,535,100,44,144,1.1156716417910448,17.13920285333323
Task_2707,2212,254,161,85,246,8.674509803921568,42.86127210751363
Task_2708,1788,412,42,104,146,4.329297820823244,36.1844496129064
Task_2709,2206,867,171,168,339,2.5414746543778803,45.36574732157698
Task_2710,2174,202,16,116,132,10.70935960591133,41.504060602286266
Task_2711,2328,1013,10,14,24,2.2958579881656807,44.649901969397604
Task_2712,1881,633,120,75,195,2.966876971608833,38.52018513089563
Task_2713,2909,822,37,30,67,3.534629404617254,53.66843922502463
Task_2714,1284,623,64,115,179,2.0576923076923075,29.243133199823237
Task_2715,1089,973,43,31,74,1.1180698151950719,25.425561481958606
Task_2716,1230,293,14,180,194,4.183673469387755,27.440195658986273
Task_2717,2221,536,36,51,87,4.1359404096834265,42.48788251997292
Task_2718,1744,131,87,80,167,13.212121212121213,34.1841001222159
Task_2719,958,132,65,106,171,7.203007518796992,22.077428803124945
Task_2720,2157,195,91,189,280,11.005102040816327,42.15634197424997
Task_2721,1881,525,47,143,190,3.576045627376426,38.471121659742806
Task_2722,2595,277,123,48,171,9.33453237410072,48.14914508168002
Task_2723,1100,773,118,151,269,1.421188630490956,27.155816564580615
Task_2724,1955,536,183,22,205,3.640595903165736,38.96166822125781
Task_2725,2825,386,112,168,280,7.299741602067184,53.36468614624554
Task_2726,1016,982,131,190,321,1.0335707019328586,26.757601152268098
Task_2727,649,645,44,76,120,1.0046439628482973,18.453217045674688
Task_2728,1073,236,148,120,268,4.527426160337553,25.030995015421507
Task_2729,2347,933,48,27,75,2.512847965738758,45.12238821254454
Task_2730,1117,566,13,62,75,1.9700176366843034,24.776649300963594
Task_2731,1773,290,131,114,245,6.092783505154639,36.16390524514593
Task_2732,2353,541,126,150,276,4.341328413284133,46.35631427446774
Task_2733,2113,810,183,164,347,2.6054254007398274,43.74439585524942
Task_2734,532,392,72,183,255,1.3536895674300256,17.01804572355361
Task_2735,1128,440,118,135,253,2.557823129251701,26.516228921640643
Task_2736,1438,317,116,90,206,4.522012578616352,30.714951268535007
Task_2737,1119,682,44,146,190,1.638360175695461,26.86452200202956
Task_2738,595,597,71,123,194,0.9949832775919732,18.272119070041768
Task_2739,1951,864,52,109,161,2.255491329479769,40.33193353320819
Task_2740,2194,372,146,168,314,5.882037533512064,43.48778214888657
Task_2741,1537,703,25,30,55,2.1832386363636362,31.53518217774045
Task_2742,2027,498,184,96,280,4.062124248496994,41.024380863225275
Task_2743,2833,822,112,72,184,3.44228432563791,54.063923813891286
Task_2744,2219,316,172,84,256,7.0,43.23537990770341
Task_2745,1621,506,70,149,219,3.1972386587771204,34.469213067875565
Task_2746,1873,775,63,118,181,2.413659793814433,39.04643899185546
Task_2747,2964,293,66,98,164,10.081632653061224,54.651583247457374
Task_2748,2332,626,78,68,146,3.719298245614035,45.33467466374473
Task_2749,1056,550,190,199,389,1.9165154264972777,26.429282673036493
Task_2750,1164,367,47,149,196,3.1630434782608696,26.65702077414912
Task_2751,2379,565,39,37,76,4.203180212014134,44.51106170971457
Task_2752,2586,164,107,154,261,15.672727272727272,48.46631465020908
Task_2753,2926,1008,160,149,309,2.8999008919722495,57.051872157511944
Task_2754,1522,347,61,118,179,4.373563218390805,32.134445081323285
Task_2755,2014,767,138,140,278,2.6223958333333335,41.695301402869276
Task_2756,1203,800,142,160,302,1.5018726591760299,29.04449146808579
Task_2757,2705,741,59,41,100,3.6455525606469004,50.60960045007268
Task_2758,2688,800,46,63,109,3.355805243445693,51.09813894253714
Task_2759,2038,317,26,160,186,6.408805031446541,40.2030453171009
Task_2760,1504,419,50,130,180,3.580952380952381,32.13597520596121
Task_2761,937,895,187,19,206,1.0457589285714286,23.965580976956563
Task_2762,1670,444,97,161,258,3.752808988764045,35.175681110066016
Task_2763,858,926,24,138,162,0.9255663430420712,23.124842752629423
Task_2764,657,900,121,164,285,0.7291897891231964,20.705430128028876
Task_2765,2513,633,191,84,275,3.9637223974763405,49.00738648309422
Task_2766,535,945,177,36,213,0.5655391120507399,18.13223327526248
Task_2767,710,991,66,142,208,0.7157258064516129,21.56981790753497
Task_2768,2915,998,116,165,281,2.9179179179179178,56.743600166880526
Task_2769,1697,415,21,44,65,4.079326923076923,33.18334628633379
Task_2770,1009,982,49,94,143,1.0264496439471007,25.63484897509788
Task_2771,2219,363,13,143,156,6.096153846153846,42.88993165584103
Task_2772,1091,587,131,80,211,1.8554421768707483,26.02311036203086
Task_2773,822,204,176,156,332,4.009756097560976,21.300400398963923
Task_2774,2889,183,189,81,270,15.701086956521738,53.325022775239724
Task_2775,1404,116,98,200,298,12.0,29.723552713769024
Task_2776,1467,794,61,65,126,1.8452830188679246,32.06791228668007
Task_2777,1819,388,183,121,304,4.676092544987147,37.49346864663789
Task_2778,2002,803,150,15,165,2.490049751243781,40.35129408224025
Task_2779,1445,906,72,165,237,1.5931642778390298,33.01144870682084
Task_2780,904,72,43,193,236,12.383561643835616,21.309967972441427
Task_2781,967,736,199,152,351,1.3120759837177747,25.312013027465483
Task_2782,2150,420,89,18,107,5.10688836104513,40.88462277537519
Task_2783,2730,656,92,141,233,4.155251141552512,52.493846871386204
Task_2784,1313,526,53,184,237,2.49146110056926,29.788135597529998
Task_2785,1053,512,22,189,211,2.0526315789473686,25.42747653910294
Task_2786,1784,291,18,51,69,6.109589041095891,34.3787004649924
Task_2787,957,475,63,11,74,2.0105042016806722,21.49162181407615
Task_2788,2781,205,13,93,106,13.5,50.73617009310965
Task_2789,1339,308,191,90,281,4.333333333333333,29.457858582402253
Task_2790,2382,146,80,28,108,16.20408163265306,43.353942670906044
Task_2791,1878,112,159,147,306,16.61946902654867,37.09970833708663
Task_2792,2989,69,97,32,129,42.7,52.15377298689726
Task_2793,1979,164,24,184,208,11.993939393939394,38.63266765214659
Task_2794,1742,865,105,153,258,2.0115473441108547,37.6205526994236
Task_2795,2401,926,60,78,138,2.5900755124056096,47.46388562335235
Task_2796,1763,943,154,27,181,1.867584745762712,37.117570163284185
Task_2797,840,910,20,20,40,0.9220636663007684,21.106709355461273
Task_2798,1676,1019,42,156,198,1.6431372549019607,36.79023255296885
Task_2799,1626,207,153,143,296,7.8173076923076925,33.822036324489694
Task_2800,836,238,58,191,249,3.497907949790795,21.382139024011682
Task_2801,1829,441,17,116,133,4.138009049773756,36.853548205891926
Task_2802,808,694,81,145,226,1.162589928057554,22.10373803294949
Task_2803,1600,612,148,67,215,2.6101141924959217,33.985968847064655
Task_2804,2678,674,110,129,239,3.9674074074074075,51.72908980451657
Task_2805,2702,545,67,104,171,4.948717948717949,51.37075679627778
Task_2806,1970,768,17,142,159,2.5617685305591675,40.23391602767774
Task_2807,1316,381,129,128,257,3.445026178010471,29.310777898076534
Task_2808,1011,340,94,110,204,2.964809384164223,24.099138866490467
Task_2809,1438,204,33,37,70,7.014634146341463,28.4165380858249
Task_2810,2410,647,84,14,98,3.7191358024691357,45.63399215377786
Task_2811,1234,766,88,140,228,1.6088657105606259,29.055233713800813
Task_2812,1836,590,26,47,73,3.1065989847715736,36.00084376501989
Task_2813,1683,582,164,66,230,2.8867924528301887,35.26910954949969
Task_2814,1286,485,79,108,187,2.646090534979424,28.868995486855287
Task_2815,1875,492,112,100,212,3.8032454361054766,38.269937562396215
Task_2816,2557,445,155,125,280,5.733183856502242,49.25654486788219
Task_2817,1319,1007,186,175,361,1.308531746031746,31.807993470841712
Task_2818,2656,699,169,92,261,3.7942857142857145,51.45284131113826
Task_2819,1276,189,136,101,237,6.71578947368421,27.9104931747313
Task_2820,590,894,41,33,74,0.659217877094972,17.485379409412364
Task_2821,2163,185,176,132,308,11.629032258064516,42.182700955701414
Task_2822,951,759,113,118,231,1.2513157894736842,24.521633893295768
Task_2823,2310,895,192,171,363,2.578125,47.21357802929549
Task_2824,1521,226,99,85,184,6.700440528634362,31.529260830865372
Task_2825,2383,575,57,35,92,4.137152777777778,44.92553713762887
Task_2826,2169,154,20,46,66,13.993548387096775,39.73056382149897
Task_2827,2194,975,170,193,363,2.247950819672131,45.65697933027017
Task_2828,674,347,190,119,309,1.9367816091954022,19.267234370981797
Task_2829,2096,108,118,83,201,19.229357798165136,39.758220490601694
Task_2830,2713,710,41,119,160,3.8157524613220817,51.853430656345914
Task_2831,2709,507,198,86,284,5.332677165354331,51.75920136479768
Task_2832,676,487,194,90,284,1.3852459016393444,19.50147806012023
Task_2833,1266,829,136,140,276,1.5253012048192771,29.986163116493174
Task_2834,1650,878,155,25,180,1.8771331058020477,35.111208713558554
Task_2835,892,895,21,115,136,0.9955357142857143,23.373507517956266
Task_2836,1387,837,118,34,152,1.6551312649164678,30.603252700669184
Task_2837,2848,625,176,72,248,4.5495207667731625,54.002336930332426
Task_2838,827,120,186,95,281,6.8347107438016526,20.504152920462523
Task_2839,1273,691,109,103,212,1.8395953757225434,29.36787438879527
Task_2840,2271,355,158,171,329,6.379213483146067,44.721109127070285
Task_2841,2800,621,107,87,194,4.501607717041801,53.165205311526314
Task_2842,1096,743,72,105,177,1.4731182795698925,26.555671864073712
Task_2843,1917,756,128,96,224,2.532364597093791,39.844627391832766
Task_2844,1069,395,85,159,244,2.6994949494949494,25.4403403925706
Task_2845,2418,972,70,110,180,2.4850976361767727,48.29746832471357
Task_2846,1580,837,192,181,373,1.8854415274463008,35.52601475740344
Task_2847,2817,825,19,67,86,3.4104116222760292,52.96562881544042
Task_2848,1371,739,61,25,86,1.8527027027027028,29.308066828468114
Task_2849,2107,814,35,119,154,2.585276073619632,42.52292019520328
Task_2850,2745,691,52,106,158,3.9667630057803467,52.32530536440289
Task_2851,1412,460,185,191,376,3.062906724511931,31.711272123383285
Task_2852,2918,246,38,80,118,11.813765182186234,53.23549655336408
Task_2853,2040,934,145,22,167,2.1818181818181817,41.3735557796646
Task_2854,2738,383,65,66,131,7.130208333333333,50.917606926141985
Task_2855,1289,116,142,131,273,11.017094017094017,27.701262739637897
Task_2856,2259,456,40,120,160,4.9431072210065645,43.85141598524021
Task_2857,1329,66,68,23,91,19.83582089552239,25.50520968467806
Task_2858,2683,996,72,45,117,2.691073219658977,51.28670344571916
Task_2859,1324,636,40,59,99,2.0784929356357926,28.632360860958233
Task_2860,2595,586,182,167,349,4.420783645655877,50.686184830654234
Task_2861,1152,583,47,27,74,1.9726027397260273,25.10547309674269
Task_2862,2964,959,40,195,235,3.0875,57.244792588047346
Task_2863,1312,766,112,157,269,1.7105606258148631,30.541846727007567
Task_2864,2896,872,75,157,232,3.3172966781214206,55.880645493391086
Task_2865,970,601,147,88,235,1.611295681063123,24.301454265579704
Task_2866,1162,1014,64,98,162,1.1448275862068966,28.246752657085448
Task_2867,1376,552,71,48,119,2.488245931283906,29.283950647954242
Task_2868,2673,889,153,192,345,3.0033707865168537,52.89627313564815
Task_2869,754,390,56,118,174,1.9283887468030692,20.102514222163034
Task_2870,1156,940,118,194,312,1.228480340063762,28.806995886836265
Task_2871,1189,558,125,54,179,2.1270125223613596,27.089029830798392
Task_2872,2460,223,190,180,370,10.982142857142858,47.43872760152376
Task_2873,890,149,66,184,250,5.933333333333334,21.74879296516821
Task_2874,1601,189,99,118,217,8.426315789473684,32.9754309944891
Task_2875,1274,696,85,164,249,1.8278335724533716,29.66150292611606
Task_2876,1388,136,160,138,298,10.13138686131387,29.54632795288762
Task_2877,2647,568,114,145,259,4.6520210896309315,51.0141646885858
Task_2878,732,744,174,49,223,0.9825503355704698,20.58550989865071
Task_2879,2450,736,52,96,148,3.324287652645862,47.80771547812591
Task_2880,1938,873,179,192,371,2.217391304347826,41.31748719241628
Task_2881,908,870,174,66,240,1.04247990815155,23.92372899804657
Task_2882,772,408,78,190,268,1.8875305623471883,20.99639525763538
Task_2883,682,192,106,122,228,3.533678756476684,18.530886499709908
Task_2884,706,263,60,188,248,2.6742424242424243,19.40048819289215
Task_2885,2036,727,192,102,294,2.7967032967032965,41.934929585867174
Task_2886,1351,437,158,82,240,3.084474885844749,29.828666234913758
Task_2887,884,152,60,47,107,5.777777777777778,19.57296935778921
Task_2888,2800,600,172,103,275,4.658901830282862,53.55001971594297
Task_2889,1050,432,126,60,186,2.4249422632794455,24.497642158546274
Task_2890,2701,328,48,27,75,8.209726443768997,48.78747754040456
Task_2891,1954,760,118,188,306,2.5676741130091982,40.91942959552227
Task_2892,1207,602,200,45,245,2.001658374792703,27.58204757299312
Task_2893,1031,578,116,181,297,1.7806563039723662,25.66650203179053
Task_2894,593,601,125,153,278,0.9850498338870431,18.661938722484702
Task_2895,1581,328,100,151,251,4.805471124620061,33.33666824524137
Task_2896,1221,128,125,197,322,9.465116279069768,27.076574736735967
Task_2897,1407,727,116,65,181,1.9326923076923077,31.110270518344606
Task_2898,1227,501,127,189,316,2.444223107569721,28.639137121183783
Task_2899,602,374,147,34,181,1.6053333333333333,17.001319295138096
Task_2900,1291,341,87,12,99,3.7748538011695905,26.92187892117538
Task_2901,515,1006,113,78,191,0.5114200595829196,18.351635402337173
Task_2902,560,974,104,39,143,0.5743589743589743,18.230924773830523
Task_2903,2967,421,84,158,242,7.030805687203792,55.55302458465932
Task_2904,2884,719,162,45,207,4.0055555555555555,54.34092342345543
Task_2905,1640,175,27,11,38,9.318181818181818,31.13761811708869
Task_2906,1284,949,123,183,306,1.351578947368421,30.837582063123843
Task_2907,1041,735,172,55,227,1.4144021739130435,25.50875371959611
Task_2908,698,214,173,61,234,3.2465116279069766,18.46652607654619
Task_2909,2891,1004,91,57,148,2.876616915422886,55.24733908156707
Task_2910,1933,753,130,18,148,2.5636604774535807,38.931040316670156
Task_2911,2365,423,150,99,249,5.577830188679245,45.961877360422186
Task_2912,848,713,120,20,140,1.1876750700280112,21.578476003464164
Task_2913,2610,410,112,189,301,6.350364963503649,50.168380289786874
Task_2914,1348,893,164,154,318,1.5078299776286352,31.69383264090895
Task_2915,2566,546,25,37,62,4.691042047531993,47.36538076015588
Task_2916,843,716,161,183,344,1.1757322175732217,23.286746418490353
Task_2917,714,855,56,58,114,0.8341121495327103,19.908315839888076
Task_2918,2959,664,61,101,162,4.449624060150376,55.692158767898015
Task_2919,535,253,152,86,238,2.106299212598425,16.33584712162217
Task_2920,1475,812,64,127,191,1.8142681426814269,32.95548076471096
Task_2921,2623,933,151,69,220,2.808351177730193,51.21352170232356
Task_2922,2100,641,41,116,157,3.2710280373831777,41.910753495837035
Task_2923,596,989,156,178,334,0.602020202020202,20.332956676868438
Task_2924,1960,836,84,145,229,2.3416965352449224,40.85169715942776
Task_2925,1197,701,118,37,155,1.705128205128205,27.212396694191607
Task_2926,883,674,37,79,116,1.308148148148148,22.360011992856485
Task_2927,2737,409,26,15,41,6.675609756097561,49.339194099541565
Task_2928,922,312,51,78,129,2.9456869009584663,22.216079820064092
Task_2929,825,245,20,187,207,3.3536585365853657,20.95159022601003
Task_2930,1257,565,32,26,58,2.2208480565371023,26.69329186814362
Task_2931,675,161,136,30,166,4.166666666666667,17.210861423129124
Task_2932,2078,852,45,163,208,2.4361078546307153,42.72117522662041
Task_2933,1599,116,96,187,283,13.666666666666666,32.71800148483041
Task_2934,834,530,196,56,252,1.5706214689265536,21.702987009117123
Task_2935,1285,1016,173,86,259,1.263520157325467,30.63032349728554
Task_2936,2216,677,93,21,114,3.2684365781710913,42.89715169756321
Task_2937,2712,966,163,80,243,2.8045501551189247,53.03153637995269
Task_2938,2113,419,39,39,78,5.030952380952381,39.891631230921995
Task_2939,2709,573,67,160,227,4.719512195121951,51.96422257080338
Task_2940,2809,820,62,174,236,3.4214372716199755,54.38428991650736
Task_2941,2993,380,126,169,295,7.8556430446194225,56.07149876766848
Task_2942,2135,642,87,134,221,3.3203732503888026,42.91384946932137
Task_2943,2115,413,55,194,249,5.108695652173913,42.18764099954333
Task_2944,2879,341,160,104,264,8.41812865497076,53.89934226272347
Task_2945,2765,823,66,83,149,3.3555825242718447,53.059875563644766
Task_2946,759,603,31,149,180,1.2566225165562914,20.773824346501563
Task_2947,2982,525,88,124,212,5.669201520912548,55.89611080525055
Task_2948,1937,682,146,133,279,2.83601756954612,40.20333849136498
Task_2949,2398,295,17,71,88,8.10135135135135,44.64186497549565
Task_2950,2057,130,79,135,214,15.702290076335878,39.73425217715056
Task_2951,2850,349,158,186,344,8.142857142857142,53.949028374303815
Task_2952,619,956,94,113,207,0.6468129571577848,19.93315977748792
Task_2953,1737,325,83,57,140,5.328220858895706,34.76705820426616
Task_2954,2006,838,157,70,227,2.390941597139452,41.18019821046782
Task_2955,1402,892,87,38,125,1.5699888017917134,30.80311024610386
Task_2956,2842,769,168,146,314,3.690909090909091,54.99005425759365
Task_2957,820,568,158,98,256,1.4411247803163445,21.954700045084937
Task_2958,2023,934,149,136,285,2.1636363636363636,42.38457257399221
Task_2959,2366,261,166,142,308,9.030534351145038,45.76007841560164
Task_2960,2102,224,193,116,309,9.342222222222222,41.42000180760436
Task_2961,1037,752,103,178,281,1.3771580345285526,26.1861970780398
Task_2962,1481,455,29,99,128,3.2478070175438596,31.507805986147734
Task_2963,1519,817,173,148,321,1.8569682151589242,34.21458316006487
Task_2964,737,543,94,32,126,1.3547794117647058,19.36190507890667
Task_2965,2140,662,133,142,275,3.2277526395173455,43.35096972405429
Task_2966,1250,590,71,67,138,2.1150592216582065,28.000905918392103
Task_2967,1876,935,48,85,133,2.0042735042735043,39.244806809828894
Task_2968,2277,185,83,150,233,12.241935483870968,43.71618515557689
Task_2969,1769,885,185,148,333,1.9966139954853273,38.441291847547895
Task_2970,1440,1019,172,93,265,1.411764705882353,33.18635261617541
Task_2971,784,266,34,73,107,2.9363295880149813,19.32781861279616
Task_2972,710,1010,185,182,367,0.7022749752720079,22.32096419444925
Task_2973,2903,965,126,112,238,3.005175983436853,56.178887268251
Task_2974,2833,367,191,113,304,7.698369565217392,53.454424049974214
Task_2975,2508,611,197,108,305,4.098039215686274,49.10329199902227
Task_2976,1772,474,109,26,135,3.7305263157894735,35.44811839141791
Task_2977,888,809,98,94,192,1.0962962962962963,23.465481359883643
Task_2978,2748,256,39,89,128,10.69260700389105,50.92695563846143
Task_2979,1068,452,68,111,179,2.357615894039735,25.283187917772164
Task_2980,2600,292,42,175,217,8.873720136518772,49.22466425757381
Task_2981,2974,1006,43,56,99,2.9533267130089373,55.94870885023598
Task_2982,2261,678,26,164,190,3.329896907216495,44.94967720288917
Task_2983,1877,793,32,121,153,2.363979848866499,38.79226645955639
Task_2984,2356,322,54,158,212,7.294117647058823,45.47718956924399
Task_2985,1985,87,193,195,388,22.556818181818183,39.02266662844511
Task_2986,565,273,184,10,194,2.062043795620438,16.058605537548825
Task_2987,1940,829,111,61,172,2.3373493975903616,39.76627247068375
Task_2988,2669,70,32,39,71,37.59154929577465,46.343674651290826
Task_2989,2075,897,198,111,309,2.3106904231625833,43.16485253329356
Task_2990,886,907,122,71,193,0.9757709251101322,23.571279163106528
Task_2991,2185,284,147,172,319,7.666666666666667,43.074679783171426
Task_2992,2969,465,191,127,318,6.371244635193133,56.01767007002928
Task_2993,700,441,42,114,156,1.583710407239819,19.065774527365143
Task_2994,1222,364,86,62,148,3.347945205479452,26.77226499862148
Task_2995,1683,729,190,173,363,2.3054794520547945,36.76432232781912
Task_2996,2109,343,191,106,297,6.130813953488372,41.87883621734337
Task_2997,2214,593,86,49,135,3.727272727272727,42.97080863121348
Task_2998,1837,930,55,197,252,1.9731471535982814,39.43507610652909
Task_2999,2305,905,17,199,216,2.5441501103752757,46.50226721218013
Task_3000,1316,884,18,91,109,1.4870056497175141,29.762402938459996
Task_3001,2278,509,81,89,170,4.466666666666667,44.47414373622713
Task_3002,2780,838,139,75,214,3.3134684147794995,53.4934250679784
Task_3003,1087,826,90,100,190,1.3143893591293834,26.671754700224238
Task_3004,2360,613,122,134,256,3.8436482084690553,46.5830249333159
Task_3005,962,986,20,32,52,0.9746707193515705,23.495217346718903
Task_3006,852,528,35,78,113,1.610586011342155,21.49504462911699
Task_3007,1373,738,140,17,157,1.857916102841678,30.0296731082949
Task_3008,1024,740,200,190,390,1.3819163292847503,26.45186196998225
Task_3009,1227,926,16,62,78,1.3236245954692556,27.768791876881917
Task_3010,1788,782,69,153,222,2.2835249042145596,38.00088648264464
Task_3011,2469,438,22,18,40,5.624145785876993,45.18497004619707
Task_3012,2231,975,62,41,103,2.285860655737705,43.83415796961899
Task_3013,654,735,184,67,251,0.8885869565217391,19.595719483646487
Task_3014,2083,665,119,62,181,3.1276276276276276,41.568358722166145
Task_3015,1394,553,78,162,240,2.5162454873646207,31.131835611645542
Task_3016,1885,871,47,148,195,2.161697247706422,39.65389084122352
Task_3017,637,1008,84,193,277,0.6313181367690783,20.81666971397338
Task_3018,1233,663,41,13,54,1.8569277108433735,26.483189547921665
Task_3019,1475,947,176,151,327,1.5559071729957805,33.909887078618375
Task_3020,1858,194,60,184,244,9.528205128205128,37.30320309756189
Task_3021,914,109,162,189,351,8.309090909090909,22.171776861115813
Task_3022,1318,570,132,94,226,2.308231173380035,29.745462529769515
Task_3023,1338,699,192,197,389,1.9114285714285715,31.35797233597832
Task_3024,625,967,133,81,214,0.6456611570247934,19.970101614329348
Task_3025,1095,249,93,139,232,4.38,25.326342084206086
Task_3026,2180,291,88,66,154,7.465753424657534,41.603756399561235
Task_3027,1605,423,143,49,192,3.785377358490566,33.189118023041054
Task_3028,967,343,95,150,245,2.811046511627907,23.656249788415163
Task_3029,2116,513,17,32,49,4.116731517509727,40.06165946959384
Task_3030,1657,850,110,98,208,1.9471210340775558,35.92864411508564
Task_3031,2752,864,190,122,312,3.1815028901734106,53.81839560445756
Task_3032,2292,940,96,57,153,2.4357066950053134,45.500671082163315
Task_3033,1762,666,68,154,222,2.6416791604197902,37.22825265033082
Task_3034,1596,556,146,130,276,2.865350089766607,34.38824780125231
Task_3035,1527,231,20,198,218,6.581896551724138,32.05907574416306
Task_3036,1458,484,116,73,189,3.0061855670103093,31.26502748872387
Task_3037,2179,191,188,61,249,11.348958333333334,41.889469880024755
Task_3038,1621,755,189,19,208,2.144179894179894,34.36801066576333
Task_3039,1859,184,128,158,286,10.04864864864865,37.31197948838267
Task_3040,2165,513,61,124,185,4.212062256809339,42.87555460684334
Task_3041,1044,825,187,157,344,1.2639225181598064,26.769413767997065
Task_3042,1376,378,145,13,158,3.6306068601583115,28.949892538363898
Task_3043,2614,281,138,25,163,9.26950354609929,48.3668914851525
Task_3044,1791,275,164,63,227,6.489130434782608,35.95869481207453
Task_3045,1765,287,40,87,127,6.128472222222222,35.33835210824056
Task_3046,711,503,59,78,137,1.4107142857142858,19.32062105408026
Task_3047,685,756,79,40,119,0.904887714663144,18.949667149758817
Task_3048,748,333,153,176,329,2.2395209580838324,20.5669545041704
Task_3049,1926,530,41,41,82,3.6271186440677967,37.56325937332358
Task_3050,1054,409,123,165,288,2.5707317073170732,25.448566384202323
Task_3051,1750,287,174,161,335,6.076388888888889,36.26462653899085
Task_3052,715,725,192,60,252,0.9848484848484849,20.481874426366826
Task_3053,2846,631,17,124,141,4.503164556962025,53.56700863913701
Task_3054,2407,920,165,47,212,2.6134636264929423,47.47266864322205
Task_3055,2173,977,162,113,275,2.221881390593047,44.816528681938394
Task_3056,1843,811,140,200,340,2.269704433497537,39.49103142511458
Task_3057,1915,880,105,10,115,2.17366628830874,38.677354200994586
Task_3058,1717,827,160,108,268,2.073671497584541,37.08524403823303
Task_3059,1894,657,78,183,261,2.878419452887538,39.50279683870722
Task_3060,2790,257,167,52,219,10.813953488372093,51.65268753198145
Task_3061,652,486,118,101,219,1.3388090349075976,18.876266870340825
Task_3062,2095,442,158,179,337,4.729119638826185,42.270587633021215
Task_3063,1800,832,68,28,96,2.1608643457382954,36.643181814592474
Task_3064,1162,631,112,138,250,1.8386075949367089,27.645171191507714
Task_3065,2607,797,37,17,54,3.2669172932330826,48.68222984001511
Task_3066,1082,976,171,31,202,1.1074718526100307,26.566991004192364
Task_3067,2881,695,121,25,146,4.139367816091954,53.82948333603745
Task_3068,736,781,51,76,127,0.9411764705882353,20.65241542476364
Task_3069,1512,74,195,199,394,20.16,31.598424139726493
Task_3070,2459,1021,66,148,214,2.4060665362035225,49.33949294583429
Task_3071,704,264,167,200,367,2.6566037735849055,19.856670929103746
Task_3072,529,986,118,100,218,0.53596757852077,18.595962543413616
Task_3073,1401,492,177,97,274,2.841784989858012,31.069549714822355
Task_3074,2304,786,159,58,217,2.9275730622617533,45.64128644726191
Task_3075,2492,552,23,34,57,4.506329113924051,46.21966427193424
Task_3076,2095,531,103,158,261,3.93796992481203,42.183436575719966
Task_3077,1534,123,198,121,319,12.370967741935484,31.82850582387538
Task_3078,1293,776,111,24,135,1.664092664092664,28.77842639601481
Task_3079,2824,101,40,98,138,27.686274509803923,50.64907041541881
Task_3080,2631,144,141,172,313,18.144827586206898,49.331383913385025
Task_3081,2834,824,32,185,217,3.435151515151515,54.65378077411708
Task_3082,1442,135,82,51,133,10.602941176470589,28.871476443280176
Task_3083,2779,263,69,10,79,10.526515151515152,49.865083633254244
Task_3084,2716,387,16,91,107,7.0,50.366768005592405
Task_3085,1222,744,168,199,367,1.640268456375839,29.55090467563548
Task_3086,1769,172,54,96,150,10.22543352601156,34.744401092128875
Task_3087,1016,860,37,149,186,1.1800232288037167,25.68938272920518
Task_3088,1347,358,13,79,92,3.752089136490251,28.37046942703435
Task_3089,2035,470,174,128,302,4.320594479830149,41.17885732192948
Task_3090,1129,686,80,137,217,1.6433770014556042,27.183599459653948
Task_3091,1623,133,114,26,140,12.111940298507463,31.640311282224463
Task_3092,2042,908,140,30,170,2.2464246424642464,41.38313512500461
Task_3093,915,209,134,165,299,4.357142857142857,22.650005824662994
Task_3094,2634,733,148,88,236,3.5885558583106265,51.08579403028605
Task_3095,2206,487,24,45,69,4.520491803278689,41.478357162447224
Task_3096,2652,145,126,13,139,18.164383561643834,47.8503442758709
Task_3097,2828,240,39,71,110,11.734439834024895,51.60676096307774
Task_3098,2942,553,115,165,280,5.310469314079422,55.76115040958067
Task_3099,2079,887,108,85,193,2.3412162162162162,42.557146689766945
Task_3100,2733,627,144,95,239,4.351910828025478,52.41458178301094
Task_3101,2147,259,50,34,84,8.257692307692308,40.13871769524851
Task_3102,855,941,132,65,197,0.9076433121019108,23.213889958119882
Task_3103,1524,275,192,138,330,5.521739130434782,32.59521651473347
Task_3104,1049,452,75,134,209,2.315673289183223,25.168814930900997
Task_3105,2938,257,154,121,275,11.387596899224807,54.604654457050934
Task_3106,950,291,98,174,272,3.2534246575342465,23.370508683667907
Task_3107,1947,786,197,53,250,2.473951715374841,40.187630042541905
Task_3108,2086,428,71,169,240,4.862470862470863,41.69076578101399
Task_3109,2362,742,167,67,234,3.1790040376850603,46.54988503411886
Task_3110,1719,562,142,94,236,3.053285968028419,36.11517086294776
Task_3111,2949,425,108,104,212,6.922535211267606,55.057252725495154
Task_3112,1620,253,171,130,301,6.377952755905512,33.89447029168444
Task_3113,1356,579,19,42,61,2.3379310344827586,28.340676236776233
Task_3114,1456,1019,76,116,192,1.427450980392157,33.23233245242758
Task_3115,1102,991,165,102,267,1.1108870967741935,27.75756127877872
Task_3116,2784,115,89,183,272,24.0,51.26182674615231
Task_3117,514,469,33,70,103,1.0936170212765957,15.587659667191545
Task_3118,1336,94,133,195,328,14.063157894736841,28.56425651961752
Task_3119,1460,164,170,175,345,8.848484848484848,31.121655202833896
Task_3120,2602,158,144,41,185,16.364779874213838,47.63074978630335
Task_3121,2807,358,198,12,210,7.818941504178273,51.86875792444612
Task_3122,1435,961,109,65,174,1.4916839916839917,32.2409256285609
Task_3123,1594,156,68,92,160,10.152866242038217,32.00847138989214
Task_3124,2962,684,61,51,112,4.324087591240876,54.85799433259743
Task_3125,1057,1000,165,172,337,1.055944055944056,27.508707253446797
Task_3126,1634,844,67,147,214,1.9337278106508875,35.711397204257345
Task_3127,1692,358,198,47,245,4.713091922005571,34.518068338384445
Task_3128,1042,845,103,70,173,1.2316784869976358,25.632838779088313
Task_3129,1857,280,58,184,242,6.608540925266904,37.616411445123056
Task_3130,668,983,193,107,300,0.6788617886178862,21.178262728926683
Task_3131,2986,692,155,60,215,4.308802308802309,56.131771880291105
Task_3132,576,766,180,77,257,0.7509778357235984,18.53034835787943
Task_3133,1290,269,167,174,341,4.777777777777778,28.978938619270455
Task_3134,2752,124,29,39,68,22.016,48.528461563628944
Task_3135,583,765,163,171,334,0.7610966057441253,19.31946744971081
Task_3136,1539,647,170,146,316,2.375,33.97539161126249
Task_3137,1657,593,84,70,154,2.7895622895622894,34.41830337818874
Task_3138,2546,373,85,62,147,6.807486631016043,47.78508017401299
Task_3139,2944,189,103,159,262,15.494736842105263,54.42907549110717
Task_3140,2109,217,106,104,210,9.674311926605505,41.040494189932964
Task_3141,2105,614,16,106,122,3.4227642276422765,41.63525949481287
Task_3142,2895,686,84,26,110,4.213973799126638,53.61689732479487
Task_3143,1552,578,134,82,216,2.680483592400691,33.3489106455781
Task_3144,511,497,60,81,141,1.0261044176706828,16.19344891154817
Task_3145,2304,191,149,20,169,12.0,43.15856548441457
Task_3146,1092,187,167,60,227,5.808510638297872,24.639859513254795
Task_3147,594,233,49,190,239,2.5384615384615383,17.522784214872008
Task_3148,569,804,163,53,216,0.7068322981366459,18.409564575721173
Task_3149,2103,132,183,124,307,15.81203007518797,40.80163802460813
Task_3150,631,869,172,115,287,0.725287356321839,20.164769766281445
Task_3151,2644,548,130,165,295,4.816029143897996,51.09405783915196
Task_3152,1076,937,68,104,172,1.1471215351812367,26.793727454728415
Task_3153,1327,568,160,122,282,2.3321616871704745,30.181777281522145
Task_3154,1659,889,176,75,251,1.8640449438202247,36.057686422035125
Task_3155,2635,963,20,135,155,2.733402489626556,51.383612321443756
Task_3156,2832,490,82,34,116,5.767820773930754,52.04883471466959
Task_3157,2588,418,42,188,230,6.176610978520286,49.54192894672724
Task_3158,2127,534,27,162,189,3.9757009345794394,42.367968498077346
Task_3159,1211,340,105,39,144,3.5513196480938416,26.24455906411215
Task_3160,949,184,53,58,111,5.129729729729729,21.439257567864605
Task_3161,1323,627,191,63,254,2.106687898089172,29.8081603700101
Task_3162,2826,514,64,160,224,5.487378640776699,53.6088833289643
Task_3163,2174,905,58,124,182,2.3995584988962473,44.23715724779154
Task_3164,1267,772,57,66,123,1.6390685640362226,28.69882439269971
Task_3165,937,663,163,168,331,1.411144578313253,24.536365518794863
Task_3166,818,990,39,78,117,0.8254288597376388,22.286394971885112
Task_3167,2589,664,45,108,153,3.8932330827067667,49.67462382240162
Task_3168,955,431,103,38,141,2.2106481481481484,22.462922653994696
Task_3169,2203,473,125,164,289,4.647679324894515,43.842060041644345
Task_3170,1970,305,68,71,139,6.437908496732026,38.54722933505695
Task_3171,2859,431,165,94,259,6.618055555555555,53.843386314898886
Task_3172,2211,1001,83,94,177,2.2065868263473054,45.03434832347407
Task_3173,2365,619,166,169,335,3.814516129032258,47.088614782658965
Task_3174,2033,707,139,14,153,2.871468926553672,40.33876804627929
Task_3175,2756,701,107,58,165,3.925925925925926,52.320114227198474
Task_3176,1571,265,10,59,69,5.906015037593985,30.907857091295085
Task_3177,568,227,83,187,270,2.491228070175439,17.167562308248744
Task_3178,2059,945,196,192,388,2.1765327695560255,43.53557728083839
Task_3179,735,458,10,160,170,1.6013071895424837,19.918013564482006
Task_3180,1244,998,98,159,257,1.2452452452452452,30.086076360459188
Task_3181,2549,541,109,82,191,4.702952029520295,48.903817605668074
Task_3182,2546,921,134,144,278,2.761388286334056,50.61158823466002
Task_3183,2532,725,21,188,209,3.487603305785124,49.5105110649966
Task_3184,2548,915,54,175,229,2.7816593886462884,50.51916095089416
Task_3185,1227,349,175,149,324,3.505714285714286,28.132379122147295
Task_3186,2106,241,195,152,347,8.702479338842975,41.76984861563092
Task_3187,1368,237,112,26,138,5.7478991596638656,28.288069948388426
Task_3188,2774,531,107,99,206,5.214285714285714,52.593818023145694
Task_3189,1141,922,116,199,315,1.2361863488624052,28.534425865537845
Task_3190,2578,772,41,106,147,3.335058214747736,49.84237878185795
Task_3191,753,825,141,10,151,0.9116222760290557,20.59040325126176
Task_3192,611,336,200,81,281,1.8130563798219586,17.949965073129288
Task_3193,831,827,34,183,217,1.0036231884057971,22.80309757704397
Task_3194,1334,662,181,179,360,2.0120663650075414,31.022054605461083
Task_3195,2217,143,38,186,224,15.395833333333334,42.365318589035894
Task_3196,1455,209,35,127,162,6.928571428571429,30.394244900953794
Task_3197,1159,378,53,95,148,3.058047493403694,26.224865662617944
Task_3198,2746,748,52,124,176,3.6662216288384513,52.7950605137733
Task_3199,1462,392,36,179,215,3.7201017811704835,31.556295467505905
Task_3200,2705,209,182,112,294,12.880952380952381,50.80993666058356
Task_3201,1137,961,14,164,178,1.181912681912682,27.883414136318066
Task_3202,2025,231,105,180,285,8.72844827586207,40.215407879331735
Task_3203,2761,1004,87,79,166,2.74726368159204,53.5484398512283
Task_3204,2908,294,56,103,159,9.857627118644068,53.58957698490098
Task_3205,1757,219,141,30,171,7.986363636363636,34.653029586442706
Task_3206,933,240,41,61,102,3.871369294605809,21.27089601504124
Task_3207,2601,533,192,176,368,4.870786516853933,50.71010574920198
Task_3208,2319,990,58,81,139,2.340060544904137,46.400293300092414
Task_3209,1914,369,21,102,123,5.172972972972973,37.839420468194525
Task_3210,1056,276,150,126,276,3.812274368231047,24.940456898240683
Task_3211,2382,94,87,188,275,25.073684210526316,44.70032562872583
Task_3212,1263,769,20,134,154,1.6402597402597403,28.98338498329387
Task_3213,1876,537,20,89,109,3.486988847583643,37.607339977725466
Task_3214,1630,790,153,124,277,2.060682680151707,35.65561429062356
Task_3215,1202,527,112,85,197,2.2765151515151514,27.559352750671852
Task_3216,1368,115,49,53,102,11.793103448275861,27.199842322770014
Task_3217,956,910,79,164,243,1.0493962678375413,25.20668752790085
Task_3218,2642,266,53,53,106,9.895131086142323,48.378509014671145
Task_3219,1000,646,148,158,306,1.545595054095827,25.365140023166948
Task_3220,1020,937,181,91,272,1.0874200426439233,26.25709459867441
Task_3221,2264,911,120,102,222,2.482456140350877,45.797960303252864
Task_3222,2681,151,171,165,336,17.638157894736842,50.26387504610571
Task_3223,2601,100,72,65,137,25.752475247524753,46.942516875393125
Task_3224,2660,550,79,102,181,4.827586206896552,50.76989977870894
Task_3225,1246,476,155,125,280,2.6121593291404612,28.604927972427134
Task_3226,2249,318,54,57,111,7.0501567398119125,42.40686916879022
Task_3227,2462,840,168,146,314,2.9274673008323426,49.192576610343245
Task_3228,727,163,120,88,208,4.432926829268292,18.72791459794968
Task_3229,884,1009,62,199,261,0.8752475247524752,24.549234475183084
Task_3230,2011,83,189,132,321,23.94047619047619,39.001220670634616
Task_3231,1126,160,29,19,48,6.9937888198757765,23.08463630087006
Task_3232,2908,469,104,21,125,6.187234042553191,53.25479067230814
Task_3233,2734,146,88,73,161,18.598639455782312,49.524412411006814
Task_3234,1717,673,177,133,310,2.5474777448071215,36.83011168342491
Task_3235,688,628,98,72,170,1.0937996820349762,19.40775850135797
Task_3236,965,330,178,11,189,2.915407854984894,22.54149239444084
Task_3237,1705,562,198,51,249,3.02841918294849,35.58172449614561
Task_3238,1756,757,35,137,172,2.316622691292876,37.080405786941284
Task_3239,2314,328,28,58,86,7.033434650455927,43.25534704701018
Task_3240,1317,586,65,155,220,2.2436115843270867,29.918590636925618
Task_3241,1252,122,200,71,271,10.178861788617887,26.809337014388728
Task_3242,563,993,152,157,309,0.5663983903420523,19.646597814811987
Task_3243,1066,214,117,102,219,4.9581395348837205,24.59828224077769
Task_3244,1657,211,11,26,37,7.816037735849057,31.631530929369095
Task_3245,1864,802,50,179,229,2.3212951432129514,39.36276522912518
Task_3246,2368,245,57,179,236,9.626016260162602,45.52939919840811
Task_3247,1618,334,87,180,267,4.829850746268657,34.01655303303723
Task_3248,1243,929,49,152,201,1.3365591397849463,29.69554675780033
Task_3249,2049,630,37,23,60,3.2472266244057053,39.40171072848305
Task_3250,983,633,172,82,254,1.5504731861198737,24.642554218841557
Task_3251,2099,995,178,149,327,2.107429718875502,43.98698313793263
Task_3252,1198,572,27,64,91,2.0907504363001745,26.564061668550465
Task_3253,2197,457,81,124,205,4.796943231441048,43.311399235986414
Task_3254,1638,1003,14,150,164,1.6314741035856575,35.89677269696613
Task_3255,2126,818,151,152,303,2.595848595848596,43.759464429145396
Task_3256,2408,441,49,144,193,5.447963800904978,46.61697809363499
Task_3257,2971,948,23,100,123,3.130663856691254,56.4314907420601
Task_3258,1538,381,36,136,172,4.026178010471204,32.43796164682636
Task_3259,2317,232,107,196,303,9.944206008583691,44.93585283084294
Task_3260,2387,771,56,167,223,3.0919689119170983,47.478309714023645
Task_3261,1180,842,42,30,72,1.3997627520759193,26.39378345476575
Task_3262,1172,469,108,157,265,2.4936170212765956,27.39072393654917
Task_3263,1283,730,31,96,127,1.7551299589603284,29.130506276710424
Task_3264,1184,224,80,39,119,5.262222222222222,25.09563185364544
Task_3265,2246,955,49,118,167,2.3493723849372383,45.471157814273965
Task_3266,2039,752,109,198,307,2.7078353253652057,42.26012104908926
Task_3267,2435,306,37,90,127,7.931596091205212,46.029796570112985
Task_3268,2692,577,180,154,334,4.657439446366782,52.106806121004105
Task_3269,2212,867,171,59,230,2.5483870967741935,44.48663244809456
Task_3270,2809,394,161,138,299,7.111392405063291,53.1801080437502
Task_3271,1603,761,186,192,378,2.1036745406824147,35.6923498144586
Task_3272,1454,262,60,59,119,5.52851711026616,29.751096440830796
Task_3273,923,263,108,194,302,3.496212121212121,23.012568640675322
Task_3274,2113,997,135,16,151,2.117234468937876,42.53148833253253
Task_3275,2764,176,99,193,292,15.615819209039548,51.46850867061517
Task_3276,1320,809,47,38,85,1.6296296296296295,28.897401883834107
Task_3277,1811,128,113,94,207,14.03875968992248,35.674785217709115
Task_3278,2461,450,176,187,363,5.4567627494456765,48.21842026455644
Task_3279,2913,760,110,127,237,3.8278580814717476,55.711579782723085
Task_3280,1031,639,17,86,103,1.6109375,24.445490064141083
Task_3281,2426,297,73,31,104,8.140939597315436,44.893334681973535
Task_3282,974,432,41,175,216,2.2494226327944573,23.958237361074804
Task_3283,874,670,179,22,201,1.3025335320417288,22.254278252642504
Task_3284,608,972,116,124,240,0.6248715313463515,19.96768284478936
Task_3285,1153,398,147,27,174,2.889724310776942,25.7256517373695
Task_3286,1434,1013,55,173,228,1.4142011834319526,33.11353192865956
Task_3287,1067,878,13,194,207,1.2138794084186575,26.70259468797042
Task_3288,1129,566,22,161,183,1.9911816578483246,26.598684768963707
Task_3289,1733,653,125,189,314,2.649847094801223,37.120914194608126
Task_3290,873,488,82,102,184,1.7852760736196318,22.275893666634147
Task_3291,2024,196,11,143,154,10.274111675126903,39.188361705260725
Task_3292,1726,726,105,34,139,2.37414030261348,35.555209643092425
Task_3293,1029,313,129,129,258,3.2770700636942673,24.557650134448973
Task_3294,2648,367,130,13,143,7.195652173913044,48.97259716012309
Task_3295,694,811,121,162,283,0.854679802955665,20.944965023115486
Task_3296,1434,143,15,30,45,9.958333333333334,27.940294938427076
Task_3297,1697,108,122,117,239,15.568807339449542,33.865258452223785
Task_3298,1753,791,147,167,314,2.2133838383838382,37.83720160786087
Task_3299,2327,128,176,172,348,18.03875968992248,44.566348929193275
Task_3300,2207,124,157,71,228,17.656,41.6453434010378
Task_3301,2647,515,173,157,330,5.12984496124031,51.18123610677046
Task_3302,1825,127,33,125,158,14.2578125,35.283051657335264
Task_3303,1934,218,21,190,211,8.831050228310502,38.39314418940082
Task_3304,713,825,163,63,226,0.8631961259079903,20.677678259834575
Task_3305,1486,292,176,96,272,5.071672354948806,31.757130337072468
Task_3306,2077,252,143,18,161,8.209486166007904,39.64688252346819
Task_3307,2184,347,124,199,323,6.275862068965517,43.33207444995883
Task_3308,2774,624,176,27,203,4.4384,52.25143200188146
Task_3309,1832,555,190,91,281,3.2949640287769784,38.03244854578135
Task_3310,1110,907,57,44,101,1.222466960352423,25.916372918117673
Task_3311,1175,321,87,10,97,3.6490683229813663,25.05691068617857
Task_3312,2998,310,188,90,278,9.639871382636656,55.68327839284225
Task_3313,2160,989,153,99,252,2.1818181818181817,44.51769427122027
Task_3314,860,721,34,35,69,1.1911357340720221,20.990969176714742
Task_3315,2466,443,89,99,188,5.554054054054054,47.316417168415946
Task_3316,1011,188,55,142,197,5.349206349206349,23.688363214845243
Task_3317,1603,435,47,143,190,3.676605504587156,33.78289868012172
Task_3318,2625,721,171,150,321,3.6357340720221605,51.43849363053082
Task_3319,808,914,90,133,223,0.8830601092896175,22.724452223195545
Task_3320,1840,754,114,93,207,2.437086092715232,38.49279392647089
Task_3321,1861,599,184,32,216,3.1016666666666666,37.804652514046275
Task_3322,897,593,132,116,248,1.5101010101010102,23.245857737809846
Task_3323,947,157,146,180,326,5.993670886075949,22.940551761464988
Task_3324,1823,681,91,115,206,2.6730205278592374,38.038416366426624
Task_3325,620,790,13,83,96,0.7838179519595448,18.296441421348753
Task_3326,1992,226,148,65,213,8.775330396475772,38.921004576212
Task_3327,2971,489,83,20,103,6.063265306122449,54.04441995393199
Task_3328,2627,988,180,79,259,2.6562184024266937,51.82105896841699
Task_3329,654,945,38,139,177,0.6913319238900634,20.295641798796222
Task_3330,670,749,142,103,245,0.8933333333333333,20.11782174771253
Task_3331,1503,996,109,166,275,1.5075225677031092,34.293123745411854
Task_3332,2229,491,135,97,232,4.530487804878049,43.9849650652067
Task_3333,2520,291,13,68,81,8.63013698630137,46.469954764347
Task_3334,1756,179,88,88,176,9.755555555555556,34.75870581510432
Task_3335,2307,411,107,175,282,5.599514563106796,45.27070067850625
Task_3336,2962,637,35,128,163,4.6426332288401255,55.72419068701178
Task_3337,2486,420,59,72,131,5.904988123515439,47.12043724760886
Task_3338,2447,718,22,89,111,3.403337969401947,47.27855642989468
Task_3339,1041,948,115,35,150,1.0969441517386722,25.50214814227658
Task_3340,2964,732,118,83,201,4.043656207366985,56.13240582811994
Task_3341,1128,341,26,96,122,3.2982456140350878,25.31846492951999
Task_3342,2292,832,124,58,182,2.751500600240096,45.4090254799101
Task_3343,2728,87,185,182,367,31.0,50.56206718302059
Task_3344,1124,346,35,200,235,3.239193083573487,26.181320105167945
Task_3345,1758,451,156,39,195,3.8893805309734515,35.60935943879147
Task_3346,1586,453,98,24,122,3.4933920704845813,32.21063772855944
Task_3347,1714,785,122,42,164,2.1806615776081424,35.83568947575923
Task_3348,1905,86,85,49,134,21.896551724137932,35.38477442874226
Task_3349,1547,691,130,33,163,2.235549132947977,32.86405622937807
Task_3350,2618,471,46,68,114,5.546610169491525,49.11850672932951
Task_3351,662,250,80,124,204,2.637450199203187,18.354922232534097
Task_3352,2581,885,150,86,236,2.9130925507900676,50.713036438922245
Task_3353,2065,990,147,58,205,2.083753784056509,42.4366730480814
Task_3354,2020,215,56,95,151,9.351851851851851,39.26428826884833
Task_3355,855,947,58,121,179,0.9018987341772152,23.391740270393797
Task_3356,1807,454,70,103,173,3.9714285714285715,36.94023419002587
Task_3357,2117,261,190,90,280,8.080152671755725,41.591050974011786
Task_3358,1175,225,199,67,266,5.199115044247788,26.243195603731312
Task_3359,2339,863,161,124,285,2.707175925925926,47.152704275593045
Task_3360,2065,828,184,148,332,2.4909529553679133,42.94908252824532
Task_3361,2020,999,147,129,276,2.02,42.488324031234576
Task_3362,2927,424,57,192,249,6.8870588235294115,55.06796372741255
Task_3363,1204,1001,170,32,202,1.2015968063872255,28.598312472392063
Task_3364,2354,924,50,39,89,2.544864864864865,45.59652354582402
Task_3365,2275,844,84,34,118,2.6923076923076925,44.36411095044355
Task_3366,1534,169,51,43,94,9.023529411764706,30.021150721204105
Task_3367,2545,998,177,190,367,2.5475475475475475,51.30446093017264
Task_3368,1230,619,76,31,107,1.9838709677419355,27.01246235030807
Task_3369,743,460,66,140,206,1.6117136659436009,20.344954333419366
Task_3370,1613,734,75,25,100,2.1945578231292515,33.38614902874183
Task_3371,1348,730,95,21,116,1.844049247606019,29.28491922681687
Task_3372,1531,731,145,99,244,2.091530054644809,33.71191368243191
Task_3373,1279,265,41,26,67,4.80827067669173,26.072337916254124
Task_3374,546,685,92,118,210,0.7959183673469388,17.832261200916538
Task_3375,2403,67,196,95,291,35.338235294117645,44.914384221186936
Task_3376,1871,582,117,190,307,3.20926243567753,39.05272968273735
Task_3377,2959,851,41,36,77,3.473004694835681,54.626793143047
Task_3378,2559,197,33,87,120,12.924242424242424,47.44396101852502
Task_3379,1448,110,129,56,185,13.045045045045045,29.241012480827475
Task_3380,1308,460,42,19,61,2.8373101952277655,27.041462993020108
Task_3381,2810,225,110,144,254,12.43362831858407,52.39840369308441
Task_3382,1446,74,98,194,292,19.28,30.098009004703346
Task_3383,1154,1018,108,158,266,1.1324828263002944,28.752229453930216
Task_3384,2198,513,192,111,303,4.276264591439689,43.877017591316324
Task_3385,1225,1021,35,68,103,1.1986301369863013,28.584651776560417
Task_3386,2682,978,20,57,77,2.73953013278856,50.849057340377165
Task_3387,1695,813,135,128,263,2.0823095823095823,36.699853613547205
Task_3388,2654,349,138,181,319,7.582857142857143,50.72873579698313
Task_3389,2950,234,42,187,229,12.553191489361701,54.612003348682265
Task_3390,1874,848,12,135,147,2.2073027090694937,38.91716491684442
Task_3391,1937,852,82,54,136,2.2708089097303636,39.577634572683344
Task_3392,1185,194,55,24,79,6.076923076923077,24.553399540128225
Task_3393,2803,496,19,54,73,5.639839034205232,51.21443453189679
Task_3394,2777,287,150,33,183,9.64236111111111,51.0991384043759
Task_3395,1047,831,11,102,113,1.2584134615384615,25.42838756423514
Task_3396,2343,722,199,120,319,3.240663900414938,46.921496391748484
Task_3397,1559,568,48,177,225,2.739894551845343,33.73909099548017
Task_3398,1864,538,103,112,215,3.458256029684601,38.273460693158896
Task_3399,1566,611,89,25,114,2.5588235294117645,32.36284925686345
Task_3400,999,230,199,35,234,4.324675324675325,23.056064529686182
Task_3401,1138,367,187,18,205,3.092391304347826,25.47549895852963
Task_3402,2649,121,62,172,234,21.71311475409836,49.0887824083301
Task_3403,1189,132,147,44,191,8.93984962406015,25.19547107423659
Task_3404,1597,588,196,61,257,2.711375212224109,33.9894584991517
Task_3405,2012,67,135,72,207,29.58823529411765,37.999461300957954
Task_3406,1756,877,54,108,162,2.0,37.31636416303261
Task_3407,1835,765,78,71,149,2.39556135770235,37.92625341659712
Task_3408,2464,432,183,170,353,5.690531177829099,48.136979257284054
Task_3409,1989,248,31,41,72,7.9879518072289155,37.28096673187077
Task_3410,2444,256,73,67,140,9.509727626459144,45.81707479065485
Task_3411,768,232,58,187,245,3.296137339055794,20.264302835617467
Task_3412,1539,566,148,33,181,2.7142857142857144,32.419137584981605
Task_3413,1810,249,51,184,235,7.24,36.76238988902699
Task_3414,2559,713,138,152,290,3.5840336134453783,50.23097392200524
Task_3415,2302,647,148,87,235,3.552469135802469,45.54720592369873
Task_3416,1118,653,198,81,279,1.709480122324159,26.950566190972427
Task_3417,1662,281,64,171,235,5.8936170212765955,34.487346951825394
Task_3418,2660,832,196,140,336,3.19327731092437,52.39497707335173
Task_3419,2383,601,98,56,154,3.9584717607973423,45.898657642321666
Task_3420,2956,449,64,99,163,6.568888888888889,55.02412221763348
Task_3421,1593,781,110,73,183,2.0370843989769822,34.27779148840804
Task_3422,1247,413,193,16,209,3.0120772946859904,27.35509102890011
Task_3423,2087,627,198,45,243,3.323248407643312,41.588351048763435
Task_3424,1329,576,152,95,247,2.3032928942807627,30.054713485655654
Task_3425,2403,229,49,189,238,10.447826086956521,46.07573514608958
Task_3426,2865,937,67,29,96,3.0543710021321964,53.84244132676511
Task_3427,2308,735,119,80,199,3.135869565217391,45.709023836173685
Task_3428,2895,933,46,86,132,3.099571734475375,55.3574030773734
Task_3429,2512,93,31,102,133,26.72340425531915,45.60987126707777
Task_3430,1009,819,124,153,277,1.2304878048780488,25.88516013478113
Task_3431,678,495,145,38,183,1.3669354838709677,18.596763148510643
Task_3432,971,388,69,162,231,2.4961439588688945,23.879689834976144
Task_3433,2386,686,105,192,297,3.473071324599709,47.49561007052466
Task_3434,1593,66,148,10,158,23.776119402985074,30.322572584364014
Task_3435,2998,228,43,153,196,13.091703056768559,55.14791144110933
Task_3436,549,1003,26,191,217,0.546812749003984,19.04636867936691
Task_3437,1987,916,48,100,148,2.1668484187568158,40.96114649464333
Task_3438,1424,843,173,93,266,1.6872037914691944,32.43189151987784
Task_3439,2732,313,171,154,325,8.700636942675159,51.82518062225241
Task_3440,1675,894,61,185,246,1.8715083798882681,36.70908669621317
Task_3441,2868,238,102,190,292,12.0,53.60395227370784
Task_3442,2435,440,85,15,100,5.521541950113379,45.392148102629086
Task_3443,822,400,160,172,332,2.0498753117206983,21.95749718730363
Task_3444,2498,118,26,25,51,20.991596638655462,44.5000641446058
Task_3445,2848,989,32,54,86,2.8767676767676766,53.825368005263535
Task_3446,1098,554,115,168,283,1.9783783783783784,26.583654916684225
Task_3447,1888,733,23,197,220,2.5722070844686646,39.40241806948924
Task_3448,2142,683,71,97,168,3.1315789473684212,42.957231648356036
Task_3449,2433,683,25,47,72,3.557017543859649,45.758077762826616
Task_3450,1321,873,88,168,256,1.511441647597254,30.901306268461465
Task_3451,1571,148,56,135,191,10.543624161073826,32.08194183540434
Task_3452,2211,811,29,168,197,2.7229064039408866,44.632439061345565
Task_3453,843,337,108,34,142,2.4940828402366866,20.384192663251333
Task_3454,2716,339,157,16,173,7.988235294117647,50.17065435898531
Task_3455,1078,127,35,101,136,8.421875,23.35980049730324
Task_3456,2020,242,52,137,189,8.312757201646091,39.74971733711678
Task_3457,893,987,51,117,168,0.9038461538461539,24.055509827180675
Task_3458,2507,948,159,112,271,2.6417281348788197,49.99940259465416
Task_3459,1201,700,181,115,296,1.7132667617689015,28.638180851491615
Task_3460,1430,603,104,61,165,2.3675496688741724,30.99762290680529
Task_3461,538,539,182,153,335,0.9962962962962963,17.835050563028126
Task_3462,561,646,21,90,111,0.8670788253477589,17.13880459917399
Task_3463,1844,893,174,108,282,2.062639821029083,39.36606734913674
Task_3464,1356,788,42,75,117,1.7186311787072244,30.213258259341586
Task_3465,2820,474,41,199,240,5.936842105263158,53.455377604167644
Task_3466,721,863,180,67,247,0.8344907407407407,21.015441246976035
Task_3467,1850,388,27,114,141,4.755784061696658,37.03353448243953
Task_3468,818,134,172,43,215,6.059259259259259,19.484230879226605
Task_3469,2088,666,71,193,264,3.130434782608696,42.625065791316366
Task_3470,2962,580,131,182,313,5.098106712564544,56.33843958895326
Task_3471,2661,458,100,140,240,5.7973856209150325,50.78694880386922
Task_3472,606,489,179,115,294,1.236734693877551,18.498387502680355
Task_3473,671,97,60,197,257,6.846938775510204,17.898116012177926
Task_3474,2042,315,106,57,163,6.462025316455696,39.73308371744451
Task_3475,590,993,99,24,123,0.5935613682092555,18.43137214812008
Task_3476,2447,78,140,149,289,30.974683544303797,45.68179582509055
Task_3477,1389,845,74,68,142,1.6418439716312057,31.039425557921604
Task_3478,2179,385,161,88,249,5.6450777202072535,42.82419463508537
Task_3479,1257,380,93,69,162,3.2992125984251968,27.52993165265505
Task_3480,1214,344,136,18,154,3.5188405797101447,26.238234302212007
Task_3481,2590,714,22,74,96,3.6223776223776225,49.17137050617856
Task_3482,928,842,42,152,194,1.1008303677342823,24.266662319839483
Task_3483,947,1004,183,107,290,0.9422885572139303,25.505629320215125
Task_3484,1597,333,109,107,216,4.781437125748503,33.383981305811254
Task_3485,1109,785,50,179,229,1.410941475826972,27.29886578221594
Task_3486,1745,1022,147,122,269,1.7057673509286413,38.14650711097539
Task_3487,952,243,52,103,155,3.901639344262295,22.488666897714207
Task_3488,1756,200,59,109,168,8.7363184079602,35.24320515931911
Task_3489,2306,572,40,50,90,4.024432809773124,43.87391315439095
Task_3490,977,220,24,47,71,4.420814479638009,21.219166089871642
Task_3491,2167,137,98,51,149,15.702898550724637,40.379886480575735
Task_3492,2876,976,80,146,226,2.9437052200614127,55.834448161904184
Task_3493,2603,698,48,182,230,3.7238912732474962,50.71400385604927
Task_3494,1230,320,129,186,315,3.8317757009345796,28.099320820839143
Task_3495,979,306,157,153,310,3.188925081433225,24.01392032083993
Task_3496,2158,527,199,182,381,4.087121212121212,43.74417074153782
Task_3497,1170,944,198,74,272,1.2380952380952381,28.538619529003824
Task_3498,1846,135,59,114,173,13.573529411764707,36.10151608078314
Task_3499,1237,321,150,10,160,3.841614906832298,26.57353498949834
Task_3500,650,418,130,135,265,1.5513126491646778,18.893375475901358
Task_3501,1189,973,47,162,209,1.2207392197125257,28.950322913258997
Task_3502,960,468,158,79,237,2.046908315565032,23.68903001037258
Task_3503,828,64,13,61,74,12.738461538461538,17.84261581483358
Task_3504,970,684,41,185,226,1.416058394160584,24.68750735886897
Task_3505,2325,147,176,39,215,15.70945945945946,43.34821410735486
Task_3506,2373,789,27,23,50,3.0037974683544304,44.978827185785214
Task_3507,2664,434,191,116,307,6.124137931034483,51.022374050523375
Task_3508,1295,929,90,47,137,1.39247311827957,29.411557072685635
Task_3509,2333,510,156,188,344,4.5655577299412915,46.30237467782032
Task_3510,1676,136,158,50,208,12.233576642335766,33.01464353829544
Task_3511,1085,749,113,173,286,1.4466666666666668,26.952533338149134
Task_3512,711,111,185,110,295,6.348214285714286,18.62838150589251
Task_3513,1989,87,109,14,123,22.602272727272727,36.64041035186407
Task_3514,2403,979,69,54,123,2.4520408163265306,47.2107203170711
Task_3515,1003,102,37,155,192,9.737864077669903,22.75345011638396
Task_3516,2259,262,106,27,133,8.5893536121673,42.46695009459474
Task_3517,1181,311,27,164,191,3.78525641025641,26.693993649653006
Task_3518,1629,649,77,78,155,2.506153846153846,34.408924243084506
Task_3519,777,482,25,113,138,1.608695652173913,20.317049288775337
Task_3520,1283,770,66,152,218,1.6640726329442284,29.935086951836237
Task_3521,2902,698,82,179,261,4.1516452074391985,55.5677501416228
Task_3522,785,548,196,88,284,1.429872495446266,21.387135001865673
Task_3523,1145,567,64,76,140,2.015845070422535,26.410278738313608
Task_3524,2943,944,134,106,240,3.1142857142857143,56.7473149161205
Task_3525,2995,83,55,24,79,35.654761904761905,51.92245099770698
Task_3526,1120,848,145,58,203,1.3191990577149588,27.00498254414178
Task_3527,1218,100,83,70,153,12.05940594059406,25.14784340041808
Task_3528,1447,809,90,71,161,1.7864197530864196,31.837229538187284
Task_3529,2352,887,144,78,222,2.6486486486486487,46.959328047210114
Task_3530,2073,242,144,65,209,8.530864197530864,40.24091681373741
Task_3531,1346,510,186,141,327,2.6340508806262233,30.530711776431797
Task_3532,2408,278,107,53,160,8.630824372759857,45.32311353087784
Task_3533,1948,789,130,79,209,2.4658227848101264,40.21586968417896
Task_3534,1981,564,99,197,296,3.506194690265487,40.699974687685604
Task_3535,1363,673,199,26,225,2.022255192878338,30.15548722467241
Task_3536,867,752,80,123,203,1.151394422310757,23.088071892799036
Task_3537,2375,230,99,60,159,10.281385281385282,44.55278052093464
Task_3538,1909,256,115,16,131,7.428015564202335,36.83103635321765
Task_3539,1528,272,49,80,129,5.597069597069597,31.685881894881714
Task_3540,1380,260,34,144,178,5.287356321839081,29.58212606147393
Task_3541,811,473,64,31,95,1.7109704641350212,19.719502884591666
Task_3542,1996,87,77,68,145,22.681818181818183,37.41063434447972
Task_3543,2167,743,90,63,153,2.9126344086021505,42.90853345811795
Task_3544,2721,850,168,21,189,3.197414806110458,52.00862013403784
Task_3545,2053,344,110,184,294,5.95072463768116,41.09725071243648
Task_3546,1116,88,18,93,111,12.539325842696629,23.416285393165793
Task_3547,1821,334,59,87,146,5.435820895522388,36.51648778712611
Task_3548,1089,173,194,198,392,6.258620689655173,25.521679941403338
Task_3549,1524,733,188,71,259,2.076294277929155,33.39765255207476
Task_3550,1768,88,107,20,127,19.865168539325843,33.2288263228704
Task_3551,2437,794,37,96,133,3.0654088050314465,47.710591662691606
Task_3552,1880,70,70,42,112,26.47887323943662,34.52236965320556
Task_3553,1962,70,27,31,58,27.633802816901408,35.20742195644009
Task_3554,956,485,44,15,59,1.9670781893004115,21.52874014032894
Task_3555,1360,451,30,63,93,3.0088495575221237,28.760098050996145
Task_3556,1410,499,182,196,378,2.82,31.819656567737653
Task_3557,1625,551,21,198,219,2.943840579710145,34.65614212661675
Task_3558,1516,513,80,47,127,2.9494163424124515,31.498528770435787
Task_3559,1205,352,45,116,161,3.413597733711048,26.87230776948571
Task_3560,1148,130,64,185,249,8.763358778625955,25.61812189175072
Task_3561,740,154,96,146,242,4.774193548387097,19.245985035082402
Task_3562,2104,736,54,104,158,2.8548168249660786,42.30821474919568
Task_3563,2346,519,106,151,257,4.5115384615384615,46.09076708224899
Task_3564,833,518,46,181,227,1.605009633911368,22.062166289068585
Task_3565,1575,222,168,136,304,7.062780269058296,33.096841384817566
Task_3566,2836,210,149,78,227,13.440758293838863,52.40745972648185
Task_3567,1595,807,110,157,267,1.974009900990099,35.15736823692338
Task_3568,570,643,90,89,179,0.8850931677018633,17.80199519081297
Task_3569,1278,461,37,18,55,2.7662337662337664,26.57893544409892
Task_3570,2295,187,58,40,98,12.207446808510639,42.309788525952335
Task_3571,1843,714,144,103,247,2.5776223776223777,38.62651699398149
Task_3572,740,385,146,83,229,1.9170984455958548,19.946104410328083
Task_3573,2956,72,63,36,99,40.49315068493151,51.029762388403746
Task_3574,2870,858,158,56,214,3.341094295692666,54.82499823780331
Task_3575,1187,65,136,25,161,17.984848484848484,24.135955632857716
Task_3576,2323,548,24,47,71,4.231329690346084,43.582183128511396
Task_3577,1549,1020,151,147,298,1.5171400587659158,35.17228071235055
Task_3578,2669,908,48,39,87,2.9361936193619362,50.5127088318971
Task_3579,1348,419,21,76,97,3.2095238095238097,28.569182116143168
Task_3580,1505,838,97,189,286,1.7938021454112039,33.96813117502459
Task_3581,2548,465,69,110,179,5.467811158798283,48.74891539931758
Task_3582,949,528,96,141,237,1.7939508506616257,23.903833676067404
Task_3583,1402,197,111,11,122,7.08080808080808,28.458847313453834
Task_3584,1136,946,91,126,217,1.1995776135163674,27.976864785243844
Task_3585,2565,1004,103,10,113,2.5522388059701493,49.38440535058436
Task_3586,2820,716,27,57,84,3.933054393305439,52.510293408218246
Task_3587,1604,806,148,106,254,1.9876084262701363,35.16349096068452
Task_3588,2902,987,73,47,120,2.937246963562753,54.788072722855304
Task_3589,2296,111,145,64,209,20.5,42.69011339844477
Task_3590,2663,465,36,68,104,5.714592274678112,49.61536316424269
Task_3591,873,982,43,195,238,0.8880976602238047,24.123470017718883
Task_3592,2814,718,58,179,237,3.913769123783032,54.15668755069776
Task_3593,954,679,112,129,241,1.4029411764705881,24.392562698656267
Task_3594,2011,751,72,94,166,2.6742021276595747,41.06799219527459
Task_3595,2666,550,192,140,332,4.838475499092559,51.57895029315233
Task_3596,1340,300,34,81,115,4.451827242524917,28.478390631194475
Task_3597,2628,384,54,49,103,6.825974025974026,48.356998382266546
Task_3598,1361,209,192,91,283,6.480952380952381,29.45583497363165
Task_3599,2838,781,195,82,277,3.629156010230179,54.63274345075077
Task_3600,809,1023,150,75,225,0.7900390625,22.908858204669134
Task_3601,1185,332,96,182,278,3.5585585585585586,27.261771589159192
Task_3602,1606,200,141,40,181,7.990049751243781,32.28110511827996
Task_3603,1727,898,83,132,215,1.9210233592880979,37.296595772163194
Task_3604,1407,797,47,81,128,1.763157894736842,31.439136671212026
Task_3605,1681,67,173,178,351,24.720588235294116,33.987731667736874
Task_3606,2122,186,42,152,194,11.3475935828877,41.1498232392596
Task_3607,1521,991,162,196,358,1.533266129032258,34.980934648406006
Task_3608,869,920,159,129,288,0.9435396308360477,24.03823455084658
Task_3609,2394,620,125,26,151,3.8550724637681157,45.87251573805519
Task_3610,1169,977,102,118,220,1.1952965235173825,28.60623061004082
Task_3611,1192,897,187,116,303,1.3273942093541202,29.10692885118344
Task_3612,1734,848,132,154,286,2.0424028268551235,37.56854611235315
Task_3613,2898,449,168,53,221,6.44,54.04355682001482
Task_3614,633,529,166,77,243,1.1943396226415095,18.630892190428415
Task_3615,2524,96,146,198,344,26.02061855670103,47.30670935918
Task_3616,1233,1022,55,77,132,1.2052785923753666,29.22709446985924
Task_3617,2369,958,152,122,274,2.470281543274244,47.871973887231064
Task_3618,779,843,199,61,260,0.9229857819905213,21.9123006196824
Task_3619,2016,632,62,138,200,3.184834123222749,41.015628461714485
Task_3620,2672,77,81,190,271,34.256410256410255,49.227509283258144
Task_3621,986,688,176,74,250,1.4310595065312046,24.726685300750642
Task_3622,2038,539,22,25,47,3.774074074074074,38.85609787067505
Task_3623,2222,856,112,70,182,2.592765460910152,44.42060660160598
Task_3624,914,779,181,142,323,1.1717948717948719,24.452067310337526
Task_3625,1136,460,130,175,305,2.4642082429501087,26.999117101433445
Task_3626,2015,160,87,93,180,12.51552795031056,38.88769012814673
Task_3627,2278,868,64,155,219,2.621403912543153,46.02004622400415
Task_3628,788,230,80,17,97,3.411255411255411,18.64044178519921
Task_3629,1283,145,189,63,252,8.787671232876713,27.33582168380302
Task_3630,2207,90,29,124,153,24.252747252747252,40.892761039642444
Task_3631,1171,584,119,110,229,2.0017094017094017,27.50512924665466
Task_3632,1042,422,33,173,206,2.4633569739952716,24.948352854503366
Task_3633,1705,275,107,47,154,6.177536231884058,33.87628549057656
Task_3634,2648,555,86,104,190,4.762589928057554,50.57440085492399
Task_3635,1030,991,89,101,190,1.0383064516129032,26.2133684550349
Task_3636,2678,561,127,135,262,4.765124555160142,51.48146404667337
Task_3637,2480,676,60,48,108,3.6632200886262924,46.95861444308193
Task_3638,1460,281,185,181,366,5.177304964539007,31.8291626886687
Task_3639,1492,691,113,155,268,2.1560693641618496,33.16546123608711
Task_3640,1767,290,131,33,164,6.072164948453608,35.082552551344904
Task_3641,2905,736,38,84,122,3.9416553595658073,54.72708656893773
Task_3642,2521,86,153,137,290,28.977011494252874,46.89423938022827
Task_3643,2386,828,162,194,356,2.8781664656212302,48.21053686308557
Task_3644,594,69,115,129,244,8.485714285714286,16.436303681956133
Task_3645,2729,920,128,167,295,2.963083604777416,53.61856032803039
Task_3646,728,541,193,63,256,1.3431734317343174,20.11922524043878
Task_3647,803,451,189,191,380,1.7765486725663717,22.048020094215087
Task_3648,2233,217,29,98,127,10.243119266055047,42.48446280670433
Task_3649,1889,444,83,104,187,4.244943820224719,38.25275995202871
Task_3650,600,702,20,141,161,0.8534850640113798,18.335558015651728
Task_3651,2357,332,138,150,288,7.078078078078078,45.78799565811611
Task_3652,2388,119,68,112,180,19.9,44.601831965904445
Task_3653,1636,1022,133,168,301,1.5992179863147604,36.63079996785498
Task_3654,2650,576,167,185,352,4.592720970537262,51.565083268749106
Task_3655,2607,845,17,89,106,3.0815602836879434,50.069384707443824
Task_3656,1117,942,37,19,56,1.1845174973488866,25.66287159298163
Task_3657,1236,404,174,163,337,3.051851851851852,28.530553221571534
Task_3658,764,522,94,79,173,1.4608030592734225,20.399015110117386
Task_3659,976,906,109,68,177,1.076074972436604,24.794143720551656
Task_3660,772,470,31,73,104,1.6390658174097665,19.755285989605515
Task_3661,623,744,59,147,206,0.836241610738255,19.26502009395657
Task_3662,2616,700,10,88,98,3.731811697574893,49.605223315505356
Task_3663,715,152,199,40,239,4.673202614379085,18.11230245037726
Task_3664,2748,996,82,12,94,2.756268806419258,52.07557299532592
Task_3665,705,122,85,173,258,5.7317073170731705,18.59959353327854
Task_3666,1225,807,113,176,289,1.516089108910891,29.379639170269183
Task_3667,2130,918,87,25,112,2.317736670293798,42.22623370884577
Task_3668,1905,752,193,163,356,2.5298804780876494,40.30685120070763
Task_3669,1683,91,43,160,203,18.293478260869566,33.41566889028186
Task_3670,2259,281,199,121,320,8.01063829787234,44.16362919404626
Task_3671,2677,107,61,152,213,24.787037037037038,49.2283274326461
Task_3672,1261,895,39,149,188,1.4073660714285714,29.712188350505496
Task_3673,1103,993,42,139,181,1.1096579476861168,27.406349502754342
Task_3674,2693,157,117,69,186,17.044303797468356,49.304674173964145
Task_3675,1176,956,60,162,222,1.2288401253918495,28.782519418677968
Task_3676,771,800,44,145,189,0.9625468164794008,21.634290718672943
Task_3677,1993,502,121,118,239,3.9622266401590456,40.31807291284564
Task_3678,2879,167,68,99,167,17.136904761904763,52.54997984022544
Task_3679,2183,378,191,100,291,5.759894459102902,43.130323710901024
Task_3680,2848,354,60,174,234,8.022535211267606,53.49058287825479
Task_3681,2785,529,85,113,198,5.254716981132075,52.757978498811646
Task_3682,2700,296,35,159,194,9.090909090909092,50.6902533164232
Task_3683,2806,74,186,88,274,37.413333333333334,51.01572889955293
Task_3684,902,987,139,81,220,0.9129554655870445,24.305032851758853
Task_3685,1921,110,60,49,109,17.306306306306308,35.66878326899724
Task_3686,1302,676,118,48,166,1.9231905465288035,29.018602605875156
Task_3687,506,415,161,86,247,1.2163461538461537,16.368252964207908
Task_3688,1065,401,73,29,102,2.6492537313432836,23.698267389605423
Task_3689,1286,817,94,106,200,1.5721271393643033,29.88774106057387
Task_3690,1124,956,194,165,359,1.174503657262278,28.523528627432555
Task_3691,1659,773,45,193,238,2.143410852713178,36.01551173209003
Task_3692,897,993,154,191,345,0.9024144869215291,25.055771414343695
Task_3693,1415,664,160,83,243,2.1278195488721803,31.57130286277835
Task_3694,698,730,182,100,282,0.9548563611491108,20.671636502905262
Task_3695,1926,293,86,123,209,6.551020408163265,38.40412899025157
Task_3696,2700,335,90,200,290,8.035714285714286,51.29972772762275
Task_3697,2585,669,78,20,98,3.8582089552238807,48.47471512332513
Task_3698,1923,483,106,79,185,3.9731404958677685,38.71626019805984
Task_3699,695,907,98,194,292,0.7654185022026432,21.379002367467624
Task_3700,2770,968,197,40,237,2.8586171310629513,53.45947570555209
Task_3701,2260,471,164,143,307,4.788135593220339,44.788219105506464
Task_3702,1330,777,182,149,331,1.7095115681233932,31.128933859174122
Task_3703,663,491,143,50,193,1.3475609756097562,18.497679082215274
Task_3704,1710,696,82,28,110,2.453371592539455,34.87846473513883
Task_3705,2987,283,93,175,268,10.517605633802816,55.56166486402173
Task_3706,1016,640,55,170,225,1.5850234009360376,25.325583552617413
Task_3707,2312,408,25,44,69,5.65281173594132,42.896340452673314
Task_3708,2109,175,85,187,272,11.982954545454545,41.06560839841507
Task_3709,1215,600,45,95,140,2.021630615640599,27.71589062985188
Task_3710,1239,556,196,174,370,2.2244165170556554,29.223493108291127
Task_3711,1821,296,176,41,217,6.1313131313131315,36.19829811472542
Task_3712,1233,818,50,64,114,1.5054945054945055,28.231581862751085
Task_3713,1143,228,156,64,220,4.991266375545852,25.534143549973535
Task_3714,2905,260,191,169,360,11.130268199233717,54.54792459474032
Task_3715,2228,176,46,43,89,12.587570621468927,41.0566232358242
Task_3716,2546,375,123,91,214,6.7712765957446805,48.44818347414755
Task_3717,1540,193,92,183,275,7.938144329896907,32.38112876162449
Task_3718,1889,276,98,102,200,6.819494584837545,37.733320678933104
Task_3719,1322,526,200,168,368,2.50853889943074,30.425557300454305
Task_3720,1156,208,30,38,68,5.5311004784688995,23.963187887192337
Task_3721,2194,718,180,92,272,3.0514603616133518,44.243946933736304
Task_3722,956,958,161,30,191,0.9968717413972888,24.487133657095843
Task_3723,1112,568,71,103,174,1.9543057996485063,26.29622649073653
Task_3724,2058,552,185,60,245,3.721518987341772,41.125017021029606
Task_3725,2888,617,167,145,312,4.673139158576052,55.226331090914336
Task_3726,1226,216,91,96,187,5.649769585253456,27.00111438463229
Task_3727,2361,451,91,47,138,5.2234513274336285,44.80472287599528
Task_3728,1249,473,137,172,309,2.6350210970464136,28.84253220418751
Task_3729,1557,266,101,116,217,5.831460674157303,32.5445843683863
Task_3730,1390,936,121,117,238,1.4834578441835646,32.077892864155864
Task_3731,1479,966,129,50,179,1.5294725956566702,32.81758648573983
Task_3732,1068,120,199,14,213,8.826446280991735,23.27800407897892
Task_3733,2082,266,93,173,266,7.797752808988764,41.18445051735062
Task_3734,1711,700,102,93,195,2.440798858773181,36.22431319133619
Task_3735,850,590,88,30,118,1.4382402707275803,20.996467964146404
Task_3736,2376,308,162,186,348,7.689320388349515,46.32915053535504
Task_3737,811,625,72,198,270,1.2955271565495208,22.236560920780974
Task_3738,947,469,73,128,201,2.0148936170212766,23.55811730949762
Task_3739,2308,232,165,160,325,9.905579399141631,44.840079159762205
Task_3740,2379,83,65,72,137,28.321428571428573,43.34813055039151
Task_3741,2278,662,173,53,226,3.4358974358974357,44.93353891806967
Task_3742,762,161,200,154,354,4.703703703703703,20.115949730456453
Task_3743,2372,976,23,185,208,2.427840327533265,47.75792759514303
Task_3744,760,845,109,121,230,0.8983451536643026,21.81104388443896
Task_3745,744,315,159,63,222,2.3544303797468356,19.515953247976615
Task_3746,757,297,131,23,154,2.540268456375839,18.89358939003271
Task_3747,1454,528,73,155,228,2.7485822306238186,31.9317118949959
Task_3748,2903,459,69,181,250,6.310869565217391,54.798346860407825
Task_3749,2993,161,87,127,214,18.47530864197531,54.59047105708945
Task_3750,1164,1012,200,71,271,1.1490621915103651,28.58842169520234
Task_3751,644,970,38,101,139,0.6632337796086509,19.88548810846981
Task_3752,2828,802,163,43,206,3.5217932752179326,53.72271894326749
Task_3753,1513,895,28,55,83,1.6886160714285714,32.36090782843733
Task_3754,1394,701,162,111,273,1.9857549857549857,31.602381208559933
Task_3755,788,927,195,180,375,0.8491379310344828,23.23393945869712
Task_3756,2228,670,121,141,262,3.3204172876304026,44.70998042470194
Task_3757,1018,511,117,47,164,1.98828125,23.98095808172805
Task_3758,1404,739,178,10,188,1.8972972972972972,30.762717423946246
Task_3759,2472,644,43,105,148,3.832558139534884,47.75785519268866
Task_3760,608,240,105,63,168,2.5228215767634854,16.837489192074546
Task_3761,2427,972,149,127,276,2.4943473792394655,48.85103546867583
Task_3762,1629,630,162,175,337,2.5816164817749603,35.484665121800795
Task_3763,1599,898,87,56,143,1.778642936596218,34.348069882624515
Task_3764,2991,524,117,169,286,5.6971428571428575,56.47605667239164
Task_3765,2221,580,121,120,241,3.8227194492254735,44.188811214902756
Task_3766,947,80,167,137,304,11.691358024691358,22.2370958846269
Task_3767,1718,873,164,84,248,1.965675057208238,37.04435409923246
Task_3768,2695,99,146,134,280,26.95,49.66009697493072
Task_3769,1373,446,21,138,159,3.0715883668903805,29.78316239671827
Task_3770,870,934,133,32,165,0.93048128342246,23.03447510893926
Task_3771,2752,309,84,75,159,8.87741935483871,50.97545361401591
Task_3772,571,157,16,127,143,3.6139240506329116,15.676982230743675
Task_3773,1701,696,27,200,227,2.4404591104734576,36.36287710445251
Task_3774,2975,337,101,97,198,8.801775147928995,55.12448664829216
Task_3775,2276,509,17,144,161,4.462745098039216,44.3034831815253
Task_3776,801,885,63,50,113,0.9040632054176072,21.250068253670054
Task_3777,1367,281,54,46,100,4.847517730496454,27.976612862813294
Task_3778,2783,822,97,64,161,3.3815309842041312,53.03241369820253
Task_3779,1583,286,53,165,218,5.515679442508711,33.17187877133558
Task_3780,2087,302,56,144,200,6.887788778877888,41.079958033175394
Task_3781,2363,467,86,84,170,5.049145299145299,45.548648826609224
Task_3782,2034,414,69,123,192,4.901204819277108,40.550965794923
Task_3783,2539,760,122,168,290,3.3363994743758214,50.085617113550576
Task_3784,1843,875,184,101,285,2.103881278538813,39.297457357101486
Task_3785,1724,289,193,32,225,5.944827586206896,34.673867628711086
Task_3786,2628,812,89,123,212,3.2324723247232474,51.22041992790785
Task_3787,2589,206,113,134,247,12.507246376811594,48.7869302430153
Task_3788,2231,552,165,98,263,4.0343580470162745,44.33242229608266
Task_3789,1817,633,154,66,220,2.865930599369085,37.50682593669954
Task_3790,1649,874,60,48,108,1.8845714285714286,34.41359051712374
Task_3791,1376,672,42,33,75,2.0445765230312034,28.94710899128547
Task_3792,627,106,23,101,124,5.859813084112149,15.918476372168781
Task_3793,1375,506,190,13,203,2.712031558185404,29.658754615319467
Task_3794,762,894,37,185,222,0.8513966480446927,21.996041066125603
Task_3795,1315,896,176,49,225,1.4659977703455964,30.229363040666794
Task_3796,903,573,98,15,113,1.5731707317073171,21.65816291038476
Task_3797,2718,591,120,25,145,4.591216216216216,50.912670122296525
Task_3798,1871,1000,50,35,85,1.8691308691308692,38.142514723201494
Task_3799,615,73,120,40,160,8.31081081081081,15.173067250818072
Task_3800,569,71,164,44,208,7.902777777777778,14.940495261633885
Task_3801,1787,363,78,168,246,4.90934065934066,36.779732336579094
Task_3802,2354,753,20,105,125,3.1220159151193636,46.11119806469636
Task_3803,1051,330,190,60,250,3.175226586102719,24.49959555811633
Task_3804,2671,106,87,183,270,24.962616822429908,49.357343358052624
Task_3805,1426,111,151,52,203,12.732142857142858,28.99642694741374
Task_3806,1764,199,170,109,279,8.82,35.853784595217135
Task_3807,1532,86,10,140,150,17.60919540229885,30.298369950612496
Task_3808,2507,938,20,11,31,2.66986155484558,47.32059094579861
Task_3809,2044,114,166,190,356,17.77391304347826,40.01429810365085
Task_3810,774,910,67,126,193,0.849615806805708,22.099291027750652
Task_3811,2232,711,191,78,269,3.134831460674157,44.718696487734036
Task_3812,536,267,94,59,153,2.0,15.587580946363701
Task_3813,2596,366,185,76,261,7.073569482288828,49.28202375523043
Task_3814,1827,425,30,29,59,4.288732394366197,35.260141155823085
Task_3815,2833,116,47,103,150,24.213675213675213,50.96742742360834
Task_3816,1563,880,52,192,244,1.7741203178206584,34.88367677117103
Task_3817,1026,272,127,59,186,3.758241758241758,23.602996579782502
Task_3818,2184,110,51,75,126,19.675675675675677,40.48833692512987
Task_3819,2139,259,190,110,300,8.226923076923077,42.08276545628308
Task_3820,1534,649,89,80,169,2.36,32.98612506195768
Task_3821,2099,117,74,93,167,17.78813559322034,39.90335937043176
Task_3822,1387,551,88,63,151,2.51268115942029,29.924611513779894
Task_3823,2649,611,96,75,171,4.328431372549019,50.45589411408097
Task_3824,2084,77,78,73,151,26.71794871794872,38.68547339863465
Task_3825,1743,740,167,87,254,2.3522267206477734,37.07046307003537
Task_3826,1319,407,108,48,156,3.232843137254902,28.24553817050393
Task_3827,2311,649,189,25,214,3.5553846153846154,45.02386354833943
Task_3828,1628,969,116,155,271,1.6783505154639176,36.185385230167384
Task_3829,869,448,127,55,182,1.935412026726058,21.67523333244236
Task_3830,884,522,51,54,105,1.6902485659655833,21.372648021607578
Task_3831,2038,645,21,52,73,3.154798761609907,39.5770722851701
Task_3832,640,1016,197,18,215,0.6293018682399213,20.000016761042247
Task_3833,2777,947,10,132,142,2.929324894514768,53.4863036205218
Task_3834,956,861,90,189,279,1.1090487238979119,25.206543813205542
Task_3835,1249,443,77,188,265,2.813063063063063,28.63955271706658
Task_3836,2440,823,133,199,332,2.9611650485436893,48.94960251641985
Task_3837,2090,664,162,20,182,3.142857142857143,41.37928600675983
Task_3838,1650,289,197,10,207,5.689655172413793,33.32039714262633
Task_3839,2482,540,16,97,113,4.587800369685767,47.347022177421934
Task_3840,2094,752,32,163,195,2.7808764940239046,42.57279410107157
Task_3841,1866,897,58,104,162,2.0779510022271714,39.11828753005117
Task_3842,2574,641,95,53,148,4.009345794392523,49.129413407768645
Task_3843,2346,645,49,63,112,3.6315789473684212,45.26347600468509
Task_3844,2282,885,134,125,259,2.5756207674943568,46.20253923250342
Task_3845,1785,330,62,11,73,5.3927492447129906,34.11321075177527
Task_3846,584,74,147,95,242,7.786666666666667,16.25409333963428
Task_3847,2384,636,94,16,110,3.7425431711145998,45.37981297117798
Task_3848,1226,506,45,45,90,2.418145956607495,26.427287066034907
Task_3849,1609,392,126,200,326,4.094147582697201,34.39871211316963
Task_3850,715,988,22,24,46,0.7229524772497472,19.669441133158074
Task_3851,2083,842,148,140,288,2.4709371293001188,43.06794551602612
Task_3852,1517,131,31,139,170,11.492424242424242,30.80230163003982
Task_3853,2773,635,109,40,149,4.360062893081761,51.956146089648904
Task_3854,2311,240,120,140,260,9.589211618257261,44.594974711340534
Task_3855,2597,556,95,49,144,4.662477558348295,49.02290174379923
Task_3856,2452,491,169,12,181,4.983739837398374,46.54145759997581
Task_3857,2312,994,160,26,186,2.3236180904522614,46.00222567434145
Task_3858,1025,948,87,78,165,1.0800842992623814,25.756548020912035
Task_3859,977,263,188,57,245,3.7007575757575757,23.095764368459356
Task_3860,2229,278,42,181,223,7.989247311827957,43.34628309177511
Task_3861,2011,161,171,172,343,12.41358024691358,39.783972160782106
Task_3862,1233,134,138,58,196,9.133333333333333,26.18739633243345
Task_3863,909,290,79,162,241,3.1237113402061856,22.617567029832866
Task_3864,2576,127,81,84,165,20.125,47.41688992544508
Task_3865,1945,765,179,18,197,2.539164490861619,39.473432489547655
Task_3866,1988,817,194,187,381,2.430317848410758,41.97279027541953
Task_3867,2285,469,156,142,298,4.861702127659575,45.13544977489193
Task_3868,2201,259,163,51,214,8.465384615384615,42.27445326747141
Task_3869,1314,865,134,83,217,1.5173210161662818,30.441105400406773
Task_3870,1076,266,22,35,57,4.0299625468164795,22.889238623686264
Task_3871,589,486,74,28,102,1.2094455852156059,16.498371678560094
Task_3872,1621,767,81,147,228,2.1106770833333335,35.30749902860688
Task_3873,745,173,11,25,36,4.281609195402299,17.112133216790273
Task_3874,2856,165,21,198,219,17.204819277108435,52.529706125772094
Task_3875,957,524,89,174,263,1.822857142857143,24.154817578024467
Task_3876,735,219,25,47,72,3.340909090909091,17.399491815035805
Task_3877,1450,669,49,46,95,2.1641791044776117,30.532976985011246
Task_3878,1836,695,161,69,230,2.6379310344827585,38.045320601509495
Task_3879,2878,181,26,113,139,15.813186813186814,52.12384803983443
Task_3880,1747,316,44,129,173,5.511041009463723,35.52268408763718
Task_3881,2934,572,115,76,191,5.12041884816754,54.99047046254773
Task_3882,2770,264,32,99,131,10.452830188679245,51.14270444403743
Task_3883,2851,107,103,41,144,26.39814814814815,50.6380503241268
Task_3884,1264,238,31,126,157,5.2887029288702925,27.378512303664802
Task_3885,2116,273,134,76,210,7.7226277372262775,41.14179820332888
Task_3886,1680,81,124,103,227,20.48780487804878,33.33220254412571
Task_3887,1038,315,146,162,308,3.2848101265822787,24.980172072910694
Task_3888,1698,875,21,199,220,1.9383561643835616,36.83236880886567
Task_3889,575,337,105,188,293,1.7011834319526626,17.685382694650794
Task_3890,1072,920,123,36,159,1.1639522258414767,25.930422676363367
Task_3891,1688,323,67,26,93,5.209876543209877,33.205327816918405
Task_3892,783,944,165,18,183,0.8285714285714286,21.63204098211955
Task_3893,2793,945,127,176,303,2.9524312896405918,54.7600809270827
Task_3894,1301,385,75,114,189,3.3704663212435233,28.821027947098486
Task_3895,864,826,182,43,225,1.044740024183797,22.77382010702027
Task_3896,1842,429,188,37,225,4.283720930232558,37.01373517170463
Task_3897,2061,285,33,67,100,7.206293706293707,39.42422194447879
Task_3898,1304,928,106,33,139,1.403659849300323,29.49503308535061
Task_3899,1277,710,122,30,152,1.7960618846694796,28.46417010844256
Task_3900,1115,884,113,200,313,1.2598870056497176,28.000499279626666
Task_3901,1984,98,184,106,290,20.04040404040404,38.47100330870966
Task_3902,692,333,200,113,313,2.07185628742515,19.51681438878641
Task_3903,2728,177,168,163,331,15.325842696629213,51.03519913426343
Task_3904,2274,661,42,158,200,3.4350453172205437,45.17232455536281
Task_3905,2711,288,44,58,102,9.380622837370241,49.523261338412766
Task_3906,1400,74,14,132,146,18.666666666666668,28.161418562214763
Task_3907,2983,898,99,191,290,3.318131256952169,57.58879048443291
Task_3908,1969,580,14,170,184,3.3889845094664373,39.964055813635646
Task_3909,2320,638,37,85,122,3.6306729264475743,45.15901307887335
Task_3910,882,999,24,176,200,0.882,24.08464601573904
Task_3911,2596,900,169,151,320,2.881243063263041,51.53781377735057
Task_3912,1475,348,49,27,76,4.226361031518625,29.471570236740835
Task_3913,2521,694,152,150,302,3.627338129496403,49.620226532000686
Task_3914,2577,112,137,35,172,22.805309734513273,46.692560253024
Task_3915,953,912,59,50,109,1.0438116100766703,23.60143188831343
Task_3916,833,953,145,158,303,0.8731656184486373,23.670588607840866
Task_3917,1563,641,132,160,292,2.4345794392523366,34.24906047274282
Task_3918,597,191,53,38,91,3.109375,15.630075382729911
Task_3919,2094,591,121,32,153,3.5371621621621623,41.04185373363379
Task_3920,543,571,65,167,232,0.9493006993006993,17.61050202170728
Task_3921,1036,535,169,195,364,1.9328358208955223,25.947098507153985
Task_3922,1904,143,46,120,166,13.222222222222221,36.95520963825678
Task_3923,2595,944,195,195,390,2.746031746031746,52.0393931203238
Task_3924,2176,256,149,94,243,8.46692607003891,42.369689261777594
Task_3925,1964,270,99,153,252,7.247232472324724,39.20441866866839
Task_3926,2879,130,84,17,101,21.977099236641223,50.98649694388297
Task_3927,2530,568,119,196,315,4.446397188049209,49.488614344929566
Task_3928,3000,250,37,177,214,11.952191235059761,55.38876313390829
Task_3929,1839,765,12,74,86,2.4007832898172325,37.32474527065921
Task_3930,1081,148,63,42,105,7.25503355704698,22.62065230813251
Task_3931,1814,1003,181,149,330,1.8067729083665338,39.50895140796064
Task_3932,963,539,169,47,216,1.7833333333333334,23.415519321602613
Task_3933,522,880,49,163,212,0.5925085130533485,18.32602199523225
Task_3934,1620,797,16,93,109,2.030075187969925,34.38540890941713
Task_3935,2954,931,59,127,186,3.1695278969957084,56.704933709962916
Task_3936,2644,506,73,182,255,5.214990138067061,50.86318895345988
Task_3937,1678,125,35,47,82,13.317460317460318,31.9039081822195
Task_3938,1385,306,102,131,233,4.511400651465798,30.05409017826544
Task_3939,2496,891,119,85,204,2.798206278026906,49.22857354723198
Task_3940,2995,504,49,94,143,5.930693069306931,55.67739861977151
Task_3941,2612,154,157,54,211,16.851612903225806,48.17274241830925
Task_3942,578,689,163,153,316,0.8376811594202899,18.864770777627864
Task_3943,2201,106,137,81,218,20.570093457943926,41.41595239250037
Task_3944,1992,366,72,110,182,5.427792915531335,39.61440011215017
Task_3945,1730,76,65,89,154,22.467532467532468,33.35363552003676
Task_3946,2328,201,42,196,238,11.524752475247524,44.71381867943385
Task_3947,2246,849,154,175,329,2.642352941176471,45.90850275062519
Task_3948,2049,348,175,176,351,5.871060171919771,41.29253125160141
Task_3949,1481,583,40,135,175,2.535958904109589,32.188451205738374
Task_3950,2289,272,66,139,205,8.384615384615385,44.19143571063953
Task_3951,2456,650,102,32,134,3.772657450076805,46.87988791782447
Task_3952,1266,859,186,133,319,1.472093023255814,30.251689734935542
Task_3953,974,300,158,184,342,3.2358803986710964,24.105083555467342
Task_3954,1501,692,197,178,375,2.165945165945166,33.827117930537575
Task_3955,1391,663,127,169,296,2.0948795180722892,31.624892950928768
Task_3956,1371,580,171,98,269,2.359724612736661,30.829959017654954
Task_3957,1156,893,114,77,191,1.2930648769574944,27.80790122822799
Task_3958,1955,624,30,50,80,3.128,38.33301886241271
Task_3959,1802,798,25,187,212,2.25531914893617,38.19059162176779
Task_3960,2971,517,79,48,127,5.735521235521236,54.59096923240411
Task_3961,1722,750,142,180,322,2.2929427430093208,37.27322349019362
Task_3962,600,924,132,79,211,0.6486486486486487,19.42239432217576
Task_3963,2225,946,129,81,210,2.3495248152059136,45.100045765557184
Task_3964,1932,484,77,139,216,3.9835051546391753,39.28881558068788
Task_3965,2688,111,134,30,164,24.0,48.45523948596093
Task_3966,1257,73,97,93,190,16.986486486486488,26.46331139033398
Task_3967,793,390,59,192,251,2.028132992327366,21.20123529375809
Task_3968,2007,971,87,150,237,2.064814814814815,42.01056786887352
Task_3969,2240,721,78,51,129,3.102493074792244,43.93941977636529
Task_3970,2659,730,120,157,277,3.6374829001367988,51.81742961077814
Task_3971,1008,352,165,150,315,2.855524079320113,24.63879754518022
Task_3972,2546,123,186,109,295,20.532258064516128,47.62737508446398
Task_3973,1310,399,148,100,248,3.275,29.19202729493749
Task_3974,2114,337,128,70,198,6.254437869822485,41.161051490607484
Task_3975,521,437,11,125,136,1.1894977168949772,16.07122803086204
Task_3976,1383,269,199,151,350,5.122222222222222,30.45560125162163
Task_3977,1531,582,18,44,62,2.6260720411663807,31.102644681172176
Task_3978,2964,81,75,51,126,36.146341463414636,52.0994518248778
Task_3979,2728,159,90,176,266,17.05,50.74931300496794
Task_3980,1781,493,180,127,307,3.6052631578947367,37.2527801374862
Task_3981,1954,1001,41,153,194,1.9500998003992016,41.12698330858928
Task_3982,2880,400,87,76,163,7.182044887780549,53.40729149334453
Task_3983,2176,516,179,40,219,4.20889748549323,42.544506279218005
Task_3984,968,565,180,161,341,1.7102473498233215,24.797268263932523
Task_3985,1237,477,57,163,220,2.587866108786611,28.31734941372264
Task_3986,1152,528,62,138,200,2.1776937618147447,27.006205097262455
Task_3987,1105,457,70,157,227,2.412663755458515,26.19346282970582
Task_3988,1696,908,183,13,196,1.8657865786578658,35.96880304905956
Task_3989,658,138,108,111,219,4.733812949640288,17.66292500305042
Task_3990,1988,487,164,39,203,4.073770491803279,39.401666066514515
Task_3991,632,332,77,74,151,1.897897897897898,17.52995748757164
Task_3992,1828,206,199,109,308,8.830917874396135,37.01152630062173
Task_3993,2164,769,178,67,245,2.81038961038961,43.547474225880215
Task_3994,2025,747,89,185,274,2.7072192513368982,41.833858776443996
Task_3995,1369,864,54,198,252,1.5826589595375722,31.77723965613843
Task_3996,890,259,98,56,154,3.423076923076923,21.172169918161824
Task_3997,1837,782,53,58,111,2.34610472541507,37.41312531434369
Task_3998,1533,388,85,33,118,3.9408740359897174,31.18203013662949
Task_3999,2024,753,62,159,221,2.684350132625995,41.64797025359213
Task_4000,1112,99,56,147,203,11.12,24.534790752332132
Task_4001,2940,637,119,46,165,4.608150470219436,54.81043092253467
Task_4002,2531,211,162,130,292,11.93867924528302,48.08817286262371
Task_4003,758,451,115,11,126,1.676991150442478,19.203235751411697
Task_4004,1864,839,49,148,197,2.219047619047619,39.286382188806414
Task_4005,1457,997,10,183,193,1.4599198396793587,33.176650572811184
Task_4006,789,786,187,72,259,1.0025412960609912,21.871723761224654
Task_4007,2828,93,189,157,346,30.085106382978722,52.03912163927655
Task_4008,2530,133,158,33,191,18.880597014925375,46.35112465874125
Task_4009,801,442,146,168,314,1.8081264108352144,21.670362608545116
Task_4010,2444,501,41,130,171,4.868525896414343,47.12047741732537
Task_4011,1811,835,93,182,275,2.166267942583732,38.777982780579514
Task_4012,2716,984,63,78,141,2.7573604060913706,52.65910560283648
Task_4013,1063,639,28,168,196,1.6609375,25.879347871156067
Task_4014,2185,264,173,106,279,8.245283018867925,42.727029085860046
Task_4015,2948,187,72,78,150,15.680851063829786,53.83462045361662
Task_4016,2363,684,199,32,231,3.44963503649635,46.09130344281191
Task_4017,2012,1016,70,41,111,1.9783677482792528,40.7235057854871
Task_4018,1247,689,51,198,249,1.8072463768115943,29.3539976178557
Task_4019,876,543,50,16,66,1.6102941176470589,20.426322481440014
Task_4020,621,160,171,64,235,3.857142857142857,16.933879146946282
Task_4021,2702,694,111,99,210,3.887769784172662,51.99190774198318
Task_4022,2198,816,194,113,307,2.690330477356181,44.854803817418826
Task_4023,2809,604,149,160,309,4.64297520661157,53.94213364013914
Task_4024,1072,755,120,70,190,1.417989417989418,25.928658849412873
Task_4025,1904,476,174,149,323,3.991614255765199,39.24989866857895
Task_4026,1188,458,147,172,319,2.588235294117647,27.874578881002254
Task_4027,1908,336,179,185,364,5.661721068249258,39.09405606122416
Task_4028,2169,766,171,104,275,2.827900912646675,44.081426543132885
Task_4029,2218,455,37,78,115,4.864035087719298,42.86664730162716
Task_4030,2213,554,22,64,86,3.9873873873873875,42.52138810263042
Task_4031,1948,778,96,18,114,2.5006418485237485,38.89533478910703
Task_4032,2958,985,44,173,217,3.0,57.124359448646736
Task_4033,2058,827,12,120,132,2.4855072463768115,41.70954981276615
Task_4034,1538,291,32,141,173,5.267123287671233,32.13634958594437
Task_4035,2985,1020,65,151,216,2.9236043095004898,57.67783489820971
Task_4036,2976,550,168,76,244,5.4010889292196005,55.82546931810083
Task_4037,924,404,119,88,207,2.2814814814814817,22.838510172021813
Task_4038,1810,940,62,89,151,1.9234856535600424,38.23528766545737
Task_4039,1617,539,192,59,251,2.9944444444444445,34.12716618808635
Task_4040,1376,568,116,133,249,2.4182776801405974,30.825088949121525
Task_4041,2094,132,129,123,252,15.74436090225564,40.41058392934471
Task_4042,1542,568,59,52,111,2.710017574692443,32.03650921033414
Task_4043,607,975,93,37,130,0.6219262295081968,19.0686658236853
Task_4044,1649,312,192,131,323,5.268370607028754,34.65403250909489
Task_4045,666,907,25,89,114,0.7334801762114538,19.71783410847734
Task_4046,1986,958,29,15,44,2.070907194994786,39.21103090271817
Task_4047,1383,443,200,39,239,3.114864864864865,29.84672169996801
Task_4048,2050,584,170,187,357,3.5042735042735043,42.11462761091699
Task_4049,1114,819,69,27,96,1.3585365853658538,25.811308020769946
Task_4050,2055,634,24,75,99,3.236220472440945,40.43912103557829
Task_4051,1739,187,117,168,285,9.25,35.54567670465199
Task_4052,545,469,137,59,196,1.1595744680851063,16.675293291526035
Task_4053,2247,804,59,80,139,2.791304347826087,44.673317269317145
Task_4054,836,310,40,141,181,2.688102893890675,21.1388154720551
Task_4055,2233,442,64,75,139,5.040632054176072,43.2319869521065
Task_4056,1920,926,160,30,190,2.071197411003236,39.63556584611104
Task_4057,1257,733,31,91,122,1.7125340599455041,28.580163020967635
Task_4058,867,987,156,98,254,0.8775303643724697,24.0131406545821
Task_4059,1099,278,69,163,232,3.939068100358423,25.55508177232217
Task_4060,848,87,148,98,246,9.636363636363637,20.42606729094229
Task_4061,2245,561,195,11,206,3.994661921708185,43.61891030995583
Task_4062,1669,972,165,145,310,1.7153134635149023,37.00551984497804
Task_4063,1182,975,186,57,243,1.2110655737704918,28.56197800795347
Task_4064,1068,331,31,88,119,3.216867469879518,24.300141210190574
Task_4065,892,429,155,141,296,2.074418604651163,22.94899514024581
Task_4066,1744,997,78,79,157,1.74749498997996,37.33782943406904
Task_4067,1211,198,117,199,316,6.085427135678392,27.451102011674806
Task_4068,1970,364,117,90,207,5.397260273972603,39.289218181657894
Task_4069,698,882,107,148,255,0.7904869762174406,21.110876914570394
Task_4070,1051,210,119,173,292,4.981042654028436,24.780772984697098
Task_4071,2397,217,123,41,164,10.995412844036696,44.78286649320095
Task_4072,2722,673,72,14,86,4.0385756676557865,50.57770694542176
Task_4073,2428,947,116,72,188,2.561181434599156,48.06992962236857
Task_4074,2115,451,12,121,133,4.679203539823009,41.426270540253675
Task_4075,2710,502,89,196,285,5.387673956262425,51.969876652423466
Task_4076,2770,284,87,30,117,9.719298245614034,50.38129633222325
Task_4077,2183,552,99,124,223,3.9475587703435804,43.42437394991153
Task_4078,1810,386,81,132,213,4.677002583979328,37.00382271556178
Task_4079,2302,566,47,142,189,4.059964726631393,45.26184951143335
Task_4080,1305,120,52,70,122,10.785123966942148,26.641271587126194
Task_4081,2269,587,26,140,166,3.858843537414966,44.617228792196556
Task_4082,1993,255,191,118,309,7.78515625,39.8137451788725
Task_4083,2402,805,176,119,295,2.9801488833746896,48.00712712732216
Task_4084,2073,873,91,53,144,2.371853546910755,41.89783765768389
Task_4085,2757,467,99,184,283,5.891025641025641,52.59597229134456
Task_4086,977,543,154,28,182,1.7959558823529411,23.44496991576611
Task_4087,1207,196,79,145,224,6.126903553299492,26.92404894177049
Task_4088,1070,262,20,45,65,4.068441064638783,22.77244420910216
Task_4089,2892,429,45,41,86,6.725581395348837,52.536508276443364
Task_4090,1571,127,118,134,252,12.2734375,32.16093158553712
Task_4091,1564,722,161,166,327,2.1632088520055324,34.68484868768446
Task_4092,1036,997,184,158,342,1.0380761523046091,27.168656811367782
Task_4093,2788,1020,12,24,36,2.730656219392752,52.09914182136777
Task_4094,2656,576,189,31,220,4.6031195840554595,50.337744179216436
Task_4095,1439,361,60,145,205,3.9751381215469612,31.05197323321856
Task_4096,2787,872,83,96,179,3.1924398625429555,53.81298255548867
Task_4097,2037,999,57,72,129,2.037,41.88218651263704
Task_4098,2505,839,97,57,154,2.982142857142857,48.57584407732801
Task_4099,2023,572,174,185,359,3.5305410122164047,41.65509632361636
Task_4100,2286,796,96,90,186,2.8682559598494355,45.551951354904475
Task_4101,662,931,42,11,53,0.7103004291845494,18.670187994597377
Task_4102,848,687,86,173,259,1.2325581395348837,22.81909862902707
Task_4103,1955,478,112,184,296,4.081419624217119,39.993252624309136
Task_4104,998,746,28,200,228,1.3360107095046854,25.32695856704422
Task_4105,1562,314,108,10,118,4.958730158730159,31.298400661706626
Task_4106,2888,462,68,184,252,6.237580993520519,54.58491890870661
Task_4107,2470,492,137,134,271,5.0101419878296145,48.005042511106545
Task_4108,921,504,17,86,103,1.8237623762376238,22.277980878553922
Task_4109,2371,259,13,144,157,9.11923076923077,44.93960391801449
Task_4110,2220,550,51,111,162,4.029038112522686,43.671627849849585
Task_4111,1997,270,46,160,206,7.369003690036901,39.56096814467532
Task_4112,1859,847,137,173,310,2.1922169811320753,39.68198013092956
Task_4113,888,423,13,63,76,2.0943396226415096,20.757281909184616
Task_4114,928,822,48,77,125,1.1275820170109356,23.652407891425796
Task_4115,2526,423,80,179,259,5.9575471698113205,48.73141940753643
Task_4116,2301,983,29,71,100,2.3384146341463414,45.48611305074755
Task_4117,1975,489,166,191,357,4.030612244897959,40.63033013492856
Task_4118,1293,393,147,127,274,3.281725888324873,29.060564662476988
Task_4119,1210,306,89,57,146,3.9413680781758957,26.425511016361625
Task_4120,1508,666,194,105,299,2.260869565217391,33.40715386598461
Task_4121,2602,325,161,23,184,7.9815950920245395,48.41425558467299
Task_4122,2315,422,147,176,323,5.472813238770685,45.619683113631346
Task_4123,2078,395,38,123,161,5.247474747474747,40.82427228625272
Task_4124,1646,594,83,158,241,2.7663865546218487,35.21876667822493
Task_4125,2941,1004,159,158,317,2.9263681592039803,57.326344912912326
Task_4126,605,715,100,158,258,0.8449720670391061,19.118831731774407
Task_4127,1298,527,176,115,291,2.4583333333333335,29.62397990785466
Task_4128,2549,741,88,144,232,3.4353099730458223,49.84645496091949
Task_4129,2666,967,20,191,211,2.7541322314049586,52.408748107664856
Task_4130,1258,93,187,177,364,13.382978723404255,27.507981950722098
Task_4131,859,604,31,33,64,1.4198347107438016,20.490564634555398
Task_4132,2993,254,124,123,247,11.737254901960783,55.33910935193128
Task_4133,2875,424,185,112,297,6.764705882352941,54.277644950835395
Task_4134,782,451,113,107,220,1.7300884955752212,20.871367227408786
Task_4135,1657,851,33,13,46,1.9448356807511737,33.70317089971157
Task_4136,1052,561,146,133,279,1.8718861209964412,25.807837383922916
Task_4137,2781,988,144,53,197,2.8119312436804855,53.79422382236027
Task_4138,2738,504,107,15,122,5.421782178217822,50.58030355874558
Task_4139,779,236,75,70,145,3.2869198312236287,19.50116063501631
Task_4140,2411,285,122,91,213,8.43006993006993,45.99929616648063
Task_4141,1615,797,27,51,78,2.0238095238095237,33.41429310823464
Task_4142,579,498,140,76,216,1.160320641282565,17.54178367205522
Task_4143,1536,730,173,51,224,2.1012311901504788,33.31951029200461
Task_4144,1668,616,150,188,338,2.7034035656401945,36.08190343694128
Task_4145,2352,969,51,101,152,2.424742268041237,46.93146951188064
Task_4146,945,803,26,194,220,1.1753731343283582,24.601754238733267
Task_4147,1014,418,100,172,272,2.420047732696897,24.782255068452972
Task_4148,584,431,29,100,129,1.3518518518518519,17.110305111485207
Task_4149,2720,575,65,147,212,4.722222222222222,52.053422055629255
Task_4150,1836,889,112,41,153,2.0629213483146067,37.86980021810671
Task_4151,1182,350,160,174,334,3.3675213675213675,27.505523718134608
Task_4152,764,258,49,13,62,2.9498069498069497,17.751690692163173
Task_4153,2604,938,50,41,91,2.7731629392971247,49.62759503146731
Task_4154,1407,185,78,72,150,7.564516129032258,29.289037709321764
Task_4155,850,1002,183,67,250,0.847457627118644,23.503258692743298
Task_4156,2188,535,158,108,266,4.082089552238806,43.61794744151373
Task_4157,816,332,15,42,57,2.4504504504504503,19.047211041461342
Task_4158,1893,170,114,191,305,11.070175438596491,37.806756561068894
Task_4159,2000,471,25,46,71,4.237288135593221,38.21287278850152
Task_4160,2664,333,112,127,239,7.976047904191617,50.392242115724
Task_4161,2815,667,189,32,221,4.2140718562874255,53.15188776764418
Task_4162,1803,690,34,55,89,2.609261939218524,36.37889000885981
Task_4163,2782,559,191,199,390,4.9678571428571425,53.792571603549696
Task_4164,2067,473,135,137,272,4.360759493670886,41.573041041614836
Task_4165,2351,249,20,150,170,9.404,44.809677754026474
Task_4166,951,871,166,110,276,1.0905963302752293,25.060354327763672
Task_4167,714,383,99,31,130,1.859375,18.439565007847808
Task_4168,1426,739,54,100,154,1.927027027027027,31.521993814902434
Task_4169,1174,491,44,58,102,2.386178861788618,25.876617737441155
Task_4170,1475,1017,181,127,308,1.4489194499017681,33.994919360379136
Task_4171,857,412,45,103,148,2.0750605326876514,21.46028023971684
Task_4172,763,818,91,118,209,0.9316239316239316,21.63206038628078
Task_4173,2197,305,70,178,248,7.1797385620915035,43.098521077288474
Task_4174,1853,199,198,75,273,9.265,37.00518266321009
Task_4175,2529,694,68,185,253,3.6388489208633095,49.65057306476843
Task_4176,714,927,118,97,215,0.7693965517241379,21.27852167855818
Task_4177,2794,323,121,62,183,8.623456790123457,51.71747631906248
Task_4178,2129,283,113,70,183,7.496478873239437,41.11044568096728
Task_4179,1790,725,197,118,315,2.465564738292011,38.149853139635724
Task_4180,1845,995,60,35,95,1.8524096385542168,37.72083677586644
Task_4181,1152,728,133,77,210,1.5802469135802468,27.324226565762743
Task_4182,2320,388,139,197,336,5.96401028277635,45.67607429276234
Task_4183,804,395,159,58,217,2.0303030303030303,20.65876064517621
Task_4184,1709,554,26,167,193,3.0792792792792794,35.83702291536763
Task_4185,2312,95,21,126,147,24.083333333333332,42.55364174366465
Task_4186,2230,207,22,185,207,10.721153846153847,42.99957841387735
Task_4187,1304,353,172,171,343,3.6836158192090394,29.48119737591169
Task_4188,1033,662,41,163,204,1.5580693815987934,25.501578507280446
Task_4189,1820,498,94,159,253,3.647294589178357,37.69997000594287
Task_4190,2136,375,53,41,94,5.680851063829787,40.40145434465004
Task_4191,723,456,139,136,275,1.5820568927789935,20.21427683484957
Task_4192,1597,428,189,91,280,3.722610722610723,33.90287683379536
Task_4193,1157,1016,111,192,303,1.1376597836774829,29.010187411516323
Task_4194,2586,798,106,65,171,3.236545682102628,49.93739655572693
Task_4195,763,67,15,194,209,11.220588235294118,18.941003618226382
Task_4196,2177,518,22,104,126,4.194605009633912,42.60178897669842
Task_4197,2852,660,147,149,296,4.314674735249622,54.72690931703793
Task_4198,2757,505,34,200,234,5.448616600790514,52.5327555137634
Task_4199,1969,161,192,70,262,12.154320987654321,38.329956585572766
Task_4200,2638,277,59,200,259,9.489208633093526,50.050838583451956
Task_4201,1922,625,119,196,315,3.070287539936102,40.041014730531984
Task_4202,621,192,144,136,280,3.2176165803108807,17.823123695665483
Task_4203,1527,156,193,147,340,9.726114649681529,32.0912209827459
Task_4204,2527,570,128,62,190,4.425569176882662,48.36477720710521
Task_4205,1587,500,137,112,249,3.1676646706586826,33.92042179518729
Task_4206,1872,156,77,160,237,11.92356687898089,37.17305942008032
Task_4207,2910,982,53,124,177,2.960325534079349,56.13182768280995
Task_4208,1775,233,146,109,255,7.585470085470085,36.034570564856786
Task_4209,2379,662,101,24,125,3.588235294117647,45.50341981182671
Task_4210,846,415,200,23,223,2.0336538461538463,21.12442293720783
Task_4211,2069,486,12,195,207,4.248459958932238,41.40263846334405
Task_4212,2324,707,143,141,284,3.2824858757062145,46.446350282889576
Task_4213,2571,672,191,43,234,3.820208023774146,49.36767957421853
Task_4214,2908,435,29,171,200,6.669724770642202,54.48820636597144
Task_4215,1277,258,26,20,46,4.93050193050193,25.795802137131805
Task_4216,827,646,45,130,175,1.278207109737249,21.96672188574126
Task_4217,1613,95,140,150,290,16.802083333333332,32.68096273745446
Task_4218,1513,541,199,70,269,2.791512915129151,32.62943771939778
Task_4219,2856,220,94,122,216,12.923076923076923,52.91178879416241
Task_4220,1214,276,13,116,129,4.382671480144404,26.617898415160358
Task_4221,1930,362,96,85,181,5.316804407713499,38.451149457730985
Task_4222,1957,434,47,147,194,4.498850574712644,39.40927562473189
Task_4223,1356,900,12,51,63,1.504994450610433,29.489038456512287
Task_4224,2255,519,72,56,128,4.336538461538462,43.66739025397295
Task_4225,794,1017,42,192,234,0.7799607072691552,22.984788697827057
Task_4226,2468,638,171,122,293,3.8622848200312987,48.52196743753023
Task_4227,1467,430,32,68,100,3.4037122969837585,30.501074474256516
Task_4228,1469,721,93,166,259,2.0346260387811634,32.90882044333111
Task_4229,2650,867,166,187,353,3.052995391705069,52.491715560672276
Task_4230,2184,104,159,13,172,20.8,40.38230338877229
Task_4231,2682,283,54,154,208,9.443661971830986,50.470775945648825
Task_4232,2961,432,159,67,226,6.838337182448037,55.004630158221936
Task_4233,1068,121,198,173,371,8.754098360655737,24.803257598657925
Task_4234,1692,622,41,87,128,2.715890850722311,35.41413524275898
Task_4235,2996,651,70,125,195,4.595092024539877,56.561103081072844
Task_4236,534,497,132,84,216,1.072289156626506,16.909920069897385
Task_4237,724,333,111,155,266,2.1676646706586826,19.872650245018527
Task_4238,627,273,138,44,182,2.2883211678832116,17.068170443325197
Task_4239,2727,650,20,61,81,4.188940092165899,50.80106962227607
Task_4240,1197,289,188,156,344,4.127586206896551,27.562581470803423
Task_4241,1086,363,163,122,285,2.9835164835164836,25.73165120978074
Task_4242,532,786,67,181,248,0.6759847522236341,18.377746909917033
Task_4243,656,893,38,40,78,0.7337807606263982,18.56214934757902
Task_4244,2883,940,120,136,256,3.063761955366631,55.90013234067627
Task_4245,2181,77,15,26,41,27.96153846153846,38.772187589232985
Task_4246,2478,888,37,172,209,2.7874015748031495,49.18495327319059
Task_4247,1109,691,195,102,297,1.6026011560693643,27.138319666096763
Task_4248,1507,963,141,66,207,1.5632780082987552,33.549502927332014
Task_4249,1655,733,64,43,107,2.2547683923705724,33.98987860228066
Task_4250,2630,328,185,187,372,7.993920972644377,50.524643065590375
Task_4251,1695,1013,118,178,296,1.6715976331360947,37.53000869896553
Task_4252,1191,573,152,30,182,2.0749128919860627,26.93389542737191
Task_4253,984,316,188,17,205,3.1041009463722395,22.871729152221416
Task_4254,2780,790,117,32,149,3.5145385587863465,52.57729217647943
Task_4255,2796,251,104,50,154,11.095238095238095,51.10582230814493
Task_4256,2757,878,27,54,81,3.136518771331058,51.99760222239495
Task_4257,2528,329,92,48,140,7.66060606060606,47.103073263383685
Task_4258,1525,962,131,145,276,1.5835929387331256,34.51006550321749
Task_4259,1029,465,25,118,143,2.208154506437768,24.299313301886418
Task_4260,1838,158,161,190,351,11.559748427672956,37.116162168685946
Task_4261,2828,431,109,141,250,6.546296296296297,53.387740372193186
Task_4262,585,513,182,129,311,1.1381322957198443,18.333436130218214
Task_4263,2801,240,47,49,96,11.622406639004149,50.59368882237259
Task_4264,1711,702,68,177,245,2.4338549075391183,36.67061716684042
Task_4265,1306,465,22,103,125,2.8025751072961373,28.60944998890872
Task_4266,1981,215,152,177,329,9.171296296296296,39.65517975415859
Task_4267,2637,173,156,62,218,15.155172413793103,48.67963552555741
Task_4268,2197,403,81,49,130,5.438118811881188,42.100611629955
Task_4269,2289,644,101,15,116,3.5488372093023255,43.86048442214176
Task_4270,543,689,98,44,142,0.7869565217391304,16.79042249311047
Task_4271,2411,637,62,195,257,3.7789968652037618,47.627904873518695
Task_4272,2197,791,36,65,101,2.773989898989899,43.22900038308196
Task_4273,1986,148,44,92,136,13.328859060402685,37.87645001358191
Task_4274,2470,364,66,55,121,6.767123287671233,46.25089234421505
Task_4275,1213,450,184,177,361,2.6895787139689578,28.44157540673461
Task_4276,2273,682,170,28,198,3.32796486090776,44.49758383431446
Task_4277,876,495,160,182,342,1.7661290322580645,23.157023975231642
Task_4278,1923,812,75,60,135,2.3653136531365315,39.26049964149442
Task_4279,1893,517,147,170,317,3.6544401544401546,39.210551070141186
Task_4280,2313,546,197,96,293,4.2285191956124315,45.76472659803135
Task_4281,624,747,70,171,241,0.8342245989304813,19.49073991691812
Task_4282,1360,337,145,93,238,4.023668639053255,29.71094650576259
Task_4283,1579,827,153,143,296,1.9070048309178744,35.07630986847669
Task_4284,644,839,157,64,221,0.7666666666666667,19.62088896526436
Task_4285,956,332,98,104,202,2.870870870870871,23.17969366584603
Task_4286,2599,969,157,180,337,2.679381443298969,51.91991641314579
Task_4287,2211,443,122,55,177,4.97972972972973,42.885356319672916
Task_4288,2229,941,69,55,124,2.3662420382165603,44.347291016081094
Task_4289,647,192,119,194,313,3.3523316062176165,18.467190060615312
Task_4290,1813,220,117,20,137,8.203619909502262,35.208880659852625
Task_4291,835,686,63,193,256,1.215429403202329,22.739588091300252
Task_4292,2214,903,164,161,325,2.4491150442477876,45.53145904158674
Task_4293,545,402,33,145,178,1.3523573200992556,16.77107440426614
Task_4294,2958,787,155,55,210,3.753807106598985,55.977436402177666
Task_4295,755,105,62,170,232,7.122641509433962,19.121296197600113
Task_4296,2525,357,136,119,255,7.053072625698324,48.33604488644596
Task_4297,2764,521,111,192,303,5.295019157088123,52.982648119210296
Task_4298,2835,776,89,185,274,3.6486486486486487,54.757069520073536
Task_4299,774,297,28,191,219,2.597315436241611,20.379269989155393
Task_4300,2777,362,146,179,325,7.650137741046832,52.74288872451075
Task_4301,1489,550,77,146,223,2.702359346642468,32.526567889686405
Task_4302,2258,807,177,77,254,2.7945544554455446,45.319417785267824
Task_4303,1073,407,32,25,57,2.6299019607843137,23.278281845584484
Task_4304,624,215,20,112,132,2.888888888888889,17.082596458635695
Task_4305,2030,640,126,116,242,3.1669266770670825,41.35251635169616
Task_4306,1559,795,196,102,298,1.9585427135678393,34.6087414061117
Task_4307,548,373,117,86,203,1.46524064171123,16.71369644768691
Task_4308,2926,418,71,134,205,6.983293556085919,54.742294979675954
Task_4309,1032,780,31,19,50,1.321382842509603,23.682269089194858
Task_4310,2419,918,56,98,154,2.632208922742111,47.819615504159536
Task_4311,1585,689,185,86,271,2.2971014492753623,34.47837611612538
Task_4312,2769,175,32,15,47,15.732954545454545,49.02683597676557
Task_4313,2034,130,160,181,341,15.526717557251908,39.942244471039324
Task_4314,1690,78,80,19,99,21.39240506329114,31.48813987302253
Task_4315,2095,850,91,10,101,2.461809635722679,41.34507142752743
Task_4316,1246,838,90,123,213,1.4851013110846245,29.386740770081392
Task_4317,1740,180,117,123,240,9.613259668508288,35.01049153657403
Task_4318,1769,740,197,36,233,2.387314439946019,36.86096908739881
Task_4319,838,344,161,60,221,2.428985507246377,21.04492542927542
Task_4320,1570,786,146,111,257,1.9949174078780179,34.583383649779826
Task_4321,1208,605,122,185,307,1.9933993399339933,28.61826035118912
Task_4322,654,887,129,197,326,0.7364864864864865,20.79406189840601
Task_4323,806,481,97,32,129,1.6721991701244814,20.231254672678322
Task_4324,1844,804,95,133,228,2.2906832298136646,38.892328389690114
Task_4325,2329,922,39,10,49,2.52329360780065,44.610131396052815
Task_4326,1228,367,19,80,99,3.3369565217391304,26.548052169301172
Task_4327,1732,385,199,79,278,4.487046632124352,35.826200083881965
Task_4328,1639,616,141,34,175,2.6564019448946516,34.142647838977425
Task_4329,1278,226,187,61,248,5.629955947136564,27.729411864419095
Task_4330,2940,193,96,118,214,15.154639175257731,54.103921973951934
Task_4331,1460,304,119,108,227,4.786885245901639,31.172551784623398
Task_4332,1179,651,102,129,231,1.8082822085889572,27.877997095503073
Task_4333,1851,865,142,96,238,2.1374133949191685,39.20222392933446
Task_4334,2910,289,190,166,356,10.03448275862069,54.71125272337232
Task_4335,2268,744,54,17,71,3.0442953020134227,43.07428825923057
Task_4336,759,771,20,158,178,0.9831606217616581,21.27974148905562
Task_4337,2825,82,138,127,265,34.036144578313255,51.491289710427054
Task_4338,2119,888,169,39,208,2.3835770528683913,42.76208472672576
Task_4339,1894,174,104,13,117,10.822857142857142,35.86938552495038
Task_4340,1727,991,162,88,250,1.7409274193548387,37.574556939895565
Task_4341,2272,407,120,137,257,5.568627450980392,44.53530740786622
Task_4342,1207,561,30,81,111,2.1476868327402134,27.144576257063893
Task_4343,2794,465,116,134,250,5.9957081545064375,52.9513783289215
Task_4344,1643,1021,25,133,158,1.6076320939334638,35.84532121885203
Task_4345,2991,299,101,18,119,9.97,53.83851156474469
Task_4346,1581,129,100,105,205,12.161538461538461,32.08560475331197
Task_4347,1955,405,44,136,180,4.815270935960591,39.154874138523596
Task_4348,2450,372,46,23,69,6.568364611260054,44.9104028353894
Task_4349,1929,615,193,44,237,3.1314935064935066,39.026894693089496
Task_4350,1286,524,157,187,344,2.4495238095238094,29.768958268640645
Task_4351,2256,999,190,46,236,2.256,45.41868884317554
Task_4352,1753,640,73,47,120,2.734789391575663,35.49775955334622
Task_4353,2813,177,179,106,285,15.803370786516854,52.08513502800258
Task_4354,1429,277,87,22,109,5.140287769784172,29.048750197129966
Task_4355,2686,476,39,163,202,5.631027253668763,51.11381887337823
Task_4356,1077,147,187,93,280,7.277027027027027,24.571383159816367
Task_4357,2352,763,159,145,304,3.0785340314136125,47.16194823880917
Task_4358,2529,345,182,18,200,7.309248554913295,47.384027801158176
Task_4359,951,639,183,188,371,1.4859375,24.90421171771585
Task_4360,1172,999,44,140,184,1.172,28.550895766574367
Task_4361,1679,600,129,134,263,2.793677204658902,35.78857715833331
Task_4362,1601,702,14,160,174,2.2773826458036983,34.47152713814309
Task_4363,758,499,165,50,215,1.516,20.1176234571813
Task_4364,725,138,37,132,169,5.215827338129497,18.339722084673923
Task_4365,982,166,163,141,304,5.880239520958084,23.342587213627073
Task_4366,1920,594,28,195,223,3.226890756302521,39.48539025020327
Task_4367,2290,820,109,31,140,2.7892813641900123,44.809862679217666
Task_4368,1077,967,45,159,204,1.112603305785124,27.10169389326789
Task_4369,1414,485,148,196,344,2.909465020576132,31.685402734502393
Task_4370,1153,443,79,154,233,2.5968468468468466,26.91913631398401
Task_4371,686,395,152,36,188,1.7323232323232323,18.403934902972452
Task_4372,803,922,13,54,67,0.8699891657638137,20.937893434524632
Task_4373,2262,180,77,156,233,12.497237569060774,43.31967684628529
Task_4374,2389,71,185,191,376,33.18055555555556,45.21346099315593
Task_4375,1052,728,181,197,378,1.4430727023319616,26.81436603439413
Task_4376,2732,682,102,120,222,4.0,52.51995660014438
Task_4377,2492,532,97,120,217,4.675422138836773,48.226100374066355
Task_4378,1249,466,145,27,172,2.674518201284797,27.44417262515398
Task_4379,2270,597,80,95,175,3.7959866220735785,44.73946499086039
Task_4380,2261,330,94,74,168,6.830815709969788,43.39900770183448
Task_4381,2097,135,169,111,280,15.419117647058824,40.588251552975684
Task_4382,1062,262,18,184,202,4.038022813688213,24.724865265017247
Task_4383,663,622,175,158,333,1.0642054574638844,20.057580214134614
Task_4384,2082,700,54,160,214,2.970042796005706,42.37333037963662
Task_4385,2395,307,10,149,159,7.775974025974026,45.48435683934466
Task_4386,1837,392,158,169,327,4.674300254452926,37.96535416265694
Task_4387,800,569,115,17,132,1.4035087719298245,20.27131769231352
Task_4388,2136,994,35,192,227,2.1467336683417084,44.19674310626055
Task_4389,710,322,10,141,151,2.198142414860681,18.828192087242552
Task_4390,2484,352,186,113,299,7.036827195467422,47.860065374892706
Task_4391,1955,939,44,127,171,2.0797872340425534,40.75404076294555
Task_4392,2411,326,184,22,206,7.373088685015291,45.494991981825926
Task_4393,1075,340,132,21,153,3.1524926686217007,24.043038292779514
Task_4394,2027,111,52,160,212,18.098214285714285,39.04925275461082
Task_4395,2525,518,171,131,302,4.865125240847784,49.09506085330688
Task_4396,2432,475,163,136,299,5.109243697478991,47.47754414657029
Task_4397,1368,357,65,64,129,3.82122905027933,29.18940853320677
Task_4398,1767,633,55,136,191,2.7870662460567823,37.03411264410509
Task_4399,942,616,38,70,108,1.526742301458671,22.845851493646695
Task_4400,2540,71,135,169,304,35.27777777777778,47.2189612008852
Task_4401,1062,382,25,153,178,2.772845953002611,24.939367042033364
Task_4402,1636,76,190,171,361,21.246753246753247,33.322598703919006
Task_4403,2854,696,125,137,262,4.094691535150646,54.70198295440961
Task_4404,797,128,85,138,223,6.178294573643411,19.8831650484662
Task_4405,2478,641,144,118,262,3.8598130841121496,48.54427771612103
Task_4406,2686,525,10,148,158,5.106463878326996,50.812248279224605
Task_4407,604,312,174,182,356,1.9297124600638977,18.353495180533567
Task_4408,625,640,15,173,188,0.9750390015600624,18.830540865951402
Task_4409,2199,272,22,42,64,8.054945054945055,40.67235100883212
Task_4410,1460,665,170,142,312,2.1921921921921923,32.75657676864852
Task_4411,2334,903,199,88,287,2.581858407079646,47.09549643028644
Task_4412,531,539,72,164,236,0.9833333333333333,17.328108566744707
Task_4413,582,381,133,125,258,1.5235602094240839,17.65514442072682
Task_4414,711,411,105,194,299,1.7257281553398058,20.10575314649614
Task_4415,1668,800,28,172,200,2.0823970037453186,36.00215226618527
Task_4416,997,910,153,146,299,1.0944017563117454,26.066358722383313
Task_4417,994,869,149,191,340,1.1425287356321838,26.137685722052137
Task_4418,2197,232,97,71,168,9.429184549356224,41.980803820890266
Task_4419,2867,372,60,51,111,7.686327077747989,52.33703910713433
Task_4420,2406,233,24,112,136,10.282051282051283,45.25418957277669
Task_4421,1713,250,28,168,196,6.824701195219124,34.925931282042995
Task_4422,994,201,161,98,259,4.920792079207921,23.598711043693346
Task_4423,2386,649,194,191,385,3.670769230769231,47.77386233661381
Task_4424,1582,388,177,199,376,4.066838046272494,34.18243293940747
Task_4425,2124,961,50,141,191,2.2079002079002077,43.7508926185777
Task_4426,2101,226,112,149,261,9.255506607929515,41.24369065150101
Task_4427,1686,833,33,51,84,2.0215827338129495,34.92341309405539
Task_4428,801,382,144,79,223,2.0913838120104438,20.838562759050827
Task_4429,1144,325,83,21,104,3.5092024539877302,24.612162994265333
Task_4430,1270,602,88,190,278,2.1061359867330016,29.426167596959544
Task_4431,2330,821,39,154,193,2.834549878345499,46.51796908401468
Task_4432,1879,403,167,115,282,4.650990099009901,38.38381085519142
Task_4433,2038,976,159,57,216,2.0859774820880244,42.01366888216703
Task_4434,796,724,116,137,253,1.0979310344827586,22.085337151972713
Task_4435,588,293,146,135,281,2.0,17.633223711346556
Task_4436,1655,655,82,25,107,2.5228658536585367,33.82182697909311
Task_4437,1502,856,24,193,217,1.7526254375729289,33.637759225735046
Task_4438,2236,213,37,153,190,10.448598130841122,43.03305129607125
Task_4439,2690,875,83,93,176,3.0707762557077625,52.21520695798686
Task_4440,1510,963,55,65,120,1.566390041493776,33.00977332033751
Task_4441,2219,852,136,31,167,2.601406799531067,44.0350033552719
Task_4442,1795,845,200,75,275,2.1217494089834514,38.18381654164273
Task_4443,2905,149,90,90,180,19.366666666666667,52.84588966443192
Task_4444,2232,443,35,156,191,5.027027027027027,43.76462973232977
Task_4445,1766,973,142,191,333,1.8131416837782341,38.73026399850958
Task_4446,2832,221,160,146,306,12.756756756756756,52.96729469923724
Task_4447,564,741,117,161,278,0.7601078167115903,18.677225222691725
Task_4448,1840,674,111,29,140,2.725925925925926,37.21691834452571
Task_4449,2048,382,104,116,220,5.347258485639687,40.71110059739121
Task_4450,1216,626,22,68,90,1.9393939393939394,27.029618000273743
Task_4451,757,232,18,183,201,3.2489270386266096,19.80090771050984
Task_4452,2715,183,15,137,152,14.755434782608695,49.89266352676589
Task_4453,2159,925,180,199,379,2.3315334773218144,45.0276031142501
Task_4454,505,936,146,37,183,0.5389541088580576,17.551783560762825
Task_4455,2267,999,108,68,176,2.267,45.55891194472009
Task_4456,642,754,114,162,276,0.8503311258278146,19.913320159497545
Task_4457,1325,772,194,171,365,1.7141009055627425,31.21966060774118
Task_4458,2678,585,200,108,308,4.5699658703071675,51.72609294407406
Task_4459,2531,359,56,12,68,7.030555555555556,45.989430739905174
Task_4460,2096,265,101,25,126,7.879699248120301,39.802083192851335
Task_4461,2386,813,13,85,98,2.9312039312039313,46.33237545153878
Task_4462,1374,260,131,148,279,5.264367816091954,29.958519950383607
Task_4463,629,126,76,114,190,4.952755905511811,17.09847029340809
Task_4464,2366,265,192,153,345,8.894736842105264,45.95740457213024
Task_4465,2389,603,120,49,169,3.955298013245033,46.03032487740713
Task_4466,890,535,22,32,54,1.6604477611940298,20.776506357074467
Task_4467,633,1017,31,144,175,0.6218074656188605,20.211096394270484
Task_4468,904,209,13,132,145,4.304761904761905,21.53057512552699
Task_4469,791,772,199,193,392,1.0232858990944373,22.859510313233958
Task_4470,2868,540,148,98,246,5.3012939001848425,54.30353557114222
Task_4471,1312,929,17,156,173,1.410752688172043,30.50741477233791
Task_4472,1436,661,178,99,277,2.1691842900302114,32.13718054263323
Task_4473,1885,589,127,138,265,3.194915254237288,39.03103889603491
Task_4474,1443,426,123,26,149,3.379391100702576,30.219799954768007
Task_4475,1989,575,93,180,273,3.453125,40.76973663193821
Task_4476,736,959,13,64,77,0.7666666666666667,20.109473887816712
Task_4477,1857,696,168,67,235,2.6642754662840744,38.41032632484903
Task_4478,1285,284,198,14,212,4.508771929824562,27.54817006889401
Task_4479,611,756,28,182,210,0.8071334214002642,19.103827934703027
Task_4480,1134,389,95,25,120,2.9076923076923076,24.849235016743194
Task_4481,2163,83,102,137,239,25.75,41.0216219286389
Task_4482,1776,598,17,50,67,2.964941569282137,35.134127928704665
Task_4483,1280,982,141,92,233,1.3021363173957274,30.347905329699216
Task_4484,608,573,161,18,179,1.0592334494773519,17.60731914547795
Task_4485,2108,333,30,52,82,6.311377245508982,40.0135859243644
Task_4486,1801,226,35,81,116,7.933920704845815,35.50736751275394
Task_4487,2290,508,103,182,285,4.49901768172888,45.34045992053503
Task_4488,555,568,121,193,314,0.9753954305799648,18.17158660053852
Task_4489,2297,174,76,30,106,13.125714285714286,42.22639066590681
Task_4490,849,366,52,184,236,2.3133514986376023,21.934037091567333
Task_4491,1975,421,106,148,254,4.680094786729858,39.8837133412051
Task_4492,2618,931,109,31,140,2.8090128755364807,50.35391444087128
Task_4493,1877,371,77,157,234,5.045698924731183,38.159628726635646
Task_4494,927,347,141,52,193,2.663793103448276,22.38826869634885
Task_4495,883,89,33,186,219,9.811111111111112,20.961161754301877
Task_4496,2107,707,28,149,177,2.975988700564972,42.50628286907462
Task_4497,1225,719,50,124,174,1.7013888888888888,28.613220665623782
Task_4498,2496,883,45,162,207,2.823529411764706,49.43507973856581
Task_4499,2570,434,45,16,61,5.908045977011494,46.903352636986654
Task_4500,1936,246,59,81,140,7.838056680161944,37.95636641223487
Task_4501,2966,272,138,152,290,10.864468864468865,55.21622885782066
Task_4502,1392,149,139,171,310,9.28,29.83419832361554
Task_4503,1534,121,93,58,151,12.573770491803279,30.458576666771393
Task_4504,2100,450,42,188,230,4.656319290465632,41.923246256141255
Task_4505,541,301,143,89,232,1.7913907284768211,16.584712409969832
Task_4506,2477,572,142,176,318,4.322862129144852,48.64633738157304
Task_4507,612,536,117,26,143,1.1396648044692737,17.366447521362268
Task_4508,1102,721,114,77,191,1.5263157894736843,26.422808324446304
Task_4509,2168,980,20,200,220,2.2099898063200816,44.611392104624734
Task_4510,1973,811,24,136,160,2.4298029556650245,40.44335774458265
Task_4511,1321,934,67,123,190,1.4128342245989305,30.835346440876126
Task_4512,1886,316,192,112,304,5.9495268138801265,38.3016004352394
Task_4513,1901,92,145,17,162,20.440860215053764,35.55030490168806
Task_4514,1715,120,73,170,243,14.173553719008265,34.46789199388757
Task_4515,1972,584,97,114,211,3.370940170940171,40.12208201786513
Task_4516,1140,77,63,34,97,14.615384615384615,22.815797385539906
Task_4517,683,855,90,98,188,0.7978971962616822,20.385748015169135
Task_4518,2281,254,135,129,264,8.945098039215686,44.17419227843809
Task_4519,2083,919,97,191,288,2.264130434782609,43.390464492252214
Task_4520,2077,670,128,145,273,3.0953800298062593,42.37368624698096
Task_4521,1550,441,167,47,214,3.506787330316742,32.40008931368798
Task_4522,736,349,45,54,99,2.1028571428571428,18.420761898447996
Task_4523,2853,652,25,144,169,4.36906584992343,54.0786894550931
Task_4524,1998,92,30,141,171,21.483870967741936,38.05594584532182
Task_4525,1905,229,49,60,109,8.282608695652174,36.704210532177335
Task_4526,2464,445,20,116,136,5.524663677130045,46.90465391005011
Task_4527,2266,507,66,63,129,4.460629921259843,43.88343663676295
Task_4528,2315,710,183,35,218,3.2559774964838257,45.352394035287226
Task_4529,2002,897,196,112,308,2.2293986636971046,42.00510888993153
Task_4530,2784,214,33,137,170,12.948837209302326,51.516951287345854
Task_4531,2079,348,47,196,243,5.957020057306591,41.34976362821067
Task_4532,2286,412,166,87,253,5.535108958837772,44.620586120370945
Task_4533,2589,571,179,134,313,4.526223776223776,50.332587535742825
Task_4534,2867,449,165,176,341,6.371111111111111,54.52595402305794
Task_4535,2757,587,161,17,178,4.688775510204081,51.67236972782038
Task_4536,1630,812,131,57,188,2.004920049200492,34.8931174644908
Task_4537,822,323,91,17,108,2.537037037037037,19.60055093691619
Task_4538,633,809,101,99,200,0.7814814814814814,19.529744931572893
Task_4539,1117,120,117,192,309,9.231404958677686,25.31963949523862
Task_4540,848,123,179,184,363,6.838709677419355,21.324409534652723
Task_4541,2400,894,25,80,105,2.6815642458100557,46.94413659909855
Task_4542,1133,868,148,181,329,1.3037974683544304,28.280391890646104
Task_4543,1733,619,48,95,143,2.7951612903225804,36.029931196497515
Task_4544,1837,769,144,125,269,2.3857142857142857,38.83491594105171
Task_4545,1556,437,176,126,302,3.5525114155251143,33.48826141849006
Task_4546,2109,473,198,43,241,4.449367088607595,41.44871115252081
Task_4547,1869,67,97,73,170,27.485294117647058,35.507203015010425
Task_4548,2653,189,88,150,238,13.963157894736842,49.68893103712946
Task_4549,1835,421,76,72,148,4.348341232227488,36.84346587646436
Task_4550,1740,654,108,192,300,2.6564885496183206,37.17622322937683
Task_4551,1005,913,38,63,101,1.099562363238512,24.69738084819699
Task_4552,1525,540,29,54,83,2.8188539741219962,31.441413504951427
Task_4553,1786,212,46,79,125,8.384976525821596,35.35124223926164
Task_4554,1768,819,132,59,191,2.15609756097561,37.12634156654189
Task_4555,2201,447,120,91,211,4.912946428571429,43.21269562717895
Task_4556,1471,903,200,187,387,1.627212389380531,34.06248500701363
Task_4557,1031,410,14,71,85,2.508515815085158,23.389550578410006
Task_4558,2982,770,101,50,151,3.867704280155642,55.77478190855529
Task_4559,1375,811,130,40,170,1.6933497536945812,30.51132705879407
Task_4560,592,695,76,54,130,0.8505747126436781,17.826614939219738
Task_4561,805,440,139,190,329,1.8253968253968254,21.827246683210237
Task_4562,1300,439,165,52,217,2.9545454545454546,28.69161447300273
Task_4563,1743,247,126,30,156,7.028225806451613,34.39592064687018
Task_4564,1914,876,57,125,182,2.1824401368301025,40.02516520216832
Task_4565,1946,758,129,49,178,2.5638998682476943,39.57386989543644
Task_4566,1392,746,50,197,247,1.8634538152610443,31.818034313739684
Task_4567,1989,66,29,102,131,29.686567164179106,37.1696718273317
Task_4568,2867,328,87,194,281,8.714285714285714,53.833165831968124
Task_4569,1931,310,96,186,282,6.209003215434084,39.00990196747147
Task_4570,1099,185,40,118,158,5.908602150537634,24.481093749789963
Task_4571,2928,779,145,117,262,3.753846153846154,56.10713756949159
Task_4572,745,185,98,20,118,4.005376344086022,17.972726188139546
Task_4573,1423,683,83,149,232,2.0804093567251463,31.912125751690684
Task_4574,1100,174,57,166,223,6.285714285714286,24.90115810180744
Task_4575,1199,294,26,70,96,4.064406779661017,25.745632960632147
Task_4576,1771,664,91,29,120,2.663157894736842,35.848260095031925
Task_4577,1947,1016,54,74,128,1.9144542772861357,40.655374997426414
Task_4578,545,70,46,26,72,7.676056338028169,13.083987200029823
Task_4579,2293,663,175,162,337,3.4533132530120483,46.08625407163628
Task_4580,2545,1001,28,35,63,2.539920159680639,48.436766468405075
Task_4581,2629,1006,132,178,310,2.6107249255213505,52.38604898820078
Task_4582,651,256,147,54,201,2.5330739299610894,17.73544490707417
Task_4583,1420,553,125,74,199,2.563176895306859,30.984422394930146
Task_4584,1578,1006,193,24,217,1.567030784508441,34.53022689889677
Task_4585,2664,521,29,39,68,5.103448275862069,48.800193404417286
Task_4586,1957,640,48,76,124,3.0530421216848675,39.37012301814459
Task_4587,2036,627,28,21,49,3.2420382165605095,39.11134810182113
Task_4588,2160,243,120,79,199,8.852459016393443,41.753965317267465
Task_4589,2378,219,67,180,247,10.809090909090909,45.64852307027576
Task_4590,2234,824,16,140,156,2.707878787878788,44.59707877545484
Task_4591,515,669,64,110,174,0.7686567164179104,17.146323736192123
Task_4592,1716,845,127,182,309,2.028368794326241,37.41871856215095
Task_4593,2124,469,63,40,103,4.519148936170213,40.54726398462669
Task_4594,750,619,41,28,69,1.2096774193548387,18.95012501608979
Task_4595,1820,248,39,164,203,7.309236947791165,36.65500952888979
Task_4596,1491,443,106,113,219,3.358108108108108,32.08555139882366
Task_4597,1827,319,83,78,161,5.709375,36.48913406284896
Task_4598,885,846,162,86,248,1.0448642266824084,23.72176081850618
Task_4599,2146,355,95,130,225,6.02808988764045,42.22525329851596
Task_4600,1638,839,140,163,303,1.95,36.10930913237351
Task_4601,2927,206,94,103,197,14.140096618357488,53.86234178111227
Task_4602,1791,942,120,19,139,1.8992576882290562,37.195743799054725
Task_4603,841,759,135,120,255,1.106578947368421,22.890759776565332
Task_4604,588,456,119,176,295,1.286652078774617,18.207802601976226
Task_4605,558,815,10,111,121,0.6838235294117647,17.843993327623014
Task_4606,1106,429,64,40,104,2.572093023255814,24.301230895833623
Task_4607,2663,149,150,82,232,17.753333333333334,49.25757246398766
Task_4608,1277,922,94,102,196,1.3835319609967498,30.035819373465134
Task_4609,2678,539,163,106,269,4.95925925925926,51.39978635583259
Task_4610,1918,630,65,138,203,3.0396196513470684,39.47336265701927
Task_4611,2628,230,15,135,150,11.376623376623376,48.83748708973147
Task_4612,574,912,174,71,245,0.628696604600219,19.04348855128674
Task_4613,1527,371,129,124,253,4.104838709677419,32.59278820100989
Task_4614,944,755,109,27,136,1.2486772486772486,23.230845874401297
Task_4615,1983,702,126,11,137,2.8207681365576103,39.44724756370691
Task_4616,2044,1023,179,134,313,1.99609375,43.117308321761385
Task_4617,1580,641,38,116,154,2.4610591900311527,33.62078961605611
Task_4618,1188,928,88,57,145,1.278794402583423,27.992049859591148
Task_4619,2629,892,138,189,327,2.9440089585666294,52.12294718465021
Task_4620,851,458,32,95,127,1.8540305010893245,21.441209563923213
Task_4621,1912,506,10,115,125,3.7712031558185406,38.32961257990048
Task_4622,995,771,159,74,233,1.288860103626943,25.057302878066125
Task_4623,968,742,197,132,329,1.3028263795423958,25.203716111758784
Task_4624,913,88,187,121,308,10.258426966292134,21.745441091744457
Task_4625,2135,901,50,120,170,2.3669623059866964,43.56474682290036
Task_4626,2783,419,93,24,117,6.626190476190477,51.07216741528445
Task_4627,1023,735,82,42,124,1.389945652173913,24.234106555306894
Task_4628,669,227,133,32,165,2.9342105263157894,17.536890530696578
Task_4629,2313,110,60,40,100,20.83783783783784,41.68601061084736
Task_4630,862,768,142,51,193,1.1209362808842653,22.60944296415804
Task_4631,2814,645,49,11,60,4.356037151702786,51.43008894742072
Task_4632,2552,813,25,106,131,3.135135135135135,49.488481118804664
Task_4633,999,899,41,49,90,1.11,24.206464456801253
Task_4634,1629,275,164,154,318,5.9021739130434785,34.22418740421497
Task_4635,803,71,131,187,318,11.152777777777779,20.13464833613387
Task_4636,2482,972,150,130,280,2.55087358684481,49.745023927361935
Task_4637,1857,235,55,78,133,7.86864406779661,36.663759994907394
Task_4638,548,376,122,150,272,1.453580901856764,17.190164483604025
Task_4639,948,200,100,74,174,4.7164179104477615,22.237801269040414
Task_4640,2042,925,50,139,189,2.205183585313175,42.3244415193062
Task_4641,2947,916,119,116,235,3.213740458015267,56.71521164998063
Task_4642,1696,441,17,141,158,3.83710407239819,34.8611200392698
Task_4643,1108,694,130,29,159,1.5942446043165468,25.814031042123244
Task_4644,2118,568,56,12,68,3.7223198594024605,40.13295808034252
Task_4645,1667,398,186,73,259,4.177944862155388,34.61788839858891
Task_4646,1795,399,183,52,235,4.4875,36.47766093146034
Task_4647,913,214,13,160,173,4.246511627906977,22.007814855596465
Task_4648,645,754,74,115,189,0.8543046357615894,19.521988239712027
Task_4649,1964,927,44,11,55,2.1163793103448274,38.88606310518126
Task_4650,1996,67,32,113,145,29.352941176470587,37.35909187378099
Task_4651,797,633,96,199,295,1.2570977917981072,22.09397212178187
Task_4652,785,900,54,150,204,0.8712541620421753,22.306711414142494
Task_4653,1715,837,28,112,140,2.0465393794749405,36.30424524803193
Task_4654,1856,136,172,58,230,13.547445255474452,36.16672246937714
Task_4655,1282,82,30,29,59,15.44578313253012,24.94130400407704
Task_4656,2146,237,34,92,126,9.016806722689076,41.20617008684706
Task_4657,1987,80,54,187,241,24.530864197530864,38.36648716729463
Task_4658,1261,732,145,54,199,1.7203274215552524,28.86942035610285
Task_4659,2298,612,146,35,181,3.7487765089722673,44.587831187866506
Task_4660,1380,964,50,46,96,1.4300518134715026,30.36623340616435
Task_4661,1042,123,151,79,230,8.403225806451612,23.444550645315328
Task_4662,2222,360,190,112,302,6.1551246537396125,43.754559819056304
Task_4663,1043,200,100,27,127,5.189054726368159,22.982244197221203
Task_4664,2267,880,142,55,197,2.5732122587968216,45.26227212827738
Task_4665,2257,707,34,108,142,3.187853107344633,44.51598815768099
Task_4666,1330,945,143,199,342,1.4059196617336152,31.732810110581706
Task_4667,701,182,157,88,245,3.830601092896175,18.730052739438975
Task_4668,1617,372,127,28,155,4.335120643431635,32.813114231199926
Task_4669,1385,486,163,168,331,2.8439425051334704,31.129852369239885
Task_4670,2276,225,73,39,112,10.070796460176991,42.33852328761983
Task_4671,1023,618,174,11,185,1.6526655896607432,24.32773710929463
Task_4672,1125,215,195,105,300,5.208333333333333,25.902792145371468
Task_4673,2299,759,156,70,226,3.025,45.570541217754226
Task_4674,1711,799,50,152,202,2.13875,36.768138799271306
Task_4675,595,476,161,93,254,1.2473794549266248,18.054793224162065
Task_4676,1469,124,128,140,268,11.752,30.60608820372681
Task_4677,1647,700,141,34,175,2.3495007132667616,34.53271844984385
Task_4678,2896,537,130,198,328,5.382899628252788,55.245829416781454
Task_4679,1785,531,39,34,73,3.3552631578947367,34.9653165459318
Task_4680,1297,67,38,187,225,19.073529411764707,27.37160006595757
Task_4681,1547,587,148,129,277,2.630952380952381,33.71304205149048
Task_4682,2846,265,75,98,173,10.699248120300751,52.728264652561855
Task_4683,682,328,80,186,266,2.072948328267477,19.29127316102295
Task_4684,2433,533,37,44,81,4.556179775280899,45.60627249264545
Task_4685,777,687,45,194,239,1.129360465116279,21.690530791342823
Task_4686,2498,304,129,108,237,8.190163934426229,47.629596976184054
Task_4687,554,519,76,22,98,1.0653846153846154,15.97497273798924
Task_4688,1397,211,18,74,92,6.589622641509434,28.62423672075398
Task_4689,1081,556,66,127,193,1.940754039497307,25.932410041172716
Task_4690,553,1002,119,97,216,0.551345962113659,19.018833102270705
Task_4691,1116,838,59,107,166,1.33015494636472,27.116842277004597
Task_4692,1099,167,78,49,127,6.541666666666667,23.585710086709764
Task_4693,1514,407,57,21,78,3.7107843137254903,30.240931341991743
Task_4694,524,294,111,59,170,1.776271186440678,15.642251664868851
Task_4695,2128,934,121,151,272,2.2759358288770053,44.01179217100147
Task_4696,2779,617,157,53,210,4.496763754045308,52.65357739776021
Task_4697,2502,464,33,166,199,5.380645161290323,48.14942644589769
Task_4698,1682,103,191,143,334,16.173076923076923,34.072094920154775
Task_4699,1125,773,85,52,137,1.4534883720930232,26.4378827516199
Task_4700,2063,104,190,180,370,19.64761904761905,40.27565216664542
Task_4701,2499,114,147,199,346,21.730434782608697,47.137688226133115
Task_4702,870,890,174,36,210,0.9764309764309764,23.058091906115134
Task_4703,1304,304,148,32,180,4.275409836065574,27.87628134984381
Task_4704,1749,824,39,151,190,2.12,37.30117104490814
Task_4705,1432,622,46,178,224,2.298555377207063,31.868399710660913
Task_4706,938,554,59,36,95,1.6900900900900901,21.963244515681453
Task_4707,1862,376,192,163,355,4.938992042440319,38.42595155564712
Task_4708,2613,348,28,93,121,7.487106017191977,48.8188788723564
Task_4709,1299,821,70,12,82,1.5802919708029197,28.485878829459967
Task_4710,2741,481,49,193,242,5.686721991701245,52.31121475927829
Task_4711,1803,143,162,179,341,12.520833333333334,36.40787948819204
Task_4712,2394,272,198,165,363,8.76923076923077,46.523784250892675
Task_4713,649,734,42,61,103,0.8829931972789116,18.383879336170676
Task_4714,1418,114,122,156,278,12.330434782608696,29.768516063452235
Task_4715,2030,384,172,192,364,5.2727272727272725,41.193320912483095
Task_4716,1771,162,166,12,178,10.865030674846626,34.435739989422935
Task_4717,776,199,128,89,217,3.88,19.907816249900293
Task_4718,1470,497,87,108,195,2.9518072289156625,31.769673855929653
Task_4719,1707,750,35,42,77,2.272969374167776,34.501345959859215
Task_4720,2440,667,111,63,174,3.6526946107784433,47.237801740184544
Task_4721,2846,503,132,164,296,5.646825396825397,54.149903986969285
Task_4722,1312,213,86,74,160,6.130841121495327,27.833025844766066
Task_4723,1245,962,105,194,299,1.2928348909657321,30.230130411545357
Task_4724,1135,815,29,171,200,1.3909313725490196,27.56330480408047
Task_4725,1347,760,54,196,250,1.7700394218134035,31.119212809844324
Task_4726,1773,134,171,120,291,13.133333333333333,35.54057283044883
Task_4727,2880,428,153,189,342,6.713286713286713,54.685762303983076
Task_4728,2199,291,109,62,171,7.530821917808219,42.115991849055696
Task_4729,511,646,126,196,322,0.7897990726429676,17.79108363280304
Task_4730,1826,754,180,177,357,2.418543046357616,39.08662566023218
Task_4731,1164,282,30,75,105,4.113074204946996,25.38343181739805
Task_4732,2533,84,52,42,94,29.8,44.83906422223789
Task_4733,1636,285,126,42,168,5.72027972027972,32.97449985391839
Task_4734,927,607,154,54,208,1.524671052631579,23.224665015829107
Task_4735,1917,1010,62,93,155,1.8961424332344214,40.19342236517057
Task_4736,1563,802,57,136,193,1.946450809464508,34.33695778889901
Task_4737,2957,504,134,33,167,5.855445544554455,54.616129410365204
Task_4738,1278,840,104,165,269,1.5196195005945303,30.215533603662113
Task_4739,1866,810,168,37,205,2.3008631319358814,38.50725973162156
Task_4740,2502,367,158,109,267,6.798913043478261,48.04538290365463
Task_4741,2483,615,96,13,109,4.0308441558441555,46.829165254737404
Task_4742,1912,962,50,180,230,1.9854620976116304,40.62750815610566
Task_4743,2587,582,19,35,54,4.437392795883362,47.805897158034064
Task_4744,2589,909,22,24,46,2.845054945054945,48.728397905128084
Task_4745,2959,235,115,104,219,12.538135593220339,54.574682405411714
Task_4746,2885,928,169,77,246,3.1054897739504845,55.59655139072922
Task_4747,968,185,149,154,303,5.204301075268817,23.337557054421637
Task_4748,1079,811,119,199,318,1.3288177339901477,27.239201470122058
Task_4749,1848,406,199,129,328,4.54054054054054,38.13087784016986
Task_4750,1486,538,102,33,135,2.7569573283858997,31.149575826445925
Task_4751,2270,191,54,133,187,11.822916666666666,43.45341582052975
Task_4752,2630,195,14,157,171,13.418367346938776,49.00455884754297
Task_4753,529,402,199,130,329,1.3126550868486353,17.20550964343318
Task_4754,1250,565,164,87,251,2.208480565371025,28.700657495197493
Task_4755,531,319,194,194,388,1.659375,17.36968789270499
Task_4756,2413,394,162,63,225,6.108860759493671,46.18828880806628
Task_4757,579,528,171,70,241,1.0945179584120983,17.658947080021555
Task_4758,695,344,104,102,206,2.0144927536231885,19.10075461861419
Task_4759,2414,107,86,45,131,22.35185185185185,43.64223424464933
Task_4760,538,527,20,102,122,1.018939393939394,16.451247342182565
Task_4761,1330,421,194,173,367,3.1516587677725116,30.222235755804082
Task_4762,2538,694,69,27,96,3.6517985611510793,47.94047345580126
Task_4763,1690,616,115,93,208,2.739059967585089,35.68872088936416
Task_4764,2182,228,130,158,288,9.528384279475983,42.66531362292623
Task_4765,1586,208,183,182,365,7.588516746411483,33.56236072135767
Task_4766,2839,99,153,56,209,28.39,51.08059864012716
Task_4767,2991,622,90,12,102,4.800963081861958,54.81259326332204
Task_4768,942,552,139,175,314,1.7034358047016276,24.24379457307366
Task_4769,2198,450,57,10,67,4.873614190687362,40.99879333352738
Task_4770,829,1008,157,140,297,0.821605550049554,23.722952043449215
Task_4771,2039,218,123,84,207,9.310502283105023,39.821464307381575
Task_4772,1848,745,75,170,245,2.4772117962466487,38.956755388597834
Task_4773,2357,482,87,113,200,4.87991718426501,45.7933289706662
Task_4774,1359,109,129,45,174,12.354545454545455,27.509892537294746
Task_4775,943,664,193,107,300,1.4180451127819549,24.405408095858235
Task_4776,1573,107,20,142,162,14.564814814814815,31.282055445520495
Task_4777,1308,102,165,64,229,12.699029126213592,27.185654212927535
Task_4778,695,222,18,182,200,3.116591928251121,18.782772086384643
Task_4779,797,665,67,100,167,1.1966966966966968,21.496604784476204
Task_4780,2203,617,46,42,88,3.5647249190938513,42.24184792654526
Task_4781,878,203,79,186,265,4.303921568627451,21.983027653916434
Task_4782,2688,620,97,10,107,4.328502415458937,50.07022646381797
Task_4783,2663,967,33,99,132,2.75103305785124,51.742037985306105
Task_4784,1178,741,170,139,309,1.587601078167116,28.465887430404425
Task_4785,2967,439,194,166,360,6.743181818181818,56.14659411136349
Task_4786,934,197,100,14,114,4.717171717171717,21.008422074016472
Task_4787,1690,705,136,95,231,2.3937677053824364,36.104367645903025
Task_4788,1243,755,110,145,255,1.6441798941798942,29.33384109019778
Task_4789,2436,963,191,23,214,2.5269709543568464,47.98323775501973
Task_4790,1527,891,122,47,169,1.7118834080717489,33.191521490956916
Task_4791,2937,615,92,76,168,4.767857142857143,55.043951621086016
Task_4792,2993,955,42,76,118,3.1307531380753137,56.68170669024813
Task_4793,2033,925,154,185,339,2.195464362850972,42.83023090599725
Task_4794,2008,551,35,11,46,3.63768115942029,38.318556174018816
Task_4795,1121,967,106,22,128,1.1580578512396693,26.75661991840928
Task_4796,1374,64,150,157,307,21.138461538461538,28.970989238929576
Task_4797,2276,187,39,89,128,12.106382978723405,43.26460937378035
Task_4798,1071,107,175,44,219,9.916666666666666,23.225158143922055
Task_4799,2933,860,85,192,277,3.4065040650406506,56.62460081233754
Task_4800,1259,737,108,139,247,1.7059620596205962,29.48646298794502
Task_4801,2956,563,122,80,202,5.24113475177305,55.439500465809346
Task_4802,2186,956,23,157,180,2.284221525600836,44.55879774512423
Task_4803,1571,524,139,196,335,2.9923809523809526,34.25393081470377
Task_4804,896,854,71,122,193,1.047953216374269,23.79679554536312
Task_4805,1657,194,116,180,296,8.497435897435897,34.30683715566138
Task_4806,668,266,109,184,293,2.50187265917603,18.937220855928462
Task_4807,2166,935,91,176,267,2.3141025641025643,44.630509237997124
Task_4808,856,438,33,45,78,1.9498861047835991,20.079111477089178
Task_4809,967,671,82,187,269,1.4389880952380953,24.825432082352776
Task_4810,2358,815,187,187,374,2.889705882352941,47.79708283172142
Task_4811,2762,265,89,64,153,10.38345864661654,50.750868293697295
Task_4812,2346,256,88,46,134,9.1284046692607,43.85894444305398
Task_4813,2286,786,115,189,304,2.9047013977128335,46.25297668819619
Task_4814,932,226,108,115,223,4.105726872246696,22.560081763096417
Task_4815,1977,180,55,76,131,10.922651933701658,37.89743934293564
Task_4816,2441,450,42,90,132,5.412416851441241,46.64093353430986
Task_4817,2881,87,83,61,144,32.73863636363637,51.15800902101531
Task_4818,2049,324,37,117,154,6.304615384615385,40.04409573386143
Task_4819,575,889,163,42,205,0.6460674157303371,18.593500732043026
Task_4820,2627,203,26,116,142,12.877450980392156,48.66346878624421
Task_4821,1618,591,154,194,348,2.733108108108108,35.265277359065216
Task_4822,1285,957,20,95,115,1.3413361169102296,29.609507783283508
Task_4823,511,695,81,176,257,0.7341954022988506,17.669656890929726
Task_4824,708,999,193,41,234,0.708,21.106969613044615
Task_4825,2523,723,41,157,198,3.484806629834254,49.29765883473326
Task_4826,1629,410,58,74,132,3.9635036496350367,33.57955371512724
Task_4827,1224,550,22,110,132,2.221415607985481,27.63469665668339
Task_4828,2472,372,65,126,191,6.627345844504021,47.33971393652832
Task_4829,1552,940,92,62,154,1.649309245483528,33.79571639550949
Task_4830,2448,306,31,50,81,7.973941368078176,45.202423917256844
Task_4831,1713,404,194,142,336,4.229629629629629,36.04326108192908
Task_4832,671,980,112,97,209,0.6839959225280327,20.82568041557404
Task_4833,806,104,46,73,119,7.6761904761904765,18.63823727561412
Task_4834,704,797,108,157,265,0.8822055137844611,20.971646605253113
Task_4835,679,578,100,187,287,1.1727115716753023,20.009850300386884
Task_4836,2706,196,197,156,353,13.736040609137056,51.11877595875355
Task_4837,2993,145,76,156,232,20.5,54.736251945595164
Task_4838,1363,988,118,23,141,1.378159757330637,30.59298095295794
Task_4839,796,640,31,164,195,1.2418096723868954,21.586529380540792
Task_4840,2051,628,86,163,249,3.260731319554849,41.707968487617336
Task_4841,2917,66,137,109,246,43.53731343283582,52.74199527290566
Task_4842,2714,1000,15,51,66,2.711288711288711,51.351000726798326
Task_4843,1838,711,77,197,274,2.581460674157303,38.86434492584721
Task_4844,2348,476,192,54,246,4.922431865828092,45.49636347035099
Task_4845,1291,1024,122,42,164,1.2595121951219512,29.879937220494565
Task_4846,1083,833,37,137,174,1.2985611510791366,26.60196332982335
Task_4847,1257,974,199,113,312,1.2892307692307692,30.397299713257908
Task_4848,1695,902,182,168,350,1.8770764119601329,37.427549235636164
Task_4849,2637,308,145,199,344,8.533980582524272,50.457063717159464
Task_4850,693,418,62,76,138,1.6539379474940334,18.771951994020878
Task_4851,1966,419,37,17,54,4.680952380952381,37.329415598584795
Task_4852,1009,524,149,70,219,1.921904761904762,24.370656374016743
Task_4853,2581,83,96,114,210,30.726190476190474,47.40899639091072
Task_4854,565,264,102,179,281,2.1320754716981134,17.241612443220287
Task_4855,859,465,22,121,143,1.8433476394849786,21.608842804305976
Task_4856,1581,716,19,87,106,2.205020920502092,33.44739955082892
Task_4857,1301,799,48,91,139,1.62625,29.676078716656452
Task_4858,1766,919,136,140,276,1.9195652173913043,38.230851377297064
Task_4859,2883,159,23,39,62,18.01875,50.99396578364486
Task_4860,612,235,41,137,178,2.593220338983051,17.351874832603396
Task_4861,967,303,48,112,160,3.1809210526315788,22.94381583704397
Task_4862,1933,784,151,179,330,2.462420382165605,40.75675546673389
Task_4863,1644,672,21,177,198,2.4427934621099556,35.21211874212843
Task_4864,2397,1023,133,183,316,2.3408203125,48.79678960389973
Task_4865,1364,765,99,59,158,1.7806788511749347,30.28610293444831
Task_4866,2792,680,52,134,186,4.0998531571218795,53.36096531421307
Task_4867,1398,655,11,138,149,2.1310975609756095,30.785489894837113
Task_4868,1439,195,82,142,224,7.341836734693878,30.54594921237776
Task_4869,1615,338,15,62,77,4.76401179941003,31.974746559937056
Task_4870,2675,144,16,74,90,18.448275862068964,48.17815255876644
Task_4871,1417,611,40,86,126,2.315359477124183,30.89258722862606
Task_4872,2657,776,183,96,279,3.4195624195624195,51.878507693076955
Task_4873,2126,779,86,141,227,2.7256410256410257,43.23908638448347
Task_4874,2223,934,61,67,128,2.3775401069518716,44.63904391723096
Task_4875,2510,723,118,131,249,3.4668508287292816,49.27072380220269
Task_4876,2472,957,34,29,63,2.580375782881002,47.17808961229781
Task_4877,2216,242,197,27,224,9.119341563786008,42.24613852176835
Task_4878,2777,135,160,97,257,20.419117647058822,51.18310080450792
Task_4879,1779,159,191,90,281,11.11875,35.664047202939194
Task_4880,916,320,136,175,311,2.853582554517134,23.099658388124215
Task_4881,2553,631,55,90,145,4.0395569620253164,49.06254706529876
Task_4882,653,435,155,197,352,1.4977064220183487,19.477090676132736
Task_4883,2847,273,186,65,251,10.39051094890511,52.7740584931712
Task_4884,1081,565,192,82,274,1.9098939929328622,26.111106717761967
Task_4885,2816,558,89,12,101,5.037567084078712,51.825250129920896
Task_4886,1801,69,102,145,247,25.728571428571428,35.3481642225885
Task_4887,2626,307,97,17,114,8.525974025974026,48.10735640596885
Task_4888,1031,936,174,149,323,1.1003201707577375,26.798128362707498
Task_4889,1256,712,177,91,268,1.761570827489481,29.3304592769657
Task_4890,2549,336,164,150,314,7.563798219584569,48.95548595776982
Task_4891,1879,100,109,63,172,18.603960396039604,35.738774716710914
Task_4892,2000,223,16,195,211,8.928571428571429,39.452155805622475
Task_4893,1543,601,158,49,207,2.5631229235880397,32.839903148314306
Task_4894,910,427,62,17,79,2.1261682242990654,20.73438517910576
Task_4895,661,64,92,148,240,10.169230769230769,17.518797990261504
Task_4896,2992,398,24,159,183,7.498746867167919,55.550456336374374
Task_4897,1085,325,167,120,287,3.3282208588957056,25.599577084910923
Task_4898,1684,406,22,106,128,4.137592137592137,34.55905528914942
Task_4899,861,702,80,44,124,1.22475106685633,21.607418844114928
Task_4900,631,936,171,154,325,0.6734258271077909,20.628454266546257
Task_4901,1200,461,128,170,298,2.5974025974025974,27.976433916461563
Task_4902,2321,576,63,100,163,4.022530329289428,45.38655974978639
Task_4903,1932,780,200,98,298,2.473751600512164,40.47297059363989
Task_4904,1830,470,142,100,242,3.8853503184713376,37.6223725685395
Task_4905,843,820,101,140,241,1.0267965895249695,23.08136772490565
Task_4906,2754,377,199,13,212,7.285714285714286,51.10533968738316
Task_4907,2060,831,50,27,77,2.4759615384615383,40.29571638026331
Task_4908,673,140,189,87,276,4.773049645390071,18.030075122314297
Task_4909,1744,476,124,113,237,3.6561844863731654,36.276756213406856
Task_4910,1211,196,121,137,258,6.147208121827411,27.067390789529497
Task_4911,836,237,143,63,206,3.5126050420168067,20.64509647519117
Task_4912,2071,550,189,147,336,3.7586206896551726,42.18589216772219
Task_4913,1658,383,60,180,240,4.317708333333333,34.797240067307094
Task_4914,1686,536,65,20,85,3.1396648044692737,33.68279730841117
Task_4915,695,734,135,117,252,0.9455782312925171,20.526204273992786
Task_4916,1050,975,110,119,229,1.0758196721311475,26.748351761096988
Task_4917,1133,658,176,132,308,1.7192716236722307,27.50925466196955
Task_4918,2567,110,142,86,228,23.126126126126128,47.33189084651308
Task_4919,660,128,98,94,192,5.116279069767442,17.48373219795009
Task_4920,2779,106,172,10,182,25.97196261682243,49.806291102720984
Task_4921,2941,220,199,26,225,13.307692307692308,53.61608633374093
Task_4922,2145,762,109,98,207,2.8112712975098297,43.38092612569838
Task_4923,2181,734,137,71,208,2.9673469387755103,43.578679756230486
Task_4924,2168,405,90,20,110,5.3399014778325125,41.176849587741316
Task_4925,2078,930,11,143,154,2.2320085929108484,42.397180005525975
Task_4926,2963,159,199,16,215,18.51875,53.41847250771257
Task_4927,610,166,169,143,312,3.6526946107784433,17.515695962410323
Task_4928,647,112,185,197,382,5.725663716814159,18.159985799954327
Task_4929,523,776,21,77,98,0.6731016731016731,16.88152636500389
Task_4930,729,636,87,110,197,1.1444270015698588,20.396643657551266
Task_4931,2080,780,153,63,216,2.6632522407170294,42.106788923104325
Task_4932,1483,609,29,120,149,2.4311475409836065,32.00539921909189
Task_4933,2136,848,103,71,174,2.5159010600706715,43.042135862429994
Task_4934,2291,740,160,128,288,3.0917678812415654,46.02634245687957
Task_4935,1844,236,10,55,65,7.780590717299578,35.114052943937054
Task_4936,1178,745,152,36,188,1.579088471849866,27.294414780126896
Task_4937,1874,132,123,77,200,14.090225563909774,36.38507194263028
Task_4938,847,978,139,117,256,0.8651685393258427,23.697745193350553
Task_4939,1336,511,119,108,227,2.609375,29.876466678936378
Task_4940,890,440,78,63,141,2.018140589569161,21.832710134846298
Task_4941,2215,617,177,102,279,3.5841423948220066,44.35606426923881
Task_4942,2926,328,122,44,166,8.893617021276595,53.56065348355674
Task_4943,2514,922,167,28,195,2.723726977248104,49.05460824074017
Task_4944,2888,960,162,107,269,3.0052029136316336,56.05795766711401
Task_4945,982,581,115,137,252,1.6872852233676976,24.6326050408142
Task_4946,2800,1014,82,73,155,2.7586206896551726,53.96254758880045
Task_4947,1751,280,24,106,130,6.2313167259786475,35.081862993335335
Task_4948,922,872,173,34,207,1.0561282932416953,23.747608594294405
Task_4949,941,669,100,173,273,1.4044776119402984,24.364293802097063
Task_4950,1342,936,67,36,103,1.432230522945571,29.724848207640346
Task_4951,1813,124,167,173,340,14.504,36.392436297738136
Task_4952,2132,778,10,68,78,2.736842105263158,41.67999227327385
Task_4953,2855,777,150,18,168,3.6696658097686377,53.75450983684856
Task_4954,2548,440,43,21,64,5.777777777777778,46.65821509484476
Task_4955,1722,88,137,142,279,19.348314606741575,34.33538653531747
Task_4956,1776,655,18,78,96,2.707317073170732,36.11144537706253
Task_4957,2405,523,28,44,72,4.5896946564885495,44.73930312482691
Task_4958,2158,258,63,94,157,8.332046332046332,41.62288273869676
Task_4959,517,373,54,176,230,1.3823529411764706,16.61343280905718
Task_4960,957,74,28,170,198,12.76,21.945056311525132
Task_4961,2631,862,77,151,228,3.048667439165701,51.62580144602344
Task_4962,1668,798,200,43,243,2.0876095118898625,35.49894339675754
Task_4963,2223,273,165,104,269,8.113138686131387,43.31157142483894
Task_4964,1131,727,196,31,227,1.5535714285714286,26.68506646428517
Task_4965,2297,206,103,37,140,11.096618357487923,42.90924010095076
Task_4966,2130,513,191,144,335,4.143968871595331,42.993032797112704
Task_4967,537,121,167,46,213,4.401639344262295,14.99206703598132
Task_4968,530,599,20,105,125,0.8833333333333333,16.718371300235244
Task_4969,1854,177,38,44,82,10.415730337078651,35.133400177636396
Task_4970,1013,383,169,10,179,2.6380208333333335,23.415894328414723
Task_4971,546,909,62,196,258,0.6,19.036972946430804
Task_4972,1323,600,16,19,35,2.201331114808652,27.50066146220557
Task_4973,2408,579,55,39,94,4.151724137931034,45.36095920907663
Task_4974,1587,183,64,116,180,8.625,32.4887390724621
Task_4975,979,330,12,38,50,2.9577039274924473,21.536402702506695
Task_4976,2642,341,180,68,248,7.7251461988304095,49.7495751553875
Task_4977,1845,358,192,147,339,5.139275766016713,38.00220580267652
Task_4978,537,145,144,174,318,3.6780821917808217,16.37105381960234
Task_4979,1806,778,119,139,258,2.318356867779204,38.34285425898778
Task_4980,794,236,59,43,102,3.350210970464135,18.741687985807946
Task_4981,1024,239,100,171,271,4.266666666666667,24.355333040343144
Task_4982,804,318,56,47,103,2.520376175548589,19.196392498622288
Task_4983,703,254,171,163,334,2.756862745098039,19.605503843902763
Task_4984,1768,261,48,68,116,6.748091603053435,34.95345141384019
Task_4985,1721,425,166,154,320,4.039906103286385,36.18321219096985
Task_4986,2848,726,35,159,194,3.9174690508940855,54.44183352834952
Task_4987,676,325,89,22,111,2.0736196319018405,17.33052102878216
Task_4988,2388,1008,70,71,141,2.3666997026759167,47.41178379904804
Task_4989,1685,794,174,143,317,2.119496855345912,36.7475772365631
Task_4990,1327,448,32,148,180,2.955456570155902,29.356609096435648
Task_4991,2378,993,118,168,286,2.3923541247484907,48.24512207221844
Task_4992,2698,576,56,26,82,4.675909878682842,49.8304998170824
Task_4993,1033,96,34,95,129,10.649484536082474,22.40567829249865
Task_4994,2916,243,141,61,202,11.950819672131148,53.45807097862865
Task_4995,896,86,23,142,165,10.298850574712644,20.746671422180764
Task_4996,942,988,199,186,385,0.9524772497472194,25.9259473657857
Task_4997,2827,638,68,49,117,4.424100156494522,52.58975487671722
Task_4998,2218,1014,15,192,207,2.185221674876847,45.437649586805605
Task_4999,560,175,116,34,150,3.1818181818181817,15.215962832353421
Task_5000,1228,929,83,123,206,1.3204301075268816,29.371689938559864
Task_5001,2043,158,42,63,105,12.849056603773585,38.314565647027884
Task_5002,1503,282,61,14,75,5.310954063604241,29.49363778259799
Task_5003,2534,1016,92,13,105,2.4916420845624385,48.87393196157151
Task_5004,2718,904,48,148,196,3.0033149171270717,52.980026297551916
Task_5005,814,461,188,46,234,1.7619047619047619,20.87808889461255
Task_5006,1259,958,98,197,295,1.3128258602711158,30.44448709589595
Task_5007,1255,966,199,158,357,1.297828335056877,30.609618769844
Task_5008,2940,212,193,183,376,13.80281690140845,55.00605836250994
Task_5009,1621,981,17,47,64,1.65071283095723,33.80145934154481
Task_5010,2259,955,156,74,230,2.3629707112970713,45.67248381924878
Task_5011,1986,817,148,94,242,2.4278728606356967,41.1716558453229
Task_5012,1615,855,130,171,301,1.8866822429906542,35.79738226908283
Task_5013,1336,473,111,27,138,2.818565400843882,28.55385049319088
Task_5014,1104,494,170,15,185,2.2303030303030305,25.22477172128448
Task_5015,502,626,47,42,89,0.8006379585326954,15.558750610340224
Task_5016,2511,797,51,163,214,3.1466165413533833,49.50654704389866
Task_5017,2775,480,24,81,105,5.769230769230769,51.57342131366092
Task_5018,2530,906,95,131,226,2.78941565600882,50.06808614623616
Task_5019,2248,923,52,100,152,2.432900432900433,45.11727333456858
Task_5020,2246,314,98,196,294,7.130158730158731,44.06976431885119
Task_5021,1686,278,152,54,206,6.043010752688172,34.188346698160075
Task_5022,2846,420,177,170,347,6.760095011876484,54.115770863922556
Task_5023,1940,379,102,183,285,5.105263157894737,39.383679532575506
Task_5024,1117,245,27,142,169,4.540650406504065,25.28795365480713
Task_5025,805,743,119,155,274,1.081989247311828,22.403965202322922
Task_5026,2843,796,94,168,262,3.5671267252195733,54.89908412739962
Task_5027,938,529,48,78,126,1.769811320754717,23.036647910223238
Task_5028,2280,966,125,101,226,2.357807652533609,46.23943840218781
Task_5029,1425,555,133,57,190,2.5629496402877696,30.867322045441743
Task_5030,2046,162,102,113,215,12.552147239263803,39.6777397882452
Task_5031,904,505,23,53,76,1.7865612648221343,21.20021457505692
Task_5032,1902,247,158,60,218,7.669354838709677,37.52856960728841
Task_5033,1598,288,178,136,314,5.529411764705882,33.733876633583
Task_5034,2594,740,11,139,150,3.5006747638326585,49.97319789958849
Task_5035,1055,188,79,55,134,5.582010582010582,23.630016822001778
Task_5036,1637,71,17,21,38,22.73611111111111,29.790452825661436
Task_5037,1422,454,40,132,172,3.1252747252747253,30.822364827479134
Task_5038,2200,577,170,29,199,3.8062283737024223,43.01861272174392
Task_5039,2505,504,49,90,139,4.96039603960396,47.879873117688284
Task_5040,996,633,150,28,178,1.5709779179810726,24.015057856358453
Task_5041,2037,152,174,74,248,13.313725490196079,39.34228691660532
Task_5042,1913,313,145,66,211,6.092356687898089,37.95415112217545
Task_5043,2021,689,18,115,133,2.928985507246377,40.70561312022413
Task_5044,987,807,190,24,214,1.2215346534653466,24.54873637056879
Task_5045,1263,524,162,28,190,2.4057142857142857,27.965712729903643
Task_5046,647,783,76,72,148,0.8252551020408163,19.185868103105975
Task_5047,1217,602,145,48,193,2.0182421227197347,27.55093079245726
Task_5048,1615,577,77,51,128,2.7941176470588234,33.659368328036074
Task_5049,2544,627,57,180,237,4.050955414012739,49.58981253885758
Task_5050,2234,149,104,144,248,14.893333333333333,42.78325574388314
Task_5051,947,932,29,12,41,1.015005359056806,22.78865675932312
Task_5052,2065,972,138,171,309,2.1223021582733814,43.3278023178006
Task_5053,2563,514,113,135,248,4.976699029126213,49.44626978023738
Task_5054,1914,293,38,89,127,6.510204081632653,37.72239989634036
Task_5055,1979,546,28,196,224,3.6179159049360146,40.27348945800042
Task_5056,1220,90,166,89,255,13.406593406593407,26.20736014994598
Task_5057,1764,148,48,75,123,11.838926174496644,34.125662657028954
Task_5058,553,972,190,120,310,0.5683453237410072,19.373738393716334
Task_5059,1677,357,59,77,136,4.684357541899441,34.13703811264036
Task_5060,2297,205,100,76,176,11.150485436893204,43.5694340377835
Task_5061,622,244,177,106,283,2.5387755102040814,17.979882025052127
Task_5062,1003,293,120,191,311,3.4115646258503403,24.41135206987724
Task_5063,2790,853,88,60,148,3.2669789227166275,53.120938955602924
Task_5064,1750,746,138,101,239,2.3427041499330654,37.2144033929661
Task_5065,858,465,137,32,169,1.8412017167381973,21.247749722746516
Task_5066,2370,334,199,93,292,7.074626865671642,45.91846583727307
Task_5067,1569,878,126,170,296,1.7849829351535835,35.11602969078167
Task_5068,1259,946,16,74,90,1.3294614572333685,28.747592339348028
Task_5069,1998,206,95,196,291,9.652173913043478,39.756479509991
Task_5070,1626,885,65,121,186,1.835214446952596,35.50974257286711
Task_5071,1310,496,199,171,370,2.6358148893360163,30.154348954513548
Task_5072,2914,405,47,199,246,7.177339901477833,54.7691837033208
Task_5073,2438,613,85,57,142,3.970684039087948,46.78005310549281
Task_5074,830,821,55,72,127,1.0097323600973236,22.09498209974269
Task_5075,1044,905,20,104,124,1.1523178807947019,25.731945580904082
Task_5076,1435,216,168,193,361,6.612903225806452,31.205142793717034
Task_5077,2926,705,19,145,164,4.144475920679887,55.37959196318844
Task_5078,1877,248,32,116,148,7.538152610441767,37.041051111751806
Task_5079,2970,680,89,157,246,4.361233480176211,56.424839812422796
Task_5080,1042,296,114,75,189,3.508417508417508,24.1363128936999
Task_5081,1624,1019,19,41,60,1.592156862745098,33.98371146900338
Task_5082,2057,803,80,147,227,2.558457711442786,42.32282618060421
Task_5083,872,1005,151,87,238,0.8667992047713717,24.000455299837938
Task_5084,796,961,165,193,358,0.8274428274428275,23.40746696962375
Task_5085,1141,559,64,139,203,2.0375,26.947391054138365
Task_5086,2343,443,132,149,281,5.277027027027027,45.902631347578925
Task_5087,578,454,194,164,358,1.2703296703296703,18.30963541998118
Task_5088,1031,653,115,40,155,1.5764525993883791,24.405876701706692
Task_5089,1739,355,96,158,254,4.884831460674158,35.95624966602031
Task_5090,1671,662,130,103,233,2.520361990950226,35.676000225809865
Task_5091,2235,477,50,85,135,4.675732217573222,43.48173828819126
Task_5092,2212,497,186,60,246,4.4417670682730925,43.391902194909164
Task_5093,1062,806,33,45,78,1.3159851301115242,24.513447483311907
Task_5094,1660,191,66,155,221,8.645833333333334,34.04670461480552
Task_5095,2938,978,160,48,208,3.001021450459653,56.05925746638251
Task_5096,1323,176,106,21,127,7.47457627118644,27.05644587478973
Task_5097,2122,336,167,35,202,6.29673590504451,41.020678409300935
Task_5098,2503,842,91,20,111,2.9691577698695135,47.89079717769523
Task_5099,2013,747,45,180,225,2.6911764705882355,41.464698982500465
Task_5100,2141,828,122,84,206,2.5826296743063932,43.41690180012525
Task_5101,2370,708,160,33,193,3.3427362482369536,46.10098591036617
Task_5102,2010,690,32,99,131,2.9088277858176554,40.51590913244341
Task_5103,2459,409,57,168,225,5.9975609756097565,47.46870837581665
Task_5104,1969,741,125,16,141,2.6536388140161726,39.38470976674881
Task_5105,581,656,80,59,139,0.8843226788432268,17.59498008357867
Task_5106,1000,120,195,51,246,8.264462809917354,22.55840247643535
Task_5107,858,657,153,65,218,1.303951367781155,22.391167832936272
Task_5108,1188,539,81,160,241,2.2,27.813961998057948
Task_5109,1942,950,41,37,78,2.0420609884332284,38.89483201399138
Task_5110,2056,232,131,31,162,8.82403433476395,39.37010760249778
Task_5111,1786,259,18,16,34,6.869230769230769,33.722100440278915
Task_5112,754,91,129,10,139,8.195652173913043,17.36847328203137
Task_5113,2962,950,81,14,95,3.114616193480547,55.31853993677701
Task_5114,2320,322,27,13,40,7.182662538699691,42.43140138719254
Task_5115,1497,273,106,120,226,5.463503649635037,31.6665665798548
Task_5116,1429,283,156,154,310,5.03169014084507,31.053885261676115
Task_5117,1695,844,196,112,308,2.0059171597633134,36.9757584392121
Task_5118,2331,151,10,177,187,15.335526315789474,43.948517606166774
Task_5119,1926,77,109,176,285,24.692307692307693,37.5380181493382
Task_5120,2399,664,101,174,275,3.607518796992481,47.5065081187358
Task_5121,2357,857,141,23,164,2.747086247086247,46.18129194743256
Task_5122,1621,741,12,42,54,2.184636118598383,33.040528935551386
Task_5123,2296,692,176,155,331,3.313131313131313,46.18793337117403
Task_5124,589,157,51,131,182,3.7278481012658227,16.567985512160476
Task_5125,2288,437,117,17,134,5.223744292237443,43.441345700101444
Task_5126,541,783,163,16,179,0.6900510204081632,17.486589801424607
Task_5127,1865,510,115,194,309,3.649706457925636,38.744064972393076
Task_5128,803,206,194,71,265,3.8792270531400965,20.338496323373317
Task_5129,2936,595,133,143,276,4.926174496644295,55.750914498562814
Task_5130,1535,340,151,69,220,4.5014662756598245,32.10443606309122
Task_5131,1083,418,21,163,184,2.58472553699284,25.411926872738267
Task_5132,512,953,165,123,288,0.5366876310272537,18.574005107697133
Task_5133,2705,671,98,141,239,4.025297619047619,52.169078126252735
Task_5134,1845,823,108,192,300,2.2390776699029127,39.36813452045085
Task_5135,2222,516,17,173,190,4.297872340425532,43.80331982046622
Task_5136,1891,712,176,170,346,2.652173913043478,39.92502021794943
Task_5137,914,380,185,44,229,2.3989501312335957,22.178930990138895
Task_5138,850,701,20,61,81,1.210826210826211,21.2823745270105
Task_5139,1724,552,195,147,342,3.11754068716094,36.724796967922565
Task_5140,2469,921,148,139,287,2.677874186550976,49.42470376760421
Task_5141,714,78,162,159,321,9.037974683544304,18.6958803795857
Task_5142,1546,351,111,50,161,4.392045454545454,31.76630700125376
Task_5143,2866,751,179,59,238,3.8111702127659575,54.5203098264764
Task_5144,1979,331,185,44,229,5.960843373493976,38.866006813012746
Task_5145,2643,632,41,44,85,4.1753554502369665,49.24380497153206
Task_5146,1854,749,151,58,209,2.472,38.360364137913315
Task_5147,937,241,168,54,222,3.871900826446281,22.299635444031356
Task_5148,1752,364,39,163,202,4.8,35.966625156779656
Task_5149,1730,888,123,195,318,1.9460067491563555,37.83395804647537
Task_5150,2743,737,107,196,303,3.71680216802168,53.344535446776625
Task_5151,2068,417,166,94,260,4.947368421052632,41.28368865559266
Task_5152,1756,758,33,200,233,2.313570487483531,37.4713462919679
Task_5153,2324,106,90,26,116,21.7196261682243,42.210030965307645
Task_5154,1402,227,73,189,262,6.149122807017544,30.33068307488899
Task_5155,2892,307,146,102,248,9.38961038961039,53.91065314953238
Task_5156,1623,415,116,154,270,3.9014423076923075,34.374732888532606
Task_5157,1016,519,149,21,170,1.9538461538461538,23.839139772020577
Task_5158,1414,857,170,189,359,1.648018648018648,32.89324339284324
Task_5159,2154,297,190,186,376,7.228187919463087,42.90724351124343
Task_5160,792,805,14,74,88,0.9826302729528535,20.935803563076153
Task_5161,1862,212,107,45,152,8.741784037558686,36.08169228940564
Task_5162,660,499,181,45,226,1.32,18.51755093341495
Task_5163,1523,392,88,131,219,3.8753180661577606,32.41334803103916
Task_5164,1550,770,53,38,91,2.0103761348897535,32.380479356658604
Task_5165,1792,973,100,199,299,1.839835728952772,39.00076271335618
Task_5166,1442,863,170,181,351,1.6689814814814814,33.30773984579033
Task_5167,1631,1003,104,140,244,1.6245019920318724,36.19470682677425
Task_5168,2645,488,55,82,137,5.408997955010225,49.998396143605454
Task_5169,2851,476,15,152,167,5.976939203354298,53.478899204150366
Task_5170,1026,707,63,122,185,1.4491525423728813,25.39554096254801
Task_5171,638,118,85,103,188,5.361344537815126,17.0602384508716
Task_5172,2266,318,138,91,229,7.103448275862069,43.893683627005224
Task_5173,1723,451,186,130,316,3.811946902654867,36.24527829104953
Task_5174,2089,817,64,162,226,2.553789731051345,42.908010465867335
Task_5175,1363,732,182,141,323,1.859481582537517,31.47729211167983
Task_5176,503,903,103,182,285,0.5564159292035398,18.331529475882654
Task_5177,663,455,187,102,289,1.4539473684210527,19.26359377423967
Task_5178,1281,643,76,19,95,1.9891304347826086,27.740579249389423
Task_5179,1753,806,93,68,161,2.1722428748451055,36.67856587647835
Task_5180,2649,674,52,171,223,3.9244444444444446,51.331246235450884
Task_5181,2766,645,99,87,186,4.281733746130031,52.63790114725102
Task_5182,2903,743,181,200,381,3.9018817204301075,56.25553241486282
Task_5183,2222,259,188,26,214,8.546153846153846,42.3560855471325
Task_5184,913,956,141,113,254,0.9540229885057471,24.67005243631254
Task_5185,710,595,53,118,171,1.191275167785235,19.935413361674463
Task_5186,882,320,91,163,254,2.7476635514018692,22.286843270249147
Task_5187,2179,1023,142,86,228,2.1279296875,44.73691729555215
Task_5188,923,216,163,85,248,4.253456221198157,22.375913816067158
Task_5189,1918,727,196,184,380,2.6346153846153846,40.57348586903889
Task_5190,1066,622,43,103,146,1.71107544141252,25.408432490932892
Task_5191,1733,332,66,52,118,5.2042042042042045,34.45836291430245
Task_5192,580,495,128,169,297,1.1693548387096775,18.202912212190288
Task_5193,1779,401,133,127,260,4.425373134328358,36.713370312998045
Task_5194,1998,487,122,146,268,4.094262295081967,40.52092652163415
Task_5195,890,683,29,121,150,1.3011695906432748,22.753182315393065
Task_5196,2662,219,157,192,349,12.1,50.53604808574406
Task_5197,2828,288,173,25,198,9.785467128027681,51.94448238668662
Task_5198,1201,940,148,72,220,1.2763018065887355,28.75339956680112
Task_5199,2268,1016,30,75,105,2.230088495575221,45.182947355301316
Task_5200,1213,1002,31,80,111,1.2093718843469592,28.609475049816094
Task_5201,1556,1009,100,45,145,1.5405940594059406,33.82454757256465
Task_5202,2683,270,77,43,120,9.900369003690036,48.96804607385306
Task_5203,2117,373,25,26,51,5.660427807486631,39.63464220754005
Task_5204,620,257,50,79,129,2.4031007751937983,17.28767670236301
Task_5205,785,833,111,11,122,0.9412470023980816,20.886389047779844
Task_5206,2590,935,38,12,50,2.767094017094017,48.797892585848324
Task_5207,686,654,55,18,73,1.047328244274809,17.840259192732727
Task_5208,2447,989,21,134,155,2.4717171717171715,48.48061596176303
Task_5209,1721,577,152,166,318,2.9775086505190314,36.67598170075607
Task_5210,1297,457,104,128,232,2.831877729257642,29.140095250177946
Task_5211,1704,210,23,113,136,8.075829383886257,34.083990339047205
Task_5212,1372,794,186,17,203,1.7257861635220126,30.498564525161346
Task_5213,1117,945,154,58,212,1.1807610993657505,27.30253789420719
Task_5214,1358,615,79,172,251,2.2045454545454546,30.81366917129391
Task_5215,2026,825,194,200,394,2.4527845036319613,42.67747391019051
Task_5216,2844,913,95,103,198,3.111597374179431,54.898209048923064
Task_5217,2723,592,71,42,113,4.591905564924114,50.7101792343131
Task_5218,2069,600,73,62,135,3.442595673876872,40.929990504177454
Task_5219,1227,432,181,107,288,2.8337182448036953,28.17439824063621
Task_5220,1281,273,171,99,270,4.675182481751825,28.414177360989388
Task_5221,914,102,148,70,218,8.87378640776699,20.962019671705637
Task_5222,2592,305,111,198,309,8.470588235294118,49.57579751553635
Task_5223,2174,939,29,100,129,2.3127659574468087,43.920162814373505
Task_5224,1439,607,124,138,262,2.366776315789474,32.01111773346843
Task_5225,646,679,70,112,182,0.95,19.252043550204093
Task_5226,1886,473,54,85,139,3.978902953586498,37.93136260350932
Task_5227,2358,886,100,53,153,2.6583990980834273,46.43039076956515
Task_5228,1767,573,73,175,248,3.078397212543554,37.149420642055006
Task_5229,1685,655,52,128,180,2.5685975609756095,35.71981725995925
Task_5230,2397,756,99,44,143,3.166446499339498,46.321147976853375
Task_5231,2041,973,75,131,206,2.095482546201232,42.49253378042562
Task_5232,2368,147,174,102,276,16.0,44.95450523825273
Task_5233,1226,737,37,82,119,1.6612466124661247,28.095057661814327
Task_5234,750,1014,13,87,100,0.7389162561576355,21.113202988917667
Task_5235,1477,318,29,146,175,4.630094043887147,31.28937872516157
Task_5236,1404,975,127,50,177,1.4385245901639345,31.650543130304683
Task_5237,2858,722,117,157,274,3.9529737206085755,54.93102936761594
Task_5238,2397,849,173,179,352,2.82,48.410510521385014
Task_5239,757,132,24,43,67,5.69172932330827,17.270314595809623
Task_5240,2551,700,166,68,234,3.6390870185449358,49.411377746431405
Task_5241,984,823,46,97,143,1.1941747572815533,24.723670751285194
Task_5242,949,917,141,193,334,1.0337690631808278,25.557878674715365
Task_5243,2059,336,187,88,275,6.109792284866469,40.87983272802253
Task_5244,2330,506,74,155,229,4.595660749506903,45.73588689128136
Task_5245,1167,619,99,67,166,1.882258064516129,26.947513204597787
Task_5246,1675,764,42,94,136,2.189542483660131,35.480849634532355
Task_5247,2853,981,98,118,216,2.905295315682281,55.350408532713836
Task_5248,2451,490,195,187,382,4.991853360488799,48.27576393929127
Task_5249,2998,296,196,74,270,10.094276094276093,55.42691858926784
Task_5250,2389,770,92,186,278,3.098573281452659,47.72066128764008
Task_5251,2297,521,133,86,219,4.400383141762452,44.988514468762766
Task_5252,970,641,63,87,150,1.5109034267912773,23.958189188215698
Task_5253,936,485,100,61,161,1.9259259259259258,22.66345229751902
Task_5254,1164,828,23,56,79,1.4041013268998794,26.428596858222765
Task_5255,1949,279,121,183,304,6.960714285714285,39.27532214558621
Task_5256,2396,673,86,18,104,3.5548961424332344,45.539223836176824
Task_5257,2294,585,140,110,250,3.9146757679180886,45.38662756344407
Task_5258,1655,69,182,121,303,23.642857142857142,33.28225229072675
Task_5259,2975,347,112,27,139,8.548850574712644,54.08591862714735
Task_5260,578,202,63,56,119,2.8472906403940885,15.669227781941679
Task_5261,2712,386,80,80,160,7.007751937984496,50.72710709770993
Task_5262,2955,375,148,105,253,7.85904255319149,55.170168424150916
Task_5263,963,489,36,12,48,1.9653061224489796,21.60205869346032
Task_5264,1966,659,85,88,173,2.978787878787879,39.974790470496266
Task_5265,875,168,187,63,250,5.177514792899408,21.047760721671526
Task_5266,2229,64,199,140,339,34.292307692307695,42.445863892151635
Task_5267,614,471,192,197,389,1.3008474576271187,19.12059081980644
Task_5268,605,500,114,14,128,1.2075848303393213,17.067967843597177
Task_5269,2800,471,170,144,314,5.932203389830509,53.3691186704876
Task_5270,2082,777,173,134,307,2.6760925449871467,42.92578836532751
Task_5271,1301,678,67,74,141,1.9160530191458027,29.22377496515196
Task_5272,2450,640,98,11,109,3.8221528861154446,46.37278086801826
Task_5273,2385,275,165,149,314,8.641304347826088,46.147959102245636
Task_5274,920,821,149,14,163,1.119221411192214,23.21227296206749
Task_5275,857,905,196,199,395,0.9459161147902869,24.386581395500055
Task_5276,2861,903,131,163,294,3.1648230088495577,55.646616945065965
Task_5277,1165,945,21,188,209,1.2315010570824525,28.46058246065125
Task_5278,717,1021,116,178,294,0.7015655577299413,22.13096507601273
Task_5279,1056,508,16,90,106,2.074656188605108,24.471638484521325
Task_5280,2358,973,152,71,223,2.4209445585215605,47.19762790742123
Task_5281,1365,350,121,119,240,3.888888888888889,29.895913661487906
Task_5282,2980,698,20,30,50,4.263233190271817,54.36105945767304
Task_5283,2116,740,11,195,206,2.855600539811066,42.94302062447432
Task_5284,2008,117,118,161,279,17.016949152542374,39.10807536548424
Task_5285,2723,224,160,148,308,12.102222222222222,51.269730107265595
Task_5286,2323,114,148,126,274,20.2,43.938416931495304
Task_5287,2235,124,45,139,184,17.88,42.1942481205806
Task_5288,1018,386,25,115,140,2.6304909560723515,23.85170415236151
Task_5289,2194,118,183,125,308,18.436974789915965,42.12912991377778
Task_5290,912,661,79,188,267,1.3776435045317221,23.93937220438148
Task_5291,1964,897,57,51,108,2.1870824053452114,39.6608242172159
Task_5292,2884,381,23,34,57,7.549738219895288,51.86405476139814
Task_5293,1997,857,128,131,259,2.3275058275058274,41.60823884169603
Task_5294,741,470,26,63,89,1.5732484076433122,18.944602845457883
Task_5295,1944,901,32,104,136,2.155210643015521,40.11073175847769
Task_5296,2726,709,68,101,169,3.83943661971831,52.26860949725113
Task_5297,2613,656,50,128,178,3.9771689497716896,50.438483226279175
Task_5298,1959,120,117,87,204,16.1900826446281,37.82864697433886
Task_5299,1287,207,157,11,168,6.1875,27.085430735019983
Task_5300,2104,826,199,43,242,2.5441354292623943,42.48952939064451
Task_5301,1169,819,104,164,268,1.425609756097561,28.406297796226102
Task_5302,1727,518,78,145,223,3.327552986512524,36.19218453103367
Task_5303,2633,323,39,106,145,8.126543209876543,49.246579249355996
Task_5304,1463,70,135,116,251,20.6056338028169,30.04611929868842
Task_5305,1895,215,88,85,173,8.773148148148149,37.306955624580304
Task_5306,1811,228,126,117,243,7.908296943231441,36.54281282162538
Task_5307,1193,658,77,77,154,1.810318664643399,27.442091796609272
Task_5308,1517,848,25,141,166,1.7868080094228505,33.525201329641135
Task_5309,1490,107,141,99,240,13.796296296296296,30.59405014851717
Task_5310,1919,885,75,91,166,2.1659142212189617,40.00087898768104
Task_5311,1289,379,75,47,122,3.392105263157895,27.38140824682007
Task_5312,1190,244,169,126,295,4.857142857142857,27.03683778933774
Task_5313,1154,891,29,114,143,1.2937219730941705,27.557596987923358
Task_5314,1966,986,76,37,113,1.9918946301925025,39.935337511041475
Task_5315,2671,366,11,173,184,7.277929155313352,50.361453952397746
Task_5316,959,712,105,58,163,1.3450210378681626,23.848611564512556
Task_5317,594,704,182,193,375,0.8425531914893617,19.48918280226494
Task_5318,2756,274,149,121,270,10.021818181818182,51.76888051803625
Task_5319,2677,372,33,120,153,7.176943699731903,50.119335256420136
Task_5320,1690,762,17,127,144,2.2149410222804717,35.68816071889609
Task_5321,762,286,179,128,307,2.6550522648083623,20.468426992473294
Task_5322,818,855,177,89,266,0.955607476635514,22.834452557230303
Task_5323,1495,726,133,151,284,2.0563961485557085,33.38850850658225
Task_5324,2824,680,88,129,217,4.146842878120411,53.92031865519667
Task_5325,662,704,75,194,269,0.9390070921985816,20.112271484863896
Task_5326,1833,603,32,25,57,3.0347682119205297,35.930399306345336
Task_5327,1560,845,112,115,227,1.8439716312056738,34.4792346671649
Task_5328,2495,881,144,87,231,2.828798185941043,49.32173801344001
Task_5329,2414,740,175,167,342,3.2577597840755734,48.27540162329124
Task_5330,916,205,101,164,265,4.446601941747573,22.49745220368462
Task_5331,901,227,67,141,208,3.9517543859649122,22.118831951388874
Task_5332,955,798,190,26,216,1.1952440550688361,24.056892748834244
Task_5333,2498,768,87,62,149,3.2483745123537062,48.26299794067398
Task_5334,1693,556,162,97,259,3.0394973070017954,35.8275880729371
Task_5335,1431,782,125,87,212,1.8275862068965518,32.06940974854763
Task_5336,2368,155,46,41,87,15.179487179487179,43.07289343402377
Task_5337,804,832,30,48,78,0.9651860744297719,20.681787180278704
Task_5338,2417,440,73,73,146,5.480725623582766,46.12300245270288
Task_5339,2005,894,185,70,255,2.2402234636871508,41.46513056759256
Task_5340,1353,750,133,16,149,1.8015978695073236,29.743044253545914
Task_5341,2948,893,75,49,124,3.2975391498881432,55.41948324105252
Task_5342,1074,470,84,114,198,2.2802547770700636,25.487477718089753
Task_5343,2251,795,173,181,354,2.827889447236181,45.9402940746784
Task_5344,1854,140,187,121,308,13.148936170212766,36.946778433020434
Task_5345,2446,608,97,13,110,4.016420361247947,46.23457825866751
Task_5346,2734,342,186,40,226,7.970845481049563,50.83312705869567
Task_5347,1977,594,145,38,183,3.3226890756302523,39.470973197574224
Task_5348,2194,745,76,54,130,2.941018766756032,43.29598917850262
Task_5349,732,1015,64,57,121,0.7204724409448819,20.778430643403574
Task_5350,1079,495,126,176,302,2.1754032258064515,26.195071056376353
Task_5351,2182,712,100,23,123,3.0603085553997196,42.515310287136714
Task_5352,1404,547,119,194,313,2.562043795620438,31.580271013999024
Task_5353,1617,500,74,144,218,3.2275449101796405,34.36311540328368
Task_5354,2376,735,75,72,147,3.2282608695652173,46.4214843239576
Task_5355,2464,748,182,99,281,3.289719626168224,48.71205910949908
Task_5356,679,180,164,161,325,3.751381215469613,18.71118763256439
Task_5357,634,157,102,20,122,4.012658227848101,15.959841258861454
Task_5358,1311,599,86,120,206,2.185,29.640428826933345
Task_5359,837,381,89,191,280,2.1910994764397906,21.9072405166995
Task_5360,2557,738,136,143,279,3.4600811907983764,50.21531496930262
Task_5361,924,632,32,139,171,1.4597156398104265,23.41763913975126
Task_5362,1976,508,158,80,238,3.882121807465619,39.90848623136912
Task_5363,783,328,48,57,105,2.3799392097264436,19.199338235623486
Task_5364,1674,422,139,190,329,3.9574468085106385,35.523069824166406
Task_5365,1066,850,59,136,195,1.2526439482961222,26.551987942924153
Task_5366,918,980,47,171,218,0.9357798165137615,24.718638263587636
Task_5367,1522,362,102,50,152,4.192837465564739,31.33144753788619
Task_5368,2185,367,94,127,221,5.9375,42.85980695516354
Task_5369,1511,908,37,13,50,1.6622662266226622,31.62353112232292
Task_5370,512,574,147,40,187,0.8904347826086957,16.28880202564841
Task_5371,1347,621,155,103,258,2.165594855305466,30.528631548546723
Task_5372,694,358,137,118,255,1.9331476323119776,19.3735293008469
Task_5373,2536,936,73,178,251,2.706510138740662,50.48804897025506
Task_5374,2116,171,86,39,125,12.30232558139535,39.50284509972303
Task_5375,2492,288,192,15,207,8.622837370242214,46.62099438688228
Task_5376,2318,511,21,49,70,4.52734375,43.45673094433116
Task_5377,2883,427,155,190,345,6.735981308411215,54.74490496959712
Task_5378,2222,954,24,153,177,2.3267015706806284,45.103653057523864
Task_5379,2366,600,26,20,46,3.9367720465890184,44.13780524699655
Task_5380,1189,438,117,101,218,2.7084282460136673,27.26774807091573
Task_5381,1972,103,83,137,220,18.96153846153846,38.132698153573685
Task_5382,1117,709,92,98,190,1.5732394366197182,26.817870022241934
Task_5383,2193,156,99,15,114,13.968152866242038,40.45965605094515
Task_5384,532,1006,186,195,381,0.5283018867924528,19.60896206109176
Task_5385,2373,454,37,127,164,5.2153846153846155,45.83385798373474
Task_5386,2204,88,115,76,191,24.764044943820224,41.045317395197294
Task_5387,2781,393,69,92,161,7.058375634517766,51.94305994371049
Task_5388,1146,712,86,36,122,1.6072931276297335,26.10816427900191
Task_5389,2932,784,198,69,267,3.735031847133758,55.85412071862236
Task_5390,1531,151,111,102,213,10.072368421052632,31.494086118338647
Task_5391,1039,950,140,20,160,1.092534174553102,25.44777132441783
Task_5392,887,891,60,20,80,0.9943946188340808,22.13561306805215
Task_5393,1718,256,48,13,61,6.684824902723736,32.81235660816654
Task_5394,708,128,103,49,152,5.488372093023256,17.25062133077313
Task_5395,1964,376,32,20,52,5.209549071618037,37.13651927146498
Task_5396,1511,638,199,102,301,2.3646322378716746,33.371612787248296
Task_5397,1698,895,198,130,328,1.8950892857142858,37.298466303548814
Task_5398,2686,344,139,193,332,7.785507246376811,51.29395935574064
Task_5399,2164,492,115,27,142,4.389452332657201,41.759711138747534
Task_5400,2955,610,88,79,167,4.8363338788870704,55.359315376421655
Task_5401,791,930,144,109,253,0.849624060150376,22.63680549294995
Task_5402,1135,266,99,11,110,4.250936329588015,24.37660829388012
Task_5403,2179,842,70,152,222,2.5848161328588373,44.38154686245275
Task_5404,1430,832,39,81,120,1.716686674669868,31.591060381457794
Task_5405,1740,204,111,135,246,8.487804878048781,35.373528861366
Task_5406,2897,1024,109,61,170,2.826341463414634,55.5205000153232
Task_5407,1181,701,48,186,234,1.6823361823361824,28.208976984041257
Task_5408,1395,216,58,116,174,6.428571428571429,29.66186186008062
Task_5409,927,486,101,86,187,1.9034907597535935,23.022748551419898
Task_5410,1705,844,185,32,217,2.0177514792899407,36.10511405781487
Task_5411,1273,167,154,164,318,7.5773809523809526,28.034632447566292
Task_5412,2794,989,77,20,97,2.8222222222222224,52.80659494094221
Task_5413,1565,783,35,47,82,1.996173469387755,32.65697010066925
Task_5414,2683,294,90,146,236,9.094915254237288,50.56475105430838
Task_5415,2472,469,41,17,58,5.259574468085106,45.50762796037082
Task_5416,1108,194,92,140,232,5.682051282051282,25.304360966028796
Task_5417,2919,615,106,48,154,4.738636363636363,54.21120474490939
Task_5418,823,1000,53,124,177,0.8221778221778222,23.035905785564932
Task_5419,649,128,38,59,97,5.0310077519379846,15.948362571956963
Task_5420,1623,224,50,14,64,7.213333333333333,31.18101066448087
Task_5421,948,380,197,110,307,2.4881889763779528,23.68423439871007
Task_5422,2915,255,173,92,265,11.38671875,54.0942956443913
Task_5423,1943,206,155,171,326,9.38647342995169,38.99901104532053
Task_5424,2956,261,151,118,269,11.282442748091603,54.872701602501046
Task_5425,2098,489,65,69,134,4.281632653061225,41.12264140705991
Task_5426,1153,156,155,190,345,7.343949044585988,26.281619260591
Task_5427,971,316,124,189,313,3.0630914826498423,23.98604721765892
Task_5428,1240,685,119,79,198,1.8075801749271136,28.625967823969855
Task_5429,530,580,69,144,213,0.9122203098106713,17.319211827873946
Task_5430,2911,675,50,100,150,4.306213017751479,54.873627013959315
Task_5431,1316,391,141,37,178,3.357142857142857,28.344950527800957
Task_5432,2531,80,93,145,238,31.246913580246915,46.77788956445594
Task_5433,588,537,144,71,215,1.0929368029739777,17.745989403334978
Task_5434,2361,299,120,188,308,7.87,45.88333445873982
Task_5435,638,345,114,196,310,1.8439306358381502,18.808866850749673
Task_5436,2283,615,197,94,291,3.706168831168831,45.46238172760494
Task_5437,2304,847,153,128,281,2.7169811320754715,46.535981258845005
Task_5438,972,788,189,128,317,1.231939163498099,25.34651147694133
Task_5439,1399,364,139,16,155,3.8328767123287673,29.245442648418162
Task_5440,2021,370,149,13,162,5.44743935309973,39.19748782226741
Task_5441,1656,468,199,20,219,3.5309168443496803,34.07169238564992
Task_5442,2556,203,53,46,99,12.529411764705882,46.404957130125744
Task_5443,2003,927,112,79,191,2.158405172413793,41.43447848100042
Task_5444,2020,930,144,181,325,2.1697099892588616,42.57083499689045
Task_5445,980,197,175,114,289,4.94949494949495,23.55408421098925
Task_5446,2361,782,68,90,158,3.0153256704980844,46.54297846485404
Task_5447,1883,252,62,82,144,7.442687747035573,37.20769736942179
Task_5448,2617,476,69,18,87,5.486373165618448,48.288061337703915
Task_5449,1194,424,187,88,275,2.8094117647058825,27.4811358665912
Task_5450,935,371,79,24,103,2.513440860215054,21.480965162249174
Task_5451,2840,349,114,68,182,8.114285714285714,52.576101707946584
Task_5452,2984,399,22,110,132,7.46,55.00630625681739
Task_5453,1231,289,52,189,241,4.244827586206896,27.756262322219083
Task_5454,2217,93,143,36,179,23.585106382978722,40.804741527930595
Task_5455,2623,575,146,179,325,4.553819444444445,51.00383927913233
Task_5456,2488,762,106,93,199,3.260812581913499,48.7474481020623
Task_5457,1358,660,48,134,182,2.05446293494705,30.54977838013146
Task_5458,1601,402,56,97,153,3.9727047146401984,33.27436422573333
Task_5459,589,771,181,164,345,0.7629533678756477,19.469985505471854
Task_5460,931,226,34,120,154,4.101321585903084,22.032564575917494
Task_5461,801,667,94,112,206,1.1991017964071857,21.745651438728686
Task_5462,918,780,78,119,197,1.175416133162612,23.975841171530856
Task_5463,1439,341,72,189,261,4.207602339181286,31.294266379948898
Task_5464,2844,777,89,153,242,3.6555269922879177,54.711666721717414
Task_5465,1297,936,128,155,283,1.384204909284952,30.851585144500145
Task_5466,1084,506,48,87,135,2.138067061143984,25.32813349396663
Task_5467,1832,363,161,18,179,5.032967032967033,36.31336758608224
Task_5468,2106,757,48,64,112,2.778364116094987,41.80588483892571
Task_5469,2019,911,176,115,291,2.213815789473684,42.245854994479224
Task_5470,1878,397,159,47,206,4.71859296482412,37.412623678409126
Task_5471,909,192,63,158,221,4.709844559585492,22.18669099662004
Task_5472,2040,212,94,34,128,9.577464788732394,38.96237076475533
Task_5473,2536,676,157,142,299,3.7459379615952733,49.77569462463973
Task_5474,2053,524,32,112,144,3.9104761904761904,40.70948350998621
Task_5475,2021,230,24,172,196,8.74891774891775,39.72315711724154
Task_5476,2321,596,77,109,186,3.8877721943048575,45.592852351798165
Task_5477,1673,767,98,22,120,2.1783854166666665,34.52385501064196
Task_5478,1794,668,56,199,255,2.681614349775785,37.95251183337211
Task_5479,1671,720,125,17,142,2.3176144244105408,34.60767062811812
Task_5480,2760,706,189,127,316,3.9038189533239036,53.473364512571926
Task_5481,1489,921,98,75,173,1.6149674620390455,33.09074091581008
Task_5482,706,94,24,122,146,7.431578947368421,17.340465394219343
Task_5483,2985,806,55,92,147,3.6988847583643123,56.4446622277824
Task_5484,2871,235,85,83,168,12.165254237288135,52.824645601911755
Task_5485,1756,615,63,111,174,2.8506493506493507,36.66173094408918
Task_5486,827,755,131,189,320,1.093915343915344,23.05068494474698
Task_5487,2228,555,170,80,250,4.0071942446043165,44.10256581248475
Task_5488,2262,558,149,65,214,4.046511627906977,44.30395723410793
Task_5489,1585,862,71,121,192,1.8366164542294323,34.83919338030284
Task_5490,2878,820,26,143,169,3.505481120584653,55.00406244104658
Task_5491,661,600,69,65,134,1.0998336106489184,18.7251816718483
Task_5492,740,557,178,155,333,1.3261648745519714,21.08370980377433
Task_5493,1126,826,56,117,173,1.3615477629987909,27.2864226094961
Task_5494,2731,132,152,124,276,20.533834586466167,50.54939722800108
Task_5495,2763,413,134,97,231,6.673913043478261,52.17754731384263
Task_5496,698,973,132,56,188,0.7166324435318275,20.76592587085838
Task_5497,2529,266,41,78,119,9.47191011235955,47.12450306007332
Task_5498,1311,715,177,161,338,1.8310055865921788,30.697517896087827
Task_5499,606,525,93,26,119,1.1520912547528517,17.03653539078452
Task_5500,644,948,120,115,235,0.678609062170706,20.408687856789047
Task_5501,502,64,94,193,287,7.723076923076923,15.319835417683104
Task_5502,2414,790,79,144,223,3.0518331226295827,47.922374376245806
Task_5503,2944,866,39,101,140,3.395617070357555,55.87495723548826
Task_5504,2486,726,182,32,214,3.4195323246217333,48.09544646036192
Task_5505,1708,70,145,175,320,24.056338028169016,34.275644304826606
Task_5506,1639,901,125,123,248,1.8170731707317074,36.01141704360848
Task_5507,1238,926,59,142,201,1.3354908306364617,29.566229278270086
Task_5508,1373,774,67,185,252,1.7716129032258066,31.57203219450975
Task_5509,862,440,120,40,160,1.9546485260770976,21.101438477220494
Task_5510,950,466,63,47,110,2.0342612419700212,22.06939518094848
Task_5511,1243,377,146,197,343,3.2883597883597884,28.631715161160372
Task_5512,758,973,47,28,75,0.7782340862422998,20.27000660680456
Task_5513,2698,433,169,71,240,6.216589861751152,50.947095809672
Task_5514,2044,157,165,85,250,12.936708860759493,39.628328954270906
Task_5515,2348,238,69,56,125,9.824267782426778,43.99543787308767
Task_5516,1465,245,61,88,149,5.955284552845528,30.601186618482846
Task_5517,2724,230,192,193,385,11.792207792207792,51.721936088263135
Task_5518,528,636,126,150,276,0.8288854003139717,17.72409231369188
Task_5519,766,506,72,132,204,1.5108481262327416,20.78966495354197
Task_5520,2386,672,105,11,116,3.5453194650817235,45.49340669337776
Task_5521,918,90,105,49,154,10.087912087912088,20.107792900059756
Task_5522,1623,161,161,32,193,10.018518518518519,32.304078119616705
Task_5523,1358,911,147,53,200,1.4890350877192982,31.00323157332299
Task_5524,1686,909,17,98,115,1.8527472527472528,35.84408745331462
Task_5525,1286,338,121,104,225,3.793510324483776,28.517756664140567
Task_5526,1844,774,149,13,162,2.3793548387096775,37.68055786897329
Task_5527,1567,214,32,175,207,7.288372093023256,32.559236961037875
Task_5528,1042,594,189,181,370,1.7512605042016807,26.219678153475815
Task_5529,1414,554,97,174,271,2.547747747747748,31.549730783588686
Task_5530,2428,252,181,56,237,9.596837944664031,45.95510882520793
Task_5531,2342,794,94,121,215,2.9459119496855344,46.67473572586689
Task_5532,1836,145,160,142,302,12.575342465753424,36.717689771399314
Task_5533,2471,832,165,69,234,2.966386554621849,48.552372272441126
Task_5534,1426,601,183,43,226,2.3687707641196014,30.973245221123506
Task_5535,1981,177,176,166,342,11.129213483146067,39.305757734357336
Task_5536,852,618,158,41,199,1.3764135702746365,21.81090842131577
Task_5537,1267,930,86,38,124,1.3609022556390977,28.7483570049088
Task_5538,2720,954,36,168,204,2.8481675392670156,53.18808221368159
Task_5539,2783,278,159,47,206,9.974910394265233,51.319697629009276
Task_5540,1857,819,116,33,149,2.2646341463414634,38.03923854105815
Task_5541,2330,171,43,99,142,13.546511627906977,43.43441957886319
Task_5542,1420,236,47,162,209,5.991561181434599,30.34812348523501
Task_5543,1454,951,127,183,310,1.5273109243697478,33.559809447979355
Task_5544,616,981,43,21,64,0.6272912423625254,18.150617618054586
Task_5545,1618,456,140,196,336,3.5404814004376366,34.78622910635597
Task_5546,1385,278,194,65,259,4.96415770609319,29.71955463158429
Task_5547,610,446,193,33,226,1.3646532438478747,17.55952540264691
Task_5548,2269,577,178,58,236,3.92560553633218,44.51324451573654
Task_5549,2322,312,56,102,158,7.4185303514377,44.38710267216419
Task_5550,1797,810,92,44,136,2.215782983970407,36.99669856457694
Task_5551,2387,245,101,64,165,9.703252032520325,45.01108037511832
Task_5552,1074,321,87,39,126,3.3354037267080745,23.89331955461169
Task_5553,1850,849,116,156,272,2.176470588235294,39.34942515859159
Task_5554,1068,764,73,86,159,1.396078431372549,25.912494131941884
Task_5555,1460,697,177,76,253,2.0916905444126073,32.32226384091255
Task_5556,1428,93,144,37,181,15.191489361702128,28.452195544607424
Task_5557,2999,727,119,70,189,4.1195054945054945,56.387091046135815
Task_5558,2507,847,78,122,200,2.956367924528302,49.44543047047969
Task_5559,972,927,137,131,268,1.0474137931034482,25.56490983327474
Task_5560,2757,558,33,138,171,4.932021466905188,52.268754271220125
Task_5561,871,248,34,117,151,3.497991967871486,21.15710594044197
Task_5562,2486,813,75,21,96,3.054054054054054,47.4059637728596
Task_5563,1216,405,45,31,76,2.9950738916256157,25.573122125996473
Task_5564,2077,563,81,31,112,3.6826241134751774,40.29623571345244
Task_5565,1038,123,85,17,102,8.370967741935484,21.91222340752016
Task_5566,586,417,163,146,309,1.4019138755980862,18.080715917438468
Task_5567,2034,513,157,113,270,3.9571984435797667,41.13474508624669
Task_5568,1897,254,120,106,226,7.43921568627451,37.9016129698227
Task_5569,543,1009,123,36,159,0.5376237623762377,18.13819959603236
Task_5570,2430,702,100,81,181,3.456614509246088,47.418060159106325
Task_5571,1287,748,45,13,58,1.7182910547396528,27.599728991636976
Task_5572,2236,991,128,54,182,2.254032258064516,45.03240993562414
Task_5573,2183,147,122,25,147,14.75,40.589879862588596
Task_5574,2189,318,147,145,292,6.862068965517241,43.094093585804785
Task_5575,2881,735,188,132,320,3.9144021739130435,55.507138661726664
Task_5576,1908,994,10,163,173,1.9175879396984925,40.215432508353715
Task_5577,1233,439,71,47,118,2.8022727272727272,26.625187984375035
Task_5578,2969,212,55,48,103,13.938967136150234,53.075696049448055
Task_5579,1653,375,121,100,221,4.3962765957446805,34.41980298566349
Task_5580,2902,461,119,156,275,6.2813852813852815,54.79268457747753
Task_5581,2525,832,97,81,178,3.0312124849939974,49.33979804583857
Task_5582,2071,319,78,113,191,6.471875,40.79632609868789
Task_5583,1161,140,195,193,388,8.23404255319149,26.497370092851828
Task_5584,2930,320,94,146,240,9.12772585669782,54.5962845857108
Task_5585,1998,352,65,135,200,5.660056657223796,39.82823742565062
Task_5586,1829,582,22,157,179,3.137221269296741,37.72189319014419
Task_5587,1646,905,107,105,212,1.8167770419426048,35.94612227221719
Task_5588,2557,694,102,92,194,3.679136690647482,49.56492274203532
Task_5589,708,432,47,196,243,1.6351039260969977,19.91485967240845
Task_5590,509,552,81,160,241,0.9204339963833634,17.01400544509827
Task_5591,1712,466,139,17,156,3.6659528907922914,34.537661217497366
Task_5592,1930,577,168,43,211,3.339100346020761,38.81138864738349
Task_5593,2884,373,65,158,223,7.711229946524064,54.052321166553476
Task_5594,1485,732,138,35,173,2.0259208731241474,32.051835967585035
Task_5595,1003,872,160,145,305,1.1489117983963344,26.064397809366312
Task_5596,1013,449,131,100,231,2.2511111111111113,24.574056138616356
Task_5597,982,613,34,80,114,1.5993485342019544,23.816328885757997
Task_5598,2672,94,60,13,73,28.126315789473683,46.67326411912736
Task_5599,2426,1020,97,134,231,2.376101860920666,48.79979221161452
Task_5600,894,843,35,101,136,1.0592417061611374,23.232014527978368
Task_5601,1883,440,102,195,297,4.26984126984127,38.7519318826484
Task_5602,1930,340,105,109,214,5.659824046920821,38.66790036475519
Task_5603,1169,406,69,80,149,2.8722358722358723,26.43814388669632
Task_5604,2542,941,57,51,108,2.6985138004246285,48.9567734171259
Task_5605,2146,756,173,159,332,2.8348745046235138,44.023245868481034
Task_5606,2918,677,16,52,68,4.303834808259587,53.62234736445271
Task_5607,1609,361,39,179,218,4.44475138121547,33.790183093369556
Task_5608,560,326,18,28,46,1.7125382262996942,14.800528642043018
Task_5609,1483,301,98,67,165,4.910596026490066,30.93781963380512
Task_5610,2126,809,69,195,264,2.6246913580246916,43.6910332459199
Task_5611,1837,131,45,59,104,13.916666666666666,34.696767291929454
Task_5612,853,708,89,113,202,1.2031029619181945,22.64207179633244
Task_5613,2363,244,128,154,282,9.644897959183673,45.55094189396217
Task_5614,1537,534,182,153,335,2.872897196261682,33.684198473952165
Task_5615,1858,414,95,166,261,4.47710843373494,38.077671714820006
Task_5616,2233,666,147,12,159,3.347826086956522,43.43750665577155
Task_5617,2382,145,90,96,186,16.315068493150687,44.68544564961942
Task_5618,2674,643,116,20,136,4.1521739130434785,50.23558125577468
Task_5619,2769,763,170,137,307,3.6243455497382198,53.76992473921623
Task_5620,868,467,122,179,301,1.8547008547008548,22.766853911078783
Task_5621,2364,635,190,192,382,3.7169811320754715,47.36904239040778
Task_5622,1458,1013,99,46,145,1.4378698224852071,32.31015993005037
Task_5623,2918,799,24,119,143,3.6475,55.27189392863105
Task_5624,2651,1009,198,65,263,2.624752475247525,52.104827373985394
Task_5625,1796,161,192,153,345,11.08641975308642,36.37553373570572
Task_5626,2157,201,173,181,354,10.678217821782178,42.49878605577066
Task_5627,850,926,28,182,210,0.9169363538295577,23.390629140664483
Task_5628,2318,1008,126,73,199,2.2973240832507433,46.57975310275473
Task_5629,2030,983,152,173,325,2.063008130081301,42.88241347709978
Task_5630,2353,554,150,69,219,4.239639639639639,45.73794183888349
Task_5631,1072,123,117,99,216,8.64516129032258,24.07029281773032
Task_5632,1944,843,128,44,172,2.3033175355450237,39.66744942167753
Task_5633,1431,464,115,53,168,3.07741935483871,30.602842567310166
Task_5634,2171,486,18,84,102,4.457905544147844,42.00435866133258
Task_5635,2409,629,145,65,210,3.823809523809524,46.839618615809975
Task_5636,2658,662,69,77,146,4.009049773755656,50.73244889644869
Task_5637,2841,842,55,65,120,3.3701067615658364,53.7797795279422
Task_5638,2228,85,52,166,218,25.906976744186046,42.05813005269239
Task_5639,2513,93,171,105,276,26.73404255319149,46.70338800048349
Task_5640,2136,425,54,98,152,5.014084507042254,41.77333020022162
Task_5641,2555,498,29,19,48,5.1202404809619235,46.813252316034756
Task_5642,1053,359,16,147,163,2.925,24.59767988958393
Task_5643,779,460,189,149,338,1.6898047722342733,21.445493666392434
Task_5644,1795,700,121,159,280,2.5606276747503567,38.05313894649024
Task_5645,1207,517,73,41,114,2.33011583011583,26.44572977347474
Task_5646,1418,657,66,148,214,2.155015197568389,31.71084190451216
Task_5647,730,795,91,55,146,0.9170854271356784,20.478166878717214
Task_5648,1211,681,126,112,238,1.7756598240469208,28.471585425212112
Task_5649,714,566,14,162,176,1.2592592592592593,19.94100575996814
Task_5650,1315,872,167,133,300,1.5063001145475372,30.99389007112087
Task_5651,1634,140,183,54,237,11.588652482269504,32.75487520085619
Task_5652,1143,436,101,85,186,2.6155606407322654,26.25138655437996
Task_5653,2705,202,15,193,208,13.32512315270936,50.49614787329151
Task_5654,1560,104,179,161,340,14.857142857142858,32.20903756755666
Task_5655,2899,167,194,137,331,17.25595238095238,53.694127968409695
Task_5656,2772,863,84,62,146,3.2083333333333335,52.96092925532923
Task_5657,2580,319,33,95,128,8.0625,48.506206058197485
Task_5658,737,135,194,63,257,5.419117647058823,18.65983741237315
Task_5659,1045,473,24,145,169,2.2046413502109705,24.885643302075625
Task_5660,1970,464,116,89,205,4.236559139784946,39.59372077828925
Task_5661,2144,313,13,27,40,6.828025477707007,39.73795588529948
Task_5662,1967,674,33,35,68,2.9140740740740743,38.290758787562304
Task_5663,2762,932,192,193,385,2.960342979635584,54.62272952748407
Task_5664,1231,598,148,109,257,2.055091819699499,28.62384313864204
Task_5665,2411,718,147,113,260,3.35326842837274,47.70991204227505
Task_5666,2188,88,121,153,274,24.584269662921347,41.63859016834778
Task_5667,1336,183,83,137,220,7.260869565217392,28.77650866703324
Task_5668,585,575,160,20,180,1.015625,17.27483963978595
Task_5669,2059,113,66,39,105,18.06140350877193,37.822917039516646
Task_5670,980,593,200,83,283,1.6498316498316499,24.631096049606544
Task_5671,2536,905,133,82,215,2.7991169977924946,49.957170424424135
Task_5672,2605,532,185,190,375,4.887429643527205,50.822291412156254
Task_5673,654,861,103,176,279,0.7587006960556845,20.50044443949581
Task_5674,2102,190,46,64,110,11.00523560209424,39.934435782262085
Task_5675,2149,677,159,172,331,3.169616519174041,43.83715419310579
Task_5676,2844,889,82,94,176,3.195505617977528,54.71478615750541
Task_5677,2053,581,151,33,184,3.527491408934708,40.619451684519596
Task_5678,2239,908,29,49,78,2.463146314631463,43.555686705174516
Task_5679,1303,90,159,10,169,14.31868131868132,26.281297716048005
Task_5680,834,279,156,183,339,2.9785714285714286,21.808775449098835
Task_5681,2178,968,193,156,349,2.2476780185758516,45.264314056263174
Task_5682,2681,877,40,97,137,3.0535307517084282,51.77308645477021
Task_5683,1788,948,132,129,261,1.8840885142255006,38.585847618533506
Task_5684,2938,498,172,165,337,5.887775551102204,55.7763638499703
Task_5685,1529,985,185,38,223,1.550709939148073,33.790627552971024
Task_5686,899,912,96,194,290,0.9846659364731654,24.581729967789983
Task_5687,2428,516,20,57,77,4.696324951644101,45.36825405986258
Task_5688,2205,622,173,54,227,3.539325842696629,43.61314243991402
Task_5689,1627,965,111,78,189,1.684265010351967,35.56171996266786
Task_5690,2758,68,50,32,82,39.971014492753625,47.96003908085797
Task_5691,1320,882,143,159,302,1.4949037372593432,31.151265192381913
Task_5692,1541,238,179,147,326,6.447698744769874,32.731678600018455
Task_5693,794,282,11,146,157,2.8056537102473498,20.08133913913346
Task_5694,2302,1014,168,121,289,2.2679802955665025,47.05071766038653
Task_5695,2440,896,188,177,365,2.720178372352285,49.294386818771706
Task_5696,2821,231,88,170,258,12.15948275862069,52.61059681153933
Task_5697,907,633,15,57,72,1.4305993690851735,21.61820382535902
Task_5698,2380,676,80,179,259,3.5155096011816838,47.23198811498667
Task_5699,1408,257,33,200,233,5.457364341085271,30.360811733330593
Task_5700,750,345,39,193,232,2.167630057803468,20.23432853623491
Task_5701,560,440,76,181,257,1.2698412698412698,17.609942250626172
Task_5702,559,255,187,77,264,2.18359375,16.72561836601236
Task_5703,1466,377,93,167,260,3.878306878306878,31.78022805004204
Task_5704,1637,496,18,166,184,3.2937625754527162,34.43565509084546
Task_5705,1298,819,50,116,166,1.5829268292682928,29.99840482251204
Task_5706,1052,861,180,40,220,1.2204176334106729,25.839727579928162
Task_5707,1926,546,93,10,103,3.5210237659963437,37.78416411531177
Task_5708,842,322,125,11,136,2.606811145510836,20.186685391066646
Task_5709,2298,980,92,77,169,2.3425076452599387,46.07713809942734
Task_5710,2119,162,30,21,51,13.0,38.86406218662007
Task_5711,2642,905,75,105,180,2.9161147902869757,51.622919924433425
Task_5712,1579,113,21,21,42,13.850877192982455,29.82831796152532
Task_5713,2705,479,124,179,303,5.635416666666667,51.89316025976539
Task_5714,2202,359,80,55,135,6.116666666666666,42.20236210187385
Task_5715,1795,371,61,165,226,4.825268817204301,36.838202729544996
Task_5716,1354,587,180,142,322,2.302721088435374,30.87856953540194
Task_5717,1989,671,40,41,81,2.9598214285714284,39.01790300631689
Task_5718,1729,790,184,127,311,2.185840707964602,37.38169615325567
Task_5719,515,833,65,198,263,0.617505995203837,18.361390141912462
Task_5720,1198,830,185,160,345,1.4416365824308062,29.241076165683896
Task_5721,2524,829,92,124,216,3.040963855421687,49.67416931403529
Task_5722,1319,336,24,137,161,3.913946587537092,28.61838645579031
Task_5723,1610,928,81,44,125,1.7330462863293865,34.165178759438845
Task_5724,1476,179,24,138,162,8.2,30.18326722197676
Task_5725,2251,903,114,198,312,2.4900442477876106,46.113383582483436
Task_5726,878,162,161,177,338,5.386503067484663,21.911028360914013
Task_5727,988,836,176,50,226,1.1804062126642771,24.86769540661943
Task_5728,1928,276,31,140,171,6.96028880866426,38.213389102343704
Task_5729,1645,414,29,134,163,3.963855421686747,34.152033419739944
Task_5730,2783,799,117,177,294,3.47875,54.10505556608084
Task_5731,1493,201,140,157,297,7.391089108910891,31.725575277538937
Task_5732,2259,463,128,199,327,4.868534482758621,44.91871867070265
Task_5733,2837,151,171,38,209,18.664473684210527,51.44615941700601
Task_5734,1152,852,147,85,232,1.35052754982415,27.895264942028522
Task_5735,2736,831,159,70,229,3.2884615384615383,52.733377035013554
Task_5736,879,329,25,72,97,2.6636363636363636,20.828138123715743
Task_5737,2589,372,87,146,233,6.941018766756033,49.29985118158069
Task_5738,2898,810,16,143,159,3.5733662145499383,55.08587277939146
Task_5739,1703,182,121,93,214,9.306010928961749,34.42381558845195
Task_5740,651,688,37,50,87,0.9448476052249637,18.083425522971407
Task_5741,2024,470,166,149,315,4.29723991507431,41.09411026944915
Task_5742,2553,684,166,178,344,3.727007299270073,50.32585362303647
Task_5743,2634,570,117,94,211,4.612959719789842,50.51697794404854
Task_5744,1723,863,79,71,150,1.994212962962963,36.392031329093605
Task_5745,2260,365,64,165,229,6.174863387978142,44.19135530566266
Task_5746,1600,859,183,130,313,1.8604651162790697,35.56613815667211
Task_5747,1018,916,182,71,253,1.1101417666303162,25.889054990136895
Task_5748,2830,709,34,76,110,3.9859154929577465,53.26819493634065
Task_5749,1370,541,24,79,103,2.5276752767527677,29.503029238747278
Task_5750,1741,833,95,171,266,2.0875299760191846,37.577821647418524
Task_5751,2696,635,149,88,237,4.238993710691824,51.762159646397045
Task_5752,1116,1019,109,161,270,1.0941176470588236,28.180538886649234
Task_5753,1831,638,108,152,260,2.865414710485133,38.3283205162206
Task_5754,2878,295,55,36,91,9.722972972972974,51.83022320292883
Task_5755,2856,124,137,130,267,22.848,52.41388569512486
Task_5756,1863,685,79,178,257,2.7157434402332363,39.067438728017
Task_5757,1355,810,148,183,331,1.6707768187422936,31.677442880580042
Task_5758,2732,545,172,85,257,5.003663003663004,52.11223843436173
Task_5759,1008,952,43,199,242,1.0577124868835257,26.15651615455737
Task_5760,711,702,106,44,150,1.0113798008534851,19.464493614304434
Task_5761,1274,81,95,138,233,15.536585365853659,27.056015800873013
Task_5762,1362,864,25,140,165,1.5745664739884393,31.078744262578578
Task_5763,1643,690,28,122,150,2.377713458755427,34.75840296930211
Task_5764,2195,365,170,94,264,5.997267759562842,43.13983626340672
Task_5765,2904,187,102,89,191,15.446808510638299,53.39008328157766
Task_5766,2527,190,92,71,163,13.230366492146597,47.09508284318292
Task_5767,1681,526,52,115,167,3.189753320683112,35.14768702686458
Task_5768,2237,516,98,96,194,4.326885880077369,44.02141855527085
Task_5769,997,531,166,119,285,1.8740601503759398,24.849607496362506
Task_5770,2624,79,96,190,286,32.8,48.50992796017025
Task_5771,1956,605,149,197,346,3.227722772277228,40.65754653749493
Task_5772,920,1012,29,30,59,0.9081934846989141,22.870834504183847
Task_5773,2278,619,123,187,310,3.674193548387097,45.6244724156868
Task_5774,1688,695,40,114,154,2.425287356321839,35.49767384448002
Task_5775,1285,825,121,65,186,1.555690072639225,29.493458093836836
Task_5776,625,178,20,56,76,3.4916201117318435,15.707836606064811
Task_5777,618,194,83,13,96,3.169230769230769,15.929193850348959
Task_5778,2149,406,63,138,201,5.28009828009828,42.40184727832611
Task_5779,2904,867,138,135,273,3.345622119815668,56.0794603899227
Task_5780,914,767,23,43,66,1.1901041666666667,22.011568060935332
Task_5781,1859,463,62,84,146,4.006465517241379,37.53813173626468
Task_5782,2352,479,159,12,171,4.9,44.846683295614326
Task_5783,1806,184,66,168,234,9.762162162162163,36.33784840172784
Task_5784,2721,1023,19,130,149,2.6572265625,52.91049794625739
Task_5785,2373,716,85,124,209,3.309623430962343,46.893949619408176
Task_5786,523,921,106,154,260,0.5672451193058569,18.565512657582122
Task_5787,2766,1022,45,198,243,2.7038123167155423,54.36242514616949
Task_5788,738,822,95,94,189,0.8967193195625759,21.159364569820927
Task_5789,1804,842,116,79,195,2.139976275207592,38.03469337319914
Task_5790,1194,726,28,71,99,1.642365887207703,27.088006221712558
Task_5791,2596,463,104,67,171,5.594827586206897,49.01859461319476
Task_5792,1547,948,158,97,255,1.63013698630137,34.70792850602662
Task_5793,1647,501,50,164,214,3.2808764940239046,34.89013551470479
Task_5794,2286,669,79,200,279,3.4119402985074627,45.84862839858554
Task_5795,1389,475,49,148,197,2.918067226890756,30.62110182224426
Task_5796,1393,927,102,60,162,1.5010775862068966,31.28674351234848
Task_5797,2573,318,129,139,268,8.065830721003135,49.04948045953743
Task_5798,2319,415,29,150,179,5.574519230769231,44.953172348576125
Task_5799,1332,559,146,159,305,2.3785714285714286,30.390582319706677
Task_5800,1152,770,110,130,240,1.4941634241245136,27.81993336702593
Task_5801,2143,821,37,50,87,2.6070559610705595,42.060181689596696
Task_5802,996,670,40,22,62,1.4843517138599105,22.84307129249922
Task_5803,2830,324,46,77,123,8.707692307692307,52.14914859824473
Task_5804,2377,689,191,82,273,3.444927536231884,47.021937873297965
Task_5805,854,431,200,97,297,1.9768518518518519,22.322292351378263
Task_5806,2606,977,165,20,185,2.6646216768916156,50.55339468733333
Task_5807,1484,880,161,27,188,1.6844494892167992,32.534574713744604
Task_5808,2002,566,100,20,120,3.5308641975308643,39.099059955843494
Task_5809,655,200,84,35,119,3.2587064676616917,16.675872658843318
Task_5810,2981,282,142,184,326,10.53356890459364,55.69929780376706
Task_5811,756,170,127,79,206,4.421052631578948,19.149063332396533
Task_5812,2052,975,191,79,270,2.1024590163934427,42.71828069059023
Task_5813,1346,450,61,174,235,2.984478935698448,30.041516319529766
Task_5814,1986,642,138,100,238,3.088646967340591,40.62045507392521
Task_5815,1270,880,150,117,267,1.441543700340522,30.12238406818268
Task_5816,1959,695,189,49,238,2.814655172413793,39.86366597092728
Task_5817,1512,364,25,51,76,4.142465753424657,30.31233014405763
Task_5818,2261,955,187,59,246,2.3650627615062763,45.60954586008774
Task_5819,1613,416,71,119,190,3.86810551558753,33.86469185716263
Task_5820,2339,815,197,173,370,2.866421568627451,47.45750591339236
Task_5821,1936,903,19,121,140,2.1415929203539825,40.019691114607426
Task_5822,1171,84,13,105,118,13.776470588235295,24.314354837840202
Task_5823,1631,502,169,110,279,3.242544731610338,34.7556358931567
Task_5824,2812,765,71,122,193,3.671018276762402,53.981589070510644
Task_5825,603,464,100,196,296,1.2967741935483872,18.504013322508555
Task_5826,1707,185,198,133,331,9.17741935483871,35.093004784681796
Task_5827,511,191,155,189,344,2.6614583333333335,16.450044664368143
Task_5828,2728,70,66,121,187,38.42253521126761,49.58243841559848
Task_5829,2250,655,122,147,269,3.4298780487804876,45.05145136030482
Task_5830,1813,150,134,138,272,12.006622516556291,36.25254777458159
Task_5831,702,714,142,128,270,0.9818181818181818,20.66585176511903
Task_5832,2387,763,183,103,286,3.1243455497382198,47.573729049659185
Task_5833,1575,252,196,101,297,6.225296442687747,33.11943428766922
Task_5834,2836,447,45,168,213,6.330357142857143,53.46815767998381
Task_5835,2413,748,148,131,279,3.2216288384512684,47.947993637087414
Task_5836,1099,693,11,193,204,1.5835734870317002,26.635533671891793
Task_5837,578,463,124,161,285,1.2456896551724137,18.000995348514135
Task_5838,1609,369,105,96,201,4.348648648648648,33.63644166015682
Task_5839,2298,909,200,160,360,2.525274725274725,47.03746685026703
Task_5840,2205,992,171,49,220,2.2205438066465257,44.607538506146305
Task_5841,1621,652,178,155,333,2.482388973966309,35.37963853526182
Task_5842,1843,414,96,74,170,4.440963855421686,37.07259605014914
Task_5843,1031,762,159,100,259,1.3512450851900393,25.915698166638638
Task_5844,1361,935,194,50,244,1.454059829059829,31.158012146649572
Task_5845,1687,350,104,168,272,4.806267806267806,35.20533777629041
Task_5846,1854,651,23,175,198,2.8435582822085887,38.47522073107519
Task_5847,879,680,21,191,212,1.2907488986784141,23.12911946237615
Task_5848,729,431,135,151,286,1.6875,20.33176809922568
Task_5849,1931,266,179,18,197,7.2322097378277155,37.64282246515012
Task_5850,1800,568,109,160,269,3.1634446397188047,37.668892673203544
Task_5851,504,89,102,154,256,5.6,15.151411577274436
Task_5852,2906,967,54,62,116,3.0020661157024793,55.062176350468924
Task_5853,505,673,175,15,190,0.7492581602373887,16.395357368647165
Task_5854,2425,348,176,125,301,6.948424068767908,46.93985685908333
Task_5855,553,708,122,35,157,0.7799717912552891,17.104153111488376
Task_5856,2162,146,92,188,280,14.70748299319728,41.836769082706596
Task_5857,2747,1014,140,186,326,2.7064039408866996,54.36479341838257
Task_5858,1048,933,162,71,233,1.1220556745182013,26.326891614592977
Task_5859,2329,708,100,122,222,3.2849083215796897,46.221411231672306
Task_5860,1888,112,197,51,248,16.707964601769913,36.36587328558284
Task_5861,1694,162,28,170,198,10.392638036809815,34.071592116782504
Task_5862,1714,297,117,93,210,5.751677852348993,35.049945952025666
Task_5863,554,218,151,82,233,2.529680365296804,16.489702318134512
Task_5864,804,968,43,105,148,0.8297213622291022,22.29932956189613
Task_5865,557,853,161,29,190,0.6522248243559718,18.089374144256197
Task_5866,2799,272,33,85,118,10.252747252747254,51.46499377716841
Task_5867,2530,431,130,156,286,5.856481481481482,48.8557379346802
Task_5868,1807,357,162,158,320,5.0474860335195535,37.328280827353545
Task_5869,2581,706,170,122,292,3.6506364922206505,50.52241542381247
Task_5870,1492,885,11,68,79,1.6839729119638827,31.907990219149767
Task_5871,2235,767,153,167,320,2.91015625,45.42531948111431
Task_5872,1015,124,199,53,252,8.12,22.953379888707797
Task_5873,2423,1013,47,184,231,2.3895463510848125,48.83621324961276
Task_5874,901,160,133,53,186,5.596273291925466,21.08653877229499
Task_5875,1599,555,171,88,259,2.8758992805755397,34.235280544490344
Task_5876,918,581,88,48,136,1.577319587628866,22.315495820645285
Task_5877,1997,182,13,121,134,10.912568306010929,38.4591296670967
Task_5878,1735,962,72,196,268,1.8016614745586708,37.9791823747071
Task_5879,2568,460,194,43,237,5.570498915401301,48.65406301114691
Task_5880,2682,882,98,52,150,3.0373725934314835,51.564563127372644
Task_5881,2419,477,41,16,57,5.060669456066946,44.68321001410718
Task_5882,1816,441,85,61,146,4.108597285067873,36.471026008437086
Task_5883,2168,359,34,109,143,6.022222222222222,41.99866651533419
Task_5884,1455,471,187,112,299,3.082627118644068,31.96404049466997
Task_5885,2471,1003,41,196,237,2.4611553784860556,49.582978614382455
Task_5886,2861,832,63,136,199,3.434573829531813,55.02338683759378
Task_5887,1648,947,53,37,90,1.738396624472574,34.451085609777145
Task_5888,2313,220,96,100,196,10.46606334841629,44.21199143291371
Task_5889,2731,769,67,198,265,3.5467532467532465,53.16142576349596
Task_5890,2782,413,84,159,243,6.719806763285024,52.60467774754287
Task_5891,1968,851,185,180,365,2.3098591549295775,41.67962177842259
Task_5892,655,282,124,133,257,2.314487632508834,18.546146821211646
Task_5893,814,728,52,129,181,1.1165980795610426,22.056221587222947
Task_5894,2944,979,22,116,138,3.0040816326530613,56.2035620554492
Task_5895,1690,265,70,111,181,6.353383458646617,34.50811053898776
Task_5896,2157,933,162,120,282,2.309421841541756,44.46783772490256
Task_5897,1847,907,22,192,214,2.0341409691629955,39.25552397241487
Task_5898,1164,573,195,115,310,2.0278745644599305,27.73225000751997
Task_5899,2013,100,17,130,147,19.93069306930693,37.92229618415128
Task_5900,1134,410,111,164,275,2.759124087591241,26.657639681396102
Task_5901,2087,594,175,86,261,3.507563025210084,42.08519278552698
Task_5902,2338,218,48,84,132,10.67579908675799,44.23468774439902
Task_5903,2543,923,133,119,252,2.752164502164502,50.41646481263596
Task_5904,2412,267,97,158,255,9.0,46.30097283248122
Task_5905,2401,857,84,104,188,2.7983682983682985,47.64615615013673
Task_5906,2504,858,24,15,39,2.9150174621653084,47.05822115454243
Task_5907,2542,597,200,158,358,4.250836120401337,49.90933392880218
Task_5908,544,647,61,146,207,0.8395061728395061,17.713732231825833
Task_5909,1925,413,116,155,271,4.64975845410628,39.15333031395674
Task_5910,757,683,189,35,224,1.1067251461988303,20.629369973991576
Task_5911,1203,987,181,163,344,1.2176113360323886,29.796045963665822
Task_5912,1485,970,189,79,268,1.529351184346035,33.67069559852711
Task_5913,1145,434,61,92,153,2.632183908045977,26.08884506570575
Task_5914,2255,842,14,167,181,2.67497034400949,45.29989519281602
Task_5915,1736,630,95,83,178,2.751188589540412,36.2359171352521
Task_5916,562,968,103,12,115,0.5799793601651186,17.780497703962997
Task_5917,2267,512,126,53,179,4.419103313840156,44.05744509696828
Task_5918,1801,556,34,32,66,3.2333931777378817,35.269273507022675
Task_5919,2820,952,100,121,221,2.9590766002098636,54.7595953000509
Task_5920,1833,299,57,22,79,6.11,34.96959186587998
Task_5921,1037,465,26,198,224,2.225321888412017,25.102133456953624
Task_5922,1206,1008,76,161,237,1.195242814667988,29.48705665749795
Task_5923,2162,79,128,139,267,27.025,41.11235273111573
Task_5924,2701,759,13,24,37,3.5539473684210527,49.940230461027454
Task_5925,2951,240,39,25,64,12.244813278008298,52.37288808257795
Task_5926,2412,194,55,198,253,12.36923076923077,46.107752988347464
Task_5927,735,611,131,155,286,1.2009803921568627,20.94779395325571
Task_5928,1354,67,64,128,192,19.91176470588235,28.088275588938686
Task_5929,2970,194,109,145,254,15.23076923076923,54.78804056906187
Task_5930,2107,958,80,151,231,2.197080291970803,43.622238565587104
Task_5931,2485,745,55,175,230,3.331099195710456,48.992411784487906
Task_5932,918,386,138,66,204,2.372093023255814,22.42222376865526
Task_5933,1694,777,192,11,203,2.177377892030848,35.55790752766019
Task_5934,2280,376,109,156,265,6.047745358090186,44.62323625446049
Task_5935,2990,964,154,130,284,3.098445595854922,57.788115776675546
Task_5936,2863,781,177,129,306,3.661125319693095,55.299569801354814
Task_5937,2122,684,108,27,135,3.0978102189781023,41.657357451850736
Task_5938,2475,633,124,20,144,3.9037854889589907,47.12522103780131
Task_5939,1934,869,181,127,308,2.2229885057471264,40.862417640169625
Task_5940,1069,302,58,118,176,3.5280528052805282,24.812698684373768
Task_5941,2439,1007,29,83,112,2.419642857142857,48.07312318712849
Task_5942,679,873,96,193,289,0.7768878718535469,20.993530954947598
Task_5943,2858,419,148,81,229,6.804761904761905,53.535915738045055
Task_5944,1614,109,85,69,154,14.672727272727272,31.441880215564865
Task_5945,1443,87,54,38,92,16.397727272727273,27.764545732214703
Task_5946,1099,649,122,126,248,1.6907692307692308,26.66347086862595
Task_5947,2523,626,91,86,177,4.023923444976076,48.6771638957008
Task_5948,2144,715,22,143,165,2.994413407821229,43.04241640672075
Task_5949,2094,352,130,67,197,5.932011331444759,40.889136665106435
Task_5950,767,416,40,190,230,1.839328537170264,20.714108572615554
Task_5951,886,761,63,90,153,1.162729658792651,22.97147711214163
Task_5952,909,107,56,13,69,8.416666666666666,19.251672918010907
Task_5953,2259,194,10,67,77,11.584615384615384,41.82531173702338
Task_5954,735,943,109,139,248,0.7786016949152542,21.840845503758647
Task_5955,1511,631,49,121,170,2.3908227848101267,32.83498517514851
Task_5956,1844,1005,171,65,236,1.8330019880715707,39.18204335380399
Task_5957,644,328,69,135,204,1.9574468085106382,18.355248775942815
Task_5958,1298,1002,104,21,125,1.2941176470588236,29.44285916196016
Task_5959,912,327,196,15,211,2.7804878048780486,21.787769542265732
Task_5960,753,563,90,34,124,1.3351063829787233,19.51503138991252
Task_5961,2016,427,124,50,174,4.710280373831775,39.60767054382533
Task_5962,1987,840,109,44,153,2.3626634958382877,40.10664470500404
Task_5963,1641,963,68,160,228,1.7022821576763485,36.259462907926256
Task_5964,1472,492,54,11,65,2.9858012170385395,29.636293091259063
Task_5965,2150,252,66,71,137,8.49802371541502,41.18735248441619
Task_5966,798,622,116,29,145,1.2808988764044944,20.650339973651317
Task_5967,2630,419,142,27,169,6.261904761904762,49.11233191992951
Task_5968,2099,254,32,166,198,8.231372549019607,41.05264534939863
Task_5969,1655,811,50,26,76,2.0381773399014778,33.77572514528163
Task_5970,884,412,131,18,149,2.1404358353510897,21.26878551511814
Task_5971,1609,723,157,193,350,2.222375690607735,35.54405911228951
Task_5972,2631,548,60,175,235,4.7923497267759565,50.70182618791349
Task_5973,1604,637,133,26,159,2.5141065830721003,33.44704432043493
Task_5974,1676,893,164,113,277,1.8747203579418346,36.68887447050739
Task_5975,603,295,119,176,295,2.0371621621621623,17.999931833196673
Task_5976,1628,491,50,48,98,3.3089430894308944,32.83383715503012
Task_5977,2596,767,144,180,324,3.3802083333333335,51.18146446683628
Task_5978,2655,484,77,57,134,5.474226804123711,49.792048495586904
Task_5979,1802,729,45,23,68,2.4684931506849317,35.79268288086957
Task_5980,733,656,32,148,180,1.1156773211567732,20.509270603505378
Task_5981,2695,265,56,124,180,10.131578947368421,50.41440825407344
Task_5982,1768,291,33,115,148,6.054794520547945,35.47499381324456
Task_5983,2340,140,17,134,151,16.595744680851062,43.403109503439936
Task_5984,2135,672,196,156,352,3.1723625557206536,43.67084900274967
Task_5985,878,270,165,82,247,3.2398523985239853,21.841080669661167
Task_5986,1676,841,79,96,175,1.990498812351544,36.11881861001705
Task_5987,2782,283,113,94,207,9.795774647887324,51.88238944329942
Task_5988,2856,547,99,21,120,5.211678832116788,52.5622075906785
Task_5989,1429,409,102,16,118,3.4853658536585366,29.498881554138507
Task_5990,834,143,47,137,184,5.791666666666667,20.281634243945252
Task_5991,2828,330,113,49,162,8.54380664652568,52.00963803945711
Task_5992,939,283,65,38,103,3.306338028169014,21.292433747246783
Task_5993,908,994,155,80,235,0.9125628140703518,24.49021614383685
Task_5994,2629,220,76,91,167,11.895927601809955,49.048990467473
Task_5995,1535,653,10,39,49,2.3470948012232418,31.31260502421937
Task_5996,2377,938,92,94,186,2.531416400425985,47.47480336940802
Task_5997,638,645,147,177,324,0.9876160990712074,19.753548773496018
Task_5998,2000,604,175,128,303,3.3057851239669422,41.05625316374714
Task_5999,597,842,42,113,155,0.708185053380783,18.827561691444085
Task_6000,1396,974,200,180,380,1.4317948717948719,33.01198775204701
Task_6001,1343,951,27,186,213,1.4107142857142858,31.34884826058106
Task_6002,2844,66,64,176,240,42.44776119402985,51.676709908764224
Task_6003,2955,762,84,153,237,3.872870249017038,56.43124959335521
Task_6004,2946,104,135,193,328,28.057142857142857,53.9798357353007
Task_6005,2868,808,49,162,211,3.5451174289245984,55.18001027255605
Task_6006,609,957,25,108,133,0.6356993736951984,19.327579639963346
Task_6007,2777,749,122,82,204,3.7026666666666666,53.23652721007426
Task_6008,2457,393,134,50,184,6.2360406091370555,46.51151013665304
Task_6009,614,337,129,145,274,1.816568047337278,18.166972435608706
Task_6010,832,406,163,116,279,2.0442260442260443,21.81370160561768
Task_6011,1596,704,100,186,286,2.2638297872340427,34.980043603709966
Task_6012,1772,938,185,155,340,1.8871139510117145,38.69541292220615
Task_6013,1641,465,83,193,276,3.5214592274678114,34.939887399518604
Task_6014,572,413,58,180,238,1.3816425120772946,17.650627929204497
Task_6015,1654,730,114,54,168,2.26265389876881,34.9252295837436
Task_6016,1292,410,69,73,142,3.1435523114355233,28.188482079474767
Task_6017,2055,67,177,31,208,30.220588235294116,38.190609137167435
Task_6018,1003,126,93,169,262,7.897637795275591,23.331133623512528
Task_6019,1183,572,185,122,307,2.0645724258289704,28.02672954569864
Task_6020,2225,301,104,200,304,7.367549668874172,43.7396216671959
Task_6021,1109,783,110,18,128,1.4145408163265305,25.93065560200593
Task_6022,590,620,68,54,122,0.9500805152979066,17.332344192056024
Task_6023,2751,183,197,44,241,14.951086956521738,50.56226474417275
Task_6024,1501,908,97,20,117,1.6512651265126512,32.23797924554376
Task_6025,1184,360,93,110,203,3.2797783933518008,26.923608444262644
Task_6026,2097,103,147,134,281,20.16346153846154,40.340250953977154
Task_6027,1856,812,54,111,165,2.2829028290282904,38.82123385238675
Task_6028,748,548,44,34,78,1.3624772313296905,18.736718488076296
Task_6029,1560,615,54,35,89,2.5324675324675323,31.988114738242245
Task_6030,2888,880,157,189,346,3.2780930760499434,56.27487426972859
Task_6031,1889,122,42,46,88,15.357723577235772,35.24189219791826
Task_6032,1864,423,43,141,184,4.39622641509434,37.78667846733822
Task_6033,2601,126,101,31,132,20.480314960629922,46.96799646954895
Task_6034,1772,959,163,25,188,1.8458333333333334,37.3234885243564
Task_6035,2692,608,166,172,338,4.420361247947455,52.25029168897574
Task_6036,595,291,149,129,278,2.037671232876712,17.715202542540613
Task_6037,836,638,137,94,231,1.3082942097026604,22.300150256591014
Task_6038,1824,992,182,78,260,1.836858006042296,39.09075460054312
Task_6039,1268,725,189,76,265,1.7465564738292012,29.413511663094614
Task_6040,674,146,34,25,59,4.585034013605442,16.03421810180267
Task_6041,1515,361,21,120,141,4.185082872928176,31.645937620320154
Task_6042,2422,158,79,126,205,15.232704402515724,45.64149224829799
Task_6043,1956,676,158,173,331,2.8892171344165436,40.77844436853372
Task_6044,2380,521,49,89,138,4.559386973180077,45.932654155611125
Task_6045,1609,957,69,120,189,1.6795407098121085,35.49554149076361
Task_6046,2495,70,64,67,131,35.140845070422536,44.94584039191481
Task_6047,2040,882,155,90,245,2.3103057757644394,42.21255803105232
Task_6048,635,832,167,138,305,0.7623049219687875,20.168013075973843
Task_6049,2399,911,48,27,75,2.630482456140351,45.87774073373965
Task_6050,655,483,47,195,242,1.353305785123967,19.185238612651407
Task_6051,2639,945,30,144,174,2.7896405919661733,51.672498713254775
Task_6052,1443,580,105,105,210,2.4836488812392425,31.70694989499493
Task_6053,2038,200,47,138,185,10.139303482587065,39.79859710590204
Task_6054,1750,738,77,179,256,2.3680649526387008,37.44730411391485
Task_6055,891,352,191,65,256,2.5240793201133145,22.135823948126426
Task_6056,1823,771,45,164,209,2.36139896373057,38.434207405698686
Task_6057,2289,132,183,54,237,17.210526315789473,42.997452609988386
Task_6058,2984,984,152,41,193,3.0294416243654823,56.70326850198912
Task_6059,708,294,52,70,122,2.4,18.336680557573114
Task_6060,2034,308,119,118,237,6.58252427184466,40.32154292563551
Task_6061,2311,888,49,48,97,2.5995500562429696,44.91320531811302
Task_6062,1655,708,66,103,169,2.3342736248236955,35.30738629469453
Task_6063,639,919,107,185,292,0.6945652173913044,20.586969247911103
Task_6064,2718,606,87,96,183,4.477759472817134,51.80843870916342
Task_6065,1183,90,68,180,248,13.0,25.8738124044191
Task_6066,2686,968,180,41,221,2.7719298245614037,52.0572076977082
Task_6067,1149,838,191,88,279,1.369487485101311,28.038448134031402
Task_6068,806,272,145,13,158,2.9523809523809526,19.592794751022904
Task_6069,2060,603,65,39,104,3.410596026490066,40.04260284138683
Task_6070,2909,841,198,137,335,3.454869358669834,56.35946286389642
Task_6071,2313,344,89,167,256,6.7043478260869565,44.99249112516984
Task_6072,1787,460,49,128,177,3.876355748373102,36.72801361338921
Task_6073,2104,933,28,94,122,2.252676659528908,42.63890019951539
Task_6074,2887,118,20,186,206,24.26050420168067,52.61451831225406
Task_6075,1740,177,152,18,170,9.775280898876405,33.92886716813748
Task_6076,2147,951,60,137,197,2.255252100840336,44.07661687146915
Task_6077,1161,532,85,54,139,2.178236397748593,26.273756652074642
Task_6078,677,903,62,34,96,0.7488938053097345,19.05558158641251
Task_6079,1248,100,200,79,279,12.356435643564357,26.61016407126976
Task_6080,2161,271,186,44,230,7.944852941176471,41.54177507516712
Task_6081,757,382,176,81,257,1.9765013054830287,20.296656798123653
Task_6082,800,500,186,39,225,1.596806387225549,20.751984091523628
Task_6083,2082,630,168,50,218,3.299524564183835,41.51030585485307
Task_6084,2793,808,141,45,186,3.452410383189122,53.07145917702271
Task_6085,1408,613,184,174,358,2.2931596091205213,32.02443420282921
Task_6086,2887,69,48,91,139,41.24285714285714,51.33521849321221
Task_6087,2193,777,188,64,252,2.8187660668380463,44.05689861427775
Task_6088,1855,928,122,147,269,1.9967707212055974,39.647813269247656
Task_6089,2340,430,46,19,65,5.4292343387471,43.24843242367351
Task_6090,686,168,89,120,209,4.059171597633136,18.22051465299762
Task_6091,2894,889,89,154,243,3.251685393258427,55.861585153838824
Task_6092,783,642,161,51,212,1.2177293934681181,21.065858248320346
Task_6093,1567,99,18,129,147,15.67,30.9253284502919
Task_6094,965,545,149,58,207,1.7673992673992673,23.62304646827238
Task_6095,901,543,115,77,192,1.65625,22.719789240195364
Task_6096,2061,723,104,10,114,2.846685082872928,40.50753985652234
Task_6097,2974,376,46,148,194,7.888594164456234,55.30503632276981
Task_6098,2982,285,180,50,230,10.426573426573427,54.66764894660265
Task_6099,553,700,163,89,252,0.7888730385164051,18.110685492302665
Task_6100,1232,455,63,30,93,2.7017543859649122,26.33659631052279
Task_6101,811,149,127,49,176,5.406666666666666,19.344508040105016
Task_6102,502,297,76,62,138,1.6845637583892616,15.17251684934836
Task_6103,2250,863,114,55,169,2.6041666666666665,44.77978156978261
Task_6104,1012,118,96,186,282,8.504201680672269,23.521790976586882
Task_6105,766,906,139,151,290,0.844542447629548,22.39411746470906
Task_6106,2134,959,97,114,211,2.222916666666667,43.863213789824535
Task_6107,1887,723,58,195,253,2.606353591160221,39.58342691765586
Task_6108,1404,317,97,14,111,4.415094339622642,28.808110175837374
Task_6109,529,891,36,174,210,0.5930493273542601,18.391909583134062
Task_6110,1868,913,43,59,102,2.0437636761487963,38.19445090857604
Task_6111,2334,225,181,198,379,10.327433628318584,45.52342704033175
Task_6112,904,815,121,130,251,1.107843137254902,24.04443609743713
Task_6113,1493,759,84,153,237,1.9644736842105264,33.26069704933971
Task_6114,629,515,153,78,231,1.2189922480620154,18.51053197503434
Task_6115,1724,416,78,65,143,4.134292565947242,34.99450688063125
Task_6116,2613,581,81,125,206,4.489690721649485,50.302476779778566
Task_6117,2021,953,151,44,195,2.1184486373165616,41.352419387299086
Task_6118,762,79,158,41,199,9.525,18.036259720792334
Task_6119,2097,615,62,151,213,3.404220779220779,42.322425051164835
Task_6120,2900,874,117,167,284,3.3142857142857145,56.13451719832864
Task_6121,1422,164,132,99,231,8.618181818181819,29.8913127504359
Task_6122,1694,828,58,79,137,2.0434258142340167,35.95999824409882
Task_6123,696,130,150,169,319,5.312977099236641,18.761919733032
Task_6124,1432,316,187,91,278,4.517350157728707,30.919543903896535
Task_6125,2565,309,37,84,121,8.274193548387096,47.94783457664218
Task_6126,1225,694,140,64,204,1.7625899280575539,28.23803306254962
Task_6127,2432,938,52,146,198,2.589989350372737,48.57262534800022
Task_6128,2676,462,170,166,336,5.779697624190065,51.50826237434692
Task_6129,2263,72,194,112,306,31.0,42.807277257251776
Task_6130,708,815,28,47,75,0.8676470588235294,18.940891848702893
Task_6131,803,632,150,18,168,1.268562401263823,20.78568745746965
Task_6132,2729,123,185,42,227,22.008064516129032,49.542389379966544
Task_6133,2369,906,174,98,272,2.6119073869900773,47.67314776594657
Task_6134,1055,106,35,101,136,9.85981308411215,22.81121974403582
Task_6135,821,144,138,113,251,5.662068965517242,20.450375444328284
Task_6136,1559,228,48,150,198,6.807860262008734,32.46812523989789
Task_6137,730,944,40,35,75,0.7724867724867724,19.69011298356464
Task_6138,2799,220,147,34,181,12.665158371040723,51.18692450673566
Task_6139,1217,165,64,108,172,7.331325301204819,26.378035534318144
Task_6140,2014,68,92,79,171,29.18840579710145,37.8799241953341
Task_6141,2397,91,11,79,90,26.054347826086957,43.20107731096848
Task_6142,2205,527,11,107,118,4.176136363636363,42.88558213974517
Task_6143,1950,429,49,12,61,4.534883720930233,37.06007321384187
Task_6144,709,69,174,124,298,10.128571428571428,18.470708541515183
Task_6145,2767,596,165,85,250,4.634840871021775,52.79854004513198
Task_6146,1626,889,164,197,361,1.8269662921348315,36.3859150641829
Task_6147,1846,581,192,88,280,3.1718213058419242,38.32333581067605
Task_6148,2103,659,16,72,88,3.1863636363636365,41.16633490598094
Task_6149,574,708,14,26,40,0.8095909732016925,16.33185154661852
Task_6150,1093,483,50,143,193,2.2582644628099175,25.937470164547168
Task_6151,2338,442,155,50,205,5.27765237020316,44.903257461758386
Task_6152,893,927,35,115,150,0.9622844827586207,23.58666952820992
Task_6153,2364,88,170,10,180,26.56179775280899,42.95583795749894
Task_6154,1860,724,128,72,200,2.56551724137931,38.44928386529201
Task_6155,2158,860,64,131,195,2.506387921022067,43.95036979183467
Task_6156,1587,493,156,49,205,3.2125506072874495,33.18647923335168
Task_6157,1380,764,91,41,132,1.803921568627451,30.222968617968235
Task_6158,1370,598,178,198,376,2.287145242070117,31.49192081193893
Task_6159,1472,857,192,120,312,1.7156177156177157,33.49924073786599
Task_6160,2794,624,84,198,282,4.4704,53.712309030325
Task_6161,2525,286,66,184,250,8.797909407665506,48.240382343084434
Task_6162,2862,133,43,38,81,21.35820895522388,50.728609960071246
Task_6163,2756,939,196,165,361,2.931914893617021,54.40031375678384
Task_6164,2646,416,185,48,233,6.345323741007194,49.75895646784389
Task_6165,1298,669,117,148,265,1.9373134328358208,30.000085600167694
Task_6166,1616,614,26,130,156,2.627642276422764,34.145493769278815
Task_6167,1953,145,187,97,284,13.376712328767123,38.4106383440348
Task_6168,2910,795,87,116,203,3.6557788944723617,55.565245130848275
Task_6169,863,172,124,20,144,4.988439306358382,19.878999660319845
Task_6170,1028,567,163,175,338,1.8098591549295775,25.77404470792945
Task_6171,2196,496,99,37,136,4.41851106639839,42.26592002080001
Task_6172,647,992,111,169,280,0.6515609264853978,20.87629741665096
Task_6173,2679,82,139,169,308,32.27710843373494,49.458391809513536
Task_6174,2997,240,110,104,214,12.435684647302905,55.17192263179542
Task_6175,1121,377,22,154,176,2.9656084656084656,25.845369619838653
Task_6176,2517,213,81,26,107,11.761682242990654,46.010268772986365
Task_6177,2323,128,100,166,266,18.007751937984494,44.12501118459074
Task_6178,859,874,163,34,197,0.9817142857142858,22.77207051676868
Task_6179,1575,901,110,66,176,1.746119733924612,34.275654276454524
Task_6180,578,818,69,98,167,0.7057387057387058,18.65463098779963
Task_6181,946,798,76,188,264,1.183979974968711,24.87834222833745
Task_6182,1835,455,42,40,82,4.024122807017544,35.88800784645302
Task_6183,1720,718,24,119,143,2.39221140472879,36.03894656812568
Task_6184,2185,130,189,92,281,16.6793893129771,41.80743436753304
Task_6185,1514,516,162,187,349,2.9284332688588006,33.37606200110264
Task_6186,2194,1001,139,188,327,2.189620758483034,45.56827508739207
Task_6187,1866,943,16,80,96,1.9766949152542372,38.46292541604543
Task_6188,2802,328,129,18,147,8.516717325227964,51.3190271246759
Task_6189,2708,742,89,52,141,3.6446837146702555,51.477071026539726
Task_6190,2150,796,176,199,375,2.697616060225847,44.46431517601269
Task_6191,1526,80,36,140,176,18.839506172839506,30.692846635392442
Task_6192,1878,442,70,42,112,4.239277652370204,36.80495167140135
Task_6193,2212,957,39,65,104,2.3089770354906056,44.02384840364241
Task_6194,1153,270,98,35,133,4.254612546125461,25.040902287905215
Task_6195,1502,99,142,98,240,15.02,30.691554613898244
Task_6196,596,252,76,29,105,2.355731225296443,15.804163927267844
Task_6197,2231,187,163,133,296,11.867021276595745,43.3072281143367
Task_6198,619,261,78,167,245,2.3625954198473282,17.972444495371743
Task_6199,2021,789,179,57,236,2.5582278481012657,41.25160166226858
Task_6200,1602,168,65,99,164,9.479289940828401,32.403080307011145
Task_6201,1447,137,194,88,282,10.485507246376812,30.215350834734583
Task_6202,2258,806,175,99,274,2.798017348203222,45.598895322769984
Task_6203,1721,337,81,196,277,5.091715976331361,35.81708003476947
Task_6204,2059,532,156,113,269,3.8630393996247654,41.5867230549491
Task_6205,1301,579,21,142,163,2.2431034482758623,29.220752029873143
Task_6206,1500,115,143,160,303,12.931034482758621,31.187777502605353
Task_6207,1028,561,130,190,320,1.8291814946619218,25.6961491630328
Task_6208,2637,891,68,188,256,2.9562780269058297,51.9982785320073
Task_6209,755,161,133,147,280,4.660493827160494,19.661806420961835
Task_6210,1757,408,64,122,186,4.295843520782396,36.08402279633177
Task_6211,2166,79,97,52,149,27.075,39.89559185151673
Task_6212,1277,691,65,190,255,1.8453757225433527,29.82232408423587
Task_6213,2469,484,32,29,61,5.090721649484536,45.61603781093731
Task_6214,1464,697,17,112,129,2.097421203438395,31.890065815592923
Task_6215,1897,670,139,188,327,2.827123695976155,39.829026046847204
Task_6216,1821,88,60,44,104,20.46067415730337,33.680169332380906
Task_6217,2029,427,141,182,323,4.740654205607477,41.11863031493122
Task_6218,2132,726,44,123,167,2.9325997248968365,42.877271433784635
Task_6219,1728,905,109,39,148,1.9072847682119205,36.244208059983045
Task_6220,1360,275,38,100,138,4.927536231884058,28.889942634377423
Task_6221,651,788,138,114,252,0.8250950570342205,19.98179691791658
Task_6222,1901,403,123,200,323,4.705445544554456,39.041325575897844
Task_6223,1647,612,21,83,104,2.686786296900489,34.13853504162055
Task_6224,1414,872,191,181,372,1.6197021764032073,32.986685403346144
Task_6225,519,276,171,37,208,1.8736462093862816,15.51807153320424
Task_6226,2798,283,71,133,204,9.852112676056338,52.24553535150693
Task_6227,2155,324,93,28,121,6.630769230769231,40.925630207846176
Task_6228,1752,479,100,45,145,3.65,35.28528559858438
Task_6229,644,878,140,194,334,0.732650739476678,20.674744916424366
Task_6230,1158,634,49,71,120,1.8236220472440945,26.564524878534794
Task_6231,647,775,68,153,221,0.8337628865979382,19.825897185805086
Task_6232,2010,635,47,54,101,3.160377358490566,39.56091730905471
Task_6233,2459,871,140,138,278,2.819954128440367,49.06803788860532
Task_6234,1998,513,173,142,315,3.88715953307393,40.81011707248916
Task_6235,1911,921,145,130,275,2.0726681127982647,40.515527638706196
Task_6236,2383,888,165,26,191,2.6805399325084363,46.83312848972462
Task_6237,2986,999,136,57,193,2.986,57.004479002730704
Task_6238,1707,943,48,161,209,1.8082627118644068,37.15916952052863
Task_6239,1288,279,92,185,277,4.6,28.716098901571684
Task_6240,1041,419,183,33,216,2.4785714285714286,24.247829687964057
Task_6241,2312,907,101,18,119,2.5462555066079293,45.054436284647274
Task_6242,2392,853,181,11,192,2.800936768149883,46.8044601421974
Task_6243,2784,236,62,65,127,11.746835443037975,51.06872906225851
Task_6244,2121,924,170,106,276,2.292972972972973,43.821793022164606
Task_6245,715,264,120,157,277,2.69811320754717,19.561838239608623
Task_6246,2261,488,103,47,150,4.623721881390593,43.37955093065623
Task_6247,654,397,84,91,175,1.64321608040201,18.38760390016095
Task_6248,1823,404,130,181,311,4.501234567901235,37.72838310984131
Task_6249,2153,521,43,126,169,4.124521072796935,42.57671050781066
Task_6250,2822,289,127,21,148,9.73103448275862,51.51623469045554
Task_6251,1758,211,118,80,198,8.29245283018868,35.2872767521095
Task_6252,1562,353,55,131,186,4.4124293785310735,32.83231899332279
Task_6253,2000,377,51,28,79,5.291005291005291,37.98235584303769
Task_6254,2341,993,175,59,234,2.3551307847082494,46.9415056889088
Task_6255,2210,756,182,164,346,2.919418758256275,45.10756060990232
Task_6256,677,951,140,135,275,0.7111344537815126,21.122098834100687
Task_6257,680,894,79,77,156,0.7597765363128491,20.10631557838047
Task_6258,1290,297,59,80,139,4.328859060402684,27.909191306116185
Task_6259,625,739,91,92,183,0.8445945945945946,18.987919410075087
Task_6260,2612,284,169,21,190,9.164912280701754,48.449434077998745
Task_6261,1155,1004,36,46,82,1.1492537313432836,26.921951220493664
Task_6262,1772,99,55,66,121,17.72,33.69235603750542
Task_6263,1479,106,197,191,388,13.822429906542055,31.20392295472273
Task_6264,2124,395,191,12,203,5.363636363636363,41.15538371070992
Task_6265,1853,99,94,167,261,18.53,36.41762506438804
Task_6266,1610,449,65,172,237,3.577777777777778,34.22558309118467
Task_6267,869,349,87,48,135,2.4828571428571427,20.832047296561374
Task_6268,2401,406,108,91,199,5.899262899262899,46.189543398271475
Task_6269,530,895,46,131,177,0.5915178571428571,18.208867405261774
Task_6270,2623,974,115,14,129,2.6902564102564104,50.44766297103754
Task_6271,734,691,198,96,294,1.060693641618497,21.157744240773763
Task_6272,2140,1006,171,16,187,2.125124131082423,43.245630423929335
Task_6273,657,878,190,137,327,0.7474402730375427,20.709604555361427
Task_6274,1258,437,150,129,279,2.872146118721461,28.67260248625102
Task_6275,1282,735,149,133,282,1.7418478260869565,29.99354282123228
Task_6276,1504,709,32,105,137,2.1183098591549294,32.53851854467567
Task_6277,776,766,151,112,263,1.0117340286831813,21.892337879029906
Task_6278,1093,871,127,60,187,1.253440366972477,26.5490237963803
Task_6279,2691,553,51,181,232,4.85740072202166,51.692018132154686
Task_6280,1972,646,164,29,193,3.047913446676971,39.599002477613844
Task_6281,999,185,189,37,226,5.370967741935484,22.883648581293016
Task_6282,2914,323,55,43,98,8.993827160493828,52.52880156588733
Task_6283,854,588,108,118,226,1.4499151103565364,22.44198859088043
Task_6284,1494,191,103,132,235,7.78125,31.38771448694534
Task_6285,2001,655,146,79,225,3.0503048780487805,40.70739919100277
Task_6286,1834,703,115,146,261,2.6051136363636362,38.57562200718475
Task_6287,704,690,64,39,103,1.0188133140376265,18.834444228635636
Task_6288,2527,557,76,146,222,4.528673835125448,48.98039198991102
Task_6289,740,268,56,97,153,2.7509293680297398,19.223645509039994
Task_6290,2200,419,92,70,162,5.238095238095238,42.5573151162379
Task_6291,1907,599,178,75,253,3.1783333333333332,39.08809950150691
Task_6292,1786,114,60,156,216,15.530434782608696,35.30439110601693
Task_6293,779,691,198,108,306,1.1257225433526012,21.89559321192699
Task_6294,2220,199,143,178,321,11.1,43.34175496573408
Task_6295,2964,91,176,115,291,32.21739130434783,53.861480477928374
Task_6296,1833,436,128,32,160,4.194508009153318,36.476725298185436
Task_6297,1344,995,37,16,53,1.3493975903614457,29.28262300051155
Task_6298,1593,833,173,49,222,1.910071942446043,34.424430318254146
Task_6299,983,161,106,26,132,6.067901234567901,21.720293795987164
Task_6300,829,876,156,165,321,0.9452679589509693,23.46988292307915
Task_6301,585,719,140,159,299,0.8125,19.016697901075037
Task_6302,1548,599,99,91,190,2.58,33.26221926781192
Task_6303,700,615,29,196,225,1.1363636363636365,20.16924326957991
Task_6304,556,461,99,31,130,1.2034632034632036,16.197237474351116
Task_6305,2159,952,80,80,160,2.265477439664218,43.770354357773236
Task_6306,554,436,101,121,222,1.2677345537757436,17.197617237724163
Task_6307,2486,163,50,109,159,15.158536585365853,46.09288573609501
Task_6308,1577,488,119,142,261,3.224948875255624,33.82204871186212
Task_6309,554,673,155,147,302,0.8219584569732937,18.36321053004617
Task_6310,2689,528,70,20,90,5.083175803402646,49.64523488454186
Task_6311,2900,812,84,33,117,3.5670356703567037,54.17020465582277
Task_6312,583,119,114,129,243,4.858333333333333,16.515338570882907
Task_6313,1829,975,26,48,74,1.8739754098360655,37.13887031511273
Task_6314,1825,190,200,150,350,9.55497382198953,37.151989025630854
Task_6315,2584,323,141,102,243,7.9753086419753085,49.07385844054062
Task_6316,1318,613,131,122,253,2.1465798045602607,30.04962380621735
Task_6317,2654,223,159,18,177,11.848214285714286,48.80568853535238
Task_6318,1185,156,176,182,358,7.547770700636943,26.832883570716675
Task_6319,2504,384,70,178,248,6.503896103896104,48.221992257471186
Task_6320,1678,767,165,50,215,2.1848958333333335,35.527108362124125
Task_6321,1840,764,151,72,223,2.4052287581699345,38.361231961436204
Task_6322,1428,298,177,149,326,4.775919732441472,31.152964557698738
Task_6323,855,686,69,74,143,1.244541484716157,22.179551643641343
Task_6324,785,911,181,158,339,0.8607456140350878,22.94245728150935
Task_6325,2236,613,121,126,247,3.6416938110749184,44.56693006262126
Task_6326,1773,876,116,128,244,2.0216647662485747,38.04622271790971
Task_6327,1633,855,80,51,131,1.9077102803738317,34.74543528692566
Task_6328,1207,242,63,130,193,4.967078189300412,26.91188932875758
Task_6329,2188,819,162,157,319,2.6682926829268294,44.82433370454394
Task_6330,2360,1009,181,168,349,2.3366336633663365,48.2936216005059
Task_6331,2195,544,53,175,228,4.027522935779817,43.75651726636378
Task_6332,2600,308,123,10,133,8.414239482200648,47.953662340372695
Task_6333,1943,126,177,79,256,15.299212598425196,37.75635749329558
Task_6334,2357,624,54,130,184,3.7712,46.27226742612581
Task_6335,803,222,110,129,239,3.600896860986547,20.602066374785707
Task_6336,1919,349,165,189,354,5.482857142857143,39.27213625217477
Task_6337,1673,328,88,13,101,5.085106382978723,32.97785749786258
Task_6338,1971,564,55,51,106,3.488495575221239,38.70371377167731
Task_6339,1476,939,66,31,97,1.5702127659574467,31.829512823588686
Task_6340,1528,659,92,84,176,2.315151515151515,33.01416133449674
Task_6341,1521,157,18,46,64,9.626582278481013,29.559565635270243
Task_6342,2926,571,89,59,148,5.115384615384615,54.417701301887284
Task_6343,2152,631,117,154,271,3.4050632911392404,43.4427553927302
Task_6344,2799,623,76,31,107,4.485576923076923,51.874065568731744
Task_6345,2832,490,184,171,355,5.767820773930754,54.16211774487317
Task_6346,534,854,200,47,247,0.624561403508772,18.069536191917063
Task_6347,961,947,184,62,246,1.0137130801687764,24.921890296681454
Task_6348,1560,151,123,94,217,10.263157894736842,31.927319245255273
Task_6349,988,387,91,111,202,2.5463917525773194,23.866925919990564
Task_6350,1912,996,102,169,271,1.917753259779338,40.80362875901359
Task_6351,1661,424,63,138,201,3.908235294117647,34.73777157516035
Task_6352,2988,638,156,95,251,4.676056338028169,56.542399759820995
Task_6353,1492,169,81,150,231,8.776470588235295,31.138367777546893
Task_6354,1014,178,159,163,322,5.664804469273743,23.961028038521434
Task_6355,2968,277,170,166,336,10.676258992805755,55.49414249763629
Task_6356,2293,310,32,40,72,7.372990353697749,42.29248499870055
Task_6357,2210,668,141,21,162,3.303437967115097,43.16723854994879
Task_6358,2484,682,58,40,98,3.636896046852123,46.86998604022506
Task_6359,2890,654,86,97,183,4.412213740458015,54.68784959401018
Task_6360,1274,987,74,165,239,1.2894736842105263,30.50695335354229
Task_6361,956,969,11,190,201,0.9855670103092784,25.16339965597668
Task_6362,2524,820,94,182,276,3.074299634591961,50.00405102301929
Task_6363,2787,560,19,96,115,4.967914438502674,52.227052984677634
Task_6364,2141,182,142,133,275,11.699453551912569,41.66523378948643
Task_6365,1312,114,31,162,193,11.408695652173913,27.696914230657942
Task_6366,1282,925,126,171,297,1.3844492440604752,30.666363255001556
Task_6367,2218,298,61,94,155,7.418060200668896,42.70304259037249
Task_6368,1134,795,118,21,139,1.4246231155778895,26.328810524612976
Task_6369,821,436,165,159,324,1.8787185354691076,21.99993159235275
Task_6370,2460,724,174,71,245,3.393103448275862,48.13369701295983
Task_6371,1867,138,101,190,291,13.431654676258994,37.14438780707686
Task_6372,856,228,192,51,243,3.7379912663755457,21.048821746271006
Task_6373,2021,565,74,185,259,3.570671378091873,41.21106778392267
Task_6374,2107,521,83,92,175,4.03639846743295,41.82840702943857
Task_6375,569,697,146,153,299,0.8151862464183381,18.68639632410836
Task_6376,1358,351,88,65,153,3.8579545454545454,28.82064629368817
Task_6377,2914,872,135,131,266,3.3379152348224514,56.21617356079895
Task_6378,2356,324,156,75,231,7.24923076923077,45.20149011734846
Task_6379,1231,576,39,136,175,2.1334488734835357,28.209033337738365
Task_6380,1370,853,13,139,152,1.604215456674473,30.931607877757077
Task_6381,2342,312,54,99,153,7.482428115015974,44.63933820866907
Task_6382,2034,696,80,169,249,2.9182209469153517,41.75465196159369
Task_6383,1668,251,74,39,113,6.619047619047619,32.88275271227158
Task_6384,2237,879,134,151,285,2.5420454545454545,45.626087601715284
Task_6385,1870,662,100,145,245,2.8205128205128207,38.943618708976224
Task_6386,2403,136,22,129,151,17.54014598540146,44.36113512845518
Task_6387,2668,203,84,84,168,13.07843137254902,49.49332997224445
Task_6388,946,897,78,115,193,1.0534521158129175,24.71776044216793
Task_6389,2142,575,28,197,225,3.71875,42.952694289512486
Task_6390,2478,224,168,77,245,11.013333333333334,46.84628534619537
Task_6391,1779,850,88,181,269,2.09048178613396,38.20951597026848
Task_6392,2308,234,95,150,245,9.821276595744681,44.48263221406311
Task_6393,2830,475,55,141,196,5.945378151260504,53.39045971609101
Task_6394,2170,374,114,118,232,5.786666666666667,42.671853659641194
Task_6395,2660,76,36,92,128,34.54545454545455,47.866419106705045
Task_6396,1657,146,41,77,118,11.272108843537415,32.32415635087418
Task_6397,1601,750,85,123,208,2.131824234354194,34.76502510232555
Task_6398,2700,322,35,75,110,8.359133126934985,49.94374038210606
Task_6399,961,121,119,172,291,7.877049180327869,22.75771848303692
Task_6400,673,308,169,24,193,2.177993527508091,17.909409894889993
Task_6401,1273,892,106,141,247,1.425531914893617,30.15216991527497
Task_6402,2526,668,121,85,206,3.7757847533632285,49.0122576532377
Task_6403,1585,452,20,75,95,3.498896247240618,32.41283178338485
Task_6404,2663,97,17,192,209,27.1734693877551,48.838268180804654
Task_6405,542,965,184,75,259,0.5610766045548654,18.788939070274804
Task_6406,748,481,80,176,256,1.5518672199170125,20.7181104102044
Task_6407,818,168,152,129,281,4.840236686390533,20.65320665013639
Task_6408,2388,178,48,196,244,13.340782122905027,45.33686991728164
Task_6409,2474,702,59,29,88,3.519203413940256,46.71467653524476
Task_6410,1225,792,126,178,304,1.544766708701135,29.40359394995419
Task_6411,648,273,170,147,317,2.3649635036496353,18.697580373794676
Task_6412,1826,842,151,24,175,2.166073546856465,37.7496715933518
Task_6413,1141,392,115,91,206,2.9033078880407124,26.23811368855259
Task_6414,1848,287,139,64,203,6.416666666666667,36.79978616175095
Task_6415,1264,907,160,34,194,1.3920704845814977,29.20494741539223
Task_6416,1907,415,57,124,181,4.584134615384615,38.452564399451965
Task_6417,586,296,141,73,214,1.973063973063973,16.988434208506096
Task_6418,2223,866,44,84,128,2.56401384083045,44.59084999494968
Task_6419,1584,987,94,163,257,1.6032388663967612,35.50289110117188
Task_6420,1628,475,140,51,191,3.4201680672268906,33.82515053958024
Task_6421,1515,473,151,158,309,3.1962025316455698,33.032671502984805
Task_6422,1729,339,166,135,301,5.0852941176470585,35.915681581754356
Task_6423,1278,374,10,64,74,3.408,26.760886228699324
Task_6424,2103,776,99,57,156,2.7065637065637067,42.03285512318878
Task_6425,2372,394,13,172,185,6.0050632911392405,45.74786454254672
Task_6426,1151,944,163,29,192,1.217989417989418,27.52821605707651
Task_6427,1619,580,180,109,289,2.7865748709122204,34.85595024574187
Task_6428,1910,348,151,184,335,5.472779369627507,39.03349077866353
Task_6429,2706,427,22,38,60,6.322429906542056,49.197641209955584
Task_6430,2400,996,47,29,76,2.407221664994985,46.18130570457481
Task_6431,1178,197,66,140,206,5.94949494949495,26.423133962437507
Task_6432,1350,631,132,188,320,2.1360759493670884,31.011478469225057
Task_6433,527,520,156,75,231,1.0115163147792707,16.808738613513974
Task_6434,1999,413,12,134,146,4.828502415458937,39.514955313929214
Task_6435,1156,428,24,92,116,2.6946386946386944,25.95937593059792
Task_6436,1924,229,198,81,279,8.365217391304348,38.336538703950325
Task_6437,1501,76,155,18,173,19.493506493506494,29.24860397977481
Task_6438,2852,376,65,181,246,7.56498673740053,53.69361948745652
Task_6439,1382,1008,61,141,202,1.3696729435084243,32.102355439256215
Task_6440,1172,120,129,98,227,9.685950413223141,25.672338650038483
Task_6441,1680,82,71,26,97,20.240963855421686,31.529071110141434
Task_6442,2475,351,154,112,266,7.03125,47.56411370227471
Task_6443,1757,964,17,177,194,1.8207253886010362,37.87090333146019
Task_6444,1697,659,56,131,187,2.5712121212121213,35.968194592395726
Task_6445,1684,79,39,41,80,21.05,31.499066276415277
Task_6446,2210,122,186,80,266,17.96747967479675,41.99790439790548
Task_6447,2695,443,26,140,166,6.06981981981982,50.897096531315505
Task_6448,1962,646,189,165,354,3.0324574961360122,40.87103808874438
Task_6449,1472,743,66,67,133,1.978494623655914,32.04079923629912
Task_6450,582,995,166,117,283,0.5843373493975904,19.80382623291114
Task_6451,1837,937,120,65,185,1.9584221748400852,38.599983492322856
Task_6452,2736,119,19,16,35,22.8,47.96554181534328
Task_6453,1127,561,93,66,159,2.005338078291815,25.96058932214441
Task_6454,2843,905,94,133,227,3.1379690949227372,55.032009487055205
Task_6455,572,914,93,170,263,0.6251366120218579,19.482244075605944
Task_6456,1760,488,10,166,176,3.5991820040899793,36.30927031875972
Task_6457,1804,239,126,151,277,7.516666666666667,36.67485004609863
Task_6458,2360,90,97,199,296,25.934065934065934,44.52139374729472
Task_6459,2648,545,33,103,136,4.8498168498168495,50.14823019655511
Task_6460,507,461,190,155,345,1.0974025974025974,17.13320159380817
Task_6461,2276,256,108,94,202,8.85603112840467,43.76505047020695
Task_6462,877,254,52,31,83,3.43921568627451,20.03738316466418
Task_6463,913,937,84,70,154,0.9733475479744137,23.709048703378304
Task_6464,605,1003,41,113,154,0.602589641434263,19.466793470202635
Task_6465,2695,786,140,99,239,3.4243964421855146,52.30180875398296
Task_6466,827,597,109,120,229,1.382943143812709,22.058842048923108
Task_6467,1987,245,14,39,53,8.077235772357724,37.18377180306712
Task_6468,1280,427,78,141,219,2.9906542056074765,28.803073332107825
Task_6469,1020,554,80,50,130,1.837837837837838,23.946778679096628
Task_6470,1690,152,148,127,275,11.045751633986928,34.32010245415619
Task_6471,2345,839,115,192,307,2.7916666666666665,47.37157680322779
Task_6472,2947,814,97,160,257,3.6159509202453988,56.566533513653575
Task_6473,1263,437,132,27,159,2.8835616438356166,27.41840127127412
Task_6474,1124,176,43,94,137,6.350282485875706,24.403875624689647
Task_6475,681,834,182,63,245,0.8155688622754491,20.290409454603374
Task_6476,742,949,80,170,250,0.7810526315789473,22.044177681337484
Task_6477,1427,665,70,195,265,2.1426426426426426,32.17218970431078
Task_6478,2822,718,176,99,275,3.924895688456189,54.26162562377738
Task_6479,2504,296,112,97,209,8.43097643097643,47.58244391898173
Task_6480,637,841,189,41,230,0.7565320665083135,19.28132025537876
Task_6481,2861,793,154,66,220,3.6032745591939546,54.54802041330104
Task_6482,1835,432,61,152,213,4.237875288683603,37.59191476592737
Task_6483,1811,376,113,58,171,4.803713527851459,36.266906419972415
Task_6484,1968,360,74,198,272,5.4515235457063715,39.787912357092026
Task_6485,1368,201,109,166,275,6.772277227722772,29.66650928019384
Task_6486,1831,502,38,111,149,3.640159045725646,37.17544625720687
Task_6487,838,465,199,102,301,1.798283261802575,22.172833960187756
Task_6488,1466,415,78,101,179,3.5240384615384617,31.443534322149343
Task_6489,1806,291,125,69,194,6.184931506849315,36.10689551900892
Task_6490,2503,773,180,160,340,3.2338501291989665,49.769778685382846
Task_6491,2697,141,35,39,74,18.992957746478872,47.93812991540897
Task_6492,2673,898,137,198,335,2.9733036707452727,52.88815015421511
Task_6493,1513,928,71,82,153,1.6286329386437028,33.45613847433115
Task_6494,1606,177,143,25,168,9.02247191011236,31.853576399470242
Task_6495,2908,371,109,112,221,7.817204301075269,54.27901027284836
Task_6496,781,448,55,90,145,1.7394209354120267,20.418431457746053
Task_6497,1772,680,135,86,221,2.6020558002936856,37.18688093000919
Task_6498,2347,651,141,176,317,3.5996932515337425,46.83401513178038
Task_6499,2138,985,109,26,135,2.1683569979716024,42.85003520262149
Task_6500,1812,747,129,53,182,2.4224598930481283,37.59944152621449
Task_6501,2712,351,140,157,297,7.704545454545454,51.51867449733967
Task_6502,596,773,135,85,220,0.7700258397932817,18.841060411774695
Task_6503,1171,864,89,189,278,1.353757225433526,28.63058860650273
Task_6504,1172,138,90,195,285,8.431654676258994,26.17906730160821
Task_6505,787,518,137,47,184,1.5163776493256262,20.410507179181817
Task_6506,2651,886,16,12,28,2.988726042841037,49.421452278804175
Task_6507,2893,92,192,188,380,31.107526881720432,53.25412636461018
Task_6508,2975,1007,33,167,200,2.951388888888889,57.366698631326585
Task_6509,1758,67,35,179,214,25.852941176470587,34.520636521050044
Task_6510,505,229,104,99,203,2.1956521739130435,15.706412629595443
Task_6511,2313,484,101,176,277,4.7690721649484535,45.5823894677816
Task_6512,2712,309,121,26,147,8.748387096774193,49.88947230328964
Task_6513,862,961,95,178,273,0.896049896049896,24.058104457511657
Task_6514,2870,141,100,172,272,20.211267605633804,52.87763599894985
Task_6515,1940,743,55,123,178,2.60752688172043,40.01605520077849
Task_6516,2105,108,36,99,135,19.31192660550459,39.34611837223384
Task_6517,516,546,149,52,201,0.943327239488117,16.6376123820854
Task_6518,1409,298,29,181,210,4.712374581939799,30.379123573341897
Task_6519,1028,392,98,155,253,2.6157760814249365,24.814976856993308
Task_6520,1275,177,115,107,222,7.162921348314606,27.54175200028148
Task_6521,2275,647,43,14,57,3.5108024691358026,42.94423275884797
Task_6522,2902,399,113,131,244,7.255,54.410312039737846
Task_6523,962,230,61,111,172,4.1645021645021645,22.846693211912598
Task_6524,2030,124,93,146,239,16.24,39.3343359985881
Task_6525,936,696,83,98,181,1.3428981348637017,23.84447968436848
Task_6526,1827,502,91,74,165,3.63220675944334,37.12102562731012
Task_6527,2858,726,97,147,244,3.931224209078404,54.80149625064754
Task_6528,2416,373,98,50,148,6.459893048128342,45.54080393054199
Task_6529,2438,146,41,128,169,16.58503401360544,45.39120381775027
Task_6530,1569,116,104,132,236,13.41025641025641,31.93986412619091
Task_6531,2112,578,76,71,147,3.6476683937823835,41.71214999232392
Task_6532,1321,152,79,185,264,8.633986928104575,28.611305400226332
Task_6533,960,419,87,148,235,2.2857142857142856,23.68918212198646
Task_6534,1231,1002,47,48,95,1.2273180458624127,28.236806385521458
Task_6535,992,158,152,71,223,6.238993710691824,22.753503511103972
Task_6536,814,939,171,123,294,0.8659574468085106,23.2343833077452
Task_6537,1932,1009,23,108,131,1.9128712871287128,40.28032798962152
Task_6538,1280,820,26,133,159,1.5590742996345919,29.433514010431182
Task_6539,1504,72,46,37,83,20.602739726027398,28.4245667548971
Task_6540,2456,308,105,19,124,7.948220064724919,45.526321637367566
Task_6541,1282,576,165,155,320,2.221837088388215,29.713936192127832
Task_6542,2487,93,190,166,356,26.45744680851064,46.74529594239206
Task_6543,2098,430,77,76,153,4.867749419953596,41.036428811075446
Task_6544,2792,681,199,64,263,4.093841642228739,53.292959845031454
Task_6545,2661,664,130,107,237,4.001503759398497,51.386867608512375
Task_6546,1392,842,119,19,138,1.6512455516014235,30.550961943776173
Task_6547,2991,548,164,136,300,5.448087431693989,56.568512625474
Task_6548,1795,1016,146,57,203,1.7649950835791544,38.21849024048301
Task_6549,507,225,62,171,233,2.243362831858407,16.038934554749066
Task_6550,1759,561,159,57,216,3.1298932384341636,36.295214544465296
Task_6551,1141,528,16,106,122,2.156899810964083,26.098990198057624
Task_6552,1887,135,142,158,300,13.875,37.44041938621026
Task_6553,621,483,116,94,210,1.2830578512396693,18.304426483504216
Task_6554,2756,837,191,134,325,3.288782816229117,53.873303564939896
Task_6555,2165,673,75,190,265,3.212166172106825,43.87171077283466
Task_6556,1394,250,112,148,260,5.553784860557769,30.154830051175214
Task_6557,1181,299,131,63,194,3.9366666666666665,26.245701881198027
Task_6558,826,799,199,128,327,1.0325,23.11704364856844
Task_6559,2718,326,70,143,213,8.311926605504587,51.200729964988085
Task_6560,2507,68,124,46,170,36.333333333333336,44.98118216020308
Task_6561,814,361,195,80,275,2.248618784530387,21.216336355059642
Task_6562,960,981,129,80,209,0.9775967413441955,25.14446515497664
Task_6563,635,226,43,85,128,2.797356828193833,17.426364825314725
Task_6564,2619,229,162,191,353,11.38695652173913,49.91249213524518
Task_6565,1699,713,93,47,140,2.3795518207282913,35.240262921062794
Task_6566,1870,1021,149,133,282,1.8297455968688845,40.21246918693978
Task_6567,1378,1021,140,94,234,1.3483365949119375,32.08855459636118
Task_6568,1630,983,148,118,266,1.6565040650406504,36.183737227242595
Task_6569,1783,747,55,69,124,2.3836898395721926,36.825259213048994
Task_6570,759,503,138,107,245,1.505952380952381,20.753357183583297
Task_6571,542,735,189,92,281,0.7364130434782609,18.163351107273012
Task_6572,1564,258,38,137,175,6.038610038610039,32.453329539348914
Task_6573,1598,219,74,117,191,7.263636363636364,32.97270939197131
Task_6574,2181,796,136,170,306,2.736511919698871,44.601950061578144
Task_6575,983,671,147,165,312,1.462797619047619,25.199849327069945
Task_6576,1093,398,115,158,273,2.7393483709273183,25.952862651416876
Task_6577,2277,907,76,137,213,2.5077092511013217,46.069163123879285
Task_6578,1700,914,150,179,329,1.8579234972677596,37.46554633575136
Task_6579,1844,991,127,117,244,1.8588709677419355,39.51259262824036
Task_6580,1324,466,116,114,230,2.835117773019272,29.566481277652017
Task_6581,2720,910,184,31,215,2.9857299670691546,52.38308612480069
Task_6582,1320,379,34,98,132,3.473684210526316,28.65339126658885
Task_6583,520,92,59,54,113,5.591397849462366,13.895191376277653
Task_6584,2938,791,29,88,117,3.70959595959596,55.35814427170527
Task_6585,2548,582,23,119,142,4.370497427101201,48.71603992587895
Task_6586,2432,985,49,162,211,2.4665314401622718,48.82517512587256
Task_6587,2334,603,120,22,142,3.8642384105960264,44.768887399305676
Task_6588,1039,344,84,10,94,3.0115942028985505,22.97173798072842
Task_6589,1260,252,44,42,86,4.980237154150197,26.154347422762317
Task_6590,711,454,13,89,102,1.5626373626373626,18.68950572149652
Task_6591,1467,809,65,56,121,1.8111111111111111,31.76059118487814
Task_6592,2808,483,184,179,363,5.801652892561983,53.807134225285154
Task_6593,2771,64,85,66,151,42.63076923076923,49.16647561158211
Task_6594,1223,455,158,129,287,2.682017543859649,28.21181328147715
Task_6595,2936,944,93,62,155,3.106878306878307,55.799185133731335
Task_6596,1791,587,107,36,143,3.045918367346939,36.20145030024778
Task_6597,695,955,41,153,194,0.7269874476987448,21.047707060337387
Task_6598,688,221,17,22,39,3.099099099099099,16.3446302436963
Task_6599,1633,770,191,151,342,2.118028534370947,35.97332964775007
Task_6600,1447,730,21,133,154,1.9794801641586868,31.785401955511393
Task_6601,1103,363,113,59,172,3.03021978021978,25.04771881903537
Task_6602,2646,714,140,35,175,3.7006993006993008,50.40361121275575
Task_6603,735,527,84,157,241,1.3920454545454546,20.500771285155544
Task_6604,1793,384,92,145,237,4.6571428571428575,36.80990112783076
Task_6605,586,840,47,151,198,0.6967895362663495,19.072119360383326
Task_6606,2468,739,200,53,253,3.3351351351351353,48.30755128786124
Task_6607,505,425,85,179,264,1.1854460093896713,16.65606264006769
Task_6608,1726,885,110,101,211,1.9480812641083523,37.14119740014508
Task_6609,1358,873,17,30,47,1.5537757437070938,29.157684809735382
Task_6610,2971,866,93,133,226,3.4267589388696655,56.96161591869582
Task_6611,2272,957,111,111,222,2.37160751565762,46.081270768538275
Task_6612,909,369,67,50,117,2.4567567567567568,21.38952433028963
Task_6613,1256,227,195,124,319,5.508771929824562,28.126476583220214
Task_6614,2573,847,90,40,130,3.0341981132075473,49.366135636372576
Task_6615,1118,640,100,90,190,1.7441497659906395,26.589515884093924
Task_6616,1266,372,16,67,83,3.3941018766756033,26.943219794465424
Task_6617,2822,504,124,96,220,5.588118811881188,53.35928733118638
Task_6618,1748,174,179,19,198,9.98857142857143,34.27105973578102
Task_6619,2087,846,65,138,203,2.4639905548996457,42.82752782267303
Task_6620,1986,685,14,138,152,2.8950437317784257,40.18126457699565
Task_6621,1864,856,91,97,188,2.175029171528588,39.151842188840384
Task_6622,2206,255,70,37,107,8.6171875,41.30207085162032
Task_6623,904,519,88,195,283,1.7384615384615385,23.387359454191067
Task_6624,604,153,69,151,220,3.9220779220779223,17.06354657559616
Task_6625,2183,209,54,169,223,10.395238095238096,42.40228282261362
Task_6626,2080,889,51,22,73,2.337078651685393,40.656261514906404
Task_6627,1526,686,22,174,196,2.2212518195050945,33.37344392503237
Task_6628,1499,387,126,123,249,3.86340206185567,32.182144659910655
Task_6629,1835,907,139,154,293,2.0209251101321586,39.38402431094361
Task_6630,1538,609,37,102,139,2.5213114754098362,32.80986488160186
Task_6631,1556,396,40,158,198,3.9193954659949624,32.94444262670823
Task_6632,1945,493,59,101,160,3.937246963562753,39.02310602793193
Task_6633,2615,798,28,138,166,3.272841051314143,50.76533065910818
Task_6634,2082,276,175,61,236,7.516245487364621,40.5530688682749
Task_6635,2786,225,118,63,181,12.327433628318584,51.2538223992845
Task_6636,2014,85,30,108,138,23.41860465116279,37.770015883956034
Task_6637,684,840,19,103,122,0.8133174791914387,19.763705319648313
Task_6638,1471,334,196,167,363,4.391044776119403,32.14498669729485
Task_6639,2909,313,19,191,210,9.264331210191083,54.145061031602104
Task_6640,969,774,148,110,258,1.2503225806451612,24.963274546033023
Task_6641,2462,395,23,131,154,6.217171717171717,46.79193883000821
Task_6642,2537,440,114,156,270,5.752834467120182,48.9239750514105
Task_6643,719,756,105,22,127,0.9498018494055482,19.764525450728936
Task_6644,1472,738,139,95,234,1.9918809201623815,32.76762131732083
Task_6645,1225,415,188,53,241,2.9447115384615383,27.54574713273293
Task_6646,2814,782,124,188,312,3.5938697318007664,54.63995871359358
Task_6647,788,894,176,101,277,0.8804469273743016,22.574458692609955
Task_6648,1708,365,145,127,272,4.666666666666667,35.526683615759744
Task_6649,1067,1015,193,39,232,1.0501968503937007,26.601332260474848
Task_6650,741,604,70,61,131,1.2247933884297522,19.931451200291196
Task_6651,2413,989,190,83,273,2.437373737373737,48.532203690308485
Task_6652,1785,292,30,131,161,6.092150170648464,35.84777995784811
Task_6653,1127,340,119,147,266,3.304985337243402,26.257241715531038
Task_6654,2913,510,98,131,229,5.700587084148728,54.88728363647059
Task_6655,1410,762,85,160,245,1.8479685452162515,31.997609688290936
Task_6656,1989,1006,26,80,106,1.9751737835153922,40.798998149332405
Task_6657,1731,724,33,200,233,2.3875862068965517,36.96904690304883
Task_6658,546,91,124,79,203,5.934782608695652,15.203515298568272
Task_6659,1985,340,40,87,127,5.821114369501466,38.9959992008338
Task_6660,1749,731,63,114,177,2.389344262295082,36.93262375631258
Task_6661,2890,709,87,109,196,4.070422535211268,54.935163272295796
Task_6662,2231,171,171,186,357,12.970930232558139,43.36856045938219
Task_6663,2248,575,93,163,256,3.9027777777777777,44.76957466520131
Task_6664,1935,956,74,18,92,2.0219435736677114,39.06924180815526
Task_6665,1790,221,23,194,217,8.063063063063064,36.16887446218443
Task_6666,1081,586,58,154,212,1.8415672913117547,26.143847713043503
Task_6667,660,286,71,31,102,2.299651567944251,16.920122187648136
Task_6668,1773,375,187,142,329,4.715425531914893,36.86664174123667
Task_6669,2177,962,14,107,121,2.260643821391485,43.86638623346323
Task_6670,851,435,39,194,233,1.951834862385321,22.122628112622497
Task_6671,1916,196,141,140,281,9.725888324873097,38.30236074638166
Task_6672,553,799,116,176,292,0.69125,18.845521912730316
Task_6673,2334,447,128,58,186,5.209821428571429,44.87580015625673
Task_6674,1675,782,153,125,278,2.1392081736909323,36.34957219274842
Task_6675,2095,332,167,165,332,6.291291291291292,41.8646363380728
Task_6676,2925,370,43,78,121,7.884097035040432,53.789655605363784
Task_6677,2019,115,34,73,107,17.405172413793103,37.63090220615362
Task_6678,2434,710,118,185,303,3.423347398030942,48.348397535146034
Task_6679,1561,389,86,110,196,4.0025641025641026,32.87193448462844
Task_6680,2875,219,132,114,246,13.068181818181818,53.32100703770893
Task_6681,2545,773,17,119,136,3.2881136950904395,49.210980001850146
Task_6682,2971,925,78,187,265,3.2084233261339095,57.42991486228312
Task_6683,2952,252,143,193,336,11.66798418972332,55.18741728761671
Task_6684,2796,756,133,47,180,3.6935270805812417,52.97286506978589
Task_6685,2919,1016,195,136,331,2.870206489675516,57.046002530424765
Task_6686,609,72,169,186,355,8.342465753424657,17.256307540729825
Task_6687,2750,802,69,40,109,3.4246575342465753,51.71921289186202
Task_6688,2653,335,112,93,205,7.895833333333333,50.005661496761356
Task_6689,1170,520,141,120,261,2.2456813819577737,27.447482622599804
Task_6690,1725,925,154,46,200,1.8628509719222461,36.611910234551225
Task_6691,1235,692,40,33,73,1.7821067821067822,26.753245274560417
Task_6692,678,966,103,72,175,0.7011375387797312,20.483458716555294
Task_6693,1322,565,194,194,388,2.335689045936396,30.676475343685812
Task_6694,2816,544,184,200,384,5.1669724770642205,54.25706287557713
Task_6695,1870,502,196,117,313,3.7176938369781314,38.70285901673815
Task_6696,641,968,97,126,223,0.6615067079463365,20.40763096304102
Task_6697,2618,233,32,52,84,11.188034188034187,47.7426359244711
Task_6698,1809,736,143,97,240,2.4545454545454546,38.14482321905289
Task_6699,2368,271,170,38,208,8.705882352941176,44.726855700162126
Task_6700,2062,294,10,124,134,6.989830508474577,40.02539942479964
Task_6701,1462,84,182,187,369,17.2,30.704189705798314
Task_6702,1575,678,83,191,274,2.3195876288659796,34.554988755964494
Task_6703,1020,453,197,154,351,2.246696035242291,25.317473312901637
Task_6704,949,845,166,22,188,1.1217494089834514,23.91290891418456
Task_6705,2688,214,194,86,280,12.502325581395349,50.39406992411987
Task_6706,1379,210,49,184,233,6.535545023696683,29.80555539129679
Task_6707,534,333,164,167,331,1.598802395209581,17.164803906082668
Task_6708,2445,621,155,161,316,3.9308681672025725,48.26459406715977
Task_6709,598,150,179,129,308,3.9602649006622515,17.25502710276714
Task_6710,716,399,14,106,120,1.79,18.93935251499919
Task_6711,2927,121,104,188,292,23.991803278688526,53.7181705558418
Task_6712,2929,584,189,146,335,5.006837606837607,55.87508994922293
Task_6713,1426,305,38,162,200,4.660130718954249,30.605632962181332
Task_6714,1276,174,76,169,245,7.291428571428572,27.854648983462795
Task_6715,2775,275,81,183,264,10.054347826086957,52.18998216667219
Task_6716,2962,725,183,164,347,4.079889807162535,56.92726290672613
Task_6717,2620,1012,82,187,269,2.586377097729516,52.13256262617397
Task_6718,1527,219,27,146,173,6.9409090909090905,31.713957044935018
Task_6719,2336,756,135,196,331,3.085865257595773,47.08295204532635
Task_6720,1160,772,48,39,87,1.500646830530401,26.19703797156753
Task_6721,618,599,138,53,191,1.03,18.287439260056185
Task_6722,2076,353,135,148,283,5.864406779661017,41.38878233319493
Task_6723,830,681,64,45,109,1.217008797653959,20.820635611551563
Task_6724,2830,102,40,107,147,27.475728155339805,50.79252793526584
Task_6725,2537,385,124,93,217,6.572538860103627,48.394271070559164
Task_6726,1367,701,134,98,232,1.9472934472934473,30.97836745274097
Task_6727,1434,254,72,197,269,5.623529411764705,30.972880382829562
Task_6728,988,1001,181,95,276,0.9860279441117764,26.077334763883197
Task_6729,896,485,53,76,129,1.8436213991769548,22.274560245758607
Task_6730,2357,969,81,121,202,2.4298969072164947,47.44341392505785
Task_6731,740,829,109,121,230,0.891566265060241,21.4325344519501
Task_6732,1104,895,185,33,218,1.2321428571428572,26.738500327466085
Task_6733,1846,246,140,11,151,7.473684210526316,35.90874261873724
Task_6734,2202,468,199,68,267,4.6950959488272925,43.29387646236205
Task_6735,1759,192,56,196,252,9.1139896373057,35.7986014245566
Task_6736,2137,251,46,127,173,8.48015873015873,41.476673097292675
Task_6737,987,584,164,104,268,1.6871794871794872,24.744885283484965
Task_6738,648,981,165,64,229,0.659877800407332,20.30602275039477
Task_6739,2700,524,65,75,140,5.142857142857143,50.88939477365841
Task_6740,2766,961,14,43,57,2.8752598752598755,51.914723020381835
Task_6741,2274,280,178,60,238,8.092526690391459,43.6144888861956
Task_6742,1594,67,129,172,301,23.441176470588236,32.393665528098445
Task_6743,2620,798,146,42,188,3.27909887359199,50.31873107562902
Task_6744,2867,896,154,183,337,3.1962095875139354,55.94289321445577
Task_6745,1581,886,157,159,316,1.782412626832018,35.39161714028228
Task_6746,1078,640,30,182,212,1.6817472698907956,26.22585744187954
Task_6747,1170,318,53,84,137,3.6677115987460813,26.087634510948902
Task_6748,1607,745,200,79,279,2.1541554959785523,34.9917469899348
Task_6749,2906,318,28,139,167,9.109717868338558,53.80347100320441
Task_6750,1124,99,155,21,176,11.24,23.603752708278137
Task_6751,1021,856,179,61,240,1.191365227537923,25.61970624227889
Task_6752,2233,926,34,100,134,2.4088457389428264,44.77423357281506
Task_6753,1336,811,130,91,221,1.645320197044335,30.693947151189196
Task_6754,2704,250,43,171,214,10.772908366533864,50.69593769551508
Task_6755,2733,342,150,89,239,7.967930029154519,51.41630464153686
Task_6756,2440,865,167,44,211,2.8175519630484986,47.78938883396686
Task_6757,692,541,189,162,351,1.2767527675276753,20.35097177775086
Task_6758,2259,461,119,189,308,4.8896103896103895,44.811942720968055
Task_6759,588,802,192,41,233,0.7322540473225405,18.48422473825266
Task_6760,2874,92,96,58,154,30.903225806451612,51.04961874531162
Task_6761,2516,77,101,81,182,32.256410256410255,45.90712819461254
Task_6762,2535,745,81,108,189,3.3981233243967828,49.48211245312695
Task_6763,1714,613,44,143,187,2.791530944625407,36.05757673876901
Task_6764,2636,746,79,152,231,3.5287817938420347,51.348865131547306
Task_6765,1819,687,133,92,225,2.6438953488372094,37.99465368158055
Task_6766,2165,311,160,44,204,6.939102564102564,41.62689486519742
Task_6767,1992,985,192,189,381,2.020283975659229,42.56230177962413
Task_6768,1896,469,143,161,304,4.034042553191489,39.032756956474124
Task_6769,1234,574,161,11,172,2.146086956521739,27.478827587292585
Task_6770,2260,93,36,196,232,24.04255319148936,42.6608344245093
Task_6771,1052,440,132,17,149,2.385487528344671,24.01211376308262
Task_6772,2950,931,109,164,273,3.165236051502146,57.0513268110106
Task_6773,1484,173,135,17,152,8.528735632183908,29.695880357486356
Task_6774,1955,746,69,25,94,2.6171352074966534,38.81410060853944
Task_6775,2395,397,171,73,244,6.017587939698492,46.066340830817495
Task_6776,2310,855,91,59,150,2.6985981308411215,45.538652774624474
Task_6777,2353,766,168,186,354,3.0677966101694913,47.47266154018922
Task_6778,1143,431,98,135,233,2.6458333333333335,26.63920503345498
Task_6779,917,167,160,26,186,5.458333333333333,21.115782440649852
Task_6780,2699,737,181,18,199,3.6571815718157183,51.339262116990795
Task_6781,2028,746,139,34,173,2.714859437751004,40.695329170935665
Task_6782,2377,941,163,125,288,2.523354564755839,48.01325471514283
Task_6783,1378,926,126,75,201,1.4865156418554477,31.46581552481973
Task_6784,2529,225,177,107,284,11.190265486725664,48.041514632466146
Task_6785,1504,453,157,129,286,3.3127753303964758,32.648663361348135
Task_6786,2634,139,166,86,252,18.814285714285713,48.77793269273744
Task_6787,2594,822,171,130,301,3.1518833535844473,51.14552517783361
Task_6788,1722,866,13,95,108,1.986159169550173,36.19568356342544
Task_6789,1957,974,127,82,209,2.0071794871794872,40.97025647429443
Task_6790,1953,476,166,71,237,4.09433962264151,39.28146677728989
Task_6791,890,390,192,91,283,2.2762148337595907,22.607324412205788
Task_6792,1450,684,55,33,88,2.116788321167883,30.439669247865492
Task_6793,1724,990,58,111,169,1.739656912209889,37.26925226240967
Task_6794,2146,914,121,181,302,2.3453551912568305,44.41390938233618
Task_6795,2612,725,32,200,232,3.597796143250689,50.91481112344604
Task_6796,1682,291,183,142,325,5.760273972602739,35.130314107945956
Task_6797,838,627,136,170,306,1.3343949044585988,22.753709928179592
Task_6798,2552,136,178,31,209,18.62773722627737,46.81269363624491
Task_6799,1695,113,86,110,196,14.868421052631579,33.64796186495383
Task_6800,1585,506,131,124,255,3.126232741617357,33.95243436079865
Task_6801,2237,174,62,47,109,12.782857142857143,41.097323791395645
Task_6802,1061,640,30,71,101,1.655226209048362,24.802346866484395
Task_6803,2129,146,80,83,163,14.482993197278912,40.46997147605604
Task_6804,1673,933,39,193,232,1.791220556745182,36.68994862727462
Task_6805,2582,591,121,55,176,4.361486486486487,49.23083589243452
Task_6806,2402,524,187,119,306,4.575238095238095,47.1673940907264
Task_6807,1310,103,90,108,198,12.596153846153847,27.561639055831147
Task_6808,2769,732,194,51,245,3.77762619372442,52.95271370780805
Task_6809,1852,147,63,172,235,12.513513513513514,36.778360530762605
Task_6810,1878,183,198,109,307,10.206521739130435,37.63629279536927
Task_6811,1575,347,85,105,190,4.525862068965517,32.96490189780438
Task_6812,644,250,63,42,105,2.5657370517928286,16.450869738855882
Task_6813,2093,226,147,24,171,9.220264317180616,39.92550494049288
Task_6814,1552,317,160,102,262,4.880503144654088,32.819385441185965
Task_6815,973,931,160,92,252,1.043991416309013,25.412048829032695
Task_6816,1427,618,190,14,204,2.3053311793214863,30.826514171675942
Task_6817,2009,1000,21,62,83,2.006993006993007,40.58739233667635
Task_6818,2097,635,109,198,307,3.297169811320755,42.81105731993498
Task_6819,538,757,14,156,170,0.7097625329815304,17.82123251801926
Task_6820,1635,328,194,69,263,4.9696048632218845,33.84024132340171
Task_6821,2807,989,17,67,84,2.8353535353535353,53.27777008539248
Task_6822,2272,179,15,87,102,12.622222222222222,42.18481343922252
Task_6823,1598,313,170,178,348,5.089171974522293,34.03250185558277
Task_6824,2915,176,42,146,188,16.468926553672315,53.256002906734345
Task_6825,1927,888,111,137,248,2.1676040494938134,40.5549184572541
Task_6826,1769,494,73,17,90,3.573737373737374,34.975434859201314
Task_6827,2922,723,93,75,168,4.035911602209945,55.15548731677378
Task_6828,2848,396,20,64,84,7.173803526448363,52.035845178214124
Task_6829,2606,566,148,185,333,4.596119929453263,50.75067917110795
Task_6830,1882,82,126,133,259,22.674698795180724,36.693329388515096
Task_6831,1226,441,74,181,255,2.773755656108597,28.207465284730375
Task_6832,1923,596,62,47,109,3.221105527638191,37.8720367406574
Task_6833,901,201,128,83,211,4.46039603960396,21.812960698717443
Task_6834,2240,692,78,83,161,3.2323232323232323,44.31107550272258
Task_6835,2336,299,32,174,206,7.786666666666667,45.00530230965114
Task_6836,509,717,70,19,89,0.7089136490250696,16.21370709240963
Task_6837,609,734,108,181,289,0.8285714285714286,19.414409009617085
Task_6838,550,88,183,188,371,6.179775280898877,16.4336317242331
Task_6839,1508,739,185,147,332,2.037837837837838,33.84547298007595
Task_6840,941,177,23,170,193,5.286516853932584,22.139523152373176
Task_6841,2722,444,101,74,175,6.116853932584269,51.11122290881079
Task_6842,1103,431,48,136,184,2.553240740740741,25.80459008199452
Task_6843,2759,223,175,14,189,12.316964285714286,50.512679423442286
Task_6844,1063,208,47,22,69,5.086124401913875,22.403902417189354
Task_6845,2345,880,164,173,337,2.6617480136208855,47.607075014358905
Task_6846,1500,249,119,141,260,6.0,31.81592173120852
Task_6847,658,454,63,191,254,1.4461538461538461,19.225486426218158
Task_6848,1804,889,101,173,274,2.0269662921348313,38.77904325689541
Task_6849,2223,142,84,188,272,15.545454545454545,42.73639176730637
Task_6850,816,825,96,29,125,0.9878934624697336,21.517583589428455
Task_6851,1943,667,51,144,195,2.908682634730539,39.98694585643554
Task_6852,2682,740,129,146,275,3.619433198380567,52.18817287566668
Task_6853,800,71,143,63,206,11.11111111111111,18.986867104790353
Task_6854,1188,663,64,90,154,1.7891566265060241,27.529221363744437
Task_6855,2935,714,190,111,301,4.104895104895105,56.179726901239405
Task_6856,2784,573,26,178,204,4.850174216027875,52.98575703214464
Task_6857,1458,925,194,64,258,1.57451403887689,32.88288326854103
Task_6858,1035,666,77,25,102,1.5517241379310345,23.988749542264404
Task_6859,2581,765,60,174,234,3.3694516971279374,50.59248656411015
Task_6860,1091,996,162,26,188,1.0942828485456368,26.69077045804947
Task_6861,854,210,187,24,211,4.04739336492891,20.53087352809763
Task_6862,1898,913,177,107,284,2.076586433260394,40.29149437357698
Task_6863,2123,406,102,192,294,5.216216216216216,42.4216133462053
Task_6864,1266,264,177,127,304,4.777358490566038,28.34720282131116
Task_6865,511,811,42,45,87,0.6293103448275862,16.500045652196665
Task_6866,2116,223,44,27,71,9.446428571428571,39.193925669935105
Task_6867,1215,186,70,32,102,6.497326203208556,25.46987936628862
Task_6868,2202,167,99,35,134,13.107142857142858,40.97535291202117
Task_6869,2083,974,134,169,303,2.1364102564102563,43.589286763220805
Task_6870,1799,837,192,123,315,2.1467780429594274,38.64941528256051
Task_6871,1501,647,193,153,346,2.316358024691358,33.51900284578317
Task_6872,1983,770,194,175,369,2.5719844357976656,41.67502498266365
Task_6873,2928,670,195,111,306,4.363636363636363,55.95182999055633
Task_6874,2336,634,14,112,126,3.678740157480315,45.50021827383779
Task_6875,2423,140,200,159,359,17.18439716312057,46.194723858551676
Task_6876,1571,1024,157,50,207,1.5326829268292683,34.592340688236796
Task_6877,2446,227,68,166,234,10.728070175438596,46.67263254427612
Task_6878,2421,145,158,171,329,16.58219178082192,46.098527345197255
Task_6879,2842,93,36,152,188,30.23404255319149,51.503453438599074
Task_6880,817,494,175,199,374,1.6505050505050505,22.389011833027126
Task_6881,781,281,15,91,106,2.769503546099291,19.401620216791404
Task_6882,1277,164,63,74,137,7.739393939393939,26.81103534735782
Task_6883,719,773,163,141,304,0.9289405684754521,21.294466395068373
Task_6884,676,299,164,131,295,2.2533333333333334,19.10084699215847
Task_6885,2856,776,36,174,210,3.675675675675676,54.82080113721663
Task_6886,1100,281,164,109,273,3.900709219858156,25.6139622041924
Task_6887,1891,805,65,91,156,2.3461538461538463,39.12299861937989
Task_6888,1671,836,57,93,150,1.996415770609319,35.727932738820094
Task_6889,1862,469,137,32,169,3.9617021276595743,37.152888502997925
Task_6890,1917,1016,137,137,274,1.8849557522123894,40.9115801190946
Task_6891,2757,238,53,189,242,11.535564853556485,51.69572336699895
Task_6892,2506,176,76,25,101,14.158192090395481,45.533191928744294
Task_6893,2624,82,33,19,52,31.6144578313253,45.811103216692096
Task_6894,836,743,158,141,299,1.1236559139784945,22.976551493384147
Task_6895,2866,422,156,125,281,6.775413711583925,54.07550415691304
Task_6896,1393,923,65,47,112,1.5075757575757576,30.59899552412367
Task_6897,1508,128,183,27,210,11.689922480620154,30.315374138391093
Task_6898,1416,401,30,141,171,3.5223880597014925,30.537410232365716
Task_6899,2245,513,12,22,34,4.367704280155642,41.88068080167047
Task_6900,1455,302,44,138,182,4.801980198019802,30.906876906995084
Task_6901,774,677,86,132,218,1.1415929203539823,21.36350397036064
Task_6902,2616,114,116,188,304,22.747826086956522,48.77219252268005
Task_6903,1945,875,26,140,166,2.220319634703196,40.38921322975733
Task_6904,2792,76,21,52,73,36.25974025974026,48.874730257286664
Task_6905,1543,914,74,72,146,1.6863387978142077,33.77098778006117
Task_6906,574,972,164,105,269,0.5899280575539568,19.514758766716703
Task_6907,2642,688,115,24,139,3.834542815674891,49.89354445307364
Task_6908,2562,664,101,140,241,3.8526315789473684,49.885199994921834
Task_6909,762,801,147,104,251,0.9501246882793017,21.771428728391243
Task_6910,2658,1001,81,99,180,2.6526946107784433,52.151087733551854
Task_6911,2281,834,119,135,254,2.731736526946108,46.019495033351824
Task_6912,692,346,70,64,134,1.994236311239193,18.415578927648514
Task_6913,1373,481,36,80,116,2.8485477178423237,29.584670797406876
Task_6914,2013,447,25,77,102,4.493303571428571,39.30697755165607
Task_6915,2593,904,161,142,303,2.8651933701657457,51.4129666693554
Task_6916,2533,466,180,103,283,5.423982869379015,48.92656210093717
Task_6917,1045,311,168,96,264,3.3493589743589745,24.811141519615436
Task_6918,2116,664,89,90,179,3.181954887218045,42.3950694032626
Task_6919,2990,1018,34,12,46,2.9342492639842983,55.34395036031364
Task_6920,1078,497,142,109,251,2.1646586345381524,25.85745271906048
Task_6921,1179,535,19,117,136,2.199626865671642,26.851597648645065
Task_6922,2008,860,74,171,245,2.332171893147503,41.84798272080072
Task_6923,1627,167,167,148,315,9.68452380952381,33.57990222899684
Task_6924,2604,132,104,31,135,19.57894736842105,47.054052312349675
Task_6925,1546,315,27,72,99,4.8924050632911396,31.319074848084156
Task_6926,1714,683,145,151,296,2.5058479532163744,36.7772203831262
Task_6927,2174,182,185,43,228,11.879781420765028,41.39978525329721
Task_6928,788,629,28,44,72,1.2507936507936508,19.496034432053744
Task_6929,2265,657,175,34,209,3.4422492401215807,44.35055989097427
Task_6930,1052,315,76,54,130,3.329113924050633,23.85215644795859
Task_6931,1097,691,180,102,282,1.5852601156069364,26.851339014932947
Task_6932,713,218,101,40,141,3.2557077625570776,17.925058676790126
Task_6933,993,84,57,125,182,11.68235294117647,22.431009450658582
Task_6934,1320,648,154,171,325,2.0338983050847457,30.58710146912935
Task_6935,1429,653,55,114,169,2.185015290519878,31.563904413286494
Task_6936,2788,710,161,182,343,3.921237693389592,54.13186483867755
Task_6937,2019,1022,107,120,227,1.9736070381231672,42.30988731053217
Task_6938,575,410,15,176,191,1.3990267639902676,17.38484467878858
Task_6939,2892,795,75,166,241,3.6331658291457285,55.62916949643847
Task_6940,2988,666,101,113,214,4.47976011994003,56.47774794007703
Task_6941,2641,556,44,137,181,4.741472172351885,50.49626465609325
Task_6942,1972,847,104,129,233,2.3254716981132075,41.06083169564708
Task_6943,1850,112,150,71,221,16.371681415929203,35.80561041946702
Task_6944,1989,393,182,10,192,5.048223350253807,38.96021509155213
Task_6945,1013,539,88,13,101,1.875925925925926,23.207871364787334
Task_6946,891,69,17,165,182,12.728571428571428,20.75945511163577
Task_6947,889,620,15,121,136,1.431561996779388,22.479976302443404
Task_6948,2039,556,172,88,260,3.6606822262118492,41.21012679593645
Task_6949,861,365,160,68,228,2.3524590163934427,21.566237348179808
Task_6950,2836,730,102,64,166,3.8796169630642954,53.717441876267834
Task_6951,1575,130,116,33,149,12.022900763358779,30.91407879706659
Task_6952,1669,922,58,14,72,1.808234019501625,34.119652832421195
Task_6953,2224,375,100,47,147,5.914893617021277,42.4353806866063
Task_6954,2801,79,23,69,92,35.0125,49.378251301857034
Task_6955,2659,453,57,158,215,5.856828193832599,50.71906803114313
Task_6956,2098,112,172,123,295,18.56637168141593,40.47410581979275
Task_6957,1128,545,175,175,350,2.065934065934066,27.34271541631762
Task_6958,607,605,67,41,108,1.0016501650165017,17.15573163108174
Task_6959,2284,1006,39,104,143,2.2681231380337636,45.87735000219933
Task_6960,2923,688,152,60,212,4.242380261248186,55.107640077338054
Task_6961,2384,64,176,33,209,36.676923076923075,43.29618993023837
Task_6962,2912,644,134,200,334,4.514728682170543,55.872348316834724
Task_6963,1438,399,177,13,190,3.595,30.25352758455024
Task_6964,940,967,97,64,161,0.9710743801652892,24.321034591410932
Task_6965,864,803,85,41,126,1.0746268656716418,22.105309489578236
Task_6966,1362,384,49,92,141,3.5376623376623377,29.389872157962184
Task_6967,2245,233,181,138,319,9.594017094017094,43.78941318230731
Task_6968,2198,548,153,96,249,4.0036429872495445,43.7518882930212
Task_6969,2977,818,131,58,189,3.634920634920635,56.27499484092858
Task_6970,2637,209,199,99,298,12.557142857142857,49.72936873194942
Task_6971,833,244,114,61,175,3.4,20.41165412980679
Task_6972,1140,947,159,78,237,1.2025316455696202,27.974247118584838
Task_6973,1186,993,18,177,195,1.193158953722334,28.869831453148848
Task_6974,2329,927,102,200,302,2.509698275862069,47.38204191052373
Task_6975,836,846,136,106,242,0.987012987012987,23.038891041433203
Task_6976,1901,143,161,137,298,13.20138888888889,37.69634452133959
Task_6977,827,784,107,185,292,1.0535031847133758,23.01225311479256
Task_6978,889,215,123,145,268,4.1157407407407405,22.0907900782577
Task_6979,2308,336,97,193,290,6.8486646884272995,45.10637502941148
Task_6980,651,927,172,10,182,0.7015086206896551,19.63925261656135
Task_6981,2005,772,99,98,197,2.59379042690815,41.15093517606493
Task_6982,1129,244,15,107,122,4.608163265306122,25.008242713288045
Task_6983,2089,831,47,144,191,2.5108173076923075,42.73749045177636
Task_6984,1552,660,19,138,157,2.3479576399394855,33.291854077719606
Task_6985,860,963,94,149,243,0.8921161825726142,23.85073602246678
Task_6986,2969,439,58,179,237,6.747727272727273,55.712751907745435
Task_6987,2902,578,81,26,107,5.0120898100172715,53.346238675250554
Task_6988,2682,829,154,187,341,3.2313253012048193,52.82556527817635
Task_6989,524,678,18,134,152,0.7717231222385862,17.00293589363903
Task_6990,2438,893,139,87,226,2.727069351230425,48.433531535547196
Task_6991,2222,847,53,171,224,2.6202830188679247,45.11493295860174
Task_6992,2024,85,59,46,105,23.53488372093023,36.88320400584201
Task_6993,963,207,92,19,111,4.6298076923076925,21.502639778596773
Task_6994,635,653,174,117,291,0.9709480122324159,19.48701942813071
Task_6995,702,983,184,27,211,0.7134146341463414,20.818043721763036
Task_6996,2394,529,89,15,104,4.516981132075472,45.05791465198121
Task_6997,613,694,193,147,340,0.8820143884892087,19.53473870821857
Task_6998,2100,382,152,162,314,5.483028720626632,42.02492271383369
Task_6999,1183,366,16,126,142,3.223433242506812,26.416462496283145
Task_7000,2837,457,167,43,210,6.1943231441048034,52.78040982208461
Task_7001,1476,868,123,133,256,1.6985040276179517,33.36345198874235
Task_7002,876,651,197,178,375,1.343558282208589,23.75287619349776
Task_7003,587,276,13,160,173,2.11913357400722,17.060722588949886
Task_7004,2934,265,101,104,205,11.030075187969924,54.23102091516832
Task_7005,555,64,95,66,161,8.538461538461538,14.703072076269736
Task_7006,1171,506,52,58,110,2.309664694280079,25.99438973765311
Task_7007,708,78,168,121,289,8.962025316455696,18.401969258094542
Task_7008,2525,672,153,11,164,3.7518573551263,48.231138821169985
Task_7009,1831,803,35,144,179,2.277363184079602,38.46026701391602
Task_7010,875,616,17,48,65,1.4181523500810373,20.884338226414304
Task_7011,2714,967,148,55,203,2.803719008264463,52.64390722861504
Task_7012,763,992,37,91,128,0.7683786505538771,21.878047300778334
Task_7013,1669,319,171,91,262,5.215625,34.605140142922274
Task_7014,2417,924,77,192,269,2.612972972972973,48.67359643564108
Task_7015,1360,604,15,55,70,2.2479338842975207,28.714595502905954
Task_7016,2066,276,26,26,52,7.458483754512636,38.50145940034153
Task_7017,1800,950,141,174,315,1.8927444794952681,39.09156250224459
Task_7018,1647,296,155,61,216,5.545454545454546,33.655159487892284
Task_7019,1247,313,150,94,244,3.9713375796178343,27.88376162762584
Task_7020,2807,285,98,35,133,9.814685314685315,51.236518278631856
Task_7021,2830,153,153,40,193,18.376623376623378,51.23820031709784
Task_7022,1748,181,121,33,154,9.604395604395604,33.999779151509266
Task_7023,1094,697,30,164,194,1.5673352435530086,26.523554123807713
Task_7024,1376,543,57,24,81,2.5294117647058822,28.78272408580885
Task_7025,2382,689,141,99,240,3.4521739130434783,47.04251370343666
Task_7026,2890,849,192,177,369,3.4,56.29541375886879
Task_7027,870,74,186,186,372,11.6,21.431085610358068
Task_7028,2922,464,153,193,346,6.283870967741936,55.493367166869916
Task_7029,843,236,169,84,253,3.5569620253164556,21.202858462795408
Task_7030,2093,252,199,124,323,8.272727272727273,41.455013842157
Task_7031,2804,233,109,34,143,11.982905982905983,51.04808496016082
Task_7032,1382,433,159,67,226,3.184331797235023,30.017918831906858
Task_7033,1313,244,138,108,246,5.359183673469388,28.732821930310525
Task_7034,1522,919,192,100,292,1.6543478260869566,34.364561588952576
Task_7035,1021,767,143,177,320,1.3294270833333333,26.16059637815766
Task_7036,2684,958,99,47,146,2.7987486965589157,51.59581895283369
Task_7037,1719,417,36,53,89,4.1124401913875595,34.21970020406978
Task_7038,2210,162,88,48,136,13.558282208588958,41.05679951910188
Task_7039,903,621,98,95,193,1.4517684887459807,23.154028945723393
Task_7040,1643,183,102,15,117,8.929347826086957,32.1244967103898
Task_7041,717,953,52,142,194,0.7515723270440252,21.360867520214228
Task_7042,1394,934,45,136,181,1.490909090909091,31.900644242380157
Task_7043,2902,895,28,43,71,3.2388392857142856,53.82084291502869
Task_7044,1491,481,140,156,296,3.0933609958506225,32.61666396597875
Task_7045,2815,980,122,41,163,2.8695208970438326,53.865658249562124
Task_7046,2959,339,60,77,137,8.702941176470588,54.35283367690067
Task_7047,1879,332,81,32,113,5.642642642642643,36.473074932060875
Task_7048,1051,313,15,108,123,3.3471337579617835,24.026823813851475
Task_7049,1866,196,43,119,162,9.472081218274111,36.85832393113042
Task_7050,1716,125,178,10,188,13.619047619047619,33.370762353945835
Task_7051,1731,367,106,74,180,4.703804347826087,35.20522707167231
Task_7052,973,319,98,36,134,3.040625,22.33105913099547
Task_7053,850,460,174,162,336,1.8438177874186552,22.592794383923415
Task_7054,983,360,177,146,323,2.7229916897506925,24.29911130857666
Task_7055,1365,336,185,184,369,4.050445103857567,30.527008966735707
Task_7056,1587,530,89,97,186,2.9887005649717513,33.695142189427834
Task_7057,2087,154,192,12,204,13.464516129032258,39.53280596789279
Task_7058,1667,347,108,174,282,4.790229885057471,34.93297459780826
Task_7059,1760,249,96,31,127,7.04,34.514352090562795
Task_7060,1231,84,182,127,309,14.48235294117647,26.724299550652834
Task_7061,819,617,12,196,208,1.325242718446602,21.973337137527952
Task_7062,2365,69,186,76,262,33.785714285714285,43.79773181903787
Task_7063,2721,875,14,98,112,3.106164383561644,52.12511691560136
Task_7064,2664,656,91,194,285,4.054794520547945,51.75223086446311
Task_7065,1291,171,85,183,268,7.505813953488372,28.147866029774942
Task_7066,1177,793,199,108,307,1.4823677581863979,28.557147061295023
Task_7067,1532,940,121,43,164,1.6280552603613176,33.43433688555471
Task_7068,1389,974,76,133,209,1.4246153846153846,32.13271725746479
Task_7069,768,269,192,133,325,2.8444444444444446,20.596796054285292
Task_7070,1200,706,59,156,215,1.6973125884016973,28.405976254069788
Task_7071,2109,398,103,150,253,5.285714285714286,41.927479378793485
Task_7072,1011,980,118,72,190,1.0305810397553516,25.731004366234966
Task_7073,629,500,169,176,345,1.255489021956088,19.216045964340392
Task_7074,2943,1001,68,184,252,2.937125748502994,57.16699421697129
Task_7075,1899,783,33,184,217,2.4221938775510203,39.71933089648331
Task_7076,1953,923,121,187,308,2.1136363636363638,41.41955933062804
Task_7077,2457,75,151,100,251,32.328947368421055,45.57032296196291
Task_7078,624,972,32,140,172,0.6413155190133607,19.8759050729463
Task_7079,2576,466,138,115,253,5.516059957173447,49.489590378441186
Task_7080,1140,264,188,82,270,4.30188679245283,26.065615681763987
Task_7081,780,904,77,46,123,0.861878453038674,21.06982265740127
Task_7082,586,856,92,156,248,0.6837806301050176,19.347861770356136
Task_7083,1805,638,120,26,146,2.8247261345852896,36.62854384648811
Task_7084,1500,457,112,172,284,3.2751091703056767,32.65212654544035
Task_7085,2890,938,61,174,235,3.0777422790202342,56.03297987684281
Task_7086,1276,264,178,187,365,4.815094339622641,28.868121387962802
Task_7087,2140,317,106,35,141,6.729559748427673,40.82919600843734
Task_7088,1372,900,137,107,244,1.5227524972253053,31.693412097451144
Task_7089,2366,988,39,87,126,2.3923154701718907,47.12335110764807
Task_7090,542,752,199,50,249,0.7197875166002656,17.848375980607937
Task_7091,1797,75,181,148,329,23.644736842105264,35.65953664825395
Task_7092,2678,758,128,58,186,3.5283267457180503,51.31552801782027
Task_7093,1748,700,175,185,360,2.49358059914408,37.70732297053694
Task_7094,2206,410,120,199,319,5.367396593673966,43.871082869111206
Task_7095,882,662,43,53,96,1.330316742081448,21.776909371406465
Task_7096,2938,885,24,38,62,3.3160270880361176,54.333311646550065
Task_7097,998,191,194,56,250,5.197916666666667,23.26949588141672
Task_7098,2620,733,122,45,167,3.569482288828338,50.01062053030976
Task_7099,2818,438,127,192,319,6.419134396355353,53.638391216158766
Task_7100,2513,797,37,42,79,3.1491228070175437,47.51216328979225
Task_7101,2171,468,128,93,221,4.628997867803838,42.892385846589455
Task_7102,1722,69,172,162,334,24.6,34.52980914744135
Task_7103,2043,85,90,150,240,23.75581395348837,39.17620275997381
Task_7104,2129,274,80,188,268,7.741818181818182,42.001323346751036
Task_7105,1947,514,132,82,214,3.7805825242718445,39.39154325926213
Task_7106,1756,230,86,82,168,7.6017316017316015,35.144697900687476
Task_7107,2732,334,149,48,197,8.155223880597015,50.6802188627637
Task_7108,2056,134,166,10,176,15.22962962962963,38.707021053039036
Task_7109,2442,695,157,135,292,3.5086206896551726,48.304952962872925
Task_7110,684,862,148,19,167,0.7925840092699884,19.749829518552257
Task_7111,2113,931,194,180,374,2.267167381974249,44.26699419961094
Task_7112,538,634,37,197,234,0.8472440944881889,17.714190811909628
Task_7113,1950,746,110,62,172,2.610441767068273,39.67561695798572
Task_7114,965,67,169,114,283,14.191176470588236,22.39546961926003
Task_7115,617,866,112,170,282,0.7116493656286044,19.991768462468933
Task_7116,2818,668,135,56,191,4.212257100149476,53.298423118743216
Task_7117,1037,705,182,146,328,1.4688385269121813,26.20516965163156
Task_7118,725,880,47,132,179,0.8229284903518729,21.10912933446798
Task_7119,2445,427,146,68,214,5.712616822429907,46.76754240904899
Task_7120,844,874,148,152,300,0.9645714285714285,23.57398007036265
Task_7121,636,640,92,97,189,0.9921996879875195,18.989919222508757
Task_7122,2979,755,64,171,235,3.9404761904761907,56.867124862408254
Task_7123,1304,792,134,101,235,1.644388398486759,30.260617086602565
Task_7124,2537,719,105,147,252,3.5236111111111112,49.72279883120217
Task_7125,2565,453,187,58,245,5.649779735682819,48.84068860868615
Task_7126,2436,467,49,39,88,5.205128205128205,45.42753435956336
Task_7127,2355,862,179,91,270,2.7288528389339515,47.23217195979988
Task_7128,672,286,115,31,146,2.341463414634146,17.611248844529356
Task_7129,1599,153,138,182,320,10.383116883116884,33.168658424723965
Task_7130,572,701,74,127,201,0.8148148148148148,18.2841019505251
Task_7131,2675,249,89,91,180,10.7,49.85649220787844
Task_7132,2769,174,194,150,344,15.822857142857142,51.72872873188218
Task_7133,2068,555,73,117,190,3.7194244604316546,41.50914762209016
Task_7134,963,280,193,13,206,3.4270462633451957,22.430508080405314
Task_7135,1233,134,29,88,117,9.133333333333333,25.644084121872424
Task_7136,2035,150,195,104,299,13.47682119205298,39.82278584528138
Task_7137,566,1000,46,67,113,0.5654345654345654,18.347247573113787
Task_7138,590,950,194,166,360,0.6203995793901157,20.216979555891808
Task_7139,709,434,151,114,265,1.6298850574712644,19.875759430272627
Task_7140,773,152,60,165,225,5.052287581699346,19.74111231761444
Task_7141,2732,131,118,10,128,20.696969696969695,49.07929812341255
Task_7142,1583,632,172,171,343,2.500789889415482,34.78357984786602
Task_7143,2155,121,82,55,137,17.66393442622951,40.12747306182988
Task_7144,1300,152,52,165,217,8.49673202614379,28.00867681435719
Task_7145,738,402,96,194,290,1.8312655086848635,20.48526376079245
Task_7146,1659,403,136,45,181,4.106435643564357,33.799435153300436
Task_7147,2295,432,27,105,132,5.300230946882217,44.21333283220908
Task_7148,736,606,146,89,235,1.2125205930807248,20.578225964062337
Task_7149,1931,1022,118,153,271,1.8875855327468232,41.162003303235984
Task_7150,2680,378,171,55,226,7.071240105540897,50.32961497450811
Task_7151,2007,877,83,174,257,2.285876993166287,41.918707993303045
Task_7152,2280,912,16,53,69,2.497261774370208,44.26360723596795
Task_7153,2722,328,82,199,281,8.27355623100304,51.6291023872081
Task_7154,591,815,71,77,148,0.7242647058823529,18.611548047654725
Task_7155,771,614,117,170,287,1.2536585365853659,21.548982603335855
Task_7156,1796,283,109,63,172,6.323943661971831,35.782329248336914
Task_7157,700,106,111,38,149,6.542056074766355,16.906925854511268
Task_7158,1195,172,168,108,276,6.907514450867052,26.542494666455287
Task_7159,599,844,119,163,282,0.7088757396449704,19.633889855688984
Task_7160,2332,567,168,200,368,4.105633802816901,46.59481329305681
Task_7161,1607,969,51,60,111,1.6567010309278352,34.43061976778473
Task_7162,2483,405,84,178,262,6.115763546798029,47.960102094707
Task_7163,1757,257,18,98,116,6.810077519379845,34.910045309232444
Task_7164,2892,75,26,162,188,38.05263157894737,52.139693892834195
Task_7165,1552,429,36,184,220,3.609302325581395,33.12934532616694
Task_7166,501,353,127,106,233,1.4152542372881356,16.13416948644074
Task_7167,1299,889,122,133,255,1.4595505617977529,30.57916943165318
Task_7168,1571,342,65,199,264,4.580174927113703,33.4233513527356
Task_7169,1183,749,34,52,86,1.5773333333333333,26.701953032223756
Task_7170,1993,877,170,89,259,2.2699316628701594,41.50306383044679
Task_7171,1707,285,172,29,201,5.968531468531468,34.27520903810682
Task_7172,1924,661,123,153,276,2.906344410876133,39.94722785446661
Task_7173,2182,341,154,72,226,6.380116959064328,42.43633008449243
Task_7174,728,384,94,108,202,1.8909090909090909,19.750255532662038
Task_7175,658,894,37,199,236,0.735195530726257,20.47748051675611
Task_7176,2615,507,111,89,200,5.147637795275591,49.920572685309196
Task_7177,2759,261,10,95,105,10.530534351145038,50.58087937708257
Task_7178,836,647,35,152,187,1.2901234567901234,22.19150865407109
Task_7179,1727,502,36,46,82,3.433399602385686,34.34023672592439
Task_7180,1742,766,68,70,138,2.2711864406779663,36.3630784701363
Task_7181,2559,497,189,59,248,5.13855421686747,48.89345022900801
Task_7182,1516,282,174,10,184,5.3568904593639575,31.05585144850512
Task_7183,2036,975,72,77,149,2.0860655737704916,41.86235581350707
Task_7184,914,877,54,150,204,1.041002277904328,24.253871915960108
Task_7185,1130,86,134,89,223,12.988505747126437,24.623140672632374
Task_7186,1439,473,94,192,286,3.0358649789029535,31.7861024641421
Task_7187,1653,507,55,164,219,3.2539370078740157,34.99814434059487
Task_7188,2929,178,60,16,76,16.363128491620113,51.62494685084991
Task_7189,2884,859,49,20,69,3.353488372093023,53.24481072685387
Task_7190,2228,979,176,70,246,2.273469387755102,45.22285358972099
Task_7191,759,68,154,133,287,11.0,19.21380678925641
Task_7192,648,404,35,55,90,1.6,17.248129617330086
Task_7193,2676,999,179,164,343,2.676,53.23725414651981
Task_7194,1812,460,193,105,298,3.93058568329718,37.56510134852943
Task_7195,1885,432,174,124,298,4.353348729792148,38.65816744423696
Task_7196,928,650,167,172,339,1.4254992319508448,24.395352085103983
Task_7197,2445,840,22,144,166,2.9072532699167657,48.20406671285799
Task_7198,2085,969,18,123,141,2.149484536082474,42.596662986485015
Task_7199,743,839,177,14,191,0.8845238095238095,20.717219957602694
Task_7200,1181,735,186,110,296,1.6046195652173914,28.42294668498555
Task_7201,571,230,124,148,272,2.4718614718614718,17.140868105609368
Task_7202,1598,506,96,43,139,3.1518737672583828,32.8601003565938
Task_7203,2947,509,86,160,246,5.7784313725490195,55.497476918775824
Task_7204,2457,786,119,195,314,3.121982210927573,49.01595581917502
Task_7205,1827,72,175,140,315,25.027397260273972,36.06675329587609
Task_7206,2767,374,13,105,118,7.378666666666667,51.29230938447546
Task_7207,2645,1022,192,134,326,2.5855327468230693,52.69707045212465
Task_7208,1579,355,64,91,155,4.435393258426966,32.756640962778455
Task_7209,2142,324,34,196,230,6.590769230769231,42.17862254539053
Task_7210,1814,295,186,44,230,6.128378378378378,36.139803081287496
Task_7211,2846,412,159,141,300,6.891041162227603,53.83476251627119
Task_7212,1260,604,71,69,140,2.0826446280991737,28.218321273152522
Task_7213,1021,649,169,181,350,1.5707692307692307,25.939114785082364
Task_7214,921,117,49,11,60,7.805084745762712,19.545110558138763
Task_7215,1011,690,189,149,338,1.463096960926194,25.79616483114998
Task_7216,715,772,175,174,349,0.92496765847348,21.474832968548828
Task_7217,843,436,175,19,194,1.929061784897025,20.985998558025827
Task_7218,794,473,131,50,181,1.6751054852320675,20.433045328121707
Task_7219,2140,194,52,132,184,10.974358974358974,41.36593384096597
Task_7220,680,727,144,132,276,0.9340659340659341,20.394876687554767
Task_7221,901,887,35,18,53,1.0146396396396395,22.072354292290964
Task_7222,649,566,78,161,239,1.144620811287478,19.289662654289188
Task_7223,2937,551,169,160,329,5.320652173913044,55.88904213134422
Task_7224,2912,82,91,94,185,35.08433734939759,52.43029818663206
Task_7225,2865,329,200,142,342,8.681818181818182,54.04346191805198
Task_7226,1311,507,51,125,176,2.5807086614173227,29.335488930816297
Task_7227,1797,999,108,125,233,1.797,38.754769383090995
Task_7228,515,576,143,119,262,0.8925476603119584,17.227128938335916
Task_7229,581,92,147,80,227,6.247311827956989,15.898541170738822
Task_7230,908,989,144,99,243,0.9171717171717172,24.61017912661228
Task_7231,709,474,115,88,203,1.4926315789473685,19.599038419586602
Task_7232,1681,806,38,142,180,2.0830235439900866,36.08675521078447
Task_7233,861,271,143,38,181,3.1654411764705883,20.768215976443294
Task_7234,1397,387,169,159,328,3.600515463917526,30.977111532822917
Task_7235,1282,868,28,54,82,1.475258918296893,28.565317014605125
Task_7236,728,469,124,96,220,1.548936170212766,20.055876497302226
Task_7237,660,1000,74,164,238,0.6593406593406593,20.981133601200266
Task_7238,2863,729,181,197,378,3.921917808219178,55.55973109982612
Task_7239,988,94,146,170,316,10.4,23.01095430581781
Task_7240,1495,747,72,13,85,1.9986631016042782,31.382847348252728
Task_7241,2332,540,175,31,206,4.310536044362292,45.02899801515543
Task_7242,1349,180,130,186,316,7.45303867403315,29.277047969349024
Task_7243,1904,934,99,59,158,2.036363636363636,39.377726751048826
Task_7244,1958,493,47,49,96,3.9635627530364372,38.12004155621774
Task_7245,2336,426,118,105,223,5.470725995316159,45.41035046636353
Task_7246,2174,120,55,105,160,17.96694214876033,40.82824536992481
Task_7247,2951,286,159,160,319,10.282229965156795,55.17294255850038
Task_7248,2666,617,192,168,360,4.313915857605178,51.96050631867356
Task_7249,2598,204,70,148,218,12.673170731707318,48.88319336512282
Task_7250,1942,506,138,164,302,3.8303747534516766,39.87482574123016
Task_7251,2937,837,116,146,262,3.5047732696897373,56.47471025851515
Task_7252,2843,981,129,131,260,2.895112016293279,55.405068312143406
Task_7253,2392,422,68,106,174,5.6548463356974,46.11145717599303
Task_7254,1252,240,93,75,168,5.195020746887967,27.160973561875505
Task_7255,2969,1004,25,24,49,2.954228855721393,55.09788898530929
Task_7256,1749,934,95,88,183,1.8705882352941177,37.42541082870289
Task_7257,2438,148,48,141,189,16.36241610738255,45.727708525918
Task_7258,1307,743,52,39,91,1.756720430107527,28.430397674866356
Task_7259,2958,209,73,20,93,14.085714285714285,52.82067303573623
Task_7260,1659,454,59,15,74,3.646153846153846,32.49767483961225
Task_7261,1592,245,46,51,97,6.471544715447155,31.64822449137004
Task_7262,1407,592,108,58,166,2.372681281618887,30.61116825244788
Task_7263,789,799,75,45,120,0.98625,20.747893293664827
Task_7264,2540,417,69,155,224,6.076555023923445,48.75938439481063
Task_7265,2834,946,106,86,192,2.992608236536431,54.71238995011975
Task_7266,525,990,73,118,191,0.5297679112008072,18.544756323501634
Task_7267,1468,111,181,25,206,13.107142857142858,29.44273300149014
Task_7268,2292,82,155,130,285,27.6144578313253,43.23207773661949
Task_7269,1412,118,124,103,227,11.865546218487395,29.430584058030217
Task_7270,2488,474,143,65,208,5.237894736842105,47.584807163967874
Task_7271,2198,702,15,133,148,3.126600284495021,43.6058011062262
Task_7272,2638,736,108,63,171,3.5793758480325644,50.542503217428255
Task_7273,1851,496,167,168,335,3.7243460764587524,38.55682529671141
Task_7274,2907,382,186,95,281,7.590078328981723,54.55953625216245
Task_7275,765,657,165,48,213,1.162613981762918,20.65291909551617
Task_7276,2008,752,108,159,267,2.6666666666666665,41.53157058107691
Task_7277,1691,212,162,26,188,7.938967136150235,33.66732672432874
Task_7278,2428,313,27,86,113,7.732484076433121,45.73736299324073
Task_7279,704,177,21,86,107,3.955056179775281,17.473169847510928
Task_7280,550,433,20,123,143,1.2672811059907834,16.571964023598223
Task_7281,1153,915,154,163,317,1.2587336244541485,28.66243124466784
Task_7282,1941,209,172,186,358,9.242857142857142,39.1449875876747
Task_7283,551,85,170,33,203,6.406976744186046,14.775901771677917
Task_7284,1044,250,148,61,209,4.159362549800797,23.93871179347957
Task_7285,1626,915,178,123,301,1.775109170305677,36.07436610643012
Task_7286,1753,491,150,40,190,3.563008130081301,35.63411557630728
Task_7287,728,1012,56,172,228,0.7186574531095755,21.995801323318386
Task_7288,900,211,86,101,187,4.245283018867925,21.768110624631916
Task_7289,2133,938,134,81,215,2.2715654952076676,43.63983001481656
Task_7290,2974,92,128,179,307,31.978494623655912,54.18308896276985
Task_7291,2817,492,137,58,195,5.713995943204869,52.73168474285194
Task_7292,1521,660,192,109,301,2.301059001512859,33.60916226779177
Task_7293,1680,400,156,62,218,4.1895261845386536,34.53911613681959
Task_7294,521,884,54,192,246,0.5887005649717514,18.48478845997204
Task_7295,2288,463,150,86,236,4.931034482758621,44.735639640995714
Task_7296,2673,813,168,52,220,3.2837837837837838,51.629750433801235
Task_7297,1684,786,142,153,295,2.1397712833545106,36.62229530304659
Task_7298,1047,994,132,135,267,1.0522613065326634,26.96195200074325
Task_7299,1959,369,30,187,217,5.294594594594595,39.3539257213369
Task_7300,672,458,70,58,128,1.4640522875816993,18.43130786004171
Task_7301,1334,894,101,161,262,1.4905027932960895,31.232967626447376
Task_7302,2695,827,35,108,143,3.254830917874396,51.844732470113236
Task_7303,2192,602,119,25,144,3.6351575456053067,42.561317122036904
Task_7304,533,835,46,48,94,0.6375598086124402,16.967688955076827
Task_7305,2599,975,26,78,104,2.6629098360655736,50.3151382023824
Task_7306,2445,256,78,172,250,9.513618677042802,46.839764663779086
Task_7307,2670,271,85,152,237,9.816176470588236,50.30142532859943
Task_7308,875,558,164,115,279,1.5652951699463327,22.926620738137036
Task_7309,2750,885,102,47,149,3.1038374717832955,52.40775600251524
Task_7310,2990,493,184,47,231,6.052631578947368,55.438940904642386
Task_7311,1729,135,155,49,204,12.713235294117647,33.83866604938297
Task_7312,1723,280,16,76,92,6.131672597864768,34.01790949131023
Task_7313,1089,822,79,190,269,1.3232077764277035,27.249958695523635
Task_7314,2418,110,172,132,304,21.783783783783782,45.532845505960516
Task_7315,573,362,159,34,193,1.578512396694215,16.557124829398052
Task_7316,1524,437,197,16,213,3.4794520547945207,31.83355901586005
Task_7317,2785,134,138,165,303,20.62962962962963,51.59572274513104
Task_7318,1112,122,36,130,166,9.040650406504065,24.356240839376785
Task_7319,880,137,136,124,260,6.3768115942028984,21.359363144167613
Task_7320,1008,84,178,77,255,11.858823529411765,22.55604653555245
Task_7321,1445,516,101,150,251,2.7949709864603483,31.787701237641002
Task_7322,1623,357,76,105,181,4.533519553072626,33.74260170262125
Task_7323,607,187,44,200,244,3.228723404255319,17.534492866031467
Task_7324,2695,212,117,199,316,12.652582159624414,50.89081946372627
Task_7325,906,184,191,166,357,4.897297297297297,22.607592167560757
Task_7326,990,679,41,12,53,1.4558823529411764,22.678423467804368
Task_7327,1511,791,172,131,303,1.9078282828282829,33.90087146837441
Task_7328,1203,226,13,40,53,5.299559471365638,24.767897111026997
Task_7329,2816,907,65,67,132,3.101321585903084,53.83456412952117
Task_7330,1221,196,39,50,89,6.197969543147208,25.528772413675725
Task_7331,674,115,92,52,144,5.810344827586207,16.77424107163997
Task_7332,643,804,39,116,155,0.7987577639751553,19.308859383070086
Task_7333,2980,589,89,173,262,5.0508474576271185,56.38831286812435
Task_7334,2407,804,37,85,122,2.990062111801242,47.05968235307517
Task_7335,2085,414,13,35,48,5.024096385542169,39.255950782050675
Task_7336,1756,759,113,123,236,2.3105263157894735,37.36879585426846
Task_7337,617,872,18,81,99,0.7067583046964491,18.658091659155478
Task_7338,1697,934,125,45,170,1.8149732620320855,35.99831206583878
Task_7339,532,605,200,179,379,0.8778877887788779,18.198889901305638
Task_7340,2601,445,57,12,69,5.831838565022421,47.38233644335717
Task_7341,917,249,31,104,135,3.668,21.78615674076758
Task_7342,2600,905,79,27,106,2.869757174392936,49.58887855379435
Task_7343,1375,319,36,133,169,4.296875,29.623345134715407
Task_7344,2905,885,94,187,281,3.278781038374718,56.27431579948318
Task_7345,2578,418,61,59,120,6.152744630071599,48.05252556925358
Task_7346,2849,118,80,21,101,23.941176470588236,50.42585462439805
Task_7347,951,223,61,176,237,4.245535714285714,23.069689018263574
Task_7348,918,847,186,165,351,1.0825471698113207,24.877997883776498
Task_7349,735,610,37,99,136,1.2029459901800328,20.016105945581604
Task_7350,2783,187,131,70,201,14.803191489361701,51.260800927131235
Task_7351,1179,436,119,114,233,2.6979405034324944,27.189797286731785
Task_7352,2893,795,141,42,183,3.6344221105527637,54.60638651353731
Task_7353,1914,982,17,192,209,1.9471007121057986,40.50432113872421
Task_7354,2485,968,133,59,192,2.564499484004128,48.95626584647215
Task_7355,618,344,20,44,64,1.791304347826087,15.886288739556234
Task_7356,1490,861,168,135,303,1.728538283062645,33.77829382187584
Task_7357,1471,345,168,111,279,4.2514450867052025,31.720330483111223
Task_7358,2133,170,150,180,330,12.473684210526315,41.688276068789996
Task_7359,539,778,153,42,195,0.6919127086007703,17.600734781479357
Task_7360,761,218,37,159,196,3.4748858447488584,19.799560149014763
Task_7361,2616,368,10,48,58,7.0894308943089435,47.66684979722126
Task_7362,1303,96,53,33,86,13.43298969072165,25.5984663537984
Task_7363,790,528,178,168,346,1.4933837429111532,21.866820391918605
Task_7364,1517,867,148,77,225,1.7476958525345623,33.626676092348035
Task_7365,2483,80,153,161,314,30.65432098765432,46.38400285810699
Task_7366,1689,140,86,77,163,11.97872340425532,33.26513936736286
Task_7367,1465,380,16,168,184,3.8451443569553807,31.33302158808797
Task_7368,2196,421,131,95,226,5.203791469194313,43.190729417614854
Task_7369,1880,518,64,60,124,3.622350674373796,37.416279343220694
Task_7370,1456,770,44,85,129,1.888456549935149,32.04966879323521
Task_7371,2712,232,142,123,265,11.639484978540773,50.89667734386086
Task_7372,1581,204,159,136,295,7.712195121951219,33.08587186551445
Task_7373,1629,92,175,112,287,17.516129032258064,32.88700726933441
Task_7374,717,632,105,155,260,1.132701421800948,20.601637118833874
Task_7375,1158,535,105,148,253,2.16044776119403,27.30959144695748
Task_7376,953,528,76,73,149,1.8015122873345937,23.235944541904683
Task_7377,2171,418,175,178,353,5.181384248210024,43.46587438690735
Task_7378,1330,737,57,48,105,1.8021680216802167,28.892069447474217
Task_7379,2783,194,185,180,365,14.271794871794873,52.38839162720301
Task_7380,2036,573,27,33,60,3.5470383275261326,39.00891824941889
Task_7381,1829,465,188,121,309,3.924892703862661,37.923267387879676
Task_7382,511,342,94,179,273,1.489795918367347,16.570584377000902
Task_7383,747,924,108,181,289,0.8075675675675675,22.20418762520477
Task_7384,837,272,85,122,207,3.065934065934066,21.155129772308154
Task_7385,2900,512,19,136,155,5.653021442495127,54.155724290204574
Task_7386,1485,625,157,158,315,2.3722044728434506,33.0642701013142
Task_7387,2976,293,127,100,227,10.122448979591837,55.090951536401086
Task_7388,1208,566,198,64,262,2.130511463844797,27.83905837556757
Task_7389,991,97,138,104,242,10.112244897959183,22.650606976034894
Task_7390,618,167,89,44,133,3.6785714285714284,15.980764061124889
Task_7391,524,621,68,47,115,0.842443729903537,16.083350344883268
Task_7392,756,162,150,85,235,4.638036809815951,19.284370993885535
Task_7393,1742,621,40,141,181,2.8006430868167205,36.465175078050315
Task_7394,1807,666,136,92,228,2.709145427286357,37.7522101783053
Task_7395,1514,868,106,84,190,1.7422324510932106,33.520743115776185
Task_7396,2925,708,127,173,300,4.125528913963328,56.08870034823161
Task_7397,2851,678,86,43,129,4.198821796759941,53.227742277184824
Task_7398,2531,451,71,79,150,5.599557522123894,48.062007684935246
Task_7399,1680,372,39,155,194,4.50402144772118,34.80598534895334
Task_7400,2848,883,13,168,181,3.2217194570135748,54.817920709984385
Task_7401,579,727,73,121,194,0.7953296703296703,18.46013028038213
Task_7402,2355,715,118,87,205,3.2891061452513966,46.465996862638065
Task_7403,1298,607,77,84,161,2.1348684210526314,29.125201583215528
Task_7404,850,468,134,79,213,1.812366737739872,21.839648210634476
Task_7405,1133,327,195,184,379,3.4542682926829267,26.87362409999659
Task_7406,803,777,129,172,301,1.032133676092545,22.63186191857285
Task_7407,2048,200,82,41,123,10.189054726368159,38.73244095962213
Task_7408,1150,527,160,140,300,2.178030303030303,27.35791391765214
Task_7409,1071,330,35,45,80,3.2356495468277946,23.29488815813204
Task_7410,2872,169,168,179,347,16.894117647058824,53.413345821775856
Task_7411,1083,803,15,69,84,1.3470149253731343,25.41662726186698
Task_7412,2145,401,45,36,81,5.335820895522388,40.62895113602094
Task_7413,2163,688,22,35,57,3.13933236574746,41.44392760318572
Task_7414,1610,809,101,95,196,1.9876543209876543,35.003837680367205
Task_7415,850,253,136,22,158,3.3464566929133857,20.24903608959451
Task_7416,863,142,63,171,234,6.034965034965035,21.137487174818908
Task_7417,2360,468,93,188,281,5.031982942430703,46.34867907785724
Task_7418,1024,326,15,129,144,3.1314984709480123,23.797115012127836
Task_7419,1929,763,52,89,141,2.524869109947644,39.55009496521732
Task_7420,2933,1007,26,87,113,2.9097222222222223,55.95132585381196
Task_7421,786,602,169,116,285,1.3034825870646767,21.664355231572625
Task_7422,1263,797,130,197,327,1.5827067669172932,30.152673720379326
Task_7423,2453,557,20,67,87,4.396057347670251,46.35609665336571
Task_7424,663,702,159,99,258,0.9431009957325747,19.909885742405717
Task_7425,894,182,106,95,201,4.885245901639344,21.640146112171845
Task_7426,1807,773,43,24,67,2.334625322997416,36.01630543041487
Task_7427,1374,77,162,200,362,17.615384615384617,29.275416579192893
Task_7428,590,582,144,179,323,1.012006861063465,18.744617386030967
Task_7429,2224,985,97,185,282,2.255578093306288,45.79439085472574
Task_7430,2142,255,110,121,231,8.3671875,41.82098092048593
Task_7431,1615,334,169,44,213,4.82089552238806,33.04701890550594
Task_7432,586,547,191,115,306,1.0693430656934306,18.41349751353576
Task_7433,2392,141,111,152,263,16.845070422535212,45.27834856229638
Task_7434,638,515,79,66,145,1.2364341085271318,18.141047670159697
Task_7435,2890,959,47,36,83,3.0104166666666665,54.17256222717014
Task_7436,2858,622,78,134,212,4.587479935794542,54.367285469941116
Task_7437,2266,496,133,61,194,4.559356136820925,44.005672447661404
Task_7438,1090,983,21,153,174,1.1077235772357723,27.127710779351784
Task_7439,2748,163,29,174,203,16.75609756097561,50.73291245396601
Task_7440,2980,580,13,26,39,5.129087779690189,53.8309795132117
Task_7441,925,764,164,104,268,1.2091503267973855,24.276245348428777
Task_7442,2672,916,74,61,135,2.913849509269357,51.46090311385988
Task_7443,581,349,75,83,158,1.66,16.93518312021631
Task_7444,1251,930,115,119,234,1.3437164339419978,29.837474828407192
Task_7445,877,981,142,127,269,0.8930753564154786,24.258271394814084
Task_7446,2744,650,65,78,143,4.21505376344086,52.06435578604251
Task_7447,685,993,53,79,132,0.6891348088531187,20.70205394125087
Task_7448,1522,116,144,193,337,13.008547008547009,31.745272109527793
Task_7449,2642,604,24,92,116,4.36694214876033,50.046402174151716
Task_7450,771,788,160,63,223,0.9771863117870723,21.485953295435134
Task_7451,1624,256,180,147,327,6.319066147859922,34.11017883324566
Task_7452,1304,307,107,17,124,4.233766233766234,27.29656075595486
Task_7453,1654,175,77,34,111,9.397727272727273,32.104572725098215
Task_7454,2795,746,101,93,194,3.7416331994645247,53.536040174967155
Task_7455,2938,877,45,121,166,3.34624145785877,56.140329548024944
Task_7456,795,904,106,78,184,0.8784530386740331,22.140239227018455
Task_7457,1606,194,58,35,93,8.235897435897435,31.450764398798714
Task_7458,2194,454,24,86,110,4.821978021978022,42.42984430321838
Task_7459,1488,1021,101,158,259,1.455968688845401,34.03792273328231
Task_7460,2123,172,152,63,215,12.271676300578035,40.569658102342274
Task_7461,2176,642,25,89,114,3.384136858475894,42.790771284837
Task_7462,1210,982,57,154,211,1.2309257375381486,29.337548935006904
Task_7463,970,664,100,35,135,1.4586466165413534,23.36277774660145
Task_7464,1449,585,91,34,125,2.4726962457337884,30.630253019335104
Task_7465,2774,1008,135,57,192,2.7492566897918733,53.66847052770265
Task_7466,1456,828,156,84,240,1.7563329312424607,32.70779925341015
Task_7467,1885,589,69,89,158,3.194915254237288,38.37896500970156
Task_7468,2757,913,67,143,210,3.016411378555799,53.69655717041675
Task_7469,2733,960,170,90,260,2.8439125910509886,53.50454764025286
Task_7470,2879,802,29,172,201,3.585305105853051,55.21140583205235
Task_7471,2979,212,82,53,135,13.985915492957746,53.986023120783756
Task_7472,911,188,181,33,214,4.8201058201058204,21.508589730235112
Task_7473,2098,715,124,154,278,2.930167597765363,42.88352858645184
Task_7474,1897,317,31,113,144,5.965408805031447,37.56738819991275
Task_7475,1487,308,41,147,188,4.8122977346278315,31.49336541316021
Task_7476,2880,633,46,189,235,4.542586750788644,54.90189510432115
Task_7477,926,355,42,128,170,2.601123595505618,22.63399102982308
Task_7478,704,261,132,95,227,2.687022900763359,19.07553627371392
Task_7479,660,789,48,99,147,0.8354430379746836,19.491996242808383
Task_7480,2161,797,161,117,278,2.708020050125313,44.08432815290911
Task_7481,1256,98,53,193,246,12.686868686868687,27.024057834859263
Task_7482,928,619,155,113,268,1.4967741935483871,23.903518411155705
Task_7483,1896,400,108,155,263,4.728179551122195,38.61603804350522
Task_7484,2803,971,128,47,175,2.883744855967078,53.72930028155122
Task_7485,2158,488,195,46,241,4.413087934560327,42.28116361078691
Task_7486,1148,551,154,144,298,2.079710144927536,27.398396243513982
Task_7487,2499,68,149,72,221,36.21739130434783,45.67330145447772
Task_7488,593,381,191,192,383,1.5523560209424083,18.490780073722437
Task_7489,2020,1020,46,181,227,1.9784524975514202,42.44269110217677
Task_7490,1481,259,74,116,190,5.696153846153846,31.25540371853748
Task_7491,1356,294,32,75,107,4.596610169491526,28.497824508890464
Task_7492,2785,553,62,40,102,5.027075812274369,51.2705466799656
Task_7493,993,505,186,29,215,1.9624505928853755,23.751957881739248
Task_7494,2204,243,156,123,279,9.032786885245901,42.976359030182664
Task_7495,1057,520,33,16,49,2.0287907869481767,23.21261099732048
Task_7496,1426,122,17,22,39,11.59349593495935,27.443427440718548
Task_7497,2738,382,184,101,285,7.148825065274152,51.89901946998369
Task_7498,2142,596,183,194,377,3.5879396984924625,43.70999319967596
Task_7499,1244,224,176,66,242,5.528888888888889,27.21683349598192
Task_7500,1674,578,13,106,119,2.8911917098445596,34.656997315266814
Task_7501,897,451,121,125,246,1.9845132743362832,22.848576346826302
Task_7502,1303,910,118,69,187,1.4302963776070252,30.0316535765409
Task_7503,1755,204,135,178,313,8.560975609756097,35.97532550832964
Task_7504,2677,937,14,65,79,2.8539445628997866,50.84729645905446
Task_7505,1952,946,22,180,202,2.061246040126716,40.96895462812997
Task_7506,968,837,31,82,113,1.1551312649164678,24.26740492756763
Task_7507,2784,114,105,177,282,24.208695652173912,51.298857170054326
Task_7508,2358,377,99,51,150,6.238095238095238,44.751926630285084
Task_7509,2362,190,64,198,262,12.366492146596858,45.35516735756142
Task_7510,697,721,28,190,218,0.9653739612188366,20.38699840427728
Task_7511,672,316,100,70,170,2.1198738170347005,18.1196184147224
Task_7512,1225,148,53,28,81,8.221476510067115,25.022186898508668
Task_7513,1659,597,43,110,153,2.774247491638796,34.72717763148828
Task_7514,522,892,33,106,139,0.5845464725643897,17.74614879943205
Task_7515,1537,302,78,120,198,5.072607260726072,32.3371649318726
Task_7516,1533,799,23,69,92,1.91625,32.60374683100402
Task_7517,1905,980,171,134,305,1.9418960244648318,40.744936120254145
Task_7518,2740,342,25,132,157,7.988338192419825,51.06176901127523
Task_7519,1342,376,93,146,239,3.559681697612732,29.68975319536192
Task_7520,1908,715,18,90,108,2.664804469273743,38.65345948316662
Task_7521,2670,340,112,36,148,7.829912023460411,49.34947151447645
Task_7522,1571,227,36,62,98,6.890350877192983,31.33313860570995
Task_7523,2139,995,54,146,200,2.147590361445783,44.11408889987465
Task_7524,1286,330,50,186,236,3.8851963746223563,28.75966608096641
Task_7525,1941,196,176,106,282,9.852791878172589,38.65159853072651
Task_7526,2638,884,182,12,194,2.9807909604519773,50.80968887178927
Task_7527,556,716,18,76,94,0.7754532775453278,16.98022273913205
Task_7528,2225,331,146,79,225,6.701807228915663,43.206728458945804
Task_7529,2127,867,161,42,203,2.4504608294930876,42.80469929030928
Task_7530,2987,872,18,142,160,3.4215349369988544,56.70588007252325
Task_7531,791,584,24,98,122,1.3521367521367522,20.65892791700848
Task_7532,2506,166,48,170,218,15.005988023952096,47.0685350791392
Task_7533,1555,675,82,187,269,2.3002958579881656,34.20679328233518
Task_7534,1131,211,154,118,272,5.334905660377358,25.876533033418166
Task_7535,666,559,111,96,207,1.1892857142857143,19.27928627714172
Task_7536,2561,399,110,166,276,6.4025,49.2100615033166
Task_7537,637,471,53,164,217,1.3495762711864407,18.739642760623727
Task_7538,2839,230,118,68,186,12.29004329004329,52.15180186082398
Task_7539,502,156,152,127,279,3.1974522292993632,15.630421253425913
Task_7540,2594,694,17,182,199,3.7323741007194244,50.31744348345026
Task_7541,617,452,135,51,186,1.3620309050772628,17.715542272556544
Task_7542,2124,832,125,141,266,2.5498199279711886,43.58863330283733
Task_7543,891,737,118,13,131,1.2073170731707317,22.260928291144168
Task_7544,2014,305,114,178,292,6.5816993464052285,40.33091674525871
Task_7545,1533,314,49,89,138,4.866666666666666,31.855433311856512
Task_7546,686,1020,136,108,244,0.6718903036238981,21.3267635944057
Task_7547,1590,135,127,17,144,11.691176470588236,31.05405948634997
Task_7548,2493,877,200,195,395,2.8394077448747153,50.23640147536472
Task_7549,2324,626,119,37,156,3.7065390749601277,44.842743590537005
Task_7550,2748,204,169,89,258,13.404878048780487,51.22986832399141
Task_7551,2640,556,62,17,79,4.73967684021544,48.53256363249967
Task_7552,2273,959,36,38,74,2.3677083333333333,44.07752275273371
Task_7553,2261,254,121,175,296,8.866666666666667,44.06982916497187
Task_7554,1037,933,166,70,236,1.1102783725910064,26.132350436866716
Task_7555,2435,568,120,48,168,4.279437609841827,46.576497738204104
Task_7556,554,910,76,89,165,0.6081229418221734,18.58785800029445
Task_7557,1565,1002,117,51,168,1.5603190428713858,34.33364641333898
Task_7558,864,80,124,145,269,10.666666666666666,20.7905989526755
Task_7559,1320,683,14,64,78,1.9298245614035088,28.528637265705026
Task_7560,2068,573,142,22,164,3.602787456445993,40.69851085942668
Task_7561,2911,325,149,71,220,8.929447852760736,53.86086541066195
Task_7562,528,1014,27,119,146,0.5201970443349754,18.354224716377974
Task_7563,2981,366,20,80,100,8.122615803814714,54.36305230426163
Task_7564,687,1001,109,74,183,0.6856287425149701,20.830470766132517
Task_7565,1718,404,68,66,134,4.241975308641975,34.8411443681815
Task_7566,2528,86,95,172,267,29.057471264367816,46.9594510862423
Task_7567,2163,668,121,141,262,3.233183856502242,43.674122810111065
Task_7568,2170,815,117,179,296,2.659313725490196,44.45523067265484
Task_7569,1867,90,52,73,125,20.516483516483518,35.29988765630597
Task_7570,1278,811,109,96,205,1.5738916256157636,29.764200582048684
Task_7571,1004,938,90,71,161,1.0692225772097976,25.159762879995515
Task_7572,2358,474,112,154,266,4.96421052631579,46.18056001886881
Task_7573,2292,666,125,196,321,3.4362818590704647,46.05761323380324
Task_7574,1859,852,111,195,306,2.17936694021102,39.7117811167425
Task_7575,2543,722,85,198,283,3.5172890733056708,50.04780333132351
Task_7576,985,305,79,45,124,3.218954248366013,22.300702779123213
Task_7577,1072,594,182,161,343,1.8016806722689076,26.557184912609284
Task_7578,2934,238,186,54,240,12.276150627615063,53.917171416521
Task_7579,1122,619,190,50,240,1.8096774193548386,26.37082713051979
Task_7580,2378,543,73,133,206,4.3713235294117645,46.47809042284336
Task_7581,2456,887,115,14,129,2.765765765765766,47.529828426909766
Task_7582,894,1015,195,58,253,0.8799212598425197,24.239158443033862
Task_7583,814,478,138,130,268,1.6993736951983298,21.712551100893972
Task_7584,693,669,48,20,68,1.0343283582089553,18.05359164848284
Task_7585,955,252,162,84,246,3.774703557312253,22.993718184148175
Task_7586,911,221,35,192,227,4.103603603603603,22.356726941426484
Task_7587,1564,99,147,181,328,15.64,32.18260890812489
Task_7588,1023,136,54,133,187,7.467153284671533,23.26661263196841
Task_7589,2956,117,44,190,234,25.050847457627118,53.837672971478064
Task_7590,1853,320,23,147,170,5.7725856697819315,37.18348515902242
Task_7591,1643,1000,132,161,293,1.6413586413586414,36.627198529616265
Task_7592,1462,570,195,24,219,2.5604203152364273,31.34206339148596
Task_7593,2457,111,19,195,214,21.9375,45.77827302983828
Task_7594,835,647,100,15,115,1.2885802469135803,20.80265567447281
Task_7595,1187,791,187,75,262,1.4987373737373737,28.29558114443871
Task_7596,2480,938,113,181,294,2.6411075612353567,49.745172709577105
Task_7597,1397,870,109,150,259,1.6039035591274398,32.15637476102153
Task_7598,1841,597,65,162,227,3.0785953177257523,38.29317739644774
Task_7599,2835,296,86,60,146,9.545454545454545,52.059018489626816
Task_7600,1224,648,96,137,233,1.8859784283513097,28.609807275851256
Task_7601,1193,856,172,21,193,1.3920653442240374,27.841885643273937
Task_7602,1649,471,160,71,231,3.4936440677966103,34.42622211708306
Task_7603,1766,102,38,147,185,17.145631067961165,34.64594282953403
Task_7604,2068,854,104,154,258,2.4187134502923975,42.75304195010807
Task_7605,914,517,200,70,270,1.7644787644787645,23.06577315936276
Task_7606,2530,761,122,17,139,3.320209973753281,48.31702427444409
Task_7607,1184,623,33,42,75,1.8974358974358974,25.78496669733934
Task_7608,1020,660,128,46,174,1.5431164901664145,24.487176866216334
Task_7609,1261,333,143,126,269,3.7754491017964074,28.336655256535803
Task_7610,2448,948,33,122,155,2.5795574288724974,48.38022134206281
Task_7611,508,198,135,173,308,2.5527638190954773,16.2810234182948
Task_7612,2835,521,96,137,233,5.431034482758621,53.71833806407576
Task_7613,2225,278,77,197,274,7.974910394265233,43.586657640731204
Task_7614,2234,585,56,82,138,3.8122866894197953,43.812631228625285
Task_7615,2319,765,183,66,249,3.0274151436031334,46.00405727567952
Task_7616,921,576,100,134,234,1.5961871750433276,23.565508166109282
Task_7617,1150,1017,92,157,249,1.1296660117878192,28.59686221552829
Task_7618,2960,500,15,11,26,5.908183632734531,53.074362714326135
Task_7619,2849,701,22,52,74,4.0584045584045585,52.60023352362004
Task_7620,1414,593,117,123,240,2.3804713804713806,31.450132790600147
Task_7621,1539,107,188,127,315,14.25,31.73190121039336
Task_7622,2964,744,43,75,118,3.978523489932886,55.55911055081972
Task_7623,2043,303,109,41,150,6.720394736842105,39.29263698638831
Task_7624,1487,819,75,80,155,1.8134146341463415,32.72536553380514
Task_7625,1806,917,88,114,202,1.9673202614379084,38.44561531821728
Task_7626,2772,236,37,149,186,11.69620253164557,51.53606309541164
Task_7627,2983,387,183,60,243,7.688144329896907,55.21916798198712
Task_7628,744,392,27,192,219,1.8931297709923665,20.208105987392972
Task_7629,1878,979,39,136,175,1.916326530612245,39.715065183463636
Task_7630,2396,518,185,179,364,4.616570327552987,47.40247787646484
Task_7631,1693,977,42,99,141,1.731083844580777,36.39547019957903
Task_7632,832,548,104,68,172,1.5154826958105647,21.378133889499892
Task_7633,1801,613,69,51,120,2.933224755700326,36.40565019480855
Task_7634,1693,140,39,142,181,12.00709219858156,33.7636966251661
Task_7635,2154,72,154,71,225,29.506849315068493,40.31388333766395
Task_7636,2066,985,22,195,217,2.0953346855983774,42.98631034135112
Task_7637,2752,75,39,80,119,36.21052631578947,49.08583259807916
Task_7638,803,306,45,110,155,2.6156351791530943,20.305971863837854
Task_7639,2495,85,121,48,169,29.011627906976745,45.02769539820812
Task_7640,2217,942,173,23,196,2.3510074231177094,44.36634978674106
Task_7641,2151,249,20,125,145,8.604,41.36503094584134
Task_7642,1355,269,195,51,246,5.018518518518518,29.083797757696672
Task_7643,2212,183,12,126,138,12.021739130434783,41.86607004606391
Task_7644,1265,613,185,106,291,2.060260586319218,29.358070089953205
Task_7645,727,409,25,77,102,1.773170731707317,18.817671427876473
Task_7646,2922,264,19,97,116,11.026415094339622,53.36107568239448
Task_7647,1418,185,50,119,169,7.623655913978495,29.79372930589778
Task_7648,2241,600,173,138,311,3.7287853577371046,44.91093512115507
Task_7649,758,482,28,153,181,1.5693581780538302,20.410350949030754
Task_7650,2969,776,122,140,262,3.821106821106821,56.78094160974458
Task_7651,1901,213,28,62,90,8.883177570093459,36.40508805100141
Task_7652,2013,1007,132,67,199,1.9970238095238095,41.689629782082584
Task_7653,855,643,69,47,116,1.3276397515527951,21.286028957091574
Task_7654,2238,1023,130,140,270,2.185546875,46.00669481641666
Task_7655,1048,155,168,79,247,6.717948717948718,23.841373699113262
Task_7656,2076,69,112,191,303,29.65714285714286,39.96840004133653
Task_7657,1467,810,117,39,156,1.8088779284833538,31.83354636450326
Task_7658,1299,960,16,38,54,1.3517169614984392,28.628813486536643
Task_7659,915,393,186,63,249,2.3223350253807107,22.590567246519687
Task_7660,738,390,193,102,295,1.8874680306905371,20.327452648055566
Task_7661,1508,418,106,91,197,3.5990453460620526,32.08819471259629
Task_7662,2755,205,184,84,268,13.37378640776699,51.35018508767025
Task_7663,952,586,122,136,258,1.6218057921635434,24.19870648523086
Task_7664,1775,718,88,200,288,2.4687065368567453,37.847639025485506
Task_7665,2777,417,171,130,301,6.643540669856459,52.74788736394296
Task_7666,2311,781,82,69,151,2.955242966751918,45.396177896702305
Task_7667,1712,859,198,32,230,1.9906976744186047,36.32130278237937
Task_7668,901,202,10,101,111,4.438423645320197,21.150435375469858
Task_7669,2570,179,116,118,234,14.277777777777779,48.05738553462647
Task_7670,670,747,161,22,183,0.8957219251336899,19.27254639648302
Task_7671,543,299,187,167,354,1.81,17.31676764457305
Task_7672,2661,565,181,40,221,4.701413427561837,50.389906770793516
Task_7673,1151,231,182,117,299,4.961206896551724,26.381405772574272
Task_7674,2017,810,185,66,251,2.4870530209617754,41.36941644124291
Task_7675,1567,220,53,191,244,7.090497737556561,32.84559808165519
Task_7676,1593,911,99,153,252,1.7467105263157894,35.363860063620216
Task_7677,2008,392,86,122,208,5.10941475826972,40.02606871009181
Task_7678,1004,494,30,63,93,2.0282828282828285,23.260633339968525
Task_7679,966,577,105,175,280,1.671280276816609,24.54865295145454
Task_7680,2754,744,102,147,249,3.6966442953020135,53.22566072530543
Task_7681,1490,142,57,106,163,10.41958041958042,30.408628436070114
Task_7682,1522,426,191,116,307,3.5644028103044496,32.92278651603977
Task_7683,2391,956,98,179,277,2.498432601880878,48.31567864366401
Task_7684,2950,442,200,187,387,6.659142212189616,56.039951118144224
Task_7685,842,491,95,122,217,1.7113821138211383,21.965211900233687
Task_7686,1678,1023,26,148,174,1.638671875,36.6612607140434
Task_7687,975,256,79,103,182,3.7937743190661477,23.159200898945596
Task_7688,2788,962,61,11,72,2.8951194184839046,51.99384986730421
Task_7689,2197,903,127,192,319,2.4303097345132745,45.280488447420275
Task_7690,744,645,56,16,72,1.151702786377709,18.698335748748267
Task_7691,799,976,149,34,183,0.8178096212896623,22.025770168623783
Task_7692,878,538,98,16,114,1.6289424860853432,21.180995526947992
Task_7693,1479,838,52,120,172,1.762812872467223,32.96011279505987
Task_7694,2518,302,200,93,293,8.310231023102311,48.15279529112454
Task_7695,1806,552,185,84,269,3.2658227848101267,37.527242079370104
Task_7696,2791,152,155,58,213,18.241830065359476,50.98547479312948
Task_7697,2402,113,84,179,263,21.07017543859649,45.21802664168542
Task_7698,836,916,160,184,344,0.9116684841875682,23.833595234279894
Task_7699,940,395,175,37,212,2.3737373737373737,22.572429801650724
Task_7700,1111,310,25,81,106,3.572347266881029,24.70730150860588
Task_7701,1915,953,110,163,273,2.007337526205451,40.717781716199376
Task_7702,1709,87,71,14,85,19.420454545454547,31.874607733172365
Task_7703,1083,221,147,167,314,4.878378378378378,25.414187945881423
Task_7704,1712,697,138,41,179,2.4527220630372493,35.57829762900681
Task_7705,1304,98,100,73,173,13.171717171717171,26.72791394640679
Task_7706,2800,933,168,104,272,2.9978586723768736,54.58823613831436
Task_7707,2559,976,89,126,215,2.6192425793244625,50.65783364846347
Task_7708,2557,607,88,20,108,4.2055921052631575,47.94977371902383
Task_7709,842,752,56,90,146,1.1181938911022575,22.280450183356205
Task_7710,2200,686,83,80,163,3.2023289665211063,43.71914274674365
Task_7711,699,242,164,117,281,2.876543209876543,19.19695737189714
Task_7712,2649,807,179,49,228,3.2784653465346536,51.101054249994036
Task_7713,2137,855,28,60,88,2.496495327102804,42.147415991144456
Task_7714,2283,840,138,26,164,2.714625445897741,44.98303109296395
Task_7715,1840,718,17,166,183,2.5591098748261474,38.31946830790872
Task_7716,2488,100,165,172,337,24.633663366336634,46.72865518761146
Task_7717,1113,938,12,65,77,1.1853035143769968,25.98772585110797
Task_7718,525,633,59,106,165,0.8280757097791798,17.110772081571238
Task_7719,1202,373,198,183,381,3.213903743315508,28.120957995428594
Task_7720,1104,621,161,186,347,1.77491961414791,27.1895011953435
Task_7721,764,136,129,20,149,5.576642335766423,18.110216554063086
Task_7722,586,364,164,25,189,1.6054794520547946,16.71394520211903
Task_7723,2491,821,90,191,281,3.0304136253041363,49.504118531226545
Task_7724,1036,543,106,20,126,1.9044117647058822,23.917495562870723
Task_7725,1598,852,127,112,239,1.873388042203986,35.15277200485483
Task_7726,590,601,119,174,293,0.9800664451827242,18.71001747634781
Task_7727,2719,269,26,177,203,10.07037037037037,50.93158241296924
Task_7728,1343,681,41,119,160,1.969208211143695,30.06131805784808
Task_7729,1423,646,28,90,118,2.1993817619783615,30.89227903202296
Task_7730,1834,460,175,94,269,3.9783080260303687,37.759864603631804
Task_7731,2074,735,24,171,195,2.817934782608696,42.204385682117014
Task_7732,2502,653,113,60,173,3.8256880733944953,48.12447321454865
Task_7733,2410,272,128,67,195,8.827838827838828,45.599163927975326
Task_7734,2392,750,81,144,225,3.18508655126498,47.45057910663845
Task_7735,2331,1022,10,84,94,2.278592375366569,46.07264017183551
Task_7736,786,289,181,110,291,2.7103448275862068,20.758990030918024
Task_7737,2064,995,114,102,216,2.072289156626506,42.86315774862775
Task_7738,1360,669,85,41,126,2.029850746268657,29.51545659946426
Task_7739,1104,729,123,193,316,1.5123287671232877,27.36703019447431
Task_7740,978,592,25,94,119,1.6492411467116357,23.680398088482182
Task_7741,1019,926,191,124,315,1.099244875943905,26.504333694739902
Task_7742,675,543,11,39,50,1.2408088235294117,17.388410250238184
Task_7743,2998,630,44,166,210,4.751188589540412,56.59770902511826
Task_7744,2493,374,51,199,250,6.648,48.08000780819071
Task_7745,1847,600,70,149,219,3.0732113144758735,38.34524310631634
Task_7746,2777,972,67,76,143,2.854059609455293,53.55570407035446
Task_7747,2398,458,57,54,111,5.224400871459695,45.213756603592294
Task_7748,2802,266,50,122,172,10.49438202247191,52.092425224132775
Task_7749,1735,681,133,14,147,2.5439882697947214,35.55997044693913
Task_7750,1039,708,61,108,169,1.465444287729196,25.49711482796614
Task_7751,1472,194,38,42,80,7.5487179487179485,29.326106346934115
Task_7752,697,892,66,69,135,0.780515117581187,20.255063028046685
Task_7753,755,891,198,134,332,0.8464125560538116,22.337842549923
Task_7754,1232,583,196,88,284,2.1095890410958904,28.624497129531573
Task_7755,662,662,111,127,238,0.9984917043740573,19.70497924473808
Task_7756,812,637,103,126,229,1.2727272727272727,21.94717496115385
Task_7757,1078,152,70,60,130,7.045751633986928,23.449560299571733
Task_7758,970,458,16,130,146,2.113289760348584,23.379362978199822
Task_7759,2694,948,92,161,253,2.838777660695469,52.96100022768874
Task_7760,1921,706,114,184,298,2.717114568599717,40.185611702940534
Task_7761,1338,656,69,81,150,2.036529680365297,29.849821722892056
Task_7762,2863,382,83,51,134,7.4751958224543085,52.704869878962505
Task_7763,2369,968,190,172,362,2.4447884416924666,48.37304639237465
Task_7764,2934,235,54,161,215,12.432203389830509,54.31533124734957
Task_7765,1525,714,128,157,285,2.132867132867133,33.83958493034071
Task_7766,842,218,79,86,165,3.8447488584474887,20.82170195357986
Task_7767,731,911,22,112,134,0.8015350877192983,20.90967057877428
Task_7768,1635,496,33,92,125,3.289738430583501,33.92722092687111
Task_7769,2583,978,122,35,157,2.638406537282942,50.04718028521844
Task_7770,2931,848,76,90,166,3.452296819787986,55.943836656476265
Task_7771,838,350,109,33,142,2.3874643874643873,20.34507219838183
Task_7772,2553,935,53,41,94,2.7275641025641026,48.78497131688692
Task_7773,1126,239,64,86,150,4.691666666666666,25.16837323040684
Task_7774,2331,898,87,191,278,2.592880978865406,47.16217685872781
Task_7775,1190,1010,186,167,353,1.1770524233432245,29.71239427202887
Task_7776,1512,185,175,159,334,8.129032258064516,32.06790514062952
Task_7777,915,797,63,16,79,1.1466165413533835,22.052982546588552
Task_7778,2672,265,71,11,82,10.045112781954888,48.4296407905725
Task_7779,1619,96,170,151,321,16.690721649484537,32.92523578623722
Task_7780,753,877,193,37,230,0.857630979498861,21.23713126149681
Task_7781,1523,427,119,77,196,3.558411214953271,32.21817898494917
Task_7782,1785,440,102,162,264,4.0476190476190474,37.00377113683583
Task_7783,2645,676,132,10,142,3.9069423929098965,49.89646113125153
Task_7784,2219,1006,185,27,212,2.2035749751737836,44.6981588779992
Task_7785,838,942,22,34,56,0.8886532343584306,21.40228334849027
Task_7786,2307,287,180,33,213,8.010416666666666,43.823524541640666
Task_7787,601,572,71,115,186,1.0488656195462478,18.182018253638443
Task_7788,2820,804,138,121,259,3.5031055900621118,54.46713419013497
Task_7789,1822,221,13,155,168,8.207207207207206,36.340251505610944
Task_7790,1032,749,192,160,352,1.376,26.391290710134076
Task_7791,2067,293,120,65,185,7.030612244897959,40.18798259540902
Task_7792,1806,527,110,57,167,3.4204545454545454,36.70320737953154
Task_7793,2679,914,137,197,334,2.9278688524590164,53.0272761088458
Task_7794,2766,821,74,96,170,3.3649635036496353,53.2859637070394
Task_7795,2380,915,74,73,147,2.5982532751091703,47.04540949216254
Task_7796,1593,1017,177,58,235,1.5648330058939097,35.16005489769644
Task_7797,853,547,169,88,257,1.5565693430656935,22.35015919992559
Task_7798,636,470,79,125,204,1.3503184713375795,18.592900693994828
Task_7799,1765,333,68,40,108,5.2844311377245505,34.57940213701986
Task_7800,2128,867,24,44,68,2.4516129032258065,41.43442633734835
Task_7801,2490,253,200,84,284,9.803149606299213,47.422502405169745
Task_7802,1096,782,128,51,179,1.3997445721583652,26.293833363945637
Task_7803,1384,854,185,135,320,1.6187134502923977,32.153661200950005
Task_7804,2634,121,119,150,269,21.59016393442623,48.94882434960213
Task_7805,2819,852,83,191,274,3.3048065650644785,54.80789107877436
Task_7806,582,654,80,77,157,0.8885496183206106,17.79286127270694
Task_7807,2813,991,193,14,207,2.8356854838709675,53.964624256375345
Task_7808,862,629,77,71,148,1.3682539682539683,22.057803450646556
Task_7809,1557,604,34,120,154,2.5735537190082645,33.149227905401766
Task_7810,2059,394,148,187,335,5.2126582278481015,41.547006977973304
Task_7811,755,877,165,80,245,0.8599088838268792,21.737875572854453
Task_7812,1179,229,183,117,300,5.126086956521739,26.821323632857332
Task_7813,1305,239,166,195,361,5.4375,29.235155367034253
Task_7814,913,279,196,50,246,3.2607142857142857,22.014056817904887
Task_7815,2503,1006,75,98,173,2.4856007944389273,49.69555018470992
Task_7816,1573,346,75,120,195,4.53314121037464,33.036377105236305
Task_7817,548,997,111,36,147,0.5490981963927856,18.143360437202244
Task_7818,926,757,111,179,290,1.2216358839050132,24.47471775902686
Task_7819,1472,403,97,193,290,3.6435643564356437,32.10161431826189
Task_7820,960,664,111,190,301,1.443609022556391,24.80084937535783
Task_7821,1690,976,53,124,177,1.7297850562947799,36.76674098610542
Task_7822,2302,390,109,46,155,5.887468030690537,43.71538841064631
Task_7823,782,410,66,200,266,1.9026763990267639,21.177053817048566
Task_7824,1856,137,158,128,286,13.44927536231884,36.85312340745039
Task_7825,790,287,63,26,89,2.7430555555555554,18.746481361347534
Task_7826,2457,700,90,50,140,3.5049928673323825,47.19779776446732
Task_7827,1745,924,183,17,200,1.8864864864864865,36.80979786733962
Task_7828,2288,428,111,182,293,5.333333333333333,45.0856203023989
Task_7829,1906,94,196,62,258,20.063157894736843,36.54022824248616
Task_7830,1568,702,134,102,236,2.2304409672830725,34.18177199596169
Task_7831,710,484,198,165,363,1.4639175257731958,20.524049206359418
Task_7832,2030,135,85,106,191,14.926470588235293,39.1286241668322
Task_7833,2676,766,45,81,126,3.4889178617992176,51.307812243120935
Task_7834,1075,609,17,43,60,1.7622950819672132,23.96147331884742
Task_7835,1649,371,49,182,231,4.432795698924731,34.604809627869066
Task_7836,1997,905,89,86,175,2.204194260485651,41.190118230011464
Task_7837,1612,614,113,59,172,2.621138211382114,33.90024452028871
Task_7838,2138,400,124,155,279,5.331670822942644,42.517440303203195
Task_7839,2911,536,96,163,259,5.420856610800745,55.1254976015392
Task_7840,1926,604,189,56,245,3.183471074380165,39.211581868838245
Task_7841,1189,557,66,74,140,2.130824372759857,27.067081046864626
Task_7842,2236,342,59,82,141,6.518950437317784,43.07506043474694
Task_7843,522,736,137,108,245,0.7082767978290366,17.832933123670724
Task_7844,2672,190,83,11,94,13.989528795811518,48.332782766211274
Task_7845,2216,131,150,144,294,16.78787878787879,42.54641765583313
Task_7846,1937,956,52,130,182,2.0240334378265414,40.65146456960624
Task_7847,1521,171,137,41,178,8.843023255813954,30.592163124905536
Task_7848,708,354,142,116,258,1.9943661971830986,19.59293192304734
Task_7849,1071,649,90,67,157,1.6476923076923078,25.315456244157968
Task_7850,2483,862,105,105,210,2.877172653534183,49.06530945757527
Task_7851,2110,385,191,149,340,5.466321243523316,42.2911668421011
Task_7852,1214,419,14,48,62,2.8904761904761904,25.67628367969583
Task_7853,2793,566,98,110,208,4.925925925925926,53.04273966207338
Task_7854,1239,641,102,41,143,1.9299065420560748,27.620870009178855
Task_7855,1672,83,36,86,122,19.904761904761905,32.22307619840381
Task_7856,2290,915,58,135,193,2.5,46.20990395253358
Task_7857,1613,600,40,60,100,2.6838602329450914,33.155304421862866
Task_7858,687,647,186,86,272,1.0601851851851851,20.076849029874882
Task_7859,2460,176,14,21,35,13.898305084745763,44.111349663995696
Task_7860,1714,636,26,163,189,2.6907378335949765,36.1476628622245
Task_7861,1886,625,136,166,302,3.012779552715655,39.368291543477405
Task_7862,2939,200,156,159,315,14.621890547263682,54.63028180292952
Task_7863,934,1024,69,43,112,0.911219512195122,23.800813337628185
Task_7864,1290,469,86,174,260,2.74468085106383,29.22123245486216
Task_7865,1071,923,85,184,269,1.1590909090909092,27.183937971955388
Task_7866,504,524,36,33,69,0.96,14.790207692175258
Task_7867,592,834,144,79,223,0.7089820359281437,19.036856079109914
Task_7868,2643,849,137,124,261,3.1094117647058823,51.81742836138246
Task_7869,2659,76,120,74,194,34.532467532467535,48.09769923681824
Task_7870,2782,425,46,54,100,6.530516431924883,51.104333730559205
Task_7871,2299,187,76,151,227,12.22872340425532,44.17744832889619
Task_7872,2083,816,174,15,189,2.5495716034271725,41.768426568045726
Task_7873,718,503,170,192,362,1.4246031746031746,20.74507580002565
Task_7874,1487,174,142,154,296,8.497142857142856,31.297519182681864
Task_7875,1897,875,181,102,283,2.165525114155251,40.145528271583366
Task_7876,856,262,139,33,172,3.2547528517110265,20.60117690446553
Task_7877,1467,884,174,131,305,1.6576271186440679,33.48845203202342
Task_7878,2019,264,36,79,115,7.618867924528302,39.08778807184312
Task_7879,1149,220,62,46,108,5.199095022624435,24.36713287906771
Task_7880,893,188,126,49,175,4.724867724867725,21.157891809973496
Task_7881,1026,526,14,54,68,1.9468690702087286,23.17086090434491
Task_7882,1424,718,128,122,250,1.9805285118219749,32.043091384342624
Task_7883,1797,923,124,160,284,1.9448051948051948,38.799876163668166
Task_7884,2419,301,45,90,135,8.009933774834437,45.75425887262812
Task_7885,2274,944,75,14,89,2.4063492063492062,44.352791353460496
Task_7886,2525,130,42,176,218,19.27480916030534,47.07631053107716
Task_7887,1237,652,47,105,152,1.894333843797856,28.2263058304106
Task_7888,970,698,80,48,128,1.3876967095851216,23.62416857741376
Task_7889,2460,509,109,80,189,4.823529411764706,47.34849220377725
Task_7890,2342,522,119,160,279,4.478011472275335,46.14941871454017
Task_7891,2169,754,81,70,151,2.8728476821192053,43.06339070315418
Task_7892,2747,102,20,76,96,26.66990291262136,48.83123199680225
Task_7893,1965,686,70,85,155,2.8602620087336246,39.91072791481182
Task_7894,1841,561,69,66,135,3.275800711743772,37.281669832688436
Task_7895,2164,841,86,171,257,2.5700712589073635,44.2141869374417
Task_7896,814,575,100,163,263,1.4131944444444444,22.000764083223007
Task_7897,921,733,174,197,371,1.2547683923705721,24.712530412825718
Task_7898,2715,818,191,124,315,3.3150183150183152,53.10435394717166
Task_7899,514,187,86,180,266,2.734042553191489,16.122976210710746
Task_7900,1064,850,47,62,109,1.2502937720329024,25.404873917162536
Task_7901,1531,522,137,200,337,2.9273422562141493,33.629170788765556
Task_7902,656,268,99,91,190,2.4386617100371746,18.09688321901943
Task_7903,862,701,178,169,347,1.227920227920228,23.52942093137617
Task_7904,2993,931,124,67,191,3.21137339055794,56.94427131929688
Task_7905,2817,944,105,133,238,2.980952380952381,54.781270006868056
Task_7906,862,596,46,115,161,1.4438860971524288,22.15896834216511
Task_7907,1883,229,70,175,245,8.18695652173913,37.85010053405944
Task_7908,1673,664,164,41,205,2.5157894736842104,34.985207343597295
Task_7909,643,958,161,33,194,0.670490093847758,19.804499198839228
Task_7910,2744,360,135,131,266,7.6011080332409975,51.87775826031594
Task_7911,2095,350,26,157,183,5.968660968660969,41.19328256340164
Task_7912,995,713,141,74,215,1.3935574229691876,24.78914117528527
Task_7913,2240,220,128,26,154,10.135746606334841,42.089040144110406
Task_7914,2039,720,172,167,339,2.828016643550624,42.25859825757024
Task_7915,1046,952,42,116,158,1.0975865687303252,26.08476473136298
Task_7916,2041,614,184,53,237,3.31869918699187,41.07786404610417
Task_7917,581,446,99,135,234,1.2997762863534676,17.732458685265872
Task_7918,2338,762,27,24,51,3.0642201834862384,44.347447069523334
Task_7919,2937,585,112,85,197,5.011945392491468,55.21656969023848
Task_7920,1676,123,182,65,247,13.516129032258064,33.33578641309255
Task_7921,2803,482,74,32,106,5.803312629399586,51.49249677946819
Task_7922,1708,951,112,98,210,1.7941176470588236,37.05968738264815
Task_7923,2439,178,105,32,137,13.625698324022347,44.77632935412348
Task_7924,2715,342,40,154,194,7.915451895043732,51.076514309778055
Task_7925,576,966,97,12,109,0.5956566701137539,17.98524081512089
Task_7926,1431,987,136,194,330,1.4483805668016194,33.40207352781454
Task_7927,1280,621,109,77,186,2.057877813504823,28.908658074641156
Task_7928,753,914,158,182,340,0.8229508196721311,22.483641030571675
Task_7929,1584,320,107,193,300,4.934579439252336,33.64003434577402
Task_7930,2519,584,192,62,254,4.305982905982906,48.57428269031427
Task_7931,2839,256,183,134,317,11.04669260700389,53.244885434912156
Task_7932,1531,908,51,46,97,1.6842684268426842,32.572828889266425
Task_7933,2504,403,159,113,272,6.198019801980198,48.2256837788532
Task_7934,2044,524,114,164,278,3.8933333333333335,41.43902546237125
Task_7935,826,766,123,44,167,1.0769230769230769,21.715157878842188
Task_7936,1379,360,54,159,213,3.8199445983379503,30.156799790803102
Task_7937,2701,431,102,53,155,6.252314814814815,50.45378708612687
Task_7938,2463,376,87,72,159,6.5331564986737405,46.48927590497635
Task_7939,1805,273,81,68,149,6.587591240875913,35.81471780294003
Task_7940,2164,67,104,57,161,31.823529411764707,39.84792740905102
Task_7941,1467,191,189,166,355,7.640625,31.55232226442227
Task_7942,913,915,181,103,284,0.9967248908296943,24.636791069629123
Task_7943,2603,230,36,23,59,11.268398268398268,46.832671374054065
Task_7944,765,536,88,114,202,1.4245810055865922,20.71289456526491
Task_7945,536,593,184,62,246,0.9023569023569024,17.23671187179714
Task_7946,1734,457,116,195,311,3.7860262008733625,36.511377566608566
Task_7947,2384,195,191,196,387,12.16326530612245,46.23084168859719
Task_7948,1976,220,138,175,313,8.941176470588236,39.51982133135889
Task_7949,2255,698,185,49,234,3.2260371959942775,44.54376757739491
Task_7950,1630,176,169,156,325,9.209039548022599,33.67380239811044
Task_7951,2958,130,38,155,193,22.580152671755727,53.744698132665896
Task_7952,2397,152,78,174,252,15.666666666666666,45.505639754767365
Task_7953,2557,563,64,15,79,4.533687943262412,47.238664703227016
Task_7954,768,909,164,94,258,0.843956043956044,22.204581245454687
Task_7955,2043,814,98,151,249,2.506748466257669,42.19134838097796
Task_7956,1688,946,18,128,146,1.7824709609292502,36.271038095056866
Task_7957,1687,91,118,148,266,18.33695652173913,33.75895957378787
Task_7958,1716,719,130,85,215,2.3833333333333333,36.38274632698212
Task_7959,587,511,97,151,248,1.146484375,18.102794637408895
Task_7960,1284,263,33,24,57,4.863636363636363,26.141443880234974
Task_7961,1791,900,40,175,215,1.9877913429522753,38.354165228923804
Task_7962,1985,582,133,12,145,3.404802744425386,39.23594099369429
Task_7963,1382,240,32,133,165,5.734439834024896,29.452113752727882
Task_7964,1872,962,109,154,263,1.9439252336448598,40.00609605321355
Task_7965,1829,105,131,156,287,17.254716981132077,36.1922577939682
Task_7966,2148,533,16,20,36,4.022471910112359,40.36539801705106
Task_7967,2538,111,124,74,198,22.660714285714285,46.542515041235
Task_7968,2310,387,184,104,288,5.953608247422681,45.161867149880344
Task_7969,1422,705,67,101,168,2.0141643059490084,31.59680742236385
Task_7970,2716,282,57,89,146,9.597173144876326,50.48026609876632
Task_7971,581,75,73,134,207,7.644736842105263,16.11675964243771
Task_7972,1247,234,185,138,323,5.306382978723405,28.046977037344945
Task_7973,1592,981,124,142,266,1.6211812627291242,35.61053871902687
Task_7974,1814,646,125,163,288,2.80370942812983,38.226551127601056
Task_7975,1733,705,173,182,355,2.454674220963173,37.45843808798133
Task_7976,1622,262,45,191,236,6.167300380228137,33.781742375938066
Task_7977,1512,371,115,11,126,4.064516129032258,30.890805147544157
Task_7978,1811,243,86,175,261,7.422131147540983,36.72301743824499
Task_7979,1122,614,17,131,148,1.824390243902439,26.25844227645133
Task_7980,1810,586,155,83,238,3.0834752981260647,37.55963240293818
Task_7981,1706,700,79,121,200,2.433666191155492,36.28709714415495
Task_7982,1921,116,117,77,194,16.418803418803417,36.90052707728477
Task_7983,1004,796,40,61,101,1.2597239648682559,24.12816427755013
Task_7984,1097,565,94,90,184,1.9381625441696113,25.98181357636234
Task_7985,2852,762,169,17,186,3.7378768020969857,53.765692164931714
Task_7986,2471,376,116,170,286,6.554376657824934,47.76022005684038
Task_7987,2742,917,117,29,146,2.9869281045751634,52.370942424019404
Task_7988,758,745,150,131,281,1.0160857908847185,21.66194537835865
Task_7989,576,191,170,84,254,3.0,16.882210246246363
Task_7990,2835,362,157,100,257,7.809917355371901,53.238127341981034
Task_7991,1104,564,68,142,210,1.9539823008849557,26.416006167616615
Task_7992,878,943,128,61,189,0.9300847457627118,23.477819636648956
Task_7993,2948,997,111,38,149,2.9539078156312626,55.895129191672886
Task_7994,1231,397,141,168,309,3.092964824120603,28.31019564591926
Task_7995,650,781,189,198,387,0.8312020460358056,20.675899436283338
Task_7996,1757,450,174,10,184,3.895787139689579,35.41845681826128
Task_7997,1022,513,19,70,89,1.9883268482490273,23.587155680451833
Task_7998,867,338,85,52,137,2.5575221238938055,21.013664132979752
Task_7999,2751,479,57,98,155,5.73125,51.71971093288886
Task_8000,2475,727,142,124,266,3.3997252747252746,48.79524421158792
Task_8001,1639,408,48,159,207,4.007334963325183,34.3885747667516
Task_8002,663,981,176,145,321,0.675152749490835,21.243208941339685
Task_8003,510,312,100,66,166,1.6293929712460065,15.579032272430785
Task_8004,504,72,76,26,102,6.904109589041096,12.858584757756885
Task_8005,2878,988,41,38,79,2.910010111223458,53.880037004122585
Task_8006,2504,985,195,87,282,2.5395537525354968,50.0187624672019
Task_8007,2659,658,154,125,279,4.034901365705615,51.551846606447384
Task_8008,2422,182,165,105,270,13.234972677595628,46.03491624164866
Task_8009,1316,537,94,182,276,2.446096654275093,29.98136520087874
Task_8010,764,572,22,122,144,1.3333333333333333,20.39919401588881
Task_8011,1154,388,73,74,147,2.966580976863753,26.023743432166057
Task_8012,2111,213,95,77,172,9.86448598130841,40.65719775995782
Task_8013,1502,679,186,145,331,2.208823529411765,33.55563938268423
Task_8014,1069,161,122,99,221,6.598765432098766,24.269950390838062
Task_8015,1075,343,164,136,300,3.125,25.5815530295307
Task_8016,1514,746,175,66,241,2.0267737617135206,33.15579046102081
Task_8017,1817,476,124,101,225,3.809224318658281,37.360653464469344
Task_8018,1519,586,85,194,279,2.5877342419080067,33.37680911786811
Task_8019,2564,358,55,13,68,7.142061281337047,46.51252859977601
Task_8020,2812,935,117,154,271,3.0042735042735043,54.853427132824265
Task_8021,2132,985,84,166,250,2.162271805273834,44.16659080807772
Task_8022,838,371,142,75,217,2.252688172043011,21.281916563782968
Task_8023,839,206,133,113,246,4.053140096618358,21.12489396265476
Task_8024,2107,944,114,170,284,2.22962962962963,43.79209422939766
Task_8025,2404,464,172,189,361,5.16989247311828,47.35573262118481
Task_8026,1686,187,79,152,231,8.96808510638298,34.51203546134169
Task_8027,1615,722,46,14,60,2.2337482710926695,32.687463425081724
Task_8028,977,910,67,153,220,1.0724478594950604,25.434723205922392
Task_8029,2644,252,173,128,301,10.450592885375494,50.067819972070254
Task_8030,1091,136,51,166,217,7.963503649635037,24.596695787109898
Task_8031,2907,458,29,26,55,6.333333333333333,52.44774645259397
Task_8032,977,158,88,76,164,6.144654088050315,22.238152772832592
Task_8033,899,110,143,112,255,8.0990990990991,21.402589483685684
Task_8034,1243,520,186,60,246,2.385796545105566,28.12398115297805
Task_8035,547,74,176,197,373,7.293333333333333,16.39584868006249
Task_8036,2454,850,80,55,135,2.883666274970623,47.76072070281494
Task_8037,2176,669,114,83,197,3.2477611940298505,43.4332916972138
Task_8038,2599,354,183,32,215,7.32112676056338,48.686956675007714
Task_8039,920,228,104,107,211,4.0174672489082965,22.311456983039808
Task_8040,2757,685,85,186,271,4.018950437317784,53.249071547895916
Task_8041,2443,764,125,65,190,3.193464052287582,47.70893662487516
Task_8042,2541,230,104,93,197,11.0,47.821180216186
Task_8043,717,921,83,182,265,0.7776572668112798,21.622952262616806
Task_8044,2714,496,93,71,164,5.4607645875251505,51.103182477644395
Task_8045,642,983,101,11,112,0.6524390243902439,19.106439665789637
Task_8046,1557,656,46,116,162,2.3698630136986303,33.45018363056966
Task_8047,2251,325,27,79,106,6.904907975460123,42.777905714590865
Task_8048,1431,893,87,88,175,1.6006711409395973,32.19127333548746
Task_8049,2871,105,79,18,97,27.08490566037736,50.507704592913655
Task_8050,2651,382,149,125,274,6.921671018276762,50.50813855085217
Task_8051,1590,894,182,92,274,1.776536312849162,35.21976979241756
Task_8052,820,478,136,48,184,1.7118997912317329,20.8048577071042
Task_8053,1612,216,73,15,88,7.428571428571429,31.52674712064199
Task_8054,972,506,182,180,362,1.9171597633136095,24.81193771210208
Task_8055,573,873,173,128,301,0.6556064073226545,19.370958556066395
Task_8056,2397,862,88,89,177,2.777520278099652,47.43579652921435
Task_8057,1731,491,109,20,129,3.518292682926829,34.83454433318727
Task_8058,1891,340,110,71,181,5.545454545454546,37.5691604487832
Task_8059,2487,372,158,175,333,6.6675603217158175,48.21910227948367
Task_8060,2722,201,58,166,224,13.475247524752476,50.8791235973882
Task_8061,1079,608,61,151,212,1.7717569786535303,26.16036396587748
Task_8062,1967,479,75,37,112,4.097916666666666,38.311802575259726
Task_8063,2416,511,121,33,154,4.71875,45.890190759102815
Task_8064,2598,189,135,171,306,13.673684210526316,49.185129663106096
Task_8065,2431,990,159,53,212,2.453077699293643,48.32166037423488
Task_8066,1059,765,187,80,267,1.3825065274151436,26.272968087480596
Task_8067,2089,137,97,141,238,15.13768115942029,40.33911864943791
Task_8068,1338,261,36,125,161,5.106870229007634,28.68720117786948
Task_8069,2106,785,121,171,292,2.6793893129770994,43.317678706440205
Task_8070,2540,339,84,131,215,7.470588235294118,48.359241027146595
Task_8071,2730,280,43,88,131,9.715302491103202,50.614951528300345
Task_8072,1221,963,63,143,206,1.266597510373444,29.418353053037947
Task_8073,1996,173,21,42,63,11.471264367816092,37.10467634893906
Task_8074,2339,342,165,197,362,6.819241982507289,45.93971551561504
Task_8075,694,498,19,127,146,1.3907815631262526,19.090818653713537
Task_8076,989,101,34,170,204,9.696078431372548,22.612805536157737
Task_8077,2845,541,25,69,94,5.249077490774908,52.57915279295761
Task_8078,1270,182,111,118,229,6.939890710382514,27.69438279248566
Task_8079,1965,706,84,79,163,2.7793493635077793,40.027885029577696
Task_8080,957,830,139,32,171,1.151624548736462,23.959450838064893
Task_8081,2989,260,48,170,218,11.452107279693486,55.296641180306615
Task_8082,1414,100,12,134,146,14.0,28.544078749175956
Task_8083,2728,585,101,197,298,4.6552901023890785,52.60328246717512
Task_8084,1123,144,108,170,278,7.744827586206896,25.413387576511806
Task_8085,2945,929,135,198,333,3.1666666666666665,57.28610410831457
Task_8086,953,989,62,136,198,0.9626262626262626,25.179411576361172
Task_8087,2142,734,135,195,330,2.914285714285714,43.934643162322004
Task_8088,2330,512,66,45,111,4.541910331384016,44.13567405736526
Task_8089,2516,629,110,181,291,3.9936507936507937,49.33110718644078
Task_8090,767,722,150,103,253,1.0608575380359613,21.573714835137945
Task_8091,2006,239,135,104,239,8.358333333333333,39.6257126161206
Task_8092,1870,809,43,175,218,2.308641975308642,39.34271089126775
Task_8093,823,94,145,135,280,8.663157894736843,20.207381842885663
Task_8094,2187,603,75,126,201,3.620860927152318,43.61670693268015
Task_8095,1933,320,188,101,289,6.021806853582555,38.97458356598328
Task_8096,1096,238,26,50,76,4.585774058577406,23.2414499740633
Task_8097,906,627,28,165,193,1.4426751592356688,23.301412095694065
Task_8098,1675,238,10,127,137,7.00836820083682,33.716663261320086
Task_8099,2256,88,198,29,227,25.348314606741575,41.686427671916185
Task_8100,1405,944,30,139,169,1.4867724867724867,32.02462711927287
Task_8101,1840,539,80,165,245,3.4074074074074074,38.16283720077811
Task_8102,1893,874,104,79,183,2.1634285714285713,39.457093779044655
Task_8103,741,505,117,99,216,1.4644268774703557,20.3151138899516
Task_8104,1201,758,174,121,295,1.5823451910408433,28.793611206541144
Task_8105,2485,815,180,86,266,3.045343137254902,49.10805973122873
Task_8106,2375,937,80,106,186,2.5319829424307034,47.501472596542136
Task_8107,2881,863,97,144,241,3.334490740740741,55.579150803046105
Task_8108,2637,986,29,30,59,2.6717325227963524,49.82922890925095
Task_8109,2322,349,104,148,252,6.634285714285714,45.12688211384451
Task_8110,1782,987,55,184,239,1.8036437246963564,38.662943544378926
Task_8111,1789,676,119,123,242,2.642540620384047,37.658821347083574
Task_8112,812,848,129,42,171,0.9564193168433451,21.82394758522982
Task_8113,992,869,183,165,348,1.1402298850574712,26.103939544065785
Task_8114,2455,807,36,108,144,3.0383663366336635,47.98445893944145
Task_8115,2503,365,129,79,208,6.83879781420765,47.64236690576352
Task_8116,1697,250,183,164,347,6.760956175298805,35.357812854910385
Task_8117,1992,374,127,163,290,5.312,40.18312890781722
Task_8118,1759,832,192,128,320,2.1116446578631454,38.029945208926655
Task_8119,1712,466,25,156,181,3.6659528907922914,35.500366142486264
Task_8120,1415,411,181,110,291,3.4344660194174756,31.100475717886102
Task_8121,2134,81,67,190,257,26.024390243902438,40.773754856541636
Task_8122,907,869,83,107,190,1.042528735632184,23.94802998104142
Task_8123,2723,773,128,138,266,3.5180878552971575,52.889340692759696
Task_8124,761,607,125,92,217,1.2516447368421053,20.887227516143685
Task_8125,2254,867,79,106,185,2.596774193548387,45.36798269048065
Task_8126,775,120,156,185,341,6.404958677685951,20.073037365740536
Task_8127,1647,720,131,125,256,2.2843273231622745,35.61329739189061
Task_8128,2473,396,41,54,95,6.2292191435768265,46.09989117998143
Task_8129,744,113,56,22,78,6.526315789473684,16.917394102076777
Task_8130,2894,556,59,51,110,5.195691202872531,53.35474361723846
Task_8131,2166,102,166,71,237,21.02912621359223,40.75994441185418
Task_8132,2691,225,76,189,265,11.9070796460177,50.70151049845501
Task_8133,2883,1010,69,67,136,2.851632047477745,55.20000070990716
Task_8134,2615,544,175,57,232,4.798165137614679,49.86731212785082
Task_8135,2335,225,168,95,263,10.331858407079647,44.8788921244388
Task_8136,1648,345,61,199,260,4.763005780346821,34.63047505239234
Task_8137,2596,797,98,113,211,3.2531328320802007,50.67245492614728
Task_8138,2681,986,89,79,168,2.7163120567375887,52.2028096588973
Task_8139,772,667,134,57,191,1.155688622754491,20.870359339067807
Task_8140,2461,534,37,171,208,4.6,47.79207118199863
Task_8141,2065,648,189,120,309,3.1818181818181817,42.23991945111765
Task_8142,1629,378,73,35,108,4.298153034300792,32.58954176826858
Task_8143,723,581,174,55,229,1.2422680412371134,20.008095787557128
Task_8144,607,565,159,180,339,1.0724381625441697,19.045466311522407
Task_8145,834,764,84,17,101,1.0901960784313725,21.093107272380706
Task_8146,2799,332,133,24,157,8.405405405405405,51.33172738788332
Task_8147,1828,1011,97,140,237,1.8063241106719368,39.33098416422907
Task_8148,2946,702,191,189,380,4.190611664295875,56.78636097732391
Task_8149,2344,802,25,15,40,2.9190535491905356,44.34932765277211
Task_8150,896,552,129,154,283,1.620253164556962,23.344913785433807
Task_8151,573,335,177,142,319,1.7053571428571428,17.697192972264226
Task_8152,1376,910,162,153,315,1.5104281009879255,32.1752446287416
Task_8153,2030,440,79,89,168,4.603174603174603,40.318644469219244
Task_8154,1843,613,43,190,233,3.001628664495114,38.390314795364866
Task_8155,1770,403,58,168,226,4.381188118811881,36.55412981345715
Task_8156,2486,626,151,43,194,3.9649122807017543,47.69531301882706
Task_8157,2420,842,12,32,44,2.870699881376038,45.8655322450555
Task_8158,2857,73,153,39,192,38.608108108108105,50.64931859781581
Task_8159,2059,239,171,105,276,8.579166666666667,40.631189990147774
Task_8160,767,287,126,23,149,2.6631944444444446,19.05300156771747
Task_8161,1870,275,78,36,114,6.77536231884058,36.11856737989745
Task_8162,1026,816,61,147,208,1.255813953488372,25.884777577250848
Task_8163,2729,202,72,86,158,13.443349753694582,50.387933237973364
Task_8164,1790,452,21,163,184,3.9514348785871967,36.709953390341674
Task_8165,2353,995,142,168,310,2.362449799196787,47.96334406223763
Task_8166,2344,522,28,158,186,4.4818355640535374,45.71929694491416
Task_8167,2901,702,69,64,133,4.126600284495021,54.532666093861216
Task_8168,2874,626,67,154,221,4.583732057416268,54.71087797982535
Task_8169,2980,221,188,84,272,13.423423423423424,54.985762544607276
Task_8170,1871,151,126,91,217,12.30921052631579,36.751362374728735
Task_8171,2842,924,144,43,187,3.0724324324324326,54.22798384243686
Task_8172,2654,244,102,49,151,10.83265306122449,48.848449500284495
Task_8173,2127,509,27,72,99,4.170588235294118,41.1433443293955
Task_8174,2099,152,56,187,243,13.718954248366012,40.74779320586578
Task_8175,967,69,32,118,150,13.814285714285715,21.316971291049192
Task_8176,2126,463,172,187,359,4.581896551724138,42.94011829413373
Task_8177,2369,247,31,139,170,9.55241935483871,45.08294466437163
Task_8178,2623,888,11,156,167,2.9505061867266593,51.15948590223861
Task_8179,1798,435,26,158,184,4.123853211009174,36.77846968235609
Task_8180,986,178,136,103,239,5.5083798882681565,23.05729280534844
Task_8181,1097,243,38,83,121,4.495901639344262,24.510872478317097
Task_8182,700,224,94,113,207,3.111111111111111,18.82468184210579
Task_8183,905,309,23,44,67,2.9193548387096775,20.327057473527322
Task_8184,1923,254,76,85,161,7.541176470588235,37.86782477920152
Task_8185,1003,570,177,85,262,1.7565674255691768,24.82669691743176
Task_8186,842,497,87,45,132,1.6907630522088353,20.819485693474522
Task_8187,1656,994,98,142,240,1.664321608040201,36.55211426515541
Task_8188,1654,985,80,37,117,1.6774847870182557,34.94807971292027
Task_8189,821,853,64,109,173,0.9613583138173302,22.492786568111807
Task_8190,2947,410,120,33,153,7.170316301703163,53.95336108140916
Task_8191,2259,554,144,46,190,4.07027027027027,43.85880283917836
Task_8192,1327,819,136,188,324,1.6182926829268294,31.237570522286802
Task_8193,512,887,36,38,74,0.5765765765765766,16.11902887381375
Task_8194,2194,351,77,93,170,6.232954545454546,42.66201620592576
Task_8195,2916,810,110,166,276,3.595561035758323,56.14954282794531
Task_8196,2651,70,38,188,226,37.33802816901409,48.57837075664685
Task_8197,1268,656,150,17,167,1.9299847792998477,28.25745170755053
Task_8198,2671,280,28,163,191,9.505338078291816,50.142659876773685
Task_8199,1609,774,58,180,238,2.0761290322580646,35.24917699638616
Task_8200,2313,391,200,88,288,5.900510204081633,45.14001265272415
Task_8201,2029,711,76,12,88,2.8497191011235956,39.72864860385885
Task_8202,2930,319,117,100,217,9.15625,54.411366990823275
Task_8203,823,964,89,66,155,0.8528497409326425,22.354132734785868
Task_8204,1073,321,173,13,186,3.3322981366459627,24.19913006956224
Task_8205,2899,787,163,90,253,3.6789340101522843,55.561021348802946
Task_8206,508,820,50,104,154,0.6187576126674786,17.450821470208776
Task_8207,1198,342,88,124,212,3.492711370262391,27.068388578997286
Task_8208,2602,217,62,198,260,11.935779816513762,49.25550627968295
Task_8209,2140,312,103,82,185,6.8370607028754,41.62293702730292
Task_8210,1051,941,73,112,185,1.115711252653928,26.45622608804049
Task_8211,1956,262,104,20,124,7.437262357414449,37.46490026392406
Task_8212,917,275,178,70,248,3.322463768115942,22.254152147751853
Task_8213,2131,793,142,169,311,2.6838790931989926,43.82148326171002
Task_8214,1599,705,99,99,198,2.264872521246459,34.50225602675771
Task_8215,1571,766,162,23,185,2.048239895697523,33.519185635477776
Task_8216,1545,229,64,193,257,6.717391304347826,32.58991532442189
Task_8217,984,201,100,193,293,4.871287128712871,23.72584142885981
Task_8218,1177,1009,86,21,107,1.1653465346534653,27.374679749148058
Task_8219,1041,866,163,91,254,1.2006920415224913,26.293059407806414
Task_8220,2692,770,93,18,111,3.4915693904020753,50.710359783315276
Task_8221,2690,611,160,187,347,4.395424836601308,52.29073713521018
Task_8222,732,609,192,156,348,1.2,21.174974238012464
Task_8223,716,901,109,154,263,0.7937915742793792,21.49963994610714
Task_8224,1597,322,181,51,232,4.944272445820434,33.02365666494898
Task_8225,2480,731,89,151,240,3.387978142076503,48.78841417422901
Task_8226,591,855,110,18,128,0.6904205607476636,18.281673250207344
Task_8227,543,724,24,149,173,0.7489655172413793,17.71414182260632
Task_8228,2351,813,119,90,209,2.888206388206388,46.76232211995981
Task_8229,2820,193,79,77,156,14.536082474226804,51.71375787080518
Task_8230,2432,247,69,84,153,9.806451612903226,45.815033438528275
Task_8231,2208,868,183,108,291,2.5408515535097815,45.096264998931105
Task_8232,2825,626,12,19,31,4.505582137161085,51.36320140278647
Task_8233,1661,355,65,71,136,4.665730337078652,33.80702923444705
Task_8234,1492,297,164,146,310,5.006711409395973,32.08496207583417
Task_8235,2995,953,96,112,208,3.139412997903564,57.47172531431725
Task_8236,2026,731,125,38,163,2.76775956284153,40.59535619836392
Task_8237,895,66,177,81,258,13.35820895522388,20.941877414476
Task_8238,982,732,146,71,217,1.339699863574352,24.602204651412492
Task_8239,2368,967,41,99,140,2.446280991735537,47.05720174293719
Task_8240,503,814,133,55,188,0.6171779141104294,17.265984628161494
Task_8241,1660,993,12,146,158,1.6700201207243461,36.01838268594006
Task_8242,1927,536,184,182,366,3.5884543761638734,40.047794529995365
Task_8243,1087,287,147,37,184,3.7743055555555554,24.404878451461943
Task_8244,2611,479,199,67,266,5.439583333333333,49.799510654301
Task_8245,1896,988,135,33,168,1.9170879676440848,39.31047562846194
Task_8246,2904,565,197,14,211,5.130742049469965,54.079895508218605
Task_8247,1394,477,23,30,53,2.916317991631799,28.563970930492463
Task_8248,781,165,172,71,243,4.704819277108434,19.56790040628122
Task_8249,2826,789,122,73,195,3.5772151898734177,53.92437547723535
Task_8250,2917,114,118,35,153,25.36521739130435,51.829267065196525
Task_8251,512,729,91,32,123,0.7013698630136986,16.441268976362327
Task_8252,614,529,94,36,130,1.1584905660377358,17.381193450073496
Task_8253,2268,477,123,137,260,4.7447698744769875,44.71362913364275
Task_8254,1853,92,119,133,252,19.9247311827957,36.27538241817616
Task_8255,1050,805,194,156,350,1.3027295285359801,26.828047235636603
Task_8256,1891,995,75,59,134,1.8985943775100402,39.33118697324945
Task_8257,1439,496,32,118,150,2.8953722334004026,30.923709216098246
Task_8258,1776,64,89,12,101,27.323076923076922,32.68755045834778
Task_8259,556,178,76,111,187,3.106145251396648,16.072220853760054
Task_8260,1872,421,193,168,361,4.436018957345971,38.76526476544186
Task_8261,657,499,170,29,199,1.314,18.348784852631052
Task_8262,986,138,139,59,198,7.093525179856115,22.31697282773126
Task_8263,1292,185,171,107,278,6.946236559139785,28.26809537558222
Task_8264,954,283,111,192,303,3.359154929577465,23.569556425448905
Task_8265,597,499,151,133,284,1.194,18.37312883468741
Task_8266,1625,394,52,170,222,4.113924050632911,34.21768979945341
Task_8267,2457,629,129,170,299,3.9,48.41660976092288
Task_8268,2054,970,49,99,148,2.1153450051493308,42.219278228328534
Task_8269,2035,496,163,66,229,4.094567404426559,40.56479517389659
Task_8270,2743,872,92,50,142,3.1420389461626574,52.31562093853365
Task_8271,963,684,69,173,242,1.4058394160583942,24.696427824905268
Task_8272,1319,747,14,125,139,1.7633689839572193,29.75024788493032
Task_8273,699,364,106,198,304,1.915068493150685,19.80969855896601
Task_8274,2091,959,134,85,219,2.178125,43.09064914406
Task_8275,3000,996,66,186,252,3.009027081243731,58.06184625529073
Task_8276,1486,925,185,172,357,1.6047516198704104,34.211239283780124
Task_8277,2687,195,81,16,97,13.709183673469388,48.58481213413549
Task_8278,1087,937,138,85,223,1.1588486140724947,27.06332041519848
Task_8279,2440,997,32,103,135,2.444889779559118,48.26337459402723
Task_8280,509,448,130,139,269,1.133630289532294,16.753395329301377
Task_8281,2066,888,27,175,202,2.3239595050618673,42.59578231788612
Task_8282,1197,393,177,161,338,3.0380710659898478,27.87986757614461
Task_8283,878,655,194,195,389,1.3384146341463414,23.885003664429203
Task_8284,1802,760,114,22,136,2.3679369250985545,36.793864452083795
Task_8285,1091,350,103,64,167,3.1082621082621085,24.860772995881646
Task_8286,1178,133,146,148,294,8.791044776119403,26.22208165897592
Task_8287,2820,308,172,50,222,9.12621359223301,52.15303186260476
Task_8288,1187,988,93,48,141,1.2002022244691608,28.00859807709283
Task_8289,2198,652,13,187,200,3.3660030627871365,43.942068595153934
Task_8290,947,821,196,118,314,1.1520681265206814,25.02017010121591
Task_8291,815,103,128,197,325,7.836538461538462,20.488921385503286
Task_8292,1895,537,149,29,178,3.5223048327137545,37.956415310785765
Task_8293,2169,981,155,134,289,2.208757637474542,44.85946875632303
Task_8294,1493,273,177,78,255,5.4489051094890515,31.549534910111756
Task_8295,1589,552,75,100,175,2.8734177215189876,33.804061236841115
Task_8296,2727,536,196,116,312,5.078212290502793,52.37442588760589
Task_8297,2652,950,167,25,192,2.7886435331230284,51.271690898440255
Task_8298,1608,959,116,142,258,1.675,35.75977965481144
Task_8299,2915,374,53,112,165,7.773333333333333,54.18991474632853
Task_8300,705,158,144,106,250,4.433962264150943,18.67748430966299
Task_8301,2419,864,178,186,364,2.7965317919075146,48.87033859974482
Task_8302,880,996,159,197,356,0.8826479438314945,24.84427782409219
Task_8303,2306,253,25,189,214,9.078740157480315,44.413831813973225
Task_8304,832,809,176,172,348,1.0271604938271606,23.402206619426078
Task_8305,551,159,167,93,260,3.44375,16.239554794329624
Task_8306,2171,557,182,15,197,3.890681003584229,42.38577112291099
Task_8307,2290,324,47,135,182,7.046153846153846,44.20370979958028
Task_8308,1799,619,108,49,157,2.9016129032258067,36.59065607022472
Task_8309,932,974,156,63,219,0.9558974358974359,24.607495372258217
Task_8310,566,110,19,37,56,5.099099099099099,14.104315629837963
Task_8311,790,960,23,95,118,0.8220603537981269,21.77993620340298
Task_8312,2724,632,11,70,81,4.303317535545023,50.80221057763165
Task_8313,2229,1016,148,26,174,2.191740412979351,44.70413614264237
Task_8314,2009,430,28,196,224,4.661252900232019,40.376195467790915
Task_8315,1437,247,107,60,167,5.794354838709677,29.944469436478787
Task_8316,2294,988,25,100,125,2.319514661274014,45.89746952707552
Task_8317,1275,801,53,163,216,1.5897755610972568,29.88073723694114
Task_8318,1090,101,172,127,299,10.686274509803921,24.56588577206217
Task_8319,2302,355,196,189,385,6.466292134831461,45.49026596063323
Task_8320,2894,205,141,65,206,14.048543689320388,53.050067200537704
Task_8321,1488,553,148,66,214,2.6859205776173285,32.017730953436455
Task_8322,1229,913,104,175,279,1.3446389496717723,29.721105261990235
Task_8323,2863,803,130,54,184,3.560945273631841,54.38862404946517
Task_8324,1070,172,74,119,193,6.184971098265896,24.299746119658703
Task_8325,1765,1014,180,114,294,1.7389162561576355,38.53958665367954
Task_8326,1695,493,93,92,185,3.431174089068826,35.247765960908474
Task_8327,2737,84,130,62,192,32.2,49.24431969330819
Task_8328,1930,760,57,170,227,2.536136662286465,40.22322349268234
Task_8329,2499,417,140,38,178,5.978468899521531,47.150765704871446
Task_8330,2217,236,70,130,200,9.354430379746836,42.88262972143186
Task_8331,1957,589,129,181,310,3.316949152542373,40.43708876830075
Task_8332,1323,439,89,21,110,3.006818181818182,27.896431637560678
Task_8333,1618,660,167,29,196,2.447806354009077,34.04960677225045
Task_8334,2140,526,99,93,192,4.060721062618596,42.45863913075122
Task_8335,1327,218,169,144,313,6.059360730593608,29.21866130744573
Task_8336,901,122,28,175,203,7.32520325203252,21.377582409485726
Task_8337,2331,440,161,95,256,5.285714285714286,45.52455907536986
Task_8338,2360,866,79,152,231,2.7220299884659744,47.35249393876641
Task_8339,2645,764,107,96,203,3.457516339869281,51.308114588888515
Task_8340,2416,1002,41,150,191,2.4087736789631107,48.43351903240825
Task_8341,2970,280,198,155,353,10.569395017793594,55.59727211879766
Task_8342,1983,343,11,95,106,5.7645348837209305,38.6136499710876
Task_8343,2339,100,31,188,219,23.15841584158416,43.88347557202082
Task_8344,1318,816,88,72,160,1.613219094247246,29.77278429084628
Task_8345,597,731,127,121,248,0.8155737704918032,18.958343430635118
Task_8346,2983,190,85,142,227,15.61780104712042,54.86712651612936
Task_8347,765,254,140,178,318,3.0,20.535043048298384
Task_8348,1060,340,91,156,247,3.1085043988269794,25.124433371991206
Task_8349,1288,1005,136,107,243,1.2803180914512922,30.664741424991703
Task_8350,2270,868,46,57,103,2.6121979286536248,44.445470042284306
Task_8351,770,134,136,184,320,5.703703703703703,19.97171090040198
Task_8352,643,936,87,35,122,0.6862326574172892,19.087462625861892
Task_8353,1245,586,25,43,68,2.1209540034071552,26.606209198702064
Task_8354,1952,749,193,126,319,2.6026666666666665,40.821029500236506
Task_8355,2713,852,109,43,152,3.1805392731535758,51.648488819692396
Task_8356,1800,975,183,154,337,1.8442622950819672,39.239049165273755
Task_8357,1659,489,170,66,236,3.3857142857142857,34.62157480108229
Task_8358,2200,362,17,169,186,6.0606060606060606,42.90244247364092
Task_8359,2070,349,107,63,170,5.914285714285715,40.31970156510103
Task_8360,883,117,178,45,223,7.483050847457627,20.41087944461788
Task_8361,1468,528,75,136,211,2.775047258979206,32.05376275558685
Task_8362,2497,591,99,68,167,4.217905405405405,47.902344095253405
Task_8363,1842,266,195,125,320,6.898876404494382,37.526089438216786
Task_8364,1826,348,92,82,174,5.232091690544412,36.735390747624045
Task_8365,945,306,88,71,159,3.0781758957654723,22.22707842345693
Task_8366,704,989,70,95,165,0.7111111111111111,21.208496106258764
Task_8367,840,549,150,92,242,1.5272727272727273,22.09207003513487
Task_8368,2751,183,44,66,110,14.951086956521738,49.99764705410135
Task_8369,2741,735,89,55,144,3.724184782608696,51.97181125888605
Task_8370,692,348,60,100,160,1.9828080229226361,18.72987200533656
Task_8371,2612,785,105,101,206,3.323155216284987,50.84388505116802
Task_8372,2599,541,111,113,224,4.795202952029521,49.96280449404215
Task_8373,828,953,38,140,178,0.8679245283018868,22.93153721334457
Task_8374,2983,541,69,54,123,5.503690036900369,55.016041539121375
Task_8375,1057,859,27,195,222,1.2290697674418605,26.560119799603346
Task_8376,2867,78,143,13,156,36.29113924050633,50.48567254478712
Task_8377,1487,676,142,102,244,2.1964549483013296,32.85351779871832
Task_8378,1656,473,58,132,190,3.4936708860759493,34.75691592347165
Task_8379,2499,288,130,77,207,8.647058823529411,47.242218721827896
Task_8380,785,305,197,127,324,2.565359477124183,20.968270399057662
Task_8381,1738,136,164,196,360,12.686131386861314,35.42253517736976
Task_8382,1971,304,151,121,272,6.462295081967213,39.473924521853164
Task_8383,2783,184,189,75,264,15.043243243243243,51.555690763977374
Task_8384,1565,519,143,164,307,3.0096153846153846,33.96999904590953
Task_8385,1893,209,82,160,242,9.014285714285714,37.86827946729556
Task_8386,1933,563,95,145,240,3.4273049645390072,39.61671564273848
Task_8387,1643,726,128,180,308,2.2599724896836313,35.883674244658145
Task_8388,1024,656,27,41,68,1.5585996955859969,23.312297610573996
Task_8389,2646,244,31,191,222,10.8,49.80320261843779
Task_8390,2267,536,108,89,197,4.221601489757914,44.490574327216564
Task_8391,2902,612,174,62,236,4.734094616639478,54.64796898770993
Task_8392,1233,640,129,98,227,1.923556942277691,28.64299291267368
Task_8393,819,874,95,132,227,0.936,22.825925333600143
Task_8394,559,810,124,141,265,0.689272503082614,18.801562200872873
Task_8395,2778,946,159,133,292,2.9334741288278776,54.41290187877765
Task_8396,2987,559,86,79,165,5.333928571428571,55.73054839423804
Task_8397,1746,577,98,92,190,3.0207612456747404,36.3370969764785
Task_8398,1473,292,167,55,222,5.027303754266212,30.932914141711212
Task_8399,2337,1024,120,78,198,2.28,47.040355452056325
Task_8400,2736,471,53,149,202,5.796610169491525,51.93061984737892
Task_8401,2363,472,171,45,216,4.995771670190275,45.34176008036659
Task_8402,1334,141,176,172,348,9.394366197183098,29.025262165487337
Task_8403,1381,984,62,161,223,1.402030456852792,32.141211165065044
Task_8404,2784,745,72,181,253,3.7319034852546915,53.83187617948554
Task_8405,514,89,76,55,131,5.711111111111111,13.949821089457918
Task_8406,1500,507,21,46,67,2.952755905511811,30.410099576417906
Task_8407,2288,876,63,91,154,2.6088939566704674,45.59555036089234
Task_8408,2400,1000,44,51,95,2.3976023976023977,46.84982413768892
Task_8409,2045,180,183,54,237,11.298342541436464,39.49284706360584
Task_8410,1272,652,147,174,321,1.9479326186830015,29.82571305296284
Task_8411,1106,325,110,112,222,3.392638036809816,25.62699456088204
Task_8412,1152,661,187,82,269,1.7401812688821752,27.503388414269185
Task_8413,1149,213,64,130,194,5.369158878504673,25.90398107727331
Task_8414,2306,312,51,40,91,7.36741214057508,42.8816186753837
Task_8415,1955,861,30,141,171,2.2679814385150814,40.52189395930952
Task_8416,2071,460,28,81,109,4.492407809110629,40.4471761824588
Task_8417,619,360,200,160,360,1.7146814404432134,18.71479543386633
Task_8418,2751,778,97,30,127,3.5314505776636715,51.90798789072554
Task_8419,1956,744,110,143,253,2.625503355704698,40.59619774246858
Task_8420,998,547,164,43,207,1.8211678832116789,23.940892769860984
Task_8421,2382,539,73,70,143,4.411111111111111,45.80753943436204
Task_8422,577,669,158,31,189,0.8611940298507462,17.59725418736649
Task_8423,2798,569,10,141,151,4.908771929824561,52.66661504347758
Task_8424,2220,705,98,25,123,3.144475920679887,43.09932490160046
Task_8425,2523,782,17,114,131,3.2222222222222223,48.91603622111177
Task_8426,1843,944,37,68,105,1.9502645502645504,38.15408182019528
Task_8427,1197,326,44,76,120,3.6605504587155964,26.25018337190997
Task_8428,1716,83,32,41,73,20.428571428571427,31.861795865415104
Task_8429,1172,160,193,152,345,7.279503105590062,26.54124207816909
Task_8430,840,75,120,54,174,11.052631578947368,19.351258290780518
Task_8431,1758,284,165,107,272,6.168421052631579,36.017749690915615
Task_8432,641,940,66,27,93,0.6811902231668437,19.041810855217076
Task_8433,1439,169,188,15,203,8.464705882352941,29.371092659747433
Task_8434,2858,1001,67,10,77,2.852295409181637,53.39161568994381
Task_8435,2066,252,151,35,186,8.16600790513834,39.75875665130568
Task_8436,2866,766,132,26,158,3.7366362451108213,53.83883862098748
Task_8437,2787,373,102,23,125,7.451871657754011,51.03275268991381
Task_8438,1540,823,193,95,288,1.8689320388349515,34.353019051685756
Task_8439,1019,736,117,67,184,1.3826322930800543,24.971284995085185
Task_8440,1697,575,154,116,270,2.9461805555555554,35.99998341965023
Task_8441,510,856,67,106,173,0.5950991831971996,17.753828690865035
Task_8442,1550,423,74,33,107,3.6556603773584904,31.47970121574234
Task_8443,2687,619,120,128,248,4.333870967741936,51.736033810983166
Task_8444,2119,526,195,185,380,4.020872865275142,43.12338086819583
Task_8445,1751,238,15,30,45,7.326359832635983,33.335965479516055
Task_8446,1027,245,133,53,186,4.17479674796748,23.59899320392432
Task_8447,1749,106,160,183,343,16.345794392523363,35.23259702349772
Task_8448,1136,652,158,167,325,1.7396630934150077,27.665995904965985
Task_8449,2157,164,104,37,141,13.072727272727272,40.29557259118476
Task_8450,2039,866,24,110,134,2.351787773933103,41.49879629703684
Task_8451,2769,695,42,161,203,3.978448275862069,53.138324837148424
Task_8452,2575,839,17,91,108,3.0654761904761907,49.57398946068228
Task_8453,1173,895,177,182,359,1.3091517857142858,29.148817565114708
Task_8454,1022,999,128,40,168,1.022,25.51280617620183
Task_8455,1863,897,43,63,106,2.074610244988864,38.27072941742372
Task_8456,1474,672,199,46,245,2.1901931649331354,32.04993387210243
Task_8457,2538,77,87,91,178,32.53846153846154,46.35229908139416
Task_8458,2416,799,10,126,136,3.02,47.261781962269986
Task_8459,546,600,43,149,192,0.908485856905158,17.47075641260086
Task_8460,1843,520,179,169,348,3.5374280230326294,38.566734228343364
Task_8461,2971,94,45,46,91,31.273684210526316,51.86826470660264
Task_8462,2483,137,118,36,154,17.992753623188406,45.230044337382104
Task_8463,2778,324,180,181,361,8.547692307692307,52.79293962214077
Task_8464,2956,348,99,45,144,8.469914040114613,53.848876987252645
Task_8465,647,1016,22,51,73,0.6361848574237955,18.8996602192766
Task_8466,1525,672,67,120,187,2.265973254086181,33.2733533275455
Task_8467,2488,430,161,181,342,5.77262180974478,48.47678959493398
Task_8468,2977,736,194,120,314,4.039348710990502,56.98643982587438
Task_8469,1440,855,123,68,191,1.6822429906542056,32.10494903632514
Task_8470,1451,110,94,105,199,13.072072072072071,29.836558285099205
Task_8471,2669,86,115,119,234,30.67816091954023,48.936363924055435
Task_8472,2557,285,192,31,223,8.94055944055944,47.81760871131106
Task_8473,2017,570,49,162,211,3.532399299474606,40.94903812857733
Task_8474,1967,379,145,73,218,5.176315789473684,39.11777820954752
Task_8475,730,689,31,61,92,1.0579710144927537,19.417755387058637
Task_8476,2206,429,28,190,218,5.130232558139535,43.454864508603634
Task_8477,2747,580,91,187,278,4.728055077452668,52.78269707779662
Task_8478,2305,845,59,200,259,2.724586288416076,46.621887595237695
Task_8479,1247,878,58,183,241,1.4186575654152447,29.805449917339896
Task_8480,1076,158,126,105,231,6.767295597484277,24.438735361378917
Task_8481,2073,412,116,146,262,5.019370460048426,41.43836911629996
Task_8482,1763,403,73,28,101,4.3638613861386135,34.763348306642584
Task_8483,802,70,122,193,315,11.295774647887324,20.10873289854903
Task_8484,990,725,152,184,336,1.3636363636363635,25.621517979362324
Task_8485,2752,331,45,122,167,8.289156626506024,51.423023930362916
Task_8486,985,784,199,82,281,1.2547770700636942,25.25112269229966
Task_8487,1023,644,95,150,245,1.586046511627907,25.450880343127977
Task_8488,788,735,160,89,249,1.0706521739130435,21.859134630492424
Task_8489,1610,481,23,118,141,3.340248962655602,33.53806831127622
Task_8490,2238,345,113,22,135,6.468208092485549,42.364664272699734
Task_8491,2068,570,177,19,196,3.6217162872154116,40.81236674149796
Task_8492,2396,122,17,44,61,19.479674796747968,42.86103429783051
Task_8493,755,472,45,111,156,1.5961945031712474,20.06746410559857
Task_8494,639,780,15,58,73,0.8181818181818182,17.91857718719154
Task_8495,2583,904,15,12,27,2.85414364640884,48.39063014044432
Task_8496,1147,516,151,43,194,2.218568665377176,26.14425863963811
Task_8497,1883,350,188,61,249,5.364672364672365,37.716426692896974
Task_8498,2069,225,10,193,203,9.154867256637168,40.497989931185096
Task_8499,955,771,72,28,100,1.2370466321243523,23.143734538467545
Task_8500,1771,799,98,30,128,2.21375,36.575999260426876
Task_8501,1590,482,124,195,319,3.2919254658385095,34.34786012267602
Task_8502,2219,301,84,90,174,7.347682119205298,42.858443280760774
Task_8503,1362,636,68,146,214,2.1381475667189953,30.751024888082085
Task_8504,2583,530,107,161,268,4.864406779661017,49.9427548479938
Task_8505,1855,457,76,196,272,4.050218340611353,38.31924699012041
Task_8506,2541,332,95,125,220,7.63063063063063,48.36521726444252
Task_8507,1917,729,109,195,304,2.626027397260274,40.23749699357129
Task_8508,1767,104,136,124,260,16.82857142857143,35.04678857900436
Task_8509,1111,914,38,26,64,1.214207650273224,25.53550572070105
Task_8510,2513,912,48,156,204,2.7524644030668126,49.80449469514073
Task_8511,938,699,172,101,273,1.34,24.311449917716715
Task_8512,838,936,193,187,380,0.8943436499466382,24.08944711420715
Task_8513,2545,155,35,19,54,16.314102564102566,45.503498628954695
Task_8514,1494,334,161,176,337,4.459701492537313,32.40475884336245
Task_8515,1149,743,182,41,223,1.5443548387096775,27.009013216087197
Task_8516,1633,628,185,120,305,2.5961844197138313,35.31688542668973
Task_8517,2558,195,84,108,192,13.051020408163266,47.97714721966387
Task_8518,2123,475,181,161,342,4.4600840336134455,42.81661956806903
Task_8519,2804,502,69,67,136,5.57455268389662,52.341650330980336
Task_8520,1899,1019,198,103,301,1.861764705882353,40.707491901800566
Task_8521,1027,392,44,75,119,2.61323155216285,23.768161517212935
Task_8522,957,293,175,71,246,3.2551020408163267,22.973118273003234
Task_8523,568,886,35,66,101,0.6403607666290868,17.869037690330895
Task_8524,877,928,93,103,196,0.9440258342303552,23.769222404624486
Task_8525,1297,564,20,25,45,2.295575221238938,27.19428659893192
Task_8526,887,705,95,40,135,1.2563739376770537,22.233451292413463
Task_8527,2662,944,119,141,260,2.816931216931217,52.43600539586462
Task_8528,2453,170,152,102,254,14.345029239766081,46.27802254989073
Task_8529,1546,690,152,57,209,2.2373371924746746,33.295678390943685
Task_8530,974,837,135,49,184,1.162291169451074,24.438397793239442
Task_8531,2047,618,129,183,312,3.3069466882067853,41.966029259699674
Task_8532,2203,561,179,109,288,3.919928825622776,44.039024809879095
Task_8533,2945,780,145,92,237,3.770806658130602,56.17849268134162
Task_8534,740,483,163,57,220,1.5289256198347108,19.918592052568176
Task_8535,723,140,28,33,61,5.127659574468085,16.794209260237928
Task_8536,965,457,152,50,202,2.106986899563319,23.206202123481464
Task_8537,1263,278,180,86,266,4.526881720430108,28.048918054076054
Task_8538,2115,857,25,98,123,2.465034965034965,42.58390078883384
Task_8539,1887,704,38,103,141,2.676595744680851,38.632448134600914
Task_8540,1281,344,165,52,217,3.7130434782608694,28.08611340615224
Task_8541,2356,439,144,126,270,5.3545454545454545,46.01203176111227
Task_8542,1003,499,163,79,242,2.006,24.489647072381576
Task_8543,1001,265,66,148,214,3.763157894736842,23.86517645234024
Task_8544,1772,133,106,162,268,13.223880597014926,35.47811420155359
Task_8545,637,188,184,172,356,3.3703703703703702,18.490315226127723
Task_8546,1698,610,76,78,154,2.779050736497545,35.34218469268773
Task_8547,565,892,169,151,320,0.6326987681970885,19.429544023693875
Task_8548,840,800,141,153,294,1.048689138576779,23.229857265639936
Task_8549,1018,74,157,95,252,13.573333333333334,23.092498663291963
Task_8550,1138,795,73,19,92,1.42964824120603,25.973541894131795
Task_8551,2109,893,19,172,191,2.359060402684564,43.23382868800747
Task_8552,2267,969,197,109,306,2.337113402061856,46.41506700684221
Task_8553,923,766,130,15,145,1.2033898305084745,22.966683035310325
Task_8554,1181,420,85,134,219,2.8052256532066506,27.142867913035886
Task_8555,2716,966,85,46,131,2.8086866597724924,52.030432249050875
Task_8556,1563,531,16,41,57,2.93796992481203,31.488463529424852
Task_8557,2802,850,85,177,262,3.2925969447708576,54.428022245979776
Task_8558,928,895,65,171,236,1.0357142857142858,24.702922597999613
Task_8559,2074,249,60,155,215,8.296,40.77208468397944
Task_8560,657,161,92,17,109,4.055555555555555,16.324045994597057
Task_8561,1318,885,63,45,108,1.487584650112867,29.124459029122107
Task_8562,2258,894,105,14,119,2.522905027932961,44.15611731059342
Task_8563,2386,806,119,77,196,2.956629491945477,47.08281553914009
Task_8564,2304,673,40,71,111,3.4183976261127595,44.75471613639227
Task_8565,595,689,31,148,179,0.8623188405797102,18.44254366097567
Task_8566,600,409,173,42,215,1.4634146341463414,17.2456522536221
Task_8567,2139,145,87,143,230,14.650684931506849,41.134196066400996
Task_8568,1764,877,98,26,124,2.009111617312073,36.43346785372674
Task_8569,711,787,166,89,255,0.9022842639593909,20.875632119184896
Task_8570,1635,653,87,96,183,2.5,34.80474062805873
Task_8571,1026,472,39,116,155,2.1691331923890065,24.359850360253457
Task_8572,2132,421,96,109,205,5.052132701421801,42.09798840872488
Task_8573,1321,400,39,11,50,3.29426433915212,27.0101277928736
Task_8574,897,464,76,70,146,1.929032258064516,22.09837082321397
Task_8575,2077,627,29,47,76,3.3073248407643314,39.92990418091737
Task_8576,909,111,163,102,265,8.116071428571429,21.594437100002267
Task_8577,1589,553,99,47,146,2.868231046931408,32.979438774738774
Task_8578,2018,492,167,77,244,4.093306288032454,40.47807196080777
Task_8579,743,942,16,117,133,0.7879109225874867,21.27086782892305
Task_8580,1666,75,190,70,260,21.92105263157895,32.752137960759384
Task_8581,1835,412,36,184,220,4.443099273607748,37.553099753644844
Task_8582,576,803,192,61,253,0.7164179104477612,18.601513855859043
Task_8583,2015,649,176,94,270,3.1,41.23061894793374
Task_8584,868,356,98,11,109,2.4313725490196076,20.42634921595732
Task_8585,1045,435,59,129,188,2.396788990825688,24.94142125647339
Task_8586,1764,146,13,25,38,12.0,33.055810071009994
Task_8587,2813,979,121,27,148,2.870408163265306,53.64213964852979
Task_8588,1261,709,172,78,250,1.776056338028169,29.236821947980513
Task_8589,689,1008,54,181,235,0.6828543111992071,21.453912491343896
Task_8590,1368,599,158,27,185,2.28,29.810617996966943
Task_8591,743,317,42,193,235,2.3364779874213837,20.05482130173144
Task_8592,1869,620,199,145,344,3.0096618357487923,39.24180926617037
Task_8593,1441,822,158,79,237,1.7509113001215066,32.40365644735801
Task_8594,753,88,178,42,220,8.460674157303371,18.015587237899076
Task_8595,1434,791,44,71,115,1.8106060606060606,31.414751174988044
Task_8596,974,525,194,34,228,1.8517110266159695,23.576440226461187
Task_8597,796,258,136,41,177,3.0733590733590734,19.679097135807165
Task_8598,2867,480,120,127,247,5.960498960498961,54.132264072148416
Task_8599,554,454,88,112,200,1.2175824175824175,17.082289385809144
Task_8600,2182,624,182,149,331,3.4912,44.15884885154611
Task_8601,674,485,145,183,328,1.3868312757201646,19.82587933352522
Task_8602,2432,161,198,114,312,15.012345679012345,46.196541700864124
Task_8603,2750,864,18,95,113,3.179190751445087,52.609333873049586
Task_8604,2381,744,98,113,211,3.195973154362416,47.09986086337222
Task_8605,2956,1007,123,180,303,2.9325396825396823,57.542566463476895
Task_8606,2356,482,81,98,179,4.877846790890269,45.736864731047945
Task_8607,1061,479,93,81,174,2.2104166666666667,25.041943690025295
Task_8608,1762,793,141,113,254,2.2191435768261965,37.63644422065544
Task_8609,2097,174,128,185,313,11.982857142857142,41.040992236280154
Task_8610,2044,193,139,159,298,10.536082474226804,40.394596876168954
Task_8611,1603,529,165,189,354,3.0245283018867926,34.85178352702582
Task_8612,2174,821,75,98,173,2.6447688564476888,43.90523688238601
Task_8613,2757,663,82,155,237,4.15210843373494,53.01664952992967
Task_8614,2089,439,188,73,261,4.747727272727273,41.438114241035514
Task_8615,2030,920,18,133,151,2.204125950054289,41.62037464890383
Task_8616,1462,1023,175,194,369,1.427734375,34.18063573816975
Task_8617,1544,815,117,144,261,1.892156862745098,34.328159976204695
Task_8618,1082,704,116,109,225,1.5347517730496454,26.407531785301092
Task_8619,1078,96,148,12,160,11.11340206185567,22.573239152660033
Task_8620,2611,1005,58,37,95,2.595427435387674,49.91387879319456
Task_8621,875,673,145,55,200,1.2982195845697329,22.570591186439326
Task_8622,1498,410,193,92,285,3.6447688564476888,32.305474401403984
Task_8623,2729,724,160,86,246,3.7641379310344827,52.59725329039306
Task_8624,2811,407,179,60,239,6.889705882352941,52.54682260978033
Task_8625,1507,428,118,131,249,3.5128205128205128,32.452386549100375
Task_8626,2891,790,84,49,133,3.6548672566371683,54.34438104811636
Task_8627,2261,582,117,145,262,3.8782161234991426,44.959895066156264
Task_8628,1260,203,53,15,68,6.176470588235294,25.357853858855332
Task_8629,1744,68,162,30,192,25.27536231884058,33.25652951709332
Task_8630,1857,78,119,131,250,23.50632911392405,36.238184349771394
Task_8631,2752,469,55,39,94,5.85531914893617,50.45263285069214
Task_8632,856,1020,108,107,215,0.8383937316356513,23.769933655658292
Task_8633,2421,595,119,112,231,4.0620805369127515,47.3469306871033
Task_8634,1999,322,63,74,137,6.188854489164087,39.103482831076484
Task_8635,1774,970,49,113,162,1.826982492276004,37.924553401564495
Task_8636,2559,227,176,24,200,11.223684210526315,47.466617396474646
Task_8637,590,160,21,168,189,3.6645962732919255,16.594078961114466
Task_8638,874,259,33,153,186,3.3615384615384616,21.61879139355899
Task_8639,1874,653,33,31,64,2.8654434250764527,36.726042736010406
Task_8640,2582,79,61,32,93,32.275,45.474181201144454
Task_8641,1090,556,115,85,200,1.9569120287253141,25.89046303255714
Task_8642,2112,860,96,102,198,2.4529616724738674,43.12996028392751
Task_8643,2062,651,120,171,291,3.1625766871165646,42.195494007018276
Task_8644,1206,171,33,151,184,7.011627906976744,26.267798831607124
Task_8645,1369,1005,51,150,201,1.3608349900596421,31.926789930333246
Task_8646,2234,349,146,173,319,6.382857142857143,44.07353771367635
Task_8647,1399,327,195,83,278,4.265243902439025,30.405171969582867
Task_8648,877,194,115,123,238,4.4974358974358974,21.65188691776822
Task_8649,1250,685,125,167,292,1.8221574344023324,29.439235416905998
Task_8650,2820,694,142,12,154,4.057553956834532,52.77961952805686
Task_8651,1930,774,188,30,218,2.490322580645161,39.44934310744246
Task_8652,2356,579,27,165,192,4.062068965517241,46.15858193740535
Task_8653,557,620,79,100,179,0.8969404186795491,17.63541182801968
Task_8654,2579,224,181,136,317,11.462222222222222,49.01854023216828
Task_8655,2010,93,117,76,193,21.382978723404257,38.039188333486344
Task_8656,1592,193,52,177,229,8.206185567010309,33.032056302036644
Task_8657,1230,104,126,99,225,11.714285714285714,26.425963810614125
Task_8658,2474,720,76,177,253,3.4313453536754506,48.84339958099841
Task_8659,2329,805,142,151,293,2.889578163771712,46.88846536417922
Task_8660,1127,314,55,194,249,3.577777777777778,26.234857683191724
Task_8661,1856,708,125,95,220,2.617771509167842,38.69370957376554
Task_8662,928,644,35,51,86,1.4387596899224806,22.31437861718217
Task_8663,623,755,95,173,268,0.8240740740740741,19.597175567411643
Task_8664,1134,472,53,197,250,2.397463002114165,26.86175445647474
Task_8665,1285,164,29,197,226,7.787878787878788,27.807330868257306
Task_8666,2283,424,31,113,144,5.371764705882353,44.0288363509111
Task_8667,2413,451,132,99,231,5.338495575221239,46.73204358489048
Task_8668,1444,330,171,42,213,4.362537764350453,30.333883914851345
Task_8669,1732,565,55,40,95,3.060070671378092,34.60792509152071
Task_8670,544,318,11,96,107,1.7053291536050157,15.788187733330167
Task_8671,1253,450,56,51,107,2.778270509977827,26.987731015368013
Task_8672,2156,556,132,146,278,3.8707360861759423,43.288039440527854
Task_8673,516,241,142,88,230,2.1322314049586777,15.971215834610836
Task_8674,1571,185,148,52,200,8.446236559139784,32.09026805887216
Task_8675,826,954,37,148,185,0.8649214659685864,22.952934313017852
Task_8676,1680,576,167,122,289,2.9116117850953205,35.828365651964916
Task_8677,869,696,127,63,190,1.2467718794835008,22.531636774897606
Task_8678,738,378,28,183,211,1.9472295514511873,20.019771888384234
Task_8679,2370,631,103,54,157,3.75,45.82080349641953
Task_8680,2301,496,146,32,178,4.629778672032193,44.261318327418444
Task_8681,950,682,68,104,172,1.390922401171303,24.036328286606487
Task_8682,1750,772,179,86,265,2.263906856403622,37.324474754538336
Task_8683,2263,119,41,27,68,18.858333333333334,40.86558781027542
Task_8684,2123,385,104,67,171,5.5,41.27711252503365
Task_8685,1492,858,13,164,177,1.7369033760186263,33.22970981868867
Task_8686,1113,931,56,169,225,1.194206008583691,27.735321361127763
Task_8687,775,915,73,37,110,0.8460698689956332,20.900731362919945
Task_8688,998,579,178,28,206,1.7206896551724138,24.006477595174417
Task_8689,1234,741,57,38,95,1.6630727762803235,27.29565055748265
Task_8690,1466,725,63,68,131,2.0192837465564737,31.883074303849508
Task_8691,1780,369,17,142,159,4.8108108108108105,35.95748117238795
Task_8692,1752,691,18,11,29,2.531791907514451,34.58176792311005
Task_8693,555,659,138,39,177,0.8409090909090909,17.175212090384896
Task_8694,752,702,130,182,312,1.069701280227596,21.648661856622624
Task_8695,1968,592,163,44,207,3.318718381112985,39.43664807049465
Task_8696,1854,542,106,156,262,3.414364640883978,38.404157422744625
Task_8697,2460,76,75,152,227,31.948051948051948,45.68311570780708
Task_8698,2955,439,168,156,324,6.715909090909091,55.77975685525403
Task_8699,1843,399,129,135,264,4.6075,37.74932482096445
Task_8700,1836,453,179,155,334,4.044052863436123,38.1580426848856
Task_8701,1330,510,81,99,180,2.6027397260273974,29.57607482105175
Task_8702,2354,325,94,172,266,7.220858895705521,45.66002478260658
Task_8703,2026,961,15,54,69,2.106029106029106,40.371971488979426
Task_8704,588,725,189,182,371,0.8099173553719008,19.441003947770984
Task_8705,1116,373,71,119,190,2.983957219251337,25.862570911106996
Task_8706,2068,714,97,144,241,2.8923076923076922,42.231439317557054
Task_8707,2160,974,78,191,269,2.2153846153846155,44.755429579961856
Task_8708,1353,289,168,154,322,4.665517241379311,29.92661719859737
Task_8709,854,920,52,135,187,0.9272529858849077,23.345522721796517
Task_8710,1293,352,136,157,293,3.6628895184135977,29.058081860524524
Task_8711,975,343,22,16,38,2.8343023255813953,21.21302230072372
Task_8712,1045,550,127,194,321,1.896551724137931,25.941296470626174
Task_8713,1683,968,66,12,78,1.736842105263158,34.71673146431559
Task_8714,2015,743,46,141,187,2.7083333333333335,41.24754589389366
Task_8715,2237,680,24,170,194,3.2848751835535976,44.6075439929495
Task_8716,1711,909,144,54,198,1.8802197802197802,36.55499927566465
Task_8717,775,477,171,170,341,1.6213389121338913,21.47970797893022
Task_8718,2139,452,102,108,210,4.7218543046357615,42.32294207568474
Task_8719,2687,373,105,179,284,7.184491978609626,51.17161063874528
Task_8720,1764,369,32,79,111,4.767567567567568,35.3498396779304
Task_8721,1330,471,191,84,275,2.8177966101694913,29.76154873064088
Task_8722,770,710,147,112,259,1.0829817158931083,21.6166236067232
Task_8723,1704,375,157,199,356,4.531914893617022,35.98024676190245
Task_8724,800,540,139,55,194,1.478743068391867,20.93384002565503
Task_8725,1555,940,92,90,182,1.6524973432518597,34.39368159352805
Task_8726,2611,538,175,69,244,4.8441558441558445,49.88448898370563
Task_8727,1256,657,79,82,161,1.9088145896656534,28.62915609708072
Task_8728,628,856,111,107,218,0.7327887981330222,19.702925945517126
Task_8729,1767,559,198,82,280,3.155357142857143,36.981949048177064
Task_8730,2195,527,158,200,358,4.15719696969697,44.25271364429866
Task_8731,899,792,36,147,183,1.1336696090794451,23.583629924028134
Task_8732,1350,698,81,24,105,1.9313304721030042,29.084884703005766
Task_8733,2573,67,197,100,297,37.838235294117645,47.573071291582586
Task_8734,2462,414,132,24,156,5.932530120481927,46.27258592968948
Task_8735,1393,646,190,143,333,2.153013910355487,31.7320689328628
Task_8736,2570,973,90,85,175,2.6386036960985626,50.48498358428436
Task_8737,717,707,95,65,160,1.0127118644067796,19.838804177060794
Task_8738,831,227,139,42,181,3.6447368421052633,20.141327304240587
Task_8739,1686,893,111,85,196,1.8859060402684564,36.364186080425874
Task_8740,1115,983,31,180,211,1.133130081300813,27.792557187051923
Task_8741,593,1003,111,46,157,0.5906374501992032,18.933925718460618
Task_8742,2330,867,149,52,201,2.684331797235023,46.27869677934044
Task_8743,2822,976,54,180,234,2.8884339815762536,55.081345707904326
Task_8744,2841,188,195,149,344,15.031746031746032,53.18046168474808
Task_8745,506,916,141,179,320,0.5517993456924755,18.557068273843452
Task_8746,2907,406,123,21,144,7.142506142506143,53.23006006298107
Task_8747,1052,264,115,44,159,3.969811320754717,23.53321568694301
Task_8748,2368,985,91,11,102,2.4016227180527383,46.081109166514416
Task_8749,1623,921,183,19,202,1.7603036876355749,34.87859543662748
Task_8750,2504,287,28,48,76,8.694444444444445,45.62267792617672
Task_8751,1180,929,79,181,260,1.2688172043010753,28.955357537936766
Task_8752,863,668,184,176,360,1.289985052316891,23.514963729081998
Task_8753,1297,501,151,178,329,2.5836653386454183,29.789802709096524
Task_8754,1011,102,57,11,68,9.815533980582524,20.827306888011098
Task_8755,2440,277,66,119,185,8.776978417266188,46.44310609220378
Task_8756,706,501,112,80,192,1.406374501992032,19.52112280185923
Task_8757,1127,909,71,55,126,1.2384615384615385,26.8772602832759
Task_8758,1651,798,26,156,182,2.0663329161451816,35.583473308064704
Task_8759,2919,368,13,67,80,7.9105691056910565,52.978564285600775
Task_8760,2126,592,137,19,156,3.585160202360877,41.513640244928844
Task_8761,1449,497,18,85,103,2.9096385542168677,30.639569418204058
Task_8762,2479,215,91,12,103,11.476851851851851,45.35974987708914
Task_8763,2340,180,17,175,192,12.92817679558011,44.20109356724651
Task_8764,684,520,168,124,292,1.3128598848368522,19.85158041171024
Task_8765,2655,730,153,21,174,3.632010943912449,50.510336428660075
Task_8766,2970,635,198,41,239,4.669811320754717,55.58936159292225
Task_8767,1712,577,157,188,345,2.961937716262976,36.687402475071714
Task_8768,667,505,121,185,306,1.3181818181818181,19.688216732221278
Task_8769,2501,795,120,161,281,3.141959798994975,49.54270841330119
Task_8770,1452,1008,92,102,194,1.4390485629335976,33.06380226220599
Task_8771,2143,594,153,11,164,3.6016806722689076,41.93404045989634
Task_8772,766,743,117,52,169,1.0295698924731183,20.940904801928223
Task_8773,2318,138,54,169,223,16.676258992805757,43.94487909436882
Task_8774,2798,283,105,43,148,9.852112676056338,51.16772530140826
Task_8775,1365,656,31,152,183,2.077625570776256,30.620293828914487
Task_8776,2114,863,90,58,148,2.446759259259259,42.50243459943497
Task_8777,1282,247,63,95,158,5.169354838709677,27.75662043161056
Task_8778,2151,874,132,158,290,2.458285714285714,44.280627399689855
Task_8779,2730,277,16,58,74,9.820143884892087,49.32845653671992
Task_8780,2568,977,151,115,266,2.625766871165644,51.03833293965414
Task_8781,1660,657,57,100,157,2.522796352583587,35.01346712827661
Task_8782,1647,326,11,110,121,5.036697247706422,33.44053765454015
Task_8783,2730,509,43,145,188,5.352941176470588,51.8214189094748
Task_8784,2280,811,183,84,267,2.8078817733990147,45.8409293544363
Task_8785,1668,264,170,29,199,6.29433962264151,33.577832976840405
Task_8786,814,291,193,53,246,2.787671232876712,20.66980183535335
Task_8787,1834,413,48,74,122,4.429951690821256,36.65106790692557
Task_8788,1953,238,154,163,317,8.171548117154812,39.22289031471978
Task_8789,1402,196,54,128,182,7.116751269035533,29.761834964300217
Task_8790,2699,289,193,165,358,9.306896551724138,51.38321152704731
Task_8791,2131,618,137,157,294,3.4426494345718903,43.17712499171347
Task_8792,1350,324,169,151,320,4.153846153846154,29.981313258938545
Task_8793,938,864,72,108,180,1.084393063583815,24.395016498146543
Task_8794,1350,954,173,34,207,1.4136125654450262,30.771943900632465
Task_8795,1648,293,41,49,90,5.605442176870748,32.5494356813479
Task_8796,1915,846,24,186,210,2.260920897284534,40.12194241217935
Task_8797,1069,625,37,84,121,1.707667731629393,25.28365783457083
Task_8798,2724,831,105,39,144,3.2740384615384617,51.75933704101217
Task_8799,1277,769,57,84,141,1.6584415584415584,29.223764148162484
Task_8800,1111,272,93,19,112,4.069597069597069,24.10130036625684
Task_8801,793,743,159,41,200,1.0658602150537635,21.282695103378824
Task_8802,2162,64,35,49,84,33.261538461538464,38.73962547737296
Task_8803,1686,96,26,127,153,17.38144329896907,32.71839974855258
Task_8804,2296,406,81,182,263,5.641277641277641,45.058104896340275
Task_8805,1993,328,169,177,346,6.057750759878419,40.31869853798356
Task_8806,2951,1009,60,131,191,2.9217821782178217,56.96232892834136
Task_8807,1190,322,19,45,64,3.6842105263157894,24.870910108295664
Task_8808,2767,295,114,140,254,9.347972972972974,51.974303516646636
Task_8809,2968,1016,149,126,275,2.9183874139626353,57.55546506669649
Task_8810,1684,978,114,69,183,1.7201225740551582,36.26310181131661
Task_8811,1897,879,16,189,205,2.1556818181818183,39.906572961850145
Task_8812,1302,208,100,16,116,6.229665071770335,26.822296628041045
Task_8813,1192,365,194,20,214,3.2568306010928962,26.37637642804481
Task_8814,2377,1018,197,194,391,2.3326790971540725,48.818440055153
Task_8815,2645,98,187,162,349,26.717171717171716,49.199180280041254
Task_8816,2800,373,173,100,273,7.4866310160427805,52.79396314716784
Task_8817,2008,743,110,113,223,2.6989247311827955,41.23764152594068
Task_8818,2591,928,149,182,331,2.7890204520990314,51.641084643348826
Task_8819,1036,675,149,26,175,1.532544378698225,24.747521851040975
Task_8820,1359,287,91,189,280,4.71875,29.876159561594264
Task_8821,1135,474,143,132,275,2.389473684210526,26.829241423565765
Task_8822,1010,759,196,150,346,1.3289473684210527,26.039114442299013
Task_8823,591,688,115,57,172,0.8577648766328012,18.009763351179902
Task_8824,1918,575,108,63,171,3.329861111111111,38.63009087729497
Task_8825,2652,940,142,139,281,2.818278427205101,52.356771331165284
Task_8826,2209,971,12,148,160,2.272633744855967,44.67198192349395
Task_8827,2793,122,26,61,87,22.70731707317073,49.619880996483566
Task_8828,1765,108,121,61,182,16.192660550458715,34.137302072962335
Task_8829,2885,871,199,145,344,3.30848623853211,56.12561485731959
Task_8830,574,626,27,182,209,0.9154704944178629,18.085389970761838
Task_8831,2599,244,104,114,218,10.608163265306123,48.93230176107443
Task_8832,2059,286,146,64,210,7.174216027874564,40.16337786957163
Task_8833,1842,692,13,96,109,2.658008658008658,37.589458294117044
Task_8834,1617,104,36,10,46,15.4,30.321191866224776
Task_8835,2159,900,173,119,292,2.3962264150943398,44.44031203502567
Task_8836,668,283,151,18,169,2.352112676056338,17.568614058662792
Task_8837,2610,423,45,102,147,6.15566037735849,49.239861850613586
Task_8838,2630,570,146,91,237,4.605954465849387,50.518120443798274
Task_8839,1301,697,167,10,177,1.8638968481375358,28.9532329550353
Task_8840,1455,947,123,94,217,1.5348101265822784,33.006993695521125
Task_8841,2878,682,197,15,212,4.2137628111273795,54.04769953891117
Task_8842,935,353,98,188,286,2.6412429378531073,23.416504015990196
Task_8843,2069,458,180,165,345,4.507625272331155,41.92638377363185
Task_8844,1350,890,37,170,207,1.5151515151515151,31.267579694155597
Task_8845,1492,661,71,113,184,2.2537764350453173,32.65365214272328
Task_8846,1660,103,128,40,168,15.961538461538462,32.15472999978242
Task_8847,835,600,68,10,78,1.3893510815307821,20.1374832998944
Task_8848,2783,116,55,174,229,23.786324786324787,51.09972063263145
Task_8849,1694,105,160,86,246,15.981132075471699,33.645035401440566
Task_8850,811,396,95,45,140,2.042821158690176,20.08166801373096
Task_8851,2783,735,37,147,184,3.78125,53.35342532935391
Task_8852,2857,120,136,183,319,23.611570247933884,52.726331503074995
Task_8853,1493,292,69,136,205,5.09556313993174,31.66859156196031
Task_8854,573,594,133,22,155,0.9630252100840336,17.054642454454136
Task_8855,2296,237,92,25,117,9.647058823529411,42.710745336073536
Task_8856,1853,300,128,96,224,6.156146179401993,37.36995747577742
Task_8857,2757,623,94,188,282,4.418269230769231,53.108894166374846
Task_8858,2587,274,150,173,323,9.407272727272728,49.41284900313995
Task_8859,1525,366,45,58,103,4.155313351498638,31.0582357096467
Task_8860,2397,585,63,28,91,4.090443686006826,45.184088321855505
Task_8861,2020,1003,167,186,353,2.0119521912350598,42.93135282345577
Task_8862,1168,798,189,177,366,1.4618272841051314,28.786029908250992
Task_8863,689,885,155,190,345,0.7776523702031602,21.44474407786923
Task_8864,1894,616,135,137,272,3.0696920583468397,39.2888957015942
Task_8865,2099,666,134,122,256,3.1469265367316344,42.599218127646644
Task_8866,2178,345,185,14,199,6.294797687861272,41.81451511797112
Task_8867,2378,81,199,170,369,29.0,45.00861551036515
Task_8868,2100,633,27,103,130,3.312302839116719,41.74772643678637
Task_8869,2459,398,141,44,185,6.162907268170426,46.47097304858221
Task_8870,2040,831,61,149,210,2.451923076923077,42.08108116063503
Task_8871,892,378,65,92,157,2.3535620052770447,21.95915614381776
Task_8872,883,453,38,156,194,1.9449339207048457,22.454223536418326
Task_8873,2486,234,103,27,130,10.578723404255319,45.924171717384525
Task_8874,2612,807,194,121,315,3.232673267326733,51.43355742324896
Task_8875,1426,877,110,75,185,1.6241457858769932,32.00256045683042
Task_8876,2573,852,85,50,135,3.0164126611957798,49.4721437338876
Task_8877,578,764,78,131,209,0.7555555555555555,18.639318643259934
Task_8878,1399,926,28,197,225,1.5091693635382957,32.24251810016278
Task_8879,2606,823,98,13,111,3.162621359223301,49.46006186993828
Task_8880,1952,482,42,199,241,4.041407867494824,39.74935395175391
Task_8881,701,968,107,102,209,0.7234262125902993,21.20905315758689
Task_8882,2796,544,87,142,229,5.130275229357798,53.11703709747389
Task_8883,2165,807,23,190,213,2.6794554455445545,43.980488736367896
Task_8884,768,268,129,177,306,2.8550185873605947,20.572419403065663
Task_8885,1836,642,162,138,300,2.855365474339036,38.57985442032348
Task_8886,2377,611,22,118,140,3.883986928104575,46.08190556103924
Task_8887,1832,432,33,86,119,4.23094688221709,36.71722922697856
Task_8888,1851,130,174,177,351,14.129770992366412,37.10055852177604
Task_8889,1969,811,128,167,295,2.4248768472906406,41.23610496263466
Task_8890,2437,641,161,92,253,3.79595015576324,47.76443629869545
Task_8891,1152,183,130,87,217,6.260869565217392,25.730258988534242
Task_8892,2179,323,188,91,279,6.7253086419753085,42.7603065799722
Task_8893,2041,745,84,82,166,2.7359249329758715,41.42509190629146
Task_8894,734,806,129,63,192,0.909541511771995,20.827426006268652
Task_8895,1339,721,44,91,135,1.8545706371191135,29.986215946142934
Task_8896,2498,843,101,136,237,2.9597156398104265,49.41065185819713
Task_8897,1505,532,72,149,221,2.823639774859287,32.71148841034939
Task_8898,693,177,170,141,311,3.893258426966292,18.81206740854147
Task_8899,1409,274,135,42,177,5.123636363636364,29.421368676826905
Task_8900,2345,94,184,22,206,24.68421052631579,42.893173711962994
Task_8901,912,943,19,66,85,0.9661016949152542,23.20740639875167
Task_8902,2527,295,161,188,349,8.537162162162161,48.678538486443756
Task_8903,2631,812,33,170,203,3.236162361623616,51.32363070380103
Task_8904,567,837,88,171,259,0.6766109785202864,19.026903758694417
Task_8905,689,148,167,192,359,4.624161073825503,19.00452823374731
Task_8906,980,971,17,59,76,1.008230452674897,23.813999112892756
Task_8907,1096,330,132,100,232,3.311178247734139,25.512506438226144
Task_8908,2678,623,145,85,230,4.291666666666667,51.385051805850075
Task_8909,1500,489,52,154,206,3.061224489795918,32.44801628536778
Task_8910,1712,136,39,37,76,12.496350364963504,32.37461547511467
Task_8911,1929,531,86,188,274,3.6259398496240602,39.61796730649661
Task_8912,2668,79,29,109,138,33.35,47.969668240851064
Task_8913,2875,865,159,10,169,3.31986143187067,54.34733922276962
Task_8914,1992,531,151,62,213,3.744360902255639,39.87565647231684
Task_8915,2423,589,120,171,291,4.106779661016949,47.716411875896576
Task_8916,595,276,27,200,227,2.148014440433213,17.531573311537922
Task_8917,2996,218,142,116,258,13.680365296803654,55.28470509048858
Task_8918,2704,207,191,190,381,13.0,51.29250355379171
Task_8919,2652,172,144,123,267,15.329479768786127,49.503378649138995
Task_8920,1074,704,79,109,188,1.523404255319149,26.16485447066349
Task_8921,1320,426,76,18,94,3.091334894613583,27.662382875403242
Task_8922,2406,153,77,134,211,15.623376623376624,45.41472779073447
Task_8923,818,88,103,159,262,9.191011235955056,20.10366279036666
Task_8924,1486,329,187,158,345,4.503030303030303,32.27146766503744
Task_8925,1925,555,197,140,337,3.462230215827338,39.884216893266185
Task_8926,2852,162,125,148,273,17.496932515337424,52.697997109970714
Task_8927,1902,881,48,184,232,2.1564625850340136,40.19362919307789
Task_8928,2533,629,132,111,243,4.020634920634921,49.281397366188344
Task_8929,1763,279,168,44,212,6.296428571428572,35.197821682354636
Task_8930,1780,701,133,18,151,2.5356125356125356,36.342482507277076
Task_8931,1858,296,175,77,252,6.255892255892256,37.339251009359856
Task_8932,2473,153,120,21,141,16.058441558441558,45.146859844529125
Task_8933,1711,479,185,182,367,3.564583333333333,36.45101891298402
Task_8934,2369,918,20,75,95,2.5778019586507073,46.296899469233864
Task_8935,948,1020,118,132,250,0.9285014691478942,25.43010553407603
Task_8936,2627,119,69,187,256,21.891666666666666,48.88646673796265
Task_8937,2100,238,72,179,251,8.786610878661088,41.33096510194342
Task_8938,2638,552,171,10,181,4.770343580470163,49.67996272055655
Task_8939,939,881,14,114,128,1.064625850340136,24.202248886765506
Task_8940,515,1017,12,111,123,0.5058939096267191,17.851037899522584
Task_8941,613,793,184,155,339,0.7720403022670025,19.877973019614405
Task_8942,1717,975,126,193,319,1.7592213114754098,37.886394634589486
Task_8943,2234,512,72,171,243,4.354775828460039,44.321238921696484
Task_8944,714,901,126,22,148,0.7915742793791575,20.176970549132786
Task_8945,1721,311,30,187,217,5.516025641025641,35.39672443995427
Task_8946,1254,282,66,130,196,4.431095406360424,27.8127104575715
Task_8947,717,343,187,96,283,2.0843023255813953,19.8121181011261
Task_8948,2295,234,21,167,188,9.76595744680851,44.00318799500307
Task_8949,563,231,85,196,281,2.4267241379310347,17.134700893919028
Task_8950,1402,705,74,149,223,1.9858356940509916,31.632498201112554
Task_8951,2855,315,167,198,365,9.034810126582279,54.02197327417963
Task_8952,2923,194,115,199,314,14.98974358974359,54.39586763377611
Task_8953,2947,375,12,162,174,7.837765957446808,54.712995817528075
Task_8954,2117,445,183,105,288,4.746636771300448,42.29919636751084
Task_8955,1292,257,30,65,95,5.007751937984496,27.08680831448045
Task_8956,962,926,118,59,177,1.0377562028047465,24.607205457646003
Task_8957,1855,728,83,34,117,2.544581618655693,37.33265727773348
Task_8958,1742,185,97,42,139,9.365591397849462,34.046420337339335
Task_8959,2070,427,94,200,294,4.836448598130841,41.673476174581054
Task_8960,723,933,47,153,200,0.7740899357601713,21.4189489204655
Task_8961,2126,191,192,83,275,11.072916666666666,41.438273777660314
Task_8962,1099,597,126,93,219,1.8377926421404682,26.319157013900426
Task_8963,642,175,106,105,211,3.647727272727273,17.517974241161465
Task_8964,2151,169,10,66,76,12.652941176470588,39.766659496730206
Task_8965,1238,514,132,35,167,2.403883495145631,27.4367885703075
Task_8966,2557,407,200,193,393,6.267156862745098,49.7402508609627
Task_8967,2810,817,95,110,205,3.43520782396088,54.10034883410457
Task_8968,2568,573,13,127,140,4.473867595818815,48.9936329273064
Task_8969,2828,840,73,148,221,3.3626634958382877,54.635217072759964
Task_8970,2308,906,162,169,331,2.5446527012127893,47.06905132818235
Task_8971,2824,842,197,91,288,3.3499406880189797,54.681651947116166
Task_8972,1850,394,99,105,204,4.6835443037974684,37.531078184632925
Task_8973,870,740,60,63,123,1.174089068825911,22.285920327689734
Task_8974,2806,442,55,48,103,6.334085778781039,51.31714936520199
Task_8975,2178,986,81,171,252,2.2066869300911853,44.95842265314959
Task_8976,1078,91,76,81,157,11.717391304347826,23.217639448401158
Task_8977,1185,733,16,179,195,1.6144414168937329,28.09863153804629
Task_8978,1126,741,122,128,250,1.517520215633423,27.36008484524919
Task_8979,1420,637,73,48,121,2.225705329153605,30.286569139861474
Task_8980,1065,980,73,101,174,1.0856269113149848,26.7284768677774
Task_8981,661,577,104,86,190,1.143598615916955,19.057309892236994
Task_8982,2665,532,41,29,70,5.0,48.91467033872912
Task_8983,963,220,31,195,226,4.357466063348416,23.15767315405785
Task_8984,821,487,200,125,325,1.6823770491803278,22.101110320762512
Task_8985,871,413,158,187,345,2.103864734299517,22.854483969430472
Task_8986,957,978,66,17,83,0.9775280898876404,23.701037609827193
Task_8987,739,371,96,183,279,1.9865591397849462,20.337640449986292
Task_8988,2316,989,17,151,168,2.3393939393939394,46.607070518792234
Task_8989,1489,663,11,174,185,2.2424698795180724,32.61475593044589
Task_8990,546,772,61,159,220,0.7063389391979301,18.34845467254975
Task_8991,2165,421,51,63,114,5.130331753554502,41.77152239922681
Task_8992,1642,949,43,28,71,1.7284210526315789,34.02980533544548
Task_8993,2676,908,37,193,230,2.943894389438944,52.51025921624204
Task_8994,1148,493,74,95,169,2.3238866396761133,26.60746561081938
Task_8995,2276,411,39,32,71,5.524271844660194,42.349948629667324
Task_8996,2924,664,122,54,176,4.396992481203007,54.887674684682146
Task_8997,1803,311,118,90,208,5.778846153846154,36.47563640020977
Task_8998,2568,323,48,196,244,7.925925925925926,49.02298161619337
Task_8999,998,872,173,163,336,1.143184421534937,26.151279363102322
Task_9000,2558,490,60,78,138,5.209775967413442,48.57220587099414
Task_9001,1245,689,114,161,275,1.8043478260869565,29.28708816891806
Task_9002,1109,112,132,25,157,9.814159292035399,23.405068357412393
Task_9003,1409,873,87,106,193,1.6121281464530892,31.95412823600826
Task_9004,2650,728,190,130,320,3.635116598079561,51.822775657104955
Task_9005,2588,239,101,38,139,10.783333333333333,47.61232468323578
Task_9006,1940,651,172,122,294,2.9754601226993866,40.20487402710313
Task_9007,1437,390,39,125,164,3.6751918158567776,30.793165723365007
Task_9008,1232,122,170,112,282,10.016260162601625,26.897406763664378
Task_9009,1432,428,14,89,103,3.337995337995338,30.136390526323567
Task_9010,623,600,117,70,187,1.0366056572379367,18.32643865557399
Task_9011,1884,921,120,131,251,2.0433839479392626,39.98099015098243
Task_9012,621,504,48,198,246,1.2297029702970297,18.73698299237949
Task_9013,732,277,88,52,140,2.633093525179856,18.684923326627473
Task_9014,821,440,131,45,176,1.8616780045351473,20.641156887435866
Task_9015,1723,322,40,11,51,5.3343653250774,33.11336642971748
Task_9016,1503,814,192,59,251,1.8441717791411043,33.18266487393313
Task_9017,1774,221,123,125,248,7.990990990990991,35.967322752444375
Task_9018,1354,836,193,124,317,1.6176821983273597,31.592790383208534
Task_9019,510,387,64,126,190,1.3144329896907216,16.285028905623324
Task_9020,1591,66,23,168,191,23.746268656716417,31.79293550787061
Task_9021,756,580,183,48,231,1.3012048192771084,20.35916742695077
Task_9022,2109,765,155,52,207,2.7532637075718016,42.48528698851752
Task_9023,1412,680,46,190,236,2.0734214390602057,31.804739620200845
Task_9024,1478,979,166,58,224,1.5081632653061225,33.170284119351386
Task_9025,2603,346,98,191,289,7.501440922190202,49.795477400115054
Task_9026,2033,329,98,109,207,6.16060606060606,40.232742528629565
Task_9027,2151,231,177,144,321,9.27155172413793,42.315048318782864
Task_9028,1497,856,166,96,262,1.7467911318553093,33.66001720507183
Task_9029,2424,535,37,199,236,4.522388059701493,47.37668903131561
Task_9030,1148,723,186,22,208,1.5856353591160222,26.78195927218611
Task_9031,2403,1015,28,114,142,2.3651574803149606,47.774411015269244
Task_9032,2209,945,67,51,118,2.3350951374207187,43.906122295401815
Task_9033,1293,829,63,79,142,1.5578313253012048,29.61425527008105
Task_9034,2346,272,33,24,57,8.593406593406593,42.956663375283654
Task_9035,2431,1000,50,125,175,2.4285714285714284,48.61587085575538
Task_9036,2361,73,127,37,164,31.905405405405407,42.748192087074784
Task_9037,1741,800,26,124,150,2.1735330836454434,36.65302753362642
Task_9038,2412,758,191,115,306,3.177865612648221,48.061810655987806
Task_9039,1480,887,166,20,186,1.6666666666666667,32.434156048443604
Task_9040,1914,986,191,141,332,1.939209726443769,41.03814805602253
Task_9041,2129,976,73,173,246,2.1791197543500513,44.13335668314284
Task_9042,512,979,80,176,256,0.5224489795918368,18.716301162984312
Task_9043,734,226,102,170,272,3.2334801762114536,19.73445667295767
Task_9044,1481,499,85,193,278,2.962,32.49459544756006
Task_9045,2817,320,14,183,197,8.77570093457944,52.64307144976035
Task_9046,1115,870,36,82,118,1.2801377726750862,26.67411791799432
Task_9047,1858,222,106,33,139,8.331838565022421,36.01077780500942
Task_9048,783,140,117,186,303,5.553191489361702,20.150089026137554
Task_9049,787,648,185,135,320,1.2126348228043142,22.005424349547436
Task_9050,2056,634,115,130,245,3.237795275590551,41.77942381529505
Task_9051,920,377,83,122,205,2.433862433862434,22.82523363213339
Task_9052,2457,392,55,142,197,6.251908396946565,47.21953145378557
Task_9053,620,413,105,161,266,1.497584541062802,18.445581493000244
Task_9054,2252,923,156,150,306,2.4372294372294374,46.09418104073516
Task_9055,1222,538,33,138,171,2.267161410018553,27.8998471660083
Task_9056,1336,598,150,119,269,2.2303839732888147,30.355418117921317
Task_9057,993,646,56,140,196,1.534775888717156,24.805301626181443
Task_9058,2249,360,56,127,183,6.229916897506925,43.699130206903014
Task_9059,2321,158,22,117,139,14.59748427672956,43.21362983312648
Task_9060,520,189,103,153,256,2.736842105263158,16.142745079451803
Task_9061,2112,643,117,45,162,3.279503105590062,41.583230641302976
Task_9062,2099,949,160,78,238,2.2094736842105265,43.215751210044566
Task_9063,1288,406,82,127,209,3.1646191646191646,28.77215518477189
Task_9064,1861,443,185,62,247,4.191441441441442,37.673196339875226
Task_9065,744,781,170,113,283,0.9514066496163683,21.581789194893005
Task_9066,2283,980,80,125,205,2.327217125382263,46.32439998428754
Task_9067,979,574,130,98,228,1.702608695652174,24.405429737341837
Task_9068,2192,491,176,196,372,4.455284552845528,44.1469518057119
Task_9069,739,210,145,10,155,3.5023696682464456,18.31273390832811
Task_9070,2148,304,76,45,121,7.0426229508196725,40.6399513851427
Task_9071,1357,746,106,172,278,1.8165997322623828,31.26847155479349
Task_9072,2906,183,101,118,219,15.793478260869565,53.47182976814643
Task_9073,718,690,106,79,185,1.0390738060781477,20.248072648802427
Task_9074,1597,394,22,184,206,4.0430379746835445,33.63272062907011
Task_9075,1147,758,23,37,60,1.5111989459815547,25.583430494221414
Task_9076,1741,801,195,189,384,2.1708229426433916,38.026017211803754
Task_9077,1836,894,160,177,337,2.0513966480446926,39.59145328739963
Task_9078,2975,555,89,123,212,5.350719424460432,55.901064658542964
Task_9079,870,405,14,95,109,2.142857142857143,21.296656738010412
Task_9080,1844,829,81,20,101,2.221686746987952,37.26509943828412
Task_9081,2275,462,149,171,320,4.913606911447085,45.096143323584386
Task_9082,1414,424,188,55,243,3.327058823529412,30.524385796833386
Task_9083,2026,551,106,22,128,3.670289855072464,39.77325199075821
Task_9084,1982,896,165,148,313,2.20958751393534,41.760397607960165
Task_9085,1381,997,164,147,311,1.3837675350701404,32.48613702203292
Task_9086,564,597,123,197,320,0.9431438127090301,18.445615525490492
Task_9087,974,84,65,157,222,11.458823529411765,22.403369216654227
Task_9088,502,135,144,95,239,3.6911764705882355,15.265150741234166
Task_9089,2602,337,21,46,67,7.6982248520710055,47.293335651270134
Task_9090,1971,764,15,163,178,2.5764705882352943,40.54914671693056
Task_9091,2278,853,151,200,351,2.667447306791569,46.56382102795504
Task_9092,1864,722,72,90,162,2.5781466113416323,38.53376203099821
Task_9093,643,557,102,83,185,1.1523297491039426,18.64531559966873
Task_9094,2561,627,105,130,235,4.078025477707007,49.71029607298177
Task_9095,2588,272,101,152,253,9.47985347985348,49.07513962028194
Task_9096,862,669,163,73,236,1.2865671641791045,22.60278022360357
Task_9097,1987,262,112,25,137,7.555133079847908,38.12475103813779
Task_9098,930,751,163,104,267,1.2367021276595744,24.305874114581133
Task_9099,2279,690,156,43,199,3.298118668596237,44.64158059658157
Task_9100,892,575,186,48,234,1.5486111111111112,22.49938306118145
Task_9101,1707,604,164,33,197,2.821487603305785,35.29035789428584
Task_9102,1972,327,63,177,240,6.012195121951219,39.57259643949003
Task_9103,974,703,172,42,214,1.3835227272727273,24.076538451450705
Task_9104,1322,443,173,52,225,2.9774774774774775,29.08859267620282
Task_9105,715,977,147,64,211,0.7310838445807771,21.148663277950163
Task_9106,2987,776,135,44,179,3.844272844272844,56.02136361685914
Task_9107,1630,487,109,142,251,3.3401639344262297,34.61281553330141
Task_9108,2866,752,162,115,277,3.806108897742364,55.10446033348982
Task_9109,1372,759,119,134,253,1.805263157894737,31.378191452914802
Task_9110,811,289,178,83,261,2.796551724137931,20.907499163878512
Task_9111,1817,173,41,97,138,10.442528735632184,35.3613189504431
Task_9112,1019,946,71,77,148,1.0760295670538542,25.606217441881224
Task_9113,600,745,12,88,100,0.8042895442359249,17.865249527912912
Task_9114,668,316,159,71,230,2.107255520504732,18.40547131782877
Task_9115,1916,727,140,151,291,2.631868131868132,40.09229999342863
Task_9116,1421,120,31,18,49,11.743801652892563,27.436198723750646
Task_9117,934,390,103,193,296,2.3887468030690537,23.566567436668436
Task_9118,1180,703,65,73,138,1.6761363636363635,27.31014898001928
Task_9119,1296,707,79,45,124,1.8305084745762712,28.492209669767657
Task_9120,2235,983,103,200,303,2.2713414634146343,46.071425475470505
Task_9121,1141,864,103,148,251,1.3190751445086706,28.00911042566082
Task_9122,1327,136,42,164,206,9.686131386861314,28.171336124653305
Task_9123,2239,453,93,39,132,4.931718061674009,42.91771873356638
Task_9124,2402,550,89,32,121,4.35934664246824,45.49870255023569
Task_9125,1847,189,20,30,50,9.721052631578948,34.90941212410087
Task_9126,1280,451,44,78,122,2.831858407079646,28.028321243782923
Task_9127,2674,128,190,129,319,20.728682170542637,49.83464070207841
Task_9128,850,225,12,16,28,3.7610619469026547,18.783092550332658
Task_9129,2813,797,173,152,325,3.525062656641604,54.67713030032174
Task_9130,2825,260,104,64,168,10.82375478927203,51.943106331656004
Task_9131,2472,454,91,31,122,5.432967032967033,46.33875426207084
Task_9132,539,280,186,112,298,1.9181494661921707,16.86016040250615
Task_9133,2264,253,140,16,156,8.913385826771654,42.54988426554714
Task_9134,1396,565,183,166,349,2.4664310954063606,31.631441259352375
Task_9135,1875,507,28,190,218,3.690944881889764,38.46683163463225
Task_9136,2382,157,21,198,219,15.075949367088608,45.031794023279836
Task_9137,2474,853,23,167,190,2.8969555035128804,48.87966766486743
Task_9138,2895,569,116,186,302,5.078947368421052,55.198391592930875
Task_9139,1798,1006,198,117,315,1.785501489572989,39.150193508038406
Task_9140,2960,206,20,20,40,14.29951690821256,52.13213338778653
Task_9141,1947,944,151,195,346,2.06031746031746,41.57280200326383
Task_9142,2291,782,121,198,319,2.925925925925926,46.4004537319355
Task_9143,2087,750,119,15,134,2.7789613848202395,41.24622384183973
Task_9144,1069,857,129,79,208,1.245920745920746,26.44440258867365
Task_9145,922,361,136,113,249,2.546961325966851,22.955431567055015
Task_9146,2220,306,105,141,246,7.231270358306189,43.329932751210755
Task_9147,2483,879,94,59,153,2.8215909090909093,48.3416282892141
Task_9148,1989,101,67,112,179,19.5,38.14861775335583
Task_9149,569,513,113,135,248,1.1070038910505837,17.809961408337063
Task_9150,1057,79,136,153,289,13.2125,23.921139122325844
Task_9151,2348,142,14,84,98,16.41958041958042,43.06756678657367
Task_9152,2038,931,23,130,153,2.186695278969957,41.77204080188599
Task_9153,2557,299,191,55,246,8.523333333333333,48.20281350473784
Task_9154,1181,701,174,86,260,1.6823361823361824,28.057469317256874
Task_9155,1417,192,169,138,307,7.341968911917099,30.50957693259888
Task_9156,2290,401,128,14,142,5.696517412935323,43.38319086355134
Task_9157,1891,953,172,170,342,1.9821802935010482,40.65872016094645
Task_9158,1906,86,49,77,126,21.908045977011493,35.96016826675411
Task_9159,2647,239,106,131,237,11.029166666666667,49.78226369262128
Task_9160,1532,171,185,79,264,8.906976744186046,31.652431037964277
Task_9161,2191,716,73,127,200,3.0557880055788007,44.02867672138874
Task_9162,2807,249,32,144,176,11.228,52.06736143486683
Task_9163,1897,737,160,186,346,2.5704607046070462,40.12182360200114
Task_9164,2314,547,95,177,272,4.2226277372262775,45.78983783445588
Task_9165,1313,845,68,97,165,1.5520094562647755,30.309673277922155
Task_9166,1896,194,159,176,335,9.723076923076922,38.24865456364046
Task_9167,525,689,60,114,174,0.7608695652173914,17.374829559093758
Task_9168,2701,90,135,178,313,29.681318681318682,49.91793235019691
Task_9169,1478,904,163,62,225,1.6331491712707182,32.96203287993451
Task_9170,1908,531,196,175,371,3.5864661654135337,39.74333003645291
Task_9171,663,281,193,34,227,2.351063829787234,17.88034312782
Task_9172,2557,314,178,183,361,8.117460317460317,49.26621821927629
Task_9173,1810,380,40,167,207,4.7506561679790025,36.965048709556115
Task_9174,1611,185,49,63,112,8.661290322580646,32.07572822824306
Task_9175,1686,488,148,129,277,3.4478527607361964,35.60063775560154
Task_9176,1968,923,33,96,129,2.1298701298701297,40.67518392264696
Task_9177,2470,403,113,18,131,6.1138613861386135,46.213043932538994
Task_9178,2921,102,40,72,112,28.359223300970875,51.716526293048304
Task_9179,2710,82,95,33,128,32.65060240963855,48.12269003628564
Task_9180,652,432,49,137,186,1.5057736720554273,18.682777430542444
Task_9181,743,376,28,156,184,1.9708222811671088,19.897133019048585
Task_9182,764,489,27,17,44,1.5591836734693878,18.395918207403458
Task_9183,2099,972,107,156,263,2.157245632065776,43.63727286160778
Task_9184,953,188,125,83,208,5.042328042328043,22.655871568004283
Task_9185,811,77,85,45,130,10.397435897435898,18.060626872699643
Task_9186,1412,881,14,14,28,1.600907029478458,29.767044340630623
Task_9187,1318,726,151,147,298,1.81292984869326,30.641866418092267
Task_9188,759,427,34,190,224,1.7733644859813085,20.583762016257506
Task_9189,2549,807,196,189,385,3.1547029702970297,50.85060614228619
Task_9190,1263,504,54,151,205,2.500990099009901,28.732563253608365
Task_9191,1618,307,63,74,137,5.253246753246753,33.02836581438606
Task_9192,1463,271,175,38,213,5.3786764705882355,30.445967492373985
Task_9193,1057,180,89,106,195,5.8397790055248615,23.966972603966088
Task_9194,1804,66,104,30,134,26.925373134328357,33.63500774932739
Task_9195,873,129,146,141,287,6.7153846153846155,21.36286107444646
Task_9196,2283,285,132,55,187,7.9825174825174825,43.54037894273091
Task_9197,2312,64,131,96,227,35.56923076923077,43.20724940990683
Task_9198,2702,584,90,152,242,4.618803418803418,51.864331624975165
Task_9199,1599,869,141,123,264,1.8379310344827586,35.35027695092183
Task_9200,1061,747,63,123,186,1.4184491978609626,26.08021170592372
Task_9201,1614,522,159,64,223,3.0860420650095604,33.95320485069812
Task_9202,1273,841,60,42,102,1.51187648456057,28.235436147574145
Task_9203,2414,354,18,173,191,6.8,46.34508456133542
Task_9204,2897,89,141,145,286,32.18888888888889,52.81441424654389
Task_9205,2717,876,185,95,280,3.0980615735461803,53.13109138745992
Task_9206,2793,272,115,199,314,10.23076923076923,52.659013401577944
Task_9207,1521,491,59,56,115,3.091463414634146,31.528949314573975
Task_9208,1680,360,119,115,234,4.653739612188366,34.878493038983805
Task_9209,1825,680,187,21,208,2.679882525697504,37.369551545837545
Task_9210,2350,490,188,168,356,4.786150712830957,46.53182682899857
Task_9211,1947,686,96,186,282,2.834061135371179,40.473206270585585
Task_9212,902,970,100,102,202,0.9289392378990731,24.286323288626928
Task_9213,1866,361,123,69,192,5.154696132596685,37.28114866657311
Task_9214,2759,305,94,151,245,9.016339869281046,51.869237569706165
Task_9215,2113,604,41,84,125,3.492561983471074,41.82686366821324
Task_9216,1328,620,25,177,202,2.138486312399356,30.06632023023054
Task_9217,1167,581,74,197,271,2.0051546391752577,27.809791126028028
Task_9218,1704,830,97,180,277,2.050541516245487,37.04242046096052
Task_9219,1507,866,103,95,198,1.7381776239907727,33.544787668460025
Task_9220,1882,131,18,35,53,14.257575757575758,34.94099559949298
Task_9221,1995,622,19,87,106,3.202247191011236,39.70979565383516
Task_9222,2639,178,198,156,354,14.743016759776536,49.7290654148897
Task_9223,2481,328,45,105,150,7.541033434650456,46.871773062239434
Task_9224,1338,98,120,59,179,13.515151515151516,27.239508584862136
Task_9225,584,235,115,77,192,2.4745762711864407,16.729622365249032
Task_9226,2620,694,28,111,139,3.7697841726618706,50.18716250705168
Task_9227,2986,928,162,11,173,3.2142088266953714,56.34679805303002
Task_9228,2182,800,144,128,272,2.724094881398252,44.415502063920165
Task_9229,1563,632,63,157,220,2.4691943127962084,33.959053447395874
Task_9230,1566,109,120,148,268,14.236363636363636,31.986793726409292
Task_9231,1245,725,79,21,100,1.7148760330578512,27.44787683311934
Task_9232,1701,863,110,44,154,1.96875,35.65757295133183
Task_9233,963,749,91,108,199,1.284,24.516431977841478
Task_9234,1175,973,148,151,299,1.2063655030800822,29.093364152449524
Task_9235,2193,624,124,90,214,3.5088,43.68751153891274
Task_9236,1707,240,102,46,148,7.08298755186722,33.7812694939959
Task_9237,701,243,32,122,154,2.872950819672131,18.444117288678978
Task_9238,2957,921,167,153,320,3.207158351409978,57.32665908510889
Task_9239,1673,560,39,89,128,2.982174688057041,34.93080453938279
Task_9240,1944,377,95,73,168,5.142857142857143,38.48868333600223
Task_9241,1205,793,163,62,225,1.5176322418136021,28.271302292403053
Task_9242,1097,286,87,96,183,3.822299651567944,25.121066035729715
Task_9243,698,696,196,162,358,1.0014347202295553,20.941389717857742
Task_9244,1039,324,183,127,310,3.1969230769230768,24.982805174556194
Task_9245,2572,315,177,108,285,8.139240506329115,49.05441286197438
Task_9246,2163,902,137,40,177,2.395348837209302,43.35380789351911
Task_9247,826,406,82,81,163,2.0294840294840295,21.084401551858136
Task_9248,2611,980,20,102,122,2.6615698267074412,50.79546184164143
Task_9249,960,455,91,119,210,2.1052631578947367,23.686626865491363
Task_9250,2315,767,13,121,134,3.0143229166666665,45.567300184810826
Task_9251,2897,631,87,74,161,4.583860759493671,54.271177459056865
Task_9252,2861,219,139,148,287,13.004545454545454,53.33456043517938
Task_9253,582,559,144,56,200,1.0392857142857144,17.576557131491096
Task_9254,1555,84,90,60,150,18.294117647058822,30.32881699943987
Task_9255,2701,127,15,175,190,21.1015625,49.66891793497007
Task_9256,2264,463,189,184,373,4.879310344827586,45.18319946067228
Task_9257,2977,954,127,127,254,3.1172774869109947,57.41123920672917
Task_9258,702,630,128,94,222,1.1125198098256734,20.081013445794486
Task_9259,850,129,23,170,193,6.538461538461538,20.564749314853177
Task_9260,2698,216,12,88,100,12.433179723502304,49.34931693553755
Task_9261,1487,871,97,198,295,1.7052752293577982,33.825814876631846
Task_9262,556,165,189,69,258,3.3493975903614457,16.05242363208878
Task_9263,2882,970,25,69,94,2.968074150360453,54.52134970119332
Task_9264,2591,862,159,150,309,3.0023174971031286,51.288683550066686
Task_9265,2570,277,175,31,206,9.244604316546763,47.91781409739872
Task_9266,1521,856,135,42,177,1.7747957992998833,33.029963165325356
Task_9267,1881,797,39,192,231,2.357142857142857,39.556263158129006
Task_9268,1487,589,160,30,190,2.5203389830508476,31.723492838560627
Task_9269,1875,422,142,40,182,4.432624113475177,37.291454257497286
Task_9270,601,478,168,191,359,1.254697286012526,18.789328681215896
Task_9271,2185,599,185,117,302,3.6416666666666666,43.949568615402974
Task_9272,1554,901,126,191,317,1.7228381374722839,35.061807582482636
Task_9273,1739,315,21,171,192,5.503164556962025,35.53713039057089
Task_9274,1542,798,199,24,223,1.9299123904881101,33.34023933287194
Task_9275,1404,346,35,97,132,4.046109510086455,29.92093046949269
Task_9276,2455,111,109,93,202,21.919642857142858,45.55188609164759
Task_9277,517,358,168,167,335,1.4401114206128134,16.952138287118917
Task_9278,2555,501,190,143,333,5.089641434262949,49.67243659465972
Task_9279,1833,275,36,158,194,6.641304347826087,36.91013296265691
Task_9280,2119,207,156,67,223,10.1875,40.88995106159525
Task_9281,2897,407,65,181,246,7.1004901960784315,54.510095971104626
Task_9282,2366,797,18,55,73,2.9649122807017543,45.25435149896395
Task_9283,1030,350,191,32,223,2.9344729344729346,23.891087665739864
Task_9284,2306,454,173,95,268,5.068131868131868,45.228556375358
Task_9285,1616,85,102,59,161,18.790697674418606,31.37342420578328
Task_9286,1560,269,197,119,316,5.777777777777778,33.05284149601919
Task_9287,2595,438,41,90,131,5.911161731207289,49.0306262878268
Task_9288,1539,515,143,147,290,2.9825581395348837,33.44415082854442
Task_9289,2239,1021,154,106,260,2.190802348336595,45.92141276068483
Task_9290,2432,614,37,13,50,3.9544715447154473,45.29507931721823
Task_9291,1920,222,160,189,349,8.609865470852018,38.82565027482377
Task_9292,1744,91,103,53,156,18.956521739130434,33.34567551205604
Task_9293,1412,582,89,17,106,2.4219554030874786,29.693436095163364
Task_9294,1831,344,143,150,293,5.3072463768115945,37.53149892731659
Task_9295,2970,690,184,51,235,4.298118668596238,55.9586971452091
Task_9296,1221,382,37,180,217,3.1879895561357703,27.730755815075856
Task_9297,2735,701,184,84,268,3.8960113960113962,52.707568020524896
Task_9298,2718,862,58,80,138,3.149478563151796,52.30501527130849
Task_9299,875,846,106,127,233,1.0330578512396693,23.61372591275175
Task_9300,2782,966,187,195,382,2.8769389865563597,55.035273466100215
Task_9301,689,343,174,149,323,2.002906976744186,19.59890899577368
Task_9302,1390,597,104,184,288,2.3244147157190636,31.388369586166046
Task_9303,1342,626,107,95,202,2.1403508771929824,30.214448646542166
Task_9304,2138,993,143,113,256,2.1509054325955734,44.226021804379904
Task_9305,1755,340,162,170,332,5.146627565982405,36.52124894176507
Task_9306,1137,1008,158,108,266,1.1268582755203171,28.369077542778758
Task_9307,1711,354,87,72,159,4.819718309859155,34.519788928041294
Task_9308,2909,939,73,63,136,3.09468085106383,55.361596754528854
Task_9309,644,898,122,160,282,0.7163515016685206,20.503744166037652
Task_9310,1745,934,163,121,284,1.8663101604278074,37.95290759948613
Task_9311,2161,412,96,85,181,5.232445520581114,42.27054972470939
Task_9312,827,504,84,30,114,1.6376237623762375,20.380712746193925
Task_9313,813,184,109,119,228,4.394594594594595,20.489960344756916
Task_9314,625,740,149,50,199,0.8434547908232118,18.74530258244124
Task_9315,1861,255,44,199,243,7.26953125,37.56590703489567
Task_9316,1026,651,72,21,93,1.5736196319018405,23.76081025894216
Task_9317,2143,490,186,90,276,4.364562118126273,42.74822938092414
Task_9318,2501,266,104,22,126,9.367041198501873,46.18976901861032
Task_9319,1110,190,113,105,218,5.81151832460733,25.208147654858156
Task_9320,942,288,190,74,264,3.2595155709342563,22.869023164519522
Task_9321,2463,678,107,178,285,3.6273932253313697,48.615402960809114
Task_9322,902,95,100,100,200,9.395833333333334,21.040208853419703
Task_9323,1741,181,82,115,197,9.565934065934066,34.88733648287525
Task_9324,2749,587,27,157,184,4.675170068027211,52.3256578447026
Task_9325,846,583,150,172,322,1.4486301369863013,22.81156639739629
Task_9326,920,192,146,104,250,4.766839378238342,22.359580029975504
Task_9327,1804,456,76,23,99,3.947483588621444,35.464328338907585
Task_9328,2874,825,33,49,82,3.4794188861985473,53.59448557098875
Task_9329,1787,706,23,46,69,2.5275813295615275,35.60002782583373
Task_9330,1455,561,158,113,271,2.588967971530249,32.12386998039247
Task_9331,1876,538,54,61,115,3.4805194805194803,37.3657389213163
Task_9332,2476,501,185,181,366,4.932270916334661,48.62619265600396
Task_9333,731,578,178,88,266,1.2625215889464594,20.537004402970606
Task_9334,1432,885,178,74,252,1.6162528216704288,32.45115336911483
Task_9335,1451,782,160,29,189,1.8531289910600255,31.75052364889468
Task_9336,1444,804,188,36,224,1.7937888198757763,31.87117702739836
Task_9337,2557,250,177,105,282,10.187250996015937,48.566404184447414
Task_9338,690,709,179,183,362,0.971830985915493,20.948433310271465
Task_9339,2768,434,149,109,258,6.363218390804597,52.437230596536246
Task_9340,2313,523,67,36,103,4.41412213740458,43.81588287766173
Task_9341,977,134,103,72,175,7.237037037037037,22.042857592486552
Task_9342,2559,370,191,82,273,6.8975741239892185,48.87353876815596
Task_9343,556,425,27,99,126,1.3051643192488263,16.578825244663523
Task_9344,1652,440,114,138,252,3.746031746031746,34.80950441551742
Task_9345,2980,335,135,55,190,8.869047619047619,54.762626446133744
Task_9346,1278,752,69,29,98,1.697211155378486,28.146868712595523
Task_9347,2526,961,17,139,156,2.625779625779626,49.63357227178963
Task_9348,2798,932,136,168,304,2.9989281886387995,54.79146195949795
Task_9349,1233,311,192,175,367,3.951923076923077,28.335581153102453
Task_9350,1312,250,12,72,84,5.227091633466135,27.27643211375752
Task_9351,1610,579,21,122,143,2.7758620689655173,33.85916808359891
Task_9352,2510,528,188,174,362,4.744801512287334,49.22322568382909
Task_9353,1113,191,87,64,151,5.796875,24.518280391036967
Task_9354,1703,473,67,90,157,3.5928270042194095,35.142689489896895
Task_9355,2250,65,54,195,249,34.09090909090909,42.45431620271609
Task_9356,2932,515,191,101,292,5.682170542635659,55.44007123968512
Task_9357,2768,899,156,48,204,3.0755555555555554,53.10042516088575
Task_9358,2511,996,173,165,338,2.518555667001003,50.59207987297723
Task_9359,1781,623,157,18,175,2.8541666666666665,36.320254875623775
Task_9360,1413,751,92,20,112,1.8789893617021276,30.359390695479977
Task_9361,2375,402,16,157,173,5.893300248138958,45.743596126324185
Task_9362,1494,788,51,78,129,1.8935361216730038,32.77005753846726
Task_9363,1660,516,141,67,208,3.2108317214700195,34.60148607660858
Task_9364,2060,171,63,56,119,11.976744186046512,38.65032947293819
Task_9365,2998,313,138,157,295,9.547770700636942,55.90052600164222
Task_9366,552,495,179,134,313,1.1129032258064515,17.76182361066439
Task_9367,2122,225,92,16,108,9.389380530973451,39.82948218780897
Task_9368,1614,816,187,134,321,1.9755201958384332,35.696081967608414
Task_9369,1708,1024,31,76,107,1.666341463414634,36.39029863517005
Task_9370,2641,113,63,142,205,23.166666666666668,48.66949930207236
Task_9371,2494,434,164,141,305,5.733333333333333,48.35948913475543
Task_9372,1017,983,137,199,336,1.0335365853658536,26.85733898191761
Task_9373,890,471,25,193,218,1.8855932203389831,22.759735514690693
Task_9374,1110,615,45,63,108,1.801948051948052,25.483476966939836
Task_9375,766,248,163,31,194,3.076305220883534,19.255217649145557
Task_9376,2724,376,106,122,228,7.225464190981432,51.43116247575248
Task_9377,2863,308,34,121,155,9.26537216828479,52.89397500279555
Task_9378,2222,941,59,173,232,2.358811040339703,45.445008012910385
Task_9379,2142,124,29,60,89,17.136,39.39507410180165
Task_9380,2647,321,44,70,114,8.220496894409937,49.06368311074874
Task_9381,755,145,55,118,173,5.171232876712328,18.999874973436718
Task_9382,2792,544,143,186,329,5.122935779816514,53.608638432202405
Task_9383,2646,650,193,185,378,4.064516129032258,51.854714339492205
Task_9384,1814,596,153,12,165,3.0385259631490786,36.73337438891553
Task_9385,2297,662,113,165,278,3.464555052790347,45.884933491637916
Task_9386,1201,116,136,157,293,10.264957264957266,26.44543553424072
Task_9387,2551,125,66,117,183,20.246031746031747,47.242833399699784
Task_9388,1592,629,148,200,348,2.526984126984127,34.981752471716035
Task_9389,1901,352,167,155,322,5.385269121813031,38.80330244842566
Task_9390,1224,602,62,76,138,2.029850746268657,27.752496634114568
Task_9391,687,172,125,112,237,3.9710982658959537,18.360526911556892
Task_9392,2563,132,186,199,385,19.270676691729324,48.50555200295607
Task_9393,2733,700,140,23,163,3.898716119828816,51.62237833358967
Task_9394,1931,637,120,122,242,3.0266457680250785,39.78387964560988
Task_9395,1874,121,174,62,236,15.360655737704919,36.386956410150844
Task_9396,924,861,26,51,77,1.0719257540603249,22.606347522720114
Task_9397,1676,827,141,89,230,2.024154589371981,36.193958057172445
Task_9398,590,984,41,141,182,0.5989847715736041,19.453350372481967
Task_9399,1048,822,57,190,247,1.2733900364520048,26.493362312465766
Task_9400,2476,707,60,138,198,3.4971751412429377,48.53148263743454
Task_9401,1316,405,49,52,101,3.2413793103448274,27.864212959316195
Task_9402,1845,105,139,200,339,17.40566037735849,36.74255261512513
Task_9403,1369,448,131,113,244,3.048997772828508,30.283213818175003
Task_9404,586,72,118,195,313,8.027397260273972,16.720320678682658
Task_9405,1902,418,171,38,209,4.5393794749403344,37.85699934253393
Task_9406,2596,633,157,47,204,4.094637223974764,49.52870625596024
Task_9407,2317,792,144,117,261,2.921815889029004,46.46355721019419
Task_9408,676,585,81,141,222,1.1535836177474403,19.65087978544847
Task_9409,2417,383,40,103,143,6.294270833333333,46.006247872535255
Task_9410,831,227,55,20,75,3.6447368421052633,18.72106679560426
Task_9411,2573,244,57,89,146,10.50204081632653,48.080776445463236
Task_9412,2647,307,177,194,371,8.594155844155845,50.72602988155571
Task_9413,1165,582,198,167,365,1.9982847341337908,28.10037294931466
Task_9414,2885,592,53,178,231,4.865092748735244,54.854182687565356
Task_9415,1249,237,58,136,194,5.2478991596638656,27.574322624500244
Task_9416,1253,800,79,157,236,1.564294631710362,29.598397674778212
Task_9417,2559,195,24,151,175,13.056122448979592,47.934486912763425
Task_9418,2312,381,50,28,78,6.052356020942408,42.91862952013705
Task_9419,2196,439,27,100,127,4.990909090909091,42.62765543897327
Task_9420,875,352,151,108,259,2.4787535410764874,22.2210174438105
Task_9421,2995,627,102,53,155,4.769108280254777,55.74357952922446
Task_9422,2398,173,28,154,182,13.781609195402298,45.035178712450055
Task_9423,2485,988,137,26,163,2.512639029322548,48.623314703240986
Task_9424,2183,177,64,69,133,12.264044943820224,41.10408896060989
Task_9425,2478,489,187,78,265,5.057142857142857,47.889898040208756
Task_9426,2998,706,159,167,326,4.2404526166902405,57.34711077904617
Task_9427,2301,396,177,153,330,5.795969773299748,45.31038887588187
Task_9428,2132,523,68,150,218,4.068702290076335,42.611331710891456
Task_9429,2429,860,182,49,231,2.821138211382114,47.79496392918179
Task_9430,1170,597,145,62,207,1.9565217391304348,27.040542585763813
Task_9431,2295,755,11,86,97,3.0357142857142856,44.68944184130222
Task_9432,2315,182,155,69,224,12.650273224043715,43.8651732216723
Task_9433,1300,319,184,65,249,4.0625,28.466437293484844
Task_9434,1359,308,56,190,246,4.398058252427185,29.86426850765201
Task_9435,716,728,98,99,197,0.9821673525377229,20.557725430312004
Task_9436,2073,187,190,181,371,11.02659574468085,41.222535350250624
Task_9437,945,1008,175,95,270,0.9365708622398414,25.394867315069366
Task_9438,2068,806,182,187,369,2.5625774473358116,43.15181512270894
Task_9439,1297,115,43,114,157,11.181034482758621,26.83917989636102
Task_9440,1423,1022,133,115,248,1.391006842619746,32.89829136154332
Task_9441,2863,186,190,135,325,15.310160427807487,53.418701065874984
Task_9442,2260,67,78,91,169,33.23529411764706,42.004472858674085
Task_9443,1723,773,85,133,218,2.2260981912144704,36.82926364201678
Task_9444,2676,239,156,48,204,11.15,49.4841354717317
Task_9445,2276,291,74,106,180,7.794520547945205,43.84924611613422
Task_9446,1963,808,96,199,295,2.426452410383189,41.186279672579836
Task_9447,1209,946,121,198,319,1.276663146779303,29.70612321847881
Task_9448,823,885,117,157,274,0.9288939051918735,23.17688636838138
Task_9449,1652,1009,52,18,70,1.6356435643564355,34.1752965021437
Task_9450,2794,1005,118,44,162,2.7773359840954273,53.528644825041624
Task_9451,1967,924,92,167,259,2.1264864864864865,41.40200686294426
Task_9452,1570,753,145,19,164,2.0822281167108754,33.37027598656132
Task_9453,1615,730,180,45,225,2.2093023255813953,34.35430355479548
Task_9454,2869,706,54,56,110,4.057991513437058,53.467442999427426
Task_9455,586,936,159,147,306,0.6254002134471718,19.839159993608767
Task_9456,2060,864,170,108,278,2.3815028901734103,42.68018997203516
Task_9457,884,122,39,191,230,7.186991869918699,21.264610620191757
Task_9458,1831,891,123,166,289,2.052690582959641,39.270428668946174
Task_9459,1650,143,60,170,230,11.458333333333334,33.52270877224876
Task_9460,705,351,23,89,112,2.002840909090909,18.535202540862425
Task_9461,675,736,50,45,95,0.9158751696065129,18.60594562656704
Task_9462,2986,1021,177,137,314,2.9217221135029354,58.04822011601391
Task_9463,2070,997,71,21,92,2.0741482965931866,41.35855450562247
Task_9464,1159,92,146,80,226,12.46236559139785,24.964863206185925
Task_9465,2694,437,84,20,104,6.1506849315068495,49.51591662188405
Task_9466,716,662,133,194,327,1.0799396681749622,21.03914520565149
Task_9467,971,835,76,173,249,1.1614832535885167,25.287162883897892
Task_9468,1819,345,30,27,57,5.257225433526012,34.90253886524342
Task_9469,1151,575,158,101,259,1.9982638888888888,27.282268061685595
Task_9470,2716,782,148,140,288,3.4687100893997447,52.908844882623725
Task_9471,1136,161,17,23,40,7.012345679012346,23.25671529423373
Task_9472,939,239,124,18,142,3.9125,21.49559845687669
Task_9473,2971,409,152,80,232,7.246341463414634,55.30746620550223
Task_9474,2700,593,89,144,233,4.545454545454546,51.793779555422454
Task_9475,1804,427,183,168,351,4.214953271028038,37.66345876454609
Task_9476,1212,562,62,145,207,2.152753108348135,28.104739607804884
Task_9477,1555,467,103,78,181,3.322649572649573,32.79430230179633
Task_9478,611,588,54,184,238,1.0373514431239388,18.761668440459093
Task_9479,1351,181,196,85,281,7.423076923076923,28.96209730029517
Task_9480,1401,447,63,106,169,3.127232142857143,30.457173438233237
Task_9481,825,855,138,161,299,0.9637850467289719,23.222852562695376
Task_9482,1031,303,165,127,292,3.3914473684210527,24.707128994554182
Task_9483,2153,763,119,93,212,2.818062827225131,43.5020575806746
Task_9484,1381,846,153,188,341,1.630460448642267,32.25362548654499
Task_9485,2412,477,70,88,158,5.046025104602511,46.359877363137315
Task_9486,1751,455,148,22,170,3.8399122807017543,35.27322029300422
Task_9487,1134,648,113,131,244,1.7473035439137135,27.20400358376251
Task_9488,682,974,100,74,174,0.6994871794871795,20.60977232462088
Task_9489,2662,837,193,90,283,3.1766109785202863,52.09843683952579
Task_9490,756,905,70,85,155,0.8344370860927153,21.38942672991206
Task_9491,841,527,109,54,163,1.5928030303030303,21.428604782644616
Task_9492,1906,974,61,103,164,1.9548717948717949,40.08094206453769
Task_9493,2368,614,177,38,215,3.850406504065041,45.889726163683555
Task_9494,1072,651,52,108,160,1.6441717791411044,25.696208249881625
Task_9495,2012,992,89,124,213,2.026183282980866,42.02749566034752
Task_9496,1558,590,17,48,65,2.6362098138747885,31.62072562592792
Task_9497,902,1012,26,190,216,0.8904244817374136,24.534661710967658
Task_9498,1708,672,129,41,170,2.537890044576523,35.36446575559191
Task_9499,2474,189,76,53,129,13.021052631578947,46.04147259810858
Task_9500,2213,437,186,126,312,5.052511415525114,43.93155664850707
Task_9501,2643,800,114,161,275,3.299625468164794,51.78107447087626
Task_9502,1651,739,44,187,231,2.231081081081081,35.730887228228134
Task_9503,889,630,156,90,246,1.4088748019017432,23.148394979765328
Task_9504,1045,609,194,15,209,1.7131147540983607,24.76191738603298
Task_9505,2339,159,44,180,224,14.61875,44.39363369421735
Task_9506,2679,441,15,122,137,6.0610859728506785,50.29807792719901
Task_9507,2632,503,59,175,234,5.222222222222222,50.56856759879156
Task_9508,1123,247,121,45,166,4.528225806451613,24.773905904788837
Task_9509,2388,621,166,151,317,3.8392282958199355,47.351706956911094
Task_9510,2899,911,11,70,81,3.178728070175439,54.4539478224065
Task_9511,1323,819,42,44,86,1.6134146341463416,28.97963565993892
Task_9512,536,93,155,166,321,5.702127659574468,15.966063220168303
Task_9513,1097,929,11,161,172,1.1795698924731184,27.089497733129416
Task_9514,1795,818,39,77,116,2.191697191697192,37.28579583554336
Task_9515,839,978,67,125,192,0.856996935648621,23.333411522396858
Task_9516,711,515,109,63,172,1.377906976744186,19.349865260346643
Task_9517,2411,122,30,171,201,19.601626016260163,45.134645298338036
Task_9518,1220,627,79,191,270,1.9426751592356688,28.779121165637616
Task_9519,1291,282,45,115,160,4.561837455830389,27.969667455670407
Task_9520,1520,589,75,131,206,2.5762711864406778,33.039493170093635
Task_9521,1238,767,119,136,255,1.6119791666666667,29.27874632946718
Task_9522,571,529,102,93,195,1.0773584905660378,17.568673100555696
Task_9523,1278,286,141,113,254,4.452961672473868,28.364447196444445
Task_9524,2008,527,73,161,234,3.803030303030303,40.7358482878415
Task_9525,2276,711,121,132,253,3.196629213483146,45.54567856772773
Task_9526,609,232,65,159,224,2.6137339055793993,17.61710886165278
Task_9527,2469,700,24,19,43,3.522111269614836,46.06467771633712
Task_9528,1872,168,52,10,62,11.076923076923077,34.88031100330241
Task_9529,1508,114,45,68,113,13.11304347826087,29.7266319909522
Task_9530,1668,400,184,26,210,4.159600997506234,34.0527818828642
Task_9531,1247,430,188,18,206,2.8932714617169375,27.405935566353183
Task_9532,2495,466,56,64,120,5.342612419700214,47.0832707798945
Task_9533,792,905,25,102,127,0.8741721854304636,21.834818043426576
Task_9534,687,360,92,141,233,1.9030470914127424,19.211334723725262
Task_9535,1018,377,13,67,80,2.693121693121693,22.933259452210564
Task_9536,2687,827,27,13,40,3.245169082125604,49.868126804684756
Task_9537,2177,643,181,149,330,3.380434782608696,44.135205108022014
Task_9538,2837,842,35,79,114,3.365361803084223,53.91069460817244
Task_9539,2396,677,10,81,91,3.533923303834808,45.98099009724023
Task_9540,2923,562,157,150,307,5.191829484902309,55.589006891299256
Task_9541,2375,356,173,127,300,6.652661064425771,46.1744031000844
Task_9542,2171,481,22,89,111,4.504149377593361,42.15422176116491
Task_9543,2368,654,94,32,126,3.615267175572519,45.515869924903775
Task_9544,711,729,80,94,174,0.9739726027397261,20.353444137246697
Task_9545,1544,438,11,70,81,3.5170842824601367,31.499884071739682
Task_9546,2049,809,29,111,140,2.5296296296296297,41.51966843692818
Task_9547,2186,170,146,74,220,12.783625730994151,41.67597282081818
Task_9548,948,761,37,52,89,1.2440944881889764,23.109205934765537
Task_9549,1789,376,200,106,306,4.745358090185676,36.96661537662227
Task_9550,2295,671,16,40,56,3.4151785714285716,43.5099234460614
Task_9551,2510,439,93,84,177,5.704545454545454,47.891506505600354
Task_9552,1314,382,179,88,267,3.430809399477807,29.209660173315402
Task_9553,2052,932,45,192,237,2.1993569131832795,42.731721350423946
Task_9554,1325,239,57,24,81,5.520833333333333,26.991692320298565
Task_9555,631,596,135,51,186,1.0569514237855946,18.388363328076814
Task_9556,1599,445,20,19,39,3.585201793721973,31.440837958749242
Task_9557,2272,192,200,74,274,11.7720207253886,43.637007433702955
Task_9558,2680,172,25,199,224,15.491329479768787,49.78619269090862
Task_9559,778,182,67,103,170,4.251366120218579,19.673299600630987
Task_9560,2038,488,171,115,286,4.1676891615541924,41.19304111997857
Task_9561,1030,638,70,118,188,1.6118935837245696,25.3131182559392
Task_9562,1754,291,188,74,262,6.006849315068493,35.70655088025536
Task_9563,2281,244,67,165,232,9.310204081632653,44.12072482876419
Task_9564,2018,800,49,163,212,2.519350811485643,41.69417355626392
Task_9565,2027,811,143,122,265,2.4963054187192117,41.953843711557006
Task_9566,2117,471,63,107,170,4.485169491525424,41.873321648717656
Task_9567,1667,844,123,25,148,1.9727810650887574,35.03888116203767
Task_9568,1715,547,152,74,226,3.1295620437956204,35.758260939306
Task_9569,1083,382,109,31,140,2.827676240208877,24.31585215874262
Task_9570,2203,1020,117,50,167,2.1576885406464252,44.40787474190588
Task_9571,945,347,88,16,104,2.7155172413793105,21.533246241574194
Task_9572,570,732,68,150,218,0.7776261937244202,18.49692411740482
Task_9573,1602,715,144,199,343,2.2374301675977653,35.38542513694987
Task_9574,1822,142,180,167,347,12.741258741258742,36.711403984045155
Task_9575,615,680,86,185,271,0.9030837004405287,19.18894364413298
Task_9576,2647,824,21,20,41,3.2084848484848485,49.270242497511816
Task_9577,2584,934,151,131,282,2.7636363636363637,51.253290407832615
Task_9578,1715,701,18,117,135,2.443019943019943,35.855450046445824
Task_9579,2201,349,167,40,207,6.288571428571428,42.34064985308079
Task_9580,2739,435,187,53,240,6.282110091743119,51.56644012985664
Task_9581,2163,548,176,195,371,3.939890710382514,43.86437279825896
Task_9582,619,182,132,95,227,3.3825136612021858,17.418727320792716
Task_9583,1323,361,43,25,68,3.654696132596685,27.08006291666487
Task_9584,847,266,47,89,136,3.1722846441947565,20.790812926907467
Task_9585,811,813,52,144,196,0.9963144963144963,22.398238260250224
Task_9586,600,979,104,152,256,0.6122448979591837,19.97582788627172
Task_9587,1127,442,119,161,280,2.544018058690745,26.666538532518747
Task_9588,1333,168,153,152,305,7.887573964497041,28.916440666825057
Task_9589,2106,67,170,17,187,30.970588235294116,38.689721196578525
Task_9590,2562,371,115,11,126,6.887096774193548,47.50227577540873
Task_9591,2055,783,23,84,107,2.621173469387755,41.19782585415644
Task_9592,1870,452,77,127,204,4.1280353200883,38.13295868213829
Task_9593,2723,863,97,138,235,3.1516203703703702,53.039874201445116
Task_9594,2724,840,193,33,226,3.2390011890606423,52.27273098111504
Task_9595,2805,351,162,78,240,7.96875,52.49409612979242
Task_9596,1039,397,93,73,166,2.6105527638190953,24.29531010574723
Task_9597,2090,137,40,109,149,15.144927536231885,39.46040301364388
Task_9598,1997,141,126,67,193,14.06338028169014,38.271175628177794
Task_9599,953,197,196,100,296,4.813131313131313,23.138963231938373
Task_9600,2171,793,77,10,87,2.734256926952141,42.22335310425917
Task_9601,833,988,49,111,160,0.8422649140546006,22.948439825568638
Task_9602,1482,309,150,124,274,4.780645161290322,31.772294699906478
Task_9603,573,997,52,40,92,0.5741482965931863,17.91101092513582
Task_9604,2256,1024,43,179,222,2.2009756097560977,46.15254620676949
Task_9605,927,342,30,199,229,2.7026239067055395,23.0129930224014
Task_9606,1085,85,28,26,54,12.616279069767442,21.93043922715152
Task_9607,2858,301,83,60,143,9.463576158940397,52.43853608273857
Task_9608,1062,772,26,38,64,1.3738680465717983,24.262205118656485
Task_9609,1745,350,51,21,72,4.971509971509971,33.64442960721402
Task_9610,1959,935,16,193,209,2.092948717948718,41.08716868218062
Task_9611,2035,808,141,33,174,2.515451174289246,41.01103513120656
Task_9612,1771,116,162,47,209,15.136752136752136,34.30196566780159
Task_9613,2356,424,151,186,337,5.543529411764706,46.352852168490095
Task_9614,2236,491,141,38,179,4.544715447154472,43.233519546660716
Task_9615,2628,770,104,161,265,3.4085603112840466,51.404084085632654
Task_9616,737,180,61,48,109,4.071823204419889,17.565011518491715
Task_9617,1798,509,162,70,232,3.5254901960784313,36.873596339778906
Task_9618,1793,779,178,63,241,2.2987179487179485,37.66951393755708
Task_9619,2816,526,189,92,281,5.343453510436433,53.52458526541245
Task_9620,2744,705,80,106,186,3.8866855524079322,52.62000582580072
Task_9621,2686,694,134,123,257,3.864748201438849,51.991448784655006
Task_9622,505,1003,129,85,214,0.5029880478087649,18.24455871872071
Task_9623,2464,182,109,152,261,13.46448087431694,46.72587280250786
Task_9624,1824,825,78,185,263,2.208232445520581,38.931573322512584
Task_9625,2342,660,156,71,227,3.5431164901664145,45.9815730524088
Task_9626,723,439,72,149,221,1.643181818181818,20.025944747933668
Task_9627,577,892,115,142,257,0.6461366181410975,19.315203623158848
Task_9628,1502,576,99,104,203,2.603119584055459,32.59734471311797
Task_9629,1841,615,161,30,191,2.9886363636363638,37.41902592644258
Task_9630,933,355,196,150,346,2.6207865168539324,23.601730829450677
Task_9631,738,385,177,31,208,1.9119170984455958,19.313826116132926
Task_9632,2057,363,170,48,218,5.6510989010989015,40.196109874033695
Task_9633,2151,659,167,180,347,3.2590909090909093,43.89595345612431
Task_9634,1335,330,102,121,223,4.033232628398792,29.28256085864462
Task_9635,1790,226,133,84,217,7.88546255506608,35.96374476194917
Task_9636,1162,859,122,69,191,1.3511627906976744,27.683650269376415
Task_9637,2763,362,55,42,97,7.6115702479338845,50.28885544144851
Task_9638,804,424,160,187,347,1.891764705882353,21.83786154776566
Task_9639,2328,653,29,101,130,3.5596330275229358,45.43156260571683
Task_9640,2975,104,75,194,269,28.333333333333332,54.25675289989956
Task_9641,1963,696,74,84,158,2.8163558106169297,39.9168474809151
Task_9642,974,881,197,180,377,1.1043083900226758,26.0135631648744
Task_9643,1252,431,33,106,139,2.8981481481481484,27.705257145917347
Task_9644,2060,553,185,124,309,3.7184115523465704,41.865854581787794
Task_9645,1696,174,19,109,128,9.691428571428572,33.455670052066104
Task_9646,1876,429,92,32,124,4.362790697674418,36.88859135544739
Task_9647,2950,840,38,106,144,3.507728894173603,55.91935622473932
Task_9648,2201,343,171,77,248,6.398255813953488,42.904457562185094
Task_9649,1131,955,10,52,62,1.1830543933054394,26.157616231129513
Task_9650,2397,133,157,150,307,17.888059701492537,45.47709626024008
Task_9651,1864,181,79,130,209,10.241758241758241,36.92617403217095
Task_9652,1495,929,199,84,283,1.60752688172043,33.83321290196848
Task_9653,1867,880,87,180,267,2.119182746878547,39.6882482613363
Task_9654,2525,262,158,141,299,9.600760456273765,48.234327187386306
Task_9655,2504,250,40,132,172,9.97609561752988,47.25063287890373
Task_9656,1288,430,147,28,175,2.988399071925754,27.988570664613032
Task_9657,1438,752,80,32,112,1.9096945551128819,30.77056102288365
Task_9658,565,649,171,191,362,0.8692307692307693,18.798787407412217
Task_9659,2165,855,15,22,37,2.5292056074766354,41.73967293042782
Task_9660,2813,733,19,113,132,3.832425068119891,53.385889881295554
Task_9661,520,815,73,166,239,0.6372549019607843,18.19793615828067
Task_9662,2353,418,48,36,84,5.615751789976134,43.94273049903745
Task_9663,2417,690,195,199,394,3.4978292329956586,48.44671470077794
Task_9664,1637,998,65,25,90,1.6386386386386387,34.44947135844079
Task_9665,503,174,37,173,210,2.874285714285714,15.376167098878318
Task_9666,654,755,22,138,160,0.8650793650793651,19.318564345404997
Task_9667,1612,252,21,15,36,6.371541501976284,30.958958393986098
Task_9668,1265,350,138,146,284,3.6039886039886038,28.55201225446049
Task_9669,1846,163,154,109,263,11.25609756097561,36.73737430564964
Task_9670,1722,591,81,19,100,2.9087837837837838,34.57626519598363
Task_9671,1988,339,130,173,303,5.847058823529411,40.076864234759505
Task_9672,966,884,154,187,341,1.0915254237288134,25.74409543796702
Task_9673,2348,225,118,126,244,10.389380530973451,45.0305318314527
Task_9674,2262,163,149,179,328,13.792682926829269,43.69192239233845
Task_9675,1114,585,82,35,117,1.901023890784983,25.144447638286366
Task_9676,1722,668,125,38,163,2.5739910313901344,35.58237191264709
Task_9677,788,682,174,88,262,1.1537335285505124,21.73426606765074
Task_9678,1237,425,119,18,137,2.903755868544601,26.764030647139208
Task_9679,1243,714,170,164,334,1.7384615384615385,29.59017423622859
Task_9680,2854,488,125,129,254,5.83640081799591,53.98708663405167
Task_9681,2563,839,138,181,319,3.051190476190476,50.86353499382083
Task_9682,2284,491,56,186,242,4.642276422764228,45.07240023680237
Task_9683,1332,692,47,182,229,1.922077922077922,30.538128691804406
Task_9684,687,398,45,52,97,1.7218045112781954,17.857386087584953
Task_9685,2728,937,88,57,145,2.908315565031983,52.429850451819625
Task_9686,1163,910,28,114,142,1.2766190998902305,27.746510769203542
Task_9687,2794,599,84,192,276,4.656666666666666,53.596652716855054
Task_9688,1862,994,29,176,205,1.871356783919598,39.72032683933537
Task_9689,633,969,45,76,121,0.6525773195876289,19.47005667087056
Task_9690,1502,259,79,187,266,5.776923076923077,32.03640304728895
Task_9691,1225,760,24,65,89,1.609724047306176,27.608130700556586
Task_9692,2623,304,53,175,228,8.6,49.73568814975719
Task_9693,1538,908,187,53,240,1.691969196919692,34.03219618324119
Task_9694,796,237,190,105,295,3.3445378151260505,20.75840890036839
Task_9695,2695,411,157,45,202,6.54126213592233,50.333167045053294
Task_9696,1698,315,139,156,295,5.3734177215189876,35.34933032728562
Task_9697,1869,980,110,110,220,1.9051987767584098,39.75617186733964
Task_9698,2358,96,176,111,287,24.309278350515463,44.31599748505139
Task_9699,1838,658,190,47,237,2.78907435508346,37.75089939883262
Task_9700,600,549,84,80,164,1.0909090909090908,17.84148730673046
Task_9701,1036,251,139,67,206,4.111111111111111,23.864937665310304
Task_9702,2761,603,77,145,222,4.571192052980132,52.83161531735627
Task_9703,2806,147,98,170,268,18.95945945945946,51.91915160200042
Task_9704,1468,920,193,125,318,1.5939196525515744,33.66582992935792
Task_9705,1474,172,179,97,276,8.520231213872833,30.92726618377684
Task_9706,2908,454,145,187,332,6.391208791208792,55.166949708971536
Task_9707,2864,596,26,154,180,4.797319932998325,54.16083106549888
Task_9708,1268,164,13,85,98,7.684848484848485,26.220785001645414
Task_9709,2296,196,129,173,302,11.654822335025381,44.44286705490546
Task_9710,2266,784,170,89,259,2.886624203821656,45.53787580828463
Task_9711,2161,772,114,58,172,2.795601552393273,43.101028867018805
Task_9712,2483,651,163,82,245,3.808282208588957,48.454606540872334
Task_9713,747,726,159,200,359,1.0275103163686383,21.889227383453363
Task_9714,1980,453,38,168,206,4.361233480176211,39.88931676195842
Task_9715,1956,80,85,184,269,24.14814814814815,37.969510152704125
Task_9716,1621,564,38,43,81,2.8690265486725663,32.87153289546015
Task_9717,1846,665,80,41,121,2.7717717717717716,37.033334795463055
Task_9718,1286,283,190,178,368,4.528169014084507,29.09002797262367
Task_9719,2348,684,122,182,304,3.4277372262773724,46.90427810325
Task_9720,636,777,54,188,242,0.8174807197943444,19.80041106574409
Task_9721,2900,95,170,74,244,30.208333333333332,52.221891064538404
Task_9722,526,75,99,122,221,6.921052631578948,15.238072908872565
Task_9723,1781,1010,188,95,283,1.76162215628091,38.716781236523495
Task_9724,2615,560,31,196,227,4.661319073083779,50.409809297251265
Task_9725,757,66,110,164,274,11.298507462686567,19.19281521042619
Task_9726,2684,200,30,126,156,13.35323383084577,49.65652770746146
Task_9727,1871,424,101,64,165,4.402352941176471,37.459852774862625
Task_9728,1841,659,50,78,128,2.7893939393939395,37.94911220616976
Task_9729,1024,238,191,183,374,4.2845188284518825,24.833795182620253
Task_9730,1659,388,33,155,188,4.26478149100257,34.48171659085108
Task_9731,2331,652,99,80,179,3.5696784073506893,45.700621901072644
Task_9732,2061,927,99,19,118,2.220905172413793,41.154732156923195
Task_9733,2088,806,144,35,179,2.587360594795539,41.87068143706989
Task_9734,1797,835,39,61,100,2.1495215311004783,36.83921265239587
Task_9735,2037,707,175,11,186,2.8771186440677967,40.682194675740924
Task_9736,552,791,116,111,227,0.696969696969697,18.402491076171913
Task_9737,661,172,94,113,207,3.820809248554913,17.841391766611142
Task_9738,1866,874,60,107,167,2.1325714285714286,39.15479895031295
Task_9739,1006,963,186,21,207,1.0435684647302905,25.278410214428373
Task_9740,1870,411,24,59,83,4.538834951456311,36.49216771068334
Task_9741,1723,798,39,86,125,2.1564455569461827,36.27736504962052
Task_9742,2941,705,58,98,156,4.165722379603399,55.46037027797295
Task_9743,1844,678,143,163,306,2.715758468335788,38.88336011567297
Task_9744,1326,409,128,175,303,3.234146341463415,29.835060264428055
Task_9745,2028,718,163,99,262,2.820584144645341,41.62537944721303
Task_9746,951,558,180,49,229,1.701252236135957,23.417148059565495
Task_9747,2927,902,107,119,226,3.241417497231451,56.318298468575925
Task_9748,2090,219,69,71,140,9.5,40.141310037877666
Task_9749,2595,808,144,101,245,3.207663782447466,50.82254685308169
Task_9750,854,148,159,73,232,5.731543624161074,20.56557158992216
Task_9751,1860,979,113,89,202,1.8979591836734695,39.45596306543417
Task_9752,973,432,189,69,258,2.2471131639722866,23.679260235607092
Task_9753,1847,367,36,98,134,5.019021739130435,36.91760899349343
Task_9754,632,501,62,75,137,1.2589641434262948,18.034854380159683
Task_9755,1509,520,114,51,165,2.896353166986564,31.985288077543775
Task_9756,1775,165,149,119,268,10.69277108433735,35.66333198514115
Task_9757,2272,254,198,65,263,8.909803921568628,43.671929064675375
Task_9758,2114,788,38,68,106,2.679340937896071,41.967207057309516
Task_9759,2116,148,176,197,373,14.201342281879194,41.56034422943578
Task_9760,1263,914,60,115,175,1.380327868852459,29.747155124544847
Task_9761,2324,234,56,123,179,9.88936170212766,44.43182193198496
Task_9762,1846,815,138,65,203,2.2622549019607843,38.47394494936439
Task_9763,1806,889,125,47,172,2.0292134831460675,37.6540548560701
Task_9764,1658,425,153,78,231,3.892018779342723,34.55070111107239
Task_9765,1427,319,104,190,294,4.459375,31.12254545000179
Task_9766,1451,882,18,99,117,1.6432616081540203,32.06550718709479
Task_9767,1510,1008,186,173,359,1.4965312190287414,34.830096297236416
Task_9768,2199,898,190,132,322,2.446051167964405,45.222156272524614
Task_9769,2251,407,131,103,234,5.517156862745098,44.04949648834985
Task_9770,746,108,74,23,97,6.844036697247707,17.205681950937006
Task_9771,1586,378,162,12,174,4.1846965699208445,32.445930425622585
Task_9772,1150,753,42,157,199,1.5251989389920424,27.610483509176365
Task_9773,696,623,187,145,332,1.1153846153846154,20.541438382597708
Task_9774,542,142,145,98,243,3.7902097902097904,15.962452164279497
Task_9775,1193,944,194,51,245,1.2624338624338625,28.64894292164374
Task_9776,856,890,171,152,323,0.9607182940516273,23.917263472313554
Task_9777,2720,309,86,78,164,8.774193548387096,50.63952958000754
Task_9778,888,278,124,119,243,3.182795698924731,22.132578392936566
Task_9779,2669,178,71,30,101,14.910614525139664,48.14939772253092
Task_9780,2154,75,53,57,110,28.342105263157894,39.26935414488478
Task_9781,908,872,172,127,299,1.0400916380297824,24.514514324761222
Task_9782,1719,179,199,56,255,9.55,34.408851827386705
Task_9783,1981,326,153,37,190,6.058103975535168,38.71319017166715
Task_9784,795,1013,23,12,35,0.7840236686390533,20.677945274725058
Task_9785,2494,865,71,23,94,2.879907621247113,47.714507239177514
Task_9786,1606,354,148,20,168,4.523943661971831,32.64001271833235
Task_9787,2520,408,106,141,247,6.161369193154035,48.42381084178276
Task_9788,2182,393,116,122,238,5.538071065989848,42.95746018488512
Task_9789,1686,382,165,114,279,4.402088772845953,35.246643442038184
Task_9790,1635,689,163,55,218,2.369565217391304,34.747446981839865
Task_9791,761,440,165,172,337,1.72562358276644,21.12709974405608
Task_9792,2035,285,190,146,336,7.115384615384615,40.745525836890025
Task_9793,2991,168,171,34,205,17.698224852071007,53.94829370428176
Task_9794,2576,268,62,28,90,9.576208178438662,46.94256241176135
Task_9795,1103,760,112,130,242,1.4494086727989488,27.010505265816843
Task_9796,1819,482,138,115,253,3.7660455486542443,37.55823188651767
Task_9797,942,236,139,63,202,3.9746835443037973,22.29817141638546
Task_9798,2365,397,39,133,172,5.942211055276382,45.56277387951034
Task_9799,897,709,91,66,157,1.263380281690141,22.71563536565122
Task_9800,1584,808,27,157,184,1.9579728059332508,34.56797997302963
Task_9801,2891,820,93,83,176,3.5213154689403168,55.1358390108426
Task_9802,2086,501,157,78,235,4.155378486055777,41.5875823812568
Task_9803,2973,119,20,72,92,24.775,52.55820323413752
Task_9804,1466,677,193,38,231,2.162241887905605,31.87395032755266
Task_9805,2748,969,86,154,240,2.8329896907216496,53.76602149779049
Task_9806,2452,853,93,57,150,2.871194379391101,47.827505607640596
Task_9807,1656,107,129,33,162,15.333333333333334,32.052868827463
Task_9808,2061,863,38,146,184,2.3854166666666665,42.29704258125861
Task_9809,2387,689,159,84,243,3.4594202898550726,47.04461532564242
Task_9810,1481,141,182,188,370,10.429577464788732,31.463400590913157
Task_9811,2130,452,162,16,178,4.701986754966887,41.304678555916965
Task_9812,2424,293,43,76,119,8.244897959183673,45.542523101427854
Task_9813,1067,420,186,95,281,2.534441805225653,25.56850045724452
Task_9814,2883,874,178,66,244,3.294857142857143,55.25913700814417
Task_9815,1607,751,193,98,291,2.136968085106383,35.20213506717771
Task_9816,855,277,193,161,354,3.0755395683453237,22.169572312928267
Task_9817,2063,302,158,121,279,6.808580858085809,40.9532460564241
Task_9818,809,955,163,165,328,0.8462343096234309,23.41867738679406
Task_9819,2136,593,192,165,357,3.595959595959596,43.4728116054896
Task_9820,2289,198,22,25,47,11.50251256281407,41.703192186649325
Task_9821,1898,258,188,178,366,7.328185328185328,38.66805962778506
Task_9822,523,92,140,166,306,5.623655913978495,15.694815649198404
Task_9823,1067,939,78,104,182,1.1351063829787233,26.689339355150327
Task_9824,2381,307,147,21,168,7.73051948051948,44.73986676610909
Task_9825,1377,381,110,154,264,3.6047120418848166,30.3455556528688
Task_9826,645,628,147,89,236,1.0254372019077902,19.21146833332566
Task_9827,1468,385,197,18,215,3.8031088082901556,30.799452352622215
Task_9828,2164,320,136,148,284,6.741433021806854,42.67391566703512
Task_9829,1261,976,165,158,323,1.2906857727737973,30.582421927270975
Task_9830,1482,1001,86,113,199,1.4790419161676647,33.51332822978745
Task_9831,1010,360,106,89,195,2.7977839335180055,24.021230059664898
Task_9832,862,736,61,110,171,1.169606512890095,22.76068507714626
Task_9833,1813,1018,183,166,349,1.7791952894995093,39.63678267211748
Task_9834,2638,732,150,29,179,3.5989085948158253,50.34546562423761
Task_9835,1637,431,200,38,238,3.7893518518518516,33.83585910536509
Task_9836,680,390,90,46,136,1.7391304347826086,17.973187497864306
Task_9837,1589,117,132,136,268,13.466101694915254,32.43125510629379
Task_9838,1919,564,84,49,133,3.3964601769911504,38.234786920913656
Task_9839,1008,246,18,27,45,4.080971659919029,21.61866651307857
Task_9840,1224,301,95,14,109,4.052980132450331,25.903794218792253
Task_9841,2130,220,154,86,240,9.638009049773755,41.42591031647532
Task_9842,1205,595,73,45,118,2.021812080536913,26.6230796149848
Task_9843,559,353,160,67,227,1.57909604519774,16.729928899880758
Task_9844,2346,570,134,180,314,4.108581436077058,46.55337242550926
Task_9845,1492,686,74,15,89,2.1717612809315865,31.16828846774507
Task_9846,1297,288,193,183,376,4.4878892733564015,29.32391584787371
Task_9847,1156,372,161,67,228,3.099195710455764,26.255685416033973
Task_9848,528,89,121,42,163,5.866666666666666,14.192208807902484
Task_9849,746,502,57,156,213,1.4831013916500995,20.542794952170055
Task_9850,1452,992,143,195,338,1.4622356495468278,33.787873203073836
Task_9851,1176,712,26,198,224,1.6493688639551192,28.062332785748747
Task_9852,2696,418,73,149,222,6.43436754176611,51.201108559695435
Task_9853,1386,762,89,133,222,1.81651376146789,31.44710835199794
Task_9854,571,893,148,174,322,0.6387024608501118,19.563087556753995
Task_9855,520,78,101,72,173,6.582278481012659,14.402197733045162
Task_9856,2468,825,22,170,192,2.9878934624697338,48.70769838484323
Task_9857,2769,288,21,192,213,9.581314878892734,51.85397274622205
Task_9858,776,624,46,143,189,1.2416,21.1978653569564
Task_9859,2842,563,123,100,223,5.039007092198582,53.85771536295084
Task_9860,2783,938,200,185,385,2.9637912673056444,54.96251886656662
Task_9861,2529,549,141,91,232,4.598181818181819,48.82898338272886
Task_9862,2829,394,109,63,172,7.162025316455696,52.4967509211965
Task_9863,2071,670,126,152,278,3.0864381520119224,42.31144702204751
Task_9864,2446,672,190,93,283,3.6344725111441307,48.17713314709102
Task_9865,1627,978,63,47,110,1.661899897854954,34.40914720520952
Task_9866,1646,122,118,190,308,13.382113821138212,33.64312442851624
Task_9867,2941,375,176,105,281,7.821808510638298,55.07487371256597
Task_9868,2955,692,86,141,227,4.264069264069264,56.09754004061073
Task_9869,1903,389,27,183,210,4.87948717948718,38.48305721631255
Task_9870,1349,646,188,107,295,2.0850077279752703,30.811136798793374
Task_9871,1636,367,187,64,251,4.445652173913044,33.93028506448379
Task_9872,715,363,15,30,45,1.9642857142857142,17.37098605016991
Task_9873,2858,158,89,190,279,17.9748427672956,52.85869033144822
Task_9874,594,496,92,27,119,1.1951710261569417,16.73203526220146
Task_9875,1281,586,165,91,256,2.1822827938671208,29.29224145217989
Task_9876,974,290,184,32,216,3.3470790378006874,22.78020064288918
Task_9877,501,156,139,120,259,3.1910828025477707,15.514256141789204
Task_9878,2638,1007,86,153,239,2.617063492063492,52.13540971225248
Task_9879,848,942,172,182,354,0.8992576882290562,24.149068682875363
Task_9880,1083,163,57,116,173,6.603658536585366,24.25876575080645
Task_9881,2505,224,170,85,255,11.133333333333333,47.418651894410196
Task_9882,888,133,78,55,133,6.626865671641791,20.288803155566963
Task_9883,2238,401,34,126,160,5.567164179104478,43.35109948902271
Task_9884,1938,345,85,97,182,5.601156069364162,38.65870779444111
Task_9885,2482,391,168,131,299,6.331632653061225,47.98577088499085
Task_9886,1871,744,143,27,170,2.5114093959731543,38.135560570813254
Task_9887,1597,860,195,83,278,1.8548199767711964,35.22315796490838
Task_9888,2677,574,48,194,242,4.655652173913044,51.56350067867795
Task_9889,2649,896,108,191,299,2.9531772575250836,52.329093943561226
Task_9890,1391,290,130,200,330,4.780068728522337,30.63416228157797
Task_9891,2138,760,172,196,368,2.80946123521682,44.12553818977053
Task_9892,2518,393,93,183,276,6.3908629441624365,48.57307980100742
Task_9893,2698,387,29,180,209,6.953608247422681,51.058690443954305
Task_9894,799,562,179,36,215,1.419182948490231,20.86041694370965
Task_9895,1990,593,60,187,247,3.3501683501683504,40.76656573899387
Task_9896,2284,367,103,194,297,6.206521739130435,44.85643885561753
Task_9897,1579,202,66,142,208,7.778325123152709,32.74105170431864
Task_9898,1632,539,181,25,206,3.022222222222222,33.88708135142865
Task_9899,1909,348,149,52,201,5.469914040114613,37.960461925260496
Task_9900,2020,457,75,64,139,4.4104803493449785,39.77846102609147
Task_9901,2618,742,72,99,171,3.5235531628532972,50.63944011417187
Task_9902,585,170,48,78,126,3.4210526315789473,15.892985486122894
Task_9903,1313,211,120,60,180,6.193396226415095,27.912411945114073
Task_9904,2254,926,38,29,67,2.431499460625674,43.61757401813301
Task_9905,1074,289,65,194,259,3.703448275862069,25.360494395981206
Task_9906,535,777,184,75,259,0.6876606683804627,18.10267244426347
Task_9907,2489,528,31,87,118,4.705103969754253,47.41891340647488
Task_9908,2765,481,85,66,151,5.736514522821577,51.602277838687
Task_9909,2119,930,12,132,144,2.276047261009667,43.02273675192058
Task_9910,2088,528,109,104,213,3.947069943289225,41.767529873456255
Task_9911,1490,757,139,25,164,1.9656992084432718,32.138377959795164
Task_9912,1472,979,87,107,194,1.5020408163265306,33.255348139441345
Task_9913,827,827,102,169,271,0.998792270531401,23.040079395046444
Task_9914,1377,615,99,126,225,2.2353896103896105,30.871635059477693
Task_9915,2971,1012,116,93,209,2.932872655478776,57.22825941728829
Task_9916,2267,272,64,174,238,8.304029304029305,44.03661330875798
Task_9917,2152,924,40,51,91,2.3264864864864867,42.65378947191018
Task_9918,1084,999,112,93,205,1.084,27.198661547144813
Task_9919,2564,938,19,90,109,2.730564430244941,49.77374905018653
Task_9920,1895,677,49,91,140,2.7949852507374633,38.752494995708524
Task_9921,2491,972,99,25,124,2.5601233299075026,48.228171380464296
Task_9922,2907,428,33,130,163,6.776223776223776,54.167623671611246
Task_9923,1516,829,32,152,184,1.8265060240963855,33.55608326240549
Task_9924,2249,517,165,140,305,4.341698841698841,44.7488156691064
Task_9925,795,393,99,94,193,2.017766497461929,20.762102689508016
Task_9926,934,766,194,96,290,1.2177314211212515,24.535999039090683
Task_9927,2164,439,121,63,184,4.918181818181818,42.17549739143346
Task_9928,648,334,72,110,182,1.9343283582089552,18.25142332964702
Task_9929,856,723,121,74,195,1.1823204419889504,22.53398982336296
Task_9930,1674,300,184,178,362,5.561461794019934,35.25375485412594
Task_9931,1517,554,45,171,216,2.7333333333333334,32.94878484119664
Task_9932,1967,350,157,174,331,5.603988603988604,39.9090665833266
Task_9933,2690,351,78,148,226,7.642045454545454,50.90442598664495
Task_9934,2684,167,99,100,199,15.976190476190476,49.6562995299436
Task_9935,1481,688,57,116,173,2.1494920174165455,32.53090751547261
Task_9936,2704,997,22,78,100,2.7094188376753507,51.97367942877589
Task_9937,2166,490,53,183,236,4.411405295315682,43.17216312724531
Task_9938,538,270,165,85,250,1.985239852398524,16.479546086817795
Task_9939,514,698,12,185,197,0.7353361945636624,17.37850940429036
Task_9940,843,595,18,74,92,1.4144295302013423,21.06625116164553
Task_9941,1834,89,132,127,259,20.377777777777776,35.990171066588196
Task_9942,2614,743,100,71,171,3.513440860215054,50.23642733629717
Task_9943,2752,808,194,140,334,3.4017305315203954,53.76824558552553
Task_9944,1606,303,74,85,159,5.282894736842105,33.001924122711834
Task_9945,2036,842,178,124,302,2.4151838671411627,42.36291758572342
Task_9946,883,181,112,168,280,4.851648351648351,21.769526713254887
Task_9947,1868,76,190,152,342,24.25974025974026,36.84183738374434
Task_9948,2931,355,104,163,267,8.23314606741573,54.87018417200176
Task_9949,2786,658,85,50,135,4.227617602427921,52.235210261431455
Task_9950,2233,772,189,54,243,2.888745148771022,44.60097125166163
Task_9951,741,852,57,129,186,0.8686987104337632,21.319521345574646
Task_9952,784,633,153,55,208,1.2365930599369086,21.04108838585969
Task_9953,531,153,109,22,131,3.448051948051948,14.494992478824843
Task_9954,999,873,158,92,250,1.143020594965675,25.626737334293566
Task_9955,1678,432,193,38,231,3.8752886836027716,34.45640569885867
Task_9956,675,972,98,53,151,0.6937307297019527,20.26380006794246
Task_9957,2723,445,103,83,186,6.105381165919282,51.289479023988726
Task_9958,700,627,121,170,291,1.1146496815286624,20.469060505533477
Task_9959,738,925,168,150,318,0.796976241900648,22.164406271102806
Task_9960,2915,125,45,145,190,23.134920634920636,52.99008893687465
Task_9961,1856,494,76,42,118,3.7494949494949497,36.63052673755936
Task_9962,685,506,167,177,344,1.3510848126232742,20.135845369711138
Task_9963,967,97,165,173,338,9.86734693877551,22.807581649796784
Task_9964,519,308,23,24,47,1.6796116504854368,14.080000362709413
Task_9965,1882,121,101,124,225,15.426229508196721,36.8806437199051
Task_9966,2198,779,173,147,320,2.817948717948718,44.84743590382027
Task_9967,540,262,87,99,186,2.053231939163498,16.216882739629284
Task_9968,2352,671,108,68,176,3.5,45.879092385168406
Task_9969,1169,521,125,29,154,2.239463601532567,26.176537947679623
Task_9970,2024,497,82,186,268,4.06425702811245,41.06526058546877
Task_9971,616,892,39,42,81,0.6898096304591266,18.38464458935817
Task_9972,2796,262,53,138,191,10.631178707224334,52.09779982675741
Task_9973,2393,914,23,124,147,2.6153005464480876,47.35321427010863
Task_9974,753,610,89,72,161,1.23240589198036,20.184961193946233
Task_9975,1454,577,27,167,194,2.5155709342560555,31.880505314238736
Task_9976,639,161,74,198,272,3.9444444444444446,17.954274382234487
Task_9977,1048,676,87,125,212,1.5480059084194977,25.704466028822917
Task_9978,1345,926,22,194,216,1.4509169363538295,31.32245497151077
Task_9979,1539,547,190,41,231,2.8083941605839415,32.61234694596494
Task_9980,951,438,166,195,361,2.1662870159453305,24.28324903287613
Task_9981,2974,399,160,166,326,7.435,55.97048354030729
Task_9982,2476,552,196,165,361,4.477396021699819,48.744211856269544
Task_9983,797,997,83,153,236,0.7985971943887775,22.952161306608726
Task_9984,2574,437,198,152,350,5.876712328767123,49.85442266429042
Task_9985,2557,293,42,89,131,8.697278911564625,47.92968755446091
Task_9986,2398,543,163,154,317,4.408088235294118,47.26589211886312
Task_9987,2636,656,165,125,290,4.012176560121766,51.23078750216117
Task_9988,2590,92,155,135,290,27.849462365591396,48.01567452804314
Task_9989,2019,464,183,116,299,4.341935483870968,40.875152377664655
Task_9990,2773,482,110,61,171,5.74120082815735,51.82653027513354
Task_9991,899,728,60,147,207,1.233196159122085,23.597669608554355
Task_9992,2833,501,73,52,125,5.643426294820717,52.573503985338
Task_9993,960,73,131,162,293,12.972972972972974,22.437161591537485
Task_9994,705,866,35,97,132,0.8131487889273357,20.450220723620358
Task_9995,1478,205,190,183,373,7.174757281553398,31.883991905089417
Task_9996,2322,748,46,28,74,3.1001335113484645,44.158885274417024
Task_9997,1553,399,62,156,218,3.8825,33.05111782835254
Task_9998,967,127,138,23,161,7.5546875,21.35994902275768
Task_9999,2120,512,49,170,219,4.132553606237817,42.44286309318647
Task_10000,685,743,193,84,277,0.9206989247311828,20.392478139658465
Task_10001,1060,525,149,111,260,2.0152091254752853,25.70388336736299
Task_10002,1599,366,184,149,333,4.356948228882834,34.1127740833444
Task_10003,2760,579,55,28,83,4.758620689655173,50.8582771960555
Task_10004,1443,814,163,154,317,1.7705521472392638,32.97848766809704
Task_10005,2079,940,54,164,218,2.2093517534537725,43.09971469083164
Task_10006,2391,842,20,64,84,2.8362989323843415,46.226493644635354
Task_10007,2345,984,66,120,186,2.3807106598984773,47.21715354216118
Task_10008,2749,902,32,178,210,3.044296788482835,53.50967201471686
Task_10009,2165,280,164,111,275,7.704626334519573,42.45679420219947
Task_10010,1964,634,15,151,166,3.0929133858267717,39.94976566377954
Task_10011,2000,85,37,137,174,23.25581395348837,38.13304628234563
Task_10012,1912,841,71,142,213,2.2707838479809976,40.08033231611039
Task_10013,785,641,50,23,73,1.222741433021807,19.51411540748592
Task_10014,2898,796,196,23,219,3.6361355081555833,54.80331320316696
Task_10015,518,511,26,92,118,1.01171875,16.02355112633006
Task_10016,1333,454,117,57,174,2.9296703296703295,29.002181800551153
Task_10017,2681,719,138,64,202,3.723611111111111,51.379956638787405
Task_10018,664,509,67,154,221,1.3019607843137255,19.27708194889092
Task_10019,2001,338,120,172,292,5.902654867256637,40.22808587403303
Task_10020,2163,418,49,31,80,5.162291169451074,40.853988069055475
Task_10021,653,796,159,200,359,0.8193224592220828,20.64654022337218
Task_10022,820,729,48,11,59,1.1232876712328768,20.20238254940666
Task_10023,1655,876,178,19,197,1.887115165336374,35.233942005837854
Task_10024,827,539,68,130,198,1.5314814814814814,21.840987333647217
Task_10025,1837,339,182,92,274,5.402941176470589,37.387339055728475
Task_10026,2668,267,153,196,349,9.955223880597014,50.81847767513663
Task_10027,2052,714,59,69,128,2.86993006993007,41.240195522425914
Task_10028,2217,474,141,135,276,4.667368421052632,43.96580136758672
Task_10029,2933,455,56,16,72,6.432017543859649,52.68097861600782
Task_10030,1385,859,185,59,244,1.6104651162790697,31.426213284730107
Task_10031,865,808,87,181,268,1.069221260815822,23.48592350588747
Task_10032,2180,827,22,85,107,2.632850241545894,43.31152810469566
Task_10033,1039,181,189,25,214,5.708791208791209,23.21647426030621
Task_10034,1842,749,180,106,286,2.456,38.900382578365054
Task_10035,2394,667,158,150,308,3.5838323353293413,47.550345126654854
Task_10036,630,738,96,59,155,0.8525033829499323,18.593701794497576
Task_10037,2991,245,25,171,196,12.158536585365853,55.09922396057522
Task_10038,1046,999,104,31,135,1.046,25.637434770153657
Task_10039,1385,713,181,49,230,1.9397759103641457,30.791510525864634
Task_10040,2919,1019,141,38,179,2.861764705882353,55.718119196914294
Task_10041,2359,545,61,58,119,4.32051282051282,44.988312742507226
Task_10042,2480,772,200,118,318,3.2082794307891334,49.241538884070245
Task_10043,1447,627,82,44,126,2.304140127388535,30.72977927387204
Task_10044,740,102,99,185,284,7.184466019417476,19.09123081258397
Task_10045,2050,404,112,153,265,5.061728395061729,41.07203746845466
Task_10046,1774,109,12,61,73,16.12727272727273,33.27391090422005
Task_10047,1605,331,176,54,230,4.8343373493975905,33.193659744667606
Task_10048,2758,822,191,89,280,3.3511543134872417,53.546560829900464
Task_10049,1630,169,184,178,362,9.588235294117647,33.89295062798315
Task_10050,1966,788,83,199,282,2.491761723700887,41.140703319397765
Task_10051,764,725,131,42,173,1.0523415977961432,20.634136275302282
Task_10052,1230,303,126,78,204,4.046052631578948,27.262115691717593
Task_10053,2304,145,170,43,213,15.780821917808218,42.98757799817158
Task_10054,2781,800,121,186,307,3.4719101123595504,54.14829809933163
Task_10055,1111,597,91,135,226,1.8578595317725752,26.618079733698618
Task_10056,2261,176,142,117,259,12.774011299435028,43.272446366130644
Task_10057,1204,850,86,178,264,1.4148061104582843,29.01718645115248
Task_10058,2187,494,127,102,229,4.418181818181818,43.295143415702775
Task_10059,2772,348,142,187,329,7.9426934097421205,52.645668089454354
Task_10060,1030,716,136,148,284,1.4365411436541144,25.933089384340445
Task_10061,2903,786,137,161,298,3.6886912325285897,55.959876066271796
Task_10062,2191,956,109,38,147,2.2894461859979103,43.7555519301712
Task_10063,719,989,88,115,203,0.7262626262626263,21.511919692714272
Task_10064,2073,138,128,61,189,14.913669064748202,39.390454137858534
Task_10065,2306,904,35,29,64,2.5480662983425413,44.36651296261459
Task_10066,2089,304,11,100,111,6.849180327868853,40.26968087912322
Task_10067,1245,259,128,94,222,4.788461538461538,27.573941953703166
Task_10068,1002,679,19,12,31,1.473529411764706,22.667119710278072
Task_10069,1830,766,22,16,38,2.3859191655801824,36.083660554092155
Task_10070,1149,712,12,96,108,1.6115007012622722,26.63840866451876
Task_10071,1522,498,19,21,40,3.0501002004008018,30.451060659843876
Task_10072,2714,74,97,164,261,36.18666666666667,49.76190148123252
Task_10073,2041,1017,122,136,258,2.004911591355599,42.806171700895824
Task_10074,1457,67,150,116,266,21.426470588235293,30.012348730734562
Task_10075,2036,434,85,135,220,4.680459770114942,40.72504252935223
Task_10076,2475,353,98,109,207,6.991525423728813,47.304815829092234
Task_10077,1150,506,110,20,130,2.2682445759368837,25.659030334495913
Task_10078,2876,555,107,60,167,5.172661870503597,53.72802055878324
Task_10079,2937,376,187,176,363,7.790450928381963,55.488650029955714
Task_10080,2452,525,168,10,178,4.661596958174905,46.64276783684252
Task_10081,2522,1019,18,195,213,2.4725490196078432,50.30296624346611
Task_10082,868,530,34,28,62,1.6346516007532956,20.43329664038362
Task_10083,1568,303,165,194,359,5.157894736842105,33.59781445215918
Task_10084,2565,677,51,30,81,3.7831858407079646,48.12611144730363
Task_10085,634,386,197,56,253,1.6382428940568476,18.11165193449909
Task_10086,1645,584,79,53,132,2.8119658119658117,34.168799546448874
Task_10087,2253,210,180,33,213,10.677725118483412,42.688130864541456
Task_10088,726,995,148,174,322,0.7289156626506024,22.273552360342098
Task_10089,2116,760,23,57,80,2.780551905387648,41.40259072695485
Task_10090,2846,831,163,161,324,3.420673076923077,55.31549611064764
Task_10091,571,892,83,22,105,0.6394176931690929,17.660889211377402
Task_10092,1340,206,24,110,134,6.473429951690822,28.316038953464712
Task_10093,2278,88,120,57,177,25.59550561797753,41.99228517358725
Task_10094,1744,280,120,83,203,6.2064056939501775,35.36469030353832
Task_10095,696,96,127,159,286,7.175257731958763,18.28769360061445
Task_10096,2152,255,76,73,149,8.40625,41.31182651832074
Task_10097,1335,94,171,54,225,14.052631578947368,27.46853003450047
Task_10098,1700,318,174,177,351,5.329153605015674,35.6741586939692
Task_10099,578,885,63,21,84,0.6523702031602708,17.64970326305047
Task_10100,781,966,18,70,88,0.8076525336091003,21.18516989610448
Task_10101,672,117,65,32,97,5.694915254237288,16.03152283056662
Task_10102,1323,993,53,58,111,1.3309859154929577,29.909154134482662
Task_10103,979,622,77,22,99,1.5714285714285714,22.900500182113305
Task_10104,1072,228,147,190,337,4.681222707423581,25.401707813195074
Task_10105,856,290,174,179,353,2.941580756013746,22.249403948801824
Task_10106,2062,578,32,159,191,3.5613126079447324,41.49388048759925
Task_10107,677,576,139,86,225,1.173310225303293,19.479403616770924
Task_10108,563,1005,115,30,145,0.5596421471172962,18.396398072863402
Task_10109,1784,953,160,86,246,1.870020964360587,38.34102975555998
Task_10110,1224,123,185,70,255,9.870967741935484,26.26568015597806
Task_10111,1363,146,172,186,358,9.272108843537415,29.5814357325099
Task_10112,1705,905,153,86,239,1.8818984547461368,36.90851346664788
Task_10113,1644,272,116,109,225,6.021978021978022,33.96589379137134
Task_10114,1106,364,101,40,141,3.03013698630137,24.61169298468448
Task_10115,2006,205,162,29,191,9.737864077669903,38.66772613137642
Task_10116,665,600,83,100,183,1.1064891846921796,19.21499215447512
Task_10117,2585,815,82,168,250,3.167892156862745,50.8488631738387
Task_10118,1239,252,44,135,179,4.897233201581027,27.319324430086382
Task_10119,1238,180,148,124,272,6.8397790055248615,27.236739106081828
Task_10120,1324,286,156,184,340,4.613240418118467,29.58329773259504
Task_10121,2247,808,63,192,255,2.7775030902348576,45.55466558116092
Task_10122,1969,224,186,73,259,8.751111111111111,38.80131772657541
Task_10123,2523,801,75,46,121,3.1458852867830425,48.22177028789611
Task_10124,783,500,18,112,130,1.562874251497006,20.44216662865649
Task_10125,1593,231,46,77,123,6.866379310344827,32.2698746134402
Task_10126,1311,828,178,35,213,1.5814234016887816,29.78941887838377
Task_10127,678,759,162,152,314,0.8921052631578947,20.65831422360768
Task_10128,1530,837,167,72,239,1.8257756563245824,33.74951548818314
Task_10129,678,915,181,20,201,0.740174672489083,19.969265883623148
Task_10130,858,847,72,88,160,1.0117924528301887,22.790497012372327
Task_10131,1999,213,92,32,124,9.341121495327103,38.09703709951797
Task_10132,1560,480,98,182,280,3.2432432432432434,33.67600072940189
Task_10133,2762,250,150,35,185,11.00398406374502,50.743905554341715
Task_10134,2664,488,54,46,100,5.447852760736196,49.17779124859828
Task_10135,1530,772,176,85,261,1.9793014230271668,33.80895502186642
Task_10136,2578,355,141,25,166,7.241573033707865,48.09261805990451
Task_10137,952,651,89,51,140,1.460122699386503,23.281591197716526
Task_10138,2848,743,23,185,208,3.827956989247312,54.56998700325362
Task_10139,2297,927,75,173,248,2.4752155172413794,46.656819362093074
Task_10140,2639,923,117,81,198,2.856060606060606,51.53443854727879
Task_10141,2761,154,116,161,277,17.81290322580645,51.26270881952053
Task_10142,1397,452,155,68,223,3.0838852097130243,30.30219469364799
Task_10143,2484,441,18,58,76,5.619909502262443,45.98300612759263
Task_10144,776,252,94,55,149,3.067193675889328,19.407312522652532
Task_10145,1743,195,108,92,200,8.892857142857142,35.06353039251049
Task_10146,1372,289,64,97,161,4.731034482758621,29.372304902672784
Task_10147,2888,588,72,42,114,4.903225806451613,53.29157915905365
Task_10148,2534,609,30,62,92,4.154098360655738,47.769704212669176
Task_10149,1642,131,179,86,265,12.43939393939394,33.16607365918107
Task_10150,2006,458,136,178,314,4.37037037037037,40.80852775008918
Task_10151,654,165,37,82,119,3.9397590361445785,16.761233221775843
Task_10152,1441,107,31,97,128,13.342592592592593,28.966568112426742
Task_10153,2172,608,163,130,293,3.5665024630541873,43.75070798407703
Task_10154,1405,370,53,181,234,3.7870619946091644,30.729425473541323
Task_10155,1611,230,85,36,121,6.974025974025974,31.90442682279452
Task_10156,2808,732,65,30,95,3.830832196452933,52.23481106666218
Task_10157,1879,396,28,55,83,4.732997481108312,36.58591997288134
Task_10158,841,153,177,14,191,5.461038961038961,19.821137973081587
Task_10159,2177,242,53,121,174,8.958847736625515,42.116231860553114
Task_10160,2431,459,171,108,279,5.284782608695652,47.27852416468905
Task_10161,2219,509,81,34,115,4.350980392156862,42.40497494724262
Task_10162,1335,219,60,64,124,6.068181818181818,27.994702643605155
Task_10163,718,121,169,24,193,5.885245901639344,17.7337513362486
Task_10164,1567,907,109,159,268,1.725770925110132,35.018675027937434
Task_10165,777,1007,29,125,154,0.7708333333333334,22.03856046683353
Task_10166,2025,1015,44,110,154,1.9931102362204725,41.835289194611825
Task_10167,1790,422,196,121,317,4.231678486997636,37.2036019570027
Task_10168,744,995,24,40,64,0.7469879518072289,20.001912026377507
Task_10169,2772,1003,126,115,241,2.760956175298805,54.23949459552076
Task_10170,1030,802,33,129,162,1.2826899128268991,25.47884668266953
Task_10171,638,988,177,154,331,0.6450960566228514,20.929204441819756
Task_10172,1292,334,87,162,249,3.8567164179104476,28.75309746072738
Task_10173,1277,912,67,57,124,1.3986856516977,29.119716102540746
Task_10174,790,727,25,160,185,1.085164835164835,21.64147808648382
Task_10175,1429,329,150,125,275,4.33030303030303,31.0061398403143
Task_10176,2173,625,28,162,190,3.4712460063897765,43.3899699532588
Task_10177,2797,1017,104,126,230,2.7475442043222005,54.64587828672993
Task_10178,1094,685,70,180,250,1.5947521865889214,26.857000808102498
Task_10179,1523,1023,130,37,167,1.4873046875,33.55052805585794
Task_10180,955,198,32,129,161,4.798994974874372,22.451609270777045
Task_10181,1128,457,57,141,198,2.462882096069869,26.397361148326507
Task_10182,1776,829,120,14,134,2.139759036144578,36.56445895705419
Task_10183,2832,257,114,165,279,10.976744186046512,53.01219708925621
Task_10184,1536,593,183,145,328,2.585858585858586,33.811028915468306
Task_10185,1145,472,142,59,201,2.4207188160676534,26.217563345047854
Task_10186,810,362,74,100,174,2.231404958677686,20.863989835716396
Task_10187,2525,347,130,186,316,7.255747126436781,48.67524579881922
Task_10188,2471,214,26,134,160,11.493023255813954,46.35955143755467
Task_10189,2942,668,14,97,111,4.3976083707025415,54.994917105831924
Task_10190,2253,896,49,98,147,2.511705685618729,45.171234680934695
Task_10191,1634,596,44,155,199,2.7370184254606365,34.82233247260388
Task_10192,969,120,56,105,161,8.008264462809917,21.901619381808597
Task_10193,2977,258,19,199,218,11.494208494208495,55.06725599387832
Task_10194,2284,788,131,190,321,2.8948035487959443,46.305643879780575
Task_10195,1344,943,12,144,156,1.423728813559322,30.801887827038403
Task_10196,1467,636,176,178,354,2.30298273155416,33.018753404051004
Task_10197,2626,667,14,185,199,3.931137724550898,50.76867878576699
Task_10198,2801,124,89,62,151,22.408,50.34206712744322
Task_10199,2984,232,154,161,315,12.806866952789699,55.47402897185727
Task_10200,1295,432,57,168,225,2.9907621247113165,29.12251710864568
Task_10201,828,922,112,112,224,0.8970747562296858,23.08630528980849
Task_10202,777,336,76,137,213,2.3056379821958455,20.52211370690348
Task_10203,1527,692,161,76,237,2.2034632034632033,33.29581953992093
Task_10204,2370,276,156,43,199,8.555956678700362,44.72908109118328
Task_10205,1198,450,171,171,342,2.656319290465632,28.109727819205816
Task_10206,2915,761,150,65,215,3.825459317585302,55.294647971578684
Task_10207,1138,843,57,129,186,1.3483412322274881,27.60100093773572
Task_10208,1437,895,128,154,282,1.6037946428571428,32.977299331250414
Task_10209,2804,351,16,38,54,7.965909090909091,50.50203601125934
Task_10210,1219,578,52,142,194,2.105354058721934,28.207665019949005
Task_10211,2512,343,147,128,275,7.3023255813953485,48.186182820526774
Task_10212,2780,361,187,60,247,7.679558011049724,51.93722738978793
Task_10213,2477,86,128,130,258,28.471264367816094,46.04975274173274
Task_10214,1569,214,192,167,359,7.297674418604651,33.26669449962947
Task_10215,592,142,170,198,368,4.13986013986014,17.475710544143322
Task_10216,922,155,172,125,297,5.910256410256411,22.320102014403606
Task_10217,2879,783,119,43,162,3.6721938775510203,54.18609517118454
Task_10218,929,729,62,13,75,1.2726027397260273,21.86662573277849
Task_10219,2426,201,141,25,166,12.009900990099009,45.13278469488595
Task_10220,2218,452,126,100,226,4.896247240618101,43.63374122641371
Task_10221,1648,604,96,80,176,2.7239669421487602,34.72387026910927
Task_10222,2712,907,35,168,203,2.986784140969163,52.90955985585023
Task_10223,1187,78,57,74,131,15.025316455696203,24.644418071464568
Task_10224,2935,723,73,157,230,4.053867403314917,56.01558198394173
Task_10225,868,938,158,88,246,0.9243876464323749,23.76944896773108
Task_10226,1017,484,30,110,140,2.0969072164948455,24.155862230580343
Task_10227,1160,414,43,193,236,2.7951807228915664,26.965199388260896
Task_10228,2627,300,194,47,241,8.727574750830565,49.09015077007671
Task_10229,2219,226,165,152,317,9.775330396475772,43.364106815943394
Task_10230,694,910,177,67,244,0.7618002195389681,20.74451244035195
Task_10231,2234,888,120,121,241,2.5129358830146233,45.36434861384476
Task_10232,2950,192,119,24,143,15.284974093264248,53.19041417112268
Task_10233,1985,94,166,14,180,20.894736842105264,37.03855145055261
Task_10234,1480,968,19,147,166,1.5273477812177503,33.280559697821225
Task_10235,1164,152,165,69,234,7.607843137254902,25.44804979051401
Task_10236,734,127,185,35,220,5.734375,18.158610108848602
Task_10237,1342,833,197,128,325,1.6091127098321343,31.43526586559393
Task_10238,659,822,24,150,174,0.8007290400972054,19.850499677905546
Task_10239,645,349,11,114,125,1.8428571428571427,17.77753208503758
Task_10240,2921,626,72,124,196,4.6586921850079746,55.284048511531786
Task_10241,1054,950,98,114,212,1.1083070452155626,26.644038617977625
Task_10242,2492,412,108,151,259,6.033898305084746,48.0627057092957
Task_10243,1014,124,145,198,343,8.112,23.86888911982834
Task_10244,2214,377,177,81,258,5.857142857142857,43.33674694948496
Task_10245,1024,598,138,166,304,1.7095158597662772,25.627652358261727
Task_10246,1358,88,102,23,125,15.258426966292134,26.815964958396805
Task_10247,555,549,82,61,143,1.009090909090909,16.742707386967712
Task_10248,1040,699,31,99,130,1.4857142857142858,25.126011019188695
Task_10249,1338,513,43,51,94,2.603112840466926,28.501726575066296
Task_10250,1876,1021,160,123,283,1.8356164383561644,40.29740146854597
Task_10251,1745,253,69,80,149,6.8700787401574805,35.04161514166936
Task_10252,2662,375,84,27,111,7.079787234042553,48.94666432798126
Task_10253,2711,364,86,136,222,7.427397260273972,51.138611401168355
Task_10254,2915,268,106,45,151,10.8364312267658,52.948227389335194
Task_10255,1958,847,118,38,156,2.3089622641509435,39.74010984450615
Task_10256,2061,226,152,198,350,9.079295154185022,41.08491209263522
Task_10257,511,753,172,130,302,0.6777188328912467,18.02320558451125
Task_10258,1281,963,197,133,330,1.3288381742738589,30.868282532510865
Task_10259,905,888,65,183,248,1.0179977502812148,24.387167912951167
Task_10260,2898,570,67,162,229,5.075306479859895,54.95940434179409
Task_10261,2756,900,118,79,197,3.0588235294117645,53.31094147962019
Task_10262,2021,889,65,80,145,2.2707865168539327,41.40998824913956
Task_10263,849,283,38,39,77,2.98943661971831,19.391292413596585
Task_10264,696,742,185,194,379,0.9367429340511441,21.249883973105927
Task_10265,1244,825,115,130,245,1.5060532687651331,29.470805390243182
Task_10266,1044,423,188,121,309,2.4622641509433962,25.36485136899019
Task_10267,1895,367,43,110,153,5.149456521739131,37.72604558609053
Task_10268,1066,154,110,111,221,6.877419354838709,24.22179349126226
Task_10269,1254,495,101,184,285,2.528225806451613,28.900608227675495
Task_10270,2095,497,23,60,83,4.206827309236948,40.3309945658664
Task_10271,860,587,125,106,231,1.4625850340136055,22.538834860208436
Task_10272,571,333,87,53,140,1.7095808383233533,16.324115638021983
Task_10273,1423,306,35,15,50,4.635179153094462,28.320676225721765
Task_10274,1236,636,87,132,219,1.9403453689167975,28.644546569289588
Task_10275,1045,486,34,105,139,2.1457905544147846,24.606903415592626
Task_10276,1584,836,98,36,134,1.89247311827957,33.631289234722736
Task_10277,1774,354,27,130,157,4.997183098591549,35.82377011678971
Task_10278,858,266,62,94,156,3.2134831460674156,21.101964671388476
Task_10279,1407,379,155,18,173,3.7026315789473685,29.606990520070198
Task_10280,1248,350,13,151,164,3.5555555555555554,27.67908295589659
Task_10281,1502,918,136,125,261,1.6343852013057671,33.94147340781908
Task_10282,1414,326,92,61,153,4.324159021406728,29.651296632387155
Task_10283,2448,92,48,136,184,26.322580645161292,45.27909438829218
Task_10284,867,330,169,110,279,2.619335347432024,22.117315461962466
Task_10285,1957,140,148,173,321,13.879432624113475,38.70396122403614
Task_10286,2865,532,131,77,208,5.375234521575985,53.85441964234113
Task_10287,2338,544,45,157,202,4.289908256880734,45.833237468157904
Task_10288,826,997,16,38,54,0.8276553106212425,21.388559374578744
Task_10289,1483,742,18,166,184,1.9959623149394348,32.76977807242998
Task_10290,1550,279,196,130,326,5.535714285714286,32.989974840870055
Task_10291,554,808,38,193,231,0.6847960444993819,18.644747939298806
Task_10292,2405,377,97,70,167,6.362433862433862,45.7628800726576
Task_10293,2496,508,29,73,102,4.903732809430255,47.10263880049148
Task_10294,1966,102,124,158,282,19.0873786407767,38.30130077229335
Task_10295,2591,788,145,129,274,3.2839036755386566,50.868136823768076
Task_10296,1581,475,91,144,235,3.3214285714285716,33.729093274701114
Task_10297,2517,798,27,53,80,3.1501877346683353,47.86721340833938
Task_10298,1665,631,135,74,209,2.634493670886076,35.15463323189671
Task_10299,505,295,48,140,188,1.7060810810810811,15.94846065699756
Task_10300,1135,751,53,137,190,1.509308510638298,27.349781461224378
Task_10301,1991,652,75,43,118,3.0490045941807042,39.27952152365349
Task_10302,1235,114,101,179,280,10.73913043478261,26.933412918331125
Task_10303,2844,652,74,170,244,4.355283307810107,54.43174425025345
Task_10304,1208,284,45,103,148,4.23859649122807,26.6003939178123
Task_10305,644,911,169,149,318,0.706140350877193,20.695543537507074
Task_10306,2642,471,168,90,258,5.5974576271186445,50.504780927618036
Task_10307,1236,95,176,199,375,12.875,27.217457474415678
Task_10308,2130,262,174,73,247,8.098859315589353,41.42827515526331
Task_10309,2696,117,78,141,219,22.847457627118644,49.711029876122815
Task_10310,2804,168,62,100,162,16.59171597633136,51.20244150469188
Task_10311,2183,512,31,37,68,4.255360623781677,41.20443749688429
Task_10312,2103,963,200,186,386,2.1815352697095434,44.27100877724511
Task_10313,2664,530,122,93,215,5.016949152542373,50.87025894221235
Task_10314,738,834,117,101,218,0.8838323353293414,21.332905071453297
Task_10315,1328,745,153,128,281,1.7801608579088473,30.74154490038101
Task_10316,1123,833,117,139,256,1.3465227817745804,27.637152183949567
Task_10317,2124,803,69,194,263,2.6417910447761193,43.63461290854023
Task_10318,2660,655,187,75,262,4.054878048780488,51.23175410709971
Task_10319,1258,736,26,64,90,1.7069199457259159,27.997877192227108
Task_10320,1217,777,50,79,129,1.56426735218509,28.33083018386931
Task_10321,1616,787,18,154,172,2.050761421319797,34.95112506017805
Task_10322,792,612,148,120,268,1.2920065252854813,21.71971034563715
Task_10323,2601,645,186,179,365,4.026315789473684,51.05872660835769
Task_10324,1827,1011,183,14,197,1.8053359683794465,38.35659116624107
Task_10325,558,1011,195,176,371,0.5513833992094862,19.902274346659627
Task_10326,2886,562,106,73,179,5.126110124333925,54.05629903897202
Task_10327,1963,510,121,113,234,3.8414872798434443,39.83882937331021
Task_10328,2984,380,99,192,291,7.832020997375328,55.94648249947695
Task_10329,1914,772,156,103,259,2.476067270375162,39.98683270673866
Task_10330,605,73,71,31,102,8.175675675675675,14.46875772859453
Task_10331,1490,926,51,41,92,1.6073354908306365,31.98080488447263
Task_10332,2575,501,182,154,336,5.129482071713148,50.01871085104892
Task_10333,1913,299,87,193,280,6.376666666666667,38.64172530369851
Task_10334,1331,680,46,49,95,1.9544787077826726,28.78018746947313
Task_10335,1098,956,45,83,128,1.1473354231974922,26.994812108416543
Task_10336,2811,223,191,185,376,12.549107142857142,53.01626140900843
Task_10337,1594,448,130,161,291,3.5501113585746102,34.1266430358368
Task_10338,1533,554,20,31,51,2.7621621621621624,31.00019497383604
Task_10339,639,826,92,53,145,0.7726723095525998,19.208378028013765
Task_10340,2283,918,185,111,296,2.484221980413493,46.46756922950593
Task_10341,2995,338,65,49,114,8.834808259587021,54.2332755380686
Task_10342,1233,834,102,126,228,1.4766467065868263,29.230856360166868
Task_10343,550,449,191,66,257,1.2222222222222223,17.030455266481752
Task_10344,1130,99,103,32,135,11.3,23.43735201062201
Task_10345,1698,987,114,53,167,1.7186234817813766,36.48349171826721
Task_10346,2762,880,193,142,335,3.135073779795687,54.15994177198743
Task_10347,779,310,66,65,131,2.504823151125402,19.713083709474073
Task_10348,736,798,51,159,210,0.9211514392991239,21.26555970224394
Task_10349,1130,75,38,26,64,14.868421052631579,22.38967782953324
Task_10350,771,765,88,25,113,1.0065274151436032,20.283263892564893
Task_10351,1480,470,34,46,80,3.142250530785563,30.24740339610035
Task_10352,522,778,122,31,153,0.6700898587933247,17.011822540366936
Task_10353,2773,792,31,110,141,3.4968474148802016,52.94326601644497
Task_10354,1769,244,99,68,167,7.220408163265306,35.239797374157
Task_10355,2843,399,141,168,309,7.1075,53.82392837545401
Task_10356,669,977,19,102,121,0.6840490797546013,20.075944384126053
Task_10357,2684,621,48,63,111,4.315112540192926,50.51935474250117
Task_10358,2571,317,191,87,278,8.084905660377359,48.92184129068457
Task_10359,2494,136,125,83,208,18.204379562043794,46.34247624282043
Task_10360,905,247,160,116,276,3.649193548387097,22.44389936180903
Task_10361,1023,747,181,123,304,1.3676470588235294,25.97893991129797
Task_10362,991,336,22,122,144,2.940652818991098,23.29469421449709
Task_10363,2840,324,33,172,205,8.738461538461538,53.06345325384628
Task_10364,1677,323,14,167,181,5.175925925925926,34.49568640863739
Task_10365,2445,279,143,47,190,8.732142857142858,45.90559329238957
Task_10366,643,337,64,107,171,1.9023668639053255,18.1177578324582
Task_10367,1838,892,77,131,208,2.0582306830907053,39.03502069901686
Task_10368,2797,638,63,39,102,4.377151799687011,51.744919297782054
Task_10369,1569,452,177,17,194,3.4635761589403975,32.51447238289425
Task_10370,667,157,70,72,142,4.2215189873417724,17.167134339968964
Task_10371,1988,673,23,57,80,2.949554896142433,39.10193228650093
Task_10372,949,884,109,19,128,1.072316384180791,23.784164024198322
Task_10373,1395,850,154,15,169,1.6392479435957696,30.83350100989482
Task_10374,2271,318,116,111,227,7.1191222570532915,44.047993840188916
Task_10375,1096,411,170,193,363,2.6601941747572817,26.498620299825905
Task_10376,1120,623,44,155,199,1.794871794871795,26.766737895185443
Task_10377,1347,268,143,64,207,5.007434944237918,28.83432000307158
Task_10378,2882,961,101,12,113,2.995841995841996,54.27660799367201
Task_10379,2083,854,181,180,361,2.4362573099415203,43.49304854356575
Task_10380,803,880,147,158,305,0.9114642451759364,22.98552239897482
Task_10381,2859,973,53,168,221,2.935318275154004,55.58414454037277
Task_10382,2326,552,128,122,250,4.206148282097649,45.80574864973454
Task_10383,2876,821,170,154,324,3.4987834549878345,55.74913384243077
Task_10384,2105,542,37,99,136,3.876611418047882,41.54903115430817
Task_10385,1632,492,144,130,274,3.310344827586207,34.746459485293464
Task_10386,1796,1018,109,72,181,1.762512266928361,38.22120914213021
Task_10387,1152,250,64,117,181,4.589641434262949,25.96219546943442
Task_10388,552,360,142,143,285,1.5290858725761773,17.26266712410817
Task_10389,2027,966,19,33,52,2.09617373319545,40.111855751352145
Task_10390,2545,585,126,139,265,4.343003412969283,49.47155663824668
Task_10391,2514,757,21,99,120,3.316622691292876,48.510938653192994
Task_10392,742,568,80,188,268,1.3040421792618628,20.93628196588996
Task_10393,2693,567,67,180,247,4.741197183098592,51.81108349656159
Task_10394,2574,920,24,87,111,2.794788273615635,49.94027606785141
Task_10395,1826,957,99,97,196,1.9060542797494782,38.906175317827426
Task_10396,2668,900,185,197,382,2.9611542730299667,53.025544681917495
Task_10397,1374,249,55,88,143,5.496,29.127378441233187
Task_10398,732,862,164,146,310,0.8482039397450754,21.802935859043686
Task_10399,1282,392,113,152,265,3.262086513994911,28.879391809606236
Task_10400,1295,391,50,69,119,3.3035714285714284,27.930934198180214
Task_10401,573,605,188,98,286,0.9455445544554455,18.32712581801186
Task_10402,1499,579,40,162,202,2.5844827586206898,32.6479783961464
Task_10403,2493,272,37,125,162,9.131868131868131,47.025603309767554
Task_10404,782,671,74,82,156,1.1636904761904763,21.094003255733167
Task_10405,1928,76,77,125,202,25.038961038961038,37.204992491225156
Task_10406,2403,399,126,197,323,6.0075,46.96723756833478
Task_10407,1090,599,186,131,317,1.8166666666666667,26.69669534437776
Task_10408,895,171,150,119,269,5.203488372093023,21.80335455098464
Task_10409,1010,871,48,145,193,1.158256880733945,25.714109154795675
Task_10410,2279,93,77,125,202,24.24468085106383,42.82071407576629
Task_10411,1192,1002,154,166,320,1.1884346959122631,29.569138041435036
Task_10412,1996,208,67,147,214,9.55023923444976,39.3778264974979
Task_10413,2941,345,83,19,102,8.5,53.05932672350022
Task_10414,2383,528,30,20,50,4.504725897920605,44.254907912139345
Task_10415,699,581,160,122,282,1.2010309278350515,20.218067434497826
Task_10416,1192,813,115,118,233,1.4643734643734643,28.526899975972423
Task_10417,2969,471,119,77,196,6.290254237288136,55.248055139855836
Task_10418,1040,953,134,80,214,1.090146750524109,26.31422583525456
Task_10419,2269,199,194,59,253,11.345,43.311121466190194
Task_10420,992,169,19,153,172,5.8352941176470585,22.786588612045772
Task_10421,2437,751,150,24,174,3.2406914893617023,47.140534576026454
Task_10422,1333,191,15,31,46,6.942708333333333,26.750073106962436
Task_10423,940,942,80,20,100,0.9968186638388123,23.38839999901987
Task_10424,571,280,93,152,245,2.0320284697508897,17.224204160006906
Task_10425,1809,728,58,188,246,2.4814814814814814,38.32166314519579
Task_10426,2528,74,26,200,226,33.70666666666666,46.70258371162026
Task_10427,770,469,28,98,126,1.6382978723404256,20.189058749995556
Task_10428,985,469,12,185,197,2.095744680851064,24.129274821309483
Task_10429,1124,188,195,65,260,5.947089947089947,25.3755631248238
Task_10430,2229,606,125,30,155,3.672158154859967,43.25764132856077
Task_10431,1428,152,25,75,100,9.333333333333334,28.580345443905184
Task_10432,1945,126,40,196,236,15.31496062992126,38.0190111078351
Task_10433,2094,835,171,31,202,2.5047846889952154,42.171313560855474
Task_10434,2475,442,149,180,329,5.586907449209932,48.25034498167003
Task_10435,2115,86,128,61,189,24.310344827586206,39.496066732947504
Task_10436,1480,317,95,12,107,4.654088050314465,30.00500382642171
Task_10437,2202,863,121,189,310,2.548611111111111,45.18996107324674
Task_10438,1763,905,58,192,250,1.945916114790287,38.16865143691568
Task_10439,1289,835,112,98,210,1.541866028708134,30.017686486795274
Task_10440,1107,421,163,175,338,2.623222748815166,26.56538438809653
Task_10441,2510,909,127,69,196,2.758241758241758,49.23983738028044
Task_10442,1187,280,67,110,177,4.224199288256227,26.603338406400763
Task_10443,2002,704,45,13,58,2.8397163120567375,38.78863577086499
Task_10444,2842,850,72,92,164,3.339600470035253,54.49396184544912
Task_10445,2039,198,147,81,228,10.246231155778894,39.84623869331008
Task_10446,1717,843,27,142,169,2.0343601895734595,36.68418666148955
Task_10447,1387,859,38,72,110,1.6127906976744186,30.84358244965921
Task_10448,645,314,108,107,215,2.0476190476190474,18.262724534466955
Task_10449,2927,1001,84,49,133,2.9211576846307383,55.575909237797624
Task_10450,797,907,71,175,246,0.8777533039647577,22.75062310880448
Task_10451,1573,985,98,131,229,1.5953346855983772,35.14320881480638
Task_10452,2680,775,59,158,217,3.4536082474226806,52.09280420159979
Task_10453,1731,414,119,156,275,4.171084337349398,36.10605859914991
Task_10454,2748,619,195,119,314,4.432258064516129,52.9863871742592
Task_10455,555,807,15,106,121,0.6868811881188119,17.776472715346486
Task_10456,1927,224,23,102,125,8.564444444444444,37.632614024301056
Task_10457,1078,98,130,125,255,10.88888888888889,24.11352292249741
Task_10458,1219,761,129,19,148,1.599737532808399,27.68415391199783
Task_10459,2839,184,74,72,146,15.345945945945946,51.897521410274805
Task_10460,1567,202,93,185,278,7.719211822660099,32.89120721721669
Task_10461,2036,890,117,41,158,2.285072951739618,41.09244162197872
Task_10462,623,672,10,28,38,0.9257057949479941,16.920657231022968
Task_10463,832,737,136,68,204,1.127371273712737,22.13168238647275
Task_10464,2662,968,104,124,228,2.7471620227038183,52.341767874887786
Task_10465,1383,1003,106,55,161,1.3774900398406376,31.347159124279518
Task_10466,2309,101,126,55,181,22.637254901960784,42.67183415682245
Task_10467,1853,1000,173,95,268,1.8511488511488512,39.772557153464035
Task_10468,551,439,26,68,94,1.2522727272727272,15.965666434119791
Task_10469,1695,667,84,16,100,2.537425149700599,34.40030841043349
Task_10470,2416,75,44,115,159,31.789473684210527,44.12774120500333
Task_10471,1698,787,30,57,87,2.1548223350253806,34.9751242287934
Task_10472,2506,356,61,108,169,7.019607843137255,47.64732044553502
Task_10473,883,953,72,24,96,0.9255765199161425,22.664262757478184
Task_10474,2183,518,33,122,155,4.20616570327553,42.828540077712795
Task_10475,2139,925,182,133,315,2.3099352051835855,44.32548615441175
Task_10476,502,276,194,50,244,1.812274368231047,15.49902201707711
Task_10477,1623,822,35,100,135,1.9720534629404618,34.78787630510319
Task_10478,2609,945,178,59,237,2.7579281183932345,51.05228719527165
Task_10479,818,666,138,46,184,1.2263868065967016,21.34688079224573
Task_10480,1754,593,88,129,217,2.952861952861953,36.6983882867899
Task_10481,2315,722,110,132,242,3.2019363762102353,46.14849516281003
Task_10482,1765,236,170,67,237,7.447257383966245,35.46996008418079
Task_10483,871,147,118,70,188,5.885135135135135,20.57589037355419
Task_10484,764,611,192,61,253,1.2483660130718954,20.843103288228765
Task_10485,2487,961,52,179,231,2.585239085239085,49.71299543548164
Task_10486,1671,449,186,137,323,3.7133333333333334,35.45762664800472
Task_10487,1289,320,60,188,248,4.015576323987539,28.802665438646716
Task_10488,595,722,26,11,37,0.8229598893499308,16.6003091886572
Task_10489,1815,517,16,117,133,3.503861003861004,36.89497842011462
Task_10490,2998,289,37,21,58,10.337931034482759,53.299579876729744
Task_10491,2815,309,197,67,264,9.080645161290322,52.446351471207855
Task_10492,2123,561,163,180,343,3.7775800711743774,43.124211705582674
Task_10493,652,237,53,183,236,2.7394957983193278,18.404164683007522
Task_10494,2051,893,151,126,277,2.2941834451901566,42.64986650327657
Task_10495,2899,780,24,93,117,3.7119078104993597,54.702656745099056
Task_10496,1421,347,55,118,173,4.083333333333333,30.506049503214637
Task_10497,1246,489,199,190,389,2.5428571428571427,29.232553410520683
Task_10498,756,509,68,77,145,1.4823529411764707,20.100391475246628
Task_10499,2015,280,153,199,352,7.170818505338079,40.56182612927163
Task_10500,1601,461,11,177,188,3.465367965367965,33.78500704115594
Task_10501,2527,218,39,120,159,11.538812785388128,47.25975895908132
Task_10502,1632,577,194,41,235,2.823529411764706,34.19763774176065
Task_10503,2366,727,117,197,314,3.25,47.39190918079305
Task_10504,1717,943,152,52,204,1.81885593220339,36.81569803400597
Task_10505,2660,312,114,123,237,8.498402555910543,50.24110495285996
Task_10506,954,572,151,29,180,1.6649214659685865,23.17799307301651
Task_10507,1241,932,45,70,115,1.330117899249732,28.711941000651404
Task_10508,1564,146,34,187,221,10.639455782312925,32.07957335565243
Task_10509,2253,643,23,42,65,3.498447204968944,42.74826661697978
Task_10510,2112,583,24,138,162,3.6164383561643834,42.000503620842935
Task_10511,2607,819,48,104,152,3.1792682926829268,50.46990529963614
Task_10512,2507,617,18,71,89,4.05663430420712,47.471278181864314
Task_10513,2376,546,200,165,365,4.343692870201097,47.15961538938378
Task_10514,2338,461,60,96,156,5.0606060606060606,45.16799946002197
Task_10515,1676,98,61,81,142,16.92929292929293,32.59696244002191
Task_10516,632,967,190,95,285,0.6528925619834711,20.50205465826539
Task_10517,2817,403,42,90,132,6.9727722772277225,52.43622343954854
Task_10518,2333,731,51,148,199,3.1871584699453552,46.38976217522855
Task_10519,1002,861,15,163,178,1.1624129930394431,25.42239309915769
Task_10520,2375,767,14,23,37,3.0924479166666665,44.80104656657045
Task_10521,2212,725,62,84,146,3.046831955922865,43.95856292482398
Task_10522,1971,329,148,139,287,5.972727272727273,39.65251056071714
Task_10523,2889,163,63,156,219,17.615853658536587,53.09290381819691
Task_10524,1426,799,41,53,94,1.7825,30.803014906824114
Task_10525,500,1006,86,20,106,0.49652432969215493,16.770869716744144
Task_10526,1559,409,157,148,305,3.8024390243902437,33.491573566460225
Task_10527,1651,192,30,109,139,8.55440414507772,33.18466051949884
Task_10528,2046,255,95,126,221,7.9921875,40.27661701154341
Task_10529,2814,554,151,38,189,5.07027027027027,52.64059016063384
Task_10530,1914,962,19,192,211,1.9875389408099688,40.47810174066279
Task_10531,513,656,53,145,198,0.7808219178082192,17.24034904585417
Task_10532,2618,570,125,99,224,4.584938704028021,50.330203439425325
Task_10533,2745,536,67,85,152,5.111731843575419,51.74850325657558
Task_10534,2673,625,52,179,231,4.2699680511182105,51.60360013727175
Task_10535,1657,847,194,145,339,1.9540094339622642,36.571110374089706
Task_10536,2039,101,20,191,211,19.99019607843137,39.15446576609326
Task_10537,1644,776,15,142,157,2.115830115830116,35.11225000350755
Task_10538,2096,319,179,62,241,6.55,40.955417219165184
Task_10539,1738,497,126,77,203,3.4899598393574296,35.87658257347926
Task_10540,2805,638,105,69,174,4.389671361502347,52.93388504372305
Task_10541,1862,614,131,99,230,3.0276422764227644,38.524827995795796
Task_10542,2841,537,175,50,225,5.280669144981412,53.26449194169111
Task_10543,1387,487,54,59,113,2.8422131147540983,29.457696657104943
Task_10544,877,491,124,21,145,1.782520325203252,21.420187722492376
Task_10545,575,951,57,129,186,0.6039915966386554,19.179024447169166
Task_10546,1875,662,163,188,351,2.828054298642534,39.56359653716907
Task_10547,989,234,29,17,46,4.208510638297873,21.157440764145118
Task_10548,1188,471,19,14,33,2.516949152542373,24.956156129653966
Task_10549,2146,227,50,139,189,9.412280701754385,41.714044734205096
Task_10550,1599,648,17,24,41,2.463790446841294,32.170529647774316
Task_10551,1258,265,169,168,337,4.7293233082706765,28.432967408402515
Task_10552,1374,405,152,185,337,3.3842364532019706,30.74970775070859
Task_10553,628,375,111,147,258,1.6702127659574468,18.425614543699
Task_10554,2785,817,32,135,167,3.404645476772616,53.51012504089406
Task_10555,922,907,93,17,110,1.0154185022026432,23.13977245922054
Task_10556,2587,442,160,74,234,5.839729119638826,49.2610640233945
Task_10557,2865,633,162,125,287,4.518927444794953,54.7711276211549
Task_10558,1398,263,196,192,388,5.295454545454546,30.903733141539746
Task_10559,2523,496,127,68,195,5.076458752515091,48.13945887009009
Task_10560,2484,935,73,179,252,2.6538461538461537,49.66691151349338
Task_10561,1327,721,51,156,207,1.8379501385041552,30.470085316564326
Task_10562,2482,629,121,200,321,3.93968253968254,48.95568670658719
Task_10563,1132,728,61,48,109,1.5528120713305897,25.786401722814656
Task_10564,1747,262,44,32,76,6.642585551330798,33.51523044365428
Task_10565,2105,173,88,120,208,12.097701149425287,40.56748675326583
Task_10566,570,1019,151,181,332,0.5588235294117647,19.965041449366584
Task_10567,2039,261,126,20,146,7.782442748091603,39.064562683701205
Task_10568,1715,481,179,178,357,3.5580912863070537,36.46978882263918
Task_10569,2197,652,192,63,255,3.364471669218989,43.733813013540264
Task_10570,2384,216,163,105,268,10.986175115207374,45.64190219684712
Task_10571,2131,815,44,98,142,2.611519607843137,42.86786512626992
Task_10572,1988,171,117,116,233,11.55813953488372,38.87466139411293
Task_10573,1534,432,48,75,123,3.5427251732101617,32.00149352051128
Task_10574,1251,415,51,185,236,3.0072115384615383,28.47823847800234
Task_10575,1082,669,130,87,217,1.6149253731343283,26.20230835800358
Task_10576,606,909,93,153,246,0.6659340659340659,19.88516417168427
Task_10577,1379,493,10,169,179,2.791497975708502,30.311566763523018
Task_10578,1492,401,35,169,204,3.711442786069652,31.995371866517804
Task_10579,2077,468,51,186,237,4.428571428571429,41.727480651152185
Task_10580,643,897,96,189,285,0.7160356347438753,20.548932143717987
Task_10581,2008,120,180,197,377,16.59504132231405,39.65124242719282
Task_10582,2240,169,111,59,170,13.176470588235293,42.07495420171849
Task_10583,622,687,44,157,201,0.9040697674418605,18.999074772663654
Task_10584,789,351,101,127,228,2.241477272727273,20.745612407346577
Task_10585,1371,849,11,140,151,1.6129411764705883,30.931600135898933
Task_10586,1412,736,198,60,258,1.9158751696065128,31.530566797188527
Task_10587,1255,702,148,127,275,1.7852062588904694,29.436157352732433
Task_10588,1339,716,156,58,214,1.8675034867503486,30.121599963592775
Task_10589,2575,506,27,145,172,5.0788954635108485,49.24413543283065
Task_10590,1803,452,86,119,205,3.980132450331126,36.95858755103679
Task_10591,626,249,80,70,150,2.504,17.03905215222496
Task_10592,589,703,132,101,233,0.8366477272727273,18.63202035495381
Task_10593,1922,493,175,196,371,3.8906882591093117,39.87453640420433
Task_10594,2554,516,11,117,128,4.940038684719536,48.68060980274874
Task_10595,1819,953,99,167,266,1.9067085953878407,39.172543425376944
Task_10596,578,781,110,35,145,0.7391304347826086,17.708806115952388
Task_10597,2856,130,88,70,158,21.801526717557252,51.23235874862785
Task_10598,2912,267,19,10,29,10.865671641791044,51.54622393600809
Task_10599,862,909,135,33,168,0.9472527472527472,22.77140337514557
Task_10600,2210,377,178,142,320,5.8465608465608465,43.74645127657711
Task_10601,2518,755,96,111,207,3.3306878306878307,49.28726260429511
Task_10602,1553,748,62,95,157,2.0734312416555407,33.64046075999038
Task_10603,2782,885,18,48,66,3.139954853273138,51.96319607669511
Task_10604,1135,398,88,31,119,2.844611528822055,24.905107770764882
Task_10605,1296,689,43,92,135,1.8782608695652174,29.201950825275592
Task_10606,926,562,118,175,293,1.644760213143872,23.927019971542098
Task_10607,699,579,67,42,109,1.2051724137931035,18.579011932337327
Task_10608,1983,421,142,106,248,4.699052132701421,39.92170690714028
Task_10609,2031,787,116,46,162,2.5774111675126905,40.77247646022092
Task_10610,2335,882,96,114,210,2.6443941109852775,46.803679605716034
Task_10611,2758,70,80,189,269,38.84507042253521,50.53139050109821
Task_10612,2281,795,84,72,156,2.8655778894472363,45.034236763091464
Task_10613,1809,653,41,115,156,2.7660550458715596,37.33356956896345
Task_10614,1227,138,66,65,131,8.827338129496402,25.769301597799878
Task_10615,2927,975,10,136,146,2.9989754098360657,55.991987371966985
Task_10616,1183,475,186,49,235,2.485294117647059,26.86922375500423
Task_10617,2975,674,162,188,350,4.407407407407407,57.02017798574218
Task_10618,923,240,82,136,218,3.8298755186721993,22.515003863489866
Task_10619,2960,379,53,39,92,7.7894736842105265,53.44999003563677
Task_10620,1818,528,81,147,228,3.436672967863894,37.67655936235199
Task_10621,1290,595,106,182,288,2.164429530201342,29.79552858830506
Task_10622,1772,767,63,195,258,2.3072916666666665,37.919078134087236
Task_10623,1553,285,85,109,194,5.43006993006993,32.43798454915699
Task_10624,2402,416,159,15,174,5.7601918465227815,45.472481880220926
Task_10625,2902,169,111,121,232,17.070588235294117,53.283115757386945
Task_10626,1402,991,118,35,153,1.4133064516129032,31.32029049576944
Task_10627,2959,191,31,31,62,15.411458333333334,52.502857494767674
Task_10628,2422,194,149,38,187,12.42051282051282,45.21149907367825
Task_10629,508,725,116,174,290,0.699724517906336,17.87479285463876
Task_10630,617,442,147,145,292,1.3927765237020315,18.57140552593808
Task_10631,1136,472,179,74,253,2.40169133192389,26.476209073284252
Task_10632,1501,380,108,28,136,3.9396325459317585,30.879965022762658
Task_10633,2920,787,19,84,103,3.7055837563451774,54.852361785875
Task_10634,584,866,72,54,126,0.6735870818915801,18.33926172416589
Task_10635,1682,672,19,132,151,2.49925705794948,35.33208611193252
Task_10636,2316,64,178,19,197,35.63076923076923,42.047483422675775
Task_10637,878,158,196,101,297,5.522012578616352,21.609115685763083
Task_10638,851,330,148,41,189,2.5709969788519635,20.842814968860026
Task_10639,2599,163,145,147,292,15.847560975609756,48.796160354461534
Task_10640,2621,750,87,37,124,3.490013315579228,49.64719060999044
Task_10641,843,645,160,31,191,1.304953560371517,21.71487119475189
Task_10642,1365,768,112,108,220,1.7750325097529258,31.095034150286267
Task_10643,1181,402,115,175,290,2.930521091811414,27.45961882561563
Task_10644,2762,921,49,184,233,2.995661605206074,53.986136559547326
Task_10645,2117,197,92,135,227,10.691919191919192,41.259937129743506
Task_10646,2999,880,59,173,232,3.4040862656072646,57.56632325561549
Task_10647,554,312,167,45,212,1.7699680511182108,16.17603194399955
Task_10648,1262,218,96,122,218,5.762557077625571,27.73952674727337
Task_10649,1481,717,109,181,290,2.062674094707521,33.209671305345324
Task_10650,2285,479,53,140,193,4.760416666666667,44.76367073008762
Task_10651,643,561,60,159,219,1.1441281138790036,19.089546374618887
Task_10652,2341,720,153,166,319,3.246879334257975,46.95095345239361
Task_10653,773,418,22,14,36,1.8448687350835322,18.22983163383726
Task_10654,2349,457,89,95,184,5.12882096069869,45.492261402194536
Task_10655,2133,629,59,122,181,3.3857142857142857,42.715107111940064
Task_10656,2933,421,133,168,301,6.950236966824645,55.28565692201308
Task_10657,1528,318,184,10,194,4.789968652037618,31.429899792713794
Task_10658,751,65,118,71,189,11.378787878787879,18.224674650611277
Task_10659,657,571,127,57,184,1.1486013986013985,18.69105886511062
Task_10660,589,157,74,117,191,3.7278481012658227,16.668314553575044
Task_10661,2134,157,149,54,203,13.50632911392405,40.62724517788237
Task_10662,1220,656,98,167,265,1.856925418569254,28.756166915181335
Task_10663,2317,816,14,130,144,2.835985312117503,45.820760601563876
Task_10664,2351,429,99,141,240,5.467441860465116,45.78865190313426
Task_10665,1618,471,188,117,305,3.4279661016949152,34.578607062389004
Task_10666,2485,214,185,41,226,11.55813953488372,46.43411398787236
Task_10667,2741,106,185,152,337,25.61682242990654,50.750013634042176
Task_10668,919,263,171,78,249,3.481060606060606,22.417489719921225
Task_10669,519,79,119,145,264,6.4875,15.36844593665741
Task_10670,1195,848,79,54,133,1.4075382803297998,27.82406722229832
Task_10671,782,115,153,52,205,6.741379310344827,18.942223640057676
Task_10672,742,376,30,103,133,1.9681697612732096,19.47091663731944
Task_10673,2976,247,135,107,242,12.0,54.99778767319467
Task_10674,2141,815,41,153,194,2.6237745098039214,43.5106844008311
Task_10675,1611,492,109,102,211,3.2677484787018254,34.08902156862648
Task_10676,2874,433,58,197,255,6.622119815668203,54.29682694589611
Task_10677,2945,964,161,169,330,3.051813471502591,57.33952033438053
Task_10678,2757,358,141,86,227,7.67966573816156,51.76851975130122
Task_10679,2729,209,197,29,226,12.995238095238095,50.255273652692516
Task_10680,1167,548,45,117,162,2.1256830601092895,26.931208195066066
Task_10681,1224,188,89,10,99,6.476190476190476,25.483687037511938
Task_10682,2615,591,33,72,105,4.41722972972973,49.28827828893218
Task_10683,2718,673,163,99,262,4.032640949554896,52.413214531531686
Task_10684,1190,585,88,38,126,2.030716723549488,26.573777789342316
Task_10685,1171,654,26,89,115,1.7877862595419847,26.90983705481332
Task_10686,2397,882,32,163,195,2.714609286523216,47.780063802161955
Task_10687,1233,561,169,139,308,2.193950177935943,28.813428738748893
Task_10688,1937,744,70,49,119,2.6,38.83464740843652
Task_10689,2300,404,145,196,341,5.679012345679013,45.43358238357026
Task_10690,558,953,49,112,161,0.5849056603773585,18.72487902366065
Task_10691,2531,349,35,10,45,7.231428571428571,45.93099359934393
Task_10692,1684,876,139,137,276,1.9201824401368301,36.79345299778203
Task_10693,2131,984,133,57,190,2.163451776649746,43.392090148500436
Task_10694,2155,890,172,77,249,2.4186307519640855,43.924196632019196
Task_10695,1090,371,143,42,185,2.9301075268817205,24.727184238255177
Task_10696,597,864,179,29,208,0.6901734104046243,18.80672045644512
Task_10697,507,1004,174,13,187,0.5044776119402985,17.773974799485085
Task_10698,572,185,50,37,87,3.075268817204301,15.137128913513486
Task_10699,1569,640,164,105,269,2.4477379095163805,34.1566675472314
Task_10700,1443,753,64,61,125,1.9137931034482758,31.282686011778086
Task_10701,1729,162,159,145,304,10.607361963190185,35.1278984439328
Task_10702,1597,570,103,88,191,2.7968476357267953,33.94248415329608
Task_10703,1673,389,61,105,166,4.28974358974359,34.57383513946257
Task_10704,969,392,152,74,226,2.4656488549618323,23.458393641273513
Task_10705,1204,93,177,28,205,12.808510638297872,25.124538278723147
Task_10706,595,811,173,164,337,0.7327586206896551,19.660957580506583
Task_10707,2701,365,32,164,196,7.379781420765028,50.944869384026426
Task_10708,848,347,58,199,257,2.4367816091954024,21.972205223975084
Task_10709,2027,905,136,188,324,2.2373068432671084,42.60967850759568
Task_10710,2235,524,135,191,326,4.257142857142857,44.71900541180289
Task_10711,1289,237,106,195,301,5.415966386554622,28.70511517979945
Task_10712,750,480,89,35,124,1.5592515592515592,19.153667584217317
Task_10713,605,874,197,99,296,0.6914285714285714,19.80022561257727
Task_10714,989,358,15,64,79,2.754874651810585,22.285032746099223
Task_10715,2184,381,10,13,23,5.717277486910994,40.374712057080636
Task_10716,2400,842,77,161,238,2.8469750889679717,47.96289758458246
Task_10717,1807,223,45,161,206,8.066964285714286,36.38731501991919
Task_10718,1898,963,109,176,285,1.9688796680497926,40.5526159040834
Task_10719,526,500,22,34,56,1.0499001996007984,15.040710832850898
Task_10720,2213,548,170,61,231,4.030965391621129,43.49994880066665
Task_10721,2727,935,197,13,210,2.9134615384615383,52.452961748927756
Task_10722,2304,693,14,119,133,3.319884726224784,45.20660159308287
Task_10723,969,919,55,142,197,1.0532608695652175,25.211595727509835
Task_10724,1371,246,188,181,369,5.550607287449393,30.31737950287067
Task_10725,516,412,122,90,212,1.2493946731234866,16.399840214837187
Task_10726,1530,747,179,109,288,2.0454545454545454,33.964922439203306
Task_10727,2141,871,24,158,182,2.455275229357798,43.57935139291726
Task_10728,927,864,175,35,210,1.0716763005780348,23.81779658283069
Task_10729,947,960,197,142,339,0.9854318418314256,25.64024088598758
Task_10730,1742,429,141,132,273,4.051162790697674,36.28437301031264
Task_10731,1252,134,80,73,153,9.274074074074074,26.09719285032905
Task_10732,769,995,41,150,191,0.7720883534136547,22.24643842793185
Task_10733,579,686,98,163,261,0.8427947598253275,18.642337499581846
Task_10734,1940,332,79,151,230,5.8258258258258255,38.99300725729727
Task_10735,2397,963,83,43,126,2.486514522821577,46.849886808967824
Task_10736,2581,644,86,130,216,4.001550387596899,49.955673021817354
Task_10737,1723,743,22,156,178,2.3158602150537635,36.54254311039955
Task_10738,821,736,72,127,199,1.1139755766621438,22.295787861413498
Task_10739,779,835,161,155,316,0.9318181818181818,22.511471677995598
Task_10740,608,902,162,54,216,0.6733111849390919,19.308328990107846
Task_10741,601,129,128,177,305,4.623076923076923,17.215029019178427
Task_10742,2988,245,48,71,119,12.146341463414634,54.21697467994642
Task_10743,1468,820,126,120,246,1.7880633373934227,33.03681779059853
Task_10744,2854,1006,38,62,100,2.83416087388282,54.16738115757068
Task_10745,2885,472,170,51,221,6.099365750528541,53.848458236276485
Task_10746,1709,299,135,137,272,5.696666666666666,35.33800987002842
Task_10747,2411,363,191,79,270,6.623626373626373,46.45966690084389
Task_10748,1524,952,52,103,155,1.5991605456453306,33.769266222296025
Task_10749,1950,190,157,150,307,10.209424083769633,38.93072766470898
Task_10750,2716,100,155,19,174,26.89108910891089,48.6466786031941
Task_10751,2788,359,32,138,170,7.7444444444444445,52.10089467488863
Task_10752,2860,92,69,176,245,30.752688172043012,52.174222370923935
Task_10753,1618,270,110,70,180,5.970479704797048,32.989256596528506
Task_10754,2264,590,43,122,165,3.8307952622673436,44.548887564396274
Task_10755,1437,996,155,78,233,1.4413239719157473,32.808769845059
Task_10756,2667,557,19,24,43,4.779569892473118,48.83538402046145
Task_10757,1201,668,28,47,75,1.7952167414050821,26.179508823383188
Task_10758,1413,934,63,112,175,1.5112299465240642,32.1905224660047
Task_10759,1444,1006,196,178,374,1.4339622641509433,33.841806370415064
Task_10760,2659,617,185,92,277,4.302588996763754,51.31235414257652
Task_10761,2040,783,171,113,284,2.6020408163265305,42.14472403868814
Task_10762,2270,287,112,87,199,7.881944444444445,43.70202109185622
Task_10763,642,936,45,24,69,0.6851654215581644,18.438489129921663
Task_10764,1450,899,197,69,266,1.6111111111111112,32.733479943724156
Task_10765,984,799,22,126,148,1.23,24.608290970878382
Task_10766,641,297,25,10,35,2.151006711409396,15.755801351465413
Task_10767,1561,725,181,138,319,2.150137741046832,34.569590778267745
Task_10768,2823,569,38,70,108,4.9526315789473685,52.5347082870768
Task_10769,2406,425,96,168,264,5.647887323943662,46.799714805207
Task_10770,852,641,112,179,291,1.3271028037383177,22.96454670563827
Task_10771,637,100,144,158,302,6.306930693069307,17.476940090102726
Task_10772,2579,589,98,134,232,4.371186440677966,49.87092665154114
Task_10773,1700,115,92,83,175,14.655172413793103,33.44133782626969
Task_10774,2169,262,160,65,225,8.247148288973383,41.901831672540865
Task_10775,2680,98,98,132,230,27.07070707070707,49.16821607953375
Task_10776,1593,654,21,44,65,2.43206106870229,32.29458203135034
Task_10777,1949,828,81,98,179,2.3510253317249696,40.384600060405795
Task_10778,2584,265,125,48,173,9.714285714285714,47.96894202128965
Task_10779,2925,766,71,40,111,3.8135593220338984,54.39408301532517
Task_10780,1429,1024,178,129,307,1.3941463414634145,33.28600894541784
Task_10781,1599,310,109,174,283,5.141479099678457,33.73949184669299
Task_10782,1884,667,114,114,228,2.820359281437126,39.05901411843989
Task_10783,2656,142,173,17,190,18.573426573426573,48.341912744209814
Task_10784,2576,927,22,76,98,2.7758620689655173,49.632411807932606
Task_10785,2369,929,29,156,185,2.5473118279569893,47.40302801679223
Task_10786,2297,492,200,109,309,4.659229208924949,45.4009289410703
Task_10787,739,749,178,199,377,0.9853333333333333,21.946694094462263
Task_10788,1712,845,46,128,174,2.023640661938534,36.67568481158026
Task_10789,2770,577,199,172,371,4.7923875432525955,53.53512530257323
Task_10790,1115,845,182,161,343,1.3179669030732861,27.971969374676153
Task_10791,2053,340,83,127,210,6.020527859237537,40.65735797156572
Task_10792,522,562,89,39,128,0.9271758436944938,16.209297104219683
Task_10793,1409,290,37,170,207,4.841924398625429,30.34424700446283
Task_10794,1076,1012,53,35,88,1.0621915103652517,25.658585716490368
Task_10795,2629,1022,192,84,276,2.5698924731182795,52.070263977685585
Task_10796,2485,528,18,70,88,4.697542533081285,46.77882560808873
Task_10797,2981,504,123,172,295,5.902970297029703,56.29764091398463
Task_10798,2924,150,23,183,206,19.364238410596027,53.46510867827222
Task_10799,2541,959,62,79,141,2.646875,49.83018163540859
Task_10800,2668,680,191,153,344,3.9177679882525696,52.098119798437516
Task_10801,1099,977,164,139,303,1.1237218813905931,27.8832074611972
Task_10802,937,1008,15,154,169,0.9286422200198216,24.764729939126568
Task_10803,1294,857,158,96,254,1.508158508158508,30.381356082685542
Task_10804,1944,243,193,187,380,7.967213114754099,39.4178464609254
Task_10805,911,678,88,189,277,1.3416789396170838,23.90973849689696
Task_10806,813,235,139,96,235,3.444915254237288,20.76503597961678
Task_10807,1800,180,110,81,191,9.94475138121547,35.56843247102423
Task_10808,640,327,21,37,58,1.951219512195122,16.209779540149878
Task_10809,607,522,189,81,270,1.1606118546845123,18.359544890066697
Task_10810,714,119,79,90,169,5.95,18.115752990546607
Task_10811,2676,310,13,77,90,8.604501607717042,49.17325480372694
Task_10812,569,144,141,82,223,3.924137931034483,16.180752961779866
Task_10813,2271,427,42,66,108,5.30607476635514,43.29193828063634
Task_10814,2389,525,50,131,181,4.5418250950570345,46.47937246046041
Task_10815,2431,865,119,25,144,2.80715935334873,47.17439516030405
Task_10816,2937,972,91,188,279,3.0184994861253855,57.03508288353026
Task_10817,1224,799,150,69,219,1.53,28.60834073095259
Task_10818,619,107,193,16,209,5.731481481481482,16.006157254163615
Task_10819,2814,628,95,26,121,4.473767885532592,52.25280376489139
Task_10820,1061,938,36,146,182,1.1299254526091587,26.589276393183756
Task_10821,1771,372,192,87,279,4.7479892761394105,36.45781763391082
Task_10822,2965,470,147,57,204,6.295116772823779,55.04193364856186
Task_10823,2358,225,111,84,195,10.43362831858407,44.82948233339355
Task_10824,2954,250,59,123,182,11.768924302788845,54.44683691508913
Task_10825,986,72,35,53,88,13.506849315068493,20.72064618507685
Task_10826,511,793,94,21,115,0.6435768261964736,16.47960049539272
Task_10827,2428,420,40,11,51,5.767220902612826,44.59119825876015
Task_10828,2605,792,141,102,243,3.2849936948297604,50.923201881041926
Task_10829,1002,247,14,117,131,4.040322580645161,23.160868347545165
Task_10830,1610,101,197,67,264,15.784313725490197,32.077432197140574
Task_10831,1753,922,63,118,181,1.8992416034669555,37.603094316654705
Task_10832,2609,195,85,94,179,13.311224489795919,48.674259354148454
Task_10833,1405,754,132,40,172,1.8609271523178808,30.852732323221385
Task_10834,1836,703,71,67,138,2.6079545454545454,37.63625404513905
Task_10835,1794,543,101,142,243,3.297794117647059,37.35114502352759
Task_10836,1941,894,173,74,247,2.1687150837988827,40.52019939078944
Task_10837,2182,568,137,48,185,3.834797891036907,42.67555775555574
Task_10838,2117,809,171,63,234,2.61358024691358,42.86480833154621
Task_10839,1445,968,186,172,358,1.4912280701754386,33.67010929114427
Task_10840,1503,462,70,173,243,3.24622030237581,32.60466683547518
Task_10841,1360,224,61,48,109,6.044444444444444,27.800758834787505
Task_10842,777,97,82,83,165,7.928571428571429,18.79264380619716
Task_10843,839,521,119,176,295,1.60727969348659,22.431936156950403
Task_10844,1272,633,103,124,227,2.006309148264984,29.269401511822153
Task_10845,2773,271,97,50,147,10.194852941176471,50.83879284821979
Task_10846,1450,426,105,93,198,3.395784543325527,31.241912679598133
Task_10847,2849,243,65,93,158,11.676229508196721,52.47717712721623
Task_10848,1666,210,126,102,228,7.895734597156398,34.09795634670833
Task_10849,580,831,12,108,120,0.6971153846153846,18.229035953913876
Task_10850,2597,219,94,79,173,11.804545454545455,48.42586129339617
Task_10851,2001,1009,104,56,160,1.9811881188118812,41.16269888176074
Task_10852,2958,529,42,130,172,5.581132075471698,55.38342394576744
Task_10853,986,969,102,73,175,1.0164948453608247,25.189337735408547
Task_10854,597,1013,122,21,143,0.5887573964497042,18.890639675435782
Task_10855,1893,74,95,38,133,25.24,35.11677178351061
Task_10856,2855,517,164,54,218,5.511583011583012,53.529408006037876
Task_10857,2788,119,63,62,125,23.233333333333334,49.90295526276526
Task_10858,2142,291,111,64,175,7.335616438356165,41.307890525603234
Task_10859,856,1008,180,177,357,0.848364717542121,24.476205360699538
Task_10860,1054,108,141,35,176,9.669724770642201,22.742955822245936
Task_10861,2175,394,169,122,291,5.506329113924051,43.08887050930186
Task_10862,2883,919,23,178,201,3.133695652173913,55.63558039942915
Task_10863,1944,795,68,143,211,2.442211055276382,40.44944604169957
Task_10864,932,979,69,96,165,0.9510204081632653,24.67048319408494
Task_10865,953,462,27,101,128,2.058315334773218,23.169313717145684
Task_10866,582,806,59,37,96,0.7211895910780669,17.591721598760294
Task_10867,1980,368,35,193,228,5.365853658536586,39.75221864058843
Task_10868,2146,441,181,80,261,4.855203619909502,42.48744527204318
Task_10869,1081,367,149,172,321,2.9375,25.900912917138214
Task_10870,2221,399,185,116,301,5.5525,43.86948353785217
Task_10871,748,379,55,157,212,1.9684210526315788,20.227109054594337
Task_10872,1807,264,28,98,126,6.818867924528302,35.935417378561816
Task_10873,2187,993,96,69,165,2.200201207243461,44.271366092494624
Task_10874,802,465,172,27,199,1.7210300429184548,20.495142348808557
Task_10875,2574,560,124,194,318,4.588235294117647,50.170329083330124
Task_10876,519,558,100,48,148,0.9284436493738819,16.15597147410539
Task_10877,2487,857,185,197,382,2.8986013986013988,50.0231241252179
Task_10878,1301,475,187,81,268,2.7331932773109244,29.249684190860247
Task_10879,1359,338,88,11,99,4.008849557522124,27.981909942597426
Task_10880,933,621,23,157,180,1.5,23.626418700506665
Task_10881,2248,886,132,161,293,2.5343855693348365,45.872942251062
Task_10882,1510,587,30,153,183,2.568027210884354,32.70767288453343
Task_10883,1340,870,200,189,389,1.5384615384615385,31.86702139537503
Task_10884,2622,179,36,50,86,14.566666666666666,47.39182182629896
Task_10885,2726,923,111,153,264,2.95021645021645,53.42015925288225
Task_10886,2228,509,49,51,100,4.368627450980392,42.60101671359168
Task_10887,2096,581,14,188,202,3.6013745704467355,42.12003306170486
Task_10888,887,963,72,43,115,0.9201244813278008,22.886287743129014
Task_10889,2202,682,177,43,220,3.224011713030747,43.49135884350073
Task_10890,2531,806,181,123,304,3.1363073110285007,50.100468736342144
Task_10891,2621,384,90,43,133,6.8077922077922075,48.67591217405232
Task_10892,867,538,100,119,219,1.608534322820037,22.50226311341204
Task_10893,2088,118,74,185,259,17.54621848739496,40.4131411245564
Task_10894,2093,665,11,106,117,3.1426426426426426,41.55241631349343
Task_10895,2972,517,92,38,130,5.737451737451737,54.68397162479801
Task_10896,2002,585,36,162,198,3.416382252559727,40.61899268451406
Task_10897,2188,605,159,91,250,3.6105610561056105,43.688679153636365
Task_10898,1280,807,80,180,260,1.5841584158415842,30.18308002166694
Task_10899,775,361,157,40,197,2.1408839779005526,19.77747459728732
Task_10900,1741,848,130,182,312,2.050647820965842,37.837684596581475
Task_10901,595,1005,63,92,155,0.5914512922465208,19.387135936385313
Task_10902,989,190,170,174,344,5.178010471204188,23.96776390748138
Task_10903,1153,548,140,150,290,2.1001821493624773,27.440900339666445
Task_10904,1071,417,72,92,164,2.562200956937799,25.081569236556103
Task_10905,2325,127,167,88,255,18.1640625,43.85257961078653
Task_10906,2948,393,175,52,227,7.482233502538071,54.66577750162232
Task_10907,2323,709,21,159,180,3.271830985915493,45.95400224590441
Task_10908,719,282,189,140,329,2.5406360424028267,19.892573731890895
Task_10909,2154,69,123,108,231,30.771428571428572,40.74197396513932
Task_10910,2467,432,108,159,267,5.697459584295612,47.780725871411335
Task_10911,2920,520,121,109,230,5.604606525911708,54.998605404396926
Task_10912,624,185,55,142,197,3.3548387096774195,17.47233463889297
Task_10913,748,445,84,13,97,1.6771300448430493,18.71361930270373
Task_10914,1853,735,128,38,166,2.5176630434782608,37.90461109521791
Task_10915,837,148,197,161,358,5.617449664429531,21.28662972208012
Task_10916,1521,925,13,86,99,1.642548596112311,32.957223603312684
Task_10917,2092,457,169,36,205,4.567685589519651,40.95377003086383
Task_10918,1441,156,135,65,200,9.178343949044587,29.684314770037222
Task_10919,2105,685,140,53,193,3.068513119533528,42.117065382273374
Task_10920,1257,203,111,155,266,6.161764705882353,27.86481618886613
Task_10921,1265,98,42,173,215,12.777777777777779,26.928974393502262
Task_10922,1511,1013,102,159,261,1.490138067061144,34.399221780262074
Task_10923,2094,953,144,70,214,2.1949685534591197,42.87429065935123
Task_10924,2156,876,109,150,259,2.458380843785633,44.21464437513739
Task_10925,575,833,108,60,168,0.6894484412470024,18.274082295745536
Task_10926,2019,866,75,182,257,2.328719723183391,42.11543042135191
Task_10927,2578,975,153,159,312,2.6413934426229506,51.46238836399042
Task_10928,2046,622,191,91,282,3.284109149277689,41.63781383014637
Task_10929,646,644,10,45,55,1.0015503875968992,17.360524408937554
Task_10930,879,566,142,24,166,1.5502645502645502,21.871309960421623
Task_10931,1964,346,157,135,292,5.659942363112392,39.61534992304705
Task_10932,2804,595,133,48,181,4.704697986577181,52.58825766655366
Task_10933,1897,300,63,54,117,6.3023255813953485,36.8315858157543
Task_10934,2792,548,124,52,176,5.0856102003642984,52.462774548217844
Task_10935,2189,694,67,120,187,3.149640287769784,43.85998072382474
Task_10936,1501,827,172,102,274,1.8128019323671498,33.68123950618365
Task_10937,556,143,114,142,256,3.861111111111111,16.32600703226024
Task_10938,1794,443,73,116,189,4.04054054054054,36.8072706707459
Task_10939,2085,296,41,86,127,7.02020202020202,40.42224570595351
Task_10940,504,793,37,198,235,0.6347607052896725,17.844000009602937
Task_10941,2151,569,16,45,61,3.7736842105263158,40.88030083317706
Task_10942,2054,453,95,25,120,4.524229074889868,39.61436161480518
Task_10943,757,897,74,55,129,0.8429844097995546,21.120306860261163
Task_10944,1623,612,20,177,197,2.6476345840130504,34.69015297556593
Task_10945,1586,808,156,168,324,1.9604449938195303,35.29091997745814
Task_10946,2599,360,113,92,205,7.199445983379501,49.20008287397181
Task_10947,751,877,35,50,85,0.8553530751708428,20.26676931680293
Task_10948,665,477,126,10,136,1.391213389121339,17.829315235864886
Task_10949,2777,927,197,55,252,2.992456896551724,53.738119219138156
Task_10950,2964,723,77,99,176,4.093922651933702,56.12250779157518
Task_10951,2034,681,28,176,204,2.9824046920821115,41.451671987637404
Task_10952,2488,495,88,196,284,5.016129032258065,48.407974117109916
Task_10953,1941,675,49,34,83,2.871301775147929,38.22855125703864
Task_10954,2977,621,66,101,167,4.786173633440514,55.957719398980025
Task_10955,1591,331,15,25,40,4.792168674698795,31.034375519863186
Task_10956,2886,911,140,57,197,3.164473684210526,55.16278190818897
Task_10957,2504,862,160,42,202,2.9015063731170336,48.75797870139888
Task_10958,1158,1004,157,99,256,1.1522388059701492,28.634785510564516
Task_10959,2178,968,33,34,67,2.2476780185758516,42.53865713156116
Task_10960,2429,492,17,61,78,4.926977687626775,45.36047625592142
Task_10961,746,288,100,161,261,2.5813148788927336,20.06298404866455
Task_10962,2455,297,14,11,25,8.238255033557047,44.401026810261634
Task_10963,2478,376,45,90,135,6.572944297082228,46.943444712932376
Task_10964,1090,382,60,85,145,2.845953002610966,25.09634253126518
Task_10965,2639,658,57,196,253,4.004552352048559,51.288412382665086
Task_10966,2289,628,121,130,251,3.639109697933227,45.477721042553476
Task_10967,2246,857,151,121,272,2.617715617715618,45.597432801631435
Task_10968,1261,440,120,61,181,2.8594104308390023,27.831132872413253
Task_10969,977,404,159,63,222,2.4123456790123456,23.48478091848609
Task_10970,2617,151,137,164,301,17.217105263157894,49.09607367493816
Task_10971,2196,220,161,123,284,9.936651583710407,42.78702626405312
Task_10972,2997,809,45,115,160,3.7,56.66587967200579
Task_10973,774,202,168,145,313,3.812807881773399,20.434178174096857
Task_10974,2020,957,13,50,63,2.1085594989561587,40.14814069290997
Task_10975,2169,298,87,83,170,7.254180602006689,41.91581463340619
Task_10976,1597,650,20,48,68,2.453149001536098,32.466106731279005
Task_10977,2032,511,24,180,204,3.96875,40.884889765766836
Task_10978,2995,335,164,161,325,8.913690476190476,56.07165612887368
Task_10979,2378,521,140,33,173,4.555555555555555,45.52488010769065
Task_10980,1378,732,168,188,356,1.8799454297407914,31.93254193228462
Task_10981,2838,254,145,171,316,11.129411764705882,53.27130059710314
Task_10982,954,242,193,139,332,3.925925925925926,23.487552407726763
Task_10983,1247,524,69,110,179,2.375238095238095,28.34159040692509
Task_10984,701,251,12,87,99,2.7817460317460316,17.84350899344027
Task_10985,1912,747,34,140,174,2.556149732620321,39.53796679030988
Task_10986,655,792,196,99,295,0.8259773013871374,20.223382003207565
Task_10987,2169,167,52,132,184,12.910714285714286,41.50127290586854
Task_10988,2156,716,81,190,271,3.00697350069735,43.879960816833055
Task_10989,1044,684,48,106,154,1.524087591240876,25.25373632110107
Task_10990,2006,207,147,127,274,9.64423076923077,39.698515856182674
Task_10991,2643,854,186,117,303,3.0912280701754384,52.01212733377421
Task_10992,2937,101,64,118,182,28.794117647058822,53.02853870687749
Task_10993,1560,309,95,120,215,5.032258064516129,32.74414807327344
Task_10994,991,658,38,68,106,1.5037936267071321,23.721395973580304
Task_10995,669,322,184,40,224,2.071207430340557,18.09886665655862
Task_10996,1812,333,184,160,344,5.425149700598802,37.43893953564725
Task_10997,2727,490,163,84,247,5.553971486761711,51.81099713690991
Task_10998,2705,338,101,89,190,7.979351032448378,50.73383625731487
Task_10999,1864,317,155,118,273,5.861635220125786,37.8261550164467
Task_11000,2756,709,22,148,170,3.8816901408450706,52.729403798503604
Task_11001,1294,769,57,15,72,1.6805194805194805,27.708031999755306
Task_11002,2173,312,105,142,247,6.942492012779553,42.61335470674992
Task_11003,2115,237,51,51,102,8.88655462184874,39.882902523799174
Task_11004,1595,873,107,110,217,1.8249427917620138,35.06844327499878
Task_11005,2523,709,161,128,289,3.5535211267605633,49.60840416018167
Task_11006,2469,484,111,32,143,5.090721649484536,46.61862010494976
Task_11007,1792,238,163,173,336,7.497907949790795,36.779883394076634
Task_11008,775,127,101,92,193,6.0546875,19.191574072773257
Task_11009,1904,682,130,60,190,2.787701317715959,38.84575381942594
Task_11010,832,395,54,15,69,2.101010101010101,19.21264655760316
Task_11011,1324,426,61,63,124,3.100702576112412,28.493572965242464
Task_11012,1077,117,36,78,114,9.127118644067796,23.02905277203062
Task_11013,2971,773,146,84,230,3.838501291989664,56.50225042817544
Task_11014,2281,186,195,172,367,12.197860962566844,44.47910441724903
Task_11015,1658,582,15,33,48,2.843910806174957,33.013929597313584
Task_11016,2909,1017,68,197,265,2.857563850687623,56.755768107931424
Task_11017,2848,933,127,78,205,3.0492505353319057,54.88580561334873
Task_11018,1400,334,171,108,279,4.17910447761194,30.55698515743688
Task_11019,1882,864,87,142,229,2.175722543352601,39.64912003975905
Task_11020,992,418,56,129,185,2.367541766109785,24.015198945259783
Task_11021,966,968,175,182,357,0.9969040247678018,26.085335002508184
Task_11022,1835,599,162,197,359,3.058333333333333,38.780957317249936
Task_11023,2570,101,140,84,224,25.19607843137255,47.26367687349528
Task_11024,2564,854,192,120,312,2.9988304093567253,50.805384377938275
Task_11025,2595,685,177,156,333,3.782798833819242,50.91245957939103
Task_11026,1657,391,184,106,290,4.2270408163265305,34.85490854456152
Task_11027,2099,311,60,88,148,6.727564102564102,40.83396030660819
Task_11028,2919,355,167,145,312,8.19943820224719,54.856793447327505
Task_11029,2599,151,110,56,166,17.098684210526315,47.723867595626565
Task_11030,1616,321,13,81,94,5.0186335403726705,32.5201988762169
Task_11031,2015,166,73,61,134,12.065868263473053,38.34096319330166
Task_11032,915,654,137,130,267,1.3969465648854962,23.815772757956623
Task_11033,1089,259,187,71,258,4.188461538461539,25.00182894594272
Task_11034,1975,718,16,13,29,2.7468706536856744,38.191326258230035
Task_11035,1200,576,198,172,370,2.079722703639515,28.66570000033894
Task_11036,762,241,183,143,326,3.1487603305785123,20.429882016540287
Task_11037,1373,958,86,174,260,1.4316996871741396,32.0060219692134
Task_11038,2416,802,139,88,227,3.008717310087173,47.80848027702183
Task_11039,2385,814,56,115,171,2.9263803680981595,47.212621615299724
Task_11040,2730,744,26,172,198,3.664429530201342,52.63789768061841
Task_11041,1851,297,84,81,165,6.2114093959731544,36.9370627585831
Task_11042,736,727,83,89,172,1.010989010989011,20.61761043143326
Task_11043,798,488,53,194,247,1.6319018404907975,21.561778221507684
Task_11044,1563,525,58,120,178,2.9714828897338403,33.35543873481931
Task_11045,2306,872,51,81,132,2.6414662084765177,45.8851505237586
Task_11046,2295,326,196,95,291,7.018348623853211,44.733367630033435
Task_11047,988,749,37,98,135,1.3173333333333332,24.482879151808806
Task_11048,2778,145,38,126,164,19.027397260273972,50.7134410810014
Task_11049,1194,1001,44,116,160,1.1916167664670658,28.612811664350133
Task_11050,957,702,13,97,110,1.3613086770981508,23.56935076663525
Task_11051,1587,369,41,53,94,4.289189189189189,32.013062053579624
Task_11052,610,666,133,113,246,0.9145427286356822,18.92976239278698
Task_11053,1904,345,141,97,238,5.502890173410405,38.392283138924775
Task_11054,984,560,91,172,263,1.7540106951871657,24.698925176781472
Task_11055,1577,347,44,140,184,4.531609195402299,32.996732435073305
Task_11056,2784,252,155,115,270,11.003952569169961,52.12111994198491
Task_11057,2084,553,195,126,321,3.7617328519855597,42.30289563944542
Task_11058,601,630,117,36,153,0.9524564183835182,17.62141051993342
Task_11059,2813,788,159,61,220,3.565272496831432,53.71347060093235
Task_11060,881,396,169,144,313,2.2191435768261965,22.75175453998784
Task_11061,1515,828,20,156,176,1.827503015681544,33.506583805306796
Task_11062,1732,127,22,141,163,13.53125,34.072308793094884
Task_11063,2376,434,149,108,257,5.462068965517242,46.22723908968343
Task_11064,1472,330,157,93,250,4.447129909365559,31.513466558475457
Task_11065,2616,390,32,196,228,6.690537084398977,49.87540630885451
Task_11066,1579,573,194,175,369,2.750871080139373,34.657788096045316
Task_11067,1995,612,35,111,146,3.2544861337683524,40.11148966720657
Task_11068,1800,655,123,101,224,2.7439024390243905,37.65375487587169
Task_11069,1565,104,194,196,390,14.904761904761905,32.56426146988755
Task_11070,586,860,13,172,185,0.6806039488966318,19.05169937948502
Task_11071,614,452,138,26,164,1.3554083885209713,17.342732934762164
Task_11072,2661,924,46,132,178,2.8767567567567567,51.98287489147926
Task_11073,1632,622,42,108,150,2.619582664526485,34.380776934678515
Task_11074,2440,617,27,26,53,3.9482200647249193,45.54979141069946
Task_11075,2384,878,103,143,246,2.712172923777019,47.76465832621067
Task_11076,2300,619,70,168,238,3.7096774193548385,45.69297765467174
Task_11077,1675,924,178,174,352,1.8108108108108107,37.196806172003654
Task_11078,627,265,137,88,225,2.357142857142857,17.779717497152294
Task_11079,1065,611,23,150,173,1.7401960784313726,25.662679456064463
Task_11080,1426,865,142,184,326,1.6466512702078522,32.95215896365073
Task_11081,1455,730,101,49,150,1.990424076607387,31.45835609265343
Task_11082,2261,487,145,81,226,4.633196721311475,44.29563928436437
Task_11083,708,426,97,58,155,1.6580796252927401,18.85167712777626
Task_11084,711,317,34,191,225,2.2358490566037736,19.496168822064696
Task_11085,1646,222,122,85,207,7.381165919282512,33.629116644262645
Task_11086,1127,736,190,131,321,1.5291723202170964,27.68478642298515
Task_11087,1075,494,194,162,356,2.1717171717171717,26.351461590647272
Task_11088,837,418,110,79,189,1.9976133651551313,21.36359133252353
Task_11089,2760,792,106,186,292,3.480453972257251,53.72283589404797
Task_11090,718,293,72,62,134,2.442176870748299,18.574659513325134
Task_11091,2632,128,61,189,250,20.4031007751938,48.97994687611794
Task_11092,1470,421,29,189,218,3.4834123222748814,31.79216418689578
Task_11093,830,172,59,104,163,4.797687861271676,20.191629494276086
Task_11094,1668,865,182,180,362,1.926096997690531,36.956367121493635
Task_11095,2118,105,81,120,201,19.9811320754717,40.33706233001069
Task_11096,1749,266,111,95,206,6.550561797752809,35.51203237675328
Task_11097,1573,155,24,103,127,10.083333333333334,31.301617929129076
Task_11098,1862,988,194,70,264,1.8827098078867543,39.53203736522497
Task_11099,999,965,182,42,224,1.0341614906832297,25.343196245712633
Task_11100,1126,300,130,48,178,3.740863787375415,25.073053325861917
Task_11101,886,274,173,129,302,3.2218181818181817,22.368512642001637
Task_11102,1182,774,30,181,211,1.5251612903225806,28.25849087862044
Task_11103,2838,991,35,72,107,2.8608870967741935,54.12695417103166
Task_11104,671,449,100,92,192,1.491111111111111,18.87696774120479
Task_11105,897,214,189,196,385,4.1720930232558135,22.81581720682561
Task_11106,1571,840,185,138,323,1.868014268727705,35.1043635216107
Task_11107,1827,180,48,69,117,10.0939226519337,35.28933312699679
Task_11108,1184,463,115,50,165,2.5517241379310347,26.539593516190035
Task_11109,1908,1004,180,125,305,1.8985074626865672,40.85382488655296
Task_11110,1960,814,117,187,304,2.4049079754601226,41.1727622835533
Task_11111,1100,98,78,84,162,11.11111111111111,23.73248771709609
Task_11112,701,526,152,68,220,1.3301707779886147,19.486327072896458
Task_11113,1967,83,151,65,216,23.416666666666668,37.29486098763376
Task_11114,1203,738,172,183,355,1.6278755074424898,29.15371534656748
Task_11115,525,183,72,200,272,2.8532608695652173,16.340899793458004
Task_11116,2759,483,140,167,307,5.700413223140496,52.76146584029366
Task_11117,1920,575,33,29,62,3.3333333333333335,37.23341315838285
Task_11118,1068,778,157,133,290,1.3709884467265725,26.73961054394414
Task_11119,2555,142,141,120,261,17.867132867132867,47.80160648362874
Task_11120,513,819,180,37,217,0.625609756097561,17.467801396053716
Task_11121,2634,184,179,100,279,14.237837837837837,49.42309950149686
Task_11122,2437,338,97,53,150,7.188790560471976,45.95806240674637
Task_11123,919,947,61,66,127,0.9694092827004219,23.894082222494948
Task_11124,537,883,53,78,131,0.6074660633484162,18.05223862534946
Task_11125,2284,327,144,15,159,6.963414634146342,43.13747852571976
Task_11126,1737,866,167,24,191,2.0034602076124566,36.49722529307677
Task_11127,683,222,189,168,357,3.062780269058296,19.296010017547154
Task_11128,1431,127,86,121,207,11.1796875,29.70308041120164
Task_11129,2884,318,56,165,221,9.04075235109718,53.86332929824883
Task_11130,807,425,82,27,109,1.8943661971830985,19.714631368749554
Task_11131,1972,677,49,166,215,2.9085545722713864,40.59799877280086
Task_11132,1062,460,180,19,199,2.3036876355748372,24.550393108830136
Task_11133,1446,435,33,13,46,3.31651376146789,29.05514917154586
Task_11134,2171,215,196,68,264,10.050925925925926,41.92619947627155
Task_11135,867,755,89,199,288,1.1468253968253967,23.510957639298535
Task_11136,2554,658,94,80,174,3.87556904400607,49.235250845848405
Task_11137,2467,954,158,14,172,2.5832460732984295,48.189875925538416
Task_11138,2934,333,88,20,108,8.784431137724551,53.015278312162756
Task_11139,2308,747,102,54,156,3.085561497326203,45.20001611598688
Task_11140,2843,389,10,182,192,7.28974358974359,53.24380971114612
Task_11141,2094,369,34,145,179,5.65945945945946,41.24348209454687
Task_11142,1804,182,16,38,54,9.857923497267759,34.22973348698405
Task_11143,965,995,33,69,102,0.9688755020080321,24.34389884145692
Task_11144,1449,298,180,20,200,4.846153846153846,30.15893274153567
Task_11145,686,395,150,157,307,1.7323232323232323,19.641691356192933
Task_11146,2425,677,75,86,161,3.5766961651917404,47.21533857980351
Task_11147,2456,102,141,125,266,23.844660194174757,45.87867017669604
Task_11148,756,560,180,186,366,1.3475935828877006,21.540579129505364
Task_11149,1667,716,37,77,114,2.324965132496513,34.948734590052375
Task_11150,2510,121,197,123,320,20.57377049180328,47.18812439284451
Task_11151,863,932,62,106,168,0.92497320471597,23.360652435969058
Task_11152,2927,548,101,51,152,5.331511839708561,54.29178094680648
Task_11153,787,606,99,26,125,1.2965403624382208,20.151411509276947
Task_11154,2001,707,61,68,129,2.8262711864406778,40.33812887509773
Task_11155,2371,396,22,58,80,5.972292191435768,44.276494216824794
Task_11156,2300,573,129,184,313,4.006968641114983,45.83586757592436
Task_11157,1273,135,76,193,269,9.360294117647058,27.768423588129888
Task_11158,2230,1006,36,41,77,2.2144985104270107,43.58360174697058
Task_11159,1068,267,176,55,231,3.985074626865672,24.48857856256454
Task_11160,856,345,50,28,78,2.4739884393063583,19.768057266667515
Task_11161,1483,693,66,22,88,2.136887608069164,31.02758779155309
Task_11162,1781,75,13,22,35,23.43421052631579,32.22249788390442
Task_11163,1684,110,114,181,295,15.17117117117117,34.02494874047945
Task_11164,621,645,169,22,191,0.9613003095975232,18.23171794588613
Task_11165,2964,679,147,59,206,4.358823529411764,55.70058161140577
Task_11166,1063,421,85,139,224,2.518957345971564,25.30850820916517
Task_11167,2782,542,78,50,128,5.123388581952118,51.910600293230495
Task_11168,567,264,188,147,335,2.139622641509434,17.469692009420527
Task_11169,622,326,183,107,290,1.9021406727828747,18.27510646660112
Task_11170,1280,133,75,88,163,9.552238805970148,27.041644935482314
Task_11171,2735,539,107,39,146,5.064814814814815,51.06824534782629
Task_11172,1903,70,110,65,175,26.802816901408452,36.043599044410975
Task_11173,2883,136,170,198,368,21.043795620437955,53.492810046385955
Task_11174,2293,905,175,101,276,2.5309050772626933,46.480680994542546
Task_11175,1975,862,102,89,191,2.2885283893395134,40.862662649042555
Task_11176,1816,514,72,99,171,3.5262135922330096,37.216256018671736
Task_11177,973,593,88,41,129,1.638047138047138,23.21193146133216
Task_11178,2589,513,128,57,185,5.036964980544747,49.12080421368011
Task_11179,1334,636,40,20,60,2.0941915227629515,28.000077290278085
Task_11180,2035,140,129,13,142,14.432624113475176,38.09382350576043
Task_11181,2824,734,156,97,253,3.8421768707482995,54.27613046115737
Task_11182,841,532,97,160,257,1.577861163227017,22.281631029011766
Task_11183,2487,900,54,187,241,2.760266370699223,49.577412744927436
Task_11184,2306,713,30,90,120,3.2296918767507004,45.10982190797609
Task_11185,639,744,50,115,165,0.8577181208053691,19.311463062994168
Task_11186,2249,738,124,116,240,3.0433017591339646,45.120788248308095
Task_11187,2799,1012,139,14,153,2.763079960513327,53.429365361646
Task_11188,2618,338,138,103,241,7.722713864306785,49.65575295911066
Task_11189,2641,334,160,28,188,7.883582089552239,49.13457884119828
Task_11190,1686,203,94,94,188,8.264705882352942,34.18347985556378
Task_11191,607,102,83,161,244,5.893203883495145,16.81984298747802
Task_11192,1790,719,70,132,202,2.486111111111111,37.71474488862359
Task_11193,594,802,144,174,318,0.7397260273972602,19.500024845332515
Task_11194,1813,429,90,74,164,4.216279069767442,36.6498155110577
Task_11195,721,585,147,52,199,1.2303754266211604,19.894419112174166
Task_11196,1272,68,97,67,164,18.434782608695652,26.13929144720846
Task_11197,1037,475,116,83,199,2.1785714285714284,24.79480801507376
Task_11198,700,336,158,64,222,2.077151335311573,18.89397782253997
Task_11199,1174,753,39,180,219,1.557029177718833,28.107764346812317
Task_11200,1726,736,32,87,119,2.3419267299864317,35.99570558112229
Task_11201,1874,503,82,29,111,3.7182539682539684,36.89003784681638
Task_11202,2105,102,176,113,289,20.436893203883496,40.450562642853306
Task_11203,1015,344,190,147,337,2.9420289855072466,24.818629273646096
Task_11204,1280,271,45,157,202,4.705882352941177,28.204281716766506
Task_11205,2253,841,102,11,113,2.675771971496437,43.93344566700404
Task_11206,2950,487,95,54,149,6.045081967213115,54.559808523995365
Task_11207,2673,898,63,118,181,2.9733036707452727,52.10612379930483
Task_11208,508,170,46,132,178,2.9707602339181287,15.23423888801031
Task_11209,2364,785,30,52,82,3.0076335877862594,45.516567532699476
Task_11210,1168,732,60,142,202,1.5934515688949522,27.900301246717017
Task_11211,1190,904,194,43,237,1.3149171270718232,28.23286408220038
Task_11212,528,593,124,36,160,0.8888888888888888,16.362265262476107
Task_11213,1108,75,34,18,52,14.578947368421053,21.767766520423418
Task_11214,921,759,56,42,98,1.2118421052631578,22.47196239072709
Task_11215,1335,734,200,110,310,1.816326530612245,30.935930090737518
Task_11216,1766,575,89,89,178,3.0659722222222223,36.55440321024639
Task_11217,739,693,153,156,309,1.0648414985590777,21.37039527068656
Task_11218,899,536,128,64,192,1.6741154562383613,22.540303175511912
Task_11219,2405,372,77,107,184,6.447721179624665,46.17973587970409
Task_11220,2277,401,64,157,221,5.664179104477612,44.53199481609488
Task_11221,1448,99,177,104,281,14.48,30.03608469188043
Task_11222,2685,963,48,21,69,2.7852697095435683,50.47518626780796
Task_11223,1746,932,66,116,182,1.8713826366559485,37.535116621861796
Task_11224,707,295,74,104,178,2.3885135135135136,19.046027378643895
Task_11225,2517,634,14,158,172,3.9637795275590553,48.747945101382506
Task_11226,2385,938,184,176,360,2.5399361022364215,48.529939149165614
Task_11227,1759,543,26,118,144,3.233455882352941,36.10738503808685
Task_11228,2732,626,171,181,352,4.35725677830941,53.017445954970526
Task_11229,2948,1022,44,100,144,2.881720430107527,56.45520194380512
Task_11230,2527,709,97,19,116,3.5591549295774647,47.859567498619406
Task_11231,1461,871,72,147,219,1.6754587155963303,33.048803830787826
Task_11232,1068,780,177,26,203,1.3674775928297056,25.723269052575287
Task_11233,753,295,136,150,286,2.543918918918919,20.292692055112056
Task_11234,2420,678,31,76,107,3.5640648011782035,46.57968548119775
Task_11235,2342,431,76,198,274,5.421296296296297,45.95481474394023
Task_11236,2950,374,168,160,328,7.866666666666666,55.50631350983806
Task_11237,1299,151,124,44,168,8.546052631578947,26.909538466861793
Task_11238,1484,407,175,98,273,3.6372549019607843,32.088316419898995
Task_11239,2108,240,195,119,314,8.746887966804978,41.60069168128248
Task_11240,2594,759,27,194,221,3.413157894736842,50.670932571797636
Task_11241,1359,454,194,20,214,2.986813186813187,29.303424282907613
Task_11242,1219,428,76,22,98,2.8414918414918415,26.12010316050056
Task_11243,1035,625,112,89,201,1.6533546325878594,25.27046314309864
Task_11244,2560,465,139,200,339,5.493562231759657,49.745273912617336
Task_11245,1795,166,76,88,164,10.748502994011975,35.45701511603058
Task_11246,2854,357,186,160,346,7.972067039106145,54.010672718160436
Task_11247,2016,798,66,51,117,2.523153942428035,40.383708188031775
Task_11248,1593,98,156,37,193,16.09090909090909,31.10898864110335
Task_11249,543,103,168,27,195,5.221153846153846,14.86909901118417
Task_11250,1326,211,199,118,317,6.254716981132075,29.15810960840082
Task_11251,1570,287,95,46,141,5.451388888888889,31.76269615188294
Task_11252,2772,931,24,196,220,2.9742489270386265,54.02624873338697
Task_11253,1266,574,186,75,261,2.2017391304347824,28.894609198834704
Task_11254,2631,971,10,182,192,2.70679012345679,51.74296082209462
Task_11255,2832,197,77,113,190,14.303030303030303,52.402151149126986
Task_11256,2079,444,63,142,205,4.671910112359551,41.44178720318797
Task_11257,1895,493,199,60,259,3.8360323886639676,38.41923053389363
Task_11258,2706,590,17,177,194,4.5786802030456855,51.731039362119766
Task_11259,2842,798,51,162,213,3.5569461827284106,54.74776668499941
Task_11260,1245,98,56,21,77,12.575757575757576,24.468775054203718
Task_11261,913,679,145,162,307,1.3426470588235293,24.095990341008456
Task_11262,2376,607,183,124,307,3.9078947368421053,47.03256657190341
Task_11263,2644,595,127,43,170,4.436241610738255,49.94825534491645
Task_11264,2452,547,62,135,197,4.474452554744525,47.63216197458991
Task_11265,583,391,182,90,272,1.4872448979591837,17.686462630900987
Task_11266,1532,239,87,170,257,6.383333333333334,32.27599988739683
Task_11267,2477,178,17,134,151,13.837988826815643,45.77362852011339
Task_11268,1245,128,178,184,362,9.651162790697674,27.615578038083868
Task_11269,2512,142,120,75,195,17.566433566433567,46.49177442852965
Task_11270,2054,391,108,185,293,5.239795918367347,41.265810947600016
Task_11271,618,934,187,139,326,0.6609625668449198,20.39961782343428
Task_11272,2762,166,89,177,266,16.538922155688624,51.28002119067571
Task_11273,2196,342,136,58,194,6.402332361516035,42.40424350758566
Task_11274,2671,707,145,140,285,3.772598870056497,51.946056826972246
Task_11275,640,932,109,94,203,0.6859592711682744,20.11673643331096
Task_11276,2616,691,70,152,222,3.7803468208092488,50.830364807521796
Task_11277,502,902,47,69,116,0.5559246954595792,17.014358384550604
Task_11278,2775,530,174,36,210,5.2259887005649714,52.024720794744354
Task_11279,626,179,87,63,150,3.477777777777778,16.43375606123332
Task_11280,2531,522,190,46,236,4.839388145315487,48.27329517378101
Task_11281,1194,857,82,114,196,1.3916083916083917,28.562993493993076
Task_11282,842,131,50,176,226,6.378787878787879,20.705911477355695
Task_11283,1625,726,90,108,198,2.235213204951857,34.99155551113459
Task_11284,2085,959,165,40,205,2.171875,42.4323840955709
Task_11285,2452,775,182,119,301,3.1597938144329896,48.732216709481975
Task_11286,2016,777,165,132,297,2.5912596401028276,41.83217858622908
Task_11287,1387,928,30,154,184,1.4930032292787945,31.789771058954397
Task_11288,1648,847,64,100,164,1.9433962264150944,35.59669369404709
Task_11289,1512,801,41,158,199,1.885286783042394,33.53143654414129
Task_11290,2992,827,83,55,138,3.6135265700483092,56.21734273234541
Task_11291,662,111,70,138,208,5.910714285714286,17.572738791193164
Task_11292,2871,196,146,30,176,14.573604060913706,52.22278409455004
Task_11293,2892,897,86,79,165,3.220489977728285,55.2963566836356
Task_11294,1256,175,141,118,259,7.136363636363637,27.438185271079835
Task_11295,602,115,142,139,281,5.189655172413793,16.934953252336197
Task_11296,1824,758,167,179,346,2.4031620553359683,39.02079807978999
Task_11297,1777,817,61,144,205,2.1723716381418092,37.84065256529454
Task_11298,1833,272,118,43,161,6.714285714285714,35.94097934280531
Task_11299,1021,709,197,48,245,1.4380281690140846,25.01491964272555
Task_11300,1118,1022,66,185,251,1.0928641251221896,28.208912147650917
Task_11301,557,684,83,164,247,0.8131386861313868,18.223342444904763
Task_11302,1064,213,100,56,156,4.97196261682243,23.790323397441114
Task_11303,608,321,90,132,222,1.8881987577639752,17.762380296298016
Task_11304,1126,768,66,186,252,1.4642392717815345,27.608615066368824
Task_11305,2647,966,199,21,220,2.737331954498449,51.341504622754464
Task_11306,601,556,88,29,117,1.0789946140035906,17.016156727611662
Task_11307,1322,327,132,187,319,4.030487804878049,29.596589437278638
Task_11308,1638,206,126,97,223,7.913043478260869,33.639747655723646
Task_11309,1468,127,145,73,218,11.46875,29.98668035525993
Task_11310,1128,856,98,189,287,1.3162193698949824,28.00493256418513
Task_11311,522,708,108,83,191,0.7362482369534555,17.324314401390662
Task_11312,1553,768,88,184,272,2.0195058517555267,34.391380269365335
Task_11313,1308,786,19,179,198,1.662007623888183,30.238036038171362
Task_11314,1486,534,179,79,258,2.777570093457944,32.318971300004726
Task_11315,643,204,94,62,156,3.1365853658536587,17.122743532833592
Task_11316,2966,127,54,169,223,23.171875,54.07574632066104
Task_11317,2923,804,195,19,214,3.631055900621118,55.17566863449696
Task_11318,2724,405,33,20,53,6.70935960591133,49.283180761942646
Task_11319,2397,328,110,197,307,7.285714285714286,46.56146717257462
Task_11320,2207,703,76,93,169,3.1349431818181817,43.9950545709145
Task_11321,567,449,34,181,215,1.26,17.496024109966687
Task_11322,2754,194,153,144,297,14.123076923076923,51.57145984858186
Task_11323,1351,221,135,169,304,6.085585585585585,29.604265106780417
Task_11324,1750,250,29,140,169,6.972111553784861,35.3156932415965
Task_11325,853,144,41,171,212,5.882758620689655,20.81921033085633
Task_11326,1120,837,165,122,287,1.3365155131264916,27.716821953214005
Task_11327,1369,72,190,80,270,18.753424657534246,28.3958239741938
Task_11328,509,933,148,82,230,0.5449678800856531,18.10003430260476
Task_11329,2593,829,36,10,46,3.1240963855421686,48.46569286111091
Task_11330,2072,228,35,88,123,9.048034934497817,39.90063382844668
Task_11331,2210,1004,150,36,186,2.199004975124378,44.445772644127025
Task_11332,1439,555,53,129,182,2.588129496402878,31.508207816908193
Task_11333,560,527,137,96,233,1.0606060606060606,17.61832109008961
Task_11334,2942,803,106,63,169,3.6592039800995027,55.57928399197428
Task_11335,2337,65,181,16,197,35.40909090909091,42.32584562416661
Task_11336,1490,773,60,44,104,1.925064599483204,31.44897685149303
Task_11337,2283,332,118,27,145,6.8558558558558556,43.20364181591484
Task_11338,1021,677,115,12,127,1.5058997050147493,24.05126182535413
Task_11339,1715,134,69,142,211,12.703703703703704,34.36787655310905
Task_11340,2794,784,172,184,356,3.559235668789809,54.521846772339735
Task_11341,835,369,110,91,201,2.2567567567567566,21.301014724719593
Task_11342,952,290,111,87,198,3.2714776632302405,22.87219620139729
Task_11343,611,506,197,144,341,1.205128205128205,18.88958815655201
Task_11344,2656,307,198,141,339,8.623376623376624,50.64641600928038
Task_11345,2748,191,86,14,100,14.3125,49.56917537124562
Task_11346,790,977,65,176,241,0.8077709611451943,22.852417887613466
Task_11347,1713,226,87,151,238,7.546255506607929,34.97538500294451
Task_11348,1219,222,70,82,152,5.466367713004484,26.585374858755532
Task_11349,1457,422,117,132,249,3.4444444444444446,31.643337783006288
Task_11350,1293,468,86,173,259,2.7569296375266523,29.25957952140601
Task_11351,1586,894,136,53,189,1.7720670391061453,34.516415186996745
Task_11352,1896,428,33,67,100,4.419580419580419,37.290527069426744
Task_11353,2953,979,138,98,236,3.013265306122449,56.992939826932094
Task_11354,1572,678,99,125,224,2.3151693667157587,34.15139890200245
Task_11355,1249,94,91,91,182,13.147368421052631,26.23201294506694
Task_11356,897,340,118,164,282,2.63049853372434,22.716456925323627
Task_11357,1555,808,27,186,213,1.9221260815822003,34.315900304354635
Task_11358,657,529,134,26,160,1.239622641509434,18.11102730133811
Task_11359,1918,663,137,142,279,2.88855421686747,39.85587850272113
Task_11360,987,813,30,90,120,1.2125307125307125,24.457775597828306
Task_11361,2447,641,150,110,260,3.811526479750779,48.03255070462574
Task_11362,644,73,169,54,223,8.702702702702704,16.531944357731813
Task_11363,686,900,200,116,316,0.7613762486126526,21.20676048796238
Task_11364,764,284,172,135,307,2.680701754385965,20.50385911985521
Task_11365,1384,670,191,67,258,2.0625931445603576,30.940409513292746
Task_11366,913,652,95,93,188,1.3981623277182236,23.349452742192124
Task_11367,2194,987,180,73,253,2.220647773279352,44.79277407068565
Task_11368,2139,450,92,151,243,4.74279379157428,42.53588820576429
Task_11369,762,87,105,156,261,8.659090909090908,19.211742197447673
Task_11370,1655,425,24,59,83,3.884976525821596,33.13502244668551
Task_11371,1063,245,113,120,233,4.321138211382114,24.74554677245909
Task_11372,2269,301,102,150,252,7.513245033112582,44.12762734634791
Task_11373,2432,259,62,176,238,9.353846153846154,46.597249368192564
Task_11374,1156,990,155,78,233,1.1664984863773966,28.333731848626115
Task_11375,1122,514,163,191,354,2.1786407766990292,27.19190847164192
Task_11376,2623,588,59,54,113,4.453310696095077,49.29440429019843
Task_11377,1414,736,74,83,157,1.9185888738127543,31.339840213532398
Task_11378,2579,161,30,42,72,15.919753086419753,46.28154738253178
Task_11379,1227,913,89,96,185,1.3424507658643325,29.120812105931282
Task_11380,1478,780,106,30,136,1.8924455825864277,31.783947501925656
Task_11381,952,498,166,66,232,1.907815631262525,23.439514280757226
Task_11382,2211,335,169,93,262,6.580357142857143,43.271930533449336
Task_11383,1205,816,171,178,349,1.474908200734394,29.35295009676729
Task_11384,2460,406,149,45,194,6.044226044226044,46.5618074677964
Task_11385,538,504,32,13,45,1.0653465346534654,15.003690420815522
Task_11386,2382,856,162,186,348,2.779463243873979,48.186968227017964
Task_11387,2694,949,80,66,146,2.8357894736842106,52.05909326066134
Task_11388,2985,108,138,129,267,27.38532110091743,54.254252013917274
Task_11389,2341,234,179,111,290,9.961702127659574,45.139241524258104
Task_11390,1072,196,108,105,213,5.441624365482234,24.623847792487695
Task_11391,933,479,35,170,205,1.94375,23.401770466467372
Task_11392,2673,345,137,65,202,7.72543352601156,50.05648152389591
Task_11393,2667,688,10,132,142,3.8708272859216257,50.93003786946722
Task_11394,1365,644,154,84,238,2.116279069767442,30.693079361438606
Task_11395,2282,198,142,168,310,11.467336683417086,44.28291009545429
Task_11396,623,151,107,81,188,4.098684210526316,16.848187615975018
Task_11397,1412,481,83,72,155,2.929460580912863,30.301424214397333
Task_11398,2794,868,160,122,282,3.2151898734177213,54.36119138777923
Task_11399,982,410,111,105,216,2.389294403892944,23.89991615086386
Task_11400,1606,939,189,39,228,1.7085106382978723,34.8714353128929
Task_11401,1116,781,12,38,50,1.4271099744245523,25.128678931011937
Task_11402,2718,359,17,69,86,7.55,49.87085005560012
Task_11403,2494,142,111,147,258,17.44055944055944,46.866751643851416
Task_11404,2533,670,34,39,73,3.774962742175857,47.243876090605134
Task_11405,1050,841,77,53,130,1.2470308788598574,25.52209386808224
Task_11406,2306,935,130,58,188,2.463675213675214,45.98860292276864
Task_11407,1897,657,90,80,170,2.882978723404255,38.78055735566061
Task_11408,1824,750,34,135,169,2.428761651131824,38.10102894867649
Task_11409,514,282,68,190,258,1.8162544169611308,16.478569077157765
Task_11410,2736,989,87,127,214,2.7636363636363637,53.48150584282906
Task_11411,2157,598,17,96,113,3.6010016694490816,42.35906532131765
Task_11412,2991,889,175,12,187,3.3606741573033707,56.37363658899241
Task_11413,1721,460,196,178,374,3.7331887201735356,36.574244656032434
Task_11414,1184,410,132,171,303,2.880778588807786,27.5853220565573
Task_11415,803,981,49,145,194,0.8177189409368636,22.810762194916865
Task_11416,2551,179,162,162,324,14.172222222222222,48.22779032222916
Task_11417,1456,664,173,175,348,2.1894736842105265,32.90072209897017
Task_11418,2254,686,191,127,318,3.2809315866084425,45.40411427933815
Task_11419,2297,347,53,35,88,6.600574712643678,42.77884646843912
Task_11420,1106,559,59,166,225,1.975,26.53157073400796
Task_11421,1898,297,20,47,67,6.369127516778524,36.03532798866095
Task_11422,1858,468,166,143,309,3.961620469083156,38.42418558962664
Task_11423,2106,624,37,119,156,3.3696,41.96674177516917
Task_11424,2705,688,108,172,280,3.925979680696662,52.44891635571395
Task_11425,2289,675,32,106,138,3.386094674556213,44.8781135120072
Task_11426,1761,1021,161,42,203,1.7230919765166341,37.47332919295841
Task_11427,2301,967,61,22,83,2.3770661157024793,44.73784711679476
Task_11428,1305,974,148,48,196,1.3384615384615384,30.12121626573737
Task_11429,1835,640,84,165,249,2.862714508580343,38.377321775490636
Task_11430,1755,308,121,94,215,5.679611650485437,35.76907183297485
Task_11431,2195,68,82,179,261,31.81159420289855,41.63014540661513
Task_11432,1976,284,13,123,136,6.933333333333334,38.64804696172322
Task_11433,518,114,178,200,378,4.504347826086956,16.130445491219064
Task_11434,2703,729,149,145,294,3.702739726027397,52.57031807016718
Task_11435,1303,831,39,70,109,1.5661057692307692,29.268965010613368
Task_11436,638,943,165,196,361,0.6758474576271186,20.98480571694097
Task_11437,729,617,33,109,142,1.1796116504854368,19.979259369732173
Task_11438,2399,374,78,190,268,6.397333333333333,46.62955619795238
Task_11439,664,286,179,33,212,2.313588850174216,17.843101195607336
Task_11440,2484,598,21,142,163,4.146911519198665,48.01487027956555
Task_11441,1355,580,144,180,324,2.332185886402754,30.937158640126995
Task_11442,2490,355,105,157,262,6.99438202247191,47.86287465677058
Task_11443,2332,101,138,89,227,22.862745098039216,43.61227819851157
Task_11444,2901,881,160,64,224,3.2891156462585034,55.473983167144034
Task_11445,2273,709,104,170,274,3.2014084507042253,45.64221668056911
Task_11446,930,839,80,169,249,1.1071428571428572,24.606029607103796
Task_11447,518,130,136,179,315,3.954198473282443,15.956370353460565
Task_11448,996,616,186,194,380,1.614262560777958,25.62393448256837
Task_11449,875,816,85,61,146,1.0709914320685434,22.713132527170405
Task_11450,673,961,159,138,297,0.6995841995841996,21.19673190212063
Task_11451,1732,422,142,62,204,4.094562647754137,35.37003605754857
Task_11452,2085,1003,170,135,305,2.0766932270916336,43.67031367952726
Task_11453,1063,365,29,128,157,2.9043715846994536,24.621628375837446
Task_11454,1589,204,178,120,298,7.751219512195122,33.20222644598794
Task_11455,2402,831,96,72,168,2.887019230769231,47.192665551378475
Task_11456,1719,771,191,96,287,2.226683937823834,37.03868798537759
Task_11457,1335,762,189,101,290,1.7496723460026213,30.906331043303737
Task_11458,1336,1018,185,23,208,1.3110893032384692,30.704813496743395
Task_11459,1304,885,78,141,219,1.471783295711061,30.566723253893624
Task_11460,2629,593,38,73,111,4.425925925925926,49.69046891483202
Task_11461,2418,859,175,56,231,2.811627906976744,47.743056938823166
Task_11462,2126,308,66,45,111,6.880258899676376,40.23546381882516
Task_11463,2809,356,185,60,245,7.868347338935574,52.369884081155384
Task_11464,2144,948,155,102,257,2.2592202318229715,44.16948074840827
Task_11465,1080,691,129,55,184,1.560693641618497,25.768714014658926
Task_11466,1661,874,20,134,154,1.8982857142857144,35.62905256805244
Task_11467,730,425,196,74,270,1.7136150234741785,19.970100923911687
Task_11468,1486,976,99,47,146,1.5209825997952917,32.65611156103158
Task_11469,538,584,93,30,123,0.9196581196581196,16.405224232818842
Task_11470,2655,200,95,69,164,13.208955223880597,49.073320371972216
Task_11471,1326,695,65,145,210,1.9051724137931034,30.342176754747516
Task_11472,1969,428,187,55,242,4.589743589743589,39.316138676068185
Task_11473,1618,992,24,71,95,1.6294058408862033,34.63879358553096
Task_11474,1700,925,106,166,272,1.83585313174946,37.22376411022959
Task_11475,2735,872,157,118,275,3.1328751431844215,53.40147250396899
Task_11476,2025,660,181,41,222,3.0635400907715584,40.62459750186645
Task_11477,2582,444,73,50,123,5.802247191011236,48.192119092147124
Task_11478,1953,583,139,131,270,3.344178082191781,40.10117877841876
Task_11479,1856,101,115,29,144,18.19607843137255,35.03603213380378
Task_11480,2588,272,168,76,244,9.47985347985348,48.751524817697465
Task_11481,1789,824,148,39,187,2.1684848484848485,37.2258227466596
Task_11482,2825,86,189,194,383,32.47126436781609,52.164220101298305
Task_11483,1009,100,146,39,185,9.990099009900991,21.950210905495904
Task_11484,2231,800,146,156,302,2.7852684144818975,45.36807191506612
Task_11485,1084,192,66,35,101,5.616580310880829,23.393445671133616
Task_11486,1198,691,62,17,79,1.73121387283237,26.12099640877085
Task_11487,2849,651,169,57,226,4.369631901840491,53.88797689054851
Task_11488,2134,221,68,23,91,9.612612612612613,39.86920497033545
Task_11489,1590,87,44,199,243,18.068181818181817,32.16785957636974
Task_11490,2369,103,71,84,155,22.778846153846153,43.62684581476344
Task_11491,880,135,131,176,307,6.470588235294118,21.64112252441545
Task_11492,2228,309,32,108,140,7.187096774193549,42.74317928515905
Task_11493,2297,264,120,69,189,8.667924528301887,43.747834557924705
Task_11494,2657,615,113,178,291,4.313311688311688,51.51527139763031
Task_11495,1550,338,12,187,199,4.572271386430678,32.661813500889686
Task_11496,1111,776,108,16,124,1.4298584298584298,25.672760272139524
Task_11497,621,585,37,40,77,1.0597269624573378,16.83477173092864
Task_11498,1978,654,156,137,293,3.019847328244275,40.83366822883074
Task_11499,2750,561,85,173,258,4.893238434163701,52.66526456978509
Task_11500,1116,297,65,152,217,3.7449664429530203,25.799816076943397
Task_11501,2858,979,103,190,293,2.916326530612245,55.871746229077566
Task_11502,786,612,111,135,246,1.2822185970636215,21.5475208290997
Task_11503,2236,119,153,119,272,18.633333333333333,42.63566581814515
Task_11504,1069,424,182,49,231,2.5152941176470587,24.885520004268795
Task_11505,1141,205,93,186,279,5.538834951456311,26.183194556525056
Task_11506,2132,391,60,66,126,5.438775510204081,41.30633457512542
Task_11507,762,896,84,139,223,0.8494983277591973,21.949735350728883
Task_11508,637,869,132,160,292,0.732183908045977,20.29689660971794
Task_11509,2383,446,147,33,180,5.331096196868009,45.40672101302828
Task_11510,820,78,166,111,277,10.379746835443038,20.087534568760493
Task_11511,963,872,125,82,207,1.1030927835051547,24.839481821854196
Task_11512,1352,440,145,48,193,3.0657596371882088,29.177692136354352
Task_11513,787,854,14,95,109,0.92046783625731,21.334271732480776
Task_11514,2867,633,200,69,269,4.522082018927445,54.35527244649
Task_11515,1757,447,106,178,284,3.921875,36.69671704075909
Task_11516,631,520,165,131,296,1.2111324376199617,19.023166852125346
Task_11517,1913,891,88,149,237,2.1446188340807173,40.269232979293264
Task_11518,2255,936,30,105,135,2.4066168623265742,45.14591942908917
Task_11519,1823,100,41,109,150,18.04950495049505,34.94396676897333
Task_11520,1429,309,122,22,144,4.609677419354838,29.527909728821655
Task_11521,2395,560,128,139,267,4.269162210338681,47.02543168769881
Task_11522,685,637,199,92,291,1.073667711598746,20.10703984421112
Task_11523,1939,886,137,107,244,2.186020293122886,40.676825680438135
Task_11524,1338,603,143,23,166,2.2152317880794703,29.259275077981943
Task_11525,748,881,193,170,363,0.8480725623582767,22.389231617641542
Task_11526,2306,760,130,76,206,3.0302233902759528,45.70931259480705
Task_11527,2188,484,37,130,167,4.511340206185567,43.017582789598784
Task_11528,1264,718,97,170,267,1.7579972183588317,29.64980222942557
Task_11529,952,126,166,124,290,7.496062992125984,22.566755070695375
Task_11530,1661,639,48,27,75,2.5953125,33.33505061794357
Task_11531,1346,592,142,66,208,2.269814502529511,29.864668196858897
Task_11532,2493,1023,135,12,147,2.4345703125,48.648470455084464
Task_11533,1652,550,101,163,264,2.9981851179673322,35.25030887123379
Task_11534,1791,128,103,96,199,13.883720930232558,35.35982481996738
Task_11535,1979,308,80,51,131,6.4045307443365695,38.48089196077725
Task_11536,2277,161,20,144,164,14.055555555555555,42.9378027752358
Task_11537,2705,888,183,29,212,3.0427446569178853,52.056385111977214
Task_11538,742,695,128,124,252,1.0660919540229885,21.12030321355164
Task_11539,1028,736,180,115,295,1.3948439620081412,25.964694062909047
Task_11540,1754,996,97,101,198,1.7592778335005015,37.86537638909267
Task_11541,1946,368,183,67,250,5.273712737127371,38.83989245488422
Task_11542,955,947,12,116,128,1.0073839662447257,24.637552720670822
Task_11543,1923,525,146,176,322,3.655893536121673,39.74234554823698
Task_11544,1350,123,171,51,222,10.887096774193548,27.96472277792856
Task_11545,1352,429,51,35,86,3.144186046511628,28.11473492523764
Task_11546,2225,305,43,160,203,7.271241830065359,43.256248183396416
Task_11547,506,93,166,143,309,5.382978723404255,15.407404444915526
Task_11548,2441,274,78,31,109,8.876363636363637,45.07998941883269
Task_11549,2984,944,80,170,250,3.157671957671958,57.58919605354396
Task_11550,2749,265,164,155,319,10.334586466165414,51.895924628542424
Task_11551,818,583,113,151,264,1.4006849315068493,22.07593188118085
Task_11552,2929,141,191,164,355,20.62676056338028,54.16935715728545
Task_11553,1408,207,151,109,260,6.769230769230769,30.168358522885274
Task_11554,1439,441,173,17,190,3.255656108597285,30.400711065838603
Task_11555,2985,574,98,82,180,5.191304347826087,55.85523791698527
Task_11556,574,266,65,160,225,2.149812734082397,17.179753767467734
Task_11557,2982,382,103,102,205,7.785900783289817,55.400405999172165
Task_11558,1029,307,33,87,120,3.340909090909091,23.617623516357316
Task_11559,1810,386,62,36,98,4.677002583979328,35.25167970738436
Task_11560,1646,866,128,112,240,1.8985005767012688,35.961352824228165
Task_11561,1164,365,164,13,177,3.180327868852459,25.74266032102197
Task_11562,2619,393,165,128,293,6.647208121827411,50.12871286486777
Task_11563,794,747,102,12,114,1.0614973262032086,20.559419419862863
Task_11564,1271,214,20,34,54,5.911627906976745,25.762043500620738
Task_11565,765,946,185,154,339,0.8078141499472017,22.743147253914575
Task_11566,1221,704,22,132,154,1.7319148936170212,28.109459849727475
Task_11567,2657,829,93,158,251,3.2012048192771085,52.01978975872111
Task_11568,565,142,83,32,115,3.9510489510489513,14.754464332314887
Task_11569,2804,97,98,29,127,28.612244897959183,49.644370800349684
Task_11570,2957,431,45,89,134,6.844907407407407,54.696395637754115
Task_11571,1123,286,68,100,168,3.912891986062718,25.532547668414043
Task_11572,1909,380,46,20,66,5.010498687664042,36.272648418934615
Task_11573,2862,136,119,126,245,20.89051094890511,52.502191333550435
Task_11574,909,972,77,150,227,0.934224049331963,24.60194095104559
Task_11575,2522,537,161,151,312,4.687732342007435,49.183087381591974
Task_11576,2440,551,38,17,55,4.420289855072464,45.24866579327388
Task_11577,2124,998,168,47,215,2.126126126126126,43.24458200279645
Task_11578,2861,829,76,98,174,3.446987951807229,54.827835045131934
Task_11579,1977,845,20,181,201,2.3368794326241136,41.050934922591686
Task_11580,2139,874,188,192,380,2.4445714285714284,44.54596660791598
Task_11581,1486,215,95,140,235,6.87962962962963,31.371585431565602
Task_11582,2868,228,126,190,316,12.524017467248909,53.673117115114586
Task_11583,2735,153,161,15,176,17.75974025974026,49.55639349950266
Task_11584,1580,383,120,29,149,4.114583333333333,32.272669647211586
Task_11585,2907,708,101,150,251,4.100141043723554,55.54900823460573
Task_11586,2402,840,40,150,190,2.8561236623067776,47.69571245233235
Task_11587,896,567,116,133,249,1.5774647887323943,23.178400424769194
Task_11588,709,596,151,131,282,1.187604690117253,20.436231135652477
Task_11589,909,750,184,187,371,1.2103861517976031,24.56049930713526
Task_11590,543,174,129,115,244,3.1028571428571428,16.116455275840938
Task_11591,1601,316,58,121,179,5.0504731861198735,33.28869867398497
Task_11592,1254,385,126,46,172,3.2487046632124352,27.313127298563654
Task_11593,899,1005,99,200,299,0.8936381709741551,24.924965882685044
Task_11594,1438,646,58,13,71,2.2225656877897992,29.614965344471063
Task_11595,1443,758,94,106,200,1.901185770750988,32.23024209780624
Task_11596,1590,213,176,164,340,7.429906542056075,33.50462338549017
Task_11597,2193,103,166,168,334,21.08653846153846,42.13725873807828
Task_11598,975,721,109,143,252,1.350415512465374,24.932787377648285
Task_11599,669,144,68,79,147,4.613793103448276,17.253446275987237
Task_11600,1680,871,65,189,254,1.926605504587156,36.761347446388406
Task_11601,2437,654,143,164,307,3.7206106870229005,48.20632569865959
Task_11602,951,543,46,117,163,1.7481617647058822,23.567000075134914
Task_11603,2415,492,84,181,265,4.898580121703854,47.186079199309496
Task_11604,1934,866,69,51,120,2.2306805074971163,39.304544817397144
Task_11605,1314,709,146,135,281,1.8507042253521127,30.43132730408924
Task_11606,2646,107,150,126,276,24.5,48.95336690747612
Task_11607,2542,939,43,113,156,2.704255319148936,49.8425062338477
Task_11608,1069,314,98,34,132,3.3936507936507936,23.8505956917024
Task_11609,2696,882,88,126,214,3.0532276330690826,52.51042094724548
Task_11610,560,851,44,185,229,0.6572769953051644,18.875212911475113
Task_11611,2342,976,51,166,217,2.3971340839303994,47.40596027441712
Task_11612,1844,773,185,135,320,2.3824289405684755,39.20282819294635
Task_11613,666,817,163,71,234,0.8141809290953546,19.978308912626016
Task_11614,787,423,141,165,306,1.8561320754716981,21.348640504216387
Task_11615,2664,835,32,190,222,3.186602870813397,52.024717365129675
Task_11616,2242,895,195,180,375,2.502232142857143,46.20338229901571
Task_11617,1059,840,72,185,257,1.2592152199762188,26.754669805974242
Task_11618,2228,243,165,103,268,9.131147540983607,43.276621216552314
Task_11619,1720,834,196,200,396,2.059880239520958,37.86634472418117
Task_11620,957,480,146,195,341,1.9896049896049897,24.420234317664978
Task_11621,1435,599,50,124,174,2.3916666666666666,31.577908922604223
Task_11622,2629,590,109,160,269,4.44839255499154,50.86655950858604
Task_11623,2631,651,184,189,373,4.035276073619632,51.60363682080242
Task_11624,2305,112,64,188,252,20.398230088495577,43.652362399430444
Task_11625,1137,574,116,98,214,1.9773913043478262,26.8577487004125
Task_11626,2670,181,62,50,112,14.67032967032967,48.13638583982681
Task_11627,2994,137,172,78,250,21.695652173913043,54.339658058140536
Task_11628,1850,678,179,182,361,2.72459499263623,39.2541383613623
Task_11629,1860,644,31,126,157,2.883720930232558,38.119215950766595
Task_11630,2573,307,124,123,247,8.353896103896103,48.893012452649884
Task_11631,2487,748,36,72,108,3.3204272363150866,47.828396188277225
Task_11632,2910,546,166,27,193,5.319926873857404,54.10993530839505
Task_11633,2886,379,182,52,234,7.594736842105263,53.669007701979865
Task_11634,1938,784,168,40,208,2.4687898089171973,39.571202124898306
Task_11635,814,323,18,180,198,2.5123456790123457,20.978628427427964
Task_11636,2745,539,72,48,120,5.083333333333333,50.91542178260358
Task_11637,1367,671,19,73,92,2.0342261904761907,29.606832071305586
Task_11638,2320,681,159,118,277,3.401759530791789,46.23579488098469
Task_11639,2036,964,88,199,287,2.1098445595854924,42.744056377586126
Task_11640,1048,466,78,99,177,2.2441113490364026,24.973220073671072
Task_11641,1880,191,64,195,259,9.791666666666666,37.735007140203
Task_11642,710,398,194,152,346,1.7794486215538847,20.19932833120173
Task_11643,2530,625,77,54,131,4.041533546325879,48.27025412479151
Task_11644,2063,908,93,156,249,2.2695269526952697,42.84298517843309
Task_11645,583,932,74,85,159,0.62486602357985,18.99896045799012
Task_11646,946,240,178,102,280,3.925311203319502,23.065903328826106
Task_11647,1161,950,107,150,257,1.220820189274448,28.604796486526784
Task_11648,2954,238,173,120,293,12.359832635983263,54.864379456297456
Task_11649,706,176,168,18,186,3.9887005649717513,17.744479611797
Task_11650,1255,587,114,119,233,2.1343537414965987,28.875961346944383
Task_11651,1433,704,95,109,204,2.0326241134751775,31.92589749329403
Task_11652,2259,378,196,100,296,5.96042216358839,44.35527251885865
Task_11653,2234,582,98,118,216,3.8319039451114922,44.28966549546115
Task_11654,2393,707,69,75,144,3.3799435028248586,46.63868863620599
Task_11655,1634,605,166,32,198,2.6963696369636962,34.14750982485554
Task_11656,1027,622,140,100,240,1.6484751203852328,25.364810567856292
Task_11657,2478,918,114,104,218,2.6964091403699673,49.19565654467177
Task_11658,2113,146,22,141,163,14.374149659863946,40.19222599181112
Task_11659,2790,1016,98,97,195,2.743362831858407,54.362232900955824
Task_11660,2995,860,110,10,120,3.478513356562137,55.73994303264618
Task_11661,2918,329,151,184,335,8.842424242424242,54.911678448925784
Task_11662,2939,526,110,154,264,5.576850094876661,55.538093391499935
Task_11663,2945,263,69,36,105,11.155303030303031,52.97663211268026
Task_11664,1369,115,40,27,67,11.801724137931034,26.744685680084583
Task_11665,1492,212,101,97,198,7.004694835680751,31.24386038295243
Task_11666,1445,452,45,148,193,3.1898454746136866,31.348405243924642
Task_11667,2569,462,132,108,240,5.5485961123110155,49.296883814765316
Task_11668,1123,493,171,148,319,2.2732793522267207,26.920916129665034
Task_11669,752,835,27,89,116,0.8995215311004785,20.756582539591857
Task_11670,1068,492,47,92,139,2.1663286004056794,25.011445035772237
Task_11671,2112,342,153,72,225,6.1574344023323615,41.32801042891308
Task_11672,1842,457,32,55,87,4.021834061135372,36.22176285556795
Task_11673,1004,788,89,87,176,1.2724968314321927,25.047309164512196
Task_11674,1583,491,133,27,160,3.217479674796748,32.662384785060695
Task_11675,1484,103,152,176,328,14.26923076923077,30.982573475471337
Task_11676,2493,96,128,80,208,25.701030927835053,45.80968754760946
Task_11677,1411,587,139,152,291,2.3996598639455784,31.65616121633343
Task_11678,2323,395,99,152,251,5.866161616161616,45.29935449204047
Task_11679,2529,895,150,52,202,2.822544642857143,49.523831569878304
Task_11680,728,887,179,152,331,0.8198198198198198,21.91954376142894
Task_11681,638,268,106,171,277,2.3717472118959106,18.378367574130753
Task_11682,2268,169,83,171,254,13.341176470588236,43.486447122558594
Task_11683,1743,272,163,130,293,6.384615384615385,35.867863086524416
Task_11684,551,331,19,34,53,1.6596385542168675,14.77978120775699
Task_11685,2532,942,190,53,243,2.6850477200424177,49.91224637378172
Task_11686,1560,558,136,96,232,2.7906976744186047,33.60467105436616
Task_11687,1788,320,57,163,220,5.570093457943925,36.527940047341055
Task_11688,938,557,168,151,319,1.6810035842293907,24.183427605623717
Task_11689,919,112,184,70,254,8.132743362831858,21.275045493584333
Task_11690,2588,619,138,34,172,4.174193548387096,49.16041797593655
Task_11691,1582,901,161,161,322,1.753880266075388,35.484034840489635
Task_11692,1790,606,94,127,221,2.9489291598023066,37.376094217081715
Task_11693,1503,933,69,14,83,1.6092077087794432,32.1127127103108
Task_11694,2680,903,85,60,145,2.9646017699115044,51.59785884758614
Task_11695,1013,529,196,194,390,1.911320754716981,25.679858724057464
Task_11696,2288,590,136,97,233,3.8714043993231813,45.24022058512926
Task_11697,2449,597,61,49,110,4.095317725752508,46.303740828084834
Task_11698,1593,350,143,200,343,4.538461538461538,34.08536415820405
Task_11699,2535,599,135,61,196,4.225,48.60380626373299
Task_11700,2994,544,82,190,272,5.493577981651376,56.59808292202258
Task_11701,1635,91,19,32,51,17.77173913043478,30.597652556642903
Task_11702,773,163,33,93,126,4.713414634146342,18.776763334275675
Task_11703,711,966,37,33,70,0.7352637021716649,19.510407038605557
Task_11704,1840,681,149,130,279,2.697947214076246,38.65935030596392
Task_11705,2187,957,84,42,126,2.2828810020876826,43.516576968390474
Task_11706,2623,142,19,61,80,18.342657342657343,47.149347798316626
Task_11707,1966,280,94,165,259,6.99644128113879,39.32859722494965
Task_11708,2795,838,100,196,296,3.33134684147795,54.45453774013915
Task_11709,1706,596,99,151,250,2.8576214405360134,36.17158127560064
Task_11710,1727,887,155,54,209,1.9448198198198199,36.78970473150334
Task_11711,604,111,28,144,172,5.392857142857143,16.293557704697815
Task_11712,2330,572,74,188,262,4.06631762652705,46.1443076231348
Task_11713,1888,228,175,76,251,8.244541484716157,37.56326404530002
Task_11714,1296,890,180,39,219,1.4545454545454546,29.779708285287878
Task_11715,854,400,134,131,265,2.1296758104738154,22.101774170870282
Task_11716,2565,859,103,150,253,2.9825581395348837,50.614940538208465
Task_11717,1386,728,25,29,54,1.9012345679012346,29.22626079926656
Task_11718,1752,295,130,195,325,5.918918918918919,36.32820472891128
Task_11719,992,882,106,159,265,1.1234428086070216,25.75177847976288
Task_11720,1124,241,137,148,285,4.644628099173554,25.971193568823065
Task_11721,1141,110,187,96,283,10.27927927927928,25.311765772654184
Task_11722,2221,967,90,163,253,2.294421487603306,45.51452813610681
Task_11723,1829,795,35,16,51,2.2977386934673367,36.31295885156583
Task_11724,1614,928,90,59,149,1.73735199138859,34.778169697010895
Task_11725,2539,354,19,122,141,7.152112676056338,47.827516300082685
Task_11726,1877,640,86,36,122,2.9282371294851792,37.461950155005745
Task_11727,589,137,54,166,220,4.268115942028985,16.69251220975812
Task_11728,2281,363,91,118,209,6.266483516483516,44.2869196539128
Task_11729,2568,108,149,157,306,23.559633027522935,47.91653049895638
Task_11730,1882,900,110,81,191,2.088790233074362,39.43414936518489
Task_11731,2466,82,69,72,141,29.710843373493976,44.746926905164365
Task_11732,1703,281,17,69,86,6.039007092198582,33.554042279050826
Task_11733,1413,758,73,140,213,1.8616600790513833,31.913057639164123
Task_11734,2366,80,111,174,285,29.209876543209877,44.439152388278366
Task_11735,893,499,76,81,157,1.786,22.32839730950265
Task_11736,1647,372,177,125,302,4.415549597855228,34.71681647040921
Task_11737,1612,224,188,27,215,7.164444444444444,32.59988164416319
Task_11738,2714,928,40,64,104,2.921420882669537,51.847775353460655
Task_11739,1324,720,73,145,218,1.8363384188626908,30.41466793840377
Task_11740,871,119,155,163,318,7.258333333333334,21.43390059968513
Task_11741,1699,975,18,46,64,1.7407786885245902,35.02323248453022
Task_11742,2075,984,103,42,145,2.1065989847715736,41.9966295989824
Task_11743,2036,189,84,116,200,10.715789473684211,39.782705580009235
Task_11744,2549,588,14,180,194,4.3276740237691005,49.26817796233346
Task_11745,997,1012,161,79,240,0.9842053307008884,25.96778320816333
Task_11746,877,822,91,47,138,1.065613608748481,22.481852307739434
Task_11747,1759,232,199,48,247,7.549356223175966,35.16693965564196
Task_11748,1592,538,163,70,233,2.953617810760668,33.70856376035865
Task_11749,970,364,93,20,113,2.6575342465753424,22.191103658416168
Task_11750,2768,230,107,92,199,11.982683982683982,51.378732668596975
Task_11751,2658,750,90,127,217,3.5392809587217045,51.54456406855309
Task_11752,2023,809,127,48,175,2.4975308641975307,40.873410224858205
Task_11753,2284,134,16,44,60,16.918518518518518,41.235270538534344
Task_11754,2731,478,155,94,249,5.701461377870563,51.92685753642686
Task_11755,965,353,164,177,341,2.725988700564972,24.11857624051952
Task_11756,724,840,34,131,165,0.8608799048751486,20.869582632642604
Task_11757,504,738,118,179,297,0.6820027063599459,17.91526092284414
Task_11758,854,359,52,192,244,2.3722222222222222,22.0386797469737
Task_11759,1267,798,75,137,212,1.5857321652065082,29.68128917733829
Task_11760,2638,478,71,65,136,5.507306889352819,49.62829064880799
Task_11761,2071,524,124,85,209,3.9447619047619047,41.36269457111044
Task_11762,2465,1007,21,151,172,2.445436507936508,49.08196808239327
Task_11763,1783,758,71,33,104,2.3491436100131753,36.19878180001846
Task_11764,1312,67,96,51,147,19.294117647058822,26.233757111940434
Task_11765,981,370,130,144,274,2.6442048517520216,24.075602497983557
Task_11766,1585,595,54,157,211,2.6593959731543624,34.15358413723854
Task_11767,1611,658,24,158,182,2.4446130500758727,34.51718262412466
Task_11768,2356,536,45,108,153,4.387337057728119,45.57716294760068
Task_11769,2821,752,13,38,51,3.746347941567065,52.0580325515915
Task_11770,969,518,165,161,326,1.8670520231213872,24.611937048462163
Task_11771,2273,826,77,99,176,2.7484885126964933,45.499285040924
Task_11772,1162,765,194,82,276,1.516971279373368,27.98763061274766
Task_11773,1565,1002,81,121,202,1.5603190428713858,34.95108512205628
Task_11774,672,1019,187,92,279,0.6588235294117647,21.222546514408073
Task_11775,2061,451,28,161,189,4.5597345132743365,41.05510330148298
Task_11776,2492,440,31,31,62,5.650793650793651,45.83408432675751
Task_11777,814,414,181,107,288,1.96144578313253,21.581449023888876
Task_11778,857,382,152,37,189,2.2375979112271542,21.111303495326684
Task_11779,512,717,196,163,359,0.713091922005571,18.20469792305381
Task_11780,772,421,38,173,211,1.8293838862559242,20.698401633846036
Task_11781,2354,278,103,33,136,8.437275985663083,44.033922443020025
Task_11782,864,869,128,55,183,0.993103448275862,22.978473702469085
Task_11783,1484,524,147,34,181,2.8266666666666667,31.417213414337567
Task_11784,1208,138,109,41,150,8.690647482014388,25.11608267823185
Task_11785,1231,637,191,155,346,1.9294670846394983,29.21432321422434
Task_11786,2700,685,65,41,106,3.935860058309038,50.45172110071824
Task_11787,2181,831,113,146,259,2.621394230769231,44.464389010601394
Task_11788,549,545,171,100,271,1.0054945054945055,17.630381769624226
Task_11789,2721,810,126,166,292,3.3551171393341552,53.13220097895711
Task_11790,965,757,125,41,166,1.2730870712401055,23.900787161877684
Task_11791,1626,785,35,158,193,2.068702290076336,35.26211139927203
Task_11792,2602,930,124,61,185,2.79484425349087,50.63437444523432
Task_11793,2872,498,108,63,171,5.755511022044089,53.4881764904104
Task_11794,2442,395,137,113,250,6.166666666666667,47.118926602987464
Task_11795,871,149,49,122,171,5.806666666666667,20.845278064866594
Task_11796,2363,599,79,102,181,3.9383333333333335,46.223353537642964
Task_11797,526,180,122,23,145,2.9060773480662982,14.683053082530924
Task_11798,2274,513,142,172,314,4.424124513618677,45.21925783942933
Task_11799,1004,555,118,107,225,1.8057553956834533,24.747517950058413
Task_11800,1337,668,105,148,253,1.9985052316890881,30.560610048475443
Task_11801,2487,952,58,37,95,2.6096537250786986,47.78367306942845
Task_11802,2519,986,148,147,295,2.552178318135765,50.46750830294286
Task_11803,1179,640,103,125,228,1.8393135725429017,27.8242939586044
Task_11804,2908,112,102,50,152,25.734513274336283,51.627182120535316
Task_11805,2215,567,106,134,240,3.8996478873239435,44.068458254581266
Task_11806,2491,619,126,23,149,4.017741935483871,47.40013816146939
Task_11807,2796,99,41,87,128,27.96,50.18282685827228
Task_11808,2857,932,19,118,137,3.062165058949625,54.67400518940739
Task_11809,1258,815,110,149,259,1.5416666666666667,29.75252015616176
Task_11810,1657,613,181,125,306,2.698697068403909,35.66168300328964
Task_11811,2017,732,73,178,251,2.751705320600273,41.62717014800648
Task_11812,1378,602,184,122,306,2.285240464344942,31.20425175973328
Task_11813,1283,962,31,23,54,1.332294911734164,28.3415850363897
Task_11814,2043,392,180,108,288,5.198473282442748,40.95963697389288
Task_11815,1735,926,145,88,233,1.871628910463862,37.4322314392584
Task_11816,1665,412,118,31,149,4.031476997578692,33.71818235674352
Task_11817,892,162,135,78,213,5.47239263803681,21.266029233109986
Task_11818,865,232,70,39,109,3.7124463519313307,20.06015766376213
Task_11819,2718,719,188,55,243,3.775,52.10964110411566
Task_11820,1465,194,118,148,266,7.512820512820513,31.094566457035143
Task_11821,2633,681,188,145,333,3.8607038123167157,51.48559173003309
Task_11822,2877,131,188,15,203,21.795454545454547,51.77017585043083
Task_11823,2509,819,116,197,313,3.0597560975609754,49.94171373505852
Task_11824,2650,919,11,138,149,2.880434782608696,51.44579725796425
Task_11825,1848,154,55,111,166,11.92258064516129,36.21743256716076
Task_11826,629,180,159,153,312,3.4751381215469612,17.852079288539844
Task_11827,1854,651,108,123,231,2.8435582822085887,38.560273043104544
Task_11828,2672,325,29,137,166,8.196319018404909,50.148286412011885
Task_11829,2801,686,174,85,259,4.0771470160116445,53.66400755618269
Task_11830,2161,973,149,146,295,2.2186858316221767,44.75243997763803
Task_11831,2163,762,137,120,257,2.834862385321101,43.916165746181115
Task_11832,512,350,118,189,307,1.4586894586894588,16.753980355315868
Task_11833,1199,775,97,23,120,1.5451030927835052,27.045660173131036
Task_11834,1777,681,107,162,269,2.6055718475073313,37.66328814579676
Task_11835,1346,331,16,185,201,4.054216867469879,29.42706444639929
Task_11836,939,241,107,64,171,3.8801652892561984,22.071614548522138
Task_11837,1072,611,194,132,326,1.7516339869281046,26.477697849637433
Task_11838,956,714,154,150,304,1.337062937062937,24.854705657262723
Task_11839,1508,736,49,40,89,2.046132971506106,31.597020991008993
Task_11840,2223,351,182,57,239,6.315340909090909,43.06320893525584
Task_11841,2617,711,153,63,216,3.675561797752809,50.39695437536576
Task_11842,2559,335,146,37,183,7.616071428571429,47.837506105858274
Task_11843,807,828,75,60,135,0.9734620024125452,21.679695354479122
Task_11844,1088,257,25,174,199,4.217054263565892,25.092227510730684
Task_11845,1462,479,17,129,146,3.0458333333333334,31.213956543030594
Task_11846,2822,883,180,111,291,3.1923076923076925,54.87627950004202
Task_11847,530,410,131,106,237,1.289537712895377,16.782223674875798
Task_11848,2572,257,151,50,201,9.968992248062015,47.954299646848796
Task_11849,980,645,187,126,313,1.5170278637770898,25.02989963601667
Task_11850,1897,999,166,182,348,1.897,40.94134104063534
Task_11851,2131,664,59,30,89,3.2045112781954885,41.17344855878082
Task_11852,1082,81,94,154,248,13.195121951219512,24.13828920707948
Task_11853,585,371,186,182,368,1.5725806451612903,18.25054014796983
Task_11854,2343,398,85,20,105,5.87218045112782,43.846195318862236
Task_11855,2809,716,65,94,159,3.917712691771269,53.427597901516926
Task_11856,2775,810,65,100,165,3.4217016029593097,53.35864619590907
Task_11857,1633,991,38,10,48,1.6461693548387097,33.75918782870118
Task_11858,1347,823,76,65,141,1.6347087378640777,30.29799162920999
Task_11859,1861,358,48,93,141,5.183844011142061,37.19880094066762
Task_11860,606,987,59,58,117,0.6133603238866396,18.75414529818671
Task_11861,1404,786,93,62,155,1.7839898348157561,31.02090689637407
Task_11862,1125,101,136,48,184,11.029411764705882,23.87382359815018
Task_11863,1425,179,31,128,159,7.916666666666667,29.293758486922936
Task_11864,2141,399,151,179,330,5.3525,42.826667205331695
Task_11865,1743,175,79,182,261,9.903409090909092,35.297882299214066
Task_11866,732,883,153,152,305,0.8280542986425339,21.85337973502827
Task_11867,1289,148,187,72,259,8.651006711409396,27.553512687719575
Task_11868,1462,700,179,117,296,2.085592011412268,32.78886032643102
Task_11869,2851,409,175,106,281,6.953658536585366,53.76692347978754
Task_11870,1231,853,144,104,248,1.4414519906323184,29.316009742329665
Task_11871,1404,449,91,24,115,3.12,29.279820423597698
Task_11872,2816,652,197,155,352,4.312404287901991,54.39247291903473
Task_11873,1310,327,174,13,187,3.9939024390243905,27.97141875997065
Task_11874,2487,192,44,12,56,12.8860103626943,44.90649656102787
Task_11875,1822,304,57,197,254,5.973770491803279,37.214792469866005
Task_11876,2274,940,60,177,237,2.416578108395324,46.29373778691558
Task_11877,2832,663,166,126,292,4.265060240963855,54.36791739721726
Task_11878,1023,839,114,109,223,1.2178571428571427,25.861065344623245
Task_11879,1119,670,195,174,369,1.6676602086438153,27.66139245463692
Task_11880,2589,493,72,111,183,5.2408906882591095,49.48397088098171
Task_11881,1299,800,43,151,194,1.6217228464419475,30.111426876060786
Task_11882,2171,823,29,156,185,2.6347087378640777,43.93482713189786
Task_11883,590,546,130,67,197,1.0786106032906764,17.675907299512154
Task_11884,2519,1007,165,21,186,2.4990079365079363,49.27394840927517
Task_11885,2109,194,165,64,229,10.815384615384616,40.734818776231386
Task_11886,992,355,136,82,218,2.7865168539325844,23.787281188375516
Task_11887,2738,255,197,38,235,10.6953125,50.637242615122204
Task_11888,765,408,71,114,185,1.8704156479217604,20.359781891275006
Task_11889,1390,828,16,80,96,1.6767189384800965,30.56394100770758
Task_11890,2695,407,195,151,346,6.605392156862745,51.65058820161405
Task_11891,1337,391,150,45,195,3.4107142857142856,28.74775322055515
Task_11892,863,555,133,62,195,1.5521582733812949,21.978525412348848
Task_11893,1565,623,170,65,235,2.5080128205128207,33.566379498221835
Task_11894,2004,512,114,200,314,3.9064327485380117,40.98242987137497
Task_11895,1650,204,72,36,108,8.048780487804878,32.31545453565967
Task_11896,2099,620,11,179,190,3.3800322061191626,42.19739208680559
Task_11897,2381,837,154,21,175,2.841288782816229,46.50996483298017
Task_11898,2227,561,135,133,268,3.9626334519572954,44.3640992102036
Task_11899,516,485,90,185,275,1.0617283950617284,17.03961495552289
Task_11900,2834,251,22,156,178,11.246031746031745,52.51236827130526
Task_11901,2841,740,67,191,258,3.834008097165992,54.770809690055735
Task_11902,982,527,75,188,263,1.8598484848484849,24.666383574502035
Task_11903,2407,709,50,198,248,3.3901408450704227,47.78689311491133
Task_11904,1306,929,169,152,321,1.4043010752688172,31.139376494302052
Task_11905,691,507,82,179,261,1.360236220472441,19.891282020946672
Task_11906,792,977,182,11,193,0.8098159509202454,21.92587149266571
Task_11907,1188,532,141,27,168,2.2288930581613506,26.644729163764083
Task_11908,2783,796,111,65,176,3.491844416562108,53.11069311662785
Task_11909,2357,943,119,172,291,2.496822033898305,47.78498630885679
Task_11910,1554,922,81,137,218,1.6836403033586131,34.654953115215726
Task_11911,1163,676,84,58,142,1.7178729689807977,26.79070897282517
Task_11912,631,756,142,61,203,0.8335535006605019,19.0094958316862
Task_11913,2516,887,93,146,239,2.8333333333333335,49.89563039488093
Task_11914,563,319,154,13,167,1.759375,16.03298837717346
Task_11915,2146,344,52,138,190,6.220289855072464,42.10103880032144
Task_11916,2688,735,13,120,133,3.652173913043478,51.41575970935423
Task_11917,1203,393,71,186,257,3.053299492385787,27.70632268279336
Task_11918,2115,354,123,109,232,5.957746478873239,41.722005851449694
Task_11919,2126,148,194,52,246,14.268456375838927,40.64275045865275
Task_11920,2989,118,76,147,223,25.11764705882353,54.37578091396633
Task_11921,2597,1017,62,137,199,2.5510805500982316,51.419946244170696
Task_11922,2344,765,106,93,199,3.060052219321149,46.47559607417944
Task_11923,2299,853,154,182,336,2.6920374707259955,46.8025599116763
Task_11924,2753,366,88,43,131,7.501362397820164,50.66938493424689
Task_11925,928,101,174,105,279,9.098039215686274,21.8987316246053
Task_11926,1346,659,96,190,286,2.0393939393939395,30.89304695979294
Task_11927,2999,1010,36,64,100,2.9663699307616223,56.600010758805546
Task_11928,662,372,142,141,283,1.774798927613941,19.05795711458543
Task_11929,2635,464,170,171,341,5.666666666666667,50.895684025400556
Task_11930,738,90,114,148,262,8.10989010989011,18.845105622343954
Task_11931,2815,187,92,191,283,14.97340425531915,52.570647438511166
Task_11932,1341,702,118,151,269,1.9075391180654337,30.806568857915906
Task_11933,2696,957,14,162,176,2.81419624217119,52.62899237014617
Task_11934,1179,433,188,72,260,2.716589861751152,27.01983022911968
Task_11935,1940,297,131,10,141,6.510067114093959,37.503613201648406
Task_11936,2083,707,154,131,285,2.9420903954802258,42.61862961637799
Task_11937,1809,593,11,146,157,3.0454545454545454,37.1347372634178
Task_11938,531,152,160,50,210,3.4705882352941178,15.136235263390846
Task_11939,2014,586,33,65,98,3.431005110732538,39.60273338077028
Task_11940,1711,214,191,30,221,7.9581395348837205,34.180586081988054
Task_11941,2302,164,196,47,243,13.951515151515151,43.22564496354284
Task_11942,2186,581,66,84,150,3.7560137457044673,43.0655860458383
Task_11943,1021,313,176,162,338,3.251592356687898,24.840089076481593
Task_11944,1655,819,75,200,275,2.018292682926829,36.30923684245921
Task_11945,1949,854,182,54,236,2.27953216374269,40.3261717817558
Task_11946,1725,888,158,145,303,1.9403824521934758,37.613831811433585
Task_11947,511,252,181,159,340,2.0197628458498023,16.58648481461555
Task_11948,577,655,51,155,206,0.8795731707317073,18.29813891755979
Task_11949,1108,408,192,56,248,2.709046454767726,25.654039980407646
Task_11950,1423,911,62,177,239,1.5603070175438596,32.686451939969906
Task_11951,1185,503,101,198,299,2.3511904761904763,27.91708926214977
Task_11952,2674,238,99,109,208,11.188284518828452,50.043712534703104
Task_11953,2326,1015,38,47,85,2.2893700787401574,45.45951620626794
Task_11954,802,682,195,175,370,1.1742313323572475,22.63728819406634
Task_11955,1628,891,13,99,112,1.8251121076233183,34.84477927570381
Task_11956,981,146,23,150,173,6.673469387755102,22.495825603102485
Task_11957,2830,817,119,107,226,3.4596577017114916,54.49717083601291
Task_11958,2713,678,35,172,207,3.995581737849779,52.2291571605466
Task_11959,1217,115,70,98,168,10.491379310344827,25.998019283886208
Task_11960,787,529,38,66,104,1.4849056603773585,20.048023965425482
Task_11961,1565,650,102,20,122,2.403993855606759,32.49225010253607
Task_11962,660,119,75,193,268,5.5,18.021736883633768
Task_11963,2028,402,79,52,131,5.032258064516129,39.632714917600886
Task_11964,1989,271,37,157,194,7.3125,39.36967503155298
Task_11965,1196,974,18,88,106,1.2266666666666666,28.12090326138561
Task_11966,1865,110,35,100,135,16.8018018018018,35.55448621927234
Task_11967,706,656,47,88,135,1.0745814307458144,19.703040126400808
Task_11968,529,945,160,162,322,0.5591966173361522,19.015898323820466
Task_11969,1701,572,170,115,285,2.968586387434555,36.119995540319394
Task_11970,1743,370,75,41,116,4.69811320754717,34.444813927176334
Task_11971,2652,463,116,140,256,5.7155172413793105,50.732963068771824
Task_11972,2693,471,159,40,199,5.705508474576271,50.49346024074001
Task_11973,1017,181,137,197,334,5.587912087912088,24.169438710572592
Task_11974,1841,547,116,45,161,3.3594890510948905,36.95470527409782
Task_11975,2025,449,198,45,243,4.5,40.03890458021633
Task_11976,2433,840,102,164,266,2.8929845422116527,48.543146101901335
Task_11977,1852,508,14,196,210,3.638506876227898,38.07220906933853
Task_11978,1864,967,103,170,273,1.9256198347107438,39.96338429527831
Task_11979,2357,641,194,30,224,3.6713395638629285,45.8221620430439
Task_11980,529,104,193,87,280,5.038095238095238,15.507113205728595
Task_11981,2603,645,135,69,204,4.029411764705882,49.91920330162711
Task_11982,2860,706,145,106,251,4.045261669024045,54.733671586739014
Task_11983,1307,469,87,187,274,2.7808510638297874,29.57248571405835
Task_11984,686,567,34,186,220,1.2077464788732395,19.778752622629785
Task_11985,1526,792,14,76,90,1.9243379571248425,32.52159629263219
Task_11986,2215,258,102,23,125,8.552123552123552,41.58824910588441
Task_11987,1847,630,22,77,99,2.9270998415213945,37.13605821312937
Task_11988,1431,131,54,69,123,10.840909090909092,28.71985297495887
Task_11989,2073,520,125,163,288,3.978886756238004,41.92900189276043
Task_11990,2454,459,153,46,199,5.334782608695652,46.683548165534006
Task_11991,923,191,11,156,167,4.807291666666667,21.989535802347707
Task_11992,1386,425,160,132,292,3.2535211267605635,30.723117120628142
Task_11993,1058,418,193,195,388,2.5250596658711215,26.035099083678727
Task_11994,2084,805,144,104,248,2.5856079404466503,42.735156796711124
Task_11995,2841,166,124,83,207,17.01197604790419,52.03332406614049
Task_11996,1783,666,113,199,312,2.6731634182908546,37.95931119076161
Task_11997,2551,320,90,129,219,7.947040498442368,48.46735875440833
Task_11998,2938,324,123,17,140,9.04,53.370892491051556
Task_11999,971,987,189,166,355,0.9827935222672065,26.211320293936154
Task_12000,1317,600,91,176,267,2.1913477537437602,30.13467807588276
Task_12001,1673,176,200,80,280,9.451977401129943,33.94408587469554
Task_12002,2239,442,198,196,394,5.054176072234763,44.831532049566384
Task_12003,2493,395,135,85,220,6.295454545454546,47.67262068317
Task_12004,2175,301,36,70,106,7.201986754966887,41.36371560059066
Task_12005,1214,210,115,142,257,5.753554502369668,27.151051823239907
Task_12006,1359,734,156,21,177,1.8489795918367347,30.006079500975435
Task_12007,2264,434,31,99,130,5.204597701149425,43.70720834903085
Task_12008,2341,978,174,108,282,2.3912155260469867,47.50610374516424
Task_12009,2683,379,53,91,144,7.060526315789474,50.26397847327067
Task_12010,2022,817,55,118,173,2.471882640586797,41.51040094921354
Task_12011,575,201,18,171,189,2.8465346534653464,16.75011961524771
Task_12012,522,413,98,52,150,1.2608695652173914,15.865490597638777
Task_12013,2265,518,53,125,178,4.364161849710983,44.45720861825516
Task_12014,1858,575,148,36,184,3.2256944444444446,37.512280243984
Task_12015,824,798,82,157,239,1.0312891113892366,22.716580899552735
Task_12016,1319,446,14,109,123,2.9507829977628637,28.69478570351834
Task_12017,800,582,36,188,224,1.3722126929674099,21.669984995187622
Task_12018,2628,946,124,129,253,2.775079197465681,51.854340697156864
Task_12019,1909,226,43,131,174,8.409691629955947,37.783719563458725
Task_12020,1942,941,142,194,336,2.061571125265393,41.43770553776502
Task_12021,725,439,74,110,184,1.6477272727272727,19.79649800969558
Task_12022,2983,644,34,48,82,4.6248062015503875,54.72057940922458
Task_12023,1372,154,187,138,325,8.851612903225806,29.553033201127445
Task_12024,618,397,119,146,265,1.5527638190954773,18.33728469586183
Task_12025,1596,997,51,188,239,1.5991983967935872,35.767458414184254
Task_12026,1576,519,82,100,182,3.0307692307692307,33.49120535992346
Task_12027,1554,307,125,59,184,5.045454545454546,32.05164309000875
Task_12028,2994,993,187,179,366,3.0120724346076457,58.38352283724341
Task_12029,2159,69,136,178,314,30.84285714285714,41.29686264520643
Task_12030,2442,178,177,119,296,13.64245810055866,46.30577897105797
Task_12031,2340,505,194,167,361,4.624505928853755,46.44294506825008
Task_12032,1677,87,140,103,243,19.056818181818183,33.403651388993765
Task_12033,577,555,148,128,276,1.0377697841726619,18.186864218755904
Task_12034,872,550,11,50,61,1.5825771324863884,20.654239291230127
Task_12035,2741,491,104,151,255,5.571138211382114,52.24475294093969
Task_12036,2712,367,101,135,236,7.369565217391305,51.265974714027
Task_12037,753,625,60,183,243,1.2028753993610224,21.18520294669706
Task_12038,1802,864,60,14,74,2.083236994219653,36.05558667114931
Task_12039,2369,250,22,71,93,9.43824701195219,44.09754598761938
Task_12040,1641,467,154,105,259,3.5064102564102564,34.704998173585146
Task_12041,1399,508,124,189,313,2.74852652259332,31.37074966791546
Task_12042,1364,852,180,184,364,1.5990621336459554,32.10070425018058
Task_12043,2573,543,40,104,144,4.729779411764706,49.00351489446266
Task_12044,2956,85,19,64,83,34.372093023255815,51.83302174388936
Task_12045,766,484,23,17,40,1.579381443298969,18.387502492962465
Task_12046,1131,294,59,47,106,3.833898305084746,24.306833099100682
Task_12047,810,560,45,180,225,1.4438502673796791,21.776797377797223
Task_12048,561,718,97,82,179,0.780250347705146,17.909298975689328
Task_12049,1195,569,27,67,94,2.0964912280701755,26.54716318028004
Task_12050,777,413,165,160,325,1.8768115942028984,21.23723763140232
Task_12051,2971,92,16,38,54,31.946236559139784,51.55920354572118
Task_12052,589,474,173,57,230,1.24,17.553380137388487
Task_12053,1381,864,142,197,339,1.5965317919075144,32.31369643313821
Task_12054,1063,688,109,143,252,1.5428156748911466,26.228336563815347
Task_12055,2259,894,136,105,241,2.524022346368715,45.75574159436096
Task_12056,1664,814,76,120,196,2.041717791411043,35.965064815641306
Task_12057,549,696,99,63,162,0.787661406025825,17.334288071992166
Task_12058,2966,263,101,182,283,11.234848484848484,55.19514598117964
Task_12059,1874,952,180,108,288,1.9664218258132213,40.051958400277364
Task_12060,1464,831,49,148,197,1.7596153846153846,32.91047715440295
Task_12061,2414,985,123,52,175,2.4482758620689653,47.847627625815164
Task_12062,2331,397,38,44,82,5.85678391959799,43.524045886591104
Task_12063,2549,801,45,189,234,3.178304239401496,50.17930541645558
Task_12064,2183,352,128,75,203,6.18413597733711,42.433914226827305
Task_12065,595,546,162,145,307,1.0877513711151736,18.604761832835646
Task_12066,835,367,121,20,141,2.2690217391304346,20.28418337117819
Task_12067,2201,906,170,98,268,2.426681367144432,44.99309005437692
Task_12068,1224,734,25,112,137,1.6653061224489796,28.166196306919165
Task_12069,917,685,24,21,45,1.336734693877551,21.551811872865233
Task_12070,2714,82,74,126,200,32.69879518072289,49.544858458366235
Task_12071,1280,362,25,61,86,3.5261707988980717,27.021050521818704
Task_12072,2256,163,148,161,309,13.75609756097561,43.48530133895165
Task_12073,2229,137,167,189,356,16.152173913043477,43.13229600388839
Task_12074,2953,666,127,48,175,4.427286356821589,55.15561833647987
Task_12075,1050,871,38,47,85,1.2041284403669725,24.88974661518786
Task_12076,2925,650,177,80,257,4.493087557603687,55.474983573755146
Task_12077,1156,828,171,135,306,1.3944511459589868,28.356970681024066
Task_12078,1455,909,12,129,141,1.598901098901099,32.41195560885462
Task_12079,853,239,130,122,252,3.5541666666666667,21.49655368182444
Task_12080,1892,242,20,138,158,7.7860082304526745,37.3185528412099
Task_12081,2474,528,194,20,214,4.676748582230624,47.1913901853816
Task_12082,1372,427,163,44,207,3.205607476635514,29.476770144016843
Task_12083,1673,742,139,100,239,2.2516823687752354,35.98063539127826
Task_12084,1471,132,168,120,288,11.06015037593985,30.759684324579865
Task_12085,2962,834,46,188,234,3.547305389221557,56.8305018534478
Task_12086,1098,501,187,32,219,2.187250996015936,25.42788304339719
Task_12087,1982,691,175,154,329,2.8641618497109826,41.200536229204054
Task_12088,1013,189,36,194,230,5.331578947368421,23.850737021288776
Task_12089,2955,476,143,112,255,6.19496855345912,55.52626273637369
Task_12090,626,449,189,44,233,1.3911111111111112,17.856164225936254
Task_12091,688,574,31,166,197,1.1965217391304348,19.687526106588162
Task_12092,2371,858,194,100,294,2.760186263096624,47.649483233688414
Task_12093,961,812,53,94,147,1.1820418204182042,24.38809207701935
Task_12094,1769,916,71,53,124,1.9291166848418757,36.98495266019936
Task_12095,728,140,152,141,293,5.163120567375887,19.17274194495406
Task_12096,2536,992,71,124,195,2.553877139979859,50.331122127838626
Task_12097,516,103,150,138,288,4.961538461538462,15.537968598711887
Task_12098,2925,213,102,112,214,13.66822429906542,53.939087716495465
Task_12099,550,361,21,62,83,1.5193370165745856,15.48061085601166
Task_12100,2304,376,42,33,75,6.111405835543766,42.69340295678995
Task_12101,2202,134,144,119,263,16.31111111111111,42.16800566908142
Task_12102,2910,460,154,151,305,6.31236442516269,55.04390607734806
Task_12103,2053,341,77,59,136,6.002923976608187,39.811855544776535
Task_12104,1052,397,58,31,89,2.64321608040201,23.25363025715801
Task_12105,2458,815,24,51,75,3.0122549019607843,46.71994341441624
Task_12106,2038,619,101,178,279,3.2870967741935484,41.67058957757317
Task_12107,2278,505,89,131,220,4.5019762845849804,44.752087500558105
Task_12108,1507,305,67,35,102,4.92483660130719,30.347550880929607
Task_12109,2132,986,178,132,310,2.160081053698075,44.38040634285486
Task_12110,2447,134,178,84,262,18.125925925925927,45.82724705542023
Task_12111,2336,1009,153,24,177,2.3128712871287127,46.35998571744303
Task_12112,2055,201,161,176,337,10.173267326732674,40.804783878232804
Task_12113,1399,212,44,37,81,6.568075117370892,28.233435756374927
Task_12114,874,752,115,99,214,1.1606905710491369,23.165319083957087
Task_12115,931,465,64,48,112,1.997854077253219,21.81779747412932
Task_12116,2983,967,185,178,363,3.081611570247934,58.11298911125467
Task_12117,1479,393,164,140,304,3.753807106598985,32.157876280794135
Task_12118,888,965,88,12,100,0.9192546583850931,22.679042793588607
Task_12119,930,249,16,82,98,3.72,21.500437794772143
Task_12120,1734,613,80,54,134,2.824104234527687,35.619132680096364
Task_12121,2292,917,42,182,224,2.496732026143791,46.40328990769012
Task_12122,2747,724,136,187,323,3.788965517241379,53.4438179683227
Task_12123,1347,278,188,42,230,4.827956989247312,28.70456477583528
Task_12124,1007,543,38,187,225,1.8511029411764706,24.88463555847606
Task_12125,1493,263,107,173,280,5.65530303030303,31.890415581123236
Task_12126,2897,226,69,181,250,12.762114537444933,53.885022222781316
Task_12127,708,894,157,71,228,0.7910614525139665,20.863894352047094
Task_12128,2342,451,136,110,246,5.18141592920354,45.6979600217441
Task_12129,1526,898,49,109,158,1.6974416017797553,33.67646867614244
Task_12130,1333,136,130,24,154,9.72992700729927,27.082390350103044
Task_12131,1628,796,150,121,271,2.042659974905897,35.611185010514156
Task_12132,1474,1002,49,117,166,1.469591226321037,33.3437949522625
Task_12133,2587,347,61,139,200,7.433908045977011,49.131339019457506
Task_12134,1261,472,154,12,166,2.6659619450317127,27.590280483731707
Task_12135,2614,102,198,32,230,25.37864077669903,47.56681557214609
Task_12136,629,478,144,51,195,1.313152400835073,18.04303549235547
Task_12137,706,805,110,70,180,0.8759305210918115,20.281577218595647
Task_12138,1827,324,165,151,316,5.621538461538462,37.50671921108097
Task_12139,1880,602,58,192,250,3.1177446102819237,39.074289545098196
Task_12140,1544,81,179,22,201,18.829268292682926,30.21354405923188
Task_12141,1325,82,103,115,218,15.963855421686747,27.75224858724241
Task_12142,842,73,96,76,172,11.378378378378379,19.48583982413825
Task_12143,1716,355,30,175,205,4.820224719101123,35.39200914642077
Task_12144,1839,247,33,137,170,7.415322580645161,36.715243518358044
Task_12145,2523,744,13,139,152,3.386577181208054,48.86720199307157
Task_12146,777,473,176,165,341,1.639240506329114,21.491520444578857
Task_12147,701,400,180,125,305,1.7481296758104738,19.83883835674278
Task_12148,1106,833,32,71,103,1.3261390887290168,26.118351429933185
Task_12149,829,708,52,13,65,1.1692524682651622,20.2516259482091
Task_12150,2442,932,35,148,183,2.617363344051447,48.555693886778045
Task_12151,2269,409,52,94,146,5.534146341463415,43.876132678816155
Task_12152,1766,1010,32,165,197,1.7467853610286845,38.17806764493693
Task_12153,1267,305,137,84,221,4.140522875816994,27.987464783061018
Task_12154,2125,172,179,192,371,12.283236994219653,41.761541330107846
Task_12155,1947,926,135,79,214,2.100323624595469,40.64963124769468
Task_12156,1079,106,55,131,186,10.08411214953271,23.903631947537395
Task_12157,2033,949,193,183,376,2.14,43.06874424028081
Task_12158,1624,693,87,93,180,2.3400576368876083,34.70412937744745
Task_12159,1777,1009,80,103,183,1.7594059405940594,38.21334369359234
Task_12160,1895,275,182,183,365,6.865942028985507,38.68285392247568
Task_12161,2982,993,74,44,118,3.0,56.01490943565946
Task_12162,1926,481,42,96,138,3.995850622406639,38.579678906238094
Task_12163,1717,228,90,15,105,7.497816593886463,33.37672556433544
Task_12164,990,370,114,150,264,2.6684636118598384,24.18171022945498
Task_12165,826,699,19,45,64,1.18,20.367261622624053
Task_12166,2473,211,176,91,267,11.665094339622641,46.947653539443166
Task_12167,1556,667,31,121,152,2.3293413173652695,33.30928095496238
Task_12168,2591,225,75,124,199,11.464601769911505,48.7273109278365
Task_12169,2718,542,98,23,121,5.005524861878453,50.400552595961784
Task_12170,1771,185,79,125,204,9.521505376344086,35.595342156816436
Task_12171,620,960,80,97,177,0.6451612903225806,19.87580877303125
Task_12172,912,636,33,97,130,1.4317111459968603,22.97007881052524
Task_12173,1086,95,143,53,196,11.3125,23.421470061072323
Task_12174,1288,535,55,155,210,2.4029850746268657,29.253985762816097
Task_12175,1314,694,156,46,202,1.8906474820143886,29.39046218657374
Task_12176,1862,83,164,73,237,22.166666666666668,35.80347313779328
Task_12177,1453,582,144,170,314,2.4922813036020584,32.43561090893294
Task_12178,886,166,168,124,292,5.3053892215568865,21.74980676291389
Task_12179,1281,492,41,51,92,2.5983772819472617,27.528142719067997
Task_12180,2685,564,178,148,326,4.752212389380531,51.90944199757022
Task_12181,1070,559,61,44,105,1.9107142857142858,24.136339695041347
Task_12182,2731,302,26,195,221,9.013201320132014,51.34758301895561
Task_12183,2718,452,147,98,245,6.0,51.63797369726581
Task_12184,2200,275,171,159,330,7.971014492753623,43.31067169706542
Task_12185,2602,627,50,147,197,4.143312101910828,50.311468598669414
Task_12186,1941,818,117,139,256,2.36996336996337,40.59751920188482
Task_12187,1110,644,49,14,63,1.7209302325581395,24.4387188686319
Task_12188,2968,341,117,47,164,8.678362573099415,54.2852080034693
Task_12189,699,963,31,146,177,0.725103734439834,21.044812196239942
Task_12190,902,804,172,42,214,1.1204968944099378,23.2475322668954
Task_12191,1975,481,119,122,241,4.097510373443983,39.98070665398419
Task_12192,2958,726,196,178,374,4.068775790921595,57.009275615705256
Task_12193,689,989,189,181,370,0.695959595959596,21.931766033789074
Task_12194,526,1023,122,130,252,0.513671875,18.94064789734469
Task_12195,2816,349,126,27,153,8.045714285714286,51.6493654535714
Task_12196,606,175,17,67,84,3.4431818181818183,15.691424688037825
Task_12197,2227,350,179,62,241,6.344729344729345,43.132010723344955
Task_12198,2866,464,85,99,184,6.163440860215053,53.70251284966435
Task_12199,1417,916,21,28,49,1.5452562704471102,30.304564056268088
Task_12200,826,966,79,117,196,0.8541882109617374,23.08109235571661
Task_12201,2131,885,55,178,233,2.405191873589165,43.84004796721265
Task_12202,850,96,152,34,186,8.762886597938145,19.39324753873056
Task_12203,2678,943,108,164,272,2.836864406779661,52.77422094584438
Task_12204,824,146,73,99,172,5.605442176870748,20.084633126473538
Task_12205,1761,265,126,187,313,6.620300751879699,36.301851740094484
Task_12206,2117,938,109,124,233,2.2545260915867944,43.63458563600611
Task_12207,2586,991,104,148,252,2.6068548387096775,51.352492387921416
Task_12208,854,626,103,83,186,1.3620414673046253,22.230501178213995
Task_12209,642,168,24,160,184,3.798816568047337,17.367297780243685
Task_12210,2611,388,120,102,222,6.712082262210797,49.627297009007044
Task_12211,1576,680,124,84,208,2.31424375917768,34.0125110534046
Task_12212,1204,331,195,194,389,3.6265060240963853,28.06920051179256
Task_12213,1699,406,157,129,286,4.174447174447175,35.5837919454087
Task_12214,1992,65,195,64,259,30.181818181818183,37.87132066617415
Task_12215,824,996,55,75,130,0.8264794383149449,22.670837795445028
Task_12216,551,139,19,112,131,3.9357142857142855,15.132407685699965
Task_12217,2301,478,106,51,157,4.803757828810021,44.20660784620488
Task_12218,1539,142,121,107,228,10.762237762237762,31.629103391984952
Task_12219,1270,274,178,102,280,4.618181818181818,28.29909734846657
Task_12220,2021,732,152,12,164,2.757162346521146,40.43795451933822
Task_12221,1511,119,119,90,209,12.591666666666667,30.832293680163847
Task_12222,1506,64,88,152,240,23.16923076923077,30.69977447882771
Task_12223,1371,885,114,137,251,1.5474040632054176,31.706556117750434
Task_12224,2043,597,15,33,48,3.4163879598662206,39.158215034627936
Task_12225,2700,998,200,46,246,2.7027027027027026,52.49672184194055
Task_12226,1188,897,109,46,155,1.3229398663697105,27.670887956710416
Task_12227,930,123,130,130,260,7.5,22.071358750658835
Task_12228,862,153,68,103,171,5.597402597402597,20.711569792910996
Task_12229,1925,328,153,49,202,5.851063829787234,37.98558632659334
Task_12230,1150,402,133,155,288,2.8535980148883375,26.93075190069709
Task_12231,1958,699,162,77,239,2.797142857142857,40.16079253097862
Task_12232,2299,721,165,157,322,3.1842105263157894,46.28910725533907
Task_12233,1264,452,57,40,97,2.7902869757174393,26.839345387475678
Task_12234,851,231,170,39,209,3.668103448275862,20.611812449936114
Task_12235,1430,342,101,129,230,4.169096209912537,30.86756697106402
Task_12236,1587,69,62,112,174,22.67142857142857,31.61450461460122
Task_12237,2477,946,134,74,208,2.6156282998944036,48.999755831143595
Task_12238,1122,564,137,102,239,1.9858407079646017,26.699938059652037
Task_12239,1913,201,175,55,230,9.470297029702971,37.59877307139311
Task_12240,1430,201,192,45,237,7.079207920792079,29.770196675426096
Task_12241,2678,232,110,135,245,11.493562231759658,50.28709002352116
Task_12242,2225,917,43,171,214,2.423747276688453,45.28043772571528
Task_12243,2383,909,147,115,262,2.6186813186813187,47.876673882867145
Task_12244,2579,480,99,169,268,5.361746361746362,49.731118247459584
Task_12245,2440,744,120,168,288,3.2751677852348995,48.45794565334967
Task_12246,1992,200,15,192,207,9.91044776119403,39.22762995146727
Task_12247,2763,751,93,81,174,3.6742021276595747,52.853853383949634
Task_12248,1551,245,31,43,74,6.304878048780488,30.357524366379845
Task_12249,2945,256,95,64,159,11.459143968871595,53.693945254036976
Task_12250,2219,941,40,149,189,2.3556263269639066,45.10535104162587
Task_12251,1943,80,33,167,200,23.987654320987655,37.404120819555246
Task_12252,1837,241,171,185,356,7.590909090909091,37.60920230164263
Task_12253,2646,128,33,32,65,20.511627906976745,46.94688278900748
Task_12254,2824,904,137,164,301,3.1204419889502764,55.09648392814908
Task_12255,2853,528,34,117,151,5.393194706994329,53.42840287151836
Task_12256,1195,140,17,143,160,8.47517730496454,25.484306620592978
Task_12257,2573,439,159,153,312,5.847727272727273,49.675364480464204
Task_12258,1987,614,185,44,229,3.2308943089430895,39.90623849793129
Task_12259,1848,288,35,163,198,6.3944636678200695,37.21691405455212
Task_12260,1367,160,43,178,221,8.490683229813664,29.058125168597822
Task_12261,673,560,179,134,313,1.1996434937611409,19.89838294644518
Task_12262,1726,129,137,27,164,13.276923076923078,33.521200712996084
Task_12263,951,470,53,162,215,2.0191082802547773,23.749619505159444
Task_12264,2827,1019,109,149,258,2.7715686274509803,55.28744760144573
Task_12265,1903,499,17,180,197,3.806,38.74345316613786
Task_12266,2147,492,138,17,155,4.354969574036511,41.50257310731664
Task_12267,2732,296,189,128,317,9.198653198653199,51.6908873123784
Task_12268,902,792,83,33,116,1.1374527112232031,22.4794095129452
Task_12269,1914,1004,121,143,264,1.9044776119402984,40.790503962266946
Task_12270,1347,676,136,200,336,1.9896602658788773,31.194293755853852
Task_12271,1373,417,197,174,371,3.284688995215311,30.909432893969562
Task_12272,883,504,123,59,182,1.7485148514851485,22.046473822372615
Task_12273,1046,259,94,163,257,4.023076923076923,24.705130987689643
Task_12274,1672,790,166,81,247,2.11378002528445,36.018638232744586
Task_12275,2177,979,102,115,217,2.2214285714285715,44.62765969701255
Task_12276,929,715,80,90,170,1.297486033519553,23.70665340401362
Task_12277,1518,891,30,130,160,1.701793721973094,33.47682253820751
Task_12278,1819,839,152,10,162,2.1654761904761903,37.482861463570885
Task_12279,595,959,161,144,305,0.6197916666666666,20.040934179218358
Task_12280,2916,1013,89,13,102,2.8757396449704142,54.834256361516815
Task_12281,1962,300,11,49,60,6.51827242524917,37.08115253357545
Task_12282,2998,898,193,196,389,3.3348164627363737,58.27830909679835
Task_12283,517,561,98,94,192,0.9199288256227758,16.861503468141688
Task_12284,2537,977,128,76,204,2.594069529652352,50.03883496710438
Task_12285,2238,818,120,172,292,2.7326007326007327,45.51368206161993
Task_12286,1129,815,142,123,265,1.383578431372549,27.686485864458874
Task_12287,2892,440,58,185,243,6.557823129251701,54.53322162213549
Task_12288,1270,303,188,125,313,4.177631578947368,28.577670053704207
Task_12289,2670,985,40,113,153,2.707910750507099,51.956369193307474
Task_12290,799,708,103,16,119,1.1269393511988717,20.468859037244258
Task_12291,1926,484,29,51,80,3.971134020618557,37.494005810015416
Task_12292,1572,842,132,136,268,1.8647686832740213,34.87560779665751
Task_12293,621,947,195,105,300,0.6550632911392406,20.321739518648403
Task_12294,2944,133,140,151,291,21.970149253731343,54.019114836545334
Task_12295,2455,180,84,44,128,13.56353591160221,45.076371244909545
Task_12296,2854,528,138,197,335,5.395085066162571,54.581805793093565
Task_12297,1072,68,141,97,238,15.53623188405797,23.867170295254223
Task_12298,1979,920,59,144,203,2.1487513572204127,41.35586154803952
Task_12299,705,688,75,39,114,1.02322206095791,19.08459997375647
Task_12300,2136,881,14,93,107,2.421768707482993,42.787097581305375
Task_12301,1598,282,121,193,314,5.646643109540636,33.79713449201541
Task_12302,1870,128,46,46,92,14.496124031007753,34.996447277090006
Task_12303,2032,115,15,194,209,17.517241379310345,39.14475667394097
Task_12304,1957,500,31,31,62,3.906187624750499,37.55949520433913
Task_12305,924,258,130,173,303,3.5675675675675675,22.985653983741532
Task_12306,1832,422,114,103,217,4.33096926713948,37.39118226294317
Task_12307,2887,557,149,75,224,5.173835125448028,54.342324923641115
Task_12308,1866,940,80,113,193,1.9829968119022316,39.52035061181181
Task_12309,1449,226,72,60,132,6.383259911894273,29.88482904464328
Task_12310,1162,218,174,32,206,5.30593607305936,25.465058619894165
Task_12311,568,444,77,161,238,1.2764044943820225,17.63409059058023
Task_12312,1145,799,127,121,248,1.43125,27.81081881987777
Task_12313,2423,319,48,80,128,7.571875,46.028122875767714
Task_12314,1411,370,168,95,263,3.803234501347709,30.77041867526562
Task_12315,539,373,23,63,86,1.4411764705882353,15.43891053417659
Task_12316,1549,331,199,69,268,4.6656626506024095,32.51258997544297
Task_12317,1651,518,180,26,206,3.1811175337186897,34.143393422804955
Task_12318,2866,504,66,75,141,5.675247524752475,53.469345333224595
Task_12319,2336,222,140,68,208,10.475336322869955,44.3060070511934
Task_12320,2721,256,49,35,84,10.587548638132295,49.1990099125353
Task_12321,2430,598,30,109,139,4.056761268781302,46.88372890080114
Task_12322,1075,443,153,18,171,2.421171171171171,24.520382517365913
Task_12323,1361,597,166,94,260,2.2759197324414715,30.664347437799538
Task_12324,1563,900,109,196,305,1.734739178690344,35.15455441551629
Task_12325,1091,146,182,23,205,7.421768707482993,23.817011404243477
Task_12326,2895,896,124,51,175,3.2274247491638794,55.13598607751225
Task_12327,2593,412,52,31,83,6.278450363196126,47.699116417417
Task_12328,743,276,104,89,193,2.6823104693140793,19.520337392567207
Task_12329,1822,483,19,149,168,3.7644628099173554,37.21623462816871
Task_12330,2739,940,152,149,301,2.9107332624867164,53.84017717957431
Task_12331,1006,105,67,165,232,9.49056603773585,23.092552144064754
Task_12332,2605,525,151,111,262,4.952471482889734,50.17463480605037
Task_12333,1677,203,94,109,203,8.220588235294118,34.15368794926676
Task_12334,1072,583,190,51,241,1.8356164383561644,25.587897350889083
Task_12335,2221,559,118,114,232,3.9660714285714285,44.072611107969294
Task_12336,1124,630,138,187,325,1.7812995245641838,27.436645524887837
Task_12337,2458,778,127,161,288,3.155327342747112,48.839665836705365
Task_12338,802,683,149,51,200,1.172514619883041,21.441920153878034
Task_12339,680,740,10,200,210,0.9176788124156545,20.128540947365988
Task_12340,765,333,167,18,185,2.2904191616766467,19.36287934936239
Task_12341,2315,120,62,100,162,19.132231404958677,43.123952051524476
Task_12342,1092,807,153,51,204,1.3514851485148516,26.4392767328797
Task_12343,1388,800,165,177,342,1.7328339575530587,32.20996531246038
Task_12344,2285,147,28,154,182,15.43918918918919,43.162817128217405
Task_12345,1303,574,171,191,362,2.266086956521739,30.282275995801353
Task_12346,1784,71,94,49,143,24.77777777777778,33.46391486447444
Task_12347,2479,196,22,174,196,12.583756345177665,46.84098610226858
Task_12348,1900,250,92,184,276,7.569721115537849,38.282198063711
Task_12349,1259,714,72,64,136,1.760839160839161,28.513910202331346
Task_12350,2929,781,148,66,214,3.7455242966751916,55.560501669256986
Task_12351,2194,889,31,11,42,2.465168539325843,42.30136506739118
Task_12352,1368,529,15,154,169,2.581132075471698,30.184956425242216
Task_12353,1654,107,188,87,275,15.314814814814815,33.17197593449886
Task_12354,2634,91,192,189,381,28.630434782608695,49.19735316214305
Task_12355,2485,827,107,117,224,3.001207729468599,49.068131670284004
Task_12356,2832,440,89,99,188,6.421768707482993,53.099303745691024
Task_12357,1868,125,61,190,251,14.825396825396826,36.91687470658212
Task_12358,2696,1010,36,91,127,2.6666666666666665,52.38695717977521
Task_12359,2848,303,193,139,332,9.368421052631579,53.633554897174996
Task_12360,1052,429,70,51,121,2.4465116279069767,24.00679882941138
Task_12361,1506,559,80,76,156,2.6892857142857145,32.10742757715517
Task_12362,2755,137,63,110,173,19.963768115942027,50.41632243858865
Task_12363,1619,918,38,95,133,1.7616974972796517,35.1032056785317
Task_12364,1854,251,154,34,188,7.357142857142857,36.412590312523484
Task_12365,1705,574,49,154,203,2.965217391304348,35.97330121167202
Task_12366,2430,191,63,67,130,12.65625,45.441360574768794
Task_12367,814,433,197,154,351,1.8755760368663594,21.99407667103687
Task_12368,1885,227,123,89,212,8.267543859649123,37.484590795570966
Task_12369,1548,994,124,156,280,1.5557788944723618,35.007914205925424
Task_12370,2184,803,25,50,75,2.716417910447761,42.26475309254631
Task_12371,1745,1019,119,43,162,1.7107843137254901,36.943730913326455
Task_12372,1056,589,131,191,322,1.7898305084745763,26.237518519213605
Task_12373,2542,856,148,70,218,2.9661610268378062,49.68838178994228
Task_12374,2334,108,181,185,366,21.412844036697248,44.54991118784568
Task_12375,2497,475,192,196,388,5.245798319327731,48.995557198854804
Task_12376,2720,283,58,68,126,9.577464788732394,50.260347313025335
Task_12377,2784,720,193,107,300,3.8613037447988905,53.79636546200967
Task_12378,1008,524,105,159,264,1.92,24.965834195058942
Task_12379,2025,225,146,20,166,8.960176991150442,38.8653178630409
Task_12380,2979,337,193,87,280,8.81360946745562,55.452902071476736
Task_12381,1234,85,137,34,171,14.348837209302326,25.245223141792426
Task_12382,2948,675,168,79,247,4.3609467455621305,55.86947321842181
Task_12383,1905,714,186,128,314,2.664335664335664,39.94726454452457
Task_12384,1699,272,154,64,218,6.2234432234432235,34.46074980547111
Task_12385,1283,334,96,123,219,3.8298507462686566,28.465797819472034
Task_12386,2433,65,92,112,204,36.86363636363637,44.984000377948014
Task_12387,534,522,193,29,222,1.0210325047801148,16.57464866901903
Task_12388,1567,955,147,142,289,1.639121338912134,35.23738821747838
Task_12389,1471,83,177,153,330,17.511904761904763,30.607886126647585
Task_12390,2265,101,172,196,368,22.205882352941178,43.435406665396165
Task_12391,825,501,120,25,145,1.6434262948207172,20.650576599836473
Task_12392,2814,864,123,144,267,3.253179190751445,54.630190742050864
Task_12393,2572,832,187,57,244,3.0876350540216086,50.15195408874096
Task_12394,2059,275,11,24,35,7.4601449275362315,38.16126100570394
Task_12395,1131,219,184,122,306,5.140909090909091,26.06329475266323
Task_12396,2441,737,70,124,194,3.307588075880759,48.03604994505514
Task_12397,1411,719,37,113,150,1.9597222222222221,31.201985964897215
Task_12398,2797,312,43,121,164,8.936102236421725,52.044739477881116
Task_12399,513,272,89,130,219,1.879120879120879,16.073041136547133
Task_12400,526,710,37,77,114,0.739803094233474,16.800807856448987
Task_12401,624,696,101,119,220,0.8952654232424677,19.1475132963874
Task_12402,863,919,185,28,213,0.9380434782608695,23.07288852490196
Task_12403,564,416,61,14,75,1.3525179856115108,15.080942719127934
Task_12404,2501,994,153,161,314,2.51356783919598,50.31334661989433
Task_12405,2194,729,165,128,293,3.0054794520547947,44.47771768251523
Task_12406,1068,733,36,27,63,1.4550408719346049,24.258121930557724
Task_12407,2368,556,169,191,360,4.2513464991023335,47.080499526000914
Task_12408,2455,801,102,152,254,3.061097256857855,48.69786274608606
Task_12409,1514,666,51,112,163,2.269865067466267,32.93832921408775
Task_12410,1836,554,62,144,206,3.308108108108108,37.95434253646135
Task_12411,859,619,104,185,289,1.385483870967742,22.99977769913451
Task_12412,1330,933,156,106,262,1.423982869379015,31.198764648373057
Task_12413,2322,703,26,159,185,3.2982954545454546,45.93819059325684
Task_12414,2062,357,42,148,190,5.759776536312849,40.77506853471332
Task_12415,2627,206,100,148,248,12.690821256038648,49.41185493058572
Task_12416,2629,606,165,131,296,4.3311367380560135,50.99679232826136
Task_12417,1683,401,112,172,284,4.186567164179104,35.368439100007016
Task_12418,2851,688,151,36,187,4.13788098693759,53.616221701971995
Task_12419,1943,542,111,134,245,3.578268876611418,39.70449365693775
Task_12420,1922,562,197,190,387,3.413854351687389,40.157566526428994
Task_12421,2947,684,143,20,163,4.302189781021898,54.94720508751701
Task_12422,1102,572,64,144,208,1.9232111692844678,26.400387822101433
Task_12423,1052,235,29,184,213,4.4576271186440675,24.54429133754213
Task_12424,2821,622,37,156,193,4.52808988764045,53.68484506795004
Task_12425,827,151,34,85,119,5.440789473684211,19.343348492092844
Task_12426,689,799,38,74,112,0.86125,19.631819045668205
Task_12427,2017,458,165,85,250,4.394335511982571,40.48083765587833
Task_12428,718,566,124,164,288,1.2663139329805997,20.559440644244415
Task_12429,1503,833,43,149,192,1.8021582733812949,33.44756112610069
Task_12430,672,794,92,67,159,0.8452830188679246,19.478001870020336
Task_12431,1130,190,159,107,266,5.9162303664921465,25.743025453526624
Task_12432,1917,495,38,89,127,3.8649193548387095,38.432874609782914
Task_12433,1929,89,75,47,122,21.433333333333334,35.73848680882317
Task_12434,1288,511,28,45,73,2.515625,27.017719842689726
Task_12435,707,1018,119,173,292,0.6938174681059862,21.95252666425192
Task_12436,1976,333,41,93,134,5.916167664670659,38.86355069438318
Task_12437,1238,863,135,94,229,1.4328703703703705,29.35100879354432
Task_12438,2191,938,143,122,265,2.3333333333333335,44.94848433788459
Task_12439,1773,553,25,75,100,3.200361010830325,35.80571399317962
Task_12440,887,130,16,172,188,6.770992366412214,21.0921056255483
Task_12441,912,113,52,16,68,8.0,19.347482813755118
Task_12442,1152,366,27,77,104,3.138964577656676,25.460514081104918
Task_12443,2443,171,31,157,188,14.203488372093023,45.830879972962215
Task_12444,1434,644,93,121,214,2.2232558139534886,31.845061712834767
Task_12445,1625,947,137,116,253,1.7141350210970465,35.93127672460608
Task_12446,2710,965,174,170,344,2.8053830227743273,53.68328904742598
Task_12447,520,628,199,180,379,0.8267090620031796,18.080825756657838
Task_12448,799,974,69,157,226,0.8194871794871795,22.876951911804213
Task_12449,921,461,44,112,156,1.9935064935064934,22.668619682325858
Task_12450,2476,526,105,19,124,4.698292220113852,46.565190254857754
Task_12451,2604,919,95,178,273,2.8304347826086955,51.561995466958244
Task_12452,1812,176,189,142,331,10.23728813559322,36.5511574564
Task_12453,2138,1021,93,125,218,2.091976516634051,44.19785061066705
Task_12454,1573,865,74,129,203,1.8163972286374135,34.720310043040485
Task_12455,743,263,178,60,238,2.8143939393939394,19.35940400039811
Task_12456,1401,668,89,163,252,2.094170403587444,31.57077656876187
Task_12457,1232,869,15,113,128,1.4160919540229886,28.818742996303808
Task_12458,1949,470,193,177,370,4.138004246284501,40.19584326787084
Task_12459,1416,806,86,50,136,1.754646840148699,30.96774859524334
Task_12460,2612,419,115,128,243,6.219047619047619,49.87902259262743
Task_12461,1924,166,45,45,90,11.520958083832335,36.153869462586
Task_12462,1998,334,138,129,267,5.964179104477612,39.991516848512354
Task_12463,2866,306,190,112,302,9.335504885993485,53.75403808937449
Task_12464,2787,745,53,17,70,3.7359249329758715,51.30984342009279
Task_12465,802,972,120,107,227,0.8242548818088387,22.820030557114933
Task_12466,753,575,76,135,211,1.3072916666666667,20.811294778611188
Task_12467,602,86,169,153,322,6.919540229885057,16.96854502814206
Task_12468,1748,395,177,45,222,4.414141414141414,35.38554665256834
Task_12469,2842,1007,167,176,343,2.8194444444444446,55.910410128772504
Task_12470,2607,1013,182,64,246,2.5710059171597632,51.326747110379735
Task_12471,2069,927,96,137,233,2.2295258620689653,42.866486794317176
Task_12472,2602,861,161,168,329,3.0185614849187936,51.57637036428937
Task_12473,1428,427,193,49,242,3.336448598130841,30.626130578883334
Task_12474,756,251,166,186,352,3.0,20.54801925247983
Task_12475,2793,539,30,16,46,5.1722222222222225,50.697881749608264
Task_12476,1481,1023,53,39,92,1.4462890625,32.085104913288895
Task_12477,882,320,83,81,164,2.7476635514018692,21.708744982093126
Task_12478,1404,795,35,198,233,1.763819095477387,32.00162293744463
Task_12479,2522,165,48,187,235,15.19277108433735,47.418758950605074
Task_12480,1346,144,128,118,246,9.282758620689656,28.706118896027856
Task_12481,550,697,21,66,87,0.7879656160458453,16.71169080499273
Task_12482,1884,801,41,114,155,2.349127182044888,38.97903301898944
Task_12483,1174,177,92,91,183,6.595505617977528,25.627373837512
Task_12484,1183,81,98,44,142,14.426829268292684,24.098191492768667
Task_12485,972,715,165,56,221,1.3575418994413408,24.332766477104993
Task_12486,2196,356,20,180,200,6.151260504201681,42.954966395353814
Task_12487,593,378,148,87,235,1.5646437994722955,17.60308602660027
Task_12488,708,566,24,76,100,1.2486772486772486,18.959787476700594
Task_12489,1181,634,115,17,132,1.8598425196850394,26.54687614908589
Task_12490,703,825,110,126,236,0.851089588377724,20.866238087858537
Task_12491,1915,1008,37,100,137,1.8979187314172448,40.003023520484554
Task_12492,1903,76,140,180,320,24.714285714285715,37.33176748726829
Task_12493,2654,408,115,136,251,6.488997555012225,50.55496274018327
Task_12494,929,363,145,28,173,2.552197802197802,22.077826113665214
Task_12495,2089,929,78,133,211,2.246236559139785,43.14386051117171
Task_12496,2502,977,42,187,229,2.558282208588957,49.94789384227014
Task_12497,1460,620,59,132,191,2.3510466988727856,32.125592062071824
Task_12498,2683,193,116,155,271,13.829896907216495,50.351494323721035
Task_12499,1821,103,113,67,180,17.509615384615383,34.96580132311198
Task_12500,2764,249,74,186,260,11.056,51.913390400827474
Task_12501,1638,508,105,147,252,3.218074656188605,34.81806061483763
Task_12502,2008,283,88,136,224,7.070422535211268,39.75112966608012
Task_12503,979,644,160,155,315,1.5178294573643412,25.06247399964599
Task_12504,639,807,26,129,155,0.7908415841584159,19.257304349602833
Task_12505,1339,920,155,78,233,1.4538545059717698,31.02028793142851
Task_12506,644,785,77,124,201,0.8193384223918575,19.669346201248302
Task_12507,1260,921,128,181,309,1.3665943600867678,30.381116383960006
Task_12508,1663,153,66,109,175,10.7987012987013,33.42286534173865
Task_12509,2251,420,48,100,148,5.346793349168646,43.57343657051566
Task_12510,2016,96,60,182,242,20.783505154639176,38.915952702106786
Task_12511,2131,500,193,13,206,4.253493013972056,41.62180944377078
Task_12512,1188,410,23,131,154,2.8905109489051095,26.68127522728938
Task_12513,1396,266,122,174,296,5.228464419475656,30.44125231957778
Task_12514,1914,467,129,149,278,4.089743589743589,39.176484486992095
Task_12515,2343,145,145,60,205,16.04794520547945,43.80983636110549
Task_12516,2798,130,72,173,245,21.358778625954198,51.59501647276627
Task_12517,741,775,155,83,238,0.9548969072164949,21.20981792446348
Task_12518,907,300,36,133,169,3.0132890365448506,22.161343958108194
Task_12519,550,803,85,105,190,0.6840796019900498,18.26433409002175
Task_12520,2994,491,36,169,205,6.085365853658536,56.06556085134022
Task_12521,1278,624,10,65,75,2.0448,27.55179097320534
Task_12522,1655,819,181,48,229,2.018292682926829,35.32844771870321
Task_12523,2337,651,164,86,250,3.584355828220859,46.17539876423049
Task_12524,1008,323,199,171,370,3.111111111111111,24.824258406542565
Task_12525,1975,199,30,169,199,9.875,38.91481334587568
Task_12526,622,649,123,165,288,0.9569230769230769,19.33924896418395
Task_12527,2128,475,86,60,146,4.470588235294118,41.47444259246569
Task_12528,1354,64,68,143,211,20.83076923076923,28.23581799064932
Task_12529,2776,438,106,128,234,6.323462414578588,52.49674292036193
Task_12530,2407,950,31,134,165,2.5310199789695056,47.94691543021779
Task_12531,2363,888,99,183,282,2.658042744656918,47.685726403551485
Task_12532,2925,71,126,31,157,40.625,51.37849907146619
Task_12533,2023,82,139,86,225,24.373493975903614,38.53447707145275
Task_12534,1156,288,37,17,54,4.0,24.088409549793795
Task_12535,877,976,157,197,354,0.8976458546571137,24.74016558739362
Task_12536,2281,314,152,95,247,7.241269841269841,44.272562886204774
Task_12537,2521,245,141,144,285,10.247967479674797,48.04970250189134
Task_12538,2298,569,85,107,192,4.031578947368421,45.13924570310018
Task_12539,1329,146,124,113,237,9.040816326530612,28.393377413810253
Task_12540,2446,103,48,65,113,23.51923076923077,44.4368740059694
Task_12541,1594,199,78,23,101,7.97,31.329323272458293
Task_12542,1552,357,124,127,251,4.335195530726257,32.938058135978494
Task_12543,2694,260,141,128,269,10.32183908045977,50.743363092963875
Task_12544,2310,206,132,49,181,11.159420289855072,43.52034177486277
Task_12545,1822,942,79,63,142,1.9321314952279958,38.16171460709149
Task_12546,1956,784,121,182,303,2.49171974522293,41.00384481930258
Task_12547,2611,955,63,58,121,2.731171548117155,50.29480317125717
Task_12548,519,150,102,70,172,3.437086092715232,14.90376402113876
Task_12549,2882,92,178,94,272,30.989247311827956,52.43609817170121
Task_12550,859,773,168,181,349,1.1098191214470283,23.71786538757873
Task_12551,606,658,40,184,224,0.9195751138088012,18.770338594230633
Task_12552,1392,843,10,48,58,1.6492890995260663,29.80614587788733
Task_12553,1115,643,188,138,326,1.7313664596273293,27.267325422577812
Task_12554,2625,124,35,103,138,21.0,47.69030151428206
Task_12555,1005,347,11,115,126,2.8879310344827585,23.497773708588223
Task_12556,1766,317,155,83,238,5.553459119496855,35.99549002146056
Task_12557,2269,530,119,114,233,4.273069679849341,44.74451012349226
Task_12558,1512,461,129,159,288,3.272727272727273,32.853790634824634
Task_12559,1536,509,25,29,54,3.011764705882353,30.914671916621558
Task_12560,1338,274,86,38,124,4.865454545454545,27.820562551909152
Task_12561,1554,847,25,27,52,1.8325471698113207,32.23806890972569
Task_12562,2945,456,60,183,243,6.444201312910285,55.42157286098021
Task_12563,2432,191,34,112,146,12.666666666666666,45.58438382825643
Task_12564,2872,220,18,170,188,12.995475113122172,53.069136241663934
Task_12565,1422,865,169,47,216,1.6420323325635104,31.71082545747737
Task_12566,2660,132,50,75,125,20.0,48.223168915051126
Task_12567,2060,603,140,40,180,3.410596026490066,40.80396104418934
Task_12568,2337,313,50,80,130,7.442675159235669,44.567762081302185
Task_12569,1235,95,78,142,220,12.864583333333334,26.51383636976236
Task_12570,1946,807,41,63,104,2.4084158415841586,39.28681040073293
Task_12571,1370,586,133,26,159,2.3339011925042588,29.58114575138774
Task_12572,2853,507,14,32,46,5.616141732283465,51.686435958314725
Task_12573,1748,570,78,102,180,3.0612959719789843,36.40678693463378
Task_12574,942,875,187,67,254,1.0753424657534247,24.52837500255586
Task_12575,674,100,74,101,175,6.673267326732673,17.435573755617572
Task_12576,2538,187,98,65,163,13.5,47.25823408653026
Task_12577,1029,611,140,146,286,1.6813725490196079,25.636944787922857
Task_12578,731,981,98,121,219,0.7443991853360489,21.69516567028464
Task_12579,1078,303,122,174,296,3.5460526315789473,25.537170597541223
Task_12580,2590,577,198,42,240,4.4809688581314875,49.392079185589544
Task_12581,2259,517,122,90,212,4.361003861003861,44.382951426282496
Task_12582,1191,712,87,92,179,1.670406732117812,27.852926736737384
Task_12583,1564,856,68,164,232,1.824970828471412,34.74434444982839
Task_12584,707,737,106,46,152,0.9579945799457995,19.63084945530439
Task_12585,2565,1003,161,89,250,2.554780876494024,50.9190257738579
Task_12586,2833,286,29,65,94,9.871080139372822,51.53220029980577
Task_12587,1546,784,125,151,276,1.9694267515923567,34.34119779405602
Task_12588,1208,298,188,187,375,4.040133779264214,27.95128968781238
Task_12589,784,702,198,165,363,1.1152204836415363,22.349361207124385
Task_12590,2088,364,150,105,255,5.720547945205479,41.42599885971558
Task_12591,2389,566,44,106,150,4.213403880070547,46.18864548588211
Task_12592,1932,210,123,101,224,9.156398104265403,38.27811102160894
Task_12593,832,73,147,115,262,11.243243243243244,20.22534427394009
Task_12594,785,607,133,149,282,1.2911184210526316,21.698917745463223
Task_12595,2718,487,39,24,63,5.569672131147541,49.542744487940006
Task_12596,1766,322,33,184,217,5.46749226006192,36.143860488038364
Task_12597,1081,209,154,102,256,5.147619047619048,24.984624853749228
Task_12598,1763,250,165,172,337,7.0239043824701195,36.367272344310976
Task_12599,1040,214,62,37,99,4.837209302325581,22.498232893520775
Task_12600,1418,713,57,49,106,1.9859943977591037,30.26533799925358
Task_12601,1409,780,132,61,193,1.8040973111395646,31.323572947190186
Task_12602,1371,433,136,65,201,3.1589861751152073,29.74117976458066
Task_12603,2945,315,77,114,191,9.319620253164556,54.604716760128944
Task_12604,1252,737,174,30,204,1.6964769647696476,28.519327981477137
Task_12605,820,784,190,192,382,1.0445859872611465,23.31725139677592
Task_12606,817,78,173,185,358,10.341772151898734,20.514093037228132
Task_12607,1444,741,188,175,363,1.9460916442048517,33.01861514824568
Task_12608,1321,426,123,94,217,3.0936768149882905,29.2972583374229
Task_12609,2325,388,67,120,187,5.976863753213368,45.031721739332795
Task_12610,2070,534,48,47,95,3.869158878504673,39.935535247879045
Task_12611,2723,239,103,120,223,11.345833333333333,50.903624793157746
Task_12612,2404,139,118,92,210,17.17142857142857,44.99548377278271
Task_12613,2947,311,118,146,264,9.445512820512821,54.93113980198715
Task_12614,2815,836,71,20,91,3.3632019115890084,52.630502344180236
Task_12615,837,690,121,65,186,1.211287988422576,21.98885015473523
Task_12616,678,922,78,50,128,0.7345612134344529,19.88897087282885
Task_12617,556,668,74,51,125,0.8310911808669657,17.05267945716547
Task_12618,1183,545,88,177,265,2.1666666666666665,27.792205125047087
Task_12619,1153,70,88,128,216,16.239436619718308,25.038948621906954
Task_12620,2354,610,145,20,165,3.8527004909983633,45.34411972443568
Task_12621,2923,308,178,23,201,9.459546925566343,53.526256747523114
Task_12622,2191,448,125,199,324,4.879732739420936,43.78022114101518
Task_12623,1050,845,193,139,332,1.2411347517730495,26.842693525013768
Task_12624,881,188,71,155,226,4.661375661375661,21.79645697589199
Task_12625,636,612,180,100,280,1.037520391517129,19.275054524825364
Task_12626,1672,311,181,199,380,5.358974358974359,35.370958221731264
Task_12627,2682,713,140,58,198,3.7563025210084033,51.31422549049288
Task_12628,567,1007,31,14,45,0.5625,17.070509691144938
Task_12629,1847,182,71,113,184,10.092896174863387,36.61872986957039
Task_12630,2115,744,88,100,188,2.838926174496644,42.704291385191006
Task_12631,1319,222,104,62,166,5.914798206278027,28.02024358831935
Task_12632,1722,110,197,122,319,15.513513513513514,34.644025646679054
Task_12633,2913,869,26,32,58,3.3482758620689657,53.862284147336034
Task_12634,1171,633,163,71,234,1.8470031545741326,27.381484007435347
Task_12635,1581,922,97,102,199,1.7128927410617552,34.90023798531692
Task_12636,1128,691,191,50,241,1.630057803468208,26.691772210253337
Task_12637,2957,367,195,133,328,8.035326086956522,55.5535901538571
Task_12638,2291,420,185,126,311,5.441805225653207,45.10593419345847
Task_12639,2566,736,30,104,134,3.4816824966078697,49.447837751284574
Task_12640,517,833,170,57,227,0.6199040767386091,17.7283329035313
Task_12641,1410,247,110,152,262,5.685483870967742,30.412212292138403
Task_12642,695,968,49,148,197,0.717234262125903,21.20985315308582
Task_12643,1683,994,116,112,228,1.6914572864321609,36.877679679012516
Task_12644,1809,113,96,84,180,15.868421052631579,35.15047311851893
Task_12645,1504,719,25,54,79,2.088888888888889,31.45535532584535
Task_12646,1698,160,10,105,115,10.546583850931677,33.130642281068205
Task_12647,709,364,104,189,293,1.9424657534246574,19.90512410413497
Task_12648,1781,884,48,84,132,2.0124293785310736,37.58376317803336
Task_12649,1351,524,83,91,174,2.5733333333333333,29.856944700327556
Task_12650,2042,919,28,132,160,2.2195652173913043,41.870048730347854
Task_12651,1373,259,39,141,180,5.280769230769231,29.466946260505413
Task_12652,2479,247,137,162,299,9.995967741935484,47.48306966372805
Task_12653,519,371,146,129,275,1.3951612903225807,16.69838601037605
Task_12654,1279,201,107,158,265,6.3316831683168315,28.204861650055495
Task_12655,1468,552,170,44,214,2.6546112115732368,31.424250123727333
Task_12656,2472,351,117,171,288,7.0227272727272725,47.70230305089353
Task_12657,1285,493,111,172,283,2.6012145748987856,29.358449210729592
Task_12658,1382,705,132,114,246,1.9575070821529745,31.307481320585726
Task_12659,1332,870,30,112,142,1.529276693455798,30.322542498658464
Task_12660,2822,858,36,107,143,3.2852153667054713,53.95308398495735
Task_12661,2440,264,100,157,257,9.20754716981132,46.7324909542974
Task_12662,1566,459,149,62,211,3.4043478260869566,32.89302348739832
Task_12663,1670,409,128,169,297,4.073170731707317,35.24280607572943
Task_12664,2815,906,56,181,237,3.103638368246968,54.766197554374976
Task_12665,2347,507,101,111,212,4.6200787401574805,45.80656179358789
Task_12666,1550,347,179,85,264,4.454022988505747,32.79370906039495
Task_12667,2545,361,173,87,260,7.030386740331492,48.580204017987676
Task_12668,1874,670,63,94,157,2.7928464977645304,38.47214624077868
Task_12669,1627,146,141,73,214,11.068027210884354,32.63142049330823
Task_12670,2737,89,46,72,118,30.41111111111111,48.84258728768962
Task_12671,2064,700,144,133,277,2.944365192582026,42.26254835653928
Task_12672,2673,927,121,196,317,2.8803879310344827,52.8947416436738
Task_12673,2156,955,147,150,297,2.2552301255230125,44.63207066807089
Task_12674,507,665,163,31,194,0.7612612612612613,16.527531835499307
Task_12675,2035,660,192,39,231,3.0786686838124053,40.82113165441645
Task_12676,1867,148,59,135,194,12.53020134228188,36.77899709568761
Task_12677,2766,807,15,110,125,3.4232673267326734,52.82356742986578
Task_12678,2136,890,140,90,230,2.3973063973063975,43.69101185289097
Task_12679,1639,785,84,47,131,2.0852417302798982,34.4126605467283
Task_12680,992,647,91,179,270,1.5308641975308641,25.1134631258016
Task_12681,833,340,186,11,197,2.442815249266862,20.524874573732635
Task_12682,1020,320,71,32,103,3.177570093457944,22.73506874295038
Task_12683,1392,524,148,152,300,2.6514285714285712,31.19761584945886
Task_12684,1401,305,14,36,50,4.578431372549019,28.12306340407376
Task_12685,2633,148,44,98,142,17.671140939597315,48.086739741124966
Task_12686,1718,99,175,22,197,17.18,33.08434413289678
Task_12687,946,755,96,120,216,1.2513227513227514,24.36095474819858
Task_12688,828,120,113,124,237,6.8429752066115705,20.348713176429612
Task_12689,1652,330,37,21,58,4.990936555891238,32.158567203323614
Task_12690,1506,599,171,154,325,2.51,33.35446459349529
Task_12691,512,378,43,123,166,1.3509234828496042,16.082304567615704
Task_12692,2931,292,153,194,347,10.003412969283277,55.054567980310104
Task_12693,2750,455,147,85,232,6.030701754385965,51.992132387165526
Task_12694,2937,810,35,72,107,3.6214549938347718,55.12874037256012
Task_12695,1922,515,108,132,240,3.7248062015503876,39.26056443996957
Task_12696,2412,478,68,101,169,5.035490605427975,46.55844252896998
Task_12697,1322,631,34,123,157,2.0917721518987342,29.567698986721496
Task_12698,594,95,175,173,348,6.1875,16.979045241580263
Task_12699,1633,925,14,182,196,1.763498920086393,35.81319113119856
Task_12700,2057,936,101,119,220,2.1953041622198506,42.61167949477284
Task_12701,2916,493,112,107,219,5.902834008097166,54.79491262166922
Task_12702,1579,363,113,77,190,4.337912087912088,32.86536825626983
Task_12703,1715,441,185,88,273,3.8800904977375565,35.77205110588296
Task_12704,1797,510,137,172,309,3.516634050880626,37.635241855083265
Task_12705,2391,455,51,75,126,5.243421052631579,45.81984022969843
Task_12706,2859,448,169,10,179,6.367483296213808,52.83975642729133
Task_12707,1081,549,191,87,278,1.9654545454545456,26.096159179250478
Task_12708,1146,543,196,82,278,2.1066176470588234,27.08945832151271
Task_12709,614,940,151,118,269,0.6524973432518597,20.068550091811318
Task_12710,2545,137,173,35,208,18.442028985507246,46.68986981443334
Task_12711,521,158,176,99,275,3.2767295597484276,15.87340046671806
Task_12712,2584,972,148,174,322,2.655704008221994,51.61517252840656
Task_12713,2781,712,169,24,193,3.900420757363254,52.563490155066084
Task_12714,752,968,66,118,184,0.7760577915376677,21.884170265215815
Task_12715,1310,965,157,144,301,1.3561076604554865,31.219444399972613
Task_12716,2270,341,32,74,106,6.637426900584796,43.07149718415379
Task_12717,1310,185,44,165,209,7.043010752688172,28.312031501569006
Task_12718,2055,788,45,102,147,2.6045627376425857,41.61446689220697
Task_12719,927,218,27,79,106,4.232876712328767,21.488593765369803
Task_12720,676,318,87,143,230,2.1191222570532915,18.846294104292955
Task_12721,2462,777,51,57,108,3.16452442159383,47.222434030112
Task_12722,2729,841,102,92,194,3.2410926365795723,52.75230510247599
Task_12723,674,173,151,195,346,3.8735632183908044,18.764458353882354
Task_12724,1950,582,168,68,236,3.3447684391080617,39.528598497813576
Task_12725,2102,328,38,35,73,6.3890577507598785,39.32431429322725
Task_12726,2302,271,159,10,169,8.463235294117647,43.35018307909741
Task_12727,1236,96,173,18,191,12.742268041237113,25.392860411542703
Task_12728,2154,936,90,142,232,2.2988260405549625,44.23088233894284
Task_12729,2238,522,172,40,212,4.279158699808796,43.51379506391704
Task_12730,2561,844,187,139,326,3.0307692307692307,50.8174898692759
Task_12731,946,122,151,15,166,7.691056910569106,21.136954992723584
Task_12732,2716,841,114,54,168,3.2256532066508314,52.09770487988061
Task_12733,1285,599,107,34,141,2.1416666666666666,28.203831082366268
Task_12734,1065,627,113,165,278,1.6958598726114649,26.248778967297266
Task_12735,2823,359,14,77,91,7.841666666666667,51.68598575333302
Task_12736,1659,779,57,41,98,2.126923076923077,34.11247421572548
Task_12737,2176,766,55,11,66,2.837027379400261,41.65902078847294
Task_12738,2339,373,76,58,134,6.254010695187166,44.438945550565585
Task_12739,2619,77,77,166,243,33.57692307692308,48.28130505928419
Task_12740,1502,1006,100,190,290,1.4915590863952333,34.41105420971682
Task_12741,1267,128,186,78,264,9.821705426356589,27.1557121666554
Task_12742,1236,522,110,118,228,2.363288718929254,28.347059788240983
Task_12743,1481,941,59,41,100,1.5721868365180467,31.831531914108552
Task_12744,1391,457,37,88,125,3.037117903930131,29.973599444411487
Task_12745,2159,772,95,183,278,2.7930142302716687,44.0814270746339
Task_12746,1683,958,92,113,205,1.7549530761209593,36.67142757104701
Task_12747,2932,909,38,14,52,3.221978021978022,54.13521849314571
Task_12748,2336,542,93,48,141,4.302025782688766,44.80037132377652
Task_12749,2379,840,164,87,251,2.8287752675386444,47.44570535028913
Task_12750,2805,81,194,125,319,34.207317073170735,51.40871359893058
Task_12751,2774,978,200,88,288,2.833503575076609,54.30631877492329
Task_12752,636,534,110,198,308,1.188785046728972,19.302952234811233
Task_12753,2062,79,194,171,365,25.775,40.03435748816468
Task_12754,613,191,83,121,204,3.1927083333333335,17.366248502181588
Task_12755,1663,262,86,120,206,6.32319391634981,34.122549570560956
Task_12756,853,107,157,92,249,7.898148148148148,20.486754545687376
Task_12757,2549,641,107,182,289,3.970404984423676,49.88430163374085
Task_12758,2278,923,67,146,213,2.465367965367965,46.15563840278811
Task_12759,1391,457,12,128,140,3.037117903930131,29.97849322373978
Task_12760,898,780,137,159,296,1.1498079385403328,24.095811712267423
Task_12761,1563,912,147,198,345,1.7119386637458927,35.37503306488176
Task_12762,1147,415,190,22,212,2.7572115384615383,25.817878720661337
Task_12763,2181,88,152,87,239,24.50561797752809,41.13823990436875
Task_12764,636,738,151,71,222,0.8606224627875507,19.198373631019617
Task_12765,2874,240,110,114,224,11.925311203319502,53.288566895796976
Task_12766,2048,494,63,113,176,4.137373737373737,40.91322003336645
Task_12767,2007,495,12,180,192,4.046370967741935,40.36041280579449
Task_12768,1551,729,29,68,97,2.1246575342465754,32.71366531277562
Task_12769,2094,782,98,127,225,2.6743295019157087,42.75594624473436
Task_12770,2556,877,69,57,126,2.9111617312072893,49.435626569367834
Task_12771,2741,404,168,147,315,6.767901234567901,52.22290813223268
Task_12772,1354,958,79,156,235,1.4118873826903025,31.67244724833075
Task_12773,1557,252,25,79,104,6.154150197628459,31.52868596146195
Task_12774,2198,981,167,29,196,2.2382892057026478,44.240527592551985
Task_12775,1647,778,20,124,144,2.1142490372272142,35.07936823712806
Task_12776,1106,649,14,112,126,1.7015384615384614,26.05757661363356
Task_12777,890,710,103,97,200,1.2517580872011251,23.261186659418673
Task_12778,2842,221,76,32,108,12.801801801801801,51.20455679087643
Task_12779,532,309,70,70,140,1.7161290322580645,15.774013925516181
Task_12780,1232,380,70,191,261,3.2335958005249346,28.161382141043873
Task_12781,1229,524,173,94,267,2.340952380952381,28.376480410134175
Task_12782,2235,98,90,115,205,22.575757575757574,42.0451463137533
Task_12783,1055,496,119,34,153,2.1227364185110664,24.286420981161537
Task_12784,1500,821,120,37,157,1.8248175182481752,32.40566267457644
Task_12785,2206,814,179,97,276,2.7067484662576686,44.84051120566835
Task_12786,1383,112,75,189,264,12.238938053097344,29.277450905116893
Task_12787,1002,855,79,53,132,1.1705607476635513,24.845001658945908
Task_12788,1327,262,79,60,139,5.0456273764258555,28.08163134291071
Task_12789,2146,573,81,142,223,3.7386759581881535,42.98332345185594
Task_12790,2800,756,128,93,221,3.6988110964332894,53.77043983333149
Task_12791,2566,817,113,174,287,3.136919315403423,50.687626589243415
Task_12792,2991,1022,44,61,105,2.9237536656891496,56.363064088763515
Task_12793,620,694,188,156,344,0.8920863309352518,19.679446150052097
Task_12794,2786,568,30,176,206,4.896309314586995,53.02501787752138
Task_12795,2399,707,42,141,183,3.388418079096045,47.15804517452849
Task_12796,1628,93,90,149,239,17.319148936170212,32.7023411078272
Task_12797,1265,164,35,100,135,7.666666666666667,26.579670132465893
Task_12798,2276,1019,105,34,139,2.231372549019608,45.183084218573185
Task_12799,1979,917,140,44,184,2.155773420479303,40.506318761757306
Task_12800,2084,665,107,109,216,3.129129129129129,42.15914197421476
Task_12801,1518,828,52,44,96,1.8311218335343789,32.06171787854781
Task_12802,1915,906,21,40,61,2.11135611907387,38.19171783076192
Task_12803,593,232,172,166,338,2.5450643776824036,17.81869998959751
Task_12804,1471,800,13,111,124,1.83645443196005,32.233022882170054
Task_12805,2208,153,129,50,179,14.337662337662337,41.37744378673164
Task_12806,875,808,11,119,130,1.0815822002472189,22.82050407633896
Task_12807,1939,467,68,70,138,4.1431623931623935,38.539016582380306
Task_12808,2553,209,92,97,189,12.157142857142857,47.95758574490523
Task_12809,1143,79,48,172,220,14.2875,25.00599607259471
Task_12810,2628,566,146,164,310,4.634920634920635,50.964602859438706
Task_12811,1656,132,182,13,195,12.451127819548873,32.53455912961177
Task_12812,1765,781,24,167,191,2.2570332480818416,37.42919826487215
Task_12813,1090,790,188,13,201,1.3780025284450064,25.984766647714647
Task_12814,2137,357,80,94,174,5.9692737430167595,41.821266045079426
Task_12815,1820,704,182,155,337,2.5815602836879434,38.71271961978665
Task_12816,2011,825,171,107,278,2.4346246973365617,41.780669947660876
Task_12817,1338,509,104,155,259,2.623529411764706,30.114941865349625
Task_12818,2697,962,129,159,288,2.8006230529595015,53.19940103316717
Task_12819,2170,507,154,11,165,4.271653543307087,42.085926804442714
Task_12820,1541,156,148,149,297,9.815286624203821,32.12102375123652
Task_12821,738,936,82,44,126,0.7876200640341515,20.585766407050624
Task_12822,1896,108,176,29,205,17.394495412844037,36.19995852302838
Task_12823,1614,299,22,126,148,5.38,33.05435519674864
Task_12824,1550,584,90,140,230,2.6495726495726495,33.54974702110222
Task_12825,1369,284,96,36,132,4.803508771929825,28.507810340789735
Task_12826,2415,739,185,118,303,3.2635135135135136,48.040493744816104
Task_12827,2310,961,127,79,206,2.401247401247401,46.47466331787484
Task_12828,1310,783,167,132,299,1.6709183673469388,30.6615922382047
Task_12829,780,610,193,181,374,1.2765957446808511,22.090617724184295
Task_12830,2158,467,174,57,231,4.611111111111111,42.37965482806522
Task_12831,2322,451,67,79,146,5.1371681415929205,44.81306414206701
Task_12832,954,1010,178,134,312,0.9436201780415431,25.778857029357038
Task_12833,1905,425,13,25,38,4.471830985915493,36.28833567538105
Task_12834,1899,398,58,105,163,4.7593984962406015,38.14346348651864
Task_12835,1678,296,120,154,274,5.64983164983165,34.87170943308191
Task_12836,750,564,60,109,169,1.3274336283185841,20.470693233090255
Task_12837,1128,658,146,13,159,1.7116843702579667,25.901101739028775
Task_12838,2458,865,127,192,319,2.838337182448037,49.29738133598162
Task_12839,2843,129,96,187,283,21.869230769230768,52.437169953821915
Task_12840,1969,181,29,181,210,10.81868131868132,38.52672810886434
Task_12841,1108,903,172,39,211,1.2256637168141593,26.815098936779563
Task_12842,2092,858,183,16,199,2.4353899883585566,42.09171052009543
Task_12843,2884,75,111,128,239,37.94736842105263,52.2422275239985
Task_12844,692,645,19,69,88,1.0712074303405572,18.773882015892962
Task_12845,1313,365,197,109,306,3.587431693989071,29.404734729825787
Task_12846,1118,653,171,48,219,1.709480122324159,26.24693300492459
Task_12847,882,956,25,77,102,0.9216300940438872,22.97821819960949
Task_12848,2149,730,33,169,202,2.9398084815321477,43.42428190894438
Task_12849,2877,881,90,151,241,3.261904761904762,55.569111312266756
Task_12850,1937,858,195,43,238,2.2549476135040747,39.9253851536597
Task_12851,2879,564,62,111,173,5.0955752212389385,54.27267021274719
Task_12852,1941,818,32,103,135,2.36996336996337,39.79852831506965
Task_12853,733,454,87,37,124,1.610989010989011,18.825368789811453
Task_12854,1481,855,197,98,295,1.730140186915888,33.53427822196002
Task_12855,2854,183,61,53,114,15.51086956521739,51.57666445516282
Task_12856,1754,602,92,12,104,2.9087893864013266,35.21206240393312
Task_12857,2181,1006,71,186,257,2.16583912611718,45.119327357359964
Task_12858,1766,112,77,48,125,15.628318584070797,33.57759325523891
Task_12859,2065,704,140,94,234,2.9290780141843973,42.033343092407954
Task_12860,894,407,139,62,201,2.1911764705882355,22.047348143945843
Task_12861,2249,890,32,145,177,2.5241301907968574,45.330298882127174
Task_12862,562,114,46,15,61,4.886956521739131,13.86239215668225
Task_12863,2777,111,48,102,150,24.794642857142858,50.032816104389006
Task_12864,1242,264,39,50,89,4.686792452830189,26.048077561570526
Task_12865,2575,437,85,151,236,5.878995433789954,49.36100012740982
Task_12866,2862,172,115,84,199,16.54335260115607,52.349113107421566
Task_12867,1122,819,171,60,231,1.3682926829268294,27.064871872917937
Task_12868,1996,110,25,56,81,17.98198198198198,36.955391916821334
Task_12869,1675,913,182,51,233,1.8326039387308535,36.13203297661885
Task_12870,2656,311,84,165,249,8.512820512820513,50.29988180591854
Task_12871,2699,922,22,28,50,2.924160346695558,50.608298770939
Task_12872,1787,349,125,79,204,5.105714285714286,36.244673372831606
Task_12873,786,960,61,111,172,0.81789802289282,22.28438078325027
Task_12874,716,151,196,139,335,4.7105263157894735,19.254446917323097
Task_12875,618,710,38,163,201,0.869198312236287,19.00474537831532
Task_12876,1995,563,89,188,277,3.5372340425531914,40.79694653519616
Task_12877,653,925,79,31,110,0.7051835853131749,19.193644275794057
Task_12878,2872,767,52,157,209,3.7395833333333335,55.073948811843174
Task_12879,2104,296,17,84,101,7.084175084175084,40.28562304629457
Task_12880,1405,335,193,35,228,4.181547619047619,29.794481677249987
Task_12881,981,758,142,173,315,1.2924901185770752,25.456304731660254
Task_12882,1988,895,49,153,202,2.21875,41.4554597379815
Task_12883,866,153,101,79,180,5.623376623376624,20.58993171936796
Task_12884,1015,856,131,182,313,1.1843640606767796,26.30438306371998
Task_12885,2892,258,71,194,265,11.166023166023166,54.00341404588755
Task_12886,632,679,166,82,248,0.9294117647058824,19.239487792498576
Task_12887,1338,551,151,79,230,2.4239130434782608,29.902933674908727
Task_12888,1613,572,85,61,146,2.8150087260034904,33.67413199221122
Task_12889,1121,713,150,140,290,1.5700280112044818,27.391705585051877
Task_12890,2644,801,30,163,193,3.2967581047381547,51.436615880893605
Task_12891,2024,80,167,52,219,24.987654320987655,38.156051283849365
Task_12892,2960,706,114,64,178,4.1867043847241865,55.62304257681941
Task_12893,1293,256,22,50,72,5.031128404669261,26.437087726371242
Task_12894,585,232,192,38,230,2.5107296137339055,16.52028620201541
Task_12895,1518,652,38,124,162,2.3246554364471668,32.81614818053786
Task_12896,2177,966,171,138,309,2.25129265770424,45.035574665864566
Task_12897,1480,150,141,49,190,9.801324503311259,30.004123332976903
Task_12898,2288,354,66,50,116,6.445070422535212,43.15214511006517
Task_12899,1960,611,28,103,131,3.2026143790849675,39.47539387996717
Task_12900,2713,499,87,103,190,5.426,51.421345784582265
Task_12901,953,578,183,32,215,1.6459412780656304,23.35159565047536
Task_12902,980,486,195,77,272,2.0123203285420943,24.153023784738494
Task_12903,976,471,86,33,119,2.0677966101694913,22.627257105804713
Task_12904,1417,397,114,15,129,3.5603015075376883,29.530401908546974
Task_12905,2758,308,83,28,111,8.925566343042071,50.225773923507695
Task_12906,2194,990,109,95,204,2.2139253279515643,44.85684415130828
Task_12907,1876,826,11,76,87,2.2684401451027814,38.106532534969624
Task_12908,2672,298,26,20,46,8.936454849498327,47.9843148705321
Task_12909,551,810,126,199,325,0.6794081381011098,19.037799115057258
Task_12910,1970,614,123,192,315,3.203252032520325,40.76064097197186
Task_12911,672,606,96,170,266,1.1070840197693574,19.843371993080382
Task_12912,2074,591,81,174,255,3.5033783783783785,42.09140119053223
Task_12913,1351,515,195,180,375,2.618217054263566,30.899161344154958
Task_12914,2017,540,58,145,203,3.7282809611829943,40.76647048829819
Task_12915,2164,93,51,171,222,23.02127659574468,41.123482221973795
Task_12916,1092,445,78,199,277,2.4484304932735426,26.231198995429406
Task_12917,2105,1012,177,151,328,2.0779861796643635,44.14234457920918
Task_12918,1368,1011,95,138,233,1.3517786561264822,31.96800699835789
Task_12919,1146,841,61,173,234,1.3610451306413303,28.03641452113909
Task_12920,2755,306,79,20,99,8.973941368078176,49.94592245354041
Task_12921,1741,377,123,158,281,4.605820105820106,36.174024759089484
Task_12922,2704,99,64,157,221,27.04,49.61903693502246
Task_12923,1041,345,76,35,111,3.008670520231214,23.209851369292007
Task_12924,2238,552,177,129,306,4.047016274864376,44.67498717410555
Task_12925,1615,743,167,182,349,2.170698924731183,35.6809260922481
Task_12926,2839,872,129,185,314,3.252004581901489,55.32331598352474
Task_12927,942,660,104,162,266,1.4251134644478063,24.304516452599476
Task_12928,2434,495,58,72,130,4.907258064516129,46.530471307195285
Task_12929,1008,645,180,169,349,1.5603715170278638,25.698662870095166
Task_12930,596,640,141,114,255,0.9297971918876755,18.67387374233824
Task_12931,921,181,131,162,293,5.06043956043956,22.418821210798757
Task_12932,865,777,109,46,155,1.1118251928020566,22.17183518657947
Task_12933,582,378,13,182,195,1.5356200527704484,17.42552981911452
Task_12934,1527,679,148,191,339,2.2455882352941177,34.055117710968
Task_12935,1557,826,185,44,229,1.882708585247884,33.758464884164965
Task_12936,526,745,174,73,247,0.7050938337801609,17.743620840498355
Task_12937,2976,603,66,143,209,4.927152317880795,56.18545684335364
Task_12938,2716,951,48,180,228,2.8529411764705883,53.28634857824093
Task_12939,2551,700,45,38,83,3.6390870185449358,48.02941445725158
Task_12940,1011,793,71,160,231,1.2732997481108312,25.694658413454878
Task_12941,908,585,193,187,380,1.5494880546075085,24.094136229914994
Task_12942,2134,284,55,188,243,7.487719298245614,42.019008289145006
Task_12943,1384,277,162,17,179,4.9784172661870505,28.939345777821018
Task_12944,2525,591,133,69,202,4.265202702702703,48.503107099074505
Task_12945,1997,752,108,56,164,2.652058432934927,40.45440073457823
Task_12946,753,764,191,141,332,0.984313725490196,21.927080347257842
Task_12947,1886,398,84,136,220,4.726817042606516,38.239502809414454
Task_12948,1608,673,80,24,104,2.3857566765578637,33.08579535687471
Task_12949,668,846,151,172,323,0.7886658795749705,20.86596891305724
Task_12950,1933,286,166,49,215,6.735191637630662,38.02799196442487
Task_12951,1165,862,113,158,271,1.3499420625724219,28.48798042674322
Task_12952,1205,135,85,20,105,8.860294117647058,24.656491088087037
Task_12953,1339,994,117,54,171,1.3457286432160804,30.74193099418234
Task_12954,1237,766,119,133,252,1.6127770534550196,29.241876665799982
Task_12955,2249,241,83,39,122,9.293388429752065,42.03817794742389
Task_12956,1398,154,118,168,286,9.019354838709678,29.83102561271474
Task_12957,769,130,61,144,205,5.870229007633588,19.39012552594839
Task_12958,1229,567,145,198,343,2.163732394366197,29.013141361560468
Task_12959,944,623,107,53,160,1.5128205128205128,23.244344933538923
Task_12960,898,886,156,76,232,1.012401352874859,23.83025127392625
Task_12961,1238,911,154,152,306,1.3574561403508771,29.945492679526453
Task_12962,1902,857,123,38,161,2.2167832167832167,38.929116946043415
Task_12963,1700,784,34,99,133,2.1656050955414012,35.920291461559806
Task_12964,683,466,190,42,232,1.462526766595289,18.814196172567062
Task_12965,2489,615,127,78,205,4.040584415584416,48.19747441175204
Task_12966,1259,299,83,198,281,4.196666666666666,28.38902041284982
Task_12967,1022,683,39,75,114,1.4941520467836258,24.56532741129213
Task_12968,2322,987,129,20,149,2.3502024291497974,45.86632467016452
Task_12969,1546,680,167,163,330,2.2701908957415564,34.27758970174988
Task_12970,1745,161,194,133,327,10.771604938271604,35.46104379867156
Task_12971,701,987,52,95,147,0.7095141700404858,20.922257225547288
Task_12972,2381,478,151,50,201,4.970772442588727,45.68287569688305
Task_12973,879,973,117,154,271,0.9024640657084189,24.32097088471296
Task_12974,2023,502,135,157,292,4.021868787276342,41.08906161843875
Task_12975,1925,936,162,62,224,2.054429028815368,40.13458623181591
Task_12976,2988,68,164,42,206,43.30434782608695,52.75164956931503
Task_12977,1523,600,54,141,195,2.534109816971714,33.091874553934176
Task_12978,2278,184,155,116,271,12.313513513513513,43.79364804453426
Task_12979,2513,287,100,23,123,8.725694444444445,46.369629704903076
Task_12980,2398,376,163,39,202,6.360742705570292,45.52351516247011
Task_12981,1577,705,28,156,184,2.23371104815864,34.134363648515
Task_12982,2573,712,144,17,161,3.608695652173913,48.9980829810805
Task_12983,859,974,188,49,237,0.8810256410256411,23.354989598696378
Task_12984,675,569,54,160,214,1.1842105263157894,19.611933955508714
Task_12985,1765,185,151,159,310,9.489247311827956,35.95160094513691
Task_12986,2453,224,182,191,373,10.902222222222223,47.36166802771309
Task_12987,1338,601,169,194,363,2.222591362126246,30.93009931006085
Task_12988,1821,509,79,133,212,3.570588235294118,37.57768341996725
Task_12989,951,175,30,53,83,5.403409090909091,21.065909322170864
Task_12990,1240,377,76,30,106,3.2804232804232805,26.39563256416994
Task_12991,2194,647,33,118,151,3.3858024691358026,43.36817224982386
Task_12992,2461,1009,86,152,238,2.4366336633663366,49.33071770439859
Task_12993,746,796,46,24,70,0.9360100376411543,19.46243865591859
Task_12994,2315,265,153,141,294,8.703007518796992,44.90397069575698
Task_12995,752,219,56,15,71,3.418181818181818,17.394613297247368
Task_12996,925,193,183,68,251,4.768041237113402,22.164287015354105
Task_12997,2176,436,150,191,341,4.979405034324943,43.56869800441141
Task_12998,784,622,62,39,101,1.2584269662921348,19.850678589547872
Task_12999,1924,734,98,142,240,2.617687074829932,40.002140436698454
Task_13000,1828,518,83,109,192,3.5221579961464355,37.567483714169796
Task_13001,997,781,123,155,278,1.274936061381074,25.587972797839793
Task_13002,2806,961,92,176,268,2.916839916839917,54.86597678216129
Task_13003,2348,594,139,175,314,3.946218487394958,46.65413521296392
Task_13004,2496,909,15,135,150,2.742857142857143,48.96775529347232
Task_13005,2146,407,200,61,261,5.259803921568627,42.11937142166938
Task_13006,1015,644,17,148,165,1.573643410852713,24.882066854419758
Task_13007,1150,582,57,126,183,1.9725557461406518,27.011107238346554
Task_13008,1329,555,53,177,230,2.3902877697841727,30.090909696938883
Task_13009,2414,238,126,108,234,10.100418410041842,46.050548179656964
Task_13010,1790,708,72,114,186,2.524682651622003,37.535959449993136
Task_13011,2160,544,62,165,227,3.963302752293578,43.17824294608862
Task_13012,1968,710,66,52,118,2.7679324894514767,39.38698626657709
Task_13013,1795,782,140,63,203,2.292464878671775,37.53929570042959
Task_13014,1331,991,186,92,278,1.341733870967742,31.401064654910908
Task_13015,1065,977,93,163,256,1.0889570552147239,27.208667087079505
Task_13016,826,952,185,33,218,0.8667366211962224,22.54695032772794
Task_13017,2684,1017,130,68,198,2.6365422396856584,52.349569084030605
Task_13018,1255,1015,18,183,201,1.235236220472441,30.062701808711086
Task_13019,2336,946,62,43,105,2.466737064413939,45.42613651657509
Task_13020,1884,768,150,93,243,2.4499349804941484,39.39586407615526
Task_13021,2273,168,27,25,52,13.449704142011834,41.39491389865082
Task_13022,709,244,72,27,99,2.8938775510204082,17.511658026502854
Task_13023,1929,679,32,54,86,2.836764705882353,38.294725726056576
Task_13024,1292,193,133,15,148,6.65979381443299,27.01873107236017
Task_13025,2369,429,182,89,271,5.5093023255813955,46.09275437677178
Task_13026,702,1001,68,168,236,0.7005988023952096,21.646216731161996
Task_13027,558,900,172,191,363,0.6193118756936737,19.6028756834899
Task_13028,668,924,176,108,284,0.7221621621621621,20.89710789495319
Task_13029,2016,298,30,177,207,6.74247491638796,39.95722207858225
Task_13030,2637,188,125,112,237,13.952380952380953,49.4249558838658
Task_13031,1072,314,158,17,175,3.403174603174603,24.11072509212377
Task_13032,1677,281,93,178,271,5.946808510638298,34.865166365802445
Task_13033,2078,484,49,163,212,4.284536082474227,41.64631086699247
Task_13034,1754,788,37,24,61,2.223067173637516,35.22853853182611
Task_13035,2224,805,24,88,112,2.759305210918114,44.027139390847715
Task_13036,714,457,151,52,203,1.5589519650655022,19.394453271720103
Task_13037,2199,542,100,32,132,4.0497237569060776,42.473442189716174
Task_13038,2482,958,111,114,225,2.5881126173096978,49.43003850375877
Task_13039,2371,152,17,126,143,15.49673202614379,43.96289345501617
Task_13040,1345,81,107,146,253,16.402439024390244,28.26271348140749
Task_13041,1804,909,44,199,243,1.9824175824175825,38.75630575224279
Task_13042,1407,207,196,171,367,6.764423076923077,30.72571328784646
Task_13043,2877,650,95,102,197,4.419354838709677,54.586278513361314
Task_13044,784,448,188,119,307,1.7461024498886415,21.303319922339004
Task_13045,546,906,177,45,222,0.6019845644983461,18.295347410575722
Task_13046,2307,574,190,10,200,4.012173913043478,44.613598810110226
Task_13047,2262,920,38,127,165,2.456026058631922,45.55424845244147
Task_13048,572,670,161,117,278,0.8524590163934426,18.487604888558067
Task_13049,2365,745,132,27,159,3.170241286863271,45.84189619954059
Task_13050,1524,796,158,50,208,1.9121706398996237,33.14617346803669
Task_13051,892,454,13,121,134,1.9604395604395604,22.048557465011374
Task_13052,2746,892,127,82,209,3.0750279955207165,53.21698547637178
Task_13053,1047,944,47,189,236,1.107936507936508,26.740520935278568
Task_13054,616,202,160,94,254,3.0344827586206895,17.592800227976184
Task_13055,2228,680,36,68,104,3.2716593245227608,43.414738303116316
Task_13056,1624,237,100,99,199,6.823529411764706,33.39056614575716
Task_13057,1490,444,45,46,91,3.348314606741573,30.46013862737007
Task_13058,1994,441,59,39,98,4.51131221719457,38.3456992678651
Task_13059,2923,522,75,198,273,5.588910133843212,55.441664665274395
Task_13060,2590,909,104,141,245,2.8461538461538463,51.11817952253919
Task_13061,2027,540,89,87,176,3.746765249537893,40.54496307525779
Task_13062,2064,975,155,52,207,2.1147540983606556,42.42735630656079
Task_13063,2814,352,121,179,300,7.971671388101983,53.1813178926036
Task_13064,2879,506,153,108,261,5.678500986193294,54.442265404790966
Task_13065,2024,852,38,68,106,2.372801875732708,40.741211611721134
Task_13066,2567,118,138,138,276,21.571428571428573,47.87142393304257
Task_13067,2085,1020,54,102,156,2.0421155729676785,42.88109486084239
Task_13068,810,804,34,62,96,1.0062111801242235,21.095392078324352
Task_13069,2617,825,185,85,270,3.168280871670702,51.23663012927404
Task_13070,2080,206,121,49,170,10.048309178743962,39.81635645091131
Task_13071,1630,610,197,178,375,2.6677577741407528,35.61332919824746
Task_13072,1026,1006,54,120,174,1.0188679245283019,26.22832740212515
Task_13073,2274,336,155,192,347,6.747774480712166,44.816372446968415
Task_13074,929,826,130,137,267,1.1233373639661426,24.556965579331997
Task_13075,1414,339,64,66,130,4.158823529411765,29.799870579738734
Task_13076,2054,117,60,130,190,17.406779661016948,39.41114134226114
Task_13077,2588,928,145,49,194,2.7857911733046286,50.36006925466421
Task_13078,1457,615,107,163,270,2.36525974025974,32.39397897627729
Task_13079,2863,530,82,152,234,5.391713747645951,54.251634812700246
Task_13080,1346,689,53,52,105,1.9507246376811593,29.235819935165356
Task_13081,959,386,51,21,72,2.4780361757105944,21.326264828176424
Task_13082,1910,814,115,22,137,2.3435582822085887,38.66934402868505
Task_13083,2558,485,113,125,238,5.2633744855967075,49.213525118544474
Task_13084,1615,196,107,48,155,8.197969543147208,32.22231473620201
Task_13085,569,306,168,129,297,1.8534201954397393,17.437437182476586
Task_13086,859,949,37,154,191,0.9042105263157895,23.50709714800003
Task_13087,792,156,44,52,96,5.044585987261146,18.507581089921562
Task_13088,1037,749,21,107,128,1.3826666666666667,25.351456844678967
Task_13089,1824,664,86,72,158,2.742857142857143,37.33566647870171
Task_13090,2936,410,81,152,233,7.143552311435523,55.01973929474703
Task_13091,2244,677,83,50,133,3.309734513274336,43.752231655929755
Task_13092,1243,739,61,56,117,1.6797297297297298,27.907966491550898
Task_13093,650,752,51,32,83,0.8632138114209827,18.19639361323415
Task_13094,2801,378,179,167,346,7.3905013192612135,53.2539476740871
Task_13095,2322,335,160,42,202,6.910714285714286,44.18707751232767
Task_13096,608,113,198,160,358,5.333333333333333,17.391286229841842
Task_13097,2850,389,107,94,201,7.3076923076923075,53.299185265461496
Task_13098,627,153,149,52,201,4.071428571428571,16.846867847678723
Task_13099,1476,902,158,37,195,1.6345514950166113,32.567951871523555
Task_13100,1760,523,16,74,90,3.3587786259541983,35.37908778299629
Task_13101,2355,902,152,175,327,2.60797342192691,47.792070060208424
Task_13102,1024,555,96,193,289,1.841726618705036,25.486420282590455
Task_13103,984,703,58,184,242,1.3977272727272727,25.101604424167675
Task_13104,855,504,167,93,260,1.693069306930693,22.33626739869599
Task_13105,2620,639,47,180,227,4.09375,50.76024349564261
Task_13106,1127,160,149,101,250,7.0,25.32888581950748
Task_13107,2511,200,27,51,78,12.492537313432836,45.62647782239148
Task_13108,2496,69,159,139,298,35.65714285714286,46.43753499054938
Task_13109,1492,196,120,176,296,7.573604060913706,31.730810405582673
Task_13110,2368,793,163,191,354,2.982367758186398,47.80231435940877
Task_13111,2486,769,152,83,235,3.2285714285714286,48.82986512198696
Task_13112,2887,493,129,31,160,5.84412955465587,53.34394854726662
Task_13113,1284,187,119,140,259,6.829787234042553,28.20799160052161
Task_13114,1593,981,48,88,136,1.6221995926680244,34.85736202712912
Task_13115,1065,371,75,29,104,2.8629032258064515,23.612824357330236
Task_13116,2549,431,158,73,231,5.900462962962963,48.557024716455736
Task_13117,1897,938,77,39,116,2.020234291799787,38.66423462791574
Task_13118,1041,848,139,180,319,1.226148409893993,26.710900799897278
Task_13119,1730,201,78,181,259,8.564356435643564,35.39743603146751
Task_13120,1229,949,73,193,266,1.2936842105263158,29.838311429761518
Task_13121,1196,103,200,165,365,11.5,26.608331956687636
Task_13122,2894,344,160,68,228,8.388405797101449,53.65563601188342
Task_13123,1295,180,70,182,252,7.154696132596685,28.176749551370918
Task_13124,1339,816,134,81,215,1.6389228886168912,30.670193143088863
Task_13125,539,804,19,81,100,0.6695652173913044,17.272356781777813
Task_13126,2851,431,118,97,215,6.599537037037037,53.55788702886176
Task_13127,1359,993,81,118,199,1.3672032193158954,31.62457003705356
Task_13128,2488,430,90,157,247,5.77262180974478,48.007780067419766
Task_13129,2123,863,109,117,226,2.457175925925926,43.45410337430716
Task_13130,994,723,49,162,211,1.37292817679558,25.171334206513876
Task_13131,1012,443,79,10,89,2.279279279279279,22.79237535339693
Task_13132,1013,987,125,100,225,1.0253036437246963,26.16091089665335
Task_13133,1019,902,142,200,342,1.1284606866002216,26.648648969324782
Task_13134,1866,466,173,160,333,3.9957173447537473,38.677489935854474
Task_13135,1786,81,16,16,32,21.78048780487805,32.40188698575573
Task_13136,2074,529,44,54,98,3.913207547169811,40.21323116032951
Task_13137,1138,655,114,74,188,1.7347560975609757,26.758335356364586
Task_13138,2029,156,165,182,347,12.92356687898089,40.0868461140904
Task_13139,2175,728,87,76,163,2.983539094650206,43.29888280950241
Task_13140,638,305,194,175,369,2.084967320261438,18.917187562676578
Task_13141,2935,450,163,137,300,6.507760532150776,55.36358671240305
Task_13142,2039,806,54,79,133,2.526641883519207,41.41317199174163
Task_13143,2744,215,33,188,221,12.703703703703704,51.238541317653436
Task_13144,1516,261,17,179,196,5.786259541984733,31.83545584870966
Task_13145,2108,176,92,178,270,11.909604519774012,41.01180172961287
Task_13146,1080,604,155,23,178,1.7851239669421488,25.207806875996866
Task_13147,1611,741,20,125,145,2.1711590296495955,34.41352939867421
Task_13148,2219,215,47,162,209,10.273148148148149,42.89048274962661
Task_13149,2132,805,110,197,307,2.6451612903225805,43.89787772137071
Task_13150,1244,656,137,132,269,1.8934550989345509,29.098779682033637
Task_13151,1337,515,53,106,159,2.5910852713178296,29.47008927104312
Task_13152,1310,451,40,192,232,2.898230088495575,29.430508094480313
Task_13153,2323,507,98,91,189,4.572834645669292,45.243865661539644
Task_13154,2126,147,82,61,143,14.364864864864865,39.96185940835255
Task_13155,2011,272,83,137,220,7.366300366300366,39.820533117378076
Task_13156,1034,866,110,191,301,1.1926182237600922,26.595508399962302
Task_13157,1834,854,48,132,180,2.1450292397660817,38.69571684791109
Task_13158,2776,529,177,162,339,5.2377358490566035,53.31678419998182
Task_13159,1580,93,51,133,184,16.80851063829787,31.679002559720885
Task_13160,1863,374,155,49,204,4.968,37.166481966352045
Task_13161,1248,601,176,24,200,2.0730897009966776,27.96480709384855
Task_13162,1689,170,130,46,176,9.87719298245614,33.2313181856165
Task_13163,667,298,24,54,78,2.230769230769231,16.863742102649802
Task_13164,2791,645,49,97,146,4.320433436532507,52.941079270841925
Task_13165,2155,113,101,44,145,18.903508771929825,39.805433642949865
Task_13166,1790,281,63,153,216,6.347517730496454,36.39547127110892
Task_13167,2966,419,183,190,373,7.061904761904762,56.157977948998735
Task_13168,2478,168,184,121,305,14.662721893491124,46.9272003752716
Task_13169,1412,171,173,156,329,8.209302325581396,30.28174485837077
Task_13170,1193,907,94,146,240,1.3138766519823788,28.916050174458164
Task_13171,963,464,179,74,253,2.0709677419354837,23.71255309482847
Task_13172,2588,723,190,76,266,3.574585635359116,50.330676604525
Task_13173,2970,657,167,38,205,4.513677811550152,55.51584514599284
Task_13174,1658,237,132,65,197,6.966386554621849,33.61303635303221
Task_13175,522,468,88,78,166,1.1130063965884862,16.30511935059354
Task_13176,925,475,20,35,55,1.9432773109243697,21.155070395806536
Task_13177,1419,222,120,82,202,6.36322869955157,30.02322549441089
Task_13178,2985,187,146,63,209,15.877659574468085,54.485043701139325
Task_13179,1637,594,189,27,216,2.7512605042016807,34.208352025904695
Task_13180,708,250,181,22,203,2.8207171314741037,18.305111696711105
Task_13181,2701,692,73,69,142,3.8975468975468974,51.33406798851852
Task_13182,2810,790,175,26,201,3.552465233881163,53.33648237448358
Task_13183,1371,751,27,191,218,1.8231382978723405,31.253273840408852
Task_13184,1076,427,11,163,174,2.514018691588785,25.275206214402914
Task_13185,1095,921,151,15,166,1.1876355748373102,26.34137238785063
Task_13186,2559,241,176,48,224,10.574380165289256,47.73354619386577
Task_13187,1270,242,98,170,268,5.226337448559671,28.240945077890867
Task_13188,2709,79,57,31,88,33.8625,47.4857705008258
Task_13189,2947,615,179,93,272,4.784090909090909,55.881404396633116
Task_13190,1472,936,44,164,208,1.5709711846318035,33.33120473313888
Task_13191,2795,776,160,157,317,3.597168597168597,54.29715397974595
Task_13192,1091,174,148,187,335,6.234285714285714,25.275639292575985
Task_13193,1248,1008,14,168,182,1.2368681863230921,29.79526144749371
Task_13194,1980,290,186,172,358,6.804123711340206,40.03062002155738
Task_13195,546,725,88,143,231,0.7520661157024794,18.034163734804896
Task_13196,1347,661,161,51,212,2.0347432024169185,30.056203444371743
Task_13197,1512,248,10,95,105,6.072289156626506,30.83021479018231
Task_13198,874,716,65,180,245,1.2189679218967922,23.384438615102102
Task_13199,1815,101,92,30,122,17.794117647058822,34.3460486159563
Task_13200,2185,484,123,97,220,4.505154639175258,43.21178910926448
Task_13201,583,789,96,81,177,0.7379746835443038,18.434204201351218
Task_13202,1990,953,11,58,69,2.0859538784067087,39.74131734605606
Task_13203,2267,760,97,199,296,2.978975032851511,45.85674948967477
Task_13204,2814,147,120,101,221,19.013513513513512,51.732500674337416
Task_13205,1309,119,144,48,192,10.908333333333333,27.010183422273656
Task_13206,2394,682,179,165,344,3.505124450951684,47.78195872712892
Task_13207,1259,609,107,154,261,2.0639344262295083,29.185685007432255
Task_13208,2958,413,88,27,115,7.144927536231884,53.77608104898488
Task_13209,2220,425,126,168,294,5.211267605633803,43.98363184423971
Task_13210,2797,83,11,135,146,33.29761904761905,50.092676731749634
Task_13211,1615,89,157,191,348,17.944444444444443,33.049482134778124
Task_13212,2272,105,20,172,192,21.433962264150942,42.70721388040678
Task_13213,2636,962,179,104,283,2.7372793354101765,52.12960949025319
Task_13214,1633,460,156,187,343,3.542299349240781,35.05480018199015
Task_13215,2348,903,170,181,351,2.5973451327433628,47.801238416611056
Task_13216,1793,971,94,129,223,1.8446502057613168,38.575548050103485
Task_13217,2355,634,75,45,120,3.7086614173228347,44.96244096663053
Task_13218,1081,257,35,194,229,4.189922480620155,25.174700713937654
Task_13219,1667,277,123,28,151,5.996402877697841,33.27022634839171
Task_13220,1242,83,31,97,128,14.785714285714286,25.701277755365243
Task_13221,1339,329,54,91,145,4.057575757575758,28.85433939037608
Task_13222,1944,264,146,64,210,7.335849056603774,38.26895467830632
Task_13223,1264,572,91,199,290,2.2059336823734728,29.34498755823553
Task_13224,2317,396,43,121,164,5.836272040302267,44.737750643205196
Task_13225,1049,866,128,133,261,1.209919261822376,26.563109203406928
Task_13226,664,664,179,137,316,0.9984962406015038,20.10906577089217
Task_13227,1675,1010,37,50,87,1.6567754698318498,35.254890299345185
Task_13228,1769,260,169,113,282,6.777777777777778,36.16270178818592
Task_13229,2852,282,135,198,333,10.07773851590106,53.71224907150349
Task_13230,2892,978,126,171,297,2.9540347293156284,56.39758755005338
Task_13231,2260,947,63,61,124,2.3839662447257384,44.79523996863512
Task_13232,1923,495,32,23,55,3.877016129032258,36.97585830717147
Task_13233,2642,861,144,135,279,3.0649651972157774,51.93642266563876
Task_13234,1889,898,91,36,127,2.1012235817575085,38.61590412365357
Task_13235,583,132,52,43,95,4.383458646616542,14.718653757264377
Task_13236,2429,793,159,121,280,3.05919395465995,48.33259804538712
Task_13237,2112,618,59,102,161,3.4119547657512115,42.09836853797002
Task_13238,1169,608,98,81,179,1.9195402298850575,27.15953831776287
Task_13239,2227,92,174,122,296,23.946236559139784,42.32692847576724
Task_13240,879,110,75,75,150,7.918918918918919,20.11344638852195
Task_13241,799,750,97,61,158,1.0639147802929427,21.276186804646567
Task_13242,2183,151,136,40,176,14.361842105263158,40.91023071854527
Task_13243,816,127,187,121,308,6.375,20.510745855127762
Task_13244,1141,711,186,57,243,1.6025280898876404,27.10390566378402
Task_13245,1859,177,38,120,158,10.4438202247191,36.11765086069797
Task_13246,1433,105,128,91,219,13.518867924528301,29.44754868444733
Task_13247,1805,783,44,94,138,2.302295918367347,37.60588889087363
Task_13248,1974,876,166,106,272,2.250855188141391,41.32497954847726
Task_13249,681,364,23,187,210,1.8657534246575342,19.072610116047105
Task_13250,2813,368,107,165,272,7.623306233062331,53.073426465141004
Task_13251,2304,616,69,111,180,3.73419773095624,45.37605735039216
Task_13252,2306,715,167,16,183,3.2206703910614527,44.9430969803272
Task_13253,1806,985,15,76,91,1.8316430020283976,37.56912116960897
Task_13254,2099,955,154,143,297,2.1956066945606696,43.718570101884474
Task_13255,2973,651,91,155,246,4.559815950920245,56.39755335659407
Task_13256,753,431,105,167,272,1.7430555555555556,20.671955379333667
Task_13257,751,779,117,19,136,0.9628205128205128,20.316376854449384
Task_13258,1836,191,77,155,232,9.5625,36.85893231124299
Task_13259,1778,816,25,92,117,2.17625458996328,37.0290408159624
Task_13260,745,71,90,40,130,10.347222222222221,17.016728326816544
Task_13261,1203,730,129,138,267,1.6456908344733243,28.666244083993586
Task_13262,1079,879,10,159,169,1.2261363636363636,26.61238705154271
Task_13263,650,975,64,70,134,0.6659836065573771,19.890551110649984
Task_13264,1316,256,25,100,125,5.120622568093385,28.088358735906677
Task_13265,1703,581,155,33,188,2.9261168384879723,35.10050338233312
Task_13266,733,406,110,78,188,1.800982800982801,19.637108039714786
Task_13267,2312,891,194,165,359,2.591928251121076,47.20596085632627
Task_13268,2475,406,182,50,232,6.081081081081081,47.074782832703846
Task_13269,2258,236,95,51,146,9.527426160337553,42.73740345642392
Task_13270,1440,141,149,107,256,10.140845070422536,30.185029510401122
Task_13271,815,682,128,21,149,1.1932650073206441,21.057164414084564
Task_13272,2672,176,106,80,186,15.096045197740112,49.216973181817956
Task_13273,2521,882,80,189,269,2.855039637599094,50.172306755945364
Task_13274,2247,926,14,60,74,2.423948220064725,43.761951571878065
Task_13275,609,497,121,190,311,1.2228915662650603,18.757359762593484
Task_13276,2284,766,46,93,139,2.9778357235984356,45.15924692824793
Task_13277,1960,983,145,156,301,1.991869918699187,41.640049580712976
Task_13278,2029,579,58,168,226,3.4982758620689656,41.2177651879171
Task_13279,2599,244,16,119,135,10.608163265306123,48.33923320207477
Task_13280,664,604,28,104,132,1.0975206611570247,18.876292441055355
Task_13281,1172,355,12,183,195,3.292134831460674,26.714231264680834
Task_13282,1893,941,135,164,299,2.0095541401273884,40.45051025701999
Task_13283,2063,920,187,68,255,2.239956568946797,42.46361730898973
Task_13284,627,216,117,99,216,2.889400921658986,17.649359313969843
Task_13285,2264,498,141,118,259,4.537074148296593,44.68567308586935
Task_13286,521,938,190,36,226,0.5548455804046858,17.95934436952379
Task_13287,1907,117,144,35,179,16.161016949152543,36.290559957442
Task_13288,2970,668,27,107,134,4.439461883408072,55.62340130427021
Task_13289,2425,676,77,118,195,3.5819793205317576,47.580535122511264
Task_13290,686,167,111,170,281,4.083333333333333,18.620231272834925
Task_13291,1057,995,142,153,295,1.0612449799196788,27.27609775340505
Task_13292,2347,782,13,166,179,2.9974457215836527,46.56363479509235
Task_13293,1159,193,193,143,336,5.974226804123711,26.575681957008513
Task_13294,1417,510,180,147,327,2.7729941291585125,31.66357640070653
Task_13295,1540,115,119,140,259,13.275862068965518,31.58923033191427
Task_13296,2157,900,163,182,345,2.3940066592674807,44.73984757954687
Task_13297,2787,816,10,102,112,3.4112607099143206,52.96748340753254
Task_13298,1530,109,166,139,305,13.909090909090908,31.574455069285335
Task_13299,1516,826,36,15,51,1.8331318016928657,31.449587629800792
Task_13300,2201,149,28,72,100,14.673333333333334,40.73083511705176
Task_13301,2135,574,118,161,279,3.7130434782608694,43.03925736883203
Task_13302,1486,147,145,16,161,10.04054054054054,29.640016615237254
Task_13303,2813,536,52,135,187,5.238361266294227,53.259091263085985
Task_13304,1810,84,16,114,130,21.294117647058822,34.5039741049282
Task_13305,2600,234,113,190,303,11.063829787234043,49.40474488447163
Task_13306,1830,928,10,17,27,1.969860064585576,36.510597315343816
Task_13307,2728,632,98,64,162,4.309636650868878,51.59332052460436
Task_13308,2202,939,122,69,191,2.342553191489362,44.428409566518205
Task_13309,1979,248,172,53,225,7.947791164658635,38.8417957121626
Task_13310,2641,308,27,49,76,8.546925566343042,47.87557620057047
Task_13311,1174,314,46,46,92,3.726984126984127,25.05391649914832
Task_13312,723,936,23,53,76,0.7716115261472786,19.75164412261198
Task_13313,2721,379,172,127,299,7.160526315789474,51.72115410422955
Task_13314,2263,665,177,42,219,3.3978978978978978,44.39799485915094
Task_13315,2897,340,153,159,312,8.495601173020528,54.47754057861929
Task_13316,793,878,87,199,286,0.9021615472127418,22.709596030030784
Task_13317,2012,862,167,52,219,2.331402085747393,41.30564194289367
Task_13318,2252,659,118,175,293,3.412121212121212,45.24497297073577
Task_13319,848,829,173,79,252,1.0216867469879518,23.056836961830964
Task_13320,2663,347,99,85,184,7.652298850574713,50.00168765548947
Task_13321,873,408,143,98,241,2.1344743276283618,22.27867246126051
Task_13322,1771,322,107,95,202,5.4829721362229105,36.032018102323626
Task_13323,2975,927,95,117,212,3.2058189655172415,57.10142632378062
Task_13324,1323,665,118,123,241,1.9864864864864864,30.238761902948454
Task_13325,2656,759,145,190,335,3.4947368421052634,52.17106085524805
Task_13326,923,220,35,103,138,4.176470588235294,21.812942830693427
Task_13327,962,124,166,173,339,7.696,22.99589896773573
Task_13328,1685,828,184,158,342,2.0325693606755126,36.988175752723286
Task_13329,2607,449,199,101,300,5.793333333333333,50.1159979591154
Task_13330,1222,469,50,78,128,2.6,27.548705724002726
Task_13331,727,639,192,41,233,1.1359375,20.05994759338309
Task_13332,2339,423,95,25,120,5.5165094339622645,44.02736570076039
Task_13333,1412,359,143,193,336,3.922222222222222,31.209772932783206
Task_13334,2686,183,38,32,70,14.597826086956522,48.1515035063442
Task_13335,680,411,50,151,201,1.6504854368932038,19.208640727722063
Task_13336,535,118,170,183,353,4.495798319327731,16.32012847088755
Task_13337,1883,98,74,61,135,19.02020202020202,35.5047624534806
Task_13338,776,384,72,200,272,2.0155844155844154,21.00970695515289
Task_13339,2559,424,77,87,164,6.021176470588236,48.675864190810245
Task_13340,2203,279,137,97,234,7.867857142857143,42.87700981990296
Task_13341,1687,864,199,70,269,1.9502890173410405,36.39616979611866
Task_13342,2647,346,90,24,114,7.628242074927954,48.626629452557694
Task_13343,850,753,23,182,205,1.1273209549071619,22.838015293737953
Task_13344,2105,82,91,152,243,25.36144578313253,40.140701679350315
Task_13345,1296,181,82,45,127,7.1208791208791204,26.675086993306383
Task_13346,938,956,66,27,93,0.9801462904911181,23.509310066614358
Task_13347,600,195,105,74,179,3.061224489795918,16.769240318689807
Task_13348,513,751,106,139,245,0.6821808510638298,17.80500029557237
Task_13349,2537,1021,84,98,182,2.4823874755381605,50.261500606044365
Task_13350,2072,400,80,118,198,5.167082294264339,41.10708045824482
Task_13351,2145,95,81,19,100,22.34375,38.922821903854114
Task_13352,1448,906,114,124,238,1.5964718853362734,32.943446998673004
Task_13353,1934,773,129,104,233,2.498708010335917,40.19108928257419
Task_13354,2297,885,103,42,145,2.5925507900677203,45.206046044188376
Task_13355,2539,832,196,59,255,3.0480192076830734,49.67092900084949
Task_13356,1365,797,112,123,235,1.7105263157894737,31.27483181901236
Task_13357,1747,539,192,180,372,3.2351851851851854,37.231394486691954
Task_13358,918,868,173,161,334,1.0563866513233602,24.8681716393699
Task_13359,2219,903,104,182,286,2.454646017699115,45.4656940885107
Task_13360,886,129,190,131,321,6.815384615384615,21.706083940396137
Task_13361,2842,451,12,97,109,6.287610619469026,52.64337723930146
Task_13362,1472,320,109,17,126,4.585669781931464,30.090983297529068
Task_13363,1705,376,118,13,131,4.522546419098143,34.019359883470045
Task_13364,899,902,98,172,270,0.9955703211517165,24.41703830824066
Task_13365,2329,898,51,182,233,2.590656284760845,47.05238094857534
Task_13366,2795,357,92,98,190,7.807262569832402,52.29357467105575
Task_13367,1847,525,181,31,212,3.511406844106464,37.32904628434455
Task_13368,655,461,169,40,209,1.4177489177489178,18.246604042780298
Task_13369,2633,931,141,17,158,2.825107296137339,50.599603928556434
Task_13370,725,843,16,108,124,0.8590047393364929,20.522638384526086
Task_13371,2423,450,96,141,237,5.37250554323725,46.98933347494327
Task_13372,1683,845,132,71,203,1.9893617021276595,36.01325487281573
Task_13373,2372,985,196,127,323,2.4056795131845843,48.2317917969641
Task_13374,2386,888,151,61,212,2.683914510686164,47.22543022985286
Task_13375,2603,278,52,61,113,9.329749103942651,48.037025619643146
Task_13376,2635,701,74,20,94,3.7535612535612537,49.38070459134395
Task_13377,736,612,148,112,260,1.200652528548124,20.786519951522475
Task_13378,1298,828,132,48,180,1.5657418576598312,29.46928229514855
Task_13379,597,570,144,79,223,1.0455341506129596,18.155350868080113
Task_13380,1406,411,161,10,171,3.412621359223301,29.651857549007318
Task_13381,778,604,58,98,156,1.2859504132231405,20.814496860798883
Task_13382,2789,422,180,32,212,6.59338061465721,51.90794972865934
Task_13383,996,136,63,133,196,7.2700729927007295,22.942450169568655
Task_13384,2134,786,30,89,119,2.7115628970775094,42.60191900281652
Task_13385,745,221,137,170,307,3.355855855855856,20.049390583709286
Task_13386,2906,382,188,186,374,7.587467362924282,55.08278929463415
Task_13387,2074,283,65,145,210,7.302816901408451,40.855468328562225
Task_13388,896,663,144,87,231,1.3493975903614457,23.26722146795366
Task_13389,1390,413,83,25,108,3.357487922705314,28.87467896577731
Task_13390,2820,555,187,109,296,5.071942446043166,53.82582130642669
Task_13391,1653,360,55,49,104,4.578947368421052,32.86062413973938
Task_13392,2753,244,161,53,214,11.236734693877551,51.00591903825571
Task_13393,921,258,37,165,202,3.555984555984556,22.495181982138757
Task_13394,1944,487,50,95,145,3.9836065573770494,39.011704999381244
Task_13395,1232,935,85,65,150,1.3162393162393162,28.73692115767317
Task_13396,1435,310,72,199,271,4.614147909967846,31.188805625216272
Task_13397,2976,324,114,68,182,9.156923076923077,54.640137038787174
Task_13398,1735,79,142,23,165,21.6875,33.06412256049138
Task_13399,1981,673,182,103,285,2.9391691394658754,40.85506294066513
Task_13400,1802,800,184,121,305,2.2496878901373285,38.53358982873757
Task_13401,1815,927,46,86,132,1.9558189655172413,38.2251642728502
Task_13402,888,192,125,137,262,4.601036269430052,21.957041264236608
Task_13403,2351,216,155,71,226,10.834101382488479,44.63954514471283
Task_13404,1413,215,62,130,192,6.541666666666667,30.067285450885763
Task_13405,2609,385,42,165,207,6.759067357512953,49.627009143195075
Task_13406,1422,725,58,113,171,1.9586776859504131,31.675583451831923
Task_13407,843,791,75,186,261,1.0643939393939394,23.16721642824477
Task_13408,1296,606,157,191,348,2.1350906095551894,30.208614005555223
Task_13409,1014,434,86,141,227,2.331034482758621,24.54487195816581
Task_13410,1366,924,170,176,346,1.4767567567567568,32.22252114555689
Task_13411,1225,911,168,149,317,1.343201754385965,29.784681106568623
Task_13412,2286,916,154,136,290,2.4929116684841874,46.518474926877495
Task_13413,2418,484,18,195,213,4.985567010309278,46.96831467943873
Task_13414,1008,149,132,92,224,6.72,23.17953668610514
Task_13415,1229,784,73,31,104,1.5656050955414014,27.507341274945485
Task_13416,2005,273,18,128,146,7.317518248175182,39.151316734861034
Task_13417,2533,97,63,94,157,25.846938775510203,46.16266297976949
Task_13418,946,424,17,18,35,2.2258823529411766,20.961924949713694
Task_13419,2017,675,93,57,150,2.9837278106508878,40.37800071678009
Task_13420,1351,868,10,141,151,1.5546605293440736,30.63975400916524
Task_13421,2230,614,160,73,233,3.6260162601626016,44.10442896457758
Task_13422,1415,637,91,57,148,2.217868338557994,30.71557480143756
Task_13423,1940,550,96,177,273,3.5208711433756807,39.87933771069522
Task_13424,577,693,11,15,26,0.8314121037463977,16.151474886602436
Task_13425,810,244,186,141,327,3.306122448979592,21.199619059687492
Task_13426,1091,193,38,188,226,5.623711340206185,25.058711128237917
Task_13427,1890,288,176,110,286,6.539792387543253,38.18558691937587
Task_13428,1335,352,14,162,176,3.781869688385269,29.16388645073101
Task_13429,569,124,19,93,112,4.552,15.024786836918572
Task_13430,2370,186,138,121,259,12.67379679144385,45.321873726541845
Task_13431,770,189,159,62,221,4.052631578947368,19.53382825888955
Task_13432,2233,578,28,174,202,3.856649395509499,44.265883504770564
Task_13433,1859,191,130,181,311,9.682291666666666,37.56206140712401
Task_13434,1327,385,136,22,158,3.437823834196891,28.220097154936997
Task_13435,877,741,22,133,155,1.1819407008086253,22.762485430297414
Task_13436,1817,973,105,180,285,1.8655030800821355,39.305976894627555
Task_13437,1551,897,72,24,96,1.7271714922048997,32.8656136452802
Task_13438,1840,214,33,139,172,8.55813953488372,36.63969630327225
Task_13439,1703,290,176,144,320,5.852233676975945,35.43930549140443
Task_13440,1514,754,83,27,110,2.0052980132450333,31.944264711527627
Task_13441,1526,336,28,59,87,4.528189910979228,30.817915807566028
Task_13442,2090,682,64,112,176,3.060029282576867,42.176277998289365
Task_13443,2005,415,115,121,236,4.819711538461538,40.218239245454846
Task_13444,2438,850,64,182,246,2.864864864864865,48.66016886548956
Task_13445,2658,856,160,81,241,3.1015169194865813,51.81971644726992
Task_13446,2920,185,156,91,247,15.698924731182796,53.76358746780732
Task_13447,1091,131,31,157,188,8.265151515151516,24.302738011166355
Task_13448,1107,743,130,49,179,1.4879032258064515,26.23827089285061
Task_13449,890,1020,82,13,95,0.871694417238002,22.884453727788564
Task_13450,1266,140,200,134,334,8.97872340425532,27.821366899419605
Task_13451,1686,912,91,24,115,1.8466593647316538,35.19709607633843
Task_13452,2958,662,112,144,256,4.461538461538462,56.224589583575174
Task_13453,876,534,126,119,245,1.6373831775700936,22.749455851605944
Task_13454,648,910,158,155,313,0.7113062568605928,20.736569466019322
Task_13455,2862,437,24,124,148,6.534246575342466,53.260145512553756
Task_13456,1232,287,48,44,92,4.277777777777778,25.833967725082065
Task_13457,1288,659,93,68,161,1.9515151515151514,28.85376330296457
Task_13458,1925,352,148,157,305,5.453257790368272,39.10925019548123
Task_13459,2841,220,195,157,352,12.855203619909503,53.32888416483477
Task_13460,2602,894,19,55,74,2.9072625698324024,49.293096086623564
Task_13461,2239,985,191,197,388,2.27079107505071,46.519739069432156
Task_13462,1287,254,102,53,155,5.047058823529412,27.498451558042387
Task_13463,2710,306,33,145,178,8.827361563517915,50.761101578168855
Task_13464,2100,318,184,166,350,6.58307210031348,41.97889326984798
Task_13465,1468,807,46,59,105,1.816831683168317,31.55359808011238
Task_13466,1241,167,115,109,224,7.386904761904762,27.02573401186036
Task_13467,799,500,141,89,230,1.594810379241517,21.274046388815993
Task_13468,1245,874,155,102,257,1.4228571428571428,29.640597227257498
Task_13469,2212,449,200,146,346,4.915555555555556,44.13731362436503
Task_13470,1515,838,123,85,208,1.8057210965435042,33.53785045504819
Task_13471,1310,623,77,51,128,2.0993589743589745,28.9736313825657
Task_13472,1924,585,101,173,274,3.2832764505119454,39.727864121919815
Task_13473,1877,496,151,35,186,3.7766599597585513,37.58020679483725
Task_13474,620,449,44,64,108,1.3777777777777778,17.17411803087235
Task_13475,1934,173,67,164,231,11.114942528735632,38.147446066522654
Task_13476,2399,106,72,31,103,22.42056074766355,43.22322706481816
Task_13477,1997,777,99,183,282,2.5668380462724936,41.54001460825011
Task_13478,2582,906,74,194,268,2.846747519294377,51.22396039312745
Task_13479,1519,255,132,52,184,5.93359375,31.38294231790854
Task_13480,519,633,178,143,321,0.8186119873817035,17.76481952410358
Task_13481,1063,973,48,200,248,1.091375770020534,27.17368362632639
Task_13482,1989,861,54,11,65,2.3074245939675175,38.98286204698811
Task_13483,2567,998,43,74,117,2.5695695695695697,50.06167267832782
Task_13484,518,278,167,194,361,1.8566308243727598,16.926008779751825
Task_13485,685,870,103,126,229,0.7864523536165328,20.71838569605384
Task_13486,1901,605,142,34,176,3.136963696369637,38.26180524818554
Task_13487,2087,112,75,100,175,18.469026548672566,39.74145423649683
Task_13488,945,961,18,40,58,0.9823284823284824,23.18198953828345
Task_13489,1725,257,143,184,327,6.686046511627907,35.76385456967264
Task_13490,2805,459,72,175,247,6.0978260869565215,53.21233223665026
Task_13491,609,199,46,57,103,3.045,16.042662799897943
Task_13492,2631,169,96,81,177,15.476470588235294,48.528893574221435
Task_13493,805,669,165,143,308,1.2014925373134329,22.31811977438552
Task_13494,2082,723,72,181,253,2.8756906077348066,42.64203118202234
Task_13495,2875,321,191,51,242,8.928571428571429,53.27554386696213
Task_13496,1734,535,196,44,240,3.235074626865672,35.69950978083602
Task_13497,1377,493,151,64,215,2.7874493927125505,30.073184922293553
Task_13498,2248,76,83,113,196,29.194805194805195,42.109112425094395
Task_13499,2484,304,57,140,197,8.144262295081967,47.341315280147676
Task_13500,1771,409,146,148,294,4.319512195121951,36.79676247168678
Task_13501,2237,973,172,160,332,2.2967145790554415,46.14406619070513
Task_13502,2396,441,57,167,224,5.420814479638009,46.570875245034706
Task_13503,1573,721,101,136,237,2.1786703601108033,34.374681813907394
Task_13504,2171,625,22,198,220,3.4680511182108624,43.54105148012936
Task_13505,2653,957,145,58,203,2.769311064718163,51.64268592865826
Task_13506,1093,185,98,44,142,5.876344086021505,23.824723652649112
Task_13507,2763,729,99,124,223,3.7849315068493152,53.17169409684002
Task_13508,2244,987,172,121,293,2.2712550607287447,46.06561687133072
Task_13509,2024,576,130,33,163,3.5077989601386483,40.05689276067843
Task_13510,2696,472,35,84,119,5.6997885835095135,50.52873591282006
Task_13511,1927,186,63,123,186,10.304812834224599,38.011426721963566
Task_13512,647,130,183,192,375,4.938931297709924,18.276644476626803
Task_13513,724,496,45,123,168,1.4567404426559356,19.826934647148466
Task_13514,2790,714,35,46,81,3.902097902097902,51.862725716892136
Task_13515,1594,389,146,103,249,4.087179487179487,33.66241764829616
Task_13516,1693,540,85,147,232,3.129390018484288,35.70620406544281
Task_13517,2542,963,50,59,109,2.636929460580913,49.15809054091039
Task_13518,2267,565,130,115,245,4.0053003533568905,44.88019135766728
Task_13519,961,69,150,137,287,13.728571428571428,22.38092569165948
Task_13520,1089,920,79,58,137,1.1824104234527688,26.379504509243258
Task_13521,2868,205,138,151,289,13.922330097087379,53.40150548649359
Task_13522,717,443,126,69,195,1.614864864864865,19.381642921769608
Task_13523,2367,858,151,23,174,2.7555296856810245,46.3710480425164
Task_13524,2495,623,43,69,112,3.9983974358974357,47.568530103372076
Task_13525,564,964,166,118,284,0.5844559585492228,19.42892899309597
Task_13526,1135,687,157,197,354,1.6497093023255813,27.933871474291873
Task_13527,2712,920,65,192,257,2.9446254071661238,53.28431532172698
Task_13528,2432,391,161,167,328,6.204081632653061,47.37811778454115
Task_13529,2643,144,23,72,95,18.22758620689655,47.616759536646505
Task_13530,1657,559,20,151,171,2.9589285714285714,34.851700451230705
Task_13531,2132,370,150,146,296,5.7466307277628035,42.386894352399764
Task_13532,2460,493,125,38,163,4.979757085020243,46.713019295291645
Task_13533,2195,945,70,131,201,2.3202959830866807,44.830853346312836
Task_13534,1295,1006,148,66,214,1.2859980139026812,30.36429473696702
Task_13535,963,130,112,59,171,7.351145038167939,21.672600721601782
Task_13536,1173,494,140,194,334,2.3696969696969696,27.85064945686453
Task_13537,1207,150,32,134,166,7.993377483443709,26.027128632124445
Task_13538,2918,413,152,51,203,7.048309178743962,54.09441125300882
Task_13539,2271,328,165,60,225,6.90273556231003,43.67466224504253
Task_13540,2365,183,25,121,146,12.853260869565217,44.35749492084748
Task_13541,1188,423,59,115,174,2.80188679245283,27.070625974594922
Task_13542,2891,98,159,41,200,29.2020202020202,51.510108659398725
Task_13543,985,506,164,114,278,1.942800788954635,24.54240714272422
Task_13544,1996,569,23,110,133,3.501754385964912,39.92675554944684
Task_13545,763,455,120,32,152,1.6732456140350878,19.53159613223309
Task_13546,686,262,100,30,130,2.6083650190114067,17.60627229744659
Task_13547,1931,305,146,93,239,6.310457516339869,38.638678202944725
Task_13548,2777,74,122,123,245,37.026666666666664,50.616311629597085
Task_13549,640,736,13,60,73,0.8683853459972863,17.780859240988104
Task_13550,2841,879,168,51,219,3.228409090909091,54.4383854749283
Task_13551,2777,458,157,184,341,6.050108932461874,53.14276464274426
Task_13552,1456,181,86,157,243,8.0,30.56607432857545
Task_13553,2625,618,76,68,144,4.240710823909532,49.90684458534502
Task_13554,2060,601,82,72,154,3.4219269102990033,40.90939456883848
Task_13555,1705,753,113,12,125,2.2612732095490715,35.09295450880666
Task_13556,2724,1007,49,61,110,2.7023809523809526,52.21911950217291
Task_13557,567,602,23,160,183,0.9402985074626866,17.726432893178654
Task_13558,900,128,127,41,168,6.976744186046512,20.45312641696322
Task_13559,814,290,197,28,225,2.797250859106529,20.278275800063877
Task_13560,2226,825,185,78,263,2.694915254237288,44.95400315122904
Task_13561,2426,957,166,25,191,2.5323590814196244,47.70776041099242
Task_13562,758,465,106,139,245,1.6266094420600858,20.694931411485562
Task_13563,2565,599,190,96,286,4.275,49.89286190347111
Task_13564,2658,207,106,20,126,12.778846153846153,48.4423534209476
Task_13565,1353,415,198,60,258,3.2524038461538463,29.586406046267257
Task_13566,662,311,173,73,246,2.121794871794872,18.38202083609205
Task_13567,2796,571,184,104,288,4.888111888111888,53.45383001122699
Task_13568,2913,922,65,114,179,3.1560130010834238,55.98387098300387
Task_13569,2443,458,126,116,242,5.32244008714597,47.310174819375845
Task_13570,1543,170,72,127,199,9.023391812865498,31.785678033147775
Task_13571,2562,532,94,53,147,4.806754221388368,48.613159452021286
Task_13572,1747,718,20,176,196,2.4297635605006955,36.98059000232615
Task_13573,584,131,33,114,147,4.424242424242424,15.706602389262793
Task_13574,510,409,59,35,94,1.2439024390243902,14.806781295482887
Task_13575,2404,321,144,23,167,7.46583850931677,45.19943848212436
Task_13576,952,251,117,163,280,3.7777777777777777,23.286652388222866
Task_13577,1055,660,96,99,195,1.5960665658093798,25.722133927522098
Task_13578,815,572,170,26,196,1.4223385689354275,21.032206790987342
Task_13579,1255,269,186,181,367,4.648148148148148,28.553227573399237
Task_13580,1978,1004,149,12,161,1.9681592039800995,40.485313961155406
Task_13581,767,541,61,109,170,1.415129151291513,20.67557050287931
Task_13582,1994,815,11,17,28,2.4436274509803924,38.76839585854586
Task_13583,1064,517,147,161,308,2.054054054054054,26.031753518923537
Task_13584,1041,289,23,72,95,3.589655172413793,23.252504549692134
Task_13585,1839,368,13,104,117,4.983739837398374,36.59369411107641
Task_13586,913,137,116,33,149,6.615942028985507,20.520178779064903
Task_13587,1922,428,168,113,281,4.480186480186481,39.13804626402867
Task_13588,1583,258,89,115,204,6.111969111969112,32.846912621470224
Task_13589,2899,866,17,61,78,3.3437139561707037,53.99111913024661
Task_13590,670,802,129,85,214,0.8343711083437111,20.044913316264125
Task_13591,1200,379,59,36,95,3.1578947368421053,25.575674523591445
Task_13592,1678,860,46,14,60,1.948896631823461,34.11571275632312
Task_13593,2272,816,103,22,125,2.780905752753978,44.28833992438761
Task_13594,605,497,174,43,217,1.214859437751004,17.62006209963647
Task_13595,1507,752,138,173,311,2.00132802124834,33.81363063419977
Task_13596,2763,631,99,94,193,4.371835443037975,52.67492795787614
Task_13597,959,804,65,52,117,1.191304347826087,23.674659287532425
Task_13598,1864,885,161,191,352,2.1038374717832955,40.09523493271606
Task_13599,1005,349,155,82,237,2.8714285714285714,24.05934199705054
Task_13600,2225,474,178,148,326,4.684210526315789,44.33684838908255
Task_13601,2091,376,23,71,94,5.546419098143236,40.147832869025656
Task_13602,1759,467,28,114,142,3.7585470085470085,35.85150983047094
Task_13603,828,473,75,39,114,1.7468354430379747,20.28659104953562
Task_13604,1260,452,43,198,241,2.781456953642384,28.69842398937371
Task_13605,2239,125,119,102,221,17.76984126984127,42.46194301348602
Task_13606,1381,515,138,63,201,2.6763565891472867,30.135908903220464
Task_13607,710,739,83,69,152,0.9594594594594594,19.902053980925213
Task_13608,565,995,92,110,202,0.5672690763052208,19.153593721864727
Task_13609,1259,900,113,178,291,1.397336293007769,30.20764964501203
Task_13610,2210,953,189,48,237,2.3165618448637315,44.575754842689356
Task_13611,2530,680,10,101,111,3.7151248164464024,48.47233665691729
Task_13612,2714,984,73,14,87,2.7553299492385785,51.4289069018167
Task_13613,1078,214,154,52,206,5.013953488372093,24.39610429375628
Task_13614,1163,672,86,19,105,1.7280832095096583,26.00776526996087
Task_13615,2864,718,127,196,323,3.9833101529902644,55.291442943096456
Task_13616,1327,992,51,143,194,1.3363544813695871,31.1791475376022
Task_13617,2571,76,109,16,125,33.38961038961039,45.53908409658411
Task_13618,2334,996,88,148,236,2.341023069207623,47.261315365143794
Task_13619,1806,134,105,146,251,13.377777777777778,35.91802634016393
Task_13620,860,791,46,150,196,1.0858585858585859,23.056280603292226
Task_13621,964,965,150,145,295,0.9979296066252588,25.71069063133824
Task_13622,2382,785,36,26,62,3.030534351145038,45.20385351377135
Task_13623,1602,126,103,148,251,12.614173228346457,32.65638063608872
Task_13624,2152,411,178,185,363,5.223300970873787,43.1976256751557
Task_13625,1388,67,88,166,254,20.41176470588235,28.920950760956213
Task_13626,2789,583,79,187,266,4.7756849315068495,53.463995486083554
Task_13627,2364,510,34,63,97,4.626223091976517,44.88902524328089
Task_13628,2519,873,199,199,398,2.8821510297482837,50.65524364142783
Task_13629,2524,163,71,154,225,15.390243902439025,47.39354660620443
Task_13630,970,381,81,80,161,2.5392670157068062,23.16571078912081
Task_13631,934,396,90,98,188,2.3526448362720402,22.94600624956844
Task_13632,555,984,103,98,201,0.5634517766497462,18.91371474320372
Task_13633,2491,667,67,176,243,3.7290419161676644,48.90639091232666
Task_13634,958,853,148,119,267,1.1217798594847774,25.073661027624073
Task_13635,2645,751,16,32,48,3.5172872340425534,49.17364106470287
Task_13636,1931,507,59,155,214,3.8011811023622046,39.363980311250025
Task_13637,2378,549,76,76,152,4.323636363636363,45.85329271435157
Task_13638,605,506,132,103,235,1.193293885601578,18.256746941971958
Task_13639,2033,667,17,130,147,3.0434131736526946,40.855792081616954
Task_13640,1334,277,45,72,117,4.798561151079137,28.18977791429835
Task_13641,1582,948,158,123,281,1.6670179135932561,35.38945394368923
Task_13642,1091,707,139,50,189,1.5409604519774012,25.915779369390737
Task_13643,2297,692,112,175,287,3.3145743145743145,46.034780460295146
Task_13644,1878,495,83,84,167,3.786290322580645,38.06085883281694
Task_13645,2884,419,90,90,180,6.866666666666666,53.79209643906497
Task_13646,623,538,52,21,73,1.155844155844156,16.577972532900166
Task_13647,2015,319,152,199,351,6.296875,40.6910208224025
Task_13648,2056,118,113,179,292,17.277310924369747,39.96537118618834
Task_13649,1389,312,195,109,304,4.437699680511182,30.424906224511073
Task_13650,630,263,35,195,230,2.3863636363636362,18.073412211696958
Task_13651,1413,215,22,177,199,6.541666666666667,30.082317375747035
Task_13652,1646,479,92,127,219,3.4291666666666667,34.68206034616757
Task_13653,2767,606,185,15,200,4.5584843492586495,51.99368658381679
Task_13654,1374,752,80,20,100,1.8247011952191234,29.575448420065356
Task_13655,1741,117,98,113,211,14.754237288135593,34.53121981912438
Task_13656,1597,597,128,170,298,2.67056856187291,34.69106150067842
Task_13657,2432,781,123,192,315,3.1099744245524295,48.60430777293332
Task_13658,2720,663,187,60,247,4.096385542168675,51.97065742050673
Task_13659,2505,986,56,137,193,2.5379939209726445,49.84086816872139
Task_13660,1791,567,86,32,118,3.153169014084507,35.83413672165812
Task_13661,1106,450,108,17,125,2.4523281596452327,24.654565078872597
Task_13662,2035,424,127,118,245,4.788235294117647,40.758462799607855
Task_13663,2617,385,103,82,185,6.77979274611399,49.414887715043854
Task_13664,1767,437,15,51,66,4.034246575342466,34.57665694807257
Task_13665,880,205,25,86,111,4.271844660194175,20.847392274095636
Task_13666,2430,792,48,32,80,3.064312736443884,46.277313946414125
Task_13667,2744,731,44,117,161,3.748633879781421,52.443809014088515
Task_13668,726,174,196,133,329,4.148571428571429,19.412365136674726
Task_13669,2223,261,177,86,263,8.48473282442748,43.14906127196658
Task_13670,839,906,50,119,169,0.9250275633958104,22.959331514178132
Task_13671,2383,80,170,101,271,29.419753086419753,44.53540557891762
Task_13672,1984,504,121,160,281,3.9287128712871286,40.432851026411264
Task_13673,1071,574,126,23,149,1.862608695652174,24.770538611013297
Task_13674,1638,873,187,134,321,1.874141876430206,36.25368436503579
Task_13675,1452,735,131,57,188,1.9728260869565217,31.83324092617664
Task_13676,618,160,61,156,217,3.8385093167701863,17.276605800857354
Task_13677,1433,789,56,165,221,1.8139240506329113,32.40875906155402
Task_13678,2772,438,189,14,203,6.314350797266515,51.540737586548225
Task_13679,2432,211,160,60,220,11.471698113207546,45.774271235150216
Task_13680,2022,130,166,49,215,15.435114503816793,38.47384975660595
Task_13681,2641,327,65,115,180,8.051829268292684,49.7682045202065
Task_13682,2641,455,31,116,147,5.791666666666667,49.82834666741733
Task_13683,2849,796,88,176,264,3.57465495608532,54.96337645091199
Task_13684,2608,698,24,85,109,3.7310443490701,49.737077219418474
Task_13685,1687,539,110,19,129,3.1240740740740742,34.28702004318716
Task_13686,2186,440,147,149,296,4.956916099773243,43.475595801591076
Task_13687,1615,516,170,136,306,3.123791102514507,34.706561489458004
Task_13688,2831,944,155,74,229,2.9957671957671956,54.69768964046361
Task_13689,2286,633,20,82,102,3.6056782334384856,44.299842054169666
Task_13690,2921,668,51,64,115,4.366218236173393,54.550365317365255
Task_13691,1545,406,133,150,283,3.796068796068796,33.16414508043538
Task_13692,1344,498,69,20,89,2.693386773547094,28.238668063819947
Task_13693,1083,328,144,169,313,3.291793313069909,25.766664136841815
Task_13694,2871,137,193,177,370,20.804347826086957,53.28845754120923
Task_13695,1546,929,34,181,215,1.6623655913978495,34.55962233960356
Task_13696,2905,481,192,11,203,6.026970954356846,53.796786344549076
Task_13697,2661,740,166,101,267,3.591093117408907,51.7534788930918
Task_13698,1136,445,139,80,219,2.5470852017937218,26.325390487837577
Task_13699,798,102,104,56,160,7.747572815533981,18.68566730997494
Task_13700,1343,159,21,23,44,8.39375,26.604559288920598
Task_13701,1264,797,31,181,212,1.5839598997493733,29.627817247320724
Task_13702,570,998,93,104,197,0.5705705705705706,19.28348532615638
Task_13703,934,83,164,184,348,11.119047619047619,22.316800179043614
Task_13704,2742,936,161,22,183,2.926360725720384,52.56895005564448
Task_13705,893,146,195,165,360,6.074829931972789,22.154502765323823
Task_13706,1776,794,60,113,173,2.2339622641509433,37.53362189791141
Task_13707,1025,229,130,95,225,4.456521739130435,24.032198199081066
Task_13708,2639,789,181,157,338,3.340506329113924,51.96123156964128
Task_13709,1684,906,72,76,148,1.8566703417861081,36.0484985589999
Task_13710,2914,791,61,143,204,3.6792929292929295,55.766964627718984
Task_13711,1392,521,108,118,226,2.6666666666666665,30.80478614848516
Task_13712,2349,472,69,96,165,4.966173361522198,45.580467671803554
Task_13713,1734,570,108,126,234,3.0367775831873907,36.42250700201978
Task_13714,1020,1016,151,141,292,1.0029498525073746,26.705066970183083
Task_13715,1048,195,158,154,312,5.346938775510204,24.745900216926188
Task_13716,781,225,84,136,220,3.4557522123893807,20.19910178828104
Task_13717,2269,538,43,132,175,4.209647495361781,44.52595363461577
Task_13718,1824,880,138,196,334,2.0703745743473325,39.37207602434764
Task_13719,2268,864,94,143,237,2.621965317919075,45.85267654634822
Task_13720,1819,762,191,39,230,2.384010484927916,37.71489706705395
Task_13721,2845,217,51,32,83,13.05045871559633,51.000750666518364
Task_13722,1293,620,24,200,224,2.082125603864734,29.646686651523883
Task_13723,2125,961,158,166,324,2.208939708939709,44.304651325922016
Task_13724,1129,77,175,64,239,14.474358974358974,24.259209726168496
Task_13725,1946,468,117,159,276,4.149253731343284,39.69187652484892
Task_13726,843,184,110,89,199,4.556756756756757,20.786727944334057
Task_13727,1972,286,149,184,333,6.871080139372823,39.79527602500264
Task_13728,2486,919,156,165,321,2.7021739130434783,49.87919106975096
Task_13729,2196,824,93,48,141,2.6618181818181816,43.472679773879825
Task_13730,1997,338,37,132,169,5.890855457227139,39.531145224950166
Task_13731,2206,860,139,142,281,2.562137049941928,45.044370738636424
Task_13732,2473,113,142,53,195,21.69298245614035,45.466199653338144
Task_13733,543,509,71,67,138,1.0647058823529412,16.53011670542421
Task_13734,2400,361,177,89,266,6.629834254143646,46.33519322942124
Task_13735,806,788,95,25,120,1.0215462610899873,21.004178862561766
Task_13736,1132,607,151,135,286,1.861842105263158,27.25296850805921
Task_13737,2611,694,38,144,182,3.756834532374101,50.468280798436545
Task_13738,1453,84,196,108,304,17.094117647058823,30.15432650982804
Task_13739,2962,531,68,65,133,5.567669172932331,54.96978695682794
Task_13740,2458,523,66,148,214,4.690839694656488,47.7560915803166
Task_13741,1597,303,94,48,142,5.253289473684211,32.28681680972027
Task_13742,2538,110,59,82,141,22.864864864864863,46.252006308977485
Task_13743,2809,950,79,147,226,2.953732912723449,54.69970222418011
Task_13744,2263,441,73,178,251,5.119909502262443,44.59717467517826
Task_13745,924,195,11,50,61,4.714285714285714,20.464435544426234
Task_13746,2521,173,156,182,338,14.488505747126437,47.840757981402675
Task_13747,2061,808,85,145,230,2.547589616810878,42.36513469169518
Task_13748,2341,670,26,93,119,3.488822652757079,45.52170673818177
Task_13749,1001,485,66,43,109,2.0596707818930042,23.000764619434932
Task_13750,559,102,39,111,150,5.427184466019417,15.120253244597599
Task_13751,1588,514,95,97,192,3.0834951456310677,33.74046177943348
Task_13752,957,462,24,122,146,2.0669546436285096,23.185371936019987
Task_13753,1786,774,78,169,247,2.304516129032258,38.07485748314983
Task_13754,1901,398,165,97,262,4.764411027568922,38.627489423251085
Task_13755,694,431,82,42,124,1.6064814814814814,18.10868066807495
Task_13756,1056,101,17,200,217,10.352941176470589,23.724636176344166
Task_13757,1566,995,34,144,178,1.572289156626506,34.81241579714832
Task_13758,1134,670,54,163,217,1.6900149031296572,27.267805400733078
Task_13759,2669,776,156,83,239,3.435006435006435,51.769058525902004
Task_13760,1277,485,186,96,282,2.6275720164609053,29.118921528247437
Task_13761,1078,628,48,93,141,1.713831478537361,25.654557673519093
Task_13762,663,757,144,142,286,0.8746701846965699,20.27103416700774
Task_13763,1360,384,27,178,205,3.5324675324675323,29.84553809431641
Task_13764,1096,424,49,115,164,2.5788235294117645,25.57731210020867
Task_13765,938,290,82,47,129,3.223367697594502,21.749023221002005
Task_13766,1329,243,58,54,112,5.44672131147541,27.589441201613685
Task_13767,2341,794,86,182,268,2.9446540880503145,46.937157239539204
Task_13768,2744,661,61,157,218,4.145015105740181,52.74677591282051
Task_13769,1469,611,174,16,190,2.400326797385621,31.40654328080289
Task_13770,930,365,88,104,192,2.540983606557377,22.783425801710212
Task_13771,911,466,112,41,153,1.9507494646680943,21.897593596215227
Task_13772,1202,437,151,66,217,2.7442922374429224,27.136829961392447
Task_13773,2908,405,196,60,256,7.16256157635468,54.15168479704037
Task_13774,2599,425,167,45,212,6.10093896713615,48.90540033330233
Task_13775,515,246,146,163,309,2.08502024291498,16.49660038121944
Task_13776,2388,773,186,38,224,3.0852713178294575,46.74858584116364
Task_13777,2595,165,195,15,210,15.632530120481928,47.618805198041116
Task_13778,1267,416,91,42,133,3.038369304556355,27.35332138262932
Task_13779,1329,577,55,114,169,2.2993079584775087,29.74209475497767
Task_13780,894,109,188,60,248,8.127272727272727,20.80947030618383
Task_13781,2091,699,42,154,196,2.987142857142857,42.36946386032187
Task_13782,2694,925,140,146,286,2.9092872570194386,53.00823999555016
Task_13783,2571,943,189,89,278,2.7235169491525424,50.95321759411536
Task_13784,2352,263,125,85,210,8.909090909090908,44.94379135403437
Task_13785,869,187,137,182,319,4.622340425531915,21.991688112128497
Task_13786,764,364,137,89,226,2.0931506849315067,20.28406946144025
Task_13787,790,850,39,20,59,0.9283196239717979,20.252239922891178
Task_13788,1792,284,168,72,240,6.287719298245614,36.13910287485803
Task_13789,1989,272,137,47,184,7.285714285714286,38.63040569074693
Task_13790,2543,435,155,101,256,5.83256880733945,48.858795784522194
Task_13791,2726,890,70,155,225,3.059483726150393,53.21654958008201
Task_13792,572,307,26,43,69,1.8571428571428572,15.079116326580332
Task_13793,1425,777,82,98,180,1.8316195372750643,31.91708204174526
Task_13794,1809,294,161,141,302,6.132203389830509,37.04312819350897
Task_13795,2449,306,103,57,160,7.977198697068404,46.003936562775266
Task_13796,761,239,25,84,109,3.1708333333333334,19.032462265783007
Task_13797,1437,808,148,132,280,1.7762669962917181,32.665757221615316
Task_13798,538,875,110,174,284,0.6141552511415526,18.83090848408138
Task_13799,1391,239,23,111,134,5.795833333333333,29.238664003337224
Task_13800,2023,120,187,131,318,16.71900826446281,39.52456597108687
Task_13801,2179,522,36,84,120,4.166347992351817,42.508403449780715
Task_13802,1550,455,106,121,227,3.3991228070175437,33.10549812893602
Task_13803,996,74,141,124,265,13.28,22.830202216859885
Task_13804,2389,883,80,29,109,2.7024886877828056,46.220540193390576
Task_13805,1915,748,100,167,267,2.5567423230974633,40.057488921630096
Task_13806,1801,704,80,14,94,2.554609929078014,36.15035929529689
Task_13807,1549,116,75,196,271,13.239316239316238,31.965438647604163
Task_13808,517,422,18,152,170,1.2222222222222223,16.302741744795707
Task_13809,2534,598,92,181,273,4.230383973288815,49.44410403539345
Task_13810,2049,744,90,42,132,2.7503355704697987,40.76747235402816
Task_13811,1972,210,33,190,223,9.345971563981042,39.041915878705176
Task_13812,751,1020,30,108,138,0.7355533790401567,21.613413208772656
Task_13813,754,881,167,58,225,0.854875283446712,21.464540652124864
Task_13814,2351,361,194,153,347,6.494475138121547,46.06150979494286
Task_13815,1616,794,198,108,306,2.0327044025157233,35.55352827532656
Task_13816,1104,813,22,37,59,1.3562653562653562,25.072916626782504
Task_13817,1696,854,185,192,377,1.983625730994152,37.450985996050456
Task_13818,1627,443,104,186,290,3.6644144144144146,34.66507809941685
Task_13819,1323,452,194,25,219,2.9205298013245033,28.7781149710168
Task_13820,517,578,52,173,225,0.8929188255613126,17.197326454380576
Task_13821,2710,517,69,176,245,5.231660231660232,51.9023337948116
Task_13822,749,294,200,132,332,2.538983050847458,20.407182139682284
Task_13823,2323,107,81,98,179,21.50925925925926,43.39727176998184
Task_13824,2985,100,104,177,281,29.554455445544555,54.289911072890256
Task_13825,1641,496,76,60,136,3.301810865191147,33.79733492871382
Task_13826,2405,634,57,124,181,3.7874015748031495,47.03828913789346
Task_13827,2716,387,55,62,117,7.0,50.20063889809115
Task_13828,2365,856,76,56,132,2.7596266044340725,46.388661156340994
Task_13829,2425,652,167,129,296,3.713629402756508,47.909047300154036
Task_13830,2164,761,183,176,359,2.8398950131233596,44.4706849663655
Task_13831,2594,120,43,186,229,21.43801652892562,48.14840598299671
Task_13832,539,563,99,186,285,0.9556737588652482,17.777123292073536
Task_13833,2188,789,62,141,203,2.769620253164557,44.251324600725475
Task_13834,1527,301,174,34,208,5.056291390728477,31.519060181336087
Task_13835,2605,993,22,188,210,2.6207243460764587,51.51086529513764
Task_13836,2699,953,25,141,166,2.8291404612159328,52.58150763627898
Task_13837,2755,697,170,139,309,3.9469914040114613,53.351733334330525
Task_13838,2378,842,34,71,105,2.8208778173190985,46.32871977304777
Task_13839,1933,538,100,39,139,3.5862708719851577,38.243052993129666
Task_13840,2399,177,159,101,260,13.47752808988764,45.43456050545089
Task_13841,717,614,11,150,161,1.1658536585365853,19.884828913385252
Task_13842,1090,440,69,165,234,2.4716553287981857,25.945586735401914
Task_13843,561,471,49,38,87,1.1885593220338984,15.88107560639905
Task_13844,2710,502,136,155,291,5.387673956262425,51.95784332571785
Task_13845,1492,230,158,133,291,6.458874458874459,31.751353420113947
Task_13846,1751,231,35,123,158,7.547413793103448,35.06624228921587
Task_13847,1800,697,63,44,107,2.5787965616045847,36.1666606475693
Task_13848,1083,670,136,136,272,1.6140089418777943,26.598287756027208
Task_13849,1508,718,67,73,140,2.097357440890125,32.570124409640734
Task_13850,1742,105,59,156,215,16.433962264150942,34.53690851496041
Task_13851,2352,627,126,149,275,3.745222929936306,46.608351230077886
Task_13852,1736,87,72,200,272,19.727272727272727,34.666721894713575
Task_13853,1454,182,17,166,183,7.945355191256831,30.338524132962338
Task_13854,1610,779,193,97,290,2.0641025641025643,35.3518758533384
Task_13855,1018,882,65,138,203,1.1528878822197055,25.92264157615152
Task_13856,714,123,115,61,176,5.758064516129032,17.783672793842396
Task_13857,2220,876,47,151,198,2.5313568985176738,44.99539549710652
Task_13858,2498,831,113,189,302,3.0024038461538463,49.743726505218696
Task_13859,755,73,122,168,290,10.202702702702704,19.224184147931574
Task_13860,2429,267,126,138,264,9.063432835820896,46.573193171167475
Task_13861,1462,771,10,173,183,1.8937823834196892,32.509176730079055
Task_13862,580,349,156,136,292,1.6571428571428573,17.7215613676274
Task_13863,2661,701,145,111,256,3.7905982905982905,51.595477119978604
Task_13864,2786,350,195,77,272,7.937321937321937,52.28964507482646
Task_13865,2472,775,42,152,194,3.185567010309278,48.631843016858
Task_13866,1725,375,20,119,139,4.587765957446808,35.002864528693216
Task_13867,1663,122,69,120,189,13.520325203252032,33.33619320726621
Task_13868,2763,427,12,18,30,6.455607476635514,49.72814100935596
Task_13869,685,849,178,106,284,0.8058823529411765,20.85758704715903
Task_13870,872,204,116,163,279,4.253658536585366,21.861085632995053
Task_13871,2450,468,31,56,87,5.223880597014926,45.88230805978974
Task_13872,2509,994,193,58,251,2.521608040201005,49.692476929338454
Task_13873,2091,807,152,12,164,2.587871287128713,41.781671500596175
Task_13874,1835,179,148,30,178,10.194444444444445,35.61771662989902
Task_13875,2910,642,14,60,74,4.5256609642301715,53.37245597443436
Task_13876,2343,668,100,134,234,3.502242152466368,46.38872646367477
Task_13877,1370,127,13,101,114,10.703125,27.71776909780004
Task_13878,1999,262,181,34,215,7.600760456273764,38.87783472521895
Task_13879,1157,608,179,180,359,1.8998357963875205,28.046996355626003
Task_13880,716,606,143,49,192,1.1795716639209226,19.699247073338448
Task_13881,1463,387,27,118,145,3.770618556701031,30.946593200493282
Task_13882,2655,915,21,112,133,2.898471615720524,51.451107111125225
Task_13883,868,324,90,150,240,2.670769230769231,21.99111954093358
Task_13884,529,149,79,114,193,3.526666666666667,15.692293155065762
Task_13885,2460,849,135,169,304,2.8941176470588235,49.17770004105694
Task_13886,1927,257,21,179,200,7.4689922480620154,38.3577890738745
Task_13887,1020,970,168,143,311,1.050463439752832,26.669913175011377
Task_13888,1340,1008,64,126,190,1.32804757185332,31.360759717527525
Task_13889,1506,133,64,83,147,11.238805970149254,30.309404866741232
Task_13890,1003,599,143,150,293,1.6716666666666666,25.22517338259354
Task_13891,2293,272,164,26,190,8.3992673992674,43.41344958449986
Task_13892,1386,191,106,157,263,7.21875,29.846236723085337
Task_13893,1572,272,153,78,231,5.758241758241758,32.68657851883796
Task_13894,687,96,161,111,272,7.082474226804123,18.012927423474796
Task_13895,1148,84,15,153,168,13.505882352941176,24.701791010237187
Task_13896,1947,423,115,157,272,4.591981132075472,39.54141418110537
Task_13897,811,189,146,129,275,4.268421052631579,20.785150485385373
Task_13898,1442,381,47,43,90,3.774869109947644,29.47079727429929
Task_13899,1426,414,129,36,165,3.436144578313253,30.106401019260534
Task_13900,2942,410,35,73,108,7.158150851581508,53.95325606402284
Task_13901,2872,906,59,113,172,3.1664829106945978,55.24502805499365
Task_13902,1423,654,52,190,242,2.1725190839694655,31.963048355309244
Task_13903,1931,679,139,189,328,2.8397058823529413,40.40181407018311
Task_13904,2348,773,63,49,112,3.03359173126615,45.27359529893019
Task_13905,2358,801,180,66,246,2.9401496259351623,46.72127375591177
Task_13906,734,142,184,89,273,5.1328671328671325,19.03708991046267
Task_13907,2346,348,63,78,141,6.722063037249284,44.771481693674616
Task_13908,763,408,117,112,229,1.8655256723716382,20.496917814241915
Task_13909,810,90,66,93,159,8.901098901098901,19.10337878904454
Task_13910,1358,1005,13,57,70,1.3499005964214712,29.90724111175218
Task_13911,966,195,11,68,79,4.928571428571429,21.49320987825688
Task_13912,1269,501,179,170,349,2.5278884462151394,29.42493741276799
Task_13913,2408,1010,146,65,211,2.3818001978239365,48.02270684692848
Task_13914,985,1019,105,76,181,0.9656862745098039,25.447027124007604
Task_13915,1577,762,187,127,314,2.0668414154652686,34.89983741878993
Task_13916,856,158,180,150,330,5.383647798742138,21.482875415047783
Task_13917,2261,144,71,74,145,15.593103448275862,42.21072506223888
Task_13918,2737,682,180,10,190,4.007320644216691,51.71872696334844
Task_13919,2979,324,126,153,279,9.166153846153847,55.56099482422676
Task_13920,1098,485,193,159,352,2.259259259259259,26.664822178914434
Task_13921,1499,84,156,157,313,17.63529411764706,30.987886077179482
Task_13922,1475,515,181,164,345,2.858527131782946,32.70369515681013
Task_13923,958,640,180,109,289,1.4945397815912635,24.53280566822518
Task_13924,1865,451,24,126,150,4.126106194690266,37.520679371459735
Task_13925,2013,859,192,185,377,2.3406976744186045,42.478978753255745
Task_13926,1190,338,98,177,275,3.510324483775811,27.335993528238188
Task_13927,1248,684,43,65,108,1.821897810218978,27.92405069562956
Task_13928,683,126,86,76,162,5.377952755905512,17.22652920437191
Task_13929,2574,324,55,27,82,7.92,47.06070246737091
Task_13930,1687,412,23,34,57,4.084745762711864,33.02620953249767
Task_13931,746,369,144,24,168,2.016216216216216,19.102417051147288
Task_13932,1612,958,18,48,66,1.6809176225234619,33.658265678947345
Task_13933,1660,278,36,187,223,5.949820788530466,34.359202749444755
Task_13934,1536,719,172,51,223,2.1333333333333333,33.280668023549964
Task_13935,536,359,176,68,244,1.488888888888889,16.461418897832157
Task_13936,1206,487,97,191,288,2.471311475409836,28.146963968744743
Task_13937,1244,1016,131,173,304,1.2232055063913472,30.36989543750094
Task_13938,519,641,117,34,151,0.8084112149532711,16.307077458846162
Task_13939,2998,106,92,20,112,28.018691588785046,52.72421951091985
Task_13940,2930,608,64,135,199,4.811165845648604,55.409024933797184
Task_13941,1857,932,143,60,203,1.9903536977491962,38.943224124182045
Task_13942,1038,568,92,181,273,1.8242530755711774,25.659017138940374
Task_13943,1525,239,84,107,191,6.354166666666667,31.825210198496677
Task_13944,2620,764,10,98,108,3.4248366013071894,50.082045461030646
Task_13945,675,707,111,53,164,0.9533898305084746,19.52305350511222
Task_13946,1703,837,186,37,223,2.032219570405728,36.090021423452335
Task_13947,2683,960,65,112,177,2.7918834547346516,52.44608695233318
Task_13948,1329,220,25,196,221,6.013574660633484,28.904484409580267
Task_13949,2965,825,65,190,255,3.5895883777239708,56.98332995077127
Task_13950,2595,742,89,166,255,3.4925975773889637,50.734410047657605
Task_13951,1756,998,88,192,280,1.7577577577577577,38.35735136044269
Task_13952,662,951,49,44,93,0.6953781512605042,19.39377255315981
Task_13953,1106,497,140,94,234,2.2208835341365463,26.195479945095872
Task_13954,2894,718,189,198,387,4.025034770514604,56.058053240999165
Task_13955,1574,823,120,21,141,1.9101941747572815,33.41605633632022
Task_13956,1965,403,144,188,332,4.8638613861386135,40.07702163359898
Task_13957,1566,122,148,70,218,12.731707317073171,31.481284623240274
Task_13958,2872,164,171,83,254,17.406060606060606,52.740478416764155
Task_13959,564,102,188,64,252,5.475728155339806,15.601141851048089
Task_13960,1918,824,181,196,377,2.3248484848484847,40.88074963669725
Task_13961,1495,549,56,177,233,2.7181818181818183,32.711585364338866
Task_13962,961,987,87,77,164,0.9726720647773279,24.88301423706361
Task_13963,2367,349,177,114,291,6.7628571428571425,45.96461761815274
Task_13964,939,806,164,108,272,1.1635687732342008,24.642999563184627
Task_13965,2867,66,64,105,169,42.791044776119406,51.53340500031476
Task_13966,2874,862,165,55,220,3.3302433371958284,54.92736052743405
Task_13967,532,750,91,200,291,0.7083888149134487,18.38433477889631
Task_13968,1957,963,187,100,287,2.030082987551867,41.3851616974178
Task_13969,794,929,200,28,228,0.853763440860215,22.015586021599614
Task_13970,984,398,22,60,82,2.4661654135338344,22.397266056350606
Task_13971,574,964,154,90,244,0.5948186528497409,19.334723707990012
Task_13972,905,505,51,174,225,1.7885375494071147,23.21999313792359
Task_13973,1469,129,180,199,379,11.3,31.24456286171328
Task_13974,971,629,179,24,203,1.5412698412698413,23.679392371373144
Task_13975,2943,137,51,15,66,21.32608695652174,51.57643663047953
Task_13976,1549,774,61,15,76,1.998709677419355,31.79761216848181
Task_13977,1352,725,93,118,211,1.862258953168044,30.7811893323907
Task_13978,1413,119,35,180,215,11.775,29.495766354049433
Task_13979,1660,142,80,52,132,11.608391608391608,32.50107322043953
Task_13980,988,654,101,16,117,1.5083969465648854,23.24168158269053
Task_13981,534,803,57,144,201,0.664179104477612,18.167934878237933
Task_13982,840,67,105,79,184,12.352941176470589,19.6616091178346
Task_13983,2217,969,122,170,292,2.2855670103092782,45.64906084238206
Task_13984,920,1016,15,83,98,0.904621435594887,23.72732345470823
Task_13985,1949,222,58,144,202,8.739910313901346,38.62493527692225
Task_13986,2939,151,17,164,181,19.335526315789473,53.4732619559978
Task_13987,933,414,172,91,263,2.2481927710843372,23.273533884873455
Task_13988,1033,627,54,149,203,1.644904458598726,25.450510492349846
Task_13989,1811,620,148,163,311,2.9162640901771337,38.200891951679004
Task_13990,1880,278,132,64,196,6.738351254480286,37.243101725488856
Task_13991,1895,705,173,48,221,2.6841359773371103,38.73837371819146
Task_13992,2105,975,73,136,209,2.1567622950819674,43.528927010828
Task_13993,2963,509,148,51,199,5.809803921568627,55.10494906938076
Task_13994,1047,961,73,107,180,1.0883575883575884,26.424702790393596
Task_13995,1198,507,122,102,224,2.358267716535433,27.656739349977347
Task_13996,2665,439,148,110,258,6.056818181818182,50.82503225142892
Task_13997,1549,938,102,17,119,1.6496272630457933,33.04973618054054
Task_13998,2038,794,34,150,184,2.5635220125786162,41.728838425904044
Task_13999,2077,411,27,88,115,5.04126213592233,40.498029186688875
Task_14000,1831,409,131,17,148,4.465853658536585,36.22126784520171
Task_14001,1147,305,198,59,257,3.7483660130718954,25.96718402072546
Task_14002,2274,214,65,200,265,10.576744186046511,44.0927844225788
Task_14003,654,501,30,51,81,1.302788844621514,17.529165264682124
Task_14004,2148,818,91,102,193,2.6227106227106227,43.53829530400702
Task_14005,2297,696,167,63,230,3.2955523672883786,45.34381775164449
Task_14006,596,286,184,177,361,2.076655052264808,18.159524027463913
Task_14007,900,633,123,63,186,1.4195583596214512,22.77825067430197
Task_14008,2513,93,42,75,117,26.73404255319149,45.38223682711172
Task_14009,1565,428,177,132,309,3.648018648018648,33.64218860684408
Task_14010,1639,968,23,48,71,1.6914344685242517,34.13635499037311
Task_14011,1047,752,81,116,197,1.3904382470119523,25.926965852400432
Task_14012,2595,856,115,97,212,3.028004667444574,50.84678753054374
Task_14013,574,1013,80,176,256,0.5660749506903353,19.74132806423604
Task_14014,901,277,109,56,165,3.241007194244604,21.609125672831578
Task_14015,2508,341,39,12,51,7.333333333333333,45.602951440007416
Task_14016,1266,885,160,84,244,1.4288939051918736,29.85194475920514
Task_14017,1632,90,49,49,98,17.934065934065934,30.91252816590043
Task_14018,1282,813,159,149,308,1.574938574938575,30.347398240370456
Task_14019,1085,564,165,80,245,1.920353982300885,26.00941701877834
Task_14020,2964,137,55,142,197,21.47826086956522,53.95635895928873
Task_14021,2912,661,187,93,280,4.398791540785498,55.50980020602854
Task_14022,518,955,30,141,171,0.5418410041841004,18.085437438589665
Task_14023,1515,73,150,175,325,20.472972972972972,31.286198831322366
Task_14024,2025,384,40,170,210,5.259740259740259,40.39775007896434
Task_14025,2290,665,101,32,133,3.4384384384384385,44.309364265627885
Task_14026,2776,223,113,79,192,12.392857142857142,51.374666462073094
Task_14027,2597,1010,46,89,135,2.568743818001978,50.83738287103606
Task_14028,1382,163,43,25,68,8.426829268292684,27.377508676176948
Task_14029,2796,104,170,107,277,26.62857142857143,51.26698444651327
Task_14030,1342,1011,68,152,220,1.326086956521739,31.581051211705226
Task_14031,1495,405,185,118,303,3.6822660098522166,32.41295538799024
Task_14032,702,379,28,140,168,1.8473684210526315,19.151976904422455
Task_14033,1318,119,106,198,304,10.983333333333333,28.454118846242594
Task_14034,652,709,158,20,178,0.9183098591549296,18.871567644396624
Task_14035,1949,750,137,142,279,2.5952063914780292,40.61980578442742
Task_14036,2794,855,188,63,251,3.264018691588785,53.81175438508658
Task_14037,965,254,97,162,259,3.784313725490196,23.413571222357845
Task_14038,2143,309,96,162,258,6.912903225806452,42.215300501769775
Task_14039,2458,951,180,20,200,2.581932773109244,48.20837718659599
Task_14040,932,580,183,94,277,1.604130808950086,23.88070670206598
Task_14041,1267,248,99,41,140,5.088353413654619,26.769217702015652
Task_14042,2100,778,155,170,325,2.6957637997432604,43.34798353149748
Task_14043,1716,870,105,180,285,1.9701492537313432,37.38541964143733
Task_14044,902,835,112,195,307,1.0789473684210527,24.43301102445757
Task_14045,1602,879,198,91,289,1.8204545454545455,35.439723381628184
Task_14046,1055,698,151,174,325,1.5092989985693848,26.50717514632859
Task_14047,2332,555,71,58,129,4.194244604316546,44.93731581945059
Task_14048,2871,684,144,53,197,4.191240875912409,54.265224945603784
Task_14049,2026,465,66,130,196,4.347639484978541,40.62288896946888
Task_14050,2863,487,12,47,59,5.866803278688525,51.923592200778074
Task_14051,2610,531,157,160,317,4.906015037593985,50.59285039871154
Task_14052,1955,585,59,138,197,3.33617747440273,39.890351522993996
Task_14053,1901,76,54,182,236,24.68831168831169,36.969699831056836
Task_14054,509,907,64,69,133,0.5605726872246696,17.478004787394518
Task_14055,2456,996,65,186,251,2.4633901705115346,49.428917598044414
Task_14056,2558,776,183,179,362,3.292149292149292,50.77754710630148
Task_14057,506,72,129,186,315,6.931506849315069,15.464374253961452
Task_14058,1826,328,108,161,269,5.550151975683891,37.307108972426185
Task_14059,650,129,31,82,113,5.0,16.444396541040202
Task_14060,2830,942,130,162,292,3.0010604453870626,55.26691124479917
Task_14061,2509,715,26,107,133,3.5041899441340782,48.50713003409848
Task_14062,2100,376,180,97,277,5.570291777188329,41.77143933853485
Task_14063,2070,684,189,104,293,3.021897810218978,42.33689934877558
Task_14064,1861,635,150,168,318,2.9261006289308176,39.07888615554183
Task_14065,2478,488,68,119,187,5.067484662576687,47.7777974196863
Task_14066,1801,760,84,142,226,2.366622864651774,38.07747207332297
Task_14067,2103,889,165,122,287,2.3629213483146065,43.50055375410766
Task_14068,937,683,197,133,330,1.3698830409356726,24.54972126833786
Task_14069,1354,702,85,155,240,1.926031294452347,30.893674544325037
Task_14070,1400,512,177,102,279,2.729044834307992,31.118447467203058
Task_14071,1817,352,86,172,258,5.147308781869689,37.171313497760906
Task_14072,1469,674,117,178,295,2.176296296296296,32.9034231068078
Task_14073,1508,732,47,35,82,2.057298772169168,31.555693070878316
Task_14074,1495,550,196,143,339,2.7132486388384756,33.073051849926465
Task_14075,1164,323,58,10,68,3.5925925925925926,24.231764788260246
Task_14076,943,290,195,25,220,3.240549828178694,22.251509773071913
Task_14077,844,784,113,163,276,1.0751592356687898,23.169554949441352
Task_14078,2718,750,138,51,189,3.6191744340878826,51.9461526481684
Task_14079,1240,74,122,143,265,16.533333333333335,26.677348427391617
Task_14080,1969,871,174,186,360,2.25802752293578,41.74406934307588
Task_14081,2547,295,86,162,248,8.60472972972973,48.4616723498032
Task_14082,1164,249,28,166,194,4.656,26.23639317028766
Task_14083,2904,564,159,13,172,5.139823008849557,53.89469973994765
Task_14084,813,531,67,125,192,1.5281954887218046,21.561308597854914
Task_14085,951,874,81,190,271,1.086857142857143,25.1673998273511
Task_14086,1287,526,88,156,244,2.4421252371916506,29.253730966608277
Task_14087,2784,757,161,44,205,3.6728232189973613,52.873527426997306
Task_14088,2969,657,30,109,139,4.5121580547112465,55.6080437224639
Task_14089,2636,389,189,93,282,6.758974358974359,50.26701125158735
Task_14090,1986,638,81,121,202,3.107981220657277,40.529680798069634
Task_14091,1454,819,46,144,190,1.773170731707317,32.61192100668149
Task_14092,2157,376,160,139,299,5.721485411140583,42.80557207297911
Task_14093,675,402,138,28,166,1.6749379652605458,18.17801189658891
Task_14094,2905,316,136,84,220,9.16403785488959,53.92091548310889
Task_14095,2313,97,74,176,250,23.602040816326532,43.64798776445102
Task_14096,2805,677,40,171,211,4.1371681415929205,53.69546183867292
Task_14097,1239,144,128,68,196,8.544827586206896,26.392342610994834
Task_14098,1585,476,144,176,320,3.3228511530398324,34.226261744298284
Task_14099,960,350,154,150,304,2.735042735042735,23.823552800060455
Task_14100,2409,526,107,178,285,4.571157495256167,47.276488222648844
Task_14101,2877,863,114,69,183,3.329861111111111,54.81710051669007
Task_14102,1017,483,74,158,232,2.1012396694214877,24.894524346141797
Task_14103,1109,654,186,98,284,1.6931297709923665,26.966169786229283
Task_14104,1310,386,11,87,98,3.3850129198966408,27.926750887478374
Task_14105,2724,636,129,88,217,4.276295133437991,52.11866407623234
Task_14106,779,69,68,110,178,11.128571428571428,19.028312272116757
Task_14107,1785,955,127,62,189,1.8671548117154813,37.814416067722526
Task_14108,1308,568,78,27,105,2.298769771528998,28.062238552516416
Task_14109,2500,589,14,65,79,4.237288135593221,46.94755479387621
Task_14110,1231,146,27,86,113,8.374149659863946,25.668730148819293
Task_14111,1906,646,82,188,270,2.945904173106646,39.68124693793826
Task_14112,640,681,64,161,225,0.9384164222873901,19.43765635720059
Task_14113,945,970,166,144,310,0.9732234809474768,25.504568937565892
Task_14114,1508,79,131,52,183,18.85,29.908263026081112
Task_14115,1960,1018,102,73,175,1.9234543670264965,40.802165666064106
Task_14116,1714,73,23,148,171,23.16216216216216,33.50936474257045
Task_14117,666,845,127,192,319,0.7872340425531915,20.84248018211274
Task_14118,774,263,93,109,202,2.9318181818181817,20.121060272991386
Task_14119,1393,537,144,109,253,2.5892193308550184,30.979572943588284
Task_14120,1683,105,197,73,270,15.877358490566039,33.33214497723995
Task_14121,968,552,140,147,287,1.7504520795660037,24.49275044381581
Task_14122,953,705,67,115,182,1.3498583569405098,24.20700323587128
Task_14123,1400,534,193,57,250,2.616822429906542,30.678760926327538
Task_14124,2212,379,109,111,220,5.821052631578947,43.288579781909554
Task_14125,2158,897,90,68,158,2.403118040089087,43.316148241732016
Task_14126,2912,279,39,98,137,10.4,53.446034459100254
Task_14127,1752,463,70,45,115,3.7758620689655173,34.88139563776473
Task_14128,1017,371,169,85,254,2.7338709677419355,24.394674195033573
Task_14129,2931,81,63,18,81,35.74390243902439,50.84644591196218
Task_14130,1840,597,122,200,322,3.076923076923077,38.691463852948964
Task_14131,1359,755,153,105,258,1.7976190476190477,31.139818309094284
Task_14132,1557,862,21,103,124,1.8041714947856315,33.7725703797789
Task_14133,1268,607,68,129,197,2.085526315789474,29.07002481251584
Task_14134,1267,426,105,84,189,2.9672131147540983,28.228856399799152
Task_14135,1174,324,120,154,274,3.6123076923076924,26.995064246678833
Task_14136,943,761,42,149,191,1.23753280839895,24.266569412561477
Task_14137,518,242,45,23,68,2.1316872427983538,13.932450026721748
Task_14138,1453,241,167,98,265,6.0041322314049586,31.012726553783423
Task_14139,1660,448,106,49,155,3.6971046770601337,33.83829280310533
Task_14140,2431,1019,136,183,319,2.3833333333333333,49.33667397977081
Task_14141,1035,815,103,120,223,1.2683823529411764,25.99623095181993
Task_14142,1631,850,130,52,182,1.9165687426556992,35.04368786172739
Task_14143,905,693,180,13,193,1.3040345821325647,22.73623624124203
Task_14144,2591,502,32,63,95,5.151093439363817,48.43227044516386
Task_14145,1578,407,141,200,341,3.8676470588235294,34.024269824457754
Task_14146,1820,230,79,78,157,7.878787878787879,36.067604031212596
Task_14147,653,968,200,118,318,0.673890608875129,20.991519995904095
Task_14148,2004,514,52,128,180,3.89126213592233,40.325580740172235
Task_14149,852,781,11,113,124,1.0895140664961638,22.289846692034775
Task_14150,1171,562,162,200,362,2.079928952042629,28.16760891310447
Task_14151,1266,303,139,57,196,4.1644736842105265,27.574975627641027
Task_14152,2076,858,16,84,100,2.4167636786961584,41.63275525688353
Task_14153,860,258,103,199,302,3.3204633204633205,22.007933398556457
Task_14154,1099,796,194,184,378,1.3789209535759097,27.750961134091607
Task_14155,2950,98,28,89,117,29.7979797979798,52.34730946240481
Task_14156,1829,912,116,189,305,2.00328587075575,39.4098938142409
Task_14157,2473,141,189,96,285,17.41549295774648,46.57802863629312
Task_14158,2613,217,154,27,181,11.986238532110091,48.20884820133579
Task_14159,1710,65,26,45,71,25.90909090909091,31.2758806307645
Task_14160,2242,361,143,32,175,6.193370165745856,42.87209198866831
Task_14161,2384,145,30,117,147,16.328767123287673,44.174415252122536
Task_14162,1157,608,74,69,143,1.8998357963875205,26.62614349111337
Task_14163,2402,214,102,57,159,11.172093023255814,44.91806381851461
Task_14164,2036,851,123,59,182,2.3896713615023475,41.4033351277046
Task_14165,1860,276,51,170,221,6.714801444043322,37.56321271441517
Task_14166,837,395,26,38,64,2.1136363636363638,19.503720293312355
Task_14167,2347,246,25,165,190,9.502024291497976,44.88957684855433
Task_14168,2444,65,100,36,136,37.03030303030303,43.625571361309234
Task_14169,1433,200,46,194,240,7.129353233830845,30.605938233028287
Task_14170,1337,248,118,155,273,5.3694779116465865,29.31625615128519
Task_14171,2828,664,43,108,151,4.252631578947368,53.45865795984062
Task_14172,2359,745,91,32,123,3.1621983914209117,45.516557253501226
Task_14173,1959,897,19,30,49,2.181514476614699,38.79910484831355
Task_14174,1942,335,187,150,337,5.779761904761905,39.455459136917106
Task_14175,2006,874,178,62,240,2.2925714285714287,41.297157535776506
Task_14176,1427,159,196,40,236,8.91875,29.35646292920191
Task_14177,1195,160,72,105,177,7.422360248447205,26.08359292567839
Task_14178,919,683,107,51,158,1.3435672514619883,22.966614282367104
Task_14179,1509,415,179,161,340,3.6274038461538463,32.896447418129966
Task_14180,2463,713,177,152,329,3.4495798319327733,48.88604029700821
Task_14181,1312,962,158,179,337,1.3624091381100727,31.455405278583132
Task_14182,2228,991,107,125,232,2.245967741935484,45.55544491242009
Task_14183,2782,317,59,118,177,8.748427672955975,51.954182308030994
Task_14184,747,320,154,179,333,2.3271028037383177,20.532158121962247
Task_14185,1497,938,74,96,170,1.5942492012779552,33.53038427775354
Task_14186,2763,270,125,43,168,10.195571955719558,50.736717128835686
Task_14187,2922,838,78,110,188,3.4827175208581647,55.90731332221922
Task_14188,1599,347,191,47,238,4.594827586206897,32.97931329967181
Task_14189,1065,627,77,30,107,1.6958598726114649,24.40569085760936
Task_14190,2132,1009,180,76,256,2.110891089108911,43.95480095290477
Task_14191,1091,180,144,119,263,6.027624309392265,24.86980550340952
Task_14192,1276,879,40,116,156,1.45,29.537629180150656
Task_14193,2211,546,35,96,131,4.042047531992687,43.33136539228271
Task_14194,658,486,23,136,159,1.351129363449692,18.53246953676908
Task_14195,2741,597,199,57,256,4.583612040133779,52.14056705408319
Task_14196,2579,89,46,75,121,28.655555555555555,46.40194658096062
Task_14197,2865,106,124,165,289,26.77570093457944,52.50146884705271
Task_14198,2611,710,188,71,259,3.6722925457102673,50.54462278689505
Task_14199,2729,644,168,20,188,4.231007751937985,51.46952414708387
Task_14200,2759,338,184,17,201,8.138643067846608,50.9985146080447
Task_14201,1250,201,112,133,245,6.188118811881188,27.62031281461911
Task_14202,2860,680,15,195,210,4.199706314243759,54.58055636361373
Task_14203,2080,500,172,21,193,4.151696606786427,40.770201401507414
Task_14204,2547,399,106,90,196,6.3675,48.48482423948037
Task_14205,2611,422,83,95,178,6.1725768321513,49.569466634478715
Task_14206,1450,116,31,130,161,12.393162393162394,29.364915175845216
Task_14207,1938,414,150,10,160,4.669879518072289,37.96631302077695
Task_14208,1448,73,112,126,238,19.56756756756757,29.77370446902479
Task_14209,2221,683,103,62,165,3.247076023391813,43.787540174963446
Task_14210,1802,381,133,60,193,4.717277486910994,36.288202948737485
Task_14211,2001,619,98,112,210,3.22741935483871,40.68111013822439
Task_14212,593,758,144,64,208,0.7812911725955204,18.50395534731834
Task_14213,2612,850,193,154,347,3.0693301997649822,51.7609736097188
Task_14214,2021,229,157,149,306,8.78695652173913,40.19409028318662
Task_14215,1968,232,122,95,217,8.446351931330472,38.90114412614819
Task_14216,802,629,48,179,227,1.273015873015873,21.8816993491923
Task_14217,1689,962,196,121,317,1.7538940809968848,37.287781424546885
Task_14218,2525,612,94,18,112,4.1190864600326265,47.546153889151874
Task_14219,770,427,104,80,184,1.7990654205607477,20.28297533219919
Task_14220,2160,145,138,108,246,14.794520547945206,41.52005173114055
Task_14221,2105,546,26,32,58,3.8482632541133457,40.04392704850217
Task_14222,1987,861,162,123,285,2.305104408352668,41.56772209845506
Task_14223,2152,921,112,178,290,2.334056399132321,44.47230944894597
Task_14224,2739,713,189,37,226,3.8361344537815127,52.127619139462844
Task_14225,1091,422,29,60,89,2.57919621749409,24.244421662881383
Task_14226,2281,953,188,32,220,2.390985324947589,45.584937945249095
Task_14227,1361,871,185,99,284,1.5607798165137614,31.591721551895237
Task_14228,2783,406,25,92,117,6.837837837837838,51.6368046995105
Task_14229,1152,134,129,26,155,8.533333333333333,24.29610148846312
Task_14230,1940,817,15,34,49,2.371638141809291,38.267321378194524
Task_14231,1482,984,140,100,240,1.5045685279187817,33.66865020068423
Task_14232,1976,869,193,89,282,2.2712643678160918,41.31243478468634
Task_14233,746,593,41,59,100,1.2558922558922558,19.40611428729208
Task_14234,1326,960,109,183,292,1.379812695109261,31.46709385527639
Task_14235,1729,974,83,191,274,1.7733333333333334,37.903358313561284
Task_14236,1137,995,147,53,200,1.141566265060241,27.76447334979709
Task_14237,2927,1009,193,147,340,2.898019801980198,57.20762725023783
Task_14238,1483,921,185,73,258,1.6084598698481563,33.34508869247292
Task_14239,1186,105,135,138,273,11.18867924528302,25.998517193541716
Task_14240,922,709,53,61,114,1.2985915492957747,22.765584158888007
Task_14241,1028,539,106,66,172,1.9037037037037037,24.46582346750424
Task_14242,2418,741,30,38,68,3.2587601078167117,45.65698954938356
Task_14243,2825,368,48,189,237,7.6558265582655824,53.20055044188252
Task_14244,1407,452,50,181,231,3.1059602649006623,31.036668311351182
Task_14245,1875,432,172,151,323,4.330254041570439,38.652159263627844
Task_14246,2753,528,157,35,192,5.2041587901701325,51.59270242993495
Task_14247,1305,449,139,141,280,2.9,29.476717287273107
Task_14248,2637,462,142,15,157,5.695464362850972,49.16316984742503
Task_14249,640,882,52,53,105,0.72480181200453,18.84563352816615
Task_14250,1498,502,32,115,147,2.978131212723658,31.884575275014328
Task_14251,1863,319,192,115,307,5.821875,37.965911689772476
Task_14252,2471,789,112,93,205,3.1278481012658226,48.58995354266445
Task_14253,2753,369,20,176,196,7.440540540540541,51.78632019508303
Task_14254,1391,846,101,181,282,1.6422668240850058,32.13588909971771
Task_14255,1295,453,151,27,178,2.852422907488987,28.165929803697484
Task_14256,1863,988,175,16,191,1.8837209302325582,38.831571260657206
Task_14257,2048,846,102,197,299,2.4179456906729633,42.65901849441371
Task_14258,2057,366,84,58,142,5.604904632152588,39.967410198908155
Task_14259,858,746,86,82,168,1.1485943775100402,22.501543662740488
Task_14260,1386,670,118,102,220,2.0655737704918034,31.12681626175218
Task_14261,539,903,52,169,221,0.5962389380530974,18.687568378280663
Task_14262,2438,878,131,37,168,2.7736063708759953,47.57324325433717
Task_14263,2100,305,98,32,130,6.862745098039215,40.11221250303965
Task_14264,1619,365,12,138,150,4.423497267759563,33.34146283759936
Task_14265,1502,1002,55,181,236,1.497507477567298,34.21599751133042
Task_14266,713,76,193,46,239,9.25974025974026,17.378851507028553
Task_14267,2897,376,157,143,300,7.684350132625995,54.52348979657044
Task_14268,1227,102,41,27,68,11.912621359223301,24.469074716484144
Task_14269,1240,607,92,49,141,2.039473684210526,27.683396473356947
Task_14270,1200,653,22,166,188,1.834862385321101,28.045464632784128
Task_14271,2260,879,93,153,246,2.5681818181818183,45.85614266799041
Task_14272,2863,909,83,51,134,3.146153846153846,54.393782155409326
Task_14273,1232,469,199,180,379,2.6212765957446806,28.8880015981256
Task_14274,1453,457,22,58,80,3.1724890829694323,29.946152349553532
Task_14275,1170,908,192,153,345,1.2871287128712872,29.021662153661158
Task_14276,699,316,52,114,166,2.2050473186119874,18.94992666267856
Task_14277,1056,75,87,167,254,13.894736842105264,23.71465490564279
Task_14278,1519,608,82,101,183,2.4942528735632186,32.87516109253678
Task_14279,2999,1000,125,57,182,2.996003996003996,57.135632747279395
Task_14280,2220,368,67,90,157,6.016260162601626,42.98266637202786
Task_14281,1239,189,104,91,195,6.521052631578947,27.095426087478987
Task_14282,1091,819,177,90,267,1.3304878048780489,27.036825421851436
Task_14283,770,849,118,112,230,0.9058823529411765,21.964163668587542
Task_14284,597,322,138,173,311,1.848297213622291,18.058480868718345
Task_14285,1451,934,25,43,68,1.5518716577540106,30.96725240311058
Task_14286,1516,566,36,72,108,2.673721340388007,31.87609749812984
Task_14287,2338,980,65,106,171,2.383282364933741,46.97310845821744
Task_14288,2771,821,97,171,268,3.3710462287104623,53.86577215584649
Task_14289,724,138,24,29,53,5.2086330935251794,16.837752754072337
Task_14290,899,358,141,160,301,2.5041782729805013,22.885299801396343
Task_14291,724,361,190,66,256,2.0,19.50818601454291
Task_14292,2061,460,189,187,376,4.4707158351409975,41.97818241916515
Task_14293,2565,269,53,169,222,9.5,48.657999290801705
Task_14294,1756,793,157,187,344,2.211586901763224,38.05549905415688
Task_14295,691,970,42,173,215,0.7116374871266735,21.198242574340117
Task_14296,2920,198,121,141,262,14.673366834170855,54.09696282967502
Task_14297,1659,561,54,128,182,2.9519572953736657,35.00725273808523
Task_14298,1945,890,186,82,268,2.1829405162738498,40.78471645318002
Task_14299,1295,315,104,29,133,4.098101265822785,27.43097110374407
Task_14300,1671,373,87,90,177,4.467914438502674,34.39962854210411
Task_14301,2545,76,195,180,375,33.05194805194805,47.63228314523991
Task_14302,865,889,174,147,321,0.9719101123595506,24.040433153469735
Task_14303,2986,78,25,82,107,37.79746835443038,52.667130368505916
Task_14304,823,170,190,15,205,4.812865497076023,19.669211108834688
Task_14305,1962,949,173,12,185,2.0652631578947367,40.246482780623666
Task_14306,1613,347,115,46,161,4.635057471264368,32.72303707409037
Task_14307,1524,76,122,57,179,19.792207792207794,30.089174012218603
Task_14308,830,449,74,162,236,1.8444444444444446,21.851556177597796
Task_14309,2725,695,174,27,201,3.9152298850574714,51.69173488206925
Task_14310,1091,119,89,188,277,9.091666666666667,24.733231575227524
Task_14311,2260,387,170,185,355,5.824742268041237,44.79146871958593
Task_14312,1870,935,150,184,334,1.9978632478632479,40.254463265413044
Task_14313,832,369,99,149,248,2.2486486486486488,21.60703697347029
Task_14314,1308,998,200,105,305,1.3093093093093093,31.250803202659522
Task_14315,2042,658,145,153,298,3.0986342943854326,41.905936633368995
Task_14316,1992,903,54,64,118,2.2035398230088497,40.497835663144805
Task_14317,1198,574,151,86,237,2.083478260869565,27.835931526943593
Task_14318,1285,643,58,73,131,1.9953416149068324,28.821986399637808
Task_14319,2305,538,96,72,168,4.276437847866419,44.73099885983996
Task_14320,1756,406,21,130,151,4.314496314496314,35.65294337374851
Task_14321,1179,545,56,145,201,2.159340659340659,27.50431140489521
Task_14322,2873,858,52,93,145,3.3445867287543654,54.85822529269032
Task_14323,624,247,60,128,188,2.5161290322580645,17.68111941532879
Task_14324,1680,475,169,44,213,3.5294117647058822,34.532069061871056
Task_14325,2276,142,63,30,93,15.916083916083917,41.47878299090764
Task_14326,2356,824,100,92,192,2.855757575757576,46.78026146261329
Task_14327,1765,348,172,173,345,5.0573065902578795,36.76887601404984
Task_14328,2606,434,192,33,225,5.99080459770115,49.104464878116886
Task_14329,1713,266,17,12,29,6.415730337078652,32.5690719895068
Task_14330,1174,300,73,195,268,3.9003322259136213,27.0097216397053
Task_14331,504,496,159,62,221,1.0140845070422535,16.16998498303499
Task_14332,2842,665,115,16,131,4.267267267267267,52.93861977530233
Task_14333,1794,260,72,42,114,6.873563218390805,34.897941999302454
Task_14334,2632,241,152,145,297,10.87603305785124,49.84383057617796
Task_14335,2276,650,165,106,271,3.49615975422427,45.396374991316975
Task_14336,2158,821,161,25,186,2.625304136253041,43.00055360702228
Task_14337,1145,67,101,95,196,16.83823529411765,24.822119696324943
Task_14338,2898,878,143,50,193,3.2969283276450514,55.10439975336132
Task_14339,1426,752,170,76,246,1.8937583001328022,31.923645310196036
Task_14340,1507,143,131,187,318,10.465277777777779,31.652927359275242
Task_14341,842,781,31,17,48,1.0767263427109974,20.696440629367178
Task_14342,701,1015,10,148,158,0.6899606299212598,21.086502673399725
Task_14343,586,454,134,165,299,1.287912087912088,18.17180973536524
Task_14344,1036,478,198,149,347,2.162839248434238,25.624126034305732
Task_14345,2012,373,58,17,75,5.379679144385027,37.85708813240897
Task_14346,1521,242,131,144,275,6.2592592592592595,32.195433688287594
Task_14347,985,546,175,126,301,1.8007312614259599,24.78891461760149
Task_14348,2777,514,147,23,170,5.392233009708738,51.725703490324946
Task_14349,2839,954,103,83,186,2.972774869109948,54.744277732245244
Task_14350,656,1000,76,87,163,0.6553446553446554,20.467577286691093
Task_14351,2202,265,187,76,263,8.278195488721805,42.71152051810969
Task_14352,565,465,118,106,224,1.2124463519313304,17.445898091174524
Task_14353,1655,414,47,34,81,3.9879518072289155,32.90153822258029
Task_14354,984,666,74,49,123,1.4752623688155921,23.551998465988007
Task_14355,1180,1017,22,69,91,1.1591355599214146,27.719185923469258
Task_14356,1104,276,107,163,270,3.9855595667870034,25.72633751427875
Task_14357,1496,358,74,148,222,4.167130919220056,32.01610690058916
Task_14358,2307,466,82,193,275,4.940042826552463,45.48710860536344
Task_14359,1507,113,158,20,178,13.219298245614034,29.87375448836352
Task_14360,1169,249,162,190,352,4.676,27.072669058001598
Task_14361,2803,270,182,34,216,10.343173431734318,51.61743610500985
Task_14362,559,489,41,161,202,1.1408163265306122,17.396794456400993
Task_14363,2756,336,171,199,370,8.178041543026707,52.55363359458801
Task_14364,2424,724,59,108,167,3.343448275862069,47.52786042032728
Task_14365,2165,345,127,87,214,6.257225433526012,42.307991625273765
Task_14366,1323,856,145,15,160,1.543757292882147,29.56293547402799
Task_14367,925,805,11,10,21,1.1476426799007444,21.854726597190027
Task_14368,1325,904,104,43,147,1.4640883977900552,29.839001523505377
Task_14369,1284,98,122,87,209,12.969696969696969,26.946996302747007
Task_14370,890,286,29,41,70,3.1010452961672472,20.013848550030982
Task_14371,2274,509,153,176,329,4.458823529411765,45.27987937922253
Task_14372,567,856,167,190,357,0.661610268378063,19.565202322228483
Task_14373,1552,569,41,108,149,2.7228070175438597,32.96870458167527
Task_14374,1820,441,101,149,250,4.117647058823529,37.478785426525604
Task_14375,1551,416,70,161,231,3.7194244604316546,33.14548399494135
Task_14376,2088,630,109,48,157,3.3090332805071316,41.13313921192569
Task_14377,897,634,19,179,198,1.4125984251968504,23.216340534581274
Task_14378,1248,601,190,52,242,2.0730897009966776,28.49152532792598
Task_14379,1951,444,76,68,144,4.384269662921349,38.67795036604259
Task_14380,518,742,108,193,301,0.6971736204576043,18.166183981454065
Task_14381,835,881,63,137,200,0.9467120181405896,22.999872794456497
Task_14382,1389,360,192,17,209,3.847645429362881,29.437792491666084
Task_14383,2799,464,118,175,293,6.019354838709678,53.28115015644397
Task_14384,2185,310,198,144,342,7.02572347266881,43.22734979642366
Task_14385,2869,550,196,123,319,5.206896551724138,54.70978030190414
Task_14386,2966,800,124,161,285,3.7028714107365794,56.94347166183343
Task_14387,2250,867,177,71,248,2.5921658986175116,45.26843341810292
Task_14388,967,196,130,107,237,4.908629441624366,23.077749868679536
Task_14389,2129,611,157,105,262,3.4787581699346406,42.90285004080432
Task_14390,1056,396,130,77,207,2.6599496221662466,24.778649499125567
Task_14391,1064,336,198,187,385,3.1572700296735907,25.842887914511365
Task_14392,1170,955,86,81,167,1.2238493723849373,28.096954464283826
Task_14393,2468,904,51,162,213,2.7270718232044198,49.15415179294565
Task_14394,1554,582,99,134,233,2.665523156089194,33.61886791230138
Task_14395,2218,842,83,125,208,2.631079478054567,44.860002424128616
Task_14396,1194,584,57,10,67,2.041025641025641,25.52927588024495
Task_14397,850,328,15,45,60,2.5835866261398177,19.524517508746047
Task_14398,2713,394,128,200,328,6.868354430379747,51.882699069847796
Task_14399,2380,593,113,119,232,4.006734006734007,46.70604591881162
Task_14400,654,195,44,23,67,3.336734693877551,16.087931593423768
Task_14401,2751,580,181,92,273,4.734939759036145,52.63310271852433
Task_14402,2538,324,27,143,170,7.809230769230769,48.02642294355278
Task_14403,2584,278,86,92,178,9.261648745519713,48.50442881988892
Task_14404,2261,965,166,80,246,2.3405797101449277,45.89517684806659
Task_14405,1454,187,145,20,165,7.73404255319149,29.78869007890347
Task_14406,1444,381,77,13,90,3.7801047120418847,29.45446911677853
Task_14407,1567,183,110,67,177,8.516304347826088,31.852800524859415
Task_14408,1082,616,118,150,268,1.753646677471637,26.41664735656526
Task_14409,2908,411,139,74,213,7.058252427184466,54.14384198282017
Task_14410,950,448,140,31,171,2.115812917594655,22.653690954424587
Task_14411,1614,384,68,87,155,4.1922077922077925,33.43173626981153
Task_14412,2522,408,28,190,218,6.166259168704157,48.38660467128643
Task_14413,1554,806,196,128,324,1.9256505576208178,34.71907227965923
Task_14414,2839,241,14,50,64,11.731404958677686,50.787460749822095
Task_14415,2913,346,57,96,153,8.394812680115274,53.83896469033001
Task_14416,1605,68,123,160,283,23.26086956521739,32.462221149503556
Task_14417,1278,437,112,195,307,2.9178082191780823,29.212086171208572
Task_14418,2045,210,184,91,275,9.691943127962086,40.222434491782096
Task_14419,1210,606,148,196,344,1.9934102141680394,28.835947508759233
Task_14420,2454,256,132,133,265,9.54863813229572,46.92547094114759
Task_14421,1919,517,32,138,170,3.7046332046332044,38.86566907544156
Task_14422,2718,762,62,108,170,3.562254259501966,52.317795722522796
Task_14423,2326,557,146,199,345,4.168458781362007,46.36276474119088
Task_14424,2994,167,42,152,194,17.821428571428573,54.57701908548487
Task_14425,2956,771,186,200,386,3.8290155440414506,57.20605406212093
Task_14426,683,1011,191,188,379,0.674901185770751,21.97717485412949
Task_14427,765,300,123,190,313,2.5415282392026577,20.678786870757506
Task_14428,1299,655,37,183,220,1.9801829268292683,29.844580659038368
Task_14429,2336,705,130,48,178,3.308781869688385,45.51936128975867
Task_14430,1807,128,165,199,364,14.007751937984496,36.49286610283613
Task_14431,1020,366,24,10,34,2.779291553133515,21.96471746303588
Task_14432,1128,187,19,48,67,6.0,23.671806463717818
Task_14433,2048,136,194,109,303,14.94890510948905,39.919932243046674
Task_14434,1924,538,68,26,94,3.569573283858998,37.645599882014146
Task_14435,1289,564,97,116,213,2.28141592920354,29.25539987628299
Task_14436,524,74,116,146,262,6.986666666666666,15.460788023544152
Task_14437,883,255,113,55,168,3.44921875,21.207696269057823
Task_14438,2866,593,42,99,141,4.824915824915825,53.781518052752055
Task_14439,690,160,123,182,305,4.285714285714286,18.80621600463066
Task_14440,1060,335,124,51,175,3.1547619047619047,24.303624794059914
Task_14441,1057,524,31,28,59,2.013333333333333,23.379750368965876
Task_14442,2788,118,56,194,250,23.428571428571427,51.352662993289435
Task_14443,2255,137,139,128,267,16.340579710144926,43.05121297382124
Task_14444,1596,788,25,25,50,2.0228136882129277,32.69051133981231
Task_14445,1548,700,55,101,156,2.2082738944365192,33.37413824226829
Task_14446,2736,824,40,127,167,3.3163636363636364,52.75281855488932
Task_14447,2687,72,45,51,96,36.80821917808219,47.25899684798838
Task_14448,1626,618,149,165,314,2.626817447495961,35.28113841576678
Task_14449,2386,871,65,112,177,2.7362385321100917,47.46200610826795
Task_14450,2738,886,161,133,294,3.0868094701240136,53.600464917103956
Task_14451,1239,788,24,47,71,1.570342205323194,27.18419487007637
Task_14452,578,896,163,38,201,0.6443701226309922,18.640925344610338
Task_14453,2740,750,149,14,163,3.648468708388815,51.85127370035183
Task_14454,1837,623,186,97,283,2.9439102564102564,38.427555900434314
Task_14455,1197,708,34,51,85,1.688293370944993,26.788036256606166
Task_14456,647,969,87,14,101,0.6670103092783505,19.118790677576797
Task_14457,1985,598,17,198,215,3.313856427378965,40.463930361471576
Task_14458,2828,346,16,118,134,8.14985590778098,52.324816493417245
Task_14459,1275,958,200,134,334,1.329509906152242,30.77721232068097
Task_14460,2037,535,106,154,260,3.800373134328358,41.26749325603415
Task_14461,1687,187,132,130,262,8.97340425531915,34.565800746307666
Task_14462,1128,761,16,106,122,1.4803149606299213,26.540478785083682
Task_14463,2949,1003,123,65,188,2.937250996015936,56.44931673723667
Task_14464,673,496,124,197,321,1.3541247484909458,19.840345341908133
Task_14465,2609,439,45,141,186,5.929545454545455,49.65439692708198
Task_14466,1060,436,171,92,263,2.425629290617849,25.35758075074384
Task_14467,1006,823,60,108,168,1.220873786407767,25.306226816359473
Task_14468,2271,177,182,62,244,12.758426966292134,43.03893924090795
Task_14469,2204,555,173,143,316,3.964028776978417,44.21177906361702
Task_14470,1469,891,187,193,380,1.6468609865470851,33.970790827105056
Task_14471,886,343,157,92,249,2.5755813953488373,22.24598319806874
Task_14472,2815,609,74,28,102,4.614754098360656,52.06164566118044
Task_14473,1717,850,72,137,209,2.017626321974148,36.9933987122876
Task_14474,1422,724,131,106,237,1.9613793103448276,31.948073693056127
Task_14475,2536,775,85,145,230,3.268041237113402,49.787119039209074
Task_14476,1846,681,101,41,142,2.7067448680351904,37.334120922985186
Task_14477,832,276,185,177,362,3.003610108303249,21.862296523810013
Task_14478,2960,890,50,78,128,3.3221099887766554,56.401592155051
Task_14479,1873,870,162,16,178,2.1504018369690012,38.55365082706383
Task_14480,1117,581,44,150,194,1.9192439862542956,26.55815836312757
Task_14481,1502,976,25,28,53,1.5373592630501536,31.8619129401724
Task_14482,1618,319,108,52,160,5.05625,32.959072693352454
Task_14483,2092,385,151,45,196,5.419689119170984,40.67857035070141
Task_14484,2468,934,179,71,250,2.639572192513369,48.94083956179804
Task_14485,1380,384,21,183,204,3.5844155844155843,30.1564854809083
Task_14486,1698,77,121,46,167,21.76923076923077,32.500005131618714
Task_14487,895,272,91,108,199,3.2783882783882783,22.00856939305861
Task_14488,2535,263,102,70,172,9.602272727272727,47.40680761712026
Task_14489,1037,956,196,47,243,1.083594566353187,26.01000482768218
Task_14490,1996,86,131,161,292,22.942528735632184,38.705489896678614
Task_14491,899,231,175,12,187,3.875,21.15698390254882
Task_14492,638,972,109,146,255,0.6557040082219938,20.525566233788272
Task_14493,2822,468,46,182,228,6.017057569296376,53.40938214480218
Task_14494,1489,68,113,153,266,21.579710144927535,30.56172725522713
Task_14495,1762,667,82,47,129,2.6377245508982035,35.98860669369212
Task_14496,2431,402,181,135,316,6.032258064516129,47.29779651401566
Task_14497,568,938,67,54,121,0.6048988285410011,18.081494502913042
Task_14498,664,226,43,148,191,2.9251101321585904,18.248253727129324
Task_14499,1329,910,140,193,333,1.4588364434687158,31.5591530576458
Task_14500,665,674,36,101,137,0.9851851851851852,19.108739648342574
Task_14501,571,1015,97,58,155,0.562007874015748,18.675043875431903
Task_14502,2999,437,67,158,225,6.84703196347032,56.100724799671234
Task_14503,1808,876,175,76,251,2.0615735461801594,38.3844712308504
Task_14504,680,286,54,179,233,2.3693379790940767,18.98343834428219
Task_14505,2919,184,193,53,246,15.778378378378378,53.54894554191939
Task_14506,2291,187,147,35,182,12.186170212765957,43.114334991020144
Task_14507,791,678,40,150,190,1.1649484536082475,21.581667756302878
Task_14508,1953,617,60,50,110,3.1601941747572817,38.51926453166839
Task_14509,1174,179,44,162,206,6.522222222222222,25.905692964237048
Task_14510,2834,1007,47,43,90,2.8115079365079363,53.492165342166395
Task_14511,616,137,76,76,152,4.463768115942029,16.205496440587414
Task_14512,812,579,87,170,257,1.4,21.92249371143232
Task_14513,2029,516,118,161,279,3.9245647969052224,41.17609805592168
Task_14514,616,401,159,57,216,1.5323383084577114,17.681340748244065
Task_14515,894,111,101,183,284,7.982142857142857,21.562976208002727
Task_14516,647,484,49,198,247,1.334020618556701,19.14756295828329
Task_14517,2824,586,115,58,173,4.810902896081772,53.01879332111586
Task_14518,2583,350,78,199,277,7.358974358974359,49.51311197123769
Task_14519,2723,853,123,177,300,3.1885245901639343,53.35097450419689
Task_14520,2241,122,47,107,154,18.21951219512195,41.74760803019129
Task_14521,1131,773,22,58,80,1.4612403100775193,25.82364679488217
Task_14522,2122,430,155,92,247,4.923433874709977,42.07395243517773
Task_14523,1844,911,184,60,244,2.0219298245614037,38.85671656401099
Task_14524,552,1019,166,96,262,0.5411764705882353,19.30103978425473
Task_14525,1791,732,111,47,158,2.4433833560709415,36.74451492329409
Task_14526,2785,884,153,99,252,3.146892655367232,54.09381177869883
Task_14527,1844,422,137,21,158,4.359338061465721,36.51896673788019
Task_14528,543,212,62,82,144,2.5492957746478875,15.90560945058744
Task_14529,549,953,84,66,150,0.5754716981132075,18.23231060394705
Task_14530,937,315,43,165,208,2.9651898734177213,22.953413511028753
Task_14531,2102,664,91,71,162,3.1609022556390975,41.813385874558385
Task_14532,907,335,161,118,279,2.699404761904762,22.777670051570023
Task_14533,2236,587,43,18,61,3.802721088435374,42.14032696448323
Task_14534,1845,76,53,33,86,23.961038961038962,33.84679470194482
Task_14535,1597,986,183,64,247,1.618034447821682,35.24720136903015
Task_14536,812,711,175,185,360,1.1404494382022472,22.846121362198136
Task_14537,2619,249,151,159,310,10.476,49.747630794216015
Task_14538,2388,748,143,45,188,3.1882510013351135,46.475952251224186
Task_14539,800,349,58,47,105,2.2857142857142856,19.243863805232724
Task_14540,953,382,180,155,335,2.4882506527415145,23.961861455911873
Task_14541,1867,285,51,36,87,6.527972027972028,35.78548834412073
Task_14542,2390,413,176,144,320,5.7729468599033815,46.71655671141266
Task_14543,2727,683,119,64,183,3.986842105263158,51.87383723882291
Task_14544,1584,925,83,178,261,1.7105831533477323,35.37589951832842
Task_14545,1250,116,166,117,283,10.683760683760683,27.112410894278607
Task_14546,2778,521,157,136,293,5.32183908045977,53.07714368031274
Task_14547,2910,299,200,174,374,9.7,54.8401277299119
Task_14548,1314,141,132,77,209,9.253521126760564,27.690537967959283
Task_14549,1018,784,82,20,102,1.2968152866242038,24.0436231544617
Task_14550,2562,844,97,36,133,3.0319526627218933,49.166499583344454
Task_14551,1838,800,17,39,56,2.2946317103620473,36.61439066882894
Task_14552,1813,466,178,115,293,3.8822269807280514,37.59230175956179
Task_14553,1108,763,72,98,170,1.450261780104712,26.75192571124063
Task_14554,2831,363,72,88,160,7.777472527472527,52.60387654565209
Task_14555,2158,440,173,92,265,4.893424036281179,42.75736626430608
Task_14556,2222,953,18,194,212,2.3291404612159328,45.3374408858721
Task_14557,2578,764,116,152,268,3.369934640522876,50.59342912756396
Task_14558,2262,145,92,100,192,15.493150684931507,42.876316478717435
Task_14559,1631,186,124,58,182,8.72192513368984,32.930482326599346
Task_14560,932,557,35,149,184,1.6702508960573477,23.45707880460812
Task_14561,1436,858,105,23,128,1.6717112922002328,31.396969926331852
Task_14562,2350,338,187,145,332,6.932153392330384,45.8886878139355
Task_14563,1704,140,141,52,193,12.085106382978724,33.64910156803936
Task_14564,1020,965,148,170,318,1.0559006211180124,26.72557912834951
Task_14565,2800,902,188,49,237,3.10077519379845,53.83186029648831
Task_14566,1830,393,193,154,347,4.644670050761421,37.9260095604618
Task_14567,2640,66,54,110,164,39.40298507462686,47.940665044868894
Task_14568,1969,533,60,169,229,3.6872659176029963,40.13610068887578
Task_14569,1988,795,70,62,132,2.4974874371859297,40.28267355060729
Task_14570,1043,899,158,64,222,1.1588888888888889,26.06868340314237
Task_14571,2572,130,183,14,197,19.633587786259543,46.93448420751483
Task_14572,1514,608,106,46,152,2.4860426929392445,31.898026894245977
Task_14573,512,626,58,118,176,0.8165869218500797,16.964097056692008
Task_14574,661,160,181,36,217,4.105590062111801,17.224084901426128
Task_14575,1471,498,35,163,198,2.9478957915831665,31.936754610738067
Task_14576,2724,324,43,28,71,8.381538461538462,49.16642867071736
Task_14577,1102,103,77,186,263,10.596153846153847,24.791498787335343
Task_14578,564,860,47,44,91,0.6550522648083623,17.50217078569354
Task_14579,2325,750,98,27,125,3.095872170439414,44.97625599819434
Task_14580,2628,704,184,108,292,3.727659574468085,51.24007958158128
Task_14581,2177,816,198,139,337,2.664626682986536,44.69541565558427
Task_14582,773,566,165,119,284,1.36331569664903,21.36065665363547
Task_14583,558,234,116,88,204,2.374468085106383,16.494926593700367
Task_14584,2537,909,40,114,154,2.7879120879120878,49.61760091607292
Task_14585,912,453,130,76,206,2.0088105726872247,22.668531638003856
Task_14586,2727,902,64,147,211,3.0199335548172757,53.19293732941278
Task_14587,1506,329,118,91,209,4.5636363636363635,31.82165333200761
Task_14588,1366,713,56,34,90,1.9131652661064427,29.235731972394806
Task_14589,2851,537,116,114,230,5.299256505576208,53.96849357797066
Task_14590,2811,408,134,37,171,6.872860635696822,51.98920780464558
Task_14591,1913,291,199,113,312,6.551369863013699,38.68105612958206
Task_14592,2086,242,88,176,264,8.584362139917696,41.07741542940186
Task_14593,2165,975,196,29,225,2.2182377049180326,43.82962414176705
Task_14594,1419,740,52,89,141,1.9149797570850202,31.398948561125867
Task_14595,2832,624,180,111,291,4.5312,54.217289695936906
Task_14596,2614,505,158,177,335,5.16600790513834,50.678294220415886
Task_14597,520,556,113,117,230,0.933572710951526,17.101628224413382
Task_14598,1982,265,87,81,168,7.451127819548872,38.80147832945796
Task_14599,2367,890,51,185,236,2.6565656565656566,47.6474440102379
Task_14600,1287,384,192,59,251,3.342857142857143,28.41027354249405
Task_14601,1186,522,166,150,316,2.2676864244741872,27.998957009233123
Task_14602,704,642,81,160,241,1.0948678071539657,20.360335139556103
Task_14603,627,590,33,84,117,1.0609137055837563,18.050601367782807
Task_14604,729,298,198,50,248,2.4381270903010033,19.175705356125988
Task_14605,1303,167,168,43,211,7.755952380952381,27.336514123524964
Task_14606,1464,210,88,124,212,6.938388625592417,30.827678126376203
Task_14607,2848,178,137,141,278,15.910614525139664,52.661475967569594
Task_14608,2734,503,171,161,332,5.424603174603175,52.53462898506084
Task_14609,1465,197,74,32,106,7.398989898989899,29.401193260966227
Task_14610,1626,296,127,26,153,5.474747474747475,32.6486812840173
Task_14611,533,745,150,75,225,0.7144772117962467,17.784388944631598
Task_14612,2982,1017,141,156,297,2.9292730844793713,57.92358034448328
Task_14613,541,729,148,144,292,0.7410958904109589,18.25341752695326
Task_14614,710,832,195,60,255,0.8523409363745498,20.7337722826253
Task_14615,1626,685,156,104,260,2.370262390670554,35.158430391920625
Task_14616,725,323,146,182,328,2.2376543209876543,20.17567412070264
Task_14617,2370,641,21,159,180,3.691588785046729,46.483814169472225
Task_14618,2676,704,74,60,134,3.795744680851064,50.858013413008585
Task_14619,1958,823,142,44,186,2.3762135922330097,39.894910222633946
Task_14620,2267,153,197,86,283,14.720779220779221,43.275514888333845
Task_14621,2273,269,91,65,156,8.41851851851852,43.122909042519744
Task_14622,1236,705,17,173,190,1.7507082152974505,28.77056102084164
Task_14623,1594,801,25,195,220,1.9875311720698254,34.952361208241705
Task_14624,832,925,194,137,331,0.8984881209503239,23.677864023949414
Task_14625,2502,409,132,60,192,6.102439024390244,47.4519398712861
Task_14626,1495,844,179,180,359,1.7692307692307692,34.123045796861675
Task_14627,771,756,142,81,223,1.0184940554821664,21.483002883691608
Task_14628,1684,172,48,38,86,9.734104046242775,32.464131597362844
Task_14629,2079,313,89,194,283,6.6210191082802545,41.34784600400686
Task_14630,2323,97,151,61,212,23.70408163265306,42.912181727079975
Task_14631,1529,120,147,29,176,12.636363636363637,30.41900211035475
Task_14632,2572,360,117,39,156,7.124653739612189,47.89427016723973
Task_14633,2656,988,127,188,315,2.685540950455005,52.795002411875714
Task_14634,2726,95,104,58,162,28.395833333333332,48.862658103565856
Task_14635,2279,293,54,64,118,7.7517006802721085,43.087083573080974
Task_14636,888,660,156,84,240,1.3434190620272315,23.154134724416725
Task_14637,805,775,81,176,257,1.0373711340206186,22.464599879511116
Task_14638,1669,487,191,181,372,3.4200819672131146,35.832730488966924
Task_14639,1368,967,11,166,177,1.4132231404958677,31.554138989930767
Task_14640,2595,647,60,95,155,4.00462962962963,49.821683936813464
Task_14641,932,1012,102,33,135,0.9200394866732478,23.958742903340895
Task_14642,2077,660,126,79,205,3.1422087745839637,41.8367587331807
Task_14643,1925,607,194,107,301,3.1661184210526314,39.83817253001099
Task_14644,1788,362,177,138,315,4.925619834710743,36.99233074685526
Task_14645,1673,841,124,98,222,1.986935866983373,36.21724163763379
Task_14646,990,665,184,155,339,1.4864864864864864,25.41021167847249
Task_14647,1490,893,199,171,370,1.6666666666666667,34.232427646632544
Task_14648,990,129,28,182,210,7.615384615384615,22.869783148228183
Task_14649,2476,163,165,123,288,15.097560975609756,46.80363795046739
Task_14650,1584,528,84,86,170,2.9943289224952743,33.47659066279669
Task_14651,1268,327,87,161,248,3.8658536585365852,28.344746064446298
Task_14652,1041,1002,193,164,357,1.0378863409770689,27.33975221974315
Task_14653,759,232,148,72,220,3.257510729613734,19.55050451502362
Task_14654,1550,957,185,116,301,1.6179540709812108,34.9901766634296
Task_14655,989,885,87,32,119,1.1162528216704288,24.13576067202418
Task_14656,630,806,40,147,187,0.7806691449814126,19.42848332122509
Task_14657,1318,156,175,115,290,8.394904458598726,28.524598804232166
Task_14658,1038,272,192,102,294,3.802197802197802,24.688729550226252
Task_14659,1698,437,165,57,222,3.8767123287671232,34.96151575135456
Task_14660,1885,646,62,134,196,2.9134466769706338,38.96104237306397
Task_14661,861,1022,75,177,252,0.841642228739003,24.14657779225716
Task_14662,2139,526,45,65,110,4.0588235294117645,41.58860977732139
Task_14663,2474,867,146,47,193,2.8502304147465436,48.28311436031706
Task_14664,2071,269,165,81,246,7.67037037037037,40.65359043004339
Task_14665,1883,266,120,199,319,7.052434456928839,38.27801482156856
Task_14666,635,542,200,143,343,1.1694290976058932,19.389120596649956
Task_14667,912,399,193,23,216,2.28,22.086730895866634
Task_14668,2757,923,89,11,100,2.9837662337662336,52.03255124709432
Task_14669,1239,392,99,29,128,3.1526717557251906,26.867566249972274
Task_14670,1992,227,16,63,79,8.736842105263158,37.6993936949387
Task_14671,844,921,187,122,309,0.9154013015184381,23.72301140412057
Task_14672,1552,742,167,154,321,2.088829071332436,34.512541983247026
Task_14673,2605,873,137,179,316,2.980549199084668,51.618995385745414
Task_14674,2296,206,59,120,179,11.091787439613526,43.87855261917872
Task_14675,2144,218,62,175,237,9.789954337899543,41.88983887740694
Task_14676,2763,527,109,13,122,5.232954545454546,51.06157847672487
Task_14677,736,205,80,45,125,3.5728155339805827,18.0712434224478
Task_14678,1145,886,197,182,379,1.29086809470124,28.753125759705274
Task_14679,1094,493,87,143,230,2.214574898785425,26.013630916414144
Task_14680,2042,334,95,82,177,6.095522388059702,40.128948976319926
Task_14681,1667,750,104,157,261,2.219707057256991,36.093277343973554
Task_14682,2180,561,170,134,304,3.8790035587188614,43.783585926802154
Task_14683,1149,65,80,66,146,17.40909090909091,23.881732784463342
Task_14684,1431,495,138,75,213,2.8850806451612905,31.04190927627855
Task_14685,1776,1022,99,125,224,1.7360703812316716,38.441045004268496
Task_14686,743,255,115,169,284,2.90234375,20.02424169206515
Task_14687,2600,214,133,53,186,12.093023255813954,48.3311266064768
Task_14688,2336,749,110,99,209,3.1146666666666665,46.36294701891678
Task_14689,2381,73,82,97,179,32.17567567567568,44.10679409249525
Task_14690,1902,857,36,152,188,2.2167832167832167,39.81486482405918
Task_14691,936,464,99,190,289,2.0129032258064514,23.797534748965756
Task_14692,2812,944,156,134,290,2.9756613756613755,54.93787281576882
Task_14693,2750,918,163,82,245,2.9923830250272037,53.52395344377263
Task_14694,777,326,127,116,243,2.376146788990826,20.52773410841964
Task_14695,2436,1006,40,37,77,2.4190665342601787,46.82192118377669
Task_14696,1760,791,80,151,231,2.2222222222222223,37.60386334591431
Task_14697,706,857,139,37,176,0.8228438228438228,20.181878748389213
Task_14698,931,785,20,37,57,1.1844783715012723,22.353629500198196
Task_14699,1767,836,196,194,390,2.111111111111111,38.581401490641916
Task_14700,1369,888,32,33,65,1.5399325084364455,29.450779649756047
Task_14701,1258,896,105,111,216,1.4024526198439242,29.74315938366038
Task_14702,2771,999,92,123,215,2.771,54.11337525196114
Task_14703,2663,955,35,196,231,2.7855648535564854,52.45031595169294
Task_14704,2906,551,120,171,291,5.2644927536231885,55.24303674504773
Task_14705,2363,413,118,57,175,5.707729468599034,45.17551225026106
Task_14706,2682,215,103,39,142,12.416666666666666,49.0239416533804
Task_14707,1394,146,164,31,195,9.482993197278912,28.60782630490709
Task_14708,2203,714,146,200,346,3.081118881118881,44.917579448984384
Task_14709,768,893,44,97,141,0.8590604026845637,21.515119391690003
Task_14710,2400,634,99,58,157,3.779527559055118,46.29619696010433
Task_14711,1654,569,107,21,128,2.9017543859649124,33.93829284981325
Task_14712,2442,100,171,86,257,24.178217821782177,45.393128969698914
Task_14713,2109,699,75,63,138,3.012857142857143,41.93582213592748
Task_14714,1793,610,34,115,149,2.934533551554828,36.924761748325146
Task_14715,562,618,109,38,147,0.9079159935379645,16.977560286330704
Task_14716,577,486,145,143,288,1.1848049281314168,18.04872477828368
Task_14717,611,637,45,36,81,0.957680250783699,17.26159208991199
Task_14718,2071,952,150,107,257,2.1731374606505773,43.03248493181943
Task_14719,1894,147,63,157,220,12.797297297297296,37.35053443877916
Task_14720,2500,319,131,52,183,7.8125,47.107060067666225
Task_14721,2633,438,86,172,258,5.997722095671982,50.3664335884913
Task_14722,2613,324,23,89,112,8.04,48.62328297870959
Task_14723,1259,624,163,157,320,2.0144,29.50291103617441
Task_14724,785,321,148,151,299,2.437888198757764,20.94198921024956
Task_14725,1887,484,163,196,359,3.890721649484536,39.237575146881035
Task_14726,915,451,61,156,217,2.024336283185841,23.115340540467297
Task_14727,1805,666,86,195,281,2.7061469265367317,38.12245954432194
Task_14728,2624,1009,106,128,234,2.598019801980198,51.90032947044515
Task_14729,567,681,35,114,149,0.8313782991202346,17.68241445581092
Task_14730,1354,817,47,175,222,1.6552567237163813,31.220502882490887
Task_14731,2724,948,27,125,152,2.8703898840885143,52.68658103544033
Task_14732,1799,110,119,154,273,16.207207207207208,35.69412089678388
Task_14733,1733,640,72,164,236,2.703588143525741,36.75183194327291
Task_14734,2249,877,129,185,314,2.561503416856492,45.99052912845402
Task_14735,1567,581,134,150,284,2.6924398625429555,34.07321013910307
Task_14736,2274,878,123,49,172,2.5870307167235493,45.11069571838372
Task_14737,2147,877,197,19,216,2.4453302961275627,43.11834682800579
Task_14738,1957,552,32,80,112,3.538878842676311,38.99355399213882
Task_14739,2710,545,89,76,165,4.9633699633699635,51.2422298720675
Task_14740,2269,786,12,22,34,2.883100381194409,43.12435509698529
Task_14741,973,855,158,118,276,1.1366822429906542,25.366140627602437
Task_14742,958,122,107,165,272,7.788617886178862,22.618702354926267
Task_14743,2938,299,151,196,347,9.793333333333333,55.19337482893881
Task_14744,1411,455,10,133,143,3.094298245614035,30.311387795867358
Task_14745,980,640,12,170,182,1.5288611544461779,24.422446857509925
Task_14746,646,941,95,90,185,0.6857749469214437,20.135907733626237
Task_14747,1496,444,163,180,343,3.3617977528089886,32.824974070296854
Task_14748,2309,870,45,187,232,2.65097588978186,46.58080159224468
Task_14749,2663,96,35,137,172,27.45360824742268,48.515685875426335
Task_14750,834,426,190,91,281,1.9531615925058547,21.82579696428194
Task_14751,586,488,159,15,174,1.1983640081799591,16.94917872754069
Task_14752,1643,112,43,193,236,14.539823008849558,33.12601578464872
Task_14753,2964,198,159,56,215,14.894472361809045,54.15187418656979
Task_14754,1653,981,138,148,286,1.6832993890020367,36.67612653164168
Task_14755,1152,502,192,101,293,2.290258449304175,27.222267135305046
Task_14756,2125,496,140,187,327,4.275653923541247,42.88634034656468
Task_14757,1479,755,158,191,349,1.9563492063492063,33.577062188602575
Task_14758,1846,279,46,84,130,6.5928571428571425,36.635533969781896
Task_14759,2425,907,193,32,225,2.670704845814978,47.74583849215111
Task_14760,2935,156,21,151,172,18.694267515923567,53.35793161284412
Task_14761,817,403,109,25,134,2.022277227722772,20.095090699983988
Task_14762,1664,682,178,176,354,2.4363103953147878,36.28015850291866
Task_14763,2571,790,112,149,261,3.25031605562579,50.52828717015988
Task_14764,2446,501,82,196,278,4.872509960159363,47.81865629628444
Task_14765,1527,443,12,131,143,3.439189189189189,32.109953347749176
Task_14766,2354,240,128,50,178,9.767634854771785,44.33258397610905
Task_14767,1442,859,21,158,179,1.6767441860465115,32.44592963057773
Task_14768,891,82,71,139,210,10.734939759036145,21.011049693880427
Task_14769,747,506,59,186,245,1.4733727810650887,20.751675633657907
Task_14770,2938,291,135,81,216,10.061643835616438,54.30141200307714
Task_14771,2732,999,100,55,155,2.732,52.6968746537867
Task_14772,1766,502,104,57,161,3.510934393638171,35.867282531463864
Task_14773,2496,707,76,68,144,3.5254237288135593,48.14552241355384
Task_14774,1273,627,188,75,263,2.0270700636942673,29.18041079736464
Task_14775,1552,543,32,188,220,2.8529411764705883,33.480595429941374
Task_14776,2096,114,111,187,298,18.22608695652174,40.566235420994836
Task_14777,1245,885,56,171,227,1.4051918735891649,29.714515469082368
Task_14778,2618,346,11,130,141,7.544668587896253,49.03736165445059
Task_14779,2243,104,39,66,105,21.36190476190476,40.99528209824462
Task_14780,2916,260,100,77,177,11.172413793103448,53.568723932484595
Task_14781,1711,408,121,163,284,4.183374083129585,35.8209819455646
Task_14782,2658,465,122,120,242,5.703862660944206,50.74205716200564
Task_14783,2427,460,145,28,173,5.264642082429501,46.0958698244201
Task_14784,2529,571,59,55,114,4.421328671328672,47.743243421631696
Task_14785,1505,720,60,116,176,2.087378640776699,33.033709807268934
Task_14786,740,304,46,70,116,2.4262295081967213,18.84521212628315
Task_14787,612,619,103,101,204,0.9870967741935484,18.608907312942126
Task_14788,1442,571,167,143,310,2.520979020979021,32.1692312865612
Task_14789,2058,985,90,14,104,2.0872210953346855,41.19011154564284
Task_14790,2758,803,63,108,171,3.4303482587064678,53.074937787303575
Task_14791,858,312,36,96,132,2.741214057507987,21.174756446280067
Task_14792,1534,160,196,90,286,9.527950310559007,31.828325197104977
Task_14793,1984,186,149,142,291,10.609625668449198,39.406353086569304
Task_14794,1937,143,136,52,188,13.45138888888889,37.311426157662886
Task_14795,1802,659,49,153,202,2.7303030303030305,37.771127624215545
Task_14796,814,920,151,151,302,0.8838219326818675,23.25485173116816
Task_14797,788,929,143,108,251,0.8473118279569892,22.574980585061535
Task_14798,1983,318,153,81,234,6.216300940438871,39.377171588830834
Task_14799,1094,135,178,63,241,8.044117647058824,24.209404586909816
Task_14800,1381,255,152,170,322,5.39453125,30.278186457768076
Task_14801,2081,685,57,12,69,3.0335276967930027,39.915857041031266
Task_14802,813,421,12,50,62,1.9265402843601895,19.337906074481776
Task_14803,2500,696,139,77,216,3.586800573888092,48.633093472324056
Task_14804,1926,194,198,44,242,9.876923076923077,37.6323335947014
Task_14805,1702,116,86,135,221,14.547008547008547,33.93591387248076
Task_14806,1837,680,81,88,169,2.697503671071953,38.01310270251343
Task_14807,1715,654,52,29,81,2.618320610687023,34.57981287038364
Task_14808,2357,263,110,189,299,8.928030303030303,45.653411842649014
Task_14809,2439,691,118,126,244,3.5245664739884393,48.0152795656933
Task_14810,1038,982,64,34,98,1.0559511698880977,24.99902666671194
Task_14811,686,943,33,121,154,0.7266949152542372,20.472451519137156
Task_14812,1934,402,92,12,104,4.799007444168734,37.42251408183824
Task_14813,708,442,127,81,208,1.5981941309255079,19.479663508948036
Task_14814,1778,256,101,78,179,6.918287937743191,35.62528469418703
Task_14815,1475,845,96,98,194,1.743498817966903,32.95865044471189
Task_14816,956,364,173,22,195,2.6191780821917807,22.556795248568154
Task_14817,1899,569,62,106,168,3.331578947368421,38.72431250592843
Task_14818,610,589,10,81,91,1.0338983050847457,17.376410600627015
Task_14819,1919,783,20,179,199,2.447704081632653,39.92652644102606
Task_14820,2409,426,90,50,140,5.6416861826697895,45.560074639186446
Task_14821,2272,255,54,44,98,8.875,42.11469310189451
Task_14822,1018,506,73,36,109,2.007889546351085,23.33545969178945
Task_14823,1675,552,161,134,295,3.0289330922242317,35.71802739808276
Task_14824,1117,77,82,75,157,14.320512820512821,23.557697773653576
Task_14825,1558,129,47,129,176,11.984615384615385,31.551734561439606
Task_14826,828,587,87,173,260,1.4081632653061225,22.21869190421562
Task_14827,886,467,125,178,303,1.893162393162393,23.059326487389967
Task_14828,1793,311,101,192,293,5.746794871794871,36.88187151631766
Task_14829,1723,408,96,14,110,4.212713936430318,34.14185270591629
Task_14830,2778,452,170,108,278,6.132450331125828,52.74352489793267
Task_14831,2532,88,38,192,230,28.44943820224719,46.883003212457204
Task_14832,1038,536,149,156,305,1.9329608938547487,25.658810540029275
Task_14833,965,993,172,65,237,0.9708249496981891,25.281522748940517
Task_14834,1433,414,87,43,130,3.4530120481927713,29.929090643230793
Task_14835,729,1003,199,63,262,0.7260956175298805,21.718460337653863
Task_14836,2184,703,188,200,388,3.102272727272727,44.7713207501142
Task_14837,967,479,23,139,162,2.0145833333333334,23.54447065834174
Task_14838,965,752,25,37,62,1.2815405046480743,22.684594506104457
Task_14839,1045,248,194,28,222,4.196787148594377,23.777851714866813
Task_14840,544,603,161,155,316,0.9006622516556292,18.073344064576045
Task_14841,1454,404,155,76,231,3.5901234567901232,31.203237579939202
Task_14842,1968,137,81,129,210,14.26086956521739,38.32248295626605
Task_14843,2585,880,156,144,300,2.9341657207718503,51.20057874642864
Task_14844,2932,769,161,126,287,3.807792207792208,56.264854721155494
Task_14845,2561,97,145,200,345,26.132653061224488,47.907879333635464
Task_14846,1816,586,25,53,78,3.093696763202726,35.969467672141654
Task_14847,2881,162,71,189,260,17.67484662576687,53.22833239557736
Task_14848,1539,374,193,174,367,4.104,33.37948150096849
Task_14849,1594,912,136,77,213,1.745892661555312,34.93244765404944
Task_14850,1800,711,112,91,203,2.5280898876404496,37.665130341092016
Task_14851,2912,640,177,43,220,4.542901716068643,54.603993632423304
Task_14852,1046,283,62,35,97,3.683098591549296,22.84787674440767
Task_14853,2161,372,21,135,156,5.793565683646112,41.99999258191068
Task_14854,2955,361,17,139,156,8.162983425414364,54.50626069720735
Task_14855,738,100,112,109,221,7.306930693069307,18.626434104396342
Task_14856,1513,510,121,64,185,2.9608610567514675,32.1148061367459
Task_14857,2274,230,149,14,163,9.844155844155845,42.76244805649571
Task_14858,1370,471,185,15,200,2.902542372881356,29.44428224136361
Task_14859,1058,977,167,128,295,1.081799591002045,27.191970142635025
Task_14860,943,568,42,184,226,1.657293497363796,23.942820122133284
Task_14861,1871,489,122,182,304,3.8183673469387753,38.73187589729848
Task_14862,2411,858,113,24,137,2.806752037252619,46.74873814780738
Task_14863,1744,133,31,77,108,13.014925373134329,33.51392327145221
Task_14864,2611,989,86,24,110,2.6373737373737374,50.035915796278545
Task_14865,1414,759,94,36,130,1.8605263157894736,30.73923543012228
Task_14866,2091,561,22,79,101,3.7206405693950177,40.94315048602145
Task_14867,2086,460,66,200,266,4.5249457700650755,41.97459409425731
Task_14868,970,212,179,103,282,4.553990610328638,23.36107947925113
Task_14869,1947,717,176,200,376,2.711699164345404,41.006964390822866
Task_14870,2568,302,47,133,180,8.475247524752476,48.52345120682972
Task_14871,1342,873,90,14,104,1.5354691075514875,29.45275520017927
Task_14872,1282,285,18,62,80,4.4825174825174825,26.723894319394503
Task_14873,812,675,100,78,178,1.2011834319526626,21.641658104938774
Task_14874,2474,1000,37,30,67,2.4715284715284715,47.33229847867198
Task_14875,2338,829,61,130,191,2.816867469879518,46.6828042128312
Task_14876,1779,788,63,79,142,2.2547528517110265,37.22585114360509
Task_14877,897,416,157,113,270,2.1510791366906474,22.828892488994793
Task_14878,1567,414,158,46,204,3.7759036144578313,32.52195382563595
Task_14879,1170,277,109,152,261,4.2086330935251794,26.716155241444756
Task_14880,983,861,192,27,219,1.140371229698376,24.70155140249528
Task_14881,2609,779,117,68,185,3.344871794871795,50.328107906191214
Task_14882,2925,171,154,10,164,17.00581395348837,52.62506516531739
Task_14883,2785,695,198,29,227,4.001436781609195,52.784360059982056
Task_14884,1508,953,110,192,302,1.580712788259958,34.39884578351152
Task_14885,1449,111,169,177,346,12.9375,30.559437659849177
Task_14886,2136,189,44,148,192,11.242105263157894,41.3343081022819
Task_14887,973,966,185,182,367,1.0062047569803516,26.203825593582323
Task_14888,2960,816,53,196,249,3.6230110159118727,56.8598571012054
Task_14889,2889,659,21,182,203,4.377272727272727,54.92069692665487
Task_14890,1739,915,168,138,306,1.898471615720524,37.922867104265755
Task_14891,2592,132,89,42,131,19.48872180451128,46.80710505796611
Task_14892,2773,811,175,33,208,3.415024630541872,52.876920642833404
Task_14893,2406,169,115,13,128,14.152941176470588,44.22517186547568
Task_14894,2865,313,127,49,176,9.124203821656051,52.6708865347467
Task_14895,1990,746,38,19,57,2.6639892904953144,38.75386547114687
Task_14896,2582,457,151,57,208,5.637554585152839,48.954892515881625
Task_14897,2406,252,190,39,229,9.5098814229249,45.34117259202213
Task_14898,2294,623,62,63,125,3.676282051282051,44.508635470322396
Task_14899,2978,182,83,180,263,16.273224043715846,54.927704736610906
Task_14900,1477,156,112,44,156,9.40764331210191,29.563719235449366
Task_14901,1372,437,138,120,258,3.132420091324201,30.369019142787028
Task_14902,1936,749,69,17,86,2.5813333333333333,38.38191136772269
Task_14903,1858,948,127,188,315,1.957850368809273,40.024949944551096
Task_14904,1246,468,71,182,253,2.656716417910448,28.601431563957167
Task_14905,1952,224,72,179,251,8.675555555555556,38.9419672502542
Task_14906,1417,791,166,123,289,1.7891414141414141,32.33681342276771
Task_14907,1288,598,62,27,89,2.1502504173622703,27.62414588089057
Task_14908,2443,361,52,67,119,6.748618784530387,45.96201412217433
Task_14909,869,233,149,58,207,3.713675213675214,21.120046008695436
Task_14910,772,376,10,121,131,2.047745358090186,19.923104237583853
Task_14911,1027,650,56,51,107,1.577572964669739,24.002068901306277
Task_14912,1367,155,24,178,202,8.762820512820513,28.920009195991522
Task_14913,2328,119,17,17,34,19.4,41.49752514787222
Task_14914,1457,839,64,162,226,1.7345238095238096,32.94987068277026
Task_14915,2853,780,195,149,344,3.653008962868118,55.33858093736342
Task_14916,1854,994,165,144,309,1.8633165829145728,40.01291525121141
Task_14917,2815,249,94,75,169,11.26,51.87598578206785
Task_14918,2646,619,166,179,345,4.267741935483871,51.598647610928744
Task_14919,664,64,194,189,383,10.215384615384615,18.269845767864116
Task_14920,1898,212,156,166,322,8.910798122065728,38.28577043154338
Task_14921,1465,225,167,113,280,6.482300884955753,31.228416858365804
Task_14922,1049,722,137,89,226,1.4508990318118948,25.866312127024106
Task_14923,584,596,80,189,269,0.9782244556113903,18.51364725278694
Task_14924,1520,303,10,16,26,5.0,29.611981959128638
Task_14925,1396,1020,132,91,223,1.367286973555338,32.26843252619559
Task_14926,1217,627,17,169,186,1.9378980891719746,28.189237380247864
Task_14927,2069,963,144,103,247,2.146265560165975,42.984077980280574
Task_14928,1949,496,37,79,116,3.921529175050302,38.75363659098868
Task_14929,1173,476,35,60,95,2.459119496855346,25.781439441032273
Task_14930,2058,880,164,78,242,2.3359818388195235,42.36920909089276
Task_14931,2330,240,75,90,165,9.66804979253112,44.44075505842873
Task_14932,2452,511,87,88,175,4.7890625,47.17150193491728
Task_14933,1816,1014,118,28,146,1.7891625615763547,37.99423584714252
Task_14934,1525,125,193,56,249,12.103174603174603,30.978166912508026
Task_14935,2595,528,78,61,139,4.905482041587902,49.028531612130486
Task_14936,2459,293,82,30,112,8.363945578231293,45.45172874776197
Task_14937,1008,448,27,60,87,2.244988864142539,22.98450759872037
Task_14938,2729,196,32,64,96,13.852791878172589,49.60062088208326
Task_14939,985,131,40,117,157,7.462121212121212,22.073119505706487
Task_14940,2754,701,94,53,147,3.923076923076923,52.19247309338524
Task_14941,2415,406,93,98,191,5.933660933660934,46.48621324272466
Task_14942,909,475,65,70,135,1.9096638655462186,22.255485419544033
Task_14943,568,484,24,168,192,1.1711340206185568,17.474789189573574
Task_14944,927,841,96,176,272,1.1009501187648456,24.66155357167645
Task_14945,1775,448,190,112,302,3.953229398663697,36.9692066131401
Task_14946,2019,108,32,178,210,18.522935779816514,38.860361069869775
Task_14947,2346,650,81,69,150,3.6036866359447006,45.53986243830263
Task_14948,2335,916,106,82,188,2.5463467829880044,46.663657884439566
Task_14949,2673,690,144,68,212,3.8683068017366136,51.213117201638426
Task_14950,2378,989,125,132,257,2.402020202020202,48.04919087038167
Task_14951,1720,965,84,22,106,1.7805383022774328,35.77355216899243
Task_14952,1738,160,170,50,220,10.79503105590062,34.245727665479244
Task_14953,1157,819,88,104,192,1.4109756097560975,27.741895494248848
Task_14954,2620,1005,189,145,334,2.6043737574552686,52.30010354994433
Task_14955,736,956,130,113,243,0.7690700104493208,21.836190288119344
Task_14956,1938,788,28,165,193,2.456273764258555,40.200498305699405
Task_14957,2099,852,114,73,187,2.4607268464243846,42.54816681943072
Task_14958,2915,116,174,69,243,24.914529914529915,52.67433732558681
Task_14959,2113,905,150,21,171,2.3322295805739515,42.421891822242664
Task_14960,2008,767,99,123,222,2.6145833333333335,41.324621129533895
Task_14961,1480,354,90,195,285,4.169014084507042,32.036593420584445
Task_14962,2676,143,15,171,186,18.583333333333332,49.32769058845643
Task_14963,2369,476,32,143,175,4.966457023060797,45.910202829142754
Task_14964,1477,151,10,44,54,9.717105263157896,28.720465868052454
Task_14965,2486,900,107,61,168,2.7591564927857934,48.61159051842955
Task_14966,1734,525,29,30,59,3.296577946768061,34.077532794463
Task_14967,2572,939,181,119,300,2.7361702127659573,51.1422831679072
Task_14968,544,553,152,170,322,0.9819494584837545,17.960322097932814
Task_14969,2093,837,56,62,118,2.4976133651551313,41.7688981917161
Task_14970,1198,473,151,159,310,2.5274261603375527,28.020675237730924
Task_14971,1476,851,187,24,211,1.732394366197183,32.39465508262839
Task_14972,2704,313,29,182,211,8.611464968152866,50.91212870956505
Task_14973,1052,942,193,114,307,1.1155885471898197,27.011525852921938
Task_14974,970,708,103,159,262,1.3681241184767279,24.881739110354257
Task_14975,2130,446,53,198,251,4.76510067114094,42.54980995332229
Task_14976,2340,882,119,174,293,2.6500566251415627,47.33725106004096
Task_14977,1398,595,58,90,148,2.3456375838926173,30.665184813087976
Task_14978,2154,273,113,86,199,7.861313868613139,41.812798373954244
Task_14979,1680,581,58,30,88,2.88659793814433,33.753509014329076
Task_14980,1179,168,91,180,271,6.976331360946745,26.38269523260945
Task_14981,1964,533,159,58,217,3.6779026217228465,39.45804559896665
Task_14982,1307,345,74,87,161,3.777456647398844,28.47829615875557
Task_14983,2966,297,155,187,342,9.953020134228188,55.59313896815055
Task_14984,1152,516,106,187,293,2.228239845261122,27.392366930566187
Task_14985,983,110,148,12,160,8.855855855855856,21.363137888581225
Task_14986,2272,424,138,193,331,5.345882352941176,45.006710050474986
Task_14987,2635,484,49,164,213,5.43298969072165,50.4697661083896
Task_14988,2566,707,179,149,328,3.6242937853107344,50.48979768721072
Task_14989,1234,340,94,155,249,3.6187683284457477,27.895024227670906
Task_14990,2559,734,172,142,314,3.4816326530612245,50.39068089721599
Task_14991,1856,664,10,129,139,2.7909774436090227,37.98838014975932
Task_14992,2633,357,23,133,156,7.354748603351955,49.41932324217952
Task_14993,1900,746,75,185,260,2.5435073627844713,39.87324566510774
Task_14994,2509,651,149,78,227,3.848159509202454,48.72763057355732
Task_14995,1899,298,101,66,167,6.351170568561873,37.469072833755725
Task_14996,739,355,45,138,183,2.0758426966292136,19.770991213952744
Task_14997,2495,976,43,176,219,2.5537359263050154,49.77265503154562
Task_14998,1684,147,33,200,233,11.378378378378379,34.06852781556965
Task_14999,610,628,81,63,144,0.9697933227344993,18.01673323364426
Task_15000,539,264,57,96,153,2.0339622641509436,16.02870649334773
Task_15001,579,377,36,124,160,1.5317460317460319,16.979295211074085
Task_15002,740,655,63,58,121,1.1280487804878048,19.69364665839286
Task_15003,2084,709,88,72,160,2.935211267605634,41.56365572010741
Task_15004,2709,587,122,137,259,4.607142857142857,52.04506920644608
Task_15005,1151,1012,30,160,190,1.136229022704837,28.33144162591189
Task_15006,738,91,190,171,361,8.021739130434783,19.329484221199703
Task_15007,544,1020,14,58,72,0.5328109696376102,17.020660255462477
Task_15008,997,433,137,89,226,2.2972350230414746,24.189087096243195
Task_15009,1851,768,179,129,308,2.4070221066319895,39.23522303216826
Task_15010,608,937,80,39,119,0.6481876332622601,18.47210220271951
Task_15011,748,480,184,20,204,1.5550935550935552,19.66926940348942
Task_15012,2865,230,88,187,275,12.402597402597403,53.403196034492275
Task_15013,1928,324,85,164,249,5.932307692307693,38.827071639243876
Task_15014,2275,899,177,190,367,2.5277777777777777,46.717355765591115
Task_15015,923,411,45,172,217,2.2402912621359223,23.100246809021385
Task_15016,2353,893,107,92,199,2.631991051454139,46.98191707121284
Task_15017,1609,97,166,33,199,16.418367346938776,31.40405490591216
Task_15018,1597,773,191,48,239,2.0633074935400515,34.31129891604317
Task_15019,535,218,139,166,305,2.442922374429224,16.70847810854867
Task_15020,1526,258,101,115,216,5.891891891891892,32.02131053142962
Task_15021,2273,262,175,91,266,8.642585551330798,43.975027188782086
Task_15022,2191,433,76,81,157,5.048387096774194,42.66393230371642
Task_15023,1428,906,129,139,268,1.5744211686879823,32.754444799078705
Task_15024,556,968,20,120,140,0.5737874097007224,18.506981717404475
Task_15025,1608,288,162,168,330,5.56401384083045,34.01098138128485
Task_15026,2766,208,163,38,201,13.23444976076555,50.743637001574804
Task_15027,2089,830,135,37,172,2.5138387484957883,41.93541492528761
Task_15028,2830,795,65,153,218,3.5552763819095476,54.529133202371895
Task_15029,1653,348,171,76,247,4.736389684813753,34.24177060581549
Task_15030,2504,155,119,184,303,16.05128205128205,47.36887222048492
Task_15031,1124,885,62,80,142,1.2686230248306998,27.116857359741672
Task_15032,2650,917,114,163,277,2.886710239651416,52.270386686519316
Task_15033,1377,763,74,85,159,1.8023560209424083,30.83884819133199
Task_15034,2695,797,16,150,166,3.3771929824561404,52.02980996154193
Task_15035,2192,337,158,20,178,6.485207100591716,41.929096454682245
Task_15036,1909,70,160,89,249,26.887323943661972,36.90828861829177
Task_15037,1725,563,196,120,316,3.0585106382978724,36.61865591664188
Task_15038,1573,590,87,81,168,2.661590524534687,33.388529478630375
Task_15039,1430,171,160,81,241,8.313953488372093,29.925685525858118
Task_15040,792,496,167,86,253,1.5935613682092555,21.226235293083395
Task_15041,2269,908,128,156,284,2.4961496149614963,46.226428920367255
Task_15042,620,489,158,58,216,1.2653061224489797,18.0289561809787
Task_15043,2189,421,11,119,130,5.187203791469194,42.472297802119634
Task_15044,1405,800,55,54,109,1.7540574282147317,30.53397602704226
Task_15045,2387,628,118,128,246,3.794912559618442,47.00435255038025
Task_15046,1766,592,153,32,185,2.9780775716694774,36.12466173146722
Task_15047,583,420,56,62,118,1.3847980997624703,16.51034542287982
Task_15048,1868,545,133,104,237,3.421245421245421,38.44645081098718
Task_15049,1137,505,55,187,242,2.2470355731225298,26.960034384589687
Task_15050,1247,295,155,74,229,4.212837837837838,27.555939777405353
Task_15051,1643,197,23,184,207,8.297979797979798,33.74262568550582
Task_15052,2290,843,189,177,366,2.713270142180095,46.7565888355003
Task_15053,1211,282,51,36,87,4.279151943462898,25.405690096037137
Task_15054,2064,830,38,167,205,2.4837545126353793,42.40481515148466
Task_15055,2127,370,162,95,257,5.7331536388140165,42.07073551650143
Task_15056,2653,120,130,56,186,21.925619834710744,48.380037741228904
Task_15057,1151,754,94,77,171,1.5245033112582782,27.16665149591482
Task_15058,775,441,25,160,185,1.753393665158371,20.6050817762461
Task_15059,2252,919,50,27,77,2.4478260869565216,43.6124497841239
Task_15060,1508,686,104,128,232,2.1950509461426493,33.201441017773
Task_15061,1243,1003,57,112,169,1.2380478087649402,29.626453879291276
Task_15062,611,345,64,125,189,1.7658959537572254,17.786122541592704
Task_15063,2388,945,18,49,67,2.52431289640592,45.92010792294588
Task_15064,551,167,142,28,170,3.2797619047619047,15.236164211379014
Task_15065,2218,753,16,47,63,2.9416445623342176,42.585265293963474
Task_15066,1596,301,15,47,62,5.28476821192053,31.290903773271065
Task_15067,2019,757,45,146,191,2.663588390501319,41.3879834963442
Task_15068,1432,590,10,117,127,2.4230118443316413,31.006281361724135
Task_15069,2201,276,36,156,192,7.945848375451264,42.718223201358875
Task_15070,2198,545,148,147,295,4.0256410256410255,43.99609323155045
Task_15071,1961,886,144,66,210,2.2108229988726045,40.534393518667024
Task_15072,2400,445,104,36,140,5.381165919282512,45.35096340221111
Task_15073,1055,443,161,166,327,2.376126126126126,25.749299371217607
Task_15074,686,1003,73,19,92,0.6832669322709163,19.914018478168973
Task_15075,2182,882,84,14,98,2.4711211778029445,42.75965636425218
Task_15076,1131,155,159,165,324,7.25,25.794654492730178
Task_15077,2530,276,36,192,228,9.133574007220217,48.1334018182165
Task_15078,697,392,88,19,107,1.7735368956743003,17.786781748211784
Task_15079,1199,803,49,79,128,1.4912935323383085,28.21587852044944
Task_15080,1333,435,31,81,112,3.0573394495412844,28.73897137655005
Task_15081,880,236,18,71,89,3.7130801687763713,20.49621661794377
Task_15082,1710,392,157,150,307,4.351145038167939,35.83787661160128
Task_15083,1887,325,169,187,356,5.788343558282208,38.69198972332005
Task_15084,1967,253,90,82,172,7.744094488188976,38.610185563441284
Task_15085,2356,406,197,182,379,5.788697788697789,46.47706750509199
Task_15086,1432,945,77,12,89,1.5137420718816068,31.01108429166655
Task_15087,2205,528,142,20,162,4.168241965973535,42.64251104088384
Task_15088,1716,854,123,133,256,2.007017543859649,37.13603006806458
Task_15089,735,599,160,102,262,1.225,20.719884749566685
Task_15090,783,489,26,59,85,1.5979591836734695,19.595997049764982
Task_15091,623,989,181,41,222,0.6292929292929293,19.758869578019596
Task_15092,2496,966,92,93,185,2.5811789038262667,49.432042389243726
Task_15093,2306,931,197,71,268,2.4742489270386265,46.44557429062954
Task_15094,986,91,63,150,213,10.717391304347826,22.57929798898486
Task_15095,2325,615,55,25,80,3.7743506493506493,43.96552890938623
Task_15096,2155,303,18,108,126,7.088815789473684,41.54504421173696
Task_15097,1939,342,72,189,261,5.653061224489796,39.20596985069451
Task_15098,954,575,41,23,64,1.65625,21.886018727458634
Task_15099,905,360,199,119,318,2.5069252077562325,23.003102347514513
Task_15100,2690,245,90,24,114,10.934959349593496,48.946047075978306
Task_15101,709,882,171,17,188,0.8029445073612684,20.280187575254818
Task_15102,1969,684,90,40,130,2.8744525547445257,39.28624064043351
Task_15103,1661,828,143,89,232,2.0036188178528347,35.96842936608653
Task_15104,1557,151,147,154,301,10.243421052631579,32.37667364001198
Task_15105,1663,264,198,35,233,6.275471698113208,33.65828857793889
Task_15106,2863,371,178,189,367,7.696236559139785,54.337996023488074
Task_15107,1218,876,71,166,237,1.3888255416191562,29.28688860973398
Task_15108,2474,262,82,91,173,9.406844106463879,46.75171017128724
Task_15109,1688,225,200,16,216,7.469026548672566,33.733768891538595
Task_15110,2692,488,139,27,166,5.505112474437627,50.36081800865244
Task_15111,2063,537,35,179,214,3.8345724907063197,41.52906482643123
Task_15112,759,227,158,78,236,3.3289473684210527,19.71253363727742
Task_15113,1138,797,89,176,265,1.4260651629072683,27.82738609345107
Task_15114,1592,109,188,93,281,14.472727272727273,32.321544275232576
Task_15115,1715,759,168,29,197,2.2565789473684212,35.90028145267376
Task_15116,2088,816,114,141,255,2.5556915544675642,42.91869638547522
Task_15117,1604,721,13,123,136,2.221606648199446,34.165244135549386
Task_15118,1826,447,13,180,193,4.075892857142857,37.35766578738083
Task_15119,2642,627,131,84,215,4.207006369426751,50.76097710980735
Task_15120,2247,773,57,149,206,2.9031007751937983,45.16049299000838
Task_15121,1003,312,20,66,86,3.2044728434504792,22.592965955353492
Task_15122,2218,721,19,79,98,3.07202216066482,43.35642687453676
Task_15123,2647,544,111,143,254,4.856880733944954,50.911661730989316
Task_15124,1750,276,24,81,105,6.317689530685921,34.67805604159389
Task_15125,1409,438,66,100,166,3.2095671981776763,30.55673037903701
Task_15126,2967,676,191,64,255,4.382570162481536,56.012965394085995
Task_15127,1785,177,107,55,162,10.02808988764045,34.90042104413149
Task_15128,2902,389,176,107,283,7.441025641025641,54.517222849894324
Task_15129,1258,830,34,28,62,1.5138387484957883,27.558162416471557
Task_15130,1544,905,18,46,64,1.7041942604856513,32.3497984435775
Task_15131,592,298,36,56,92,1.979933110367893,16.025077774562234
Task_15132,648,493,39,125,164,1.311740890688259,18.56820662154505
Task_15133,2363,455,93,96,189,5.182017543859649,45.83805632287857
Task_15134,1661,691,174,147,321,2.4002890173410405,36.06957197039093
Task_15135,668,408,41,100,141,1.6332518337408313,18.39160813092449
Task_15136,2343,816,65,196,261,2.86780905752754,47.13620856599138
Task_15137,872,661,114,180,294,1.3172205438066464,23.358453510547886
Task_15138,1027,142,149,117,266,7.181818181818182,23.749663623676174
Task_15139,2389,1014,199,164,363,2.3536945812807883,48.82598588727353
Task_15140,2740,942,168,77,245,2.9056203605514317,53.33814526389901
Task_15141,2622,735,122,150,272,3.5625,51.21426815247736
Task_15142,2363,118,100,57,157,19.857142857142858,43.43852200432128
Task_15143,781,253,39,11,50,3.074803149606299,17.995597355521625
Task_15144,1832,620,70,185,255,2.9500805152979064,38.38577557727299
Task_15145,1994,598,182,109,291,3.328881469115192,40.86032341577411
Task_15146,900,397,152,152,304,2.2613065326633164,23.026722397927852
Task_15147,1857,960,104,71,175,1.9323621227887617,38.97456556354426
Task_15148,1880,899,155,38,193,2.088888888888889,38.953770658059604
Task_15149,2227,772,13,73,86,2.8809831824062098,43.478635975305394
Task_15150,2840,275,11,63,74,10.289855072463768,51.12199034992179
Task_15151,2940,910,195,16,211,3.2272228320526892,55.74488171213334
Task_15152,1228,140,50,29,79,8.709219858156029,24.961410085191076
Task_15153,1318,722,147,74,221,1.8229598893499308,29.996977726551833
Task_15154,2983,961,103,99,202,3.100831600831601,57.246820945484124
Task_15155,1755,157,108,93,201,11.10759493670886,34.94089976428635
Task_15156,1250,709,56,186,242,1.7605633802816902,29.37268326146261
Task_15157,1450,877,98,126,224,1.6514806378132119,32.829192192541136
Task_15158,1016,742,84,198,282,1.3674293405114402,25.859635646341246
Task_15159,2834,776,141,97,238,3.6473616473616475,54.49938766778067
Task_15160,1528,142,145,91,236,10.685314685314685,31.352765639041408
Task_15161,1062,986,50,117,167,1.0759878419452888,26.705648372638652
Task_15162,2178,148,196,56,252,14.61744966442953,41.47680337790416
Task_15163,1006,76,85,43,128,13.064935064935066,21.137749355715822
Task_15164,2115,207,187,86,273,10.16826923076923,41.28837258438863
Task_15165,2534,399,137,166,303,6.335,48.904520209293004
Task_15166,1757,742,188,101,289,2.3647375504710633,37.53814749320299
Task_15167,538,714,127,117,244,0.7524475524475525,17.924906870073897
Task_15168,2967,319,115,53,168,9.271875,54.42459399908074
Task_15169,2074,747,69,184,253,2.772727272727273,42.60745883646451
Task_15170,1674,855,27,113,140,1.955607476635514,35.71212696650018
Task_15171,2161,472,192,61,253,4.568710359408033,42.53204060958678
Task_15172,1897,712,57,200,257,2.6605890603085554,39.729360709730315
Task_15173,2299,211,159,59,218,10.84433962264151,43.66450838755204
Task_15174,1097,486,19,117,136,2.252566735112936,25.39932056704879
Task_15175,1563,65,79,10,89,23.681818181818183,29.13267746635528
Task_15176,1171,827,14,164,178,1.4142512077294687,28.022926635304568
Task_15177,1581,306,91,62,153,5.149837133550489,32.22202176218524
Task_15178,1825,832,186,57,243,2.1908763505402162,38.31207518239446
Task_15179,1624,289,66,16,82,5.6,31.90764380582672
Task_15180,1548,387,99,127,226,3.9896907216494846,32.861322568602475
Task_15181,645,744,156,101,257,0.8657718120805369,19.754856959460707
Task_15182,2910,919,199,182,381,3.1630434782608696,56.89309461346752
Task_15183,1893,432,63,21,84,4.371824480369515,36.61626764145972
Task_15184,1407,368,30,68,98,3.813008130081301,29.29847803232708
Task_15185,545,762,101,63,164,0.7142857142857143,17.65806147881301
Task_15186,2730,580,80,134,214,4.698795180722891,52.20130306817108
Task_15187,2645,891,59,35,94,2.9652466367713006,50.072445236520316
Task_15188,2272,377,42,197,239,6.01058201058201,44.45957086809788
Task_15189,2414,977,15,82,97,2.4683026584867074,47.29413465159771
Task_15190,510,116,115,163,278,4.358974358974359,15.51843636777705
Task_15191,2021,962,10,60,70,2.09865005192108,40.2542359752072
Task_15192,866,722,107,80,187,1.197786998616874,22.699548861277375
Task_15193,678,160,33,13,46,4.211180124223603,16.01963137952599
Task_15194,2991,827,35,161,196,3.61231884057971,57.037579129779495
Task_15195,1033,866,27,171,198,1.1914648212226067,26.06267797886032
Task_15196,1522,147,34,173,207,10.283783783783784,31.364941276996632
Task_15197,2638,497,31,144,175,5.2971887550200805,50.23813135360911
Task_15198,715,795,132,72,204,0.8982412060301508,20.587913428102627
Task_15199,2500,855,179,62,241,2.9205607476635516,49.06955346994922
Task_15200,1537,243,29,186,215,6.299180327868853,32.24529085702192
Task_15201,1054,390,67,52,119,2.6956521739130435,23.91552690650413
Task_15202,2189,803,17,134,151,2.722636815920398,43.749896092328775
Task_15203,1157,96,198,146,344,11.927835051546392,25.76795757877025
Task_15204,854,76,147,174,321,11.090909090909092,20.901925092637985
Task_15205,2677,229,173,102,275,11.639130434782608,50.346546393212144
Task_15206,2834,907,59,197,256,3.1211453744493394,55.17980847228235
Task_15207,1005,430,71,96,167,2.331786542923434,24.14911340663914
Task_15208,1129,587,106,198,304,1.9200680272108843,27.316433587409904
Task_15209,1869,826,80,25,105,2.259975816203144,37.71569246960943
Task_15210,2020,247,183,123,306,8.14516129032258,40.20557673508996
Task_15211,2183,371,34,33,67,5.868279569892473,40.72272149357636
Task_15212,566,829,131,35,166,0.6819277108433734,18.060646646467564
Task_15213,2220,408,37,115,152,5.427872860635697,43.017254915085715
Task_15214,2592,745,22,86,108,3.474530831099196,49.5974835972272
Task_15215,874,655,111,16,127,1.3323170731707317,21.673769885491982
Task_15216,2080,752,150,37,187,2.762284196547145,41.62166828158507
Task_15217,2833,477,11,69,80,5.926778242677824,51.95935994840661
Task_15218,1146,191,50,106,156,5.96875,25.39546273302986
Task_15219,2066,96,43,74,117,21.298969072164947,38.33659940110817
Task_15220,1177,173,70,141,211,6.764367816091954,26.08192333007762
Task_15221,2172,375,109,69,178,5.776595744680851,42.080102937086714
Task_15222,1021,813,190,36,226,1.2542997542997543,25.217696529963693
Task_15223,1172,595,163,29,192,1.9664429530201342,26.764457740574596
Task_15224,1110,335,155,102,257,3.3035714285714284,25.86569064763624
Task_15225,1166,213,29,149,178,5.4485981308411215,26.038167937718566
Task_15226,1222,684,35,166,201,1.783941605839416,28.581773562141322
Task_15227,1808,128,45,25,70,14.015503875968992,33.77025106316306
Task_15228,1697,863,58,182,240,1.9641203703703705,36.932523991232316
Task_15229,922,258,185,138,323,3.55984555984556,22.992884904568438
Task_15230,765,787,119,117,236,0.9708121827411168,21.713401377388493
Task_15231,761,643,118,190,308,1.1816770186335404,21.609405740540677
Task_15232,1856,629,101,200,301,2.9460317460317462,38.95109450550898
Task_15233,1764,437,48,129,177,4.027397260273973,36.255311097028184
Task_15234,1629,711,103,102,205,2.287921348314607,35.03645593690375
Task_15235,2447,870,40,32,72,2.809414466130884,46.51525934121386
Task_15236,2244,392,59,65,124,5.709923664122138,42.97277180068298
Task_15237,1484,960,34,90,124,1.5442247658688866,32.88023941025909
Task_15238,2345,232,57,128,185,10.064377682403434,44.77970325217856
Task_15239,1358,615,148,26,174,2.2045454545454546,29.654211053707183
Task_15240,568,149,104,173,277,3.7866666666666666,16.703962660265336
Task_15241,1952,376,156,50,206,5.177718832891247,38.58332922276715
Task_15242,2880,774,173,195,368,3.7161290322580647,55.92303032299085
Task_15243,2327,673,89,110,199,3.4525222551928785,45.93712708180454
Task_15244,945,143,188,93,281,6.5625,22.438659417176652
Task_15245,2024,947,197,122,319,2.1350210970464136,42.573584203583344
Task_15246,2850,790,108,12,120,3.6030341340075855,53.22553198110412
Task_15247,2110,329,120,187,307,6.393939393939394,42.01130857329
Task_15248,2374,851,129,23,152,2.7863849765258215,46.231365270672676
Task_15249,886,388,39,73,112,2.2776349614395888,21.44576102624391
Task_15250,1235,563,191,39,230,2.1897163120567376,27.842085866762048
Task_15251,2099,657,42,174,216,3.189969604863222,42.4834637208078
Task_15252,2689,661,194,126,320,4.061933534743202,52.22278609861047
Task_15253,2257,750,33,53,86,3.0053262316910785,43.738842898298394
Task_15254,2091,130,93,76,169,15.961832061068701,39.534424230440074
Task_15255,670,648,73,48,121,1.0323574730354392,18.45408716797993
Task_15256,604,789,51,101,152,0.7645569620253164,18.66949245221065
Task_15257,1093,728,71,158,229,1.4993141289437586,26.810509342618392
Task_15258,1999,189,43,74,117,10.521052631578947,38.48125442936993
Task_15259,2490,861,126,194,320,2.8886310904872388,49.79933532425122
Task_15260,2156,222,194,110,304,9.668161434977579,42.23397815110121
Task_15261,735,475,79,173,252,1.5441176470588236,20.477850879827486
Task_15262,1171,458,169,198,367,2.55119825708061,27.859947445549636
Task_15263,773,68,43,69,112,11.202898550724637,17.69738896405562
Task_15264,1691,234,49,148,197,7.195744680851064,34.60312945216486
Task_15265,2119,276,40,189,229,7.649819494584838,41.63255945756195
Task_15266,1511,734,150,81,231,2.05578231292517,33.22130770174137
Task_15267,2319,667,20,169,189,3.4715568862275448,45.83595031274816
Task_15268,1199,228,122,133,255,5.235807860262009,26.95441251364623
Task_15269,500,217,168,82,250,2.293577981651376,15.710374642096502
Task_15270,1015,89,16,139,155,11.277777777777779,22.250358650997622
Task_15271,1324,1005,36,113,149,1.31610337972167,30.67891445984257
Task_15272,633,97,176,107,283,6.459183673469388,17.218437763824692
Task_15273,1316,317,126,59,185,4.138364779874214,28.33110311542845
Task_15274,2826,565,147,140,287,4.992932862190813,53.957875499270735
Task_15275,1775,64,130,135,265,27.307692307692307,35.01328253836456
Task_15276,522,279,174,32,206,1.8642857142857143,15.55467305604948
Task_15277,627,858,169,163,332,0.729918509895227,20.2897281243135
Task_15278,832,365,160,35,195,2.273224043715847,20.678688665026016
Task_15279,1975,687,81,166,247,2.870639534883721,40.77840681437918
Task_15280,2019,477,108,190,298,4.2238493723849375,41.02096164898785
Task_15281,1765,281,185,74,259,6.25886524822695,35.83279796124719
Task_15282,2591,311,120,139,259,8.304487179487179,49.269161185901304
Task_15283,936,859,176,29,205,1.0883720930232559,23.921877702781572
Task_15284,676,246,142,120,262,2.736842105263158,18.765378303677952
Task_15285,1141,658,131,27,158,1.7314112291350532,26.165782587730813
Task_15286,1524,298,23,184,207,5.096989966555184,32.173155268047104
Task_15287,2728,545,80,83,163,4.996336996336996,51.6840533392976
Task_15288,1619,214,34,80,114,7.530232558139535,32.59600472635345
Task_15289,2316,618,65,172,237,3.741518578352181,45.94187055935969
Task_15290,1607,285,133,63,196,5.618881118881119,32.944681668195805
Task_15291,1047,505,71,154,225,2.069169960474308,25.40053854747099
Task_15292,2380,921,11,129,140,2.581344902386117,47.09866686551385
Task_15293,1313,993,96,91,187,1.3209255533199196,30.68758685587588
Task_15294,1535,357,84,67,151,4.287709497206704,31.74221243870711
Task_15295,2520,645,99,199,298,3.9009287925696596,49.50485008229532
Task_15296,1063,403,125,167,292,2.631188118811881,25.59288693851992
Task_15297,2260,882,104,183,287,2.5594563986409966,46.05580642293549
Task_15298,1582,761,70,100,170,2.0761154855643045,34.311063922194315
Task_15299,1067,83,67,44,111,12.702380952380953,21.956456442029438
Task_15300,1147,411,171,19,190,2.783980582524272,25.696890422617205
Task_15301,1335,624,151,166,317,2.136,30.70623907927974
Task_15302,2634,916,73,134,207,2.872410032715376,51.715669498449415
Task_15303,1825,69,91,64,155,26.071428571428573,34.5019120522526
Task_15304,545,429,17,20,37,1.2674418604651163,14.690049491525714
Task_15305,632,737,126,42,168,0.8563685636856369,18.57424683713002
Task_15306,589,187,142,185,327,3.132978723404255,17.614015441262957
Task_15307,1943,299,150,200,350,6.476666666666667,39.48152063911978
Task_15308,1242,542,74,191,265,2.287292817679558,28.83927721265806
Task_15309,2379,340,19,66,85,6.976539589442815,44.433627741177936
Task_15310,653,780,102,126,228,0.8361075544174136,19.898166789995688
Task_15311,1758,274,82,29,111,6.392727272727273,34.30357359927499
Task_15312,2139,481,24,194,218,4.437759336099585,42.566180566453184
Task_15313,2653,607,26,67,93,4.363486842105263,49.743870845025036
Task_15314,2192,954,10,28,38,2.2952879581151833,42.50075549055283
Task_15315,1160,326,63,200,263,3.547400611620795,26.865135200515066
Task_15316,1436,552,40,55,95,2.596745027124774,30.177066004828333
Task_15317,2522,614,55,46,101,4.100813008130081,47.34225034205903
Task_15318,1157,615,176,133,309,1.8782467532467533,27.774613735693283
Task_15319,2177,899,88,73,161,2.418888888888889,43.64177746447651
Task_15320,1144,205,41,173,214,5.553398058252427,25.8928196948192
Task_15321,765,973,168,171,339,0.7854209445585215,22.865936129594747
Task_15322,787,666,184,153,337,1.1799100449775113,22.169067298299993
Task_15323,2536,354,90,52,142,7.143661971830986,47.521143637473635
Task_15324,2593,117,137,67,204,21.97457627118644,47.459632907919605
Task_15325,1063,459,189,146,335,2.3108695652173914,25.93317448354884
Task_15326,2557,696,182,151,333,3.66857962697274,50.3379728381366
Task_15327,1294,462,157,64,221,2.794816414686825,28.68816279451879
Task_15328,518,470,119,173,292,1.099787685774947,17.122845076887675
Task_15329,2853,457,165,157,322,6.229257641921397,54.21722576012123
Task_15330,615,348,172,67,239,1.7621776504297995,17.662012876849918
Task_15331,1263,684,172,152,324,1.8437956204379562,29.764272995851147
Task_15332,2072,553,153,12,165,3.740072202166065,40.68268046910239
Task_15333,1219,336,127,87,214,3.6172106824925816,27.315695996498803
Task_15334,1659,775,158,183,341,2.1378865979381443,36.443227923866246
Task_15335,1797,938,171,174,345,1.9137380191693292,39.14195045061567
Task_15336,874,221,43,161,204,3.936936936936937,21.625776523059432
Task_15337,2537,298,190,34,224,8.48494983277592,47.5493642551279
Task_15338,985,96,55,163,218,10.154639175257731,22.576724897891875
Task_15339,1724,104,137,158,295,16.419047619047618,34.57872502537497
Task_15340,2432,875,48,125,173,2.776255707762557,48.18823516137143
Task_15341,1189,558,170,40,210,2.1270125223613596,27.009332982171745
Task_15342,1677,95,87,72,159,17.46875,32.26675968262918
Task_15343,952,568,179,46,225,1.67311072056239,23.366534902312736
Task_15344,1032,867,121,31,152,1.1889400921658986,25.08374841924562
Task_15345,1630,565,115,112,227,2.8798586572438163,34.70780008890984
Task_15346,2669,548,40,129,169,4.861566484517304,50.830949732739555
Task_15347,537,835,102,94,196,0.6423444976076556,18.16616930236096
Task_15348,1965,265,191,158,349,7.387218045112782,39.64552585822161
Task_15349,1101,327,51,153,204,3.356707317073171,25.63154694780238
Task_15350,2647,158,176,129,305,16.647798742138363,49.572290970767845
Task_15351,2244,799,32,158,190,2.805,45.06342566881381
Task_15352,1651,838,35,56,91,1.967818831942789,34.45451202200109
Task_15353,2218,903,21,65,86,2.4535398230088497,43.69881579154822
Task_15354,502,556,36,95,131,0.9012567324955116,16.240353579722964
Task_15355,2382,972,117,96,213,2.448098663926002,47.836859129038764
Task_15356,2052,836,19,101,120,2.4516129032258065,41.449987072407616
Task_15357,843,439,61,181,242,1.915909090909091,22.087347001684233
Task_15358,1829,808,89,100,189,2.2608158220024723,38.40859821954714
Task_15359,984,919,82,63,145,1.0695652173913044,24.817880634717287
Task_15360,1923,252,200,147,347,7.600790513833992,38.910807165362804
Task_15361,853,581,136,131,267,1.465635738831615,22.608196684723698
Task_15362,2174,783,44,11,55,2.7729591836734695,41.76404531481927
Task_15363,1049,430,199,184,383,2.433874709976798,25.892014784064713
Task_15364,1309,95,165,126,291,13.635416666666666,27.87786323423279
Task_15365,1275,99,17,31,48,12.75,24.992173169140074
Task_15366,1516,621,96,153,249,2.437299035369775,33.24558722868827
Task_15367,1455,423,29,176,205,3.431603773584906,31.48354062455732
Task_15368,1823,654,187,168,355,2.783206106870229,38.70354532159763
Task_15369,2398,95,184,188,372,24.979166666666668,45.42977802444684
Task_15370,698,513,142,125,267,1.3579766536964981,19.940210077829438
Task_15371,770,952,19,74,93,0.8079748163693599,21.068094741718955
Task_15372,1588,735,156,66,222,2.157608695652174,34.20811163844841
Task_15373,1307,613,45,108,153,2.1286644951140063,29.20948498062322
Task_15374,1793,740,122,116,238,2.4197031039136303,37.89431909777345
Task_15375,533,970,173,195,368,0.548918640576725,19.399343193419774
Task_15376,2447,456,151,194,345,5.354485776805252,47.945538448123195
Task_15377,980,685,130,104,234,1.4285714285714286,24.754884944353904
Task_15378,592,75,38,31,69,7.7894736842105265,14.002133508980473
Task_15379,2783,402,140,115,255,6.905707196029777,52.56349125481654
Task_15380,756,780,164,194,358,0.967989756722151,22.211889150638893
Task_15381,865,742,29,169,198,1.164199192462988,23.015472425685463
Task_15382,749,113,58,25,83,6.5701754385964914,17.062320966872495
Task_15383,2838,383,125,49,174,7.390625,52.47615232527116
Task_15384,1896,125,90,90,180,15.047619047619047,36.737828620712854
Task_15385,592,219,97,145,242,2.690909090909091,17.30479175027838
Task_15386,2733,892,89,151,240,3.0604703247480405,53.30199681475926
Task_15387,2167,126,75,25,100,17.062992125984252,39.802159964148906
Task_15388,2313,799,24,140,164,2.89125,45.95954019367949
Task_15389,2240,254,161,119,280,8.784313725490197,43.58380417411112
Task_15390,2118,680,19,120,139,3.1101321585903086,42.199671831129486
Task_15391,2351,811,177,10,187,2.895320197044335,45.9859735039
Task_15392,1731,136,86,26,112,12.635036496350365,33.06645806380687
Task_15393,2805,294,55,198,253,9.508474576271187,52.72159658776116
Task_15394,2907,162,86,75,161,17.834355828220858,52.52647109733169
Task_15395,2417,249,70,19,89,9.668,44.38043769304983
Task_15396,1824,751,171,15,186,2.425531914893617,37.43778744347971
Task_15397,2299,271,26,84,110,8.452205882352942,43.47073799520614
Task_15398,2862,655,111,58,169,4.362804878048781,53.81336876298877
Task_15399,592,820,59,18,77,0.7210718635809987,17.188732947158755
Task_15400,1510,516,54,169,223,2.920696324951644,32.78847849716181
Task_15401,1620,785,178,179,357,2.0610687022900764,35.92279307506872
Task_15402,1568,669,63,182,245,2.3402985074626868,34.30351188302836
Task_15403,2782,722,50,182,232,3.847856154910097,53.67263939411874
Task_15404,2661,80,198,168,366,32.851851851851855,49.41760592763067
Task_15405,604,224,95,194,289,2.6844444444444444,17.796890626941302
Task_15406,706,214,157,31,188,3.2837209302325583,18.15512099269625
Task_15407,1247,1007,40,191,231,1.2371031746031746,30.080484122045107
Task_15408,1368,132,164,163,327,10.285714285714286,29.37682116945308
Task_15409,2950,646,180,180,360,4.559505409582689,56.56844530486806
Task_15410,2258,598,197,50,247,3.7696160267111853,44.327043461172956
Task_15411,850,175,137,183,320,4.829545454545454,21.404434024385925
Task_15412,1068,631,138,63,201,1.6898734177215189,25.53441237724253
Task_15413,872,740,184,116,300,1.1767881241565452,23.524034458691688
Task_15414,1600,560,22,26,48,2.8520499108734403,32.005866154511864
Task_15415,1322,265,109,15,124,4.969924812030075,27.433524642029592
Task_15416,2678,401,126,12,138,6.661691542288557,49.49596304188626
Task_15417,1217,839,30,199,229,1.4488095238095238,29.111909082061207
Task_15418,1241,833,185,109,294,1.4880095923261392,29.638167029111553
Task_15419,2898,856,157,71,228,3.381563593932322,55.411110050289686
Task_15420,533,361,117,60,177,1.4723756906077348,16.042296400874285
Task_15421,853,998,108,29,137,0.8538538538538538,22.584566495396004
Task_15422,2133,454,183,175,358,4.687912087912088,42.99971178267085
Task_15423,1313,345,74,92,166,3.7947976878612715,28.701046711441194
Task_15424,1774,856,162,77,239,2.070011668611435,37.73633383518352
Task_15425,605,543,45,118,163,1.1121323529411764,18.00877240480379
Task_15426,823,685,133,129,262,1.1997084548104957,22.425037053812687
Task_15427,1978,209,30,175,205,9.41904761904762,39.02663576535547
Task_15428,2991,835,196,123,319,3.577751196172249,57.54718722580221
Task_15429,552,355,126,35,161,1.550561797752809,15.95677517276971
Task_15430,1883,897,96,73,169,2.096881959910913,39.1719936756029
Task_15431,1849,103,139,72,211,17.778846153846153,35.69819731514503
Task_15432,1747,190,134,116,250,9.146596858638743,35.42057528441061
Task_15433,906,514,46,144,190,1.7592233009708738,22.98133418644179
Task_15434,1360,916,168,177,345,1.4830970556161396,32.110716752295154
Task_15435,1276,705,197,168,365,1.8073654390934843,30.243890824868547
Task_15436,1827,915,56,168,224,1.994541484716157,39.06127111404397
Task_15437,1355,537,56,171,227,2.5185873605947955,30.421196776554893
Task_15438,712,404,48,197,245,1.7580246913580246,19.920443981810056
Task_15439,1877,449,19,184,203,4.171111111111111,38.23131871443532
Task_15440,2292,580,177,134,311,3.944922547332186,45.64916126115437
Task_15441,531,141,85,168,253,3.73943661971831,15.954012803853438
Task_15442,1958,953,70,30,100,2.052410901467505,39.5828767847032
Task_15443,2712,290,23,51,74,9.31958762886598,49.055985939602
Task_15444,1712,121,17,189,206,14.032786885245901,34.13781242409727
Task_15445,1027,246,89,164,253,4.157894736842105,24.313747355592273
Task_15446,1001,616,96,140,236,1.6223662884927066,24.982638331425573
Task_15447,812,960,124,46,170,0.8449531737773153,22.1247925627576
Task_15448,2642,787,126,109,235,3.3527918781725887,51.46788459271031
Task_15449,1619,223,125,191,316,7.227678571428571,33.929991766440224
Task_15450,2370,308,104,125,229,7.669902912621359,45.60851887723451
Task_15451,800,546,158,25,183,1.4625228519195612,20.616772113050857
Task_15452,2734,416,155,198,353,6.556354916067146,52.39813398871943
Task_15453,2081,1003,25,89,114,2.0727091633466137,42.41468723385477
Task_15454,2323,1000,38,49,87,2.3206793206793206,45.43844759127603
Task_15455,2220,832,150,84,234,2.6650660264105643,44.807262488761104
Task_15456,2542,857,121,123,244,2.9627039627039626,50.16411564381582
Task_15457,2295,347,156,159,315,6.594827586206897,44.99312773009905
Task_15458,1073,636,42,37,79,1.684458398744113,24.19612990581268
Task_15459,1760,114,143,121,264,15.304347826086957,35.03235585649391
Task_15460,1374,261,77,198,275,5.244274809160306,30.084121663876445
Task_15461,1028,716,97,127,224,1.4337517433751743,25.60789358646859
Task_15462,1063,479,83,43,126,2.214583333333333,24.204720215945752
Task_15463,1497,207,75,183,258,7.197115384615385,31.737674868873366
Task_15464,1324,570,50,30,80,2.318739054290718,28.064454378126644
Task_15465,1052,534,198,27,225,1.966355140186916,24.79702581267362
Task_15466,2056,315,138,151,289,6.506329113924051,40.975993727680866
Task_15467,2882,172,92,130,222,16.658959537572255,52.95517419364334
Task_15468,774,591,192,176,368,1.3074324324324325,21.902150452628263
Task_15469,1023,136,110,48,158,7.467153284671533,22.255792982551828
Task_15470,2479,480,35,21,56,5.153846153846154,45.73579989170414
Task_15471,2538,603,178,19,197,4.201986754966887,48.364729990644435
Task_15472,2520,405,93,82,175,6.206896551724138,47.93416919667871
Task_15473,761,601,48,189,237,1.2641196013289036,21.2050832686737
Task_15474,2773,296,50,194,244,9.336700336700337,52.20499594885133
Task_15475,2143,411,151,160,311,5.201456310679611,42.78418972892725
Task_15476,2827,775,115,29,144,3.643041237113402,53.21159695388281
Task_15477,2866,830,190,138,328,3.4488567990373045,55.61354498402886
Task_15478,2695,877,144,185,329,3.069476082004556,53.12493377002145
Task_15479,933,1023,194,54,248,0.9111328125,24.87090578825675
Task_15480,1544,372,97,193,290,4.13941018766756,33.14058861342331
Task_15481,2301,685,179,71,250,3.3542274052478134,45.5147217327383
Task_15482,808,270,160,76,236,2.981549815498155,20.57589565074089
Task_15483,597,381,193,155,348,1.5628272251308901,18.342080719832516
Task_15484,2091,87,27,44,71,23.761363636363637,37.74043562208127
Task_15485,1891,827,21,162,183,2.283816425120773,39.48566388064477
Task_15486,647,434,69,142,211,1.4873563218390804,18.739642785710178
Task_15487,1147,642,183,182,365,1.7838258164852254,28.011307888253118
Task_15488,1457,716,33,27,60,2.03207810320781,30.33189487516637
Task_15489,2840,653,90,190,280,4.342507645259939,54.49692194173179
Task_15490,1732,131,71,137,208,13.121212121212121,34.60077065447479
Task_15491,2479,476,153,158,311,5.19706498951782,48.311121737988636
Task_15492,1516,159,44,92,136,9.475,30.558931770223975
Task_15493,744,514,155,24,179,1.4446601941747572,19.613175063117197
Task_15494,2474,936,81,173,254,2.64034151547492,49.50514981365948
Task_15495,2720,529,65,101,166,5.132075471698113,51.596222209606424
Task_15496,1790,914,48,18,66,1.9562841530054644,36.05795287152346
Task_15497,1216,947,111,27,138,1.2827004219409284,28.1340338165311
Task_15498,630,413,80,118,198,1.5217391304347827,18.291935381541414
Task_15499,605,866,86,52,138,0.6978085351787774,18.722940588260197
Task_15500,2485,717,124,39,163,3.4610027855153205,47.81037279928577
Task_15501,530,391,13,196,209,1.3520408163265305,16.71060500624259
Task_15502,826,557,103,77,180,1.4802867383512546,21.472276119902336
Task_15503,2954,373,29,98,127,7.898395721925134,54.43820589349709
Task_15504,2921,923,193,153,346,3.161255411255411,56.87965660429601
Task_15505,2980,611,159,62,221,4.869281045751634,55.81245534291438
Task_15506,2343,809,102,127,229,2.8925925925925924,46.79916461755423
Task_15507,1998,969,172,51,223,2.0597938144329895,41.37928503098842
Task_15508,1672,573,36,190,226,2.912891986062718,35.52254288125062
Task_15509,2829,166,171,61,232,16.940119760479043,51.719570486844155
Task_15510,1645,627,168,164,332,2.6194267515923566,35.68998765533552
Task_15511,1119,909,92,29,121,1.2296703296703297,26.36436689095972
Task_15512,1041,659,121,192,313,1.5772727272727274,26.136385587120262
Task_15513,2529,905,58,123,181,2.7913907284768213,49.85629922439134
Task_15514,2889,704,107,46,153,4.097872340425532,53.98370993846225
Task_15515,1280,558,95,125,220,2.289803220035778,29.141398322167174
Task_15516,2212,819,58,56,114,2.6975609756097563,43.503610442222715
Task_15517,2611,376,63,122,185,6.925729442970822,49.48335938165752
Task_15518,861,400,123,63,186,2.14713216957606,21.444262970885845
Task_15519,1662,445,118,53,171,3.726457399103139,34.19329716889826
Task_15520,1165,506,120,149,269,2.2978303747534516,27.402859220376797
Task_15521,2408,184,79,113,192,13.016216216216216,45.54952357823868
Task_15522,2082,625,127,51,178,3.3258785942492013,41.41808082434031
Task_15523,1822,664,95,74,169,2.73984962406015,37.531362952717835
Task_15524,1707,826,22,43,65,2.064087061668682,34.67462537626863
Task_15525,2024,169,126,163,289,11.905882352941177,39.755388236360346
Task_15526,1048,429,17,106,123,2.437209302325581,24.312221486649904
Task_15527,1397,450,178,200,378,3.097560975609756,31.46423780858176
Task_15528,729,695,90,30,120,1.0474137931034482,19.512092003156052
Task_15529,2212,182,197,178,375,12.087431693989071,43.30205417864044
Task_15530,2335,364,123,186,309,6.397260273972603,45.695568460571685
Task_15531,2126,291,82,98,180,7.280821917808219,41.45642948767988
Task_15532,2018,568,44,50,94,3.546572934973638,39.333282292516266
Task_15533,2552,560,21,51,72,4.549019607843137,47.423392398662735
Task_15534,515,186,166,15,181,2.7540106951871657,14.97488501319711
Task_15535,735,437,53,138,191,1.678082191780822,20.070363321957615
Task_15536,1233,857,67,109,176,1.437062937062937,29.095941212813017
Task_15537,2127,731,185,27,212,2.9057377049180326,42.38198439144549
Task_15538,1157,585,124,178,302,1.9744027303754266,27.715252765545284
Task_15539,2490,241,137,171,308,10.289256198347108,47.68824654740255
Task_15540,894,286,62,63,125,3.1149825783972127,21.273170594663718
Task_15541,556,156,181,21,202,3.5414012738853504,15.42162660886469
Task_15542,2330,862,121,179,300,2.6998841251448438,47.15520911577536
Task_15543,1395,847,123,32,155,1.6450471698113207,30.804377475487726
Task_15544,2972,103,105,94,199,28.576923076923077,53.63758167199364
Task_15545,1102,436,126,31,157,2.5217391304347827,24.889815358374463
Task_15546,2353,559,183,105,288,4.201785714285714,46.40198848181931
Task_15547,1907,294,159,170,329,6.464406779661017,38.75665134006619
Task_15548,2925,438,150,68,218,6.662870159453303,54.41856982834301
Task_15549,1204,143,97,170,267,8.36111111111111,26.638690877346193
Task_15550,794,983,67,44,111,0.806910569105691,21.41586868946207
Task_15551,615,875,16,109,125,0.702054794520548,19.101122675161804
Task_15552,2810,160,37,111,148,17.453416149068325,51.01575464791079
Task_15553,2152,417,125,200,325,5.148325358851674,43.067978677523435
Task_15554,888,250,66,88,154,3.537848605577689,21.47120143355926
Task_15555,2728,402,19,76,95,6.769230769230769,50.34402121613903
Task_15556,2276,541,87,106,193,4.199261992619927,44.65880084641014
Task_15557,764,894,112,67,179,0.8536312849162011,21.468474130437226
Task_15558,2871,510,189,109,298,5.61839530332681,54.49683866327113
Task_15559,1885,514,166,170,336,3.6601941747572817,39.15996626384116
Task_15560,2549,868,31,194,225,2.9332566168009206,50.32536147254547
Task_15561,2274,984,11,55,66,2.3086294416243653,44.33212579421067
Task_15562,1476,337,132,126,258,4.366863905325443,31.700563736030286
Task_15563,569,370,138,156,294,1.5336927223719676,17.622636335399353
Task_15564,2280,818,146,51,197,2.7838827838827838,45.25961217785493
Task_15565,2287,628,168,131,299,3.6359300476947536,45.663850659289665
Task_15566,2020,691,23,62,85,2.9190751445086707,39.81664681341446
Task_15567,2171,107,80,16,96,20.10185185185185,39.528904913198865
Task_15568,2830,328,34,102,136,8.601823708206688,52.31305776339719
Task_15569,2015,673,48,162,210,2.9896142433234423,41.20190947092089
Task_15570,833,821,87,92,179,1.0133819951338199,22.409988073096304
Task_15571,1981,393,17,116,133,5.027918781725888,39.10305755431358
Task_15572,1823,635,95,68,163,2.8663522012578615,37.35753135189771
Task_15573,2162,911,83,75,158,2.370614035087719,43.603276533888625
Task_15574,2005,174,67,118,185,11.457142857142857,38.94070871591692
Task_15575,644,529,100,18,118,1.2150943396226415,17.476079063911474
Task_15576,2631,178,24,134,158,14.69832402234637,48.288586751363304
Task_15577,2148,614,27,178,205,3.4926829268292683,43.05337874823806
Task_15578,1140,404,34,86,120,2.814814814814815,25.686593757588653
Task_15579,2371,402,180,52,232,5.883374689826303,45.588345445497964
Task_15580,1044,79,17,20,37,13.05,20.789118110670206
Task_15581,2556,797,23,14,37,3.2030075187969924,47.68742619519557
Task_15582,638,216,161,189,350,2.9400921658986174,18.56489873549106
Task_15583,1420,513,133,112,245,2.762645914396887,31.29966803043322
Task_15584,1818,893,48,102,150,2.033557046979866,38.20644828712035
Task_15585,2493,413,33,167,200,6.021739130434782,47.84569361307496
Task_15586,2184,636,43,41,84,3.4285714285714284,42.01341471180943
Task_15587,1675,801,23,180,203,2.0885286783042396,36.13885193707657
Task_15588,1364,460,151,155,306,2.9587852494577005,30.58323138574499
Task_15589,2235,807,175,110,285,2.766089108910891,45.30930154304057
Task_15590,948,231,80,151,231,4.086206896551724,22.971701899205897
Task_15591,2796,315,30,184,214,8.848101265822784,52.39112543903769
Task_15592,1756,490,134,103,237,3.576374745417515,36.49676313317513
Task_15593,2862,442,158,155,313,6.460496613995486,54.266723056418925
Task_15594,2198,1015,178,110,288,2.1633858267716537,45.385079617832936
Task_15595,2792,569,89,176,265,4.898245614035088,53.36492455100112
Task_15596,2325,684,37,147,184,3.394160583941606,45.937523062197236
Task_15597,748,788,149,29,178,0.9480354879594424,20.67476539185348
Task_15598,2311,398,115,191,306,5.791979949874687,45.42276482677056
Task_15599,2992,67,197,120,317,44.0,54.242017913880915
Task_15600,1505,948,132,75,207,1.5858798735511064,33.573525096669734
Task_15601,1117,600,14,41,55,1.8585690515806987,24.63384187068142
Task_15602,2394,786,13,20,33,3.0419313850063534,45.05061630518848
Task_15603,2756,337,26,184,210,8.153846153846153,51.79962004863062
Task_15604,2741,990,25,199,224,2.765893037336024,53.739854853277215
Task_15605,1010,282,108,79,187,3.568904593639576,23.63960748266507
Task_15606,1504,435,97,121,218,3.44954128440367,32.28063821594311
Task_15607,2399,251,145,64,209,9.51984126984127,45.40764237814019
Task_15608,2061,299,90,173,263,6.87,40.90978422097802
Task_15609,889,411,184,36,220,2.157766990291262,21.83493412070887
Task_15610,2675,168,57,69,126,15.828402366863905,48.751198211977744
Task_15611,1681,156,38,132,170,10.707006369426752,33.552018221342635
Task_15612,1173,380,148,123,271,3.078740157480315,27.100862478519677
Task_15613,2750,521,198,39,237,5.268199233716475,51.728097810291615
Task_15614,1218,468,107,69,176,2.5970149253731343,27.27408043613066
Task_15615,2333,652,68,44,112,3.572741194486983,44.6384100695835
Task_15616,1175,382,159,150,309,3.0678851174934727,27.349757591364234
Task_15617,1401,142,194,172,366,9.797202797202797,30.172493470216878
Task_15618,1055,166,127,39,166,6.317365269461078,23.178197039921354
Task_15619,1951,526,102,19,121,3.7020872865275143,38.18649626298297
Task_15620,719,169,179,78,257,4.229411764705882,18.769735548403137
Task_15621,1848,551,53,115,168,3.347826086956522,37.87781327363627
Task_15622,1002,722,47,20,67,1.3858921161825726,23.024961566603654
Task_15623,2782,476,183,162,345,5.832285115303983,53.26664434566042
Task_15624,1246,391,35,66,101,3.1785714285714284,26.873064736898357
Task_15625,1917,948,145,55,200,2.0200210748155953,39.9416622465502
Task_15626,1768,328,186,82,268,5.37386018237082,36.198372544636335
Task_15627,2659,207,108,26,134,12.783653846153847,48.56410394842208
Task_15628,618,802,188,22,210,0.7696139476961394,18.73891135162745
Task_15629,537,489,42,131,173,1.0959183673469388,16.8284743841836
Task_15630,641,978,78,170,248,0.6547497446373851,20.672624721439263
Task_15631,1669,137,24,93,117,12.094202898550725,32.53772357927826
Task_15632,2764,997,146,73,219,2.7695390781563125,53.703426298882995
Task_15633,843,651,135,137,272,1.2929447852760736,22.691587405473452
Task_15634,2049,579,115,155,270,3.532758620689655,41.643915632445264
Task_15635,1804,600,143,39,182,3.0016638935108153,36.733688514174936
Task_15636,2167,108,97,150,247,19.880733944954127,41.34768499788038
Task_15637,1004,973,153,180,333,1.0308008213552362,26.57903840945198
Task_15638,1001,229,146,61,207,4.352173913043479,23.1799786190109
Task_15639,624,593,111,122,233,1.0505050505050506,18.846481217626785
Task_15640,821,518,128,130,258,1.581888246628131,21.874092523473745
Task_15641,1943,77,106,167,273,24.91025641025641,37.736975885010885
Task_15642,2630,300,177,96,273,8.737541528239202,49.875534888376905
Task_15643,1257,657,84,10,94,1.9103343465045592,27.40977185649092
Task_15644,1464,931,73,193,266,1.5708154506437768,33.53613380689005
Task_15645,2351,1006,118,14,132,2.3346573982125123,46.23363200950272
Task_15646,2283,903,94,107,201,2.525442477876106,45.99705299728385
Task_15647,2229,554,139,134,273,4.0162162162162165,44.397454315695875
Task_15648,2214,873,170,160,330,2.533180778032037,45.45894189579504
Task_15649,2672,279,135,58,193,9.542857142857143,49.70721756986592
Task_15650,1915,370,190,77,267,5.1617250673854445,38.55584428557393
Task_15651,1943,236,82,84,166,8.19831223628692,38.248541974259204
Task_15652,1459,818,92,183,275,1.7814407814407816,33.105296421719686
Task_15653,939,850,49,187,236,1.1034077555816686,24.79430471621104
Task_15654,2237,426,47,169,216,5.23887587822014,43.94600226355838
Task_15655,1307,366,131,134,265,3.561307901907357,29.164902565866623
Task_15656,571,116,106,141,247,4.880341880341881,16.30588794161709
Task_15657,2163,64,75,97,172,33.276923076923076,40.64618894653529
Task_15658,1350,589,170,55,225,2.288135593220339,29.951845073338177
Task_15659,1828,442,72,48,120,4.126410835214447,36.086008861793324
Task_15660,824,755,114,52,166,1.08994708994709,21.926865706414844
Task_15661,1629,1008,176,72,248,1.6144697720515362,35.89509938459347
Task_15662,1828,754,161,68,229,2.4211920529801323,38.10530666274169
Task_15663,2689,572,151,73,224,4.692844677137871,51.19891290388896
Task_15664,2085,643,82,85,167,3.237577639751553,41.811667192968905
Task_15665,1326,530,31,132,163,2.4971751412429377,29.463726081650723
Task_15666,1987,154,99,104,203,12.819354838709678,38.64815449605381
Task_15667,1606,243,109,73,182,6.581967213114754,32.75336009847524
Task_15668,2144,651,132,196,328,3.2883435582822087,43.69767012172443
Task_15669,2367,728,49,14,63,3.246913580246914,44.612534125459185
Task_15670,811,858,170,47,217,0.9441210710128056,22.109143302375156
Task_15671,2991,838,155,193,348,3.5649582836710367,57.789932774137924
Task_15672,1785,347,149,113,262,5.129310344827586,36.61988191431977
Task_15673,2580,240,88,57,145,10.705394190871369,47.81582147991846
Task_15674,2232,849,40,126,166,2.6258823529411766,44.855557767409096
Task_15675,690,212,131,59,190,3.23943661971831,18.134904678539296
Task_15676,1914,473,193,131,324,4.037974683544304,39.37669106033272
Task_15677,2186,575,23,179,202,3.795138888888889,43.51683783839069
Task_15678,778,455,38,196,234,1.706140350877193,21.024035414723013
Task_15679,1396,345,39,141,180,4.034682080924855,30.115896392252456
Task_15680,2893,560,101,200,301,5.1568627450980395,55.15377591659976
Task_15681,1712,720,127,72,199,2.3744798890429957,36.08779256303625
Task_15682,1786,520,14,11,25,3.4280230326295587,34.55038878034275
Task_15683,917,304,162,174,336,3.0065573770491802,23.17511647282919
Task_15684,2366,679,175,78,253,3.4794117647058824,46.668355774696664
Task_15685,2561,540,132,145,277,4.733826247689464,49.643693348589956
Task_15686,638,529,112,180,292,1.2037735849056603,19.220565384339277
Task_15687,1947,198,19,72,91,9.78391959798995,37.248087126599685
Task_15688,1734,1005,65,196,261,1.7236580516898607,38.06162510019436
Task_15689,1875,303,45,43,88,6.167763157894737,36.03703788149665
Task_15690,1790,257,138,77,215,6.937984496124031,35.96313987954031
Task_15691,531,759,57,84,141,0.6986842105263158,17.493230270148505
Task_15692,2593,282,31,199,230,9.162544169611307,49.152906900169114
Task_15693,2148,186,20,98,118,11.48663101604278,40.762819772647546
Task_15694,2020,883,117,58,175,2.2850678733031673,41.235119328713274
Task_15695,2329,200,180,54,234,11.587064676616915,44.187134657743286
Task_15696,721,1019,191,61,252,0.7068627450980393,21.56708096641783
Task_15697,2194,906,80,63,143,2.4189636163175305,43.943364475698615
Task_15698,1143,160,83,91,174,7.099378881987578,25.148554511581057
Task_15699,909,765,41,75,116,1.1866840731070496,23.034302707088344
Task_15700,1515,684,148,103,251,2.2116788321167884,33.35505456252185
Task_15701,2413,670,153,87,240,3.596125186289121,47.40055660624938
Task_15702,2151,782,43,74,117,2.7471264367816093,42.79567022579945
Task_15703,1659,422,111,95,206,3.921985815602837,34.60553625665303
Task_15704,1903,389,86,166,252,4.87948717948718,38.61768189481956
Task_15705,1023,748,76,95,171,1.3658210947930574,25.37543604175133
Task_15706,1519,324,126,84,210,4.673846153846154,31.985341964676824
Task_15707,1048,313,130,92,222,3.337579617834395,24.58980118126011
Task_15708,2643,195,46,26,72,13.48469387755102,47.53973407476726
Task_15709,1627,120,196,164,360,13.446280991735538,33.53210724233787
Task_15710,1639,484,80,160,240,3.379381443298969,34.77584755996332
Task_15711,2303,655,171,97,268,3.510670731707317,45.841492268954454
Task_15712,1074,731,53,93,146,1.4672131147540983,25.921933098312817
Task_15713,1325,596,39,151,190,2.219430485762144,29.87259127841965
Task_15714,1086,970,38,75,113,1.1184346035015449,26.505708280566182
Task_15715,2299,451,84,140,224,5.086283185840708,44.972057966764034
Task_15716,659,411,42,158,200,1.5995145631067962,18.800562349522316
Task_15717,2244,701,169,76,245,3.1965811965811968,44.7175265100345
Task_15718,2235,726,40,112,152,3.0742778541953233,44.24821544494389
Task_15719,652,128,114,106,220,5.054263565891473,17.526986667231693
Task_15720,2461,303,82,173,255,8.095394736842104,47.2595409597726
Task_15721,666,757,38,67,105,0.8786279683377308,18.922306677759394
Task_15722,1896,491,114,183,297,3.8536585365853657,39.103956859227786
Task_15723,855,634,49,160,209,1.3464566929133859,22.68116613317743
Task_15724,2328,229,127,169,296,10.121739130434783,45.027193118475566
Task_15725,1657,1022,130,156,286,1.619745845552297,36.87839820182657
Task_15726,2000,959,173,174,347,2.0833333333333335,42.43302125992433
Task_15727,1945,121,59,171,230,15.942622950819672,37.9955522931179
Task_15728,1469,950,128,114,242,1.5446898002103049,33.38677444506144
Task_15729,859,322,175,156,331,2.6594427244582044,22.266977141863645
Task_15730,982,966,135,45,180,1.015511892450879,24.816994913113447
Task_15731,508,139,39,16,55,3.6285714285714286,13.27749072331804
Task_15732,1702,68,90,75,165,24.666666666666668,32.965820133517695
Task_15733,1346,297,132,40,172,4.516778523489933,28.469540470996137
Task_15734,2936,461,116,63,179,6.354978354978355,54.4521865818111
Task_15735,1572,439,170,102,272,3.5727272727272728,33.577504787821645
Task_15736,2996,777,29,121,150,3.8508997429305913,56.476077035004636
Task_15737,2225,677,182,28,210,3.281710914454277,43.77560664481689
Task_15738,2642,541,161,198,359,4.874538745387454,51.37670997092033
Task_15739,633,481,18,166,184,1.3132780082987552,18.43442465513461
Task_15740,2169,728,34,118,152,2.9753086419753085,43.2207576293326
Task_15741,1874,657,85,142,227,2.8480243161094223,38.91175671624482
Task_15742,1059,432,61,125,186,2.4457274826789837,25.116001460980215
Task_15743,2891,334,69,185,254,8.629850746268657,54.21094493636613
Task_15744,2807,948,171,67,238,2.957850368809273,54.263868228452374
Task_15745,2481,955,69,161,230,2.5951882845188283,49.56871439005631
Task_15746,1909,483,71,200,271,3.9442148760330578,39.251823379087085
Task_15747,1949,936,150,130,280,2.080042689434365,41.186863711528744
Task_15748,2791,754,150,186,336,3.696688741721854,54.29262177796977
Task_15749,1298,226,46,20,66,5.71806167400881,26.095737525840846
Task_15750,1397,220,181,137,318,6.321266968325792,30.343356680837243
Task_15751,1537,857,125,148,273,1.7913752913752914,34.40782392952887
Task_15752,1988,763,148,41,189,2.602094240837696,40.209960137758394
Task_15753,2770,156,195,27,222,17.643312101910826,50.46203210973112
Task_15754,1726,970,65,177,242,1.7775489186405766,37.71274792540854
Task_15755,2523,992,138,41,179,2.540785498489426,49.34887230713441
Task_15756,1485,287,74,109,183,5.15625,31.336952171339433
Task_15757,1936,643,28,66,94,3.0062111801242235,38.49956530101385
Task_15758,2945,551,75,29,104,5.3351449275362315,53.94948994635093
Task_15759,1255,993,56,83,139,1.2625754527162978,29.51258240873442
Task_15760,1954,300,61,89,150,6.4916943521594686,38.48042810796783
Task_15761,800,74,62,192,254,10.666666666666666,19.845740467724692
Task_15762,1294,562,195,89,284,2.2984014209591472,29.55845288505002
Task_15763,1533,138,146,55,201,11.028776978417266,30.968794461654326
Task_15764,2493,711,47,50,97,3.5014044943820224,47.300434753501655
Task_15765,521,590,83,74,157,0.8815566835871405,16.57817889510198
Task_15766,1058,842,57,40,97,1.255041518386714,24.845048096115843
Task_15767,1214,987,172,187,359,1.228744939271255,30.073148729717605
Task_15768,2535,1002,85,140,225,2.527417746759721,50.451175619046786
Task_15769,1139,321,68,110,178,3.5372670807453415,25.982016918493724
Task_15770,630,465,17,163,180,1.351931330472103,18.302920161202774
Task_15771,778,406,181,170,351,1.9115479115479115,21.36286818046642
Task_15772,693,155,152,80,232,4.4423076923076925,18.19074836991128
Task_15773,1727,84,188,87,275,20.31764705882353,34.146809317098295
Task_15774,2276,322,119,133,252,7.046439628482972,44.28568022561586
Task_15775,2345,519,31,83,114,4.509615384615385,45.10115969510006
Task_15776,612,95,160,46,206,6.375,15.746499136759079
Task_15777,2605,444,154,40,194,5.853932584269663,48.989627369805056
Task_15778,1300,849,67,29,96,1.5294117647058822,28.78737227517092
Task_15779,1457,855,109,156,265,1.7021028037383177,33.09630128513478
Task_15780,2706,428,43,129,172,6.3076923076923075,51.06248127947137
Task_15781,2582,276,194,98,292,9.321299638989169,49.09890011262721
Task_15782,1605,646,152,147,299,2.480680061823802,34.94244102874744
Task_15783,2664,174,192,60,252,15.222857142857142,49.262449470436586
Task_15784,1838,477,83,126,209,3.8451882845188283,37.69647310520849
Task_15785,2814,933,64,173,237,3.012847965738758,54.82374561033809
Task_15786,856,837,48,91,139,1.0214797136038185,22.66377498855014
Task_15787,1171,853,15,191,206,1.3711943793911008,28.28643467987818
Task_15788,2337,743,161,43,204,3.1411290322580645,45.749626427808614
Task_15789,2761,403,17,56,73,6.834158415841584,50.219043048135795
Task_15790,2228,785,117,100,217,2.8346055979643765,44.80838432030301
Task_15791,1614,378,95,169,264,4.258575197889182,34.11779927469944
Task_15792,2912,496,61,154,215,5.859154929577465,54.85936787167471
Task_15793,2341,533,122,46,168,4.383895131086143,44.9514421003239
Task_15794,956,415,64,142,206,2.298076923076923,23.583731991545633
Task_15795,1221,418,168,160,328,2.9140811455847255,28.292875548483398
Task_15796,2821,572,112,199,311,4.923211169284468,54.09584502140857
Task_15797,744,179,85,185,270,4.133333333333334,19.49768238188395
Task_15798,2661,679,192,175,367,3.913235294117647,52.119988624980785
Task_15799,914,429,47,190,237,2.125581395348837,23.143230527437424
Task_15800,1921,373,192,50,242,5.136363636363637,38.24526250094215
Task_15801,1020,613,66,45,111,1.6612377850162867,23.72643578336834
Task_15802,1682,682,118,176,294,2.4626647144948755,36.2948494664223
Task_15803,1628,547,196,51,247,2.9708029197080292,34.30605253676887
Task_15804,885,80,40,127,167,10.925925925925926,20.515640936631925
Task_15805,879,503,161,158,319,1.744047619047619,23.090719323830285
Task_15806,1358,580,39,152,191,2.3373493975903616,30.354057222249278
Task_15807,1884,802,33,32,65,2.3462017434620175,37.35275122450278
Task_15808,1761,373,78,90,168,4.708556149732621,35.86000190483029
Task_15809,1363,826,40,46,86,1.6481257557436517,29.597750471110732
Task_15810,2041,369,186,48,234,5.5162162162162165,40.034994853164044
Task_15811,1411,240,130,192,322,5.854771784232365,30.732941607828565
Task_15812,2640,392,13,88,101,6.717557251908397,49.10527668086712
Task_15813,1285,223,183,32,215,5.736607142857143,27.465339653852272
Task_15814,1239,661,93,172,265,1.8716012084592144,29.114261353463405
Task_15815,1815,488,162,87,249,3.7116564417177913,37.39363449680137
Task_15816,1608,609,198,195,393,2.636065573770492,35.367819228774145
Task_15817,1612,216,128,91,219,7.428571428571429,33.15554674304684
Task_15818,1672,876,33,195,228,1.9064994298745723,36.47831889112515
Task_15819,1638,385,192,123,315,4.243523316062176,34.672400702173476
Task_15820,1266,753,196,106,302,1.6790450928381964,29.846647141270523
Task_15821,2680,74,11,107,118,35.733333333333334,47.89263246294775
Task_15822,1681,167,40,70,110,10.005952380952381,32.771434615496496
Task_15823,1800,490,134,125,259,3.6659877800407332,37.32471943085963
Task_15824,1462,983,131,127,258,1.4857723577235773,33.46932171857339
Task_15825,926,836,89,128,217,1.1063321385902032,24.25361260006635
Task_15826,1223,600,59,94,153,2.0349417637271214,27.892476003245168
Task_15827,1211,291,97,153,250,4.147260273972603,27.370133125248135
Task_15828,1541,269,88,71,159,5.707407407407407,31.526103585695807
Task_15829,541,212,65,134,199,2.539906103286385,16.328769933119606
Task_15830,2931,198,174,11,185,14.728643216080402,53.140433802967976
Task_15831,1110,1009,67,60,127,1.099009900990099,26.952952490672242
Task_15832,2260,303,79,59,138,7.434210526315789,42.95849624003889
Task_15833,1686,471,153,173,326,3.5720338983050848,35.83174601167803
Task_15834,1439,341,25,52,77,4.207602339181286,29.14096611210171
Task_15835,2906,599,161,41,202,4.843333333333334,54.29393506728294
Task_15836,1161,811,173,98,271,1.4298029556650247,28.179019979705007
Task_15837,690,921,64,70,134,0.7483731019522777,20.170993394185263
Task_15838,2978,151,45,116,161,19.592105263157894,53.72802946853485
Task_15839,541,418,185,154,339,1.2911694510739857,17.511375876347312
Task_15840,1551,820,65,110,175,1.8891595615103531,34.061135085376826
Task_15841,1432,688,134,136,270,2.078374455732946,32.18685393145508
Task_15842,933,447,41,38,79,2.0825892857142856,21.376162768303704
Task_15843,2186,332,16,110,126,6.564564564564565,42.13603025385317
Task_15844,1394,252,153,103,256,5.509881422924901,30.0776784587638
Task_15845,719,661,162,37,199,1.0861027190332326,19.857483217557064
Task_15846,1857,255,145,36,181,7.25390625,36.435335152327674
Task_15847,2283,201,114,158,272,11.301980198019802,44.08437936821571
Task_15848,2243,1001,50,39,89,2.2385229540918163,44.077387412268
Task_15849,1940,998,96,40,136,1.941941941941942,39.79153185171031
Task_15850,2648,611,33,148,181,4.326797385620915,50.792398565192684
Task_15851,1241,759,174,31,205,1.6328947368421052,28.43039637020981
Task_15852,2043,893,41,166,207,2.285234899328859,42.278995226727396
Task_15853,2310,797,145,106,251,2.8947368421052633,46.30712576847598
Task_15854,886,497,100,131,231,1.7791164658634537,22.746552858289892
Task_15855,1289,471,15,79,94,2.7309322033898304,27.82696518095373
Task_15856,1907,122,85,176,261,15.504065040650406,37.53070326156012
Task_15857,2913,397,155,119,274,7.319095477386934,54.69526373142611
Task_15858,1510,851,113,15,128,1.772300469483568,32.49372755599678
Task_15859,807,397,20,51,71,2.027638190954774,19.27881032554487
Task_15860,722,766,90,25,115,0.9413298565840938,19.629323222857796
Task_15861,1944,473,26,12,38,4.10126582278481,36.97160935751433
Task_15862,1865,391,118,190,308,4.75765306122449,38.350273602198
Task_15863,641,757,119,46,165,0.8456464379947229,18.820491024616953
Task_15864,2661,286,66,149,215,9.27177700348432,50.18120475786956
Task_15865,2807,1024,161,167,328,2.738536585365854,55.327970238200386
Task_15866,777,821,144,200,344,0.9452554744525548,22.630839103041193
Task_15867,2215,888,14,80,94,2.4915635545556807,43.811640747940224
Task_15868,1462,599,91,90,181,2.4366666666666665,31.85390620034082
Task_15869,2474,571,122,196,318,4.325174825174825,48.624955189017335
Task_15870,1199,170,106,82,188,7.011695906432749,26.04622409168783
Task_15871,935,766,161,58,219,1.2190352020860495,23.89400823524947
Task_15872,1600,236,159,14,173,6.751054852320675,32.16757789021625
Task_15873,1787,684,159,80,239,2.6087591240875914,37.4762541505438
Task_15874,2077,196,189,103,292,10.543147208121827,40.83873919415217
Task_15875,2221,662,128,150,278,3.349924585218703,44.659179125219374
Task_15876,2620,910,59,75,134,2.87596048298573,50.827118690842326
Task_15877,580,1006,68,102,170,0.5759682224428997,19.298031426559064
Task_15878,1473,363,51,47,98,4.0467032967032965,29.915651300648467
Task_15879,1152,653,125,98,223,1.761467889908257,27.36918654076456
Task_15880,1823,744,145,188,333,2.4469798657718123,38.91579056714645
Task_15881,1811,80,12,85,97,22.358024691358025,34.0076599916619
Task_15882,1629,109,20,66,86,14.809090909090909,31.275068857391783
Task_15883,557,314,152,182,334,1.7682539682539682,17.50405617119003
Task_15884,1599,310,174,187,361,5.141479099678457,34.110099728339954
Task_15885,2604,498,28,41,69,5.218436873747495,47.81815170003628
Task_15886,2956,599,58,46,104,4.926666666666667,54.14817630066303
Task_15887,1045,134,26,11,37,7.7407407407407405,21.48564377593296
Task_15888,1495,672,145,151,296,2.221396731054978,33.273922040315426
Task_15889,1342,141,89,139,228,9.450704225352112,28.546981224081893
Task_15890,2674,545,35,63,98,4.897435897435898,49.91837753123777
Task_15891,2777,733,177,94,271,3.7833787465940056,53.570135419912106
Task_15892,1414,528,109,63,172,2.67296786389414,30.533714425650277
Task_15893,1269,620,109,63,172,2.0434782608695654,28.526463353455032
Task_15894,2567,115,154,142,296,22.129310344827587,47.91059710091802
Task_15895,2528,857,165,105,270,2.9463869463869465,50.03309129634132
Task_15896,993,661,128,35,163,1.5,23.998826864257712
Task_15897,2192,288,89,29,118,7.58477508650519,41.265271465339055
Task_15898,1582,377,89,126,215,4.185185185185185,33.29306540946456
Task_15899,807,91,84,180,264,8.771739130434783,20.00392405700254
Task_15900,1538,687,74,167,241,2.23546511627907,33.83806050075514
Task_15901,770,470,24,108,132,1.634819532908705,20.190319428093545
Task_15902,2752,530,151,145,296,5.182674199623352,52.72129587769132
Task_15903,2566,614,81,197,278,4.172357723577235,50.093465546516086
Task_15904,611,1009,25,160,185,0.6049504950495049,19.89700802941775
Task_15905,986,453,128,121,249,2.171806167400881,24.27122271047943
Task_15906,2650,147,15,90,105,17.905405405405407,47.93843516752074
Task_15907,1301,873,151,75,226,1.488558352402746,30.19402859145353
Task_15908,590,607,60,107,167,0.9703947368421053,18.031182321887588
Task_15909,2749,745,111,81,192,3.6849865951742626,52.68985642915282
Task_15910,2844,392,71,164,235,7.236641221374046,53.53678648976677
Task_15911,2568,582,43,87,130,4.404802744425386,49.05287590767269
Task_15912,1342,725,120,103,223,1.8484848484848484,30.616408186771963
Task_15913,2769,150,47,125,172,18.337748344370862,50.72871031766093
Task_15914,1607,550,131,33,164,2.9165154264972775,33.39380598703263
Task_15915,1708,922,66,52,118,1.8504875406283856,35.92910212036444
Task_15916,823,717,185,130,315,1.1462395543175488,22.755530876697865
Task_15917,637,205,36,41,77,3.092233009708738,15.836963751468948
Task_15918,2816,213,157,140,297,13.158878504672897,52.63319665365293
Task_15919,1793,888,53,45,98,2.016872890888639,36.56923370989692
Task_15920,1211,751,34,127,161,1.610372340425532,28.222571595032523
Task_15921,1731,920,87,177,264,1.8794788273615635,37.639783702118386
Task_15922,2789,875,150,157,307,3.1837899543378994,54.46788305291839
Task_15923,1620,564,50,68,118,2.8672566371681416,33.62557090101592
Task_15924,1942,740,134,73,207,2.620782726045884,39.822098378574275
Task_15925,2400,569,97,191,288,4.2105263157894735,47.31191646743043
Task_15926,2015,191,163,129,292,10.494791666666666,39.86200044187633
Task_15927,2245,487,158,186,344,4.600409836065574,44.832235218233535
Task_15928,2193,85,10,167,177,25.5,41.18938262250569
Task_15929,1562,275,100,108,208,5.659420289855072,32.601995042751774
Task_15930,2523,321,140,41,181,7.8354037267080745,47.20278267808245
Task_15931,1863,797,186,71,257,2.3345864661654137,38.95887927188757
Task_15932,1731,927,92,128,220,1.865301724137931,37.438785496347734
Task_15933,1635,548,58,70,128,2.978142076502732,34.11296583512634
Task_15934,2823,291,183,147,330,9.667808219178083,53.19807972386576
Task_15935,2581,381,167,115,282,6.7565445026178015,49.418666448900105
Task_15936,2669,721,108,165,273,3.6966759002770084,51.941145386599146
Task_15937,2946,766,187,107,294,3.8409387222946547,56.48088275095495
Task_15938,1195,325,134,157,291,3.665644171779141,27.41143596814929
Task_15939,1340,92,67,44,111,14.408602150537634,26.323125393829667
Task_15940,997,881,81,22,103,1.1303854875283448,24.086445652712346
Task_15941,2061,989,66,95,161,2.081818181818182,42.48110335146509
Task_15942,1748,929,63,92,155,1.8795698924731183,37.23173133459086
Task_15943,1033,518,195,32,227,1.9903660886319845,24.488241611559175
Task_15944,2988,571,192,76,268,5.223776223776224,56.19136799854283
Task_15945,660,826,40,62,102,0.7980652962515115,18.849011065124973
Task_15946,1506,207,72,45,117,7.240384615384615,30.118076565426495
Task_15947,1632,153,65,60,125,10.597402597402597,32.02016406092421
Task_15948,2830,339,95,32,127,8.323529411764707,51.76984824894861
Task_15949,2891,265,135,198,333,10.868421052631579,54.26616587419418
Task_15950,2977,883,73,19,92,3.3676470588235294,55.35849741193923
Task_15951,2306,993,39,119,158,2.319919517102616,46.28204455366551
Task_15952,1557,762,69,40,109,2.040629095674967,32.69369911542042
Task_15953,2840,529,38,74,112,5.3584905660377355,52.86241335032933
Task_15954,2931,994,183,93,276,2.9457286432160803,56.84016177920959
Task_15955,1860,248,109,134,243,7.469879518072289,37.41342029726626
Task_15956,1178,701,107,93,200,1.6780626780626782,27.795615509054812
Task_15957,2573,292,29,11,40,8.781569965870307,46.33103309367933
Task_15958,1858,716,79,117,196,2.591352859135286,38.721070901123845
Task_15959,1009,622,179,123,302,1.6195826645264848,25.392889365244766
Task_15960,1524,806,145,139,284,1.8884758364312269,34.07961662656416
Task_15961,2337,708,25,121,146,3.296191819464034,45.80992969543525
Task_15962,2348,251,56,130,186,9.317460317460318,44.90807036076662
Task_15963,1282,926,25,177,202,1.3829557713052858,30.237627579071756
Task_15964,1249,507,128,127,255,2.4586614173228347,28.640526612585987
Task_15965,915,624,138,98,236,1.464,23.54338619173467
Task_15966,825,392,138,99,237,2.099236641221374,21.438553702029193
Task_15967,1574,977,18,123,141,1.6094069529652353,34.51898564932026
Task_15968,512,406,25,82,107,1.257985257985258,15.548406730440961
Task_15969,2721,65,126,49,175,41.22727272727273,48.39136590966604
Task_15970,892,275,44,19,63,3.2318840579710146,19.876231516802278
Task_15971,2162,97,85,149,234,22.06122448979592,41.0904222116423
Task_15972,1718,1001,65,189,254,1.7145708582834331,37.7538513271879
Task_15973,2092,429,100,116,216,4.865116279069768,41.543170800007935
Task_15974,2765,898,53,172,225,3.0756395995550614,53.88406900030875
Task_15975,2180,599,80,160,240,3.6333333333333333,43.70728385920116
Task_15976,926,609,162,10,172,1.518032786885246,22.670796908326395
Task_15977,1419,964,76,189,265,1.4704663212435234,32.91161024006405
Task_15978,1966,470,44,50,94,4.174097664543525,38.19714555630758
Task_15979,2882,897,121,138,259,3.2093541202672604,55.76618664364579
Task_15980,1244,256,134,174,308,4.840466926070039,28.05955024526349
Task_15981,1025,194,153,115,268,5.256410256410256,24.111112313454097
Task_15982,1829,334,82,149,231,5.459701492537313,37.227753966675024
Task_15983,2686,755,25,130,155,3.552910052910053,51.53322124620285
Task_15984,827,177,63,56,119,4.646067415730337,19.254503408010006
Task_15985,2470,610,188,187,375,4.042553191489362,48.92960547084024
Task_15986,2959,188,133,123,256,15.656084656084657,54.60770365038152
Task_15987,1317,285,34,199,233,4.604895104895105,29.021079101718964
Task_15988,1828,742,199,166,365,2.4602960969044414,39.100720270201194
Task_15989,648,314,42,185,227,2.057142857142857,18.495245919902544
Task_15990,1680,305,186,128,314,5.490196078431373,35.0757965763838
Task_15991,1567,303,55,127,182,5.154605263157895,32.7178430327041
Task_15992,2875,531,133,162,295,5.404135338345864,54.692418704207704
Task_15993,1409,525,21,97,118,2.678707224334601,30.293866870114474
Task_15994,659,336,186,122,308,1.9554896142433233,18.99505909830496
Task_15995,956,251,190,139,329,3.7936507936507935,23.535518266909396
Task_15996,1460,551,97,80,177,2.6449275362318843,31.58656637761048
Task_15997,2538,840,131,165,296,3.0178359096313914,50.34344936285593
Task_15998,1189,964,80,66,146,1.232124352331606,28.255752891736762
Task_15999,1849,397,72,90,162,4.6457286432160805,37.26375141402489
Task_16000,1316,743,57,17,74,1.7688172043010753,27.99679627055931
Task_16001,2296,884,30,142,172,2.5943502824858755,46.02884071711754
Task_16002,2855,73,148,155,303,38.58108108108108,52.12873607899604
Task_16003,2280,675,86,142,228,3.3727810650887573,45.35789227317964
Task_16004,1105,356,189,196,385,3.0952380952380953,26.56893999953841
Task_16005,941,208,63,12,75,4.502392344497608,20.40343411169353
Task_16006,2559,642,34,95,129,3.979782270606532,49.155273408884916
Task_16007,1051,108,148,162,310,9.642201834862385,24.097186509500006
Task_16008,2081,302,153,163,316,6.867986798679868,41.46616984197761
Task_16009,1848,964,23,154,177,1.9150259067357513,39.209678100833464
Task_16010,1119,804,189,171,360,1.3900621118012422,27.992460754067192
Task_16011,1888,589,26,27,53,3.2,36.73197373644539
Task_16012,991,754,194,108,302,1.3125827814569537,25.46272358337727
Task_16013,2677,779,98,166,264,3.432051282051282,52.21573184381621
Task_16014,1913,684,11,161,172,2.7927007299270072,39.32014487916958
Task_16015,2639,451,183,96,279,5.838495575221239,50.55537689017959
Task_16016,900,615,25,127,152,1.4610389610389611,22.694069944057986
Task_16017,726,146,20,111,131,4.938775510204081,17.95183176025508
Task_16018,2302,369,68,166,234,6.221621621621622,44.89605693008058
Task_16019,1893,368,88,42,130,5.130081300813008,37.0551481075229
Task_16020,1212,720,176,90,266,1.680998613037448,28.675165449288258
Task_16021,2903,650,161,34,195,4.459293394777266,54.37036874044318
Task_16022,2296,182,56,64,120,12.546448087431694,42.913751744885225
Task_16023,1460,71,74,29,103,20.27777777777778,27.860361468840278
Task_16024,2023,1008,42,166,208,2.0049554013875124,42.328243963021116
Task_16025,1934,82,200,175,375,23.301204819277107,38.09271695858419
Task_16026,1190,446,70,153,223,2.6621923937360177,27.48014812844431
Task_16027,2057,466,68,85,153,4.404710920770878,40.628794227391595
Task_16028,1660,1011,71,143,214,1.640316205533597,36.60821057433931
Task_16029,1781,715,177,90,267,2.4874301675977653,37.68686934406082
Task_16030,1640,833,144,119,263,1.9664268585131894,35.8775412412277
Task_16031,711,619,47,197,244,1.146774193548387,20.482698586817964
Task_16032,2477,766,72,53,125,3.229465449804433,47.78003250441791
Task_16033,1353,409,84,199,283,3.3,30.21723635292072
Task_16034,1891,513,142,16,158,3.678988326848249,37.52411030700566
Task_16035,2179,280,42,96,138,7.754448398576512,41.91562071149408
Task_16036,1268,520,123,161,284,2.433781190019194,29.162837132089493
Task_16037,2004,833,146,138,284,2.402877697841727,41.76721910528915
Task_16038,663,250,98,22,120,2.641434262948207,16.905165403672868
Task_16039,2893,634,99,174,273,4.555905511811024,55.228197933890044
Task_16040,1913,848,200,196,396,2.253239104829211,40.96200790243406
Task_16041,2898,164,181,105,286,17.563636363636363,53.42657571674055
Task_16042,2875,394,29,107,136,7.2784810126582276,53.24394329904627
Task_16043,2250,352,42,86,128,6.373937677053824,43.37740091296056
Task_16044,1563,993,88,147,235,1.5724346076458753,34.982756600420466
Task_16045,2216,823,107,187,294,2.6893203883495147,45.21176227901313
Task_16046,707,203,192,191,383,3.465686274509804,19.762839139238203
Task_16047,2265,345,137,147,284,6.546242774566474,44.35454879145382
Task_16048,509,117,171,118,289,4.313559322033898,15.511826001569766
Task_16049,818,868,42,199,241,0.9413118527042578,22.90346174240527
Task_16050,725,934,88,174,262,0.7754010695187166,21.708085446383944
Task_16051,2853,732,152,169,321,3.892223738062756,55.11284923814433
Task_16052,2042,588,177,72,249,3.466893039049236,41.12470398087525
Task_16053,1303,767,13,35,48,1.6966145833333333,27.989280576438414
Task_16054,1519,913,64,121,185,1.661925601750547,33.88384757677348
Task_16055,1318,1015,133,169,302,1.297244094488189,31.527915077482234
Task_16056,2434,268,114,137,251,9.048327137546469,46.595762533342054
Task_16057,1608,574,163,139,302,2.796521739130435,34.76541936287821
Task_16058,2592,879,193,75,268,2.9454545454545453,50.88649246240826
Task_16059,807,550,171,108,279,1.4646098003629764,21.803556010074654
Task_16060,2360,918,166,168,334,2.568008705114255,47.94250826058322
Task_16061,1064,493,149,140,289,2.1538461538461537,25.839953798460453
Task_16062,1477,552,158,177,335,2.670886075949367,32.82615207778026
Task_16063,1248,193,43,44,87,6.43298969072165,25.864137273152974
Task_16064,2389,510,109,51,160,4.675146771037182,45.71906510068172
Task_16065,564,900,166,76,242,0.6259711431742508,18.89867560301637
Task_16066,2300,435,175,30,205,5.275229357798165,44.17355793004617
Task_16067,2599,584,183,176,359,4.442735042735043,50.80140319130203
Task_16068,1345,328,59,66,125,4.088145896656535,28.561485879357857
Task_16069,2263,108,107,180,287,20.761467889908257,43.070522225105435
Task_16070,2751,878,17,176,193,3.1296928327645053,53.347429645374795
Task_16071,1414,685,25,85,110,2.061224489795918,30.807503034015145
Task_16072,2709,150,180,174,354,17.94039735099338,50.79451889662409
Task_16073,2953,646,70,190,260,4.564142194744977,56.25235673357267
Task_16074,2693,213,82,142,224,12.58411214953271,50.40708032287287
Task_16075,519,523,31,24,55,0.9904580152671756,15.037458801722636
Task_16076,2813,163,127,12,139,17.152439024390244,50.53023130633046
Task_16077,1552,686,40,107,147,2.2590975254730714,33.31822171876999
Task_16078,1405,508,97,96,193,2.760314341846758,30.82259969905984
Task_16079,2832,322,39,136,175,8.76780185758514,52.719716736055595
Task_16080,1029,72,20,199,219,14.095890410958905,23.19038561762436
Task_16081,2324,967,186,115,301,2.4008264462809916,47.29835108511353
Task_16082,1634,675,54,79,133,2.4171597633136095,34.5875911781095
Task_16083,1601,136,89,181,270,11.686131386861314,32.822382321233306
Task_16084,709,858,97,83,180,0.8253783469150174,20.66525879198994
Task_16085,1791,291,162,160,322,6.133561643835616,36.86634401190809
Task_16086,2459,518,179,64,243,4.737957610789981,47.409078363535855
Task_16087,641,617,198,127,325,1.0372168284789645,19.61214759324171
Task_16088,1030,781,31,187,218,1.3171355498721227,25.88582459428532
Task_16089,947,368,179,60,239,2.5663956639566394,22.92674175028587
Task_16090,1713,326,182,177,359,5.238532110091743,35.9424615303456
Task_16091,1777,466,34,96,130,3.805139186295503,36.18525312187485
Task_16092,1072,127,160,131,291,8.375,24.478165295621267
Task_16093,728,826,120,119,239,0.8802902055622733,21.26868298848804
Task_16094,2361,943,141,189,330,2.5010593220338984,48.04906655899288
Task_16095,606,930,133,10,143,0.6509129967776585,18.7310961499276
Task_16096,1228,521,180,92,272,2.3524904214559386,28.325653478186794
Task_16097,2367,95,159,163,322,24.65625,44.68111546729326
Task_16098,1150,647,63,54,117,1.7746913580246915,26.110589160747992
Task_16099,2812,76,94,88,182,36.51948051948052,50.649110902170186
Task_16100,795,128,182,25,207,6.162790697674419,19.060041849812414
Task_16101,561,456,182,69,251,1.2275711159737417,17.1871951130926
Task_16102,1425,198,140,170,310,7.160804020100502,30.75925049160053
Task_16103,2091,728,150,43,193,2.8683127572016462,41.75597057848665
Task_16104,1847,329,197,192,389,5.596969696969697,38.22885635514771
Task_16105,1106,947,183,152,335,1.1666666666666667,28.07395439342045
Task_16106,881,974,172,164,336,0.9035897435897436,24.663372458722304
Task_16107,1974,878,61,154,215,2.2457337883959045,41.211794745040024
Task_16108,725,409,134,165,299,1.7682926829268293,20.278499875400108
Task_16109,898,535,46,130,176,1.6753731343283582,22.814006840737292
Task_16110,1201,192,137,144,281,6.22279792746114,26.992450627473904
Task_16111,2560,704,96,145,241,3.631205673758865,49.99500123160584
Task_16112,2259,661,25,103,128,3.4123867069486407,44.47534585705446
Task_16113,1986,65,78,49,127,30.09090909090909,36.33620095480818
Task_16114,2826,752,44,39,83,3.752988047808765,52.551662296237424
Task_16115,1973,995,93,51,144,1.9809236947791165,40.67606503177009
Task_16116,559,459,108,173,281,1.2152173913043478,17.68734322882314
Task_16117,2562,778,148,59,207,3.288831835686778,49.64956866944533
Task_16118,1788,66,26,68,94,26.686567164179106,33.26769057629655
Task_16119,1069,407,176,114,290,2.6200980392156863,25.613833160173808
Task_16120,1479,628,171,171,342,2.3513513513513513,33.11939557195188
Task_16121,1567,294,123,40,163,5.311864406779661,31.91976438232859
Task_16122,1880,281,86,178,264,6.666666666666667,37.964228549029194
Task_16123,1150,421,15,77,92,2.7251184834123223,25.419925412292283
Task_16124,578,477,80,117,197,1.209205020920502,17.633805755523625
Task_16125,2305,822,183,157,340,2.800729040097205,46.78206761245735
Task_16126,1589,198,116,155,271,7.984924623115578,33.15000565469842
Task_16127,775,117,128,51,179,6.567796610169491,18.566143596531024
Task_16128,1733,880,168,65,233,1.9670828603859252,37.02121420585747
Task_16129,1744,297,95,183,278,5.852348993288591,35.98937781183659
Task_16130,1557,988,126,123,249,1.5743174924165824,34.9438409562094
Task_16131,1404,914,187,63,250,1.5344262295081967,31.951416463288
Task_16132,2673,222,46,88,134,11.986547085201794,49.47032102671174
Task_16133,895,286,103,173,276,3.1184668989547037,22.49712581499851
Task_16134,2002,868,63,130,193,2.3037974683544302,41.48994681706719
Task_16135,2933,524,165,79,244,5.586666666666667,55.13432156571281
Task_16136,2601,497,121,110,231,5.22289156626506,49.879628970080184
Task_16137,2947,126,36,100,136,23.20472440944882,52.76654418456426
Task_16138,856,450,113,79,192,1.8980044345898004,21.781503867616973
Task_16139,1400,698,21,147,168,2.0028612303290414,31.204756089777433
Task_16140,706,299,146,64,210,2.3533333333333335,18.81693025543089
Task_16141,2061,192,73,33,106,10.678756476683938,38.87240889158561
Task_16142,2066,793,91,93,184,2.602015113350126,42.06059372103121
Task_16143,2405,497,16,172,188,4.829317269076305,46.63288407363317
Task_16144,698,256,81,184,265,2.7159533073929962,19.306083617051712
Task_16145,1977,998,162,127,289,1.978978978978979,41.8594553164988
Task_16146,2302,407,180,199,379,5.642156862745098,45.65078073118891
Task_16147,2510,592,32,20,52,4.232715008431703,46.477266391685355
Task_16148,2679,609,46,13,59,4.391803278688524,49.1919080180323
Task_16149,2346,760,187,198,385,3.082785808147175,47.50024338437206
Task_16150,530,240,165,133,298,2.199170124481328,16.620737436818118
Task_16151,2177,677,96,113,209,3.2109144542772863,43.65200515117632
Task_16152,2469,805,131,60,191,3.063275434243176,48.18968324851212
Task_16153,1972,139,87,156,243,14.085714285714285,38.50460203524613
Task_16154,1180,1023,188,194,382,1.15234375,29.755318080610184
Task_16155,2514,294,161,181,342,8.522033898305084,48.42767444461464
Task_16156,2228,652,49,144,193,3.411944869831547,44.44265175403516
Task_16157,1820,237,198,76,274,7.647058823529412,36.62534406492977
Task_16158,2877,643,200,173,373,4.467391304347826,55.451017499773535
Task_16159,1872,246,163,80,243,7.578947368421052,37.41732479504412
Task_16160,2491,490,195,148,343,5.0733197556008145,48.676046536543026
Task_16161,2013,856,27,77,104,2.348891481913652,40.63776276541501
Task_16162,964,619,134,105,239,1.5548387096774194,24.3312318920394
Task_16163,2063,710,133,132,265,2.90154711673699,42.22256337156907
Task_16164,1916,370,59,17,76,5.164420485175202,36.3328877681865
Task_16165,678,941,200,176,376,0.7197452229299363,21.622387272924545
Task_16166,786,537,142,28,170,1.4609665427509293,20.328531257641984
Task_16167,2772,476,54,30,84,5.811320754716981,50.71925255545326
Task_16168,2397,591,39,84,123,4.048986486486487,46.2463516301402
Task_16169,1336,72,149,148,297,18.301369863013697,28.314630427316093
Task_16170,2446,397,54,20,74,6.1457286432160805,44.79464096164465
Task_16171,1383,116,43,113,156,11.820512820512821,28.190068934977386
Task_16172,859,258,18,40,58,3.3166023166023164,19.4573388901719
Task_16173,1718,859,96,41,137,1.9976744186046511,35.83842984112166
Task_16174,1534,153,134,182,316,9.96103896103896,32.12619538958925
Task_16175,1837,555,146,199,345,3.303956834532374,38.613329420727695
Task_16176,2834,105,124,97,221,26.735849056603772,51.60226552272052
Task_16177,693,798,35,54,89,0.867334167709637,19.16634816239146
Task_16178,1526,311,139,172,311,4.891025641025641,32.71179425154977
Task_16179,2234,371,55,181,236,6.005376344086022,43.85437630922135
Task_16180,1671,268,140,55,195,6.211895910780669,33.85959097264304
Task_16181,1195,190,14,29,43,6.2565445026178015,24.547946775279087
Task_16182,2338,413,64,43,107,5.647342995169082,43.7865987951566
Task_16183,2247,235,64,190,254,9.521186440677965,43.681970664945936
Task_16184,992,78,47,143,190,12.556962025316455,22.441436041048423
Task_16185,829,255,50,186,236,3.23828125,21.289907025567196
Task_16186,739,535,171,135,306,1.3787313432835822,20.841340138923467
Task_16187,2641,662,164,23,187,3.9834087481146305,50.151321331563565
Task_16188,1702,972,197,11,208,1.749229188078109,36.30313128607613
Task_16189,550,610,163,54,217,0.900163666121113,17.388771940222735
Task_16190,2143,134,57,39,96,15.874074074074073,39.22901249713507
Task_16191,2913,694,161,21,182,4.19136690647482,54.5113393001034
Task_16192,1202,323,133,99,232,3.7098765432098766,27.1587198039155
Task_16193,594,907,58,39,97,0.6541850220264317,18.046118963515813
Task_16194,1931,478,73,122,195,4.031315240083507,39.12717869441233
Task_16195,1852,660,165,33,198,2.8018154311649015,37.76750094641276
Task_16196,1114,356,25,133,158,3.1204481792717087,25.394573066247858
Task_16197,1538,574,54,16,70,2.674782608695652,30.96570343331582
Task_16198,849,371,182,122,304,2.282258064516129,22.093452913539647
Task_16199,2034,896,176,20,196,2.2675585284280935,41.30033430896494
Task_16200,1115,821,53,88,141,1.356447688564477,26.794369179393623
Task_16201,2193,179,11,40,51,12.183333333333334,40.21484119020483
Task_16202,2649,451,61,122,183,5.860619469026549,50.32011673367294
Task_16203,573,501,176,118,294,1.1414342629482073,18.013380656332824
Task_16204,2774,841,173,165,338,3.294536817102138,54.275079326480146
Task_16205,2202,960,27,44,71,2.291363163371488,42.89899478694361
Task_16206,976,470,96,104,200,2.0721868365180467,23.928372974554204
Task_16207,2121,279,157,23,180,7.575,40.64532877460061
Task_16208,916,844,111,57,168,1.0840236686390532,23.56178095899548
Task_16209,1036,529,41,91,132,1.9547169811320755,24.625490750989055
Task_16210,1217,843,182,159,341,1.4419431279620853,29.56295048229632
Task_16211,1441,506,121,179,300,2.842209072978304,31.956109395351543
Task_16212,1442,928,61,86,147,1.5522066738428417,32.352857749460505
Task_16213,1255,615,70,120,190,2.0373376623376624,28.84062177961827
Task_16214,1778,563,54,155,209,3.152482269503546,37.09697596508271
Task_16215,1550,312,72,26,98,4.952076677316294,31.040588138486942
Task_16216,630,791,25,90,115,0.7954545454545454,18.718759497598434
Task_16217,2752,988,138,163,301,2.782608695652174,54.21655386788073
Task_16218,512,413,133,44,177,1.2367149758454106,15.680228402568046
Task_16219,2260,831,102,156,258,2.7163461538461537,45.72620496474593
Task_16220,2307,224,148,28,176,10.253333333333334,43.40932022772673
Task_16221,827,899,130,199,329,0.9188888888888889,23.588645347859057
Task_16222,790,895,139,183,322,0.8816964285714286,22.93226167605629
Task_16223,2607,142,129,185,314,18.23076923076923,48.95490328580414
Task_16224,2990,623,92,163,255,4.791666666666667,56.63806351900116
Task_16225,2308,179,179,130,309,12.822222222222223,44.27987705645359
Task_16226,2908,101,46,134,180,28.50980392156863,52.53477776261291
Task_16227,1991,534,132,137,269,3.721495327102804,40.551615518503596
Task_16228,1307,784,90,137,227,1.6649681528662421,30.29433710108586
Task_16229,2592,722,132,145,277,3.5850622406639006,50.71325495716263
Task_16230,2822,71,188,34,222,39.19444444444444,50.25311147815554
Task_16231,1037,304,149,135,284,3.4,24.780917059001045
Task_16232,1860,908,24,32,56,2.046204620462046,37.30244584674245
Task_16233,2771,398,132,148,280,6.9448621553884715,52.52127109361995
Task_16234,1434,682,124,77,201,2.0995607613469986,31.63613206501051
Task_16235,1981,678,191,172,363,2.917525773195876,41.32347907116219
Task_16236,2291,266,141,143,284,8.58052434456929,44.48612916783416
Task_16237,2279,375,134,176,310,6.0611702127659575,44.83622265106086
Task_16238,1394,1018,71,107,178,1.368007850834151,32.132505966560586
Task_16239,2101,942,157,196,353,2.227995758218452,44.0398934154472
Task_16240,1241,455,134,12,146,2.7214912280701755,27.05843889203995
Task_16241,1184,497,94,85,179,2.3775100401606424,27.078876161322153
Task_16242,2129,206,178,71,249,10.285024154589372,41.199562872198385
Task_16243,2477,928,21,169,190,2.666307857911733,49.15873116137155
Task_16244,978,882,141,109,250,1.1075877689694225,25.389048372529242
Task_16245,2556,646,139,141,280,3.9505409582689337,49.9103655183896
Task_16246,2611,552,40,65,105,4.7215189873417724,49.048996484386144
Task_16247,637,192,113,173,286,3.300518134715026,18.156903448877102
Task_16248,2330,360,67,174,241,6.454293628808864,45.35347269009491
Task_16249,1582,765,147,126,273,2.0652741514360313,34.80214662407098
Task_16250,2548,780,194,148,342,3.262483994878361,50.49610399666187
Task_16251,1856,671,151,73,224,2.761904761904762,38.32009328343364
Task_16252,753,775,136,123,259,0.970360824742268,21.59860793979733
Task_16253,1796,159,47,27,74,11.225,33.93647167161104
Task_16254,1478,701,55,15,70,2.1054131054131053,30.41249831655524
Task_16255,2627,909,195,90,285,2.8868131868131868,51.778247887462406
Task_16256,1148,683,149,109,258,1.6783625730994152,27.56565717741309
Task_16257,2642,716,83,157,240,3.684797768479777,51.37285782467438
Task_16258,1512,664,177,125,302,2.2736842105263158,33.50709149760168
Task_16259,1142,827,65,99,164,1.3792270531400965,27.459662758569433
Task_16260,2754,813,63,60,123,3.383292383292383,52.184905684692374
Task_16261,1224,130,101,149,250,9.34351145038168,26.733698946825854
Task_16262,662,155,68,186,254,4.243589743589744,18.19112959532737
Task_16263,752,248,87,81,168,3.0200803212851404,19.30775092226987
Task_16264,1739,550,134,160,294,3.1560798548094375,36.75869838335151
Task_16265,2444,343,192,98,290,7.104651162790698,47.14177759649433
Task_16266,2514,770,99,114,213,3.2607003891050583,49.296480700019536
Task_16267,1253,573,195,200,395,2.182926829268293,29.649297553830795
Task_16268,2804,962,32,191,223,2.9117341640706127,54.646386184463076
Task_16269,2930,449,125,197,322,6.511111111111111,55.468254041511706
Task_16270,1685,110,198,110,308,15.18018018018018,33.995182742663914
Task_16271,1475,305,123,180,303,4.8202614379084965,31.86112506939952
Task_16272,2436,818,132,182,314,2.9743589743589745,48.7645190526531
Task_16273,2880,845,53,86,139,3.404255319148936,54.855556358825034
Task_16274,822,551,23,28,51,1.4891304347826086,19.759720499104084
Task_16275,515,589,191,189,380,0.8728813559322034,17.89926071322877
Task_16276,2632,819,124,39,163,3.209756097560976,50.459850305711676
Task_16277,1287,562,20,186,206,2.285968028419183,29.265940777881607
Task_16278,1071,924,124,139,263,1.1578378378378378,27.10475613581596
Task_16279,1107,1020,181,63,244,1.0842311459353575,27.542722553184504
Task_16280,2688,67,53,180,233,39.529411764705884,49.20024965410018
Task_16281,1170,962,110,13,123,1.2149532710280373,27.257335544048832
Task_16282,1787,646,58,172,230,2.7619783616692426,37.62051287081135
Task_16283,2432,569,56,189,245,4.266666666666667,47.68380705081782
Task_16284,2929,976,51,146,197,2.9979529170931425,56.58848868481885
Task_16285,2720,492,34,180,214,5.517241379310345,51.7853125332848
Task_16286,1423,816,62,17,79,1.7417380660954713,30.074383656166543
Task_16287,897,848,136,97,233,1.0565371024734982,23.952899158444577
Task_16288,2950,801,84,91,175,3.678304239401496,56.03238884854982
Task_16289,1038,964,142,164,306,1.0756476683937823,26.93718100115383
Task_16290,2832,1004,38,58,96,2.817910447761194,53.73187313021719
Task_16291,1191,845,33,160,193,1.4078014184397163,28.49980172756891
Task_16292,718,866,144,193,337,0.8281430219146482,21.783345130279837
Task_16293,1369,416,15,132,147,3.2829736211031175,29.576086122716877
Task_16294,2453,876,29,33,62,2.797035347776511,46.58587634359545
Task_16295,1104,351,35,55,90,3.1363636363636362,24.249911288466944
Task_16296,2656,743,110,154,264,3.5698924731182795,51.747896547549566
Task_16297,985,264,75,128,203,3.7169811320754715,23.517515252934942
Task_16298,1623,476,178,25,203,3.40251572327044,33.53105534105356
Task_16299,2448,690,25,118,143,3.5426917510853837,47.47954801923118
Task_16300,1026,375,50,161,211,2.728723404255319,24.642623814739014
Task_16301,632,746,15,35,50,0.8460508701472557,17.50387943374131
Task_16302,1941,690,44,18,62,2.808972503617945,37.797567222609636
Task_16303,1585,373,95,198,293,4.237967914438503,33.81594215384134
Task_16304,1238,594,42,78,120,2.080672268907563,27.78256821193234
Task_16305,2212,73,129,137,266,29.89189189189189,41.8726333115826
Task_16306,2964,379,11,103,114,7.8,54.41228373446247
Task_16307,1848,142,103,54,157,12.923076923076923,35.564144101815806
Task_16308,2897,976,128,55,183,2.9651995905834188,55.45705792636474
Task_16309,577,989,122,89,211,0.5828282828282828,19.307888291959475
Task_16310,1648,797,102,31,133,2.0651629072681703,34.55157737909026
Task_16311,1395,97,160,197,357,14.23469387755102,29.64890206921108
Task_16312,2229,725,84,165,249,3.0702479338842976,44.885398381669255
Task_16313,1156,318,43,181,224,3.623824451410658,26.52178447700516
Task_16314,1835,988,161,117,278,1.8554095045500505,39.51389614357374
Task_16315,1300,746,37,143,180,1.7402945113788488,29.869576276325464
Task_16316,2195,379,173,19,192,5.776315789473684,42.187579551715814
Task_16317,1241,119,56,119,175,10.341666666666667,26.512562940852735
Task_16318,657,585,77,35,112,1.121160409556314,17.93483895012232
Task_16319,2372,137,113,164,277,17.18840579710145,44.9916516974261
Task_16320,2918,239,100,30,130,12.158333333333333,52.790885058361994
Task_16321,1677,214,194,137,331,7.8,34.801790190721
Task_16322,2675,339,81,49,130,7.867647058823529,49.44793719802488
Task_16323,526,695,26,163,189,0.7557471264367817,17.465117915557602
Task_16324,1244,323,43,164,207,3.8395061728395063,27.828149384789537
Task_16325,1805,856,77,148,225,2.106184364060677,38.501619008357544
Task_16326,1165,712,26,90,116,1.6339410939691446,27.000204328159242
Task_16327,1734,612,73,119,192,2.828711256117455,36.41533620456976
Task_16328,2079,721,115,118,233,2.8795013850415514,42.34579588355953
Task_16329,1847,844,119,15,134,2.1857988165680475,37.73758831438695
Task_16330,2305,801,199,42,241,2.874064837905237,45.58989322954694
Task_16331,1330,946,60,151,211,1.4044350580781415,31.1488148774046
Task_16332,2779,238,188,87,275,11.627615062761507,51.90903908722782
Task_16333,647,455,117,40,157,1.418859649122807,17.719725059594733
Task_16334,1715,167,165,180,345,10.208333333333334,35.149699793714625
Task_16335,1195,250,144,131,275,4.760956175298805,27.053306827357826
Task_16336,769,281,168,106,274,2.726950354609929,20.38197426005364
Task_16337,2894,386,44,88,132,7.478036175710594,53.582173970365865
Task_16338,1587,669,102,13,115,2.3686567164179104,32.82677609012212
Task_16339,2154,457,167,182,349,4.703056768558952,43.3115155444223
Task_16340,694,589,165,65,230,1.176271186440678,19.64072278676069
Task_16341,1285,242,52,55,107,5.288065843621399,26.854791930177058
Task_16342,2871,578,170,28,198,4.958549222797927,53.6380037623256
Task_16343,2553,128,93,194,287,19.790697674418606,47.90300321227101
Task_16344,1188,678,26,126,152,1.7496318114874816,27.49230996483401
Task_16345,2751,915,103,105,208,3.0032751091703056,53.46853084538151
Task_16346,741,622,22,107,129,1.189406099518459,20.176996062667804
Task_16347,2866,846,84,58,142,3.38370720188902,54.31157281278862
Task_16348,2652,682,130,187,317,3.882869692532943,51.77916551565352
Task_16349,1674,330,155,77,232,5.057401812688822,34.453794013360216
Task_16350,2824,193,83,39,122,14.556701030927835,51.05601821620363
Task_16351,2315,867,57,16,73,2.6670506912442398,44.199162078373085
Task_16352,1099,250,155,155,310,4.378486055776892,25.72943140806335
Task_16353,1753,746,128,11,139,2.3467202141900936,35.96110437920587
Task_16354,875,964,136,197,333,0.9067357512953368,24.572245408895924
Task_16355,2317,868,118,162,280,2.666283084004603,46.85291310173694
Task_16356,1951,651,104,36,140,2.9923312883435584,38.899729073770544
Task_16357,1910,153,162,160,322,12.402597402597403,38.04694914439789
Task_16358,2950,781,152,82,234,3.772378516624041,56.21331510617701
Task_16359,2799,93,187,89,276,29.77659574468085,51.07682629542041
Task_16360,1332,129,120,110,230,10.246153846153845,28.285937497970718
Task_16361,2948,806,75,111,186,3.6530359355638167,56.189140065442594
Task_16362,1690,338,116,135,251,4.985250737463127,35.07017983351253
Task_16363,1136,152,101,136,237,7.42483660130719,25.43106086597439
Task_16364,1265,795,76,27,103,1.5891959798994975,28.084483344496007
Task_16365,2790,688,87,69,156,4.049346879535559,52.60451291675371
Task_16366,809,821,30,25,55,0.9841849148418491,20.569639379919153
Task_16367,2267,264,38,164,202,8.554716981132076,43.77075908128228
Task_16368,1332,655,17,182,199,2.0304878048780486,30.20547838368725
Task_16369,2052,73,114,91,205,27.72972972972973,38.90815079968461
Task_16370,2896,911,151,173,324,3.175438596491228,56.376121290810374
Task_16371,2290,340,156,79,235,6.715542521994135,44.31034197016814
Task_16372,654,764,182,102,284,0.8549019607843137,20.08245841853589
Task_16373,2769,314,121,35,156,8.790476190476191,50.85419944241303
Task_16374,584,665,80,190,270,0.8768768768768769,18.75005892381711
Task_16375,1529,800,54,177,231,1.9088639200998752,34.0270088407275
Task_16376,2798,603,127,109,236,4.632450331125828,53.360956729355145
Task_16377,2021,192,19,88,107,10.471502590673575,38.81003089283932
Task_16378,1791,358,122,124,246,4.988857938718663,36.695111493893926
Task_16379,1900,957,58,155,213,1.9832985386221293,40.28018549874553
Task_16380,2430,962,58,26,84,2.5233644859813085,46.81360873442521
Task_16381,786,156,101,155,256,5.006369426751593,20.04435060624183
Task_16382,954,71,155,199,354,13.25,22.676752294580393
Task_16383,2083,805,40,59,99,2.5843672456575684,41.18398851953472
Task_16384,1365,484,94,187,281,2.814432989690722,30.61970860466779
Task_16385,2258,531,160,198,358,4.2443609022556394,45.260065878332966
Task_16386,2067,186,74,87,161,11.053475935828876,40.05639506101951
Task_16387,2802,380,44,120,164,7.354330708661418,52.35662121103352
Task_16388,2801,428,86,45,131,6.529137529137529,51.62071631507098
Task_16389,2470,297,76,150,226,8.288590604026846,47.241294902744784
Task_16390,2917,448,131,60,191,6.496659242761693,54.144218390268655
Task_16391,737,233,89,34,123,3.1495726495726495,18.185165842629296
Task_16392,1370,772,79,24,103,1.7723156532988358,29.608455235066838
Task_16393,2441,293,33,184,217,8.302721088435375,46.71740479248166
Task_16394,1281,545,198,169,367,2.3461538461538463,29.83313238411152
Task_16395,865,827,14,142,156,1.0446859903381642,22.821345695579385
Task_16396,2861,461,13,33,46,6.192640692640692,51.656166352972356
Task_16397,2219,281,124,160,284,7.868794326241135,43.42626721419651
Task_16398,2556,598,108,26,134,4.267111853088481,48.266822079348465
Task_16399,747,375,153,80,233,1.9867021276595744,20.011413640657864
Task_16400,1174,347,90,190,280,3.3735632183908044,27.1437162598383
Task_16401,990,834,162,86,248,1.18562874251497,25.341381754847575
Task_16402,2020,212,136,164,300,9.48356807511737,40.109923377532276
Task_16403,1569,759,136,10,146,2.0644736842105265,33.203772623510915
Task_16404,1394,884,185,123,308,1.575141242937853,32.304267959272025
Task_16405,1178,909,194,122,316,1.2945054945054946,28.975375833861765
Task_16406,1234,682,59,184,243,1.8067349926793559,29.050446531809495
Task_16407,1951,877,160,181,341,2.222095671981777,41.38459401386902
Task_16408,1556,440,136,22,158,3.5283446712018143,32.02039564002616
Task_16409,662,877,161,199,360,0.7539863325740319,21.050742259569738
Task_16410,1769,1003,79,130,209,1.7619521912350598,38.26921445060983
Task_16411,1826,453,132,128,260,4.022026431718062,37.62665956428892
Task_16412,1968,598,132,39,171,3.285475792988314,39.24714578935356
Task_16413,1074,550,138,190,328,1.9491833030852994,26.426174079101116
Task_16414,750,602,172,51,223,1.243781094527363,20.47107477324916
Task_16415,2410,240,190,136,326,10.0,46.450524293800214
Task_16416,2169,368,164,38,202,5.878048780487805,41.885961650104456
Task_16417,1266,554,168,154,322,2.281081081081081,29.39908776420585
Task_16418,1462,391,90,78,168,3.729591836734694,31.013415695344992
Task_16419,2064,1009,19,151,170,2.0435643564356436,42.71174422581972
Task_16420,1881,717,185,192,377,2.6197771587743732,39.95424856893066
Task_16421,1439,859,34,60,94,1.6732558139534883,31.20254952977901
Task_16422,919,462,52,53,105,1.9848812095032398,21.779066985288654
Task_16423,1560,804,110,40,150,1.937888198757764,33.24605517416434
Task_16424,1063,87,109,31,140,12.079545454545455,22.3674673742614
Task_16425,2013,984,140,16,156,2.0436548223350255,40.92463114369353
Task_16426,2727,122,118,179,297,22.170731707317074,50.58670574669458
Task_16427,1062,561,79,196,275,1.8896797153024911,26.100523751631926
Task_16428,2893,830,99,42,141,3.4813477737665464,54.38693408799001
Task_16429,2712,449,103,36,139,6.026666666666666,50.2794419662145
Task_16430,2095,250,194,127,321,8.346613545816734,41.47480877519216
Task_16431,2351,82,135,163,298,28.325301204819276,44.26375590370651
Task_16432,2285,263,65,125,190,8.655303030303031,43.997166004149825
Task_16433,992,97,104,43,147,10.122448979591837,21.233513009023365
Task_16434,1319,856,158,58,216,1.5390898483080513,30.23328155318816
Task_16435,1042,641,183,180,363,1.6230529595015577,26.333226730473587
Task_16436,1298,566,23,23,46,2.289241622574956,27.205883764807293
Task_16437,2722,95,127,80,207,28.354166666666668,49.38982477395453
Task_16438,2648,1017,92,50,142,2.601178781925344,51.263111021352614
Task_16439,2408,557,101,175,276,4.315412186379929,47.31502918825557
Task_16440,1523,989,111,141,252,1.5383838383838384,34.44805526405984
Task_16441,1791,866,119,127,246,2.065743944636678,38.30785251273091
Task_16442,1759,255,163,184,347,6.87109375,36.38426580734217
Task_16443,500,350,88,200,288,1.4245014245014245,16.45090554731388
Task_16444,2298,644,29,24,53,3.562790697674419,43.3662040220485
Task_16445,1544,655,143,147,290,2.3536585365853657,33.963927116947104
Task_16446,1369,888,100,35,135,1.5399325084364455,30.373610361944518
Task_16447,1684,925,199,81,280,1.818574514038877,36.77755609380669
Task_16448,2346,469,22,119,141,4.991489361702127,45.14588580050463
Task_16449,2211,73,196,200,396,29.87837837837838,42.53525357802078
Task_16450,629,969,115,146,261,0.6484536082474227,20.40073153722518
Task_16451,2316,408,183,137,320,5.662591687041565,45.51881059792194
Task_16452,1195,515,126,187,313,2.315891472868217,28.160152003478277
Task_16453,2234,877,187,196,383,2.5444191343963554,46.07996901291862
Task_16454,2330,429,117,103,220,5.4186046511627906,45.30876776340153
Task_16455,1626,352,43,25,68,4.606232294617564,31.843822505429745
Task_16456,2975,202,65,126,191,14.655172413793103,54.66947012307776
Task_16457,2651,499,134,144,278,5.302,50.93934560785533
Task_16458,1109,445,69,35,104,2.486547085201794,24.54884104611678
Task_16459,2094,517,76,139,215,4.042471042471043,41.95463853823508
Task_16460,1412,943,158,37,195,1.4957627118644068,31.68196054293595
Task_16461,2457,738,198,152,350,3.324763193504736,48.9643630821196
Task_16462,2165,280,55,49,104,7.704626334519573,40.687116444317674
Task_16463,832,140,14,51,65,5.900709219858156,18.69808369320158
Task_16464,1161,526,131,103,234,2.20303605313093,27.177230629352593
Task_16465,1589,863,52,72,124,1.8391203703703705,34.18320288563083
Task_16466,1156,978,111,76,187,1.180796731358529,28.02767230681552
Task_16467,1778,406,86,34,120,4.368550368550369,35.11067931705248
Task_16468,1803,399,10,12,22,4.5075,34.39942806034413
Task_16469,1967,991,87,159,246,1.9828629032258065,41.492612628659366
Task_16470,2311,612,190,13,203,3.769983686786297,44.81564844358218
Task_16471,2227,579,178,91,269,3.839655172413793,44.309393285290035
Task_16472,2091,258,89,87,176,8.073359073359073,40.62478795972279
Task_16473,712,377,14,14,28,1.8835978835978835,17.106031367513484
Task_16474,2915,212,132,98,230,13.685446009389672,53.83622585040357
Task_16475,994,226,74,138,212,4.378854625550661,23.583974843583647
Task_16476,815,343,134,65,199,2.369186046511628,20.64811027795466
Task_16477,1000,650,115,183,298,1.5360983102918586,25.378182208172948
Task_16478,1193,439,163,95,258,2.7113636363636364,27.519194912490374
Task_16479,1727,699,56,102,158,2.467142857142857,36.216903305144754
Task_16480,1884,778,58,184,242,2.418485237483954,39.64224272652883
Task_16481,2166,638,90,88,178,3.3896713615023475,43.085547208004094
Task_16482,790,64,73,158,231,12.153846153846153,19.534280978346327
Task_16483,1177,191,87,139,226,6.130208333333333,26.31675558042329
Task_16484,2439,423,151,128,279,5.752358490566038,47.31666693335614
Task_16485,2010,677,134,129,263,2.9646017699115044,41.265942539838036
Task_16486,1321,401,175,29,204,3.2860696517412937,28.5646845878893
Task_16487,930,797,36,146,182,1.1654135338345866,24.084280273239198
Task_16488,1648,285,165,182,347,5.7622377622377625,34.730287737348384
Task_16489,2932,473,98,193,291,6.185654008438819,55.43757194978857
Task_16490,723,635,152,84,236,1.1367924528301887,20.420385968704164
Task_16491,2429,264,126,75,201,9.166037735849057,46.00955520667185
Task_16492,1484,961,19,36,55,1.5426195426195426,31.55726467851198
Task_16493,2317,428,140,173,313,5.400932400932401,45.621524628643805
Task_16494,1368,976,180,24,204,1.4002047082906857,31.053909644941964
Task_16495,1279,654,142,14,156,1.952671755725191,28.26496393452327
Task_16496,2103,725,157,85,242,2.896694214876033,42.65369996819009
Task_16497,1343,553,16,147,163,2.4241877256317688,29.802403010795288
Task_16498,669,742,86,173,259,0.9004037685060565,20.1645768328117
Task_16499,642,377,123,68,191,1.6984126984126984,17.962034356558153
Task_16500,679,696,131,162,293,0.9741750358680057,20.39215380481289
Task_16501,2606,510,115,139,254,5.099804305283757,50.14703501128272
Task_16502,660,958,149,86,235,0.6882168925964547,20.616441766088542
Task_16503,2261,418,150,37,187,5.39618138424821,43.42416575224204
Task_16504,1267,390,196,86,282,3.2404092071611252,28.549185697686614
Task_16505,718,582,150,181,331,1.2315608919382504,20.82462553692226
Task_16506,2246,899,178,46,224,2.4955555555555557,44.8946612808593
Task_16507,2372,203,176,13,189,11.627450980392156,44.335597489272864
Task_16508,2075,687,136,79,215,3.015988372093023,41.93512784252075
Task_16509,1321,853,127,143,270,1.5468384074941453,30.909442197007014
Task_16510,1121,227,193,130,323,4.916666666666667,26.02114841702658
Task_16511,1084,813,25,42,67,1.3316953316953317,24.772444486356388
Task_16512,2711,160,21,27,48,16.838509316770185,48.229060911019694
Task_16513,2629,763,46,173,219,3.4410994764397906,51.24192059076705
Task_16514,1080,748,189,51,240,1.4419225634178905,26.222745330178896
Task_16515,2461,968,131,14,145,2.539731682146543,47.976360441416055
Task_16516,2776,916,124,63,187,3.0272628135223556,53.407887242022554
Task_16517,2444,289,145,184,329,8.427586206896551,47.24919608227788
Task_16518,1655,914,162,70,232,1.8087431693989071,35.87779986347438
Task_16519,1378,561,30,102,132,2.4519572953736657,30.11753352711501
Task_16520,1882,220,21,136,157,8.515837104072398,37.06992522711699
Task_16521,2300,482,115,43,158,4.761904761904762,43.9893718430223
Task_16522,861,375,57,132,189,2.2898936170212765,21.855697334581432
Task_16523,1926,83,56,138,194,22.928571428571427,37.14969847810052
Task_16524,2470,864,115,198,313,2.8554913294797686,49.46614207667424
Task_16525,1630,463,167,53,220,3.5129310344827585,34.0141959537219
Task_16526,2471,479,61,32,93,5.147916666666666,46.01357648776616
Task_16527,885,552,58,86,144,1.6003616636528029,22.356131393293904
Task_16528,2990,1023,115,137,252,2.919921875,57.83841228187706
Task_16529,1132,96,40,89,129,11.670103092783505,23.946235972696453
Task_16530,1069,668,195,140,335,1.5979073243647235,26.660120384688057
Task_16531,1090,683,17,150,167,1.5935672514619883,26.208433434990695
Task_16532,2810,92,64,57,121,30.21505376344086,49.825799675257514
Task_16533,739,690,107,101,208,1.069464544138929,20.818071629033987
Task_16534,1851,737,141,129,270,2.508130081300813,38.96702416162969
Task_16535,665,327,76,20,96,2.027439024390244,17.006325202046288
Task_16536,1464,442,38,98,136,3.304740406320542,31.093904621986443
Task_16537,1352,1000,143,51,194,1.3506493506493507,31.11209867487773
Task_16538,890,680,57,128,185,1.3069016152716593,23.14613275950855
Task_16539,2979,376,51,57,108,7.901856763925729,54.11565129377414
Task_16540,1064,722,79,61,140,1.4716459197787,25.38623625039764
Task_16541,742,344,66,155,221,2.1507246376811593,20.066875475080472
Task_16542,2850,106,62,78,140,26.635514018691588,51.07048658096056
Task_16543,793,174,23,149,172,4.531428571428571,19.632286986979185
Task_16544,1974,233,85,152,237,8.435897435897436,39.16580122150901
Task_16545,2802,527,92,175,267,5.306818181818182,53.42418546538078
Task_16546,1846,866,126,125,251,2.129181084198385,39.19890973597064
Task_16547,1948,68,73,17,90,28.231884057971016,35.17768040553172
Task_16548,623,843,78,30,108,0.7381516587677726,18.220172885221857
Task_16549,512,681,159,150,309,0.750733137829912,17.75234646491437
Task_16550,2455,676,17,98,115,3.62629246676514,47.29805967815778
Task_16551,2569,181,12,173,185,14.115384615384615,47.79588513398553
Task_16552,2013,796,83,194,277,2.5257214554579672,41.880457578083046
Task_16553,1849,351,123,170,293,5.252840909090909,37.86873142308381
Task_16554,1588,428,187,64,251,3.7016317016317015,33.36818770792117
Task_16555,2603,70,108,98,206,36.66197183098591,47.67977501458011
Task_16556,803,815,196,85,281,0.9840686274509803,22.491498718367
Task_16557,1476,423,106,195,301,3.481132075471698,32.27394733295436
Task_16558,669,261,30,191,221,2.553435114503817,18.62585285118308
Task_16559,2234,484,79,197,276,4.606185567010309,44.41808729332215
Task_16560,1054,541,129,198,327,1.944649446494465,26.088531237182764
Task_16561,2425,100,14,105,119,24.00990099009901,44.11811446733244
Task_16562,1404,443,36,83,119,3.1621621621621623,29.982856061427558
Task_16563,1429,848,60,18,78,1.6831566548881036,30.234927516339287
Task_16564,970,446,76,85,161,2.170022371364653,23.425652450681905
Task_16565,663,859,42,66,108,0.7709302325581395,19.214330998169203
Task_16566,2043,134,144,13,157,15.133333333333333,38.265501415480955
Task_16567,1181,546,62,132,194,2.1590493601462524,27.486039052460423
Task_16568,2771,959,170,121,291,2.886458333333333,54.32048550138969
Task_16569,1699,415,167,82,249,4.084134615384615,35.30607585858872
Task_16570,2410,834,30,134,164,2.8862275449101795,47.61290484381819
Task_16571,1209,821,156,52,208,1.4708029197080292,28.392474392840843
Task_16572,1481,682,28,124,152,2.168374816983895,32.160676791176776
Task_16573,2137,499,136,189,325,4.274,43.0798636184368
Task_16574,2148,722,112,95,207,2.970954356846473,43.304542578979955
Task_16575,2676,962,149,142,291,2.778816199376947,52.85522707950497
Task_16576,2820,179,136,156,292,15.666666666666666,52.31832517635914
Task_16577,2870,94,195,44,239,30.210526315789473,51.32961981437473
Task_16578,2918,171,23,166,189,16.96511627906977,53.33595365392028
Task_16579,678,199,24,15,39,3.39,16.058609910655672
Task_16580,1440,928,86,90,176,1.55005382131324,32.44189778054305
Task_16581,1773,679,163,45,208,2.6073529411764707,36.6208872088122
Task_16582,1494,449,25,13,38,3.32,29.773035875305684
Task_16583,2579,937,74,168,242,2.7494669509594885,51.11794505719124
Task_16584,2203,121,102,145,247,18.057377049180328,42.06110670366775
Task_16585,2601,164,70,127,197,15.763636363636364,48.447563280673315
Task_16586,2022,1023,12,60,72,1.974609375,40.47841427258969
Task_16587,1936,685,134,37,171,2.8221574344023326,39.02495363771931
Task_16588,773,820,38,42,80,0.9415347137637028,20.272825077089
Task_16589,2964,990,25,198,223,2.9909182643794145,57.26773718864967
Task_16590,1878,632,10,110,120,2.9668246445497632,38.05251137124706
Task_16591,1580,321,40,91,131,4.906832298136646,32.561289758844346
Task_16592,1174,384,99,105,204,3.0493506493506493,26.8028194335223
Task_16593,572,486,71,61,132,1.1745379876796715,16.88329369450937
Task_16594,1858,192,84,121,205,9.626943005181348,36.995898336947754
Task_16595,617,812,192,84,276,0.7589175891758918,19.550045985092982
Task_16596,1617,677,145,47,192,2.3849557522123894,34.10720462377839
Task_16597,653,691,164,171,335,0.9436416184971098,20.180999745069006
Task_16598,2690,606,134,78,212,4.43163097199341,51.38360535472421
Task_16599,1414,727,185,198,383,1.9423076923076923,32.623592487157175
Task_16600,1233,385,112,128,240,3.194300518134715,27.93379696225972
Task_16601,1169,414,186,198,384,2.816867469879518,27.76534011895671
Task_16602,1058,679,151,126,277,1.5558823529411765,26.20889446475817
Task_16603,1307,115,88,181,269,11.267241379310345,27.99810159669993
Task_16604,1527,103,177,105,282,14.682692307692308,31.34675905301044
Task_16605,1294,413,179,166,345,3.1256038647342996,29.51756595195455
Task_16606,2147,81,143,22,165,26.182926829268293,39.48353097894134
Task_16607,2616,582,168,172,340,4.487135506003431,50.97272252689978
Task_16608,2674,835,199,158,357,3.1985645933014353,52.747233513365906
Task_16609,2288,896,125,147,272,2.550724637681159,46.42277924660842
Task_16610,1895,527,124,70,194,3.5890151515151514,38.29340790147055
Task_16611,719,808,165,84,249,0.8887515451174289,21.001288097701494
Task_16612,997,874,122,83,205,1.1394285714285715,25.36327618034792
Task_16613,1154,284,16,141,157,4.049122807017544,25.789406306677176
Task_16614,967,580,170,137,307,1.6643717728055079,24.639837452437416
Task_16615,1242,911,176,63,239,1.361842105263158,29.333686507300524
Task_16616,2710,921,23,176,199,2.9392624728850327,52.88858699220429
Task_16617,1293,702,87,50,137,1.8392603129445235,28.700840673817808
Task_16618,1125,981,24,150,174,1.145621181262729,27.701920905041685
Task_16619,1126,520,185,58,243,2.161228406909789,26.26612487605638
Task_16620,2804,983,165,60,225,2.8495934959349594,54.20774371485091
Task_16621,510,967,145,195,340,0.5268595041322314,18.99310905544066
Task_16622,1008,78,52,15,67,12.759493670886076,20.362789577902216
Task_16623,2128,184,99,156,255,11.502702702702702,41.415210296998815
Task_16624,1646,638,116,22,138,2.575899843505477,33.945439681315854
Task_16625,579,130,27,150,177,4.419847328244275,16.14438638927039
Task_16626,2018,563,152,184,336,3.578014184397163,41.442227684920034
Task_16627,1534,146,38,145,183,10.435374149659864,31.314601257567663
Task_16628,655,814,43,148,191,0.803680981595092,19.87494306439206
Task_16629,1228,693,130,183,313,1.7694524495677233,29.220364282904814
Task_16630,1308,706,56,130,186,1.85007072135785,29.927680138241872
Task_16631,1119,800,155,65,220,1.3970037453183521,26.97167649745359
Task_16632,2145,437,132,136,268,4.897260273972603,42.671680543960804
Task_16633,2771,590,53,74,127,4.688663282571912,52.20779249396865
Task_16634,2570,553,77,99,176,4.6389891696750905,49.341169989233485
Task_16635,1630,897,102,14,116,1.8151447661469933,34.21083245633721
Task_16636,2172,853,77,112,189,2.5433255269320845,44.08903579273319
Task_16637,2709,700,68,112,180,3.8644793152639085,52.058952820650156
Task_16638,1609,685,49,94,143,2.3454810495626823,34.30469724281246
Task_16639,1339,325,55,17,72,4.107361963190184,27.042753526222068
Task_16640,1527,91,130,163,293,16.597826086956523,31.391977127364797
Task_16641,557,414,25,126,151,1.342168674698795,16.65029246832498
Task_16642,2426,977,109,161,270,2.4805725971370145,48.87356489056475
Task_16643,959,284,192,159,351,3.364912280701754,23.819819623304113
Task_16644,1161,204,25,97,122,5.663414634146341,25.384829388639428
Task_16645,1225,849,61,183,244,1.4411764705882353,29.377755036097863
Task_16646,787,239,32,148,180,3.279166666666667,20.14284979377526
Task_16647,929,498,29,45,74,1.8617234468937875,21.2890811508478
Task_16648,2178,753,184,88,272,2.8885941644562334,44.08715351766441
Task_16649,1157,362,140,173,313,3.18732782369146,27.052582380946774
Task_16650,977,214,157,11,168,4.544186046511628,22.21537261054435
Task_16651,882,526,159,15,174,1.6736242884250474,21.753042580288767
Task_16652,1740,688,31,113,144,2.525399129172714,36.27208018797443
Task_16653,2631,341,93,55,148,7.692982456140351,49.06241696858378
Task_16654,2752,803,151,36,187,3.4228855721393034,52.41073937589905
Task_16655,2319,239,72,93,165,9.6625,44.25781348026596
Task_16656,2475,356,119,83,202,6.932773109243698,47.178166395655914
Task_16657,2888,928,57,194,251,3.108719052744887,56.07076828149598
Task_16658,1661,580,127,200,327,2.8588640275387265,35.82571381959975
Task_16659,1768,625,75,174,249,2.8242811501597442,37.33710899995962
Task_16660,1739,324,23,80,103,5.350769230769231,34.652753221271155
Task_16661,953,782,71,12,83,1.2171136653895274,22.989748361281347
Task_16662,2268,922,141,171,312,2.457204767063922,46.40242173014304
Task_16663,2981,346,155,199,354,8.590778097982708,56.07490027474379
Task_16664,819,594,170,187,357,1.3764705882352941,22.597935212850143
Task_16665,1398,641,84,149,233,2.177570093457944,31.363585566603657
Task_16666,2440,617,115,133,248,3.9482200647249193,47.825179581483575
Task_16667,2935,112,138,79,217,25.97345132743363,52.969014095628864
Task_16668,2951,550,120,49,169,5.3557168784029034,54.76015596155806
Task_16669,2853,303,196,136,332,9.384868421052632,53.70821210658564
Task_16670,724,712,110,64,174,1.0154277699859748,20.1406860491264
Task_16671,2695,412,144,192,336,6.52542372881356,51.68225560850434
Task_16672,2714,399,60,132,192,6.785,51.271985803521
Task_16673,511,732,173,28,201,0.6971350613915416,16.97260632333031
Task_16674,2489,777,108,11,119,3.1992287917737787,47.459475317214476
Task_16675,2880,506,14,71,85,5.680473372781065,52.96511709996344
Task_16676,682,165,94,67,161,4.108433734939759,17.423999186446295
Task_16677,2984,708,185,178,363,4.208744710860366,57.314568411420204
Task_16678,1849,925,132,88,220,1.9967602591792657,39.17695004359798
Task_16679,2330,387,97,114,211,6.005154639175258,45.15361956972949
Task_16680,915,531,90,195,285,1.7199248120300752,23.643612414549278
Task_16681,2693,183,130,48,178,14.63586956521739,49.391479231297104
Task_16682,2557,133,59,43,102,19.082089552238806,45.71202742334213
Task_16683,2213,398,172,21,193,5.546365914786968,42.54429745370488
Task_16684,2623,989,46,125,171,2.6494949494949496,51.5093329725984
Task_16685,2706,659,63,124,187,4.1,51.93692869518406
Task_16686,2362,919,166,134,300,2.5673913043478263,47.77423814292197
Task_16687,1608,552,25,62,87,2.907775768535262,32.864968543769045
Task_16688,1144,690,141,50,191,1.6555716353111434,26.71674609563053
Task_16689,1661,711,14,66,80,2.332865168539326,34.1549211281477
Task_16690,1535,459,54,193,247,3.3369565217391304,33.14654543040191
Task_16691,1890,1007,160,44,204,1.875,39.48486621212877
Task_16692,2030,230,172,116,288,8.787878787878787,40.210414295665075
Task_16693,2204,398,177,119,296,5.523809523809524,43.57905505631877
Task_16694,2565,197,153,167,320,12.954545454545455,48.78795399960566
Task_16695,888,206,55,157,212,4.2898550724637685,21.87929723693235
Task_16696,878,214,146,161,307,4.083720930232558,22.112958263981493
Task_16697,2111,269,111,133,244,7.818518518518519,41.45711224784822
Task_16698,1703,953,170,54,224,1.7851153039832286,36.682097279648765
Task_16699,1669,395,171,150,321,4.2146464646464645,35.26197729095557
Task_16700,2738,128,85,118,203,21.224806201550386,50.31644607525544
Task_16701,964,938,106,138,244,1.0266240681576144,25.374256436798174
Task_16702,1878,991,144,10,154,1.8931451612903225,38.781437611847956
Task_16703,1937,167,19,79,98,11.529761904761905,36.75119579647985
Task_16704,1192,540,53,172,225,2.2033271719038816,27.844657176422274
Task_16705,1587,222,188,179,367,7.116591928251121,33.63332624823594
Task_16706,2671,443,39,177,216,6.0157657657657655,50.8519519597613
Task_16707,1340,397,126,42,168,3.3668341708542715,28.66062176084399
Task_16708,970,300,126,161,287,3.222591362126246,23.760237363202503
Task_16709,1632,210,29,36,65,7.734597156398104,31.42631020561654
Task_16710,1823,312,88,149,237,5.824281150159744,37.002972854847656
Task_16711,2735,241,58,126,184,11.301652892561984,50.96587108535093
Task_16712,1672,83,96,129,225,19.904761904761905,33.24970948055796
Task_16713,1963,817,40,161,201,2.399755501222494,40.737193384014304
Task_16714,1524,220,176,196,372,6.895927601809955,32.67875059708949
Task_16715,2191,880,69,157,226,2.4869466515323495,44.71566527136082
Task_16716,1478,374,199,91,290,3.941333333333333,31.890760500238628
Task_16717,2269,720,50,151,201,3.147018030513176,45.35475880257453
Task_16718,1432,191,121,14,135,7.458333333333333,29.121567832317215
Task_16719,1248,723,160,49,209,1.723756906077348,28.54534228880296
Task_16720,908,659,36,153,189,1.3757575757575757,23.4128501591607
Task_16721,563,354,142,84,226,1.5859154929577466,16.994877947504985
Task_16722,1643,309,132,125,257,5.3,34.242869792183605
Task_16723,1245,941,78,21,99,1.321656050955414,28.112528756061707
Task_16724,502,644,132,189,321,0.7782945736434108,17.62758059226441
Task_16725,1961,225,62,197,259,8.676991150442477,39.157407930011146
Task_16726,2611,234,93,139,232,11.11063829787234,49.22220245453854
Task_16727,726,362,41,56,97,2.0,18.366088040492127
Task_16728,2530,285,67,178,245,8.846153846153847,48.28160271725841
Task_16729,914,905,124,149,273,1.0088300220750552,24.608240336563465
Task_16730,2714,159,109,82,191,16.9625,49.93313568863749
Task_16731,738,627,167,32,199,1.1751592356687899,20.042943526718993
Task_16732,526,725,56,92,148,0.7245179063360881,17.296110490639368
Task_16733,2320,959,23,135,158,2.4166666666666665,46.39538029088303
Task_16734,2944,931,148,16,164,3.1587982832618025,55.67691518926825
Task_16735,1511,805,77,143,220,1.8746898263027296,33.65489680019239
Task_16736,1826,90,33,185,218,20.065934065934066,35.75540082544293
Task_16737,620,171,161,192,353,3.604651162790698,17.951869348629113
Task_16738,1956,567,53,154,207,3.443661971830986,39.91981001964242
Task_16739,2862,150,118,11,129,18.95364238410596,51.21829417491637
Task_16740,1870,404,159,18,177,4.617283950617284,37.03977631800284
Task_16741,2368,553,43,146,189,4.274368231046932,46.24781004767802
Task_16742,933,191,69,45,114,4.859375,21.17614260138842
Task_16743,1818,949,116,17,133,1.9136842105263159,37.62388298771417
Task_16744,2931,111,118,154,272,26.169642857142858,53.492493341540175
Task_16745,1362,245,121,87,208,5.536585365853658,29.246945883793003
Task_16746,1506,946,119,194,313,1.590285110876452,34.39795102343425
Task_16747,2250,733,200,176,376,3.0653950953678475,45.82184098260286
Task_16748,1092,786,23,51,74,1.3875476493011436,25.008045891936643
Task_16749,1791,165,137,29,166,10.789156626506024,34.82135218416083
Task_16750,1178,299,154,50,204,3.9266666666666667,26.079418218887525
Task_16751,2565,276,114,108,222,9.259927797833935,48.52184162273243
Task_16752,1562,660,167,152,319,2.363086232980333,34.402720176858494
Task_16753,1041,960,185,118,303,1.0832466181061395,26.89139541084467
Task_16754,2016,383,24,83,107,5.25,39.30436460149601
Task_16755,1225,233,23,150,173,5.235042735042735,26.996610570715692
Task_16756,1205,963,114,141,255,1.25,29.320072459171964
Task_16757,2576,444,156,118,274,5.78876404494382,49.516683332967546
Task_16758,2012,889,144,34,178,2.2606741573033706,40.91880699275427
Task_16759,1155,158,39,110,149,7.264150943396227,24.930111731590134
Task_16760,842,950,164,127,291,0.8853838065194533,23.70648846965226
Task_16761,541,699,88,80,168,0.7728571428571429,17.380637675244515
Task_16762,2438,668,108,81,189,3.6442451420029895,47.50382963233077
Task_16763,2794,228,56,141,197,12.200873362445416,51.96578490205823
Task_16764,1214,947,195,130,325,1.280590717299578,29.71581197708176
Task_16765,1526,346,35,129,164,4.3976945244956775,32.072078813970506
Task_16766,556,109,30,134,164,5.054545454545455,15.46228392561786
Task_16767,1822,587,103,172,275,3.098639455782313,38.12196041022637
Task_16768,2671,153,57,183,240,17.344155844155843,49.73116604346824
Task_16769,2614,153,190,178,368,16.974025974025974,49.3760769534996
Task_16770,998,942,117,23,140,1.058324496288441,24.68623386867119
Task_16771,1406,122,37,185,222,11.43089430894309,29.43330745999465
Task_16772,2459,191,116,111,227,12.807291666666666,46.54931654156201
Task_16773,1155,168,57,88,145,6.834319526627219,25.028485505937677
Task_16774,2736,686,161,110,271,3.982532751091703,52.80217171944596
Task_16775,2416,528,108,152,260,4.56710775047259,47.242952228863544
Task_16776,2179,305,21,47,68,7.120915032679738,40.511828322145384
Task_16777,2905,88,187,194,381,32.640449438202246,53.42771487455411
Task_16778,2366,286,103,103,206,8.24390243902439,45.33245858167086
Task_16779,1459,219,64,42,106,6.631818181818182,29.21752276667549
Task_16780,1791,79,149,15,164,22.3875,33.85242487510132
Task_16781,1458,873,137,165,302,1.668192219679634,33.34801032000695
Task_16782,726,381,69,129,198,1.9005235602094241,19.784052516647204
Task_16783,2742,641,116,37,153,4.271028037383178,51.46913122886573
Task_16784,2738,367,29,175,204,7.440217391304348,51.59416639466132
Task_16785,607,777,159,60,219,0.7802056555269923,18.76953746231814
Task_16786,1001,479,136,14,150,2.0854166666666667,23.292073111277517
Task_16787,1052,354,110,92,202,2.963380281690141,24.695095311244724
Task_16788,1552,494,46,77,123,3.1353535353535356,32.48708329980527
Task_16789,2574,849,195,34,229,3.028235294117647,49.93929955119484
Task_16790,2848,751,143,95,238,3.7872340425531914,54.62453786342126
Task_16791,1886,664,197,37,234,2.8360902255639098,38.49777991650182
Task_16792,1541,962,172,177,349,1.6002076843198338,35.1688272984918
Task_16793,1234,941,91,189,280,1.3099787685774946,29.903412127610526
Task_16794,716,360,17,63,80,1.9833795013850415,18.05937887704238
Task_16795,1012,118,195,166,361,8.504201680672269,23.83469656975667
Task_16796,1378,909,22,162,184,1.5142857142857142,31.57846784435988
Task_16797,797,975,53,73,126,0.8165983606557377,22.138654823531635
Task_16798,892,656,188,118,306,1.3576864535768645,23.62289376422096
Task_16799,2032,435,30,108,138,4.660550458715596,40.04736782224304
Task_16800,744,788,102,21,123,0.9429657794676806,20.171518361263644
Task_16801,1531,173,196,158,354,8.798850574712644,32.26312602271968
Task_16802,2912,713,62,149,211,4.078431372549019,55.52941587466275
Task_16803,1654,629,31,113,144,2.6253968253968254,34.724856778143646
Task_16804,1809,777,134,74,208,2.3251928020565553,37.888248462852
Task_16805,510,176,196,76,272,2.8813559322033897,15.484860261413166
Task_16806,2400,508,11,126,137,4.715127701375246,46.08218037100347
Task_16807,1307,380,111,155,266,3.4304461942257216,29.245309929190615
Task_16808,1689,129,137,30,167,12.992307692307692,32.95769817758916
Task_16809,1509,331,54,158,212,4.545180722891566,32.11238113192574
Task_16810,1000,169,29,195,224,5.882352941176471,23.317738492148646
Task_16811,2300,952,120,12,132,2.4134312696747116,45.26831459081219
Task_16812,2228,382,20,109,129,5.8172323759791125,43.00440965989518
Task_16813,1955,302,71,56,127,6.452145214521452,38.04950369114828
Task_16814,2880,978,196,113,309,2.9417773237997955,56.17648995655647
Task_16815,611,526,161,112,273,1.159392789373814,18.589325299007417
Task_16816,2168,642,19,159,178,3.3716951788491447,43.28204270554147
Task_16817,1115,221,83,147,230,5.0225225225225225,25.547273432083106
Task_16818,1045,939,177,145,322,1.1117021276595744,27.004370190444366
Task_16819,1065,284,26,78,104,3.736842105263158,23.839612401585907
Task_16820,604,203,94,166,260,2.9607843137254903,17.556205583356157
Task_16821,2410,966,110,69,179,2.4922440537745607,47.72924163826831
Task_16822,2951,852,140,114,254,3.459554513481829,56.66066723584527
Task_16823,1960,415,11,193,204,4.711538461538462,39.42774542571062
Task_16824,1775,975,189,63,252,1.8186475409836065,38.04390521780313
Task_16825,1525,890,171,59,230,1.7115600448933783,33.662814149315416
Task_16826,1066,655,159,26,185,1.625,25.215986985379487
Task_16827,2384,657,110,31,141,3.6231003039513676,45.794718228145676
Task_16828,2569,990,105,131,236,2.5923309788092834,50.98294515559959
Task_16829,732,278,160,152,312,2.6236559139784945,20.026151575308035
Task_16830,2958,622,140,96,236,4.747993579454254,55.96486597774254
Task_16831,826,900,82,175,257,0.9167591564927858,23.195651390276055
Task_16832,2823,559,179,94,273,5.041071428571429,53.75390984539467
Task_16833,1065,679,62,187,249,1.5661764705882353,26.353716141093344
Task_16834,1539,759,16,25,41,2.025,31.601187031147898
Task_16835,2291,466,14,191,205,4.905781584582441,44.856980397990505
Task_16836,2287,758,17,190,207,3.013175230566535,45.7035073166359
Task_16837,2785,871,40,114,154,3.1938073394495414,53.42831133517381
Task_16838,2499,785,90,94,184,3.1793893129770994,48.90173091927527
Task_16839,2499,819,122,51,173,3.047560975609756,48.603528695881074
Task_16840,1812,570,76,60,136,3.1733800350262698,36.73947315293197
Task_16841,765,833,194,50,244,0.9172661870503597,21.503224333098753
Task_16842,2110,262,50,69,119,8.022813688212928,40.38806031965992
Task_16843,1458,89,98,131,229,16.2,29.961920466381873
Task_16844,2661,778,128,160,288,3.4159178433889603,52.054239833071925
Task_16845,2741,468,166,77,243,5.844349680170576,51.840969459436366
Task_16846,2414,917,17,128,145,2.6296296296296298,47.66287898165093
Task_16847,2417,782,87,43,130,3.086845466155811,46.67558322176598
Task_16848,1479,742,169,37,206,1.990578734858681,32.16862973531179
Task_16849,2044,563,27,116,143,3.624113475177305,40.68056586052236
Task_16850,1972,763,63,167,230,2.581151832460733,40.90777602804963
Task_16851,993,742,70,195,265,1.3364737550471064,25.482618580541935
Task_16852,2344,244,71,124,195,9.56734693877551,44.87462164658965
Task_16853,2772,917,165,16,181,3.019607843137255,52.95053793341435
Task_16854,1694,234,24,20,44,7.208510638297873,32.29122775398121
Task_16855,541,493,83,81,164,1.0951417004048583,16.760154764939475
Task_16856,908,864,23,150,173,1.0497109826589595,23.8700151366908
Task_16857,1515,621,158,87,245,2.4356913183279745,33.04589669393614
Task_16858,1442,360,56,102,158,3.994459833795014,30.629394333938396
Task_16859,983,263,127,173,300,3.7234848484848486,23.9209586677066
Task_16860,2074,1021,128,177,305,2.0293542074363993,43.6134940551697
Task_16861,1096,868,145,78,223,1.2612197928653626,26.97064692466829
Task_16862,1867,101,113,74,187,18.30392156862745,35.822261743237576
Task_16863,2210,1002,175,17,192,2.2033898305084745,44.384824758430625
Task_16864,1207,1011,86,75,161,1.1926877470355732,28.670419661071843
Task_16865,2929,706,181,132,313,4.142857142857143,56.144217773266895
Task_16866,2250,426,66,174,240,5.269320843091335,44.30450706258214
Task_16867,1785,547,63,60,123,3.2572992700729926,35.99779773782823
Task_16868,2817,211,89,57,146,13.287735849056604,51.4776654817992
Task_16869,939,247,108,168,276,3.786290322580645,23.05730181412385
Task_16870,1277,132,103,66,169,9.601503759398497,26.621996919042648
Task_16871,503,605,135,35,170,0.83003300330033,16.1079731010304
Task_16872,1744,119,78,140,218,14.533333333333333,34.76404473973249
Task_16873,1233,591,77,107,184,2.08277027027027,28.330810891980487
Task_16874,1484,363,189,197,386,4.076923076923077,32.59297550345174
Task_16875,594,434,58,73,131,1.3655172413793104,17.209874155736365
Task_16876,733,427,172,158,330,1.7126168224299065,20.591094224903692
Task_16877,2839,164,84,84,168,17.206060606060607,51.7926913047011
Task_16878,1848,446,187,111,298,4.134228187919463,38.09869421289945
Task_16879,2608,362,101,149,250,7.184573002754821,49.687403361014766
Task_16880,1975,599,41,107,148,3.2916666666666665,39.743201036418434
Task_16881,1284,516,93,74,167,2.483558994197292,28.58219964041466
Task_16882,1753,317,189,120,309,5.512578616352202,36.23606923097169
Task_16883,741,944,188,154,342,0.7841269841269841,22.384663323299606
Task_16884,1464,529,188,161,349,2.762264150943396,32.58740691888685
Task_16885,2847,1008,24,138,162,2.821605550049554,54.979214761942046
Task_16886,770,620,33,99,132,1.2399355877616747,20.61975348707251
Task_16887,2690,645,35,58,93,4.164086687306502,50.3203349401528
Task_16888,1297,933,88,158,246,1.3886509635974305,30.636174638836604
Task_16889,1162,176,141,38,179,6.564971751412429,24.97074151417868
Task_16890,2534,941,156,189,345,2.6900212314225054,50.85180617878169
Task_16891,1252,334,177,80,257,3.737313432835821,27.97662787880348
Task_16892,1212,910,133,59,192,1.3304061470911086,28.596329246569212
Task_16893,1614,563,175,37,212,2.8617021276595747,33.772928359031
Task_16894,2120,575,165,100,265,3.6805555555555554,42.652383983240284
Task_16895,1273,803,42,185,227,1.5833333333333333,29.881703898474708
Task_16896,2011,567,173,185,358,3.540492957746479,41.444702133167716
Task_16897,2631,932,50,183,233,2.819935691318328,51.945358915837886
Task_16898,2705,231,162,109,271,11.65948275862069,50.788767469018694
Task_16899,1675,124,49,148,197,13.4,33.58680546915306
Task_16900,2176,351,181,34,215,6.181818181818182,41.98159962004987
Task_16901,1839,190,134,127,261,9.6282722513089,36.93806918613065
Task_16902,938,777,184,196,380,1.205655526992288,25.16215117786076
Task_16903,1124,689,164,96,260,1.6289855072463768,27.22244641854805
Task_16904,2818,198,140,145,285,14.160804020100503,52.596556258527926
Task_16905,1212,98,118,181,299,12.242424242424242,26.49822484243424
Task_16906,1777,973,97,193,290,1.824435318275154,38.721398308646876
Task_16907,2134,411,195,192,387,5.179611650485437,43.03121453270224
Task_16908,2263,273,142,144,286,8.25912408759124,44.07903991491356
Task_16909,1610,683,107,118,225,2.353801169590643,34.761509588211204
Task_16910,2240,475,14,165,179,4.705882352941177,43.901344419286715
Task_16911,2116,973,136,130,266,2.1724845995893225,43.885183332186934
Task_16912,2902,110,77,37,114,26.144144144144143,51.271947308053505
Task_16913,912,627,114,40,154,1.4522292993630572,22.419769446197847
Task_16914,2313,786,107,110,217,2.9390088945362134,46.172810600653634
Task_16915,1166,372,142,143,285,3.1260053619302948,27.056892338827634
Task_16916,1643,396,37,20,57,4.138539042821159,32.17543879367646
Task_16917,1112,84,187,182,369,13.08235294117647,25.209720449834325
Task_16918,2470,267,67,41,108,9.216417910447761,45.492573090248015
Task_16919,2641,521,159,44,203,5.059386973180077,49.8485037297095
Task_16920,1566,944,75,172,247,1.6571428571428573,35.10689620119893
Task_16921,1058,863,163,47,210,1.224537037037037,25.907376437877673
Task_16922,1039,900,100,191,291,1.1531631520532741,26.72583521028824
Task_16923,1291,193,134,141,275,6.654639175257732,28.380992242959532
Task_16924,1114,465,138,142,280,2.390557939914163,26.505621551730744
Task_16925,2733,515,197,196,393,5.296511627906977,52.88392567418432
Task_16926,891,734,125,106,231,1.2122448979591838,23.47600609140994
Task_16927,2486,404,10,15,25,6.1382716049382715,45.22934421069607
Task_16928,946,490,167,15,182,1.9266802443991853,22.692154467510715
Task_16929,2761,643,176,85,261,4.287267080745342,52.902958912169076
Task_16930,1148,195,121,40,161,5.857142857142857,24.87765674269475
Task_16931,2338,1024,78,156,234,2.2809756097560974,47.52268823825502
Task_16932,2269,100,64,145,209,22.465346534653467,42.722156741898566
Task_16933,2017,897,169,85,254,2.2461024498886415,41.882804180120225
Task_16934,930,378,183,31,214,2.453825857519789,22.35646064945928
Task_16935,2228,168,16,104,120,13.183431952662723,41.54935594591061
Task_16936,1778,558,27,108,135,3.1806797853309483,36.39588907409976
Task_16937,2525,342,36,61,97,7.3615160349854225,46.77643499130278
Task_16938,797,448,111,21,132,1.7750556792873051,19.901121075643946
Task_16939,2542,1016,196,180,376,2.4995083579154374,51.33889138581829
Task_16940,2009,452,119,177,296,4.434878587196468,40.75405471420235
Task_16941,2038,702,138,89,227,2.8990042674253202,41.52455712989788
Task_16942,1447,475,141,169,310,3.0399159663865545,31.98324646668264
Task_16943,1642,365,149,66,215,4.4863387978142075,33.858576678144665
Task_16944,2250,835,31,182,213,2.6913875598086126,45.413035790380924
Task_16945,2974,461,130,198,328,6.437229437229437,56.2327927570315
Task_16946,2790,529,77,47,124,5.264150943396227,51.648895615971135
Task_16947,2370,498,56,125,181,4.749498997995992,46.0542980666847
Task_16948,1334,192,67,34,101,6.9119170984455955,27.365426153057964
Task_16949,1110,666,98,136,234,1.6641679160419791,26.846463053339544
Task_16950,2961,143,27,27,54,20.5625,52.0743417638933
Task_16951,2099,218,143,73,216,9.584474885844749,40.638100712021924
Task_16952,2401,151,142,145,287,15.796052631578947,45.60113770111666
Task_16953,701,885,71,95,166,0.791196388261851,20.728850011217837
Task_16954,2946,460,192,61,253,6.390455531453362,54.918729090374136
Task_16955,1126,405,41,102,143,2.773399014778325,25.651908874970143
Task_16956,994,606,108,122,230,1.6375617792421746,24.779483073202442
Task_16957,1415,204,81,34,115,6.902439024390244,28.673127226245438
Task_16958,1301,573,67,72,139,2.2665505226480835,28.836444888709355
Task_16959,2967,970,148,77,225,3.055612770339856,56.93260381461574
Task_16960,1595,281,83,193,276,5.656028368794326,33.61071227099905
Task_16961,1268,845,163,84,247,1.4988179669030732,29.78418994469185
Task_16962,2189,786,143,62,205,2.781448538754765,43.76396223731563
Task_16963,1287,176,90,116,206,7.271186440677966,27.667278319984728
Task_16964,1413,720,111,53,164,1.9597780859916782,31.152345270326474
Task_16965,968,715,20,151,171,1.3519553072625698,24.367261635209896
Task_16966,1217,445,114,123,237,2.7286995515695067,27.85099860069047
Task_16967,2040,944,124,155,279,2.1587301587301586,42.68588095499636
Task_16968,1566,1023,42,173,215,1.529296875,35.135266734462085
Task_16969,1305,789,41,75,116,1.6518987341772151,29.42823707361589
Task_16970,2288,594,145,108,253,3.8453781512605043,45.33081029395425
Task_16971,604,865,23,61,84,0.6974595842956121,18.180553931262825
Task_16972,1962,238,154,161,315,8.209205020920502,39.35311644368396
Task_16973,1512,145,52,98,150,10.356164383561644,30.517371592145896
Task_16974,2425,655,173,150,323,3.6966463414634148,48.07101566028513
Task_16975,2427,827,110,144,254,2.931159420289855,48.323985016593916
Task_16976,2522,904,14,60,74,2.7867403314917127,48.05084241793947
Task_16977,2768,905,94,97,191,3.055187637969095,53.65696618900514
Task_16978,2824,294,115,104,219,9.572881355932203,52.6613453408433
Task_16979,1969,630,115,189,304,3.1204437400950873,40.741313485579404
Task_16980,2036,671,100,176,276,3.0297619047619047,41.78638519825498
Task_16981,2235,579,177,95,272,3.853448275862069,44.523881645464805
Task_16982,578,118,142,134,276,4.857142857142857,16.57766530779112
Task_16983,995,348,16,153,169,2.8510028653295127,23.69477786229992
Task_16984,2319,598,142,63,205,3.8714524207011687,45.26966230678634
Task_16985,1800,587,122,182,304,3.061224489795918,37.91893242052794
Task_16986,1815,803,191,23,214,2.2574626865671643,37.644630095786866
Task_16987,1004,123,147,172,319,8.096774193548388,23.563292625264115
Task_16988,1442,257,146,72,218,5.589147286821706,30.415939108281737
Task_16989,1920,170,190,186,376,11.228070175438596,38.54523767179517
Task_16990,705,417,143,169,312,1.686602870813397,20.051589527747904
Task_16991,780,526,115,72,187,1.4800759013282732,20.629163409187566
Task_16992,1199,809,151,196,347,1.480246913580247,29.264650114416156
Task_16993,2246,216,60,100,160,10.350230414746544,42.84292156674706
Task_16994,2570,78,51,84,135,32.53164556962025,46.455261275460465
Task_16995,1437,575,142,180,322,2.4947916666666665,32.21095451206949
Task_16996,2612,829,159,92,251,3.146987951807229,51.119806426547854
Task_16997,1929,970,33,26,59,1.9866117404737385,38.58485557043151
Task_16998,573,823,185,167,352,0.6953883495145631,19.488809535134127
Task_16999,2409,418,115,19,134,5.749403341288783,45.316314182166415
Task_17000,2097,406,53,117,170,5.152334152334152,41.36524047527147
Task_17001,1269,143,148,68,216,8.8125,26.934563989722037
Task_17002,1699,722,197,91,288,2.3499308437067774,36.4827258096418
Task_17003,716,1011,56,111,167,0.7075098814229249,21.39651194876249
Task_17004,2132,256,13,91,104,8.295719844357977,40.64121825264965
Task_17005,2602,185,181,142,323,13.989247311827956,49.191562433944966
Task_17006,1500,609,22,194,216,2.459016393442623,32.839919276690985
Task_17007,2042,928,65,114,179,2.1980624327233587,42.20093141715494
Task_17008,1514,559,160,161,321,2.7035714285714287,33.34753476083127
Task_17009,2123,392,140,115,255,5.402035623409669,42.08698184776556
Task_17010,840,212,158,74,232,3.943661971830986,20.862289731289536
Task_17011,875,753,70,145,215,1.160477453580902,23.324451723639754
Task_17012,1582,156,80,146,226,10.07643312101911,32.49643931231653
Task_17013,505,67,200,129,329,7.426470588235294,15.434415224957709
Task_17014,1599,502,171,198,369,3.1789264413518885,34.78366389135001
Task_17015,799,124,104,31,135,6.392,18.582987428551284
Task_17016,956,1018,113,191,304,0.9381746810598626,25.88057415789437
Task_17017,1529,490,157,154,311,3.114052953156823,33.31147663174917
Task_17018,2062,636,88,79,167,3.2370486656200943,41.299001020407765
Task_17019,2159,566,79,130,209,3.8077601410934743,43.09294710088235
Task_17020,2697,441,119,165,284,6.101809954751131,51.535891607944826
Task_17021,1577,690,120,28,148,2.2821997105643996,33.17328205197781
Task_17022,1474,956,146,152,298,1.5402298850574712,33.792711003905886
Task_17023,699,322,174,157,331,2.1640866873065017,19.738198634764384
Task_17024,1437,83,74,83,157,17.107142857142858,28.81138320285559
Task_17025,1706,935,174,172,346,1.8226495726495726,37.69222128787863
Task_17026,1966,886,128,140,268,2.216459977452086,41.261185524290184
Task_17027,1903,187,176,189,365,10.122340425531915,38.524785949052564
Task_17028,1845,874,188,72,260,2.1085714285714285,38.95027570578406
Task_17029,2653,840,68,154,222,3.154577883472057,51.88903282388491
Task_17030,2351,691,144,168,312,3.397398843930636,46.98940607293812
Task_17031,2106,368,185,57,242,5.7073170731707314,41.28264121191342
Task_17032,1048,289,118,28,146,3.613793103448276,23.55320948073445
Task_17033,2003,948,45,173,218,2.110642781875659,41.89156286869439
Task_17034,1979,786,107,164,271,2.5146124523506987,41.20386670662695
Task_17035,1159,523,25,53,78,2.2118320610687023,25.367758534778364
Task_17036,1311,880,121,67,188,1.4880817253121452,30.08393043591586
Task_17037,1348,754,60,58,118,1.7854304635761589,29.630538704525446
Task_17038,1655,693,17,161,178,2.384726224783862,35.29284698819754
Task_17039,2668,169,66,199,265,15.694117647058823,49.936394041252186
Task_17040,608,483,147,165,312,1.256198347107438,18.66577612573681
Task_17041,2682,623,153,132,285,4.298076923076923,51.84221030584282
Task_17042,2330,320,183,60,243,7.258566978193146,44.66148713461922
Task_17043,1594,845,65,37,102,1.884160756501182,33.4137056358955
Task_17044,2417,333,85,101,186,7.236526946107785,46.18146651484651
Task_17045,1855,844,169,142,311,2.195266272189349,39.56831894462929
Task_17046,1026,370,168,59,227,2.765498652291105,24.1279545585143
Task_17047,2772,633,70,26,96,4.37223974763407,51.433136812455636
Task_17048,2349,230,25,131,156,10.168831168831169,44.47467262836873
Task_17049,827,398,141,76,217,2.072681704260652,21.199619264526397
Task_17050,2237,73,66,21,87,30.22972972972973,39.736624916776556
Task_17051,2612,230,128,103,231,11.307359307359308,49.1269201820179
Task_17052,2937,472,25,72,97,6.209302325581396,53.857685553123964
Task_17053,1581,832,122,148,270,1.8979591836734695,35.01370075879412
Task_17054,1771,565,89,39,128,3.128975265017668,35.855713692604006
Task_17055,2503,786,81,116,197,3.1804320203303686,49.15489269387634
Task_17056,1703,387,57,58,115,4.389175257731959,34.111012128428605
Task_17057,865,800,60,170,230,1.079900124843945,23.384555798593144
Task_17058,1254,611,37,65,102,2.049019607843137,27.736227907607475
Task_17059,1262,607,123,129,252,2.075657894736842,29.149726813820617
Task_17060,1346,443,104,120,224,3.0315315315315314,29.82338784231558
Task_17061,1194,371,113,116,229,3.2096774193548385,27.20468215635906
Task_17062,2769,260,72,46,118,10.60919540229885,50.29597016833452
Task_17063,2589,69,15,166,181,36.98571428571429,47.3186525946096
Task_17064,2134,360,148,14,162,5.911357340720222,40.93945904152965
Task_17065,2239,94,87,179,266,23.568421052631578,42.40189220932008
Task_17066,1848,192,152,97,249,9.575129533678757,37.02161603581869
Task_17067,2376,981,27,83,110,2.419551934826884,46.971234576491916
Task_17068,2875,441,187,178,365,6.504524886877828,54.73725359019528
Task_17069,536,71,117,200,317,7.444444444444445,15.972223823191579
Task_17070,807,298,126,169,295,2.698996655518395,21.224482100782005
Task_17071,1870,334,124,191,315,5.582089552238806,38.27432273376362
Task_17072,536,75,31,139,170,7.052631578947368,15.077316197436962
Task_17073,1686,869,169,140,309,1.9379310344827587,36.95650196058593
Task_17074,628,651,34,197,231,0.9631901840490797,19.1570683510654
Task_17075,1477,92,97,43,140,15.881720430107526,28.800761482457318
Task_17076,2383,317,111,33,144,7.4937106918239,44.701915802348005
Task_17077,2910,390,114,18,132,7.442455242966752,53.1391793284625
Task_17078,865,1022,152,49,201,0.8455522971652004,23.42813211818128
Task_17079,1266,679,141,35,176,1.861764705882353,28.4388055466852
Task_17080,711,549,198,114,312,1.2927272727272727,20.430577678435444
Task_17081,2672,954,145,81,226,2.7979057591623038,52.28036195894097
Task_17082,801,837,17,187,204,0.9558472553699284,22.299348971998047
Task_17083,2931,875,101,175,276,3.345890410958904,56.604511625749716
Task_17084,1550,450,170,115,285,3.436807095343681,33.342142115663876
Task_17085,2753,972,180,69,249,2.829393627954779,53.525997634922184
Task_17086,1336,944,62,11,73,1.4137566137566138,28.936992260705907
Task_17087,1746,840,121,171,292,2.0760998810939357,37.78572804203919
Task_17088,2400,847,131,128,259,2.830188679245283,47.95786953002365
Task_17089,1932,970,112,154,266,1.9897013388259526,40.99526633422915
Task_17090,797,84,40,58,98,9.376470588235295,17.946324057412102
Task_17091,847,935,14,16,30,0.9049145299145299,21.201054973580913
Task_17092,2886,389,159,161,320,7.4,54.509984410308356
Task_17093,1696,207,171,71,242,8.153846153846153,34.33606289199432
Task_17094,1693,859,71,61,132,1.9686046511627906,35.78108642326377
Task_17095,1293,526,163,162,325,2.4535104364326377,29.76380404430356
Task_17096,889,428,128,161,289,2.0722610722610724,22.89613386271156
Task_17097,643,260,84,165,249,2.4636015325670497,18.30651634687524
Task_17098,1586,184,121,32,153,8.572972972972973,31.671122395892823
Task_17099,2762,885,75,43,118,3.1173814898419865,52.225218393371385
Task_17100,549,726,148,141,289,0.7551581843191196,18.38881624444666
Task_17101,2977,900,143,193,336,3.304106548279689,57.70855302979163
Task_17102,2590,239,132,180,312,10.791666666666666,49.291684032284515
Task_17103,890,532,58,170,228,1.6697936210131332,23.03283053818252
Task_17104,2179,158,182,126,308,13.70440251572327,42.20397951672948
Task_17105,2748,327,96,84,180,8.378048780487806,51.28167166472482
Task_17106,2695,470,101,174,275,5.721868365180467,51.57196513235076
Task_17107,1034,953,57,72,129,1.0838574423480083,25.83162521734739
Task_17108,2995,533,42,146,188,5.608614232209738,56.09630441085543
Task_17109,1768,186,47,146,193,9.454545454545455,35.57658775390464
Task_17110,911,251,27,62,89,3.615079365079365,20.89418443932708
Task_17111,2000,587,18,175,193,3.401360544217687,40.559928829428436
Task_17112,1216,607,50,93,143,2.0,27.830375614856028
Task_17113,2863,399,100,14,114,7.1575,52.15710509320018
Task_17114,1925,315,141,140,281,6.091772151898734,38.85231615594498
Task_17115,2026,440,12,41,53,4.594104308390023,38.48990818359375
Task_17116,2419,127,44,20,64,18.8984375,43.219118905007186
Task_17117,1342,939,74,191,265,1.4276595744680851,31.610516983534826
Task_17118,2269,164,109,180,289,13.751515151515152,43.63237569840471
Task_17119,547,371,89,179,268,1.4704301075268817,17.159573412928523
Task_17120,702,832,14,114,128,0.8427370948379351,20.34676512013888
Task_17121,1371,753,178,65,243,1.8183023872679045,30.935723737090157
Task_17122,1227,938,25,123,148,1.3067092651757188,28.884295179143674
Task_17123,530,293,159,45,204,1.8027210884353742,15.710984241900128
Task_17124,1045,198,29,171,200,5.251256281407035,24.272134471813203
Task_17125,2659,387,84,39,123,6.853092783505154,49.08206095956771
Task_17126,917,706,141,32,173,1.297029702970297,22.9781159492091
Task_17127,2414,269,48,121,169,8.940740740740742,45.901917102405825
Task_17128,2951,352,77,33,110,8.359773371104815,53.42449165220959
Task_17129,1598,416,181,25,206,3.8321342925659474,32.95671707263658
Task_17130,1308,949,42,141,183,1.3768421052631579,30.572548117378545
Task_17131,1941,98,197,39,236,19.606060606060606,36.74034024659408
Task_17132,1699,917,149,113,262,1.8507625272331154,37.060299840943806
Task_17133,2298,99,174,166,340,22.98,43.7424150282217
Task_17134,2133,394,104,183,287,5.4,42.495699719957564
Task_17135,2920,96,102,26,128,30.103092783505154,51.540558722608175
Task_17136,2337,350,193,59,252,6.6581196581196584,44.913929441204196
Task_17137,1637,753,109,158,267,2.1710875331564985,35.655894266735906
Task_17138,2403,769,160,119,279,3.120779220779221,47.837947066709546
Task_17139,2191,578,64,105,169,3.784110535405872,43.3829811231264
Task_17140,2729,777,146,62,208,3.507712082262211,52.30426688059547
Task_17141,1284,388,102,175,277,3.3007712082262213,28.986007012866136
Task_17142,2029,447,159,108,267,4.529017857142857,40.822598880973466
Task_17143,2836,186,107,188,295,15.165775401069519,52.9351601129697
Task_17144,786,208,34,124,158,3.7607655502392343,19.744040091908165
Task_17145,802,347,138,135,273,2.3045977011494254,21.153078098878886
Task_17146,1242,249,173,63,236,4.968,27.23458467827932
Task_17147,2936,365,62,83,145,8.021857923497267,54.24687559640853
Task_17148,2211,119,33,107,140,18.425,41.167268667219595
Task_17149,2292,936,199,52,251,2.4461045891141944,46.11722045456869
Task_17150,2304,821,195,64,259,2.802919708029197,45.98478437132801
Task_17151,869,295,150,83,233,2.935810810810811,21.71760211790695
Task_17152,1350,469,44,91,135,2.872340425531915,29.36967288121501
Task_17153,705,552,86,18,104,1.274864376130199,18.377964824169137
Task_17154,1723,198,110,86,196,8.658291457286433,34.759512488371904
Task_17155,1994,350,53,127,180,5.680911680911681,39.63293879197395
Task_17156,1508,695,51,99,150,2.1666666666666665,32.705029106439255
Task_17157,2735,615,167,119,286,4.439935064935065,52.641550662578275
Task_17158,2445,873,184,122,306,2.7974828375286043,48.955207234699174
Task_17159,2682,963,18,25,43,2.7821576763485476,50.3691345970887
Task_17160,2336,403,120,109,229,5.782178217821782,45.36761781342566
Task_17161,970,430,115,180,295,2.2505800464037122,24.23925620406527
Task_17162,1755,320,123,19,142,5.4672897196261685,34.68266241876301
Task_17163,1547,494,139,83,222,3.125252525252525,33.032012581145324
Task_17164,606,467,143,158,301,1.294871794871795,18.5276890822113
Task_17165,1207,108,89,163,252,11.073394495412844,26.27237774587128
Task_17166,1851,961,88,42,130,1.9241164241164241,38.26312019773618
Task_17167,1385,939,182,178,360,1.4734042553191489,32.63612883486393
Task_17168,2008,381,114,21,135,5.2565445026178015,38.84455345804381
Task_17169,2066,813,33,27,60,2.538083538083538,40.28267341722543
Task_17170,1310,302,101,147,248,4.323432343234323,28.94610037648069
Task_17171,1581,752,80,186,266,2.099601593625498,34.85546958948133
Task_17172,2793,97,74,23,97,28.5,49.11967578893555
Task_17173,2347,639,112,34,146,3.6671875,45.243497742697706
Task_17174,1928,143,155,44,199,13.38888888888889,36.975557728026594
Task_17175,2067,478,194,190,384,4.315240083507307,42.17161898092025
Task_17176,1357,193,14,63,77,6.994845360824742,27.584330816915543
Task_17177,2773,830,182,86,268,3.3369434416365826,53.72709267092453
Task_17178,1657,630,188,110,298,2.6259904912836767,35.65706509349916
Task_17179,1085,428,59,191,250,2.5291375291375293,25.936170215227303
Task_17180,1145,181,16,144,160,6.291208791208791,24.97907366619937
Task_17181,2532,854,144,47,191,2.9614035087719297,49.1524100146203
Task_17182,599,786,59,91,150,0.761118170266836,18.57919092684804
Task_17183,2796,806,117,60,177,3.4646840148698885,53.29019062084797
Task_17184,2430,371,70,103,173,6.532258064516129,46.52716122679167
Task_17185,2278,540,23,37,60,4.210720887245841,42.791450974754945
Task_17186,793,733,133,200,333,1.0803814713896458,22.51476528116312
Task_17187,2020,738,89,190,279,2.733423545331529,41.756318264975334
Task_17188,1838,186,100,17,117,9.828877005347593,35.27372833318815
Task_17189,1498,647,187,88,275,2.3117283950617282,32.997076106066466
Task_17190,1767,730,165,127,292,2.417236662106703,37.71067800099619
Task_17191,2146,116,82,40,122,18.34188034188034,39.47854571772281
Task_17192,2230,128,73,56,129,17.286821705426355,41.367209217380214
Task_17193,1907,493,148,197,345,3.860323886639676,39.52135505816583
Task_17194,2560,112,147,17,164,22.654867256637168,46.35868216182467
Task_17195,1010,743,140,147,287,1.35752688172043,25.719142906028576
Task_17196,1752,472,183,177,360,3.704016913319239,37.038790263775425
Task_17197,2297,742,176,17,193,3.091520861372813,44.95579709318887
Task_17198,2214,693,130,123,253,3.190201729106628,44.49373699461322
Task_17199,727,417,121,97,218,1.7392344497607655,19.898920910749318
Task_17200,2184,347,55,160,215,6.275862068965517,42.85773634408421
Task_17201,1464,254,14,159,173,5.741176470588235,30.853769796236318
Task_17202,1947,750,38,10,48,2.59254327563249,37.98622073006519
Task_17203,1328,108,135,10,145,12.18348623853211,26.72376385637394
Task_17204,2921,994,130,97,227,2.935678391959799,56.51152075077902
Task_17205,2166,987,193,41,234,2.1923076923076925,43.93471709704727
Task_17206,955,197,182,18,200,4.8232323232323235,22.03218714703028
Task_17207,1699,868,142,164,306,1.95512082853855,37.18103228552146
Task_17208,678,676,95,62,157,1.0014771048744462,19.065139066290886
Task_17209,2727,317,108,163,271,8.575471698113208,51.52995065203023
Task_17210,1614,222,146,126,272,7.237668161434978,33.553850852847354
Task_17211,2597,514,113,19,132,5.042718446601942,48.611679277787395
Task_17212,1286,367,78,187,265,3.494565217391304,28.98054650188323
Task_17213,1753,445,187,186,373,3.930493273542601,37.03983551635632
Task_17214,1011,768,29,129,158,1.3146944083224967,25.00543597570923
Task_17215,2818,479,142,17,159,5.870833333333334,52.10067434711187
Task_17216,1152,595,40,118,158,1.9328859060402686,26.757010588219288
Task_17217,2552,458,57,135,192,5.559912854030501,48.90442516388804
Task_17218,2063,80,26,120,146,25.469135802469136,38.56033240909124
Task_17219,762,242,113,31,144,3.1358024691358026,18.830433404870043
Task_17220,2255,691,67,145,212,3.258670520231214,45.05883092069382
Task_17221,2733,306,117,187,304,8.90228013029316,51.770066827730695
Task_17222,1149,440,46,107,153,2.6054421768707483,26.167802252850993
Task_17223,2462,159,88,200,288,15.3875,46.656529304708585
Task_17224,760,733,142,17,159,1.0354223433242506,20.312843480407192
Task_17225,608,807,161,111,272,0.7524752475247525,19.45327507042669
Task_17226,540,824,64,194,258,0.6545454545454545,18.65886534196966
Task_17227,828,964,128,46,174,0.8580310880829015,22.441694733966248
Task_17228,598,75,15,128,143,7.868421052631579,15.584389871277864
Task_17229,1303,161,43,183,226,8.04320987654321,28.074211908816
Task_17230,2538,399,158,55,213,6.345,48.094527873570314
Task_17231,2179,999,190,149,339,2.179,45.32126461350384
Task_17232,2117,535,171,126,297,3.949626865671642,42.65988141491386
Task_17233,1764,565,160,145,305,3.11660777385159,37.22960991871044
Task_17234,1097,830,45,136,181,1.3200962695547533,26.853016280462366
Task_17235,2324,440,47,82,129,5.26984126984127,44.791338264669314
Task_17236,2147,863,37,69,106,2.4849537037037037,42.72756847627567
Task_17237,2547,457,43,146,189,5.56113537117904,48.77174509860896
Task_17238,2865,569,20,97,117,5.026315789473684,53.49276934025318
Task_17239,725,463,82,153,235,1.5625,20.15304227725561
Task_17240,581,540,36,183,219,1.0739371534195934,17.9861178719552
Task_17241,564,894,108,195,303,0.6301675977653631,19.407751371193935
Task_17242,874,548,84,148,232,1.5919854280510017,22.75529817500158
Task_17243,2546,417,60,27,87,6.090909090909091,46.925720084106864
Task_17244,2312,696,128,39,167,3.317073170731707,45.021459157071035
Task_17245,686,137,131,27,158,4.971014492753623,16.965915315415987
Task_17246,2884,242,118,150,268,11.868312757201647,53.7053261813762
Task_17247,2112,502,57,147,204,4.198807157057654,42.153230013765544
Task_17248,2131,422,148,121,269,5.037825059101655,42.383775688674106
Task_17249,2871,647,144,93,237,4.430555555555555,54.6220664959553
Task_17250,2546,522,28,169,197,4.868068833652008,49.0129177839492
Task_17251,2545,439,79,109,188,5.784090909090909,48.65532240910297
Task_17252,1422,238,94,46,140,5.949790794979079,29.262376030951582
Task_17253,2716,664,30,195,225,4.08421052631579,52.33613790176557
Task_17254,2912,999,183,103,286,2.912,56.63083008430569
Task_17255,2661,932,186,156,342,2.852090032154341,52.77425180778935
Task_17256,1783,803,42,158,200,2.2176616915422884,37.83958206996568
Task_17257,2114,584,146,60,206,3.6136752136752137,41.93766849186188
Task_17258,2980,234,197,56,253,12.680851063829786,54.679557971438506
Task_17259,854,441,172,153,325,1.9321266968325792,22.53365103310894
Task_17260,1869,674,107,196,303,2.7688888888888887,39.301644625200005
Task_17261,2902,112,58,42,100,25.68141592920354,50.948654006018124
Task_17262,1759,474,93,169,262,3.703157894736842,36.741040951251144
Task_17263,2056,299,164,184,348,6.8533333333333335,41.23561494890668
Task_17264,2605,285,159,147,306,9.108391608391608,49.62218092933358
Task_17265,2677,551,123,66,189,4.84963768115942,50.72068997459991
Task_17266,577,338,46,149,195,1.7020648967551621,17.25505558476851
Task_17267,2506,255,105,126,231,9.7890625,47.57997273487708
Task_17268,2082,204,134,153,287,10.15609756097561,40.98350636144182
Task_17269,675,478,18,99,117,1.4091858037578289,18.443294315048167
Task_17270,604,311,62,174,236,1.935897435897436,17.864870545623212
Task_17271,911,1016,102,13,115,0.895771878072763,23.320798168970203
Task_17272,2764,520,146,180,326,5.305182341650672,53.06548442245836
Task_17273,2906,491,191,166,357,5.90650406504065,55.33853946216917
Task_17274,1308,217,190,125,315,6.0,28.896289870561176
Task_17275,761,66,69,151,220,11.35820895522388,19.016008251353668
Task_17276,2313,603,39,120,159,3.8294701986754967,45.17054776384547
Task_17277,1893,668,35,20,55,2.8295964125560538,36.98308265523119
Task_17278,1816,1016,87,109,196,1.7856440511307767,38.878676710996295
Task_17279,2322,96,72,168,240,23.938144329896907,43.69721072361747
Task_17280,670,316,63,172,235,2.1135646687697163,18.91695452862853
Task_17281,2760,502,111,113,224,5.487077534791252,52.38587567037863
Task_17282,926,421,163,165,328,2.1943127962085307,23.641245947823013
Task_17283,1621,748,145,185,330,2.164218958611482,35.71034534600506
Task_17284,2226,593,53,98,151,3.7474747474747474,43.75174823770272
Task_17285,987,640,29,193,222,1.5397815912636506,24.819336978048813
Task_17286,2702,965,114,170,284,2.7971014492753623,53.286093257924904
Task_17287,2437,338,23,115,138,7.188790560471976,46.1281769424101
Task_17288,661,607,129,24,153,1.087171052631579,18.35389489327347
Task_17289,1078,834,29,30,59,1.2910179640718562,24.696504384296464
Task_17290,901,807,73,138,211,1.11509900990099,23.85335741449333
Task_17291,1082,359,192,20,212,3.0055555555555555,24.607960955830276
Task_17292,2832,564,107,80,187,5.012389380530974,53.39037359859358
Task_17293,1483,343,51,152,203,4.311046511627907,31.7193342864478
Task_17294,1717,940,194,151,345,1.8246546227417642,37.84676644635295
Task_17295,2531,694,194,42,236,3.641726618705036,48.811186563453475
Task_17296,1777,324,156,47,203,5.467692307692308,35.56066159594777
Task_17297,2478,403,167,18,185,6.133663366336633,46.690578455367266
Task_17298,516,137,87,14,101,3.739130434782609,13.833850136249564
Task_17299,2648,874,53,188,241,3.0262857142857142,52.05065873682455
Task_17300,2708,203,50,27,77,13.27450980392157,48.473402248460246
Task_17301,2401,303,151,52,203,7.8980263157894735,45.59733596781066
Task_17302,2102,323,29,159,188,6.487654320987654,41.276028353988494
Task_17303,2583,210,122,111,233,12.24170616113744,48.611421557651376
Task_17304,2075,148,190,83,273,13.926174496644295,40.17051579897838
Task_17305,1384,92,118,174,292,14.881720430107526,29.15552670120189
Task_17306,2666,406,168,33,201,6.5503685503685505,49.853139391756606
Task_17307,2591,543,47,184,231,4.762867647058823,50.018338387824166
Task_17308,1053,471,177,199,376,2.2309322033898304,26.075192895003543
Task_17309,541,805,86,45,131,0.6712158808933002,17.388892216704694
Task_17310,2960,641,181,197,378,4.610591900311526,56.81693900133723
Task_17311,1343,956,105,110,215,1.4033437826541275,31.27003403867981
Task_17312,1043,785,134,18,152,1.326972010178117,24.89166789689463
Task_17313,695,626,148,148,296,1.1084529505582137,20.377054341618223
Task_17314,850,613,119,155,274,1.3843648208469055,22.726994811374677
Task_17315,2973,574,59,137,196,5.170434782608695,55.96997142082639
Task_17316,2558,728,39,197,236,3.5089163237311385,50.09488576097311
Task_17317,1147,213,134,185,319,5.359813084112149,26.44614343469338
Task_17318,2789,977,182,160,342,2.8517382413087935,54.948950299544116
Task_17319,2932,278,198,36,234,10.508960573476703,53.76515835446608
Task_17320,2549,588,148,81,229,4.3276740237691005,49.193068004225466
Task_17321,2558,481,153,24,177,5.3070539419087135,48.21055023241659
Task_17322,2360,816,114,90,204,2.8886168910648715,46.89177157437663
Task_17323,2417,507,29,54,83,4.7578740157480315,45.45898807916251
Task_17324,1577,797,34,157,191,1.9761904761904763,34.51054507387667
Task_17325,1933,366,115,197,312,5.267029972752043,39.37232592403824
Task_17326,2942,467,67,158,225,6.286324786324786,55.29763786903431
Task_17327,2413,317,31,177,208,7.588050314465409,46.298632534723374
Task_17328,869,298,126,190,316,2.9063545150501673,22.33014149424066
Task_17329,1292,752,30,114,144,1.7158034528552457,29.369129925130352
Task_17330,2642,538,36,90,126,4.901669758812616,50.092313546537135
Task_17331,2133,936,199,176,375,2.2764140875133405,44.59812470013899
Task_17332,642,845,146,81,227,0.7588652482269503,19.78461332294653
Task_17333,510,493,42,29,71,1.0323886639676114,14.791954608554144
Task_17334,1032,834,119,23,142,1.2359281437125749,24.87562661682904
Task_17335,2891,539,18,79,97,5.353703703703704,53.43052117130086
Task_17336,2293,457,175,149,324,5.006550218340611,45.35061120597979
Task_17337,928,819,74,138,212,1.1317073170731706,24.325725579513048
Task_17338,869,844,96,168,264,1.0284023668639053,23.70790337945648
Task_17339,2196,584,38,121,159,3.753846153846154,43.25882673508452
Task_17340,769,121,35,72,107,6.30327868852459,18.06410253686822
Task_17341,2683,452,191,179,370,5.922737306843267,51.75859229705238
Task_17342,1790,944,105,164,269,1.8941798941798942,38.692475526335556
Task_17343,1600,162,39,149,188,9.815950920245399,32.50967784430855
Task_17344,2274,127,157,128,285,17.765625,43.365926246680225
Task_17345,2390,545,183,31,214,4.377289377289378,45.999421507466515
Task_17346,1699,920,80,89,169,1.8447339847991313,36.5889222043743
Task_17347,584,493,19,128,147,1.1821862348178138,17.339797318165783
Task_17348,1090,545,117,171,288,1.9963369963369964,26.455724115831487
Task_17349,1622,542,198,125,323,2.987108655616943,34.96020941957675
Task_17350,2834,593,122,52,174,4.771043771043771,53.26334406578579
Task_17351,2515,739,133,74,207,3.3986486486486487,48.949091082480045
Task_17352,665,177,10,97,107,3.735955056179775,16.84857795970338
Task_17353,2792,856,169,135,304,3.2578763127187864,54.41010071044955
Task_17354,710,732,167,46,213,0.9686221009549796,20.065762073740927
Task_17355,2466,727,191,146,337,3.3873626373626373,49.00492540660031
Task_17356,2803,681,135,112,247,4.109970674486804,53.74235603932866
Task_17357,2918,650,156,198,354,4.482334869431644,56.073697114119035
Task_17358,2924,846,156,137,293,3.4521841794569066,56.42352709197513
Task_17359,2935,966,133,150,283,3.035160289555326,56.947621469596946
Task_17360,2512,515,145,13,158,4.868217054263566,47.371850626284036
Task_17361,1864,594,196,81,277,3.1327731092436975,38.580673966663795
Task_17362,1056,271,78,108,186,3.8823529411764706,24.525548950041827
Task_17363,2237,1012,92,35,127,2.2082922013820334,44.52241550726867
Task_17364,2437,478,57,52,109,5.087682672233821,45.89676296685295
Task_17365,519,98,105,80,185,5.242424242424242,14.680773351851684
Task_17366,2619,689,41,124,165,3.7956521739130435,50.484215355986805
Task_17367,1608,74,142,94,236,21.44,32.231393181927395
Task_17368,1903,766,86,72,158,2.48109517601043,38.906641026881346
Task_17369,528,359,179,73,252,1.4666666666666666,16.413534473549763
Task_17370,1285,755,158,75,233,1.6997354497354498,29.62563046662143
Task_17371,822,901,172,77,249,0.9113082039911308,22.85513863474848
Task_17372,1941,239,121,128,249,8.0875,38.67914879912819
Task_17373,1040,821,77,62,139,1.2652068126520681,25.337410830609752
Task_17374,2388,325,146,118,264,7.325153374233129,46.099245121078106
Task_17375,828,977,181,186,367,0.8466257668711656,23.994282901724194
Task_17376,1414,765,127,45,172,1.845953002610966,31.021707124140914
Task_17377,1571,1013,114,88,202,1.54930966469428,34.92500732201987
Task_17378,1865,457,32,25,57,4.072052401746725,35.97266315685051
Task_17379,720,297,79,84,163,2.4161073825503356,19.113804627484242
Task_17380,565,650,144,70,214,0.8678955453149002,17.7339046044997
Task_17381,1454,78,128,111,239,18.40506329113924,29.846908595678666
Task_17382,680,518,160,137,297,1.3102119460500963,19.82361216028684
Task_17383,2556,981,111,20,131,2.6028513238289204,49.43192322549553
Task_17384,2089,392,134,170,304,5.315521628498728,41.85048039950906
Task_17385,2474,104,52,163,215,23.561904761904763,46.05489966363597
Task_17386,2898,599,11,194,205,4.83,54.877013437072726
Task_17387,1312,287,167,117,284,4.555555555555555,29.0463171870496
Task_17388,1088,383,68,124,192,2.8333333333333335,25.484189992511148
Task_17389,2663,710,55,28,83,3.7454289732770745,49.73842231903999
Task_17390,1908,296,10,173,183,6.424242424242424,38.051812200379494
Task_17391,1033,1019,104,142,246,1.0127450980392156,26.714495919795567
Task_17392,1503,812,111,160,271,1.848708487084871,33.73776912997086
Task_17393,2852,937,149,70,219,3.0405117270788913,54.85828775902164
Task_17394,521,793,50,71,121,0.6561712846347607,17.10054813283499
Task_17395,1915,353,150,84,234,5.409604519774011,38.45277277464663
Task_17396,2847,918,21,96,117,3.0979325353645266,54.30936121542613
Task_17397,1444,246,77,89,166,5.846153846153846,30.457564172761817
Task_17398,1890,430,140,144,284,4.385150812064965,38.69704876574858
Task_17399,1908,596,87,173,260,3.1959798994974875,39.40643437981606
Task_17400,2390,423,33,140,173,5.636792452830188,46.058954946736264
Task_17401,1534,401,140,59,199,3.81592039800995,32.13884502943725
Task_17402,2007,286,176,53,229,6.993031358885017,39.43588034691977
Task_17403,2591,309,156,59,215,8.358064516129032,48.6234544844365
Task_17404,1575,762,144,144,288,2.0642201834862384,34.77588968528331
Task_17405,787,704,51,178,229,1.1163120567375886,21.90620794245578
Task_17406,726,946,68,132,200,0.7666314677930306,21.522319082889013
Task_17407,2858,153,90,151,241,18.558441558441558,52.613052278079664
Task_17408,1833,266,36,82,118,6.865168539325842,36.191718014055475
Task_17409,766,823,122,93,215,0.9296116504854369,21.70978422133204
Task_17410,2049,232,130,102,232,8.793991416309012,40.244943282447615
Task_17411,2716,647,35,54,89,4.191358024691358,50.70359745842122
Task_17412,1073,675,133,161,294,1.5872781065088757,26.561966584637577
Task_17413,1084,772,78,26,104,1.4023285899094438,25.128355805477756
Task_17414,626,877,79,121,200,0.7129840546697038,19.79756207886104
Task_17415,719,503,16,39,55,1.4265873015873016,17.99503151175563
Task_17416,1025,939,52,47,99,1.0904255319148937,24.648729166773208
Task_17417,2550,938,116,151,267,2.7156549520766773,50.68872529937107
Task_17418,2737,545,118,88,206,5.012820512820513,51.98384167295288
Task_17419,2307,243,121,169,290,9.454918032786885,44.720587372999724
Task_17420,1690,750,30,174,204,2.2503328894806924,36.22886212024084
Task_17421,2234,290,199,94,293,7.676975945017182,43.632085543273696
Task_17422,1164,768,134,124,258,1.5136540962288687,28.076160704960174
Task_17423,2625,247,178,167,345,10.584677419354838,50.00442000486373
Task_17424,596,593,128,200,328,1.0033670033670035,18.927079020328485
Task_17425,2098,1017,70,115,185,2.06090373280943,43.38876369689126
Task_17426,2237,510,51,59,110,4.3776908023483365,42.92700582835437
Task_17427,1073,212,151,133,284,5.037558685446009,25.04032254839808
Task_17428,613,121,49,190,239,5.024590163934426,17.121611210871436
Task_17429,1594,1002,35,60,95,1.5892323030907278,34.06807244553165
Task_17430,1986,419,49,157,206,4.728571428571429,39.944203710097305
Task_17431,1135,293,134,99,233,3.860544217687075,26.005785927243483
Task_17432,1503,717,96,58,154,2.0933147632311977,32.3180560263844
Task_17433,925,829,33,86,119,1.1144578313253013,23.5216060652009
Task_17434,2141,655,25,102,127,3.263719512195122,42.44525025816497
Task_17435,2768,588,134,134,268,4.699490662139219,53.01876013481691
Task_17436,1488,431,57,183,240,3.4444444444444446,32.26340817905714
Task_17437,2828,228,64,195,259,12.34934497816594,52.862050052631126
Task_17438,2948,229,10,49,59,12.817391304347826,52.39381045984826
Task_17439,888,112,101,63,164,7.8584070796460175,20.320205703473675
Task_17440,1486,559,167,16,183,2.6535714285714285,31.4647848009166
Task_17441,2081,234,197,65,262,8.85531914893617,40.5769816582391
Task_17442,1023,409,88,21,109,2.495121951219512,23.03889609840968
Task_17443,2251,910,141,21,162,2.4709110867178925,44.574974872315295
Task_17444,834,287,107,197,304,2.8958333333333335,21.697456836728595
Task_17445,628,556,104,92,196,1.1274685816876122,18.514075595136845
Task_17446,1715,243,39,47,86,7.028688524590164,33.3031866982435
Task_17447,1734,987,94,145,239,1.7550607287449393,37.7724032049361
Task_17448,2095,785,92,155,247,2.6653944020356235,42.924796021737734
Task_17449,2486,828,34,68,102,2.9987937273823886,47.91504191984276
Task_17450,1695,505,196,25,221,3.349802371541502,34.844319664988724
Task_17451,2834,781,124,144,268,3.6240409207161126,54.69085322587282
Task_17452,1308,203,61,44,105,6.411764705882353,26.745958144803907
Task_17453,1321,927,93,109,202,1.4234913793103448,30.814038515876955
Task_17454,1276,78,43,186,229,16.151898734177216,27.11165940848962
Task_17455,892,256,28,167,195,3.470817120622568,21.9678802861674
Task_17456,1280,413,69,114,183,3.0917874396135265,28.524302265272976
Task_17457,2412,609,42,60,102,3.954098360655738,45.86190120651323
Task_17458,2127,1007,76,180,256,2.1101190476190474,44.26038800650889
Task_17459,1360,975,52,37,89,1.3934426229508197,30.003129552082367
Task_17460,1754,872,42,14,56,2.009163802978236,35.392386679928606
Task_17461,1838,156,25,50,75,11.707006369426752,34.62273202531935
Task_17462,2420,65,95,19,114,36.666666666666664,42.94800480076085
Task_17463,1601,709,89,185,274,2.2549295774647886,34.998297951517834
Task_17464,1555,159,198,12,210,9.71875,31.207771738520204
Task_17465,2099,370,109,45,154,5.657681940700809,40.39089686657644
Task_17466,2581,390,190,172,362,6.601023017902813,49.89291551647792
Task_17467,1058,517,197,120,317,2.0424710424710426,25.917221015813357
Task_17468,1583,569,43,153,196,2.7771929824561403,33.913208854898166
Task_17469,2081,593,60,81,141,3.5033670033670035,41.40632763193653
Task_17470,1143,932,174,65,239,1.22508038585209,27.855826643007394
Task_17471,780,470,135,187,322,1.6560509554140128,21.476233288351235
Task_17472,1211,289,155,64,219,4.175862068965517,26.80874462112155
Task_17473,2980,74,179,44,223,39.733333333333334,52.759237854167736
Task_17474,1429,986,141,186,327,1.447821681864235,33.34203296107717
Task_17475,2131,334,69,169,238,6.361194029850746,42.095389544944574
Task_17476,1973,876,26,110,136,2.249714937286203,40.48484171876509
Task_17477,661,564,176,155,331,1.1699115044247788,19.83271059849501
Task_17478,1004,319,104,166,270,3.1375,24.290053941638522
Task_17479,681,963,75,38,113,0.7064315352697096,19.819537134637084
Task_17480,1114,546,49,105,154,2.036563071297989,26.01144555289211
Task_17481,1050,873,128,176,304,1.2013729977116705,26.86223567313483
Task_17482,2169,954,92,181,273,2.2712041884816756,44.77989286708754
Task_17483,2604,852,173,55,228,3.052754982415006,50.65408313668095
Task_17484,1370,589,180,26,206,2.3220338983050848,29.917836072493994
Task_17485,1515,193,77,160,237,7.809278350515464,31.82483494187095
Task_17486,2915,437,157,16,173,6.655251141552512,53.64972577245975
Task_17487,2064,812,115,158,273,2.5387453874538743,42.632002401314075
Task_17488,2057,203,134,195,329,10.083333333333334,40.835871799094726
Task_17489,2362,253,131,39,170,9.299212598425196,44.341238891633225
Task_17490,1614,92,163,177,340,17.35483870967742,32.985763067071915
Task_17491,1938,625,96,123,219,3.0958466453674123,39.762421376474244
Task_17492,2829,626,178,32,210,4.511961722488039,53.1936059311189
Task_17493,1395,975,44,29,73,1.4293032786885247,30.21494249981313
Task_17494,2372,757,51,169,220,3.129287598944591,47.21471498444074
Task_17495,1354,620,10,87,97,2.180354267310789,29.358208923955203
Task_17496,2691,986,87,12,99,2.7264437689969605,51.12992145939024
Task_17497,649,989,85,194,279,0.6555555555555556,20.94748897587121
Task_17498,1796,504,95,113,208,3.5564356435643565,37.06889727336153
Task_17499,2378,159,170,158,328,14.8625,45.48145434811386
Task_17500,640,369,74,182,256,1.7297297297297298,18.69943399864934
Task_17501,755,191,24,184,208,3.9322916666666665,19.64651766720435
Task_17502,1640,190,89,27,116,8.586387434554974,32.30873551056846
Task_17503,1828,612,50,187,237,2.9820554649265905,38.24475341668937
Task_17504,501,831,192,124,316,0.6021634615384616,18.179786852075477
Task_17505,2071,206,70,31,101,10.004830917874395,38.9602892452824
Task_17506,544,180,13,191,204,3.005524861878453,15.986068087513592
Task_17507,571,841,48,24,72,0.6781472684085511,17.01920067970921
Task_17508,1311,467,169,154,323,2.801282051282051,29.84166654125023
Task_17509,2993,70,94,70,164,42.15492957746479,53.087672080784564
Task_17510,1862,156,29,140,169,11.859872611464969,36.40202364339985
Task_17511,1277,1001,44,161,205,1.2744510978043913,30.386241192116533
Task_17512,879,764,56,51,107,1.1490196078431372,22.04964227041475
Task_17513,2106,473,198,140,338,4.443037974683544,42.492257819368504
Task_17514,766,111,86,122,208,6.839285714285714,19.08253247914531
Task_17515,1937,858,11,162,173,2.2549476135040747,40.25041648151664
Task_17516,1322,657,134,47,181,2.0091185410334345,29.303534911896477
Task_17517,2089,947,173,114,287,2.2035864978902953,43.447631549436586
Task_17518,2627,371,46,17,63,7.061827956989247,47.60832689075616
Task_17519,1196,870,32,112,144,1.373134328358209,28.17637939637342
Task_17520,1730,324,174,111,285,5.323076923076923,35.77437443590021
Task_17521,2044,672,66,96,162,3.037147102526003,41.27493449147475
Task_17522,905,109,147,63,210,8.227272727272727,20.804388135434703
Task_17523,2771,731,104,194,298,3.7855191256830603,53.743691422054326
Task_17524,1734,353,108,59,167,4.898305084745763,34.99493949952738
Task_17525,1120,894,132,70,202,1.2513966480446927,27.186220754798427
Task_17526,1461,286,99,74,173,5.090592334494773,30.630030673538226
Task_17527,2469,474,133,21,154,5.197894736842105,46.540154073615156
Task_17528,1170,385,11,170,181,3.0310880829015545,26.658811709165096
Task_17529,2645,261,15,57,72,10.095419847328245,47.918068964438355
Task_17530,1609,147,103,181,284,10.871621621621621,33.147267638329296
Task_17531,2637,869,88,102,190,3.0310344827586206,51.38844999490499
Task_17532,2090,720,132,84,216,2.89875173370319,42.31584706697063
Task_17533,1639,224,74,159,233,7.2844444444444445,33.888997147369516
Task_17534,772,121,84,163,247,6.327868852459017,19.5895565296052
Task_17535,2544,400,82,128,210,6.344139650872818,48.633257411064875
Task_17536,784,83,24,111,135,9.333333333333334,18.450838629027672
Task_17537,2387,127,200,200,400,18.6484375,45.768377383065854
Task_17538,1073,549,21,164,185,1.950909090909091,25.67657411170968
Task_17539,1984,420,135,124,259,4.712589073634204,40.010245019463326
Task_17540,1142,223,128,26,154,5.098214285714286,24.760256186477218
Task_17541,1459,613,116,84,200,2.3762214983713354,31.913480308838512
Task_17542,2236,248,185,180,365,8.97991967871486,43.971341231400594
Task_17543,1646,682,70,164,234,2.4099560761346996,35.509048553771486
Task_17544,1938,343,193,117,310,5.633720930232558,39.248845414900906
Task_17545,2877,762,22,93,115,3.770642201834862,54.29145297457817
Task_17546,1591,817,120,173,293,1.9449877750611246,35.26576653235101
Task_17547,2534,791,145,32,177,3.1994949494949494,48.882609255625056
Task_17548,1900,845,107,130,237,2.2458628841607564,39.93330879390836
Task_17549,791,825,124,172,296,0.9576271186440678,22.607640504021187
Task_17550,1118,102,24,17,41,10.854368932038835,22.423151364858764
Task_17551,2956,878,131,59,190,3.3629124004550626,56.12624130707931
Task_17552,2673,588,168,83,251,4.538200339558574,51.291043628841656
Task_17553,1369,924,124,120,244,1.48,31.73936398254509
Task_17554,2271,664,199,83,282,3.4150375939849624,45.30534487341998
Task_17555,2906,159,18,173,191,18.1625,53.11551118516845
Task_17556,982,736,116,59,175,1.332428765264586,24.315838552993892
Task_17557,1773,551,37,143,180,3.2119565217391304,36.76321359139816
Task_17558,537,417,199,171,370,1.284688995215311,17.609590727355478
Task_17559,1817,319,127,193,320,5.678125,37.411419394812064
Task_17560,2655,93,10,52,62,28.24468085106383,46.834277706949216
Task_17561,2916,410,132,168,300,7.094890510948905,54.97537545204879
Task_17562,2974,972,13,198,211,3.0565262076053443,57.30629379238866
Task_17563,2024,718,196,157,353,2.8150208623087623,42.063150367465575
Task_17564,2292,778,62,199,261,2.9422336328626444,46.21093741184624
Task_17565,1377,491,39,158,197,2.798780487804878,30.41030908291612
Task_17566,680,341,56,101,157,1.9883040935672514,18.50914167822408
Task_17567,1440,874,39,95,134,1.6457142857142857,32.08870856355817
Task_17568,1208,838,56,103,159,1.4398092967818832,28.372989529193475
Task_17569,2160,738,33,163,196,2.9228687415426253,43.58780478929805
Task_17570,1927,385,87,196,283,4.992227979274611,39.16800766441907
Task_17571,2744,715,24,192,216,3.8324022346368714,52.88039438235932
Task_17572,2512,261,80,111,191,9.587786259541986,47.54780222931237
Task_17573,2697,774,22,97,119,3.48,51.49095022220984
Task_17574,2941,437,32,26,58,6.7146118721461185,52.94179261445277
Task_17575,2610,689,99,64,163,3.782608695652174,49.98276773700996
Task_17576,882,696,21,24,45,1.2654232424677188,21.064158371273784
Task_17577,2243,450,78,150,228,4.9733924611973395,44.17219737417587
Task_17578,2025,586,180,55,235,3.4497444633730834,40.676771724169654
Task_17579,759,832,79,180,259,0.9111644657863145,21.97341202609331
Task_17580,914,491,46,149,195,1.8577235772357723,23.082326591257697
Task_17581,2107,100,70,89,159,20.861386138613863,39.54528273070029
Task_17582,1521,91,165,91,256,16.532608695652176,30.911411816300333
Task_17583,2395,710,183,160,343,3.3684950773558366,47.87424824545789
Task_17584,1623,886,36,139,175,1.8297632468996619,35.39814613807729
Task_17585,837,864,127,148,275,0.9676300578034682,23.313597912208422
Task_17586,829,372,107,169,276,2.222520107238606,21.722912811594835
Task_17587,1250,640,77,85,162,1.9500780031201248,28.50448298062672
Task_17588,975,871,139,56,195,1.1181192660550459,24.725192560687123
Task_17589,2307,918,53,33,86,2.510337323177367,44.74961907249732
Task_17590,2451,682,93,166,259,3.588579795021962,48.3416546238071
Task_17591,1863,570,171,160,331,3.2626970227670755,38.95227364423231
Task_17592,2988,878,38,136,174,3.3993174061433447,56.984267559417496
Task_17593,831,468,81,188,269,1.7718550106609807,22.0931542885063
Task_17594,1767,127,114,139,253,13.8046875,35.257762658190124
Task_17595,785,428,136,121,257,1.82983682983683,21.04736033212537
Task_17596,1325,139,28,89,117,9.464285714285714,27.138742434169846
Task_17597,1248,797,43,149,192,1.5639097744360901,29.256468125642687
Task_17598,2569,882,76,135,211,2.909399773499434,50.605936430088214
Task_17599,2808,742,58,27,85,3.779273216689098,52.127853841035346
Task_17600,1921,937,104,198,302,2.0479744136460556,40.94512298684744
Task_17601,613,890,30,115,145,0.6879910213243546,19.216390905682797
Task_17602,1499,849,126,179,305,1.7635294117647058,33.95711631932588
Task_17603,1986,101,56,10,66,19.470588235294116,36.14095154542528
Task_17604,1002,442,33,74,107,2.2618510158013545,23.36679591579498
Task_17605,1922,301,22,196,218,6.364238410596027,38.53723562138003
Task_17606,936,274,36,166,202,3.403636363636364,22.77691015313464
Task_17607,963,204,161,192,353,4.697560975609756,23.67364285495019
Task_17608,1124,876,184,155,339,1.281641961231471,28.169536541594272
Task_17609,1509,1017,97,180,277,1.4823182711198428,34.49051172246727
Task_17610,1001,130,10,19,29,7.641221374045801,20.70698484860485
Task_17611,937,191,29,80,109,4.880208333333333,21.7232131558832
Task_17612,1528,485,172,143,315,3.1440329218106995,33.28166805403788
Task_17613,554,953,179,91,270,0.5807127882599581,19.10996512730576
Task_17614,2690,430,24,169,193,6.241299303944316,50.97200092782429
Task_17615,735,422,72,177,249,1.7375886524822695,20.329772278569703
Task_17616,2966,800,89,168,257,3.7028714107365794,56.806508972304016
Task_17617,2335,87,162,118,280,26.53409090909091,43.91237913745456
Task_17618,2827,737,48,25,73,3.830623306233062,52.067113353250214
Task_17619,2355,264,36,31,67,8.88679245283019,43.083133041725404
Task_17620,793,922,14,41,55,0.8591549295774648,20.65663992822104
Task_17621,652,108,129,148,277,5.981651376146789,17.65631833855655
Task_17622,2840,228,97,43,140,12.40174672489083,51.55512776858251
Task_17623,1434,302,143,93,236,4.732673267326732,30.756974386917424
Task_17624,1466,607,198,23,221,2.411184210526316,31.53486679984492
Task_17625,1081,135,39,179,218,7.948529411764706,24.36849710526792
Task_17626,2056,221,55,23,78,9.26126126126126,38.20251394803389
Task_17627,2503,983,71,131,202,2.5436991869918697,49.82194274471383
Task_17628,1265,532,50,105,155,2.373358348968105,28.396190801819305
Task_17629,2952,532,17,80,97,5.538461538461538,54.35710190057088
Task_17630,2508,682,116,31,147,3.67203513909224,47.910698174045685
Task_17631,2502,77,89,82,171,32.07692307692308,45.59460071412686
Task_17632,2352,680,64,109,173,3.4537444933920707,46.295801219912555
Task_17633,1231,702,95,99,194,1.7510668563300142,28.640774523768442
Task_17634,955,408,139,34,173,2.334963325183374,22.641059289178127
Task_17635,2373,419,135,124,259,5.65,46.16302888939726
Task_17636,2514,779,131,171,302,3.223076923076923,49.807747750403905
Task_17637,1218,652,132,26,158,1.8652373660030628,27.37585480625236
Task_17638,2612,863,170,173,343,3.0231481481481484,51.811505165239986
Task_17639,2764,552,106,28,134,4.998191681735985,51.431832137128374
Task_17640,1175,762,118,145,263,1.5399737876802098,28.28510340987236
Task_17641,2697,959,200,62,262,2.809375,52.610763660770466
Task_17642,2298,1004,111,188,299,2.2865671641791043,47.099505461715374
Task_17643,1110,802,28,32,60,1.3823163138231631,25.08780180323626
Task_17644,548,1015,16,14,30,0.5393700787401575,16.675853051964946
Task_17645,1460,374,30,132,162,3.8933333333333335,31.017807394092554
Task_17646,2479,729,158,175,333,3.3958904109589043,49.24164083736656
Task_17647,1161,694,174,178,352,1.6705035971223021,28.330637986110844
Task_17648,1995,439,188,19,207,4.534090909090909,39.28671538110722
Task_17649,2398,187,21,97,118,12.75531914893617,44.70294044283318
Task_17650,1412,585,125,103,228,2.409556313993174,31.309943078800725
Task_17651,2196,809,62,98,160,2.7111111111111112,43.995791070127844
Task_17652,1474,457,117,195,312,3.2183406113537116,32.40050179426431
Task_17653,1994,647,90,166,256,3.0771604938271606,40.93513514200057
Task_17654,912,1012,157,185,342,0.9002961500493584,25.32986299511742
Task_17655,1503,578,17,181,198,2.5958549222797926,32.666329652285036
Task_17656,1636,633,132,166,298,2.580441640378549,35.415980638464
Task_17657,1961,748,182,120,302,2.618157543391188,40.87505959589907
Task_17658,1892,929,134,199,333,2.0344086021505374,40.60189767597688
Task_17659,2383,489,58,108,166,4.863265306122449,46.142007636957196
Task_17660,1962,891,137,60,197,2.1995515695067263,40.45238631721457
Task_17661,1889,445,136,122,258,4.23542600896861,38.580241345128584
Task_17662,2204,669,60,118,178,3.28955223880597,43.95795877891941
Task_17663,1217,542,189,133,322,2.241252302025783,28.554749938184646
Task_17664,1994,624,125,110,235,3.1904,40.69153517903199
Task_17665,2549,399,189,174,363,6.3725,49.424022561705975
Task_17666,2504,848,41,44,85,2.949352179034158,47.72247612298606
Task_17667,889,904,40,190,230,0.9823204419889503,24.0596604256954
Task_17668,1539,517,104,92,196,2.971042471042471,32.89439803330369
Task_17669,2816,632,132,165,297,4.448657187993681,54.095589326253595
Task_17670,2062,748,175,99,274,2.753004005340454,42.31212552796336
Task_17671,1598,401,33,156,189,3.9751243781094527,33.57504262353962
Task_17672,2930,990,79,72,151,2.9566094853683147,55.93365004418167
Task_17673,1817,442,23,52,75,4.10158013544018,35.442186379557995
Task_17674,2807,881,199,53,252,3.1825396825396823,54.119638126561945
Task_17675,1337,444,169,41,210,3.004494382022472,28.99356138597786
Task_17676,1692,1014,186,23,209,1.6669950738916257,36.32799942801237
Task_17677,1746,804,92,29,121,2.1689440993788818,35.946817236642936
Task_17678,1015,843,25,198,223,1.20260663507109,25.854389482918695
Task_17679,2078,542,141,51,192,3.826887661141805,41.167555561210285
Task_17680,717,586,88,128,216,1.221465076660988,20.16938479533897
Task_17681,502,599,193,144,337,0.8366666666666667,17.463882360986883
Task_17682,2431,322,184,154,338,7.526315789473684,47.155246096699706
Task_17683,1457,865,131,120,251,1.6824480369515011,33.01149379520634
Task_17684,1793,985,11,17,28,1.8184584178498986,36.112645318741826
Task_17685,2046,889,66,78,144,2.298876404494382,41.77829353801979
Task_17686,2730,412,100,47,147,6.610169491525424,50.56478769613411
Task_17687,976,403,137,65,202,2.4158415841584158,23.399329253360463
Task_17688,2064,658,50,44,94,3.1320182094081943,40.19338745878088
Task_17689,1147,544,84,101,185,2.1045871559633027,26.76481091531656
Task_17690,1579,314,111,131,242,5.012698412698413,33.188742359879065
Task_17691,532,595,30,28,58,0.8926174496644296,15.50768143273487
Task_17692,1825,65,59,96,155,27.651515151515152,34.85889066065554
Task_17693,2941,415,96,91,187,7.069711538461538,54.703014872890854
Task_17694,2283,916,22,140,162,2.489640130861505,45.75208418428622
Task_17695,2776,434,113,85,198,6.381609195402299,52.1812152146758
Task_17696,1181,761,79,12,91,1.5498687664041995,26.477105775634254
Task_17697,1430,539,151,83,234,2.6481481481481484,31.37605932440024
Task_17698,2690,537,167,100,267,5.0,51.56553778717588
Task_17699,2113,650,145,39,184,3.2457757296466974,41.794227527084736
Task_17700,1954,629,102,120,222,3.1015873015873017,40.029866889110515
Task_17701,2368,832,154,180,334,2.8427370948379354,47.81818846909287
Task_17702,1880,640,157,70,227,2.932917316692668,38.56401991311832
Task_17703,1883,1015,107,34,141,1.8533464566929134,38.97368869878949
Task_17704,2447,751,38,61,99,3.2539893617021276,46.8237458504074
Task_17705,2156,353,142,187,329,6.090395480225989,42.91874113387337
Task_17706,819,272,189,173,362,3.0,21.637971995703225
Task_17707,1968,606,124,35,159,3.242174629324547,39.147022155292824
Task_17708,1382,498,11,128,139,2.7695390781563125,29.95777576863964
Task_17709,698,271,130,36,166,2.5661764705882355,18.136720134575828
Task_17710,1494,589,93,91,184,2.5322033898305083,32.35437155685592
Task_17711,2915,965,88,187,275,3.0175983436853,56.60454089986974
Task_17712,1122,869,22,73,95,1.289655172413793,26.380972546098352
Task_17713,2345,537,125,180,305,4.358736059479554,46.39151817557107
Task_17714,2696,798,181,128,309,3.3742177722152693,52.719341729472525
Task_17715,1306,1023,150,42,192,1.275390625,30.23526067498877
Task_17716,1544,931,150,138,288,1.6566523605150214,34.78808737341381
Task_17717,2849,209,77,106,183,13.566666666666666,52.60345350221697
Task_17718,1975,614,200,194,394,3.2113821138211383,41.198816893674824
Task_17719,2466,203,152,131,283,12.088235294117647,46.99103679960593
Task_17720,2122,211,179,39,218,10.00943396226415,40.65260951867374
Task_17721,1479,969,194,116,310,1.524742268041237,33.91356179950353
Task_17722,1970,676,62,65,127,2.909896602658789,39.648756830051504
Task_17723,2738,948,168,16,184,2.8851422550052686,52.52218041276874
Task_17724,1108,274,185,162,347,4.029090909090909,26.12853059065524
Task_17725,1252,903,190,185,375,1.3849557522123894,30.49488635599945
Task_17726,572,463,56,181,237,1.2327586206896552,17.780831519643087
Task_17727,2401,997,78,157,235,2.405811623246493,48.44301366806028
Task_17728,1875,82,107,191,298,22.59036144578313,36.844415550871034
Task_17729,1351,529,138,190,328,2.549056603773585,30.74613316407458
Task_17730,668,812,101,19,120,0.8216482164821648,18.821548695323983
Task_17731,1499,387,29,21,50,3.86340206185567,29.850872075071248
Task_17732,2795,377,176,72,248,7.394179894179894,52.35411460196638
Task_17733,2240,175,187,72,259,12.727272727272727,42.69333129308368
Task_17734,1419,469,106,33,139,3.019148936170213,29.890298781699304
Task_17735,2126,280,134,130,264,7.565836298932385,41.8186056086125
Task_17736,734,283,76,19,95,2.584507042253521,17.94711282409269
Task_17737,2559,818,21,145,166,3.1245421245421245,49.94280800126342
Task_17738,1814,267,115,77,192,6.768656716417911,36.27163775981243
Task_17739,1925,408,168,59,227,4.706601466992665,38.47489151946014
Task_17740,2016,174,79,129,208,11.52,39.283324036581725
Task_17741,763,404,195,17,212,1.8839506172839506,19.687454811487246
Task_17742,948,270,173,68,241,3.4981549815498156,22.694685751023446
Task_17743,2390,787,31,39,70,3.032994923857868,45.33083354430093
Task_17744,960,917,189,29,218,1.0457516339869282,24.530032782410288
Task_17745,625,337,60,18,78,1.849112426035503,15.899824460520174
Task_17746,768,86,36,170,206,8.827586206896552,19.068167714613896
Task_17747,1684,1004,167,57,224,1.6756218905472637,36.531707920922386
Task_17748,2325,904,127,151,278,2.569060773480663,47.066922588955066
Task_17749,1035,350,162,196,358,2.948717948717949,25.320709432653057
Task_17750,751,797,99,78,177,0.9411027568922306,21.120644837588205
Task_17751,578,345,108,117,225,1.670520231213873,17.34749792924148
Task_17752,2769,502,51,46,97,5.504970178926441,50.88493827751617
Task_17753,1749,606,164,62,226,2.8813838550247115,36.32383937015375
Task_17754,2738,1021,133,90,223,2.679060665362035,53.607296994457194
Task_17755,1253,118,174,44,218,10.529411764705882,26.218007110859904
Task_17756,2679,844,80,141,221,3.1704142011834318,52.270090547077395
Task_17757,511,988,137,124,261,0.5166835187057633,18.633225681757782
Task_17758,2882,242,59,146,205,11.860082304526749,53.453846371908774
Task_17759,2507,722,115,57,172,3.467496542185339,48.424001753789575
Task_17760,943,455,177,120,297,2.067982456140351,23.811782329071733
Task_17761,675,504,162,183,345,1.3366336633663367,19.984596764546364
Task_17762,1481,416,150,191,341,3.551558752997602,32.50504339660919
Task_17763,1164,780,195,138,333,1.4903969270166453,28.471984660044143
Task_17764,1539,456,169,103,272,3.3676148796498904,33.11101097293416
Task_17765,2281,781,118,132,250,2.9168797953964196,45.83115610036543
Task_17766,2596,650,138,144,282,3.9877112135176653,50.570004743801086
Task_17767,721,831,86,48,134,0.8665865384615384,20.077093137462033
Task_17768,2021,109,197,41,238,18.37272727272727,38.26211462046317
Task_17769,703,788,113,53,166,0.8910012674271229,20.19656638743034
Task_17770,1729,222,71,52,123,7.753363228699552,34.11388118874569
Task_17771,1987,618,38,41,79,3.210016155088853,38.60387096995185
Task_17772,2760,734,10,76,86,3.7551020408163267,51.81700451753565
Task_17773,818,579,154,113,267,1.410344827586207,22.02129511340892
Task_17774,1033,174,157,35,192,5.902857142857143,23.047350573050835
Task_17775,1803,304,16,61,77,5.911475409836066,34.8041681989523
Task_17776,2033,349,67,33,100,5.808571428571429,38.82788479398271
Task_17777,822,564,200,144,344,1.454867256637168,22.430438735105678
Task_17778,2751,408,133,168,301,6.726161369193154,52.362179699945955
Task_17779,2077,687,110,52,162,3.0188953488372094,41.46165050579222
Task_17780,809,797,116,43,159,1.0137844611528821,21.352714781342623
Task_17781,1123,144,133,193,326,7.744827586206896,25.663442442838704
Task_17782,2853,754,147,75,222,3.7788079470198674,54.42180100579507
Task_17783,2691,559,136,132,268,4.805357142857143,51.70354047993167
Task_17784,2328,352,119,199,318,6.594900849858357,45.60413237010829
Task_17785,2473,149,69,24,93,16.486666666666668,44.779809089241326
Task_17786,653,988,54,152,206,0.660262891809909,20.646947257369394
Task_17787,577,302,162,140,302,1.9042904290429044,17.58989691474369
Task_17788,2813,276,92,48,140,10.155234657039712,51.42168856798074
Task_17789,1232,997,136,39,175,1.2344689378757514,28.889098416974104
Task_17790,1286,390,179,162,341,3.289002557544757,29.293464303467303
Task_17791,973,751,47,198,245,1.2938829787234043,25.058386361626507
Task_17792,940,153,191,124,315,6.103896103896104,22.674908479621333
Task_17793,943,860,161,20,181,1.0952380952380953,23.83975532345467
Task_17794,1853,337,182,102,284,5.482248520710059,37.74526982371465
Task_17795,664,736,112,131,243,0.9009497964721845,20.02170742709266
Task_17796,2383,464,91,188,279,5.124731182795699,46.651625156370926
Task_17797,618,456,44,53,97,1.3522975929978118,16.941509464592745
Task_17798,653,895,157,179,336,0.7287946428571429,20.87845697140921
Task_17799,1725,670,97,107,204,2.570789865871833,36.43925179152779
Task_17800,2046,703,161,116,277,2.90625,41.96192458764476
Task_17801,1388,984,140,63,203,1.4091370558375635,31.705562766764146
Task_17802,2747,897,28,125,153,3.0590200445434297,52.8956841471809
Task_17803,564,996,170,139,309,0.5656970912738215,19.645311755882094
Task_17804,2816,541,17,81,98,5.195571955719557,52.239430498875315
Task_17805,1958,327,45,146,191,5.969512195121951,39.04586769716839
Task_17806,1313,777,190,197,387,1.6876606683804627,31.18236962528252
Task_17807,814,918,174,113,287,0.8857453754080522,23.12536043705703
Task_17808,970,786,29,53,82,1.2325285895806861,23.432208846558847
Task_17809,1976,846,33,118,151,2.332939787485242,40.5386759985885
Task_17810,552,861,23,185,208,0.6403712296983759,18.648154014763943
Task_17811,2306,117,144,184,328,19.54237288135593,44.04998175857826
Task_17812,2045,1003,119,108,227,2.0368525896414345,42.6452995999215
Task_17813,1287,442,151,76,227,2.905191873589165,28.663776755158782
Task_17814,2049,604,76,200,276,3.386776859504132,41.883050985425065
Task_17815,2234,536,97,49,146,4.160148975791434,43.22428044617211
Task_17816,2273,816,89,192,281,2.782129742962056,46.020662537563574
Task_17817,1673,549,41,146,187,3.041818181818182,35.20692297359601
Task_17818,2881,623,149,110,259,4.61698717948718,54.84444739172136
Task_17819,731,986,122,157,279,0.7406281661600811,22.038394321702032
Task_17820,1966,930,96,111,207,2.111707841031149,41.088405445307636
Task_17821,1535,806,187,140,327,1.902106567534077,34.449162277790386
Task_17822,2404,74,185,118,303,32.053333333333335,45.031880882360404
Task_17823,1932,82,36,144,180,23.27710843373494,37.086336849773204
Task_17824,889,563,59,55,114,1.576241134751773,21.683285931231552
Task_17825,2650,289,168,138,306,9.137931034482758,50.334649244860564
Task_17826,959,967,189,77,266,0.9907024793388429,25.296919313418258
Task_17827,2780,83,99,163,262,33.095238095238095,50.83677015477019
Task_17828,2034,702,119,73,192,2.8933143669985775,41.09074362236476
Task_17829,1926,814,12,160,172,2.36319018404908,39.93521493919354
Task_17830,2457,836,142,104,246,2.935483870967742,48.73278652618052
Task_17831,640,810,34,69,103,0.7891491985203453,18.63491458076178
Task_17832,1337,180,170,149,319,7.386740331491713,29.04702149520173
Task_17833,2312,652,142,127,269,3.540581929555896,45.994655988798684
Task_17834,1573,594,135,132,267,2.6436974789915966,34.10612852811184
Task_17835,1992,945,29,193,222,2.105708245243129,41.729641648666
Task_17836,2215,689,78,28,106,3.210144927536232,42.81521240296394
Task_17837,772,685,33,199,232,1.1253644314868805,21.55709811011133
Task_17838,2532,1016,105,139,244,2.489675516224189,50.525383835951686
Task_17839,714,774,123,85,208,0.9212903225806451,20.635883626083185
Task_17840,2510,604,138,49,187,4.148760330578512,48.05986625659506
Task_17841,2479,102,60,51,111,24.067961165048544,44.55526616065243
Task_17842,2684,125,139,61,200,21.3015873015873,48.97537619015278
Task_17843,800,642,73,166,239,1.244167962674961,21.92523992900206
Task_17844,2713,850,164,153,317,3.188014101057579,53.22456708768194
Task_17845,1649,918,146,133,279,1.794341675734494,36.37706308438154
Task_17846,2863,569,191,143,334,5.02280701754386,54.77285928225651
Task_17847,1973,747,177,115,292,2.6377005347593583,41.009629574978696
Task_17848,509,640,137,108,245,0.7940717628705148,17.264795012961425
Task_17849,666,887,118,44,162,0.75,19.483592219996954
Task_17850,2744,633,148,44,192,4.3280757097791795,51.78875426121859
Task_17851,548,667,146,14,160,0.8203592814371258,16.818338825755454
Task_17852,559,414,185,171,356,1.346987951807229,17.899550096947124
Task_17853,2927,278,102,187,289,10.491039426523297,54.66871220195102
Task_17854,678,1001,147,46,193,0.6766467065868264,20.517506184003533
Task_17855,1539,973,131,195,326,1.5800821355236139,35.06467761857598
Task_17856,2063,836,191,195,386,2.4647550776583036,43.2546517556819
Task_17857,1019,1022,53,120,173,0.9960899315738025,26.176231820923352
Task_17858,1208,910,152,163,315,1.3260153677277717,29.523717581830926
Task_17859,1787,755,131,165,296,2.363756613756614,38.179393712509444
Task_17860,2979,615,98,72,170,4.836038961038961,55.66035382074892
Task_17861,709,940,38,144,182,0.7534537725823592,21.04368179704965
Task_17862,2261,224,147,170,317,10.04888888888889,44.04627150080122
Task_17863,2693,376,169,78,247,7.143236074270557,50.8388982879348
Task_17864,995,898,12,140,152,1.10678531701891,25.0451147098546
Task_17865,2351,460,95,165,260,5.099783080260304,46.02371169442423
Task_17866,2727,804,175,81,256,3.387577639751553,52.81742729822333
Task_17867,2294,965,132,41,173,2.3747412008281574,45.60102372311553
Task_17868,2590,928,72,160,232,2.7879440258342303,51.206732626486335
Task_17869,2634,361,85,64,149,7.276243093922652,49.18944684651248
Task_17870,2403,92,166,113,279,25.838709677419356,44.99916702375591
Task_17871,2728,108,88,87,175,25.027522935779817,49.531572694183886
Task_17872,2783,416,176,197,373,6.6738609112709835,53.2622351864753
Task_17873,843,612,136,108,244,1.3752039151712887,22.40891497597603
Task_17874,2530,717,49,27,76,3.5236768802228413,47.352693403516405
Task_17875,2888,385,30,181,211,7.481865284974093,54.0693727199996
Task_17876,1928,987,114,61,175,1.951417004048583,40.089244137982696
Task_17877,2548,81,190,50,240,31.073170731707318,46.21307078165636
Task_17878,1354,795,125,175,300,1.7010050251256281,31.463526421979612
Task_17879,2292,523,162,10,172,4.374045801526718,44.068249449452416
Task_17880,2151,505,142,50,192,4.25098814229249,42.08824385660446
Task_17881,2342,525,71,14,85,4.452471482889734,44.08477160380621
Task_17882,519,285,168,190,358,1.8146853146853146,16.944675205550006
Task_17883,952,380,105,77,182,2.4986876640419946,22.934263976829115
Task_17884,2267,378,16,74,90,5.981530343007916,42.93428142211258
Task_17885,1087,826,16,129,145,1.3143893591293834,26.327033507626314
Task_17886,1665,142,23,90,113,11.643356643356643,32.500000679064065
Task_17887,1268,733,117,171,288,1.7275204359673024,29.848285263975622
Task_17888,1268,1018,190,23,213,1.2443572129538762,29.650269106691443
Task_17889,1799,194,130,60,190,9.225641025641025,35.60110666785199
Task_17890,1531,920,150,100,250,1.6623235613463627,34.32097959810579
Task_17891,1753,510,133,198,331,3.4305283757338554,37.07590439787403
Task_17892,1772,213,181,151,332,8.280373831775702,36.323144497160165
Task_17893,2096,707,56,86,142,2.9604519774011298,42.015440214022725
Task_17894,2501,517,58,40,98,4.828185328185328,46.61345032867653
Task_17895,1119,462,73,69,142,2.4168466522678185,25.555125490668527
Task_17896,970,208,135,135,270,4.641148325358851,23.340229437747848
Task_17897,2348,801,97,117,214,2.9276807980049875,46.77875127637454
Task_17898,1805,211,18,133,151,8.514150943396226,35.77142001433601
Task_17899,2483,312,120,80,200,7.932907348242812,47.113080467253035
Task_17900,2968,719,167,15,182,4.122222222222222,55.436386476941266
Task_17901,2470,550,110,34,144,4.482758620689655,46.84742499554628
Task_17902,1390,709,171,164,335,1.9577464788732395,31.921105323437093
Task_17903,1268,941,134,140,274,1.346072186836518,30.352001170796868
Task_17904,2587,552,162,120,282,4.678119349005425,50.07979558089598
Task_17905,1492,334,148,106,254,4.453731343283582,31.89642786612259
Task_17906,1633,754,149,116,265,2.1629139072847683,35.5250654303883
Task_17907,1567,768,102,34,136,2.037711313394018,33.15213934630386
Task_17908,2005,863,188,40,228,2.3206018518518516,40.96944159746088
Task_17909,2836,520,181,188,369,5.4433781190019195,54.41095925189982
Task_17910,907,111,54,60,114,8.098214285714286,20.071900759507344
Task_17911,1971,744,195,177,372,2.6456375838926176,41.420003806657185
Task_17912,2804,516,23,108,131,5.423597678916828,52.54120191803946
Task_17913,1933,501,180,192,372,3.850597609561753,40.072905049229576
Task_17914,1707,330,131,36,167,5.157099697885196,34.26330386180171
Task_17915,730,999,180,86,266,0.73,21.916444072137665
Task_17916,2278,464,155,49,204,4.898924731182795,44.02740904033809
Task_17917,1638,990,119,150,269,1.6528758829465187,36.39265451606047
Task_17918,2802,660,155,157,312,4.2390317700453854,54.01880192200834
Task_17919,1181,331,125,77,202,3.5572289156626504,26.524930263252955
Task_17920,1620,113,42,73,115,14.210526315789474,31.44395901162593
Task_17921,2033,640,96,180,276,3.171606864274571,41.65478245108245
Task_17922,657,252,34,124,158,2.5968379446640317,17.851387063775842
Task_17923,2309,407,81,59,140,5.659313725490196,44.09302556108505
Task_17924,2317,809,90,64,154,2.860493827160494,45.51113250642856
Task_17925,2601,579,23,10,33,4.48448275862069,47.67949017468197
Task_17926,2074,649,193,74,267,3.190769230769231,41.95051645919393
Task_17927,2937,827,79,168,247,3.5471014492753623,56.46794871039037
Task_17928,844,317,93,30,123,2.6540880503144653,20.242280916605324
Task_17929,883,629,45,191,236,1.4015873015873015,23.213314659234882
Task_17930,1286,548,66,186,252,2.3424408014571947,29.50575546076183
Task_17931,1824,165,191,144,335,10.987951807228916,36.774581267575776
Task_17932,533,764,170,93,263,0.6967320261437908,18.149765998087997
Task_17933,550,413,174,76,250,1.328502415458937,16.979255416272988
Task_17934,982,841,63,137,200,1.166270783847981,25.207661668663402
Task_17935,2246,573,52,131,183,3.912891986062718,44.35140392863182
Task_17936,676,345,97,191,288,1.953757225433526,19.311131765757498
Task_17937,532,827,52,44,96,0.642512077294686,16.87965769093034
Task_17938,2978,720,94,191,285,4.130374479889043,56.93533555941446
Task_17939,794,384,100,112,212,2.0623376623376624,20.83513450171416
Task_17940,1756,313,55,44,99,5.592356687898089,34.13200605601393
Task_17941,640,589,23,187,210,1.0847457627118644,19.014252786799155
Task_17942,3000,177,110,62,172,16.853932584269664,54.13395272287025
Task_17943,1470,484,134,112,246,3.0309278350515463,32.003902162173034
Task_17944,1849,67,184,17,201,27.191176470588236,34.74498189568776
Task_17945,2819,236,25,87,112,11.89451476793249,51.56846659244692
Task_17946,2819,480,84,60,144,5.860706860706861,52.41080570311798
Task_17947,2326,993,194,190,384,2.3400402414486923,47.89502387331492
Task_17948,601,803,167,20,187,0.7475124378109452,18.317961246353686
Task_17949,943,883,131,40,171,1.0667420814479638,23.9196736061256
Task_17950,1701,846,15,170,185,2.0082644628099175,36.56158508044381
Task_17951,718,79,160,86,246,8.975,18.17093723950558
Task_17952,832,346,21,58,79,2.397694524495677,19.66091885164001
Task_17953,842,920,19,95,114,0.9142236699239956,22.468977165571914
Task_17954,2895,709,137,22,159,4.077464788732394,54.083800757715046
Task_17955,1932,446,186,82,268,4.322147651006712,39.17932709785247
Task_17956,1647,300,192,98,290,5.471760797342193,34.39261357393317
Task_17957,917,710,191,99,290,1.289732770745429,24.06638751988559
Task_17958,2114,157,153,47,200,13.379746835443038,40.03570864529369
Task_17959,2239,182,100,176,276,12.234972677595628,43.27889466458032
Task_17960,616,212,143,136,279,2.892018779342723,17.806678550241152
Task_17961,2567,619,73,180,253,4.140322580645162,49.994253700656465
Task_17962,1290,980,122,40,162,1.3149847094801224,29.612533342423347
Task_17963,1129,272,14,34,48,4.135531135531136,23.66448167089493
Task_17964,1428,113,102,148,250,12.526315789473685,29.781155188635235
Task_17965,769,871,45,177,222,0.8818807339449541,22.048900031258853
Task_17966,1982,545,10,164,174,3.63003663003663,39.993673752453915
Task_17967,1323,570,17,158,175,2.316987740805604,29.631275889383428
Task_17968,2043,790,122,159,281,2.5828065739570163,42.268053355577045
Task_17969,1546,155,77,46,123,9.91025641025641,30.38850340195353
Task_17970,1768,943,33,132,165,1.8728813559322033,37.805358523056384
Task_17971,1264,616,51,138,189,2.048622366288493,29.033894828300458
Task_17972,2254,554,190,125,315,4.0612612612612615,44.969418122855984
Task_17973,1668,874,136,199,335,1.9062857142857144,36.890519213532336
Task_17974,2993,399,132,29,161,7.4825,54.72835035909218
Task_17975,1204,973,144,174,318,1.2361396303901437,29.66750209812155
Task_17976,719,934,116,19,135,0.7689839572192514,20.262569436129972
Task_17977,2283,477,26,51,77,4.7761506276150625,42.90643645758055
Task_17978,2160,831,141,165,306,2.5961538461538463,44.371352396587874
Task_17979,2615,615,161,109,270,4.24512987012987,50.654313056271995
Task_17980,2828,79,181,86,267,35.35,51.320772419661154
Task_17981,1871,120,33,18,51,15.462809917355372,34.52517509547325
Task_17982,1927,81,148,34,182,23.5,36.17791101142988
Task_17983,1970,927,94,182,276,2.122844827586207,41.56012678032443
Task_17984,1990,677,161,176,337,2.9351032448377583,41.3515716992654
Task_17985,2711,514,188,127,315,5.264077669902913,52.079681710382225
Task_17986,1412,110,178,60,238,12.72072072072072,28.919994438132182
Task_17987,1228,114,45,149,194,10.678260869565218,26.375067481413613
Task_17988,699,418,178,198,376,1.668257756563246,20.290740487360335
Task_17989,1203,533,164,171,335,2.252808988764045,28.419106280322172
Task_17990,1779,138,92,122,214,12.798561151079136,35.32688133281507
Task_17991,967,413,168,116,284,2.3357487922705316,23.994649336515447
Task_17992,1477,713,35,23,58,2.0686274509803924,30.625367432100703
Task_17993,1310,460,86,152,238,2.841648590021692,29.37787705158408
Task_17994,2869,703,131,24,155,4.075284090909091,53.64226897216583
Task_17995,1034,294,128,160,288,3.5050847457627117,24.755595624158502
Task_17996,1522,94,121,36,157,16.021052631578947,29.612290325957577
Task_17997,1421,993,102,24,126,1.4295774647887325,31.430007758168845
Task_17998,2786,724,17,83,100,3.842758620689655,52.43401774025768
Task_17999,2216,523,195,89,284,4.229007633587786,44.03359049989752
Task_18000,1187,1003,164,53,217,1.1822709163346614,28.667297012603047
Task_18001,1364,214,108,48,156,6.344186046511628,28.316817547231327
Task_18002,1212,722,154,82,236,1.6763485477178424,28.495028008955355
Task_18003,1190,845,43,83,126,1.4066193853427895,27.965427230308112
Task_18004,2627,918,88,195,283,2.8585418933623505,51.94180510081565
Task_18005,2468,844,175,190,365,2.9207100591715975,49.59452130269267
Task_18006,907,421,159,20,179,2.1492890995260665,21.876544640926003
Task_18007,2339,325,33,72,105,7.174846625766871,44.04867037679438
Task_18008,1187,366,86,88,174,3.23433242506812,26.67912859882796
Task_18009,2310,1017,168,195,363,2.269155206286837,47.62882706455264
Task_18010,603,514,87,150,237,1.170873786407767,18.270336007768147
Task_18011,1183,463,176,44,220,2.5495689655172415,26.658342686538873
Task_18012,926,1009,38,73,111,0.9168316831683169,24.0182062489652
Task_18013,2089,924,64,191,255,2.2583783783783784,43.414948954363105
Task_18014,1273,957,33,183,216,1.3288100208768268,30.27554533255888
Task_18015,2972,898,28,117,145,3.305895439377086,56.460914048916955
Task_18016,1834,425,90,95,185,4.305164319248826,37.26045457381865
Task_18017,759,96,110,41,151,7.824742268041237,17.587516644522
Task_18018,1522,659,97,131,228,2.306060606060606,33.33279845647111
Task_18019,1211,794,11,162,173,1.5232704402515724,28.510871463644662
Task_18020,2614,681,73,31,104,3.832844574780059,49.124331371718846
Task_18021,1346,747,129,189,318,1.7994652406417113,31.30252920974588
Task_18022,1528,984,60,53,113,1.551269035532995,33.15229321516204
Task_18023,2195,454,16,68,84,4.824175824175824,41.91629592796277
Task_18024,1597,993,21,106,127,1.6066398390342052,34.869029016257876
Task_18025,1116,998,176,56,232,1.117117117117117,27.519200745720237
Task_18026,1291,636,107,37,144,2.0266875981161694,28.458472913304885
Task_18027,2779,782,87,18,105,3.549169859514687,51.961198687901835
Task_18028,2197,672,146,167,313,3.264487369985141,44.49323970397429
Task_18029,987,942,13,31,44,1.0466595970307528,23.58681036471839
Task_18030,2654,761,116,41,157,3.4829396325459316,50.47553704354109
Task_18031,2468,521,152,71,223,4.727969348659004,47.5161138629226
Task_18032,2915,75,197,118,315,38.35526315789474,53.05542942468654
Task_18033,848,607,64,114,178,1.394736842105263,22.23266541026476
Task_18034,794,983,89,17,106,0.806910569105691,21.238388018520734
Task_18035,2081,964,68,22,90,2.1564766839378238,41.4081559137968
Task_18036,836,222,171,11,182,3.7488789237668163,20.102409476279643
Task_18037,1218,891,150,93,243,1.3654708520179373,29.179746046848987
Task_18038,2213,323,96,66,162,6.830246913580247,42.43419015289781
Task_18039,2554,435,31,109,140,5.8577981651376145,48.32434278833342
Task_18040,1139,734,101,13,114,1.5496598639455783,25.89281904882125
Task_18041,2865,491,145,144,289,5.823170731707317,54.35074754297968
Task_18042,2380,406,150,33,183,5.847665847665848,45.227340185783696
Task_18043,1120,106,175,133,308,10.467289719626168,25.116425457144246
Task_18044,1512,293,173,26,199,5.142857142857143,31.18405935795081
Task_18045,2338,824,144,130,274,2.833939393939394,46.97412142231841
Task_18046,2547,81,63,128,191,31.0609756097561,46.848920784716704
Task_18047,966,654,50,97,147,1.4748091603053435,24.020801045916055
Task_18048,1549,905,106,118,224,1.7097130242825607,34.46883431145517
Task_18049,2540,320,35,124,159,7.912772585669782,47.85058084877869
Task_18050,1463,600,118,34,152,2.4342762063227954,31.068865033472367
Task_18051,1587,124,109,190,299,12.696,32.676046463040876
Task_18052,991,294,114,70,184,3.359322033898305,23.162085349016035
Task_18053,1261,652,169,158,327,1.9310872894333844,29.655075803871682
Task_18054,1403,660,133,176,309,2.122541603630862,31.87443754733279
Task_18055,910,733,159,153,312,1.2397820163487738,24.20785940290537
Task_18056,1904,961,161,112,273,1.9792099792099793,40.49357672017978
Task_18057,1853,407,64,69,133,4.541666666666667,37.000219481705905
Task_18058,1821,954,115,153,268,1.9068062827225132,39.1941450547799
Task_18059,1486,142,29,81,110,10.391608391608392,29.57483058938448
Task_18060,1125,218,184,189,373,5.136986301369863,26.365293115615383
Task_18061,1414,810,199,23,222,1.7435265104808877,31.33867038452897
Task_18062,2511,581,103,47,150,4.314432989690721,47.63612893261168
Task_18063,1725,250,92,158,250,6.872509960159363,35.36189309876217
Task_18064,600,632,31,186,217,0.9478672985781991,18.57451669962721
Task_18065,676,200,144,189,333,3.36318407960199,19.03519561852779
Task_18066,2072,314,156,178,334,6.5777777777777775,41.46799498363864
Task_18067,2033,439,173,52,225,4.620454545454545,40.32885409907169
Task_18068,1953,1023,96,175,271,1.9072265625,41.55369395347538
Task_18069,1011,742,40,175,215,1.360699865410498,25.444946905183105
Task_18070,1100,505,146,99,245,2.1739130434782608,26.183220848683344
Task_18071,1834,638,153,119,272,2.8701095461658843,38.38154506440312
Task_18072,2866,336,166,173,339,8.504451038575668,54.115566945729846
Task_18073,2667,870,157,121,278,3.0619977037887485,52.335687950128886
Task_18074,851,120,109,70,179,7.033057851239669,19.981674104263842
Task_18075,2284,234,82,112,194,9.719148936170212,43.84970918317058
Task_18076,1639,238,87,130,217,6.857740585774058,33.723853149339384
Task_18077,2214,732,62,16,78,3.020463847203274,42.303339614572664
Task_18078,1854,445,151,172,323,4.15695067264574,38.39253413376171
Task_18079,704,992,145,104,249,0.7089627391742196,21.5194225118852
Task_18080,2529,554,24,65,89,4.556756756756757,47.56985182412038
Task_18081,800,390,181,133,314,2.0460358056265986,21.43952507167167
Task_18082,673,664,21,181,202,1.0120300751879698,19.697645361135653
Task_18083,1529,384,140,116,256,3.9714285714285715,32.66838887606567
Task_18084,696,280,75,69,144,2.4768683274021353,18.300085239584224
Task_18085,1163,629,25,176,201,1.8460317460317461,27.47527330423617
Task_18086,1814,723,192,154,346,2.505524861878453,38.716271066884154
Task_18087,2295,510,24,47,71,4.4911937377690805,43.01706758875529
Task_18088,1863,287,133,45,178,6.46875,36.63610212472728
Task_18089,2539,980,182,38,220,2.588175331294597,49.77027746852656
Task_18090,2991,374,41,169,210,7.976,55.64907372560841
Task_18091,1947,413,11,147,158,4.702898550724638,38.750099063311715
Task_18092,556,995,97,77,174,0.5582329317269076,18.713700231885298
Task_18093,1394,847,42,175,217,1.6438679245283019,31.90143104910722
Task_18094,713,912,22,111,133,0.7809419496166484,20.687788678520494
Task_18095,2530,718,141,178,319,3.5187760778859527,49.95617643843533
Task_18096,1987,923,109,76,185,2.1504329004329006,41.03953149551457
Task_18097,2122,821,22,123,145,2.5815085158150852,42.75263749334788
Task_18098,1945,930,66,78,144,2.0891514500537056,40.30554833280937
Task_18099,1501,662,67,63,130,2.26395173453997,32.20404636231006
Task_18100,1447,266,128,84,212,5.419475655430712,30.66212174489317
Task_18101,630,695,87,37,124,0.9051724137931034,18.02045240963289
Task_18102,1264,862,116,29,145,1.4646581691772886,28.771857330642366
Task_18103,755,123,170,172,342,6.088709677419355,19.748740948323174
Task_18104,1330,319,144,42,186,4.15625,28.359529045723423
Task_18105,2478,327,128,54,182,7.554878048780488,46.74565355410604
Task_18106,1800,77,71,86,157,23.076923076923077,34.476944765422914
Task_18107,2092,583,57,64,121,3.5821917808219177,41.10012391493441
Task_18108,2072,469,59,12,71,4.408510638297872,39.08922098666175
Task_18109,951,411,82,184,266,2.308252427184466,23.79572021893655
Task_18110,1872,786,94,83,177,2.3786531130876747,38.874410653351596
Task_18111,2711,622,107,200,307,4.351524879614767,52.49715032017116
Task_18112,2175,1004,66,65,131,2.1641791044776117,43.99722793179171
Task_18113,1780,316,40,166,206,5.615141955835962,36.27275388748735
Task_18114,583,794,160,113,273,0.7333333333333333,19.05509980465253
Task_18115,2973,933,49,40,89,3.1830835117773018,55.42394201435167
Task_18116,1119,680,39,197,236,1.6431718061674008,27.13668473432403
Task_18117,2349,483,136,67,203,4.853305785123967,45.38105152573161
Task_18118,1815,916,114,152,266,1.9792802617230099,38.97048084811161
Task_18119,2504,189,106,193,299,13.178947368421053,47.702518781044326
Task_18120,2762,525,177,181,358,5.250950570342205,53.1956819326302
Task_18121,2122,651,182,89,271,3.254601226993865,42.89289511503407
Task_18122,2395,202,91,151,242,11.798029556650246,45.71014700582068
Task_18123,1906,554,50,17,67,3.4342342342342342,36.771740252015604
Task_18124,597,704,142,29,171,0.8468085106382979,17.90548332755422
Task_18125,2150,882,175,104,279,2.434881087202718,44.16100033741039
Task_18126,1336,968,78,131,209,1.3787409700722395,31.271290168513204
Task_18127,1091,258,80,64,144,4.212355212355212,24.4400923876193
Task_18128,2452,459,67,155,222,5.3304347826086955,47.497407144958466
Task_18129,2828,115,111,98,209,24.379310344827587,51.5586373908806
Task_18130,936,968,18,12,30,0.9659442724458205,22.722582906401225
Task_18131,1584,159,95,38,133,9.9,31.265465072591187
Task_18132,961,953,53,131,184,1.0073375262054507,25.07484232994138
Task_18133,2833,457,133,171,304,6.185589519650655,53.84005322829961
Task_18134,1689,138,79,158,237,12.151079136690647,34.11610132830131
Task_18135,1251,350,91,111,202,3.5641025641025643,27.909020590002626
Task_18136,2458,877,146,53,199,2.7995444191343966,48.338384416722675
Task_18137,877,604,99,52,151,1.449586776859504,22.067286756689125
Task_18138,1703,1010,115,130,245,1.6844708209693373,37.347258365381215
Task_18139,1302,912,129,161,290,1.4260679079956189,30.896812378962668
Task_18140,572,100,147,34,181,5.663366336633663,15.08897699163655
Task_18141,704,573,73,57,130,1.2264808362369337,19.18210571970133
Task_18142,2642,324,175,23,198,8.12923076923077,49.12544870788676
Task_18143,1574,603,63,80,143,2.6059602649006623,33.41436492315946
Task_18144,2170,711,112,83,195,3.047752808988764,43.45945173078318
Task_18145,980,814,124,26,150,1.2024539877300613,24.088957342536343
Task_18146,2886,935,197,28,225,3.0833333333333335,55.125090328799196
Task_18147,1377,991,38,73,111,1.3881048387096775,31.036664661474195
Task_18148,1978,488,127,182,309,4.044989775051125,40.44508436331287
Task_18149,2981,215,141,177,318,13.800925925925926,55.39548284133855
Task_18150,2394,378,37,91,128,6.316622691292876,45.75918842487234
Task_18151,1954,1004,143,44,187,1.944278606965174,40.39968893196669
Task_18152,990,611,18,127,145,1.6176470588235294,24.168904289754778
Task_18153,2765,908,95,193,288,3.041804180418042,54.16833859986397
Task_18154,2468,685,137,107,244,3.597667638483965,48.4278443446286
Task_18155,2827,352,156,188,344,8.008498583569406,53.59845812504731
Task_18156,2487,536,191,88,279,4.631284916201118,48.32549267399864
Task_18157,713,391,14,185,199,1.8188775510204083,19.607632351272205
Task_18158,2447,623,100,10,110,3.921474358974359,46.29021662409462
Task_18159,572,310,20,124,144,1.8392282958199357,16.59191524929924
Task_18160,794,963,56,107,163,0.8236514522821576,22.36156099757572
Task_18161,2600,313,158,183,341,8.280254777070065,49.85253753412572
Task_18162,1485,560,39,35,74,2.6470588235294117,30.31405890616591
Task_18163,2306,744,66,78,144,3.0953020134228186,45.444137119810314
Task_18164,1594,495,81,125,206,3.213709677419355,33.89391428814246
Task_18165,2629,493,98,71,169,5.321862348178137,49.701931692037505
Task_18166,2430,280,22,140,162,8.647686832740213,46.03098031810163
Task_18167,2409,358,101,147,248,6.710306406685237,46.51393112749702
Task_18168,1424,485,127,106,233,2.9300411522633745,31.211491228186365
Task_18169,2552,470,180,48,228,5.418259023354564,48.42599016911981
Task_18170,1014,686,147,19,166,1.4759825327510918,24.36665397394656
Task_18171,2293,1011,88,105,193,2.265810276679842,46.401419891267516
Task_18172,2683,229,48,76,124,11.665217391304347,49.486897660438366
Task_18173,2329,222,12,129,141,10.443946188340806,44.02830408320457
Task_18174,2337,454,193,73,266,5.136263736263737,45.434631271381875
Task_18175,1728,460,69,96,165,3.7483731019522777,35.711954599603324
Task_18176,1751,924,159,125,284,1.892972972972973,38.02277369886138
Task_18177,1452,600,76,57,133,2.415973377703827,31.12618153676894
Task_18178,2831,694,151,115,266,4.073381294964029,54.31710234447517
Task_18179,1525,777,45,145,190,1.9601542416452442,33.615299933982044
Task_18180,1577,627,141,26,167,2.511146496815287,33.12737376259397
Task_18181,1364,983,196,101,297,1.386178861788618,32.04284559478337
Task_18182,2236,726,66,107,173,3.075653370013755,44.60736050338644
Task_18183,1092,551,82,148,230,1.9782608695652173,26.253100618157024
Task_18184,1315,800,124,67,191,1.6416978776529338,29.95375127024056
Task_18185,618,132,73,33,106,4.646616541353383,15.453543161901676
Task_18186,1255,674,19,85,104,1.8592592592592592,28.130195794011474
Task_18187,692,967,79,83,162,0.7148760330578512,20.78957635256032
Task_18188,1885,453,14,57,71,4.151982378854625,36.5433913940878
Task_18189,704,1015,89,26,115,0.6929133858267716,20.228286803700264
Task_18190,1899,400,130,121,251,4.7356608478802995,38.559583221254144
Task_18191,1871,250,130,13,143,7.4541832669322705,36.283326910921595
Task_18192,2523,268,110,148,258,9.37918215613383,48.050014451927574
Task_18193,1685,661,155,67,222,2.5453172205438066,35.51757039720129
Task_18194,1211,216,163,63,226,5.580645161290323,26.586632938342856
Task_18195,898,482,36,43,79,1.8592132505175984,20.950754494353063
Task_18196,2187,946,27,116,143,2.309398099260824,44.14753291632672
Task_18197,569,968,49,25,74,0.587203302373581,17.354705390559577
Task_18198,2885,182,60,71,131,15.765027322404372,52.529617644731324
Task_18199,1242,786,103,186,289,1.5781448538754765,29.598404142235154
Task_18200,918,372,48,64,112,2.46112600536193,21.781864248651562
Task_18201,1572,365,44,134,178,4.295081967213115,32.9526592254061
Task_18202,2451,94,95,11,106,25.8,43.85006244353716
Task_18203,2343,556,117,97,214,4.206463195691203,45.91719870512364
Task_18204,2501,135,190,141,331,18.389705882352942,47.22387831375212
Task_18205,1159,342,128,77,205,3.379008746355685,26.226106238470294
Task_18206,552,940,43,119,162,0.5866099893730075,18.54990274629698
Task_18207,729,598,167,94,261,1.2170283806343907,20.59888738624604
Task_18208,1010,379,199,19,218,2.6578947368421053,23.5564762736371
Task_18209,2079,617,198,148,346,3.3640776699029127,42.57159685715744
Task_18210,2488,291,190,160,350,8.520547945205479,48.011312124887105
Task_18211,789,769,164,122,286,1.0246753246753246,22.23670873030893
Task_18212,2606,887,192,104,296,2.934684684684685,51.47855262086963
Task_18213,1737,586,78,133,211,2.959114139693356,36.49406705220479
Task_18214,1027,916,89,33,122,1.1199563794983642,24.913233153140926
Task_18215,1195,966,164,153,317,1.235780765253361,29.46792382825443
Task_18216,2675,299,160,27,187,8.916666666666666,49.52542276189203
Task_18217,1615,71,73,17,90,22.430555555555557,30.00255393984571
Task_18218,713,339,103,147,250,2.097058823529412,19.63388375328662
Task_18219,1777,404,18,15,33,4.387654320987655,34.0655716822723
Task_18220,2151,887,133,83,216,2.4222972972972974,43.805797708721
Task_18221,619,753,46,68,114,0.8209549071618037,18.31221159429948
Task_18222,604,170,144,171,315,3.5321637426900585,17.494078438396787
Task_18223,1895,341,193,193,386,5.54093567251462,39.016001556368884
Task_18224,626,789,157,199,356,0.7924050632911392,20.212686359586957
Task_18225,1543,583,180,142,322,2.642123287671233,33.85898802877586
Task_18226,1214,753,60,178,238,1.610079575596817,28.909337820687124
Task_18227,2578,748,85,150,235,3.4419225634178905,50.3974459144841
Task_18228,2597,872,158,170,328,2.974799541809851,51.53000001330363
Task_18229,1021,744,79,49,128,1.3704697986577181,24.652628518868962
Task_18230,2590,101,189,59,248,25.392156862745097,47.40700205499704
Task_18231,976,998,56,128,184,0.9769769769769769,25.47273468090278
Task_18232,1938,285,89,134,223,6.776223776223776,38.664261432728516
Task_18233,2170,341,162,22,184,6.345029239766082,41.61624304516569
Task_18234,1769,593,113,158,271,2.978114478114478,37.26303284559578
Task_18235,1911,78,84,167,251,24.189873417721518,37.15700071109743
Task_18236,964,195,54,35,89,4.918367346938775,21.314035808077197
Task_18237,2794,823,68,79,147,3.3907766990291264,53.473419651628085
Task_18238,1588,329,80,39,119,4.8121212121212125,31.83419901643283
Task_18239,2535,714,143,12,155,3.5454545454545454,48.354544855977174
Task_18240,1656,681,51,46,97,2.4281524926686218,33.82861842745863
Task_18241,850,307,140,31,171,2.75974025974026,20.62363925854579
Task_18242,1543,219,143,55,198,7.013636363636364,31.67935802903202
Task_18243,2429,224,156,34,190,10.795555555555556,45.41596654148305
Task_18244,2915,876,40,72,112,3.3238312428734322,55.0733190158889
Task_18245,2542,887,130,55,185,2.8626126126126126,49.567946525212676
Task_18246,2722,487,127,155,282,5.577868852459017,52.05850695687874
Task_18247,2634,982,46,86,132,2.6795523906408953,51.37452876358242
Task_18248,1450,673,37,68,105,2.1513353115727,31.0834040765361
Task_18249,2238,401,31,14,45,5.567164179104478,41.45883345897327
Task_18250,2472,397,187,19,206,6.211055276381909,46.69317943297694
Task_18251,927,202,52,190,242,4.566502463054187,22.667325169660092
Task_18252,2623,691,85,31,116,3.790462427745665,49.40983875885982
Task_18253,2108,225,144,12,156,9.327433628318584,39.990726486196984
Task_18254,815,529,107,107,214,1.5377358490566038,21.581414217774704
Task_18255,1853,141,44,119,163,13.049295774647888,36.063164209033765
Task_18256,1357,325,168,21,189,4.162576687116564,28.74200011494825
Task_18257,639,815,170,188,358,0.7830882352941176,20.4918996076436
Task_18258,1840,348,73,36,109,5.2722063037249285,35.837344812701055
Task_18259,1328,577,192,171,363,2.2975778546712804,30.662764889842446
Task_18260,1983,463,58,48,106,4.273706896551724,38.37251648125986
Task_18261,2946,862,142,195,337,3.413673232908459,57.10565440273439
Task_18262,1990,144,84,28,112,13.724137931034482,37.181903874142456
Task_18263,1827,112,58,127,185,16.168141592920353,35.69615535900559
Task_18264,2071,666,105,94,199,3.1049475262368817,41.851136934236685
Task_18265,2024,811,29,83,112,2.4926108374384235,40.88613888139496
Task_18266,1048,268,93,72,165,3.895910780669145,24.028762734791837
Task_18267,2927,818,31,200,231,3.573870573870574,56.19346933841778
Task_18268,1636,325,77,31,108,5.0184049079754605,32.51413465950635
Task_18269,1376,92,84,77,161,14.795698924731182,27.72520621332634
Task_18270,2721,581,173,91,264,4.675257731958763,52.116062142024816
Task_18271,797,72,58,50,108,10.917808219178083,17.655654139719783
Task_18272,2809,521,30,144,174,5.381226053639847,53.02438286012671
Task_18273,648,778,58,73,131,0.8318356867779204,19.185429113013075
Task_18274,576,325,197,63,260,1.7668711656441718,17.053550414877808
Task_18275,1354,231,55,62,117,5.836206896551724,28.134098816743343
Task_18276,1295,854,38,119,157,1.5146198830409356,29.781140070263707
Task_18277,2208,414,75,73,148,5.320481927710843,42.72933507452931
Task_18278,1326,605,52,82,134,2.1881188118811883,29.50069378256448
Task_18279,659,850,200,77,277,0.7743830787309048,20.245251897781998
Task_18280,2249,169,195,142,337,13.229411764705882,43.48922894794893
Task_18281,2807,182,185,73,258,15.33879781420765,51.84381745493755
Task_18282,1126,448,52,42,94,2.507795100222717,24.67526218238066
Task_18283,2337,693,85,179,264,3.367435158501441,46.57975771285761
Task_18284,1899,225,88,188,276,8.402654867256636,38.13333112372903
Task_18285,748,913,131,162,293,0.8183807439824945,22.1601735853388
Task_18286,1909,484,42,174,216,3.936082474226804,38.92573978183375
Task_18287,527,919,161,59,220,0.5728260869565217,18.074598691215755
Task_18288,2518,536,14,19,33,4.68901303538175,46.218964697472096
Task_18289,2720,797,69,166,235,3.408521303258145,52.89105774517754
Task_18290,966,394,105,164,269,2.4455696202531647,23.921381376717097
Task_18291,690,258,54,115,169,2.664092664092664,18.62086972257297
Task_18292,2088,342,163,131,294,6.087463556851312,41.56645136113434
Task_18293,689,603,145,146,291,1.140728476821192,20.194691523135614
Task_18294,725,97,180,88,268,7.3979591836734695,18.43303997574998
Task_18295,1778,427,148,187,335,4.154205607476635,37.20772213466956
Task_18296,1261,338,145,46,191,3.71976401179941,27.376504586995704
Task_18297,545,859,99,77,176,0.6337209302325582,18.135963503888377
Task_18298,1973,324,11,78,89,6.070769230769231,38.09314454309378
Task_18299,2057,678,120,79,199,3.0294550810014726,41.54959394595415
Task_18300,1473,657,35,42,77,2.2386018237082066,30.503983034403273
Task_18301,2874,783,155,162,317,3.6658163265306123,55.57808968995141
Task_18302,2496,965,25,111,136,2.5838509316770186,49.05099028258695
Task_18303,2128,772,139,166,305,2.7529107373868045,43.676783874438364
Task_18304,1773,409,14,113,127,4.324390243902439,35.84632654490583
Task_18305,2531,915,60,151,211,2.763100436681223,50.132831496928304
Task_18306,1842,379,86,149,235,4.847368421052631,37.51826373757683
Task_18307,2420,91,39,34,73,26.304347826086957,42.96441274205559
Task_18308,756,387,143,162,305,1.9484536082474226,20.735820635438454
Task_18309,2440,500,173,43,216,4.870259481037924,46.66302205490454
Task_18310,1683,376,137,163,300,4.464190981432361,35.34610217979253
Task_18311,1192,167,187,71,258,7.095238095238095,26.11721288905466
Task_18312,1184,214,32,94,126,5.506976744186047,25.942147829500865
Task_18313,763,646,156,180,336,1.179289026275116,21.76193406526485
Task_18314,2517,882,153,58,211,2.8505096262740657,49.289469486416785
Task_18315,2850,263,19,89,108,10.795454545454545,52.071194542037006
Task_18316,1127,804,134,158,292,1.4,27.793669249973078
Task_18317,1841,588,128,180,308,3.1256366723259763,38.58646384662671
Task_18318,1166,217,31,163,194,5.348623853211009,26.161849401792338
Task_18319,2563,219,24,66,90,11.65,46.970527920566525
Task_18320,1739,250,30,106,136,6.9282868525896415,34.78576285133913
Task_18321,2593,929,95,49,144,2.7881720430107526,50.13609743744009
Task_18322,2291,892,70,136,206,2.5655095184770436,46.21668556277174
Task_18323,2029,1020,151,146,297,1.9872673849167484,42.81575711938689
Task_18324,515,855,86,161,247,0.6016355140186916,18.212131359192565
Task_18325,2258,118,186,134,320,18.974789915966387,43.20315756521563
Task_18326,904,259,177,153,330,3.476923076923077,22.765273958940536
Task_18327,2376,973,171,44,215,2.439425051334702,47.13029992479662
Task_18328,2616,178,45,96,141,14.614525139664805,47.977417076836986
Task_18329,2151,973,136,23,159,2.208418891170431,43.134784053680654
Task_18330,1605,637,23,65,88,2.5156739811912225,33.17666050091992
Task_18331,1501,429,60,169,229,3.4906976744186045,32.39557305519296
Task_18332,1627,136,80,116,196,11.875912408759124,32.865912014558155
Task_18333,860,999,28,45,73,0.86,21.877878503549265
Task_18334,1502,714,53,46,99,2.1006993006993007,31.42133709390106
Task_18335,1895,450,192,37,229,4.201773835920178,37.93836469339101
Task_18336,2323,267,157,79,236,8.667910447761194,44.58307470824601
Task_18337,1502,381,132,85,217,3.931937172774869,31.933248603862832
Task_18338,2544,116,36,151,187,21.743589743589745,47.00014476399746
Task_18339,1200,858,195,101,296,1.3969732246798603,29.052244739971997
Task_18340,1817,681,42,150,192,2.664222873900293,37.948898819805414
Task_18341,1490,714,160,62,222,2.0839160839160837,32.54205566572433
Task_18342,2744,186,186,52,238,14.67379679144385,50.83314810813203
Task_18343,1593,445,183,143,326,3.571748878923767,34.23257445067524
Task_18344,1661,487,64,198,262,3.403688524590164,35.3054963542591
Task_18345,1446,565,129,81,210,2.5547703180212014,31.56797450657498
Task_18346,2010,992,10,148,158,2.02416918429003,41.573770984707636
Task_18347,2717,547,81,164,245,4.958029197080292,52.073212221973485
Task_18348,2275,91,159,183,342,24.72826086956522,43.379484926440206
Task_18349,1183,635,137,162,299,1.860062893081761,28.24628117086101
Task_18350,2054,480,164,167,331,4.27027027027027,41.69967163802477
Task_18351,1740,203,154,57,211,8.529411764705882,34.785268326367714
Task_18352,2261,257,167,103,270,8.763565891472869,43.8579503153641
Task_18353,1917,929,197,185,382,2.0612903225806454,41.19836743091937
Task_18354,1104,437,173,93,266,2.5205479452054793,26.107483979738063
Task_18355,2824,616,54,13,67,4.576985413290114,51.4537923201857
Task_18356,1515,511,72,78,150,2.958984375,32.149324215460034
Task_18357,2596,490,55,94,149,5.287169042769857,49.33201299390516
Task_18358,2902,419,189,51,240,6.90952380952381,54.02800607846924
Task_18359,1995,195,120,10,130,10.178571428571429,37.99069629925662
Task_18360,660,481,103,173,276,1.3692946058091287,19.349759393094192
Task_18361,2044,545,118,20,138,3.7435897435897436,39.95172007780733
Task_18362,685,808,18,176,194,0.8467243510506799,20.341956322733136
Task_18363,2264,836,13,74,87,2.7048984468339308,44.299957997790614
Task_18364,701,828,34,181,215,0.8455971049457177,20.775936957743614
Task_18365,2299,777,81,122,203,2.955012853470437,45.93059515983816
Task_18366,654,83,121,144,265,7.785714285714286,17.49498332728321
Task_18367,2492,404,97,39,136,6.153086419753087,46.64995856805342
Task_18368,2983,735,103,185,288,4.052989130434782,57.05642593321352
Task_18369,2313,272,189,144,333,8.472527472527473,45.07757528817001
Task_18370,628,392,132,191,323,1.5979643765903309,18.83649329956189
Task_18371,2277,858,40,152,192,2.650756693830035,45.786488067706365
Task_18372,778,400,100,67,167,1.940149625935162,20.074505094384218
Task_18373,2446,788,171,175,346,3.100126742712294,48.962868459011816
Task_18374,865,353,46,103,149,2.443502824858757,21.422885287225572
Task_18375,1447,322,98,42,140,4.479876160990712,29.86718374828312
Task_18376,2656,829,31,74,105,3.2,50.737220432352125
Task_18377,1374,531,192,16,208,2.582706766917293,29.734817438875528
Task_18378,2777,777,82,135,217,3.569408740359897,53.5742194328968
Task_18379,1386,459,144,46,190,3.0130434782608697,29.735082013619387
Task_18380,1413,417,14,91,105,3.3803827751196174,29.820475438748115
Task_18381,848,883,120,56,176,0.9592760180995475,22.76504837524931
Task_18382,2503,341,10,68,78,7.318713450292398,46.14897684239677
Task_18383,1764,932,100,188,288,1.8906752411575563,38.36400925569787
Task_18384,1210,516,126,65,191,2.3404255319148937,27.40838516126992
Task_18385,2472,215,196,156,352,11.444444444444445,47.48088990207384
Task_18386,2572,528,154,93,247,4.862003780718337,49.551398703911126
Task_18387,2448,862,192,138,330,2.836616454229432,49.0999736188272
Task_18388,1763,503,21,190,211,3.498015873015873,36.641074932441676
Task_18389,1880,114,187,155,342,16.347826086956523,37.320851176755845
Task_18390,1121,368,135,121,256,3.037940379403794,26.169197694991436
Task_18391,1627,770,82,10,92,2.1102464332036317,33.592860050228516
Task_18392,2136,576,187,172,359,3.701906412478336,43.43813657417643
Task_18393,2006,770,99,52,151,2.601815823605707,40.49812039473954
Task_18394,1888,898,180,60,240,2.100111234705228,39.49543871225593
Task_18395,2439,751,190,98,288,3.2433510638297873,48.36902091059181
Task_18396,560,807,191,74,265,0.693069306930693,18.611356081498695
Task_18397,818,342,174,121,295,2.3848396501457727,21.46887480226813
Task_18398,1974,538,159,56,215,3.6623376623376624,39.62726478925384
Task_18399,1623,1012,198,124,322,1.6021717670286277,36.42393195362726
Task_18400,2811,390,184,184,368,7.189258312020461,53.57672482248455
Task_18401,2724,243,72,164,236,11.163934426229508,51.117687794769004
Task_18402,557,182,72,95,167,3.0437158469945356,16.21583170591258
Task_18403,2511,191,49,132,181,13.078125,47.219604751043505
Task_18404,510,244,23,163,186,2.0816326530612246,15.814554663748362
Task_18405,1512,95,20,187,207,15.75,30.757694802770022
Task_18406,578,206,150,71,221,2.792270531400966,16.588175273665048
Task_18407,850,962,174,57,231,0.8826583592938733,23.26157207989206
Task_18408,1995,533,98,76,174,3.735955056179775,39.907729499592655
Task_18409,1529,672,184,123,307,2.2719167904903417,33.82099345778473
Task_18410,1580,286,158,87,245,5.505226480836237,32.998378215442465
Task_18411,792,739,83,91,174,1.0702702702702702,21.56792223601524
Task_18412,2004,320,61,115,176,6.242990654205608,39.649912420739135
Task_18413,2467,208,146,150,296,11.803827751196172,47.113198549268056
Task_18414,697,849,153,36,189,0.82,20.058332012679696
Task_18415,2038,969,47,59,106,2.1010309278350516,41.08911280209449
Task_18416,2892,674,170,49,219,4.2844444444444445,54.490272975976985
Task_18417,1943,804,147,184,331,2.413664596273292,40.989496055852804
Task_18418,2522,962,140,132,272,2.618899273104881,50.31458471436008
Task_18419,2950,333,78,128,206,8.832335329341317,54.835189089501576
Task_18420,1138,634,178,122,300,1.7921259842519686,27.476321746872582
Task_18421,1285,856,105,181,286,1.499416569428238,30.47617254050247
Task_18422,2288,798,129,74,203,2.8635794743429286,45.52008850354457
Task_18423,665,432,193,192,385,1.535796766743649,19.799021635683467
Task_18424,1775,569,144,75,219,3.1140350877192984,36.74972263518204
Task_18425,1165,701,87,99,186,1.6595441595441596,27.47400293912931
Task_18426,626,337,17,54,71,1.8520710059171597,16.231336208397476
Task_18427,2989,809,12,198,210,3.6901234567901233,57.016463636912505
Task_18428,2085,920,163,111,274,2.263843648208469,43.237205473118614
Task_18429,2502,119,108,101,209,20.85,46.5099314347411
Task_18430,1873,531,167,162,329,3.5206766917293235,38.98081535098341
Task_18431,591,357,92,58,150,1.6508379888268156,16.775391583691487
Task_18432,2172,266,193,107,300,8.134831460674157,42.62481722277274
Task_18433,1792,655,96,120,216,2.731707317073171,37.52653394081198
Task_18434,1591,567,168,174,342,2.801056338028169,34.70574191946966
Task_18435,1831,155,123,196,319,11.737179487179487,36.85085395733909
Task_18436,1230,746,12,119,131,1.6465863453815262,28.325144167201355
Task_18437,1282,495,18,94,112,2.5846774193548385,28.131377705613087
Task_18438,2871,954,11,59,70,3.006282722513089,53.70322865856832
Task_18439,1184,891,19,68,87,1.3273542600896862,27.307789725410213
Task_18440,2135,88,53,185,238,23.98876404494382,40.740313349733405
Task_18441,636,828,136,41,177,0.767189384800965,19.014488024801263
Task_18442,2043,507,129,33,162,4.021653543307087,40.08113178127286
Task_18443,1127,393,88,144,232,2.8604060913705585,26.22839352236319
Task_18444,675,735,53,103,156,0.9171195652173914,19.588424607567934
Task_18445,515,224,41,121,162,2.2888888888888888,15.588539319104228
Task_18446,845,483,157,56,213,1.7458677685950412,21.560201693720895
Task_18447,951,644,130,176,306,1.4744186046511627,24.59810342714142
Task_18448,2061,743,29,161,190,2.7701612903225805,41.998253970499526
Task_18449,2209,219,163,154,317,10.040909090909091,43.18270143615237
Task_18450,718,405,168,91,259,1.7684729064039408,19.81145744643953
Task_18451,2332,941,157,103,260,2.475583864118896,47.14173445591664
Task_18452,1016,694,35,187,222,1.4618705035971222,25.439207066886443
Task_18453,1273,580,120,39,159,2.1910499139414803,28.05632292055728
Task_18454,1226,505,165,198,363,2.4229249011857705,28.86093663399889
Task_18455,2678,424,109,85,194,6.301176470588235,50.57718085874373
Task_18456,582,850,130,192,322,0.6839012925969448,19.628709161024577
Task_18457,1789,631,33,184,217,2.8306962025316458,37.500528373338035
Task_18458,819,590,172,27,199,1.385786802030457,21.16654024007864
Task_18459,1029,389,189,54,243,2.6384615384615384,24.328243002182816
Task_18460,967,179,71,58,129,5.372222222222222,21.850806212869628
Task_18461,1662,208,114,158,272,7.952153110047847,34.307867356333425
Task_18462,1931,342,15,17,32,5.629737609329446,36.29005587694556
Task_18463,2571,272,174,102,276,9.417582417582418,48.83682052985114
Task_18464,1029,793,53,88,141,1.2959697732997482,25.33072634123548
Task_18465,657,454,47,110,157,1.443956043956044,18.429245420894883
Task_18466,1069,397,57,88,145,2.685929648241206,24.808442742159215
Task_18467,1512,959,26,33,59,1.575,31.932773430736287
Task_18468,1281,706,198,57,255,1.811881188118812,29.355274350125995
Task_18469,1531,94,40,42,82,16.11578947368421,29.232823366638588
Task_18470,971,595,37,125,162,1.6291946308724832,23.980528950560835
Task_18471,901,66,29,64,93,13.447761194029852,19.385870475508536
Task_18472,951,208,163,63,226,4.55023923444976,22.45393196027092
Task_18473,948,237,114,55,169,3.9831932773109244,22.17951853969274
Task_18474,2950,477,164,106,270,6.171548117154812,55.50920366190153
Task_18475,1624,279,168,181,349,5.8,34.33808228653115
Task_18476,506,215,14,21,35,2.3425925925925926,13.42989587361218
Task_18477,590,281,71,55,126,2.0921985815602837,16.414984869456703
Task_18478,1473,479,65,89,154,3.06875,31.446236061065935
Task_18479,1658,787,196,91,287,2.1040609137055837,36.03161936488521
Task_18480,2205,876,156,111,267,2.514253135689852,44.969927024994206
Task_18481,2616,793,112,172,284,3.2947103274559195,51.38801745514703
Task_18482,1649,487,163,173,336,3.3790983606557377,35.34213872320728
Task_18483,2840,849,98,181,279,3.3411764705882354,55.10766933072714
Task_18484,2534,495,96,107,203,5.108870967741935,48.68956569881885
Task_18485,2378,694,64,83,147,3.42158273381295,46.49720492963885
Task_18486,1641,384,143,16,159,4.2623376623376625,33.15700880731655
Task_18487,1193,166,113,132,245,7.1437125748503,26.390629321247474
Task_18488,1621,475,162,146,308,3.4054621848739495,34.694883684042374
Task_18489,2552,657,41,122,163,3.878419452887538,49.28011404127347
Task_18490,678,274,155,11,166,2.4654545454545453,17.73503941518139
Task_18491,609,841,85,52,137,0.7232779097387173,18.714960447497635
Task_18492,990,817,45,59,104,1.2102689486552567,23.997385889385175
Task_18493,1623,770,122,45,167,2.105058365758755,34.332284290554604
Task_18494,2179,193,123,168,291,11.231958762886597,42.50675849075855
Task_18495,887,960,146,126,272,0.922996878251821,24.364035054510726
Task_18496,2223,613,155,40,195,3.6205211726384365,43.48946774554895
Task_18497,821,705,90,21,111,1.1628895184135977,20.864300389932836
Task_18498,2695,543,111,200,311,4.954044117647059,52.00892858912491
Task_18499,2460,830,86,55,141,2.96028880866426,47.781345642703855
Task_18500,2921,864,175,109,284,3.376878612716763,56.35087347135792
Task_18501,2492,896,88,159,247,2.778149386845039,49.51891030236598
Task_18502,1133,577,172,175,347,1.9602076124567474,27.508586563837184
Task_18503,1303,259,84,198,282,5.0115384615384615,28.92986233845342
Task_18504,2511,371,117,194,311,6.75,48.524132009558095
Task_18505,1514,646,135,45,180,2.340030911901082,32.28413090150467
Task_18506,1511,728,79,171,250,2.072702331961591,33.58430015734356
Task_18507,1339,394,111,74,185,3.389873417721519,29.10437312103933
Task_18508,1803,534,30,173,203,3.3700934579439252,37.3334586683444
Task_18509,2692,783,81,49,130,3.433673469387755,51.15290773175787
Task_18510,1187,695,98,23,121,1.7054597701149425,26.626483302188884
Task_18511,2858,976,160,55,215,2.925281473899693,55.0079961937974
Task_18512,1331,279,184,134,318,4.753571428571429,29.498149262329278
Task_18513,761,763,183,36,219,0.9960732984293194,20.919395257168947
Task_18514,2801,611,56,179,235,4.576797385620915,53.60172571107608
Task_18515,1729,619,25,146,171,2.7887096774193547,36.174226559481745
Task_18516,2384,495,37,87,124,4.806451612903226,45.7710835431349
Task_18517,972,556,146,190,336,1.7450628366247756,24.852468021150013
Task_18518,1903,845,198,118,316,2.2494089834515365,40.31930876467168
Task_18519,2983,741,20,99,119,4.020215633423181,55.88919759915163
Task_18520,790,568,111,45,156,1.3884007029876977,20.323353466485496
Task_18521,1836,109,107,136,243,16.69090909090909,36.10082906015377
Task_18522,982,1020,29,129,158,0.9618021547502449,25.319538600879735
Task_18523,988,203,47,93,140,4.8431372549019605,22.851163509797683
Task_18524,2308,962,12,161,173,2.3966770508826585,46.45540383504838
Task_18525,506,333,162,115,277,1.5149700598802396,16.373063451321844
Task_18526,1884,73,155,130,285,25.45945945945946,36.81480367356375
Task_18527,2307,791,139,58,197,2.912878787878788,45.61434195257491
Task_18528,2244,723,139,70,209,3.0994475138121547,44.5095808608898
Task_18529,2421,918,23,120,143,2.634385201305767,47.771489616317155
Task_18530,2312,791,100,129,229,2.919191919191919,46.254573876838755
Task_18531,982,774,189,133,322,1.2670967741935484,25.49468777219738
Task_18532,591,303,98,134,232,1.944078947368421,17.49437509266943
Task_18533,635,214,141,29,170,2.953488372093023,16.917265391979353
Task_18534,910,712,13,33,46,1.276297335203366,21.571518655455375
Task_18535,2324,690,162,146,308,3.3632416787264834,46.50829554295592
Task_18536,2863,353,114,135,249,8.087570621468927,53.66548445141128
Task_18537,1481,879,54,184,238,1.6829545454545454,33.54049640666104
Task_18538,1652,875,189,78,267,1.8858447488584476,36.033310245877736
Task_18539,2438,638,46,189,235,3.815336463223787,47.91737714906418
Task_18540,2889,521,67,12,79,5.5344827586206895,52.4562702415382
Task_18541,2003,316,193,151,344,6.318611987381703,40.38918642002597
Task_18542,1980,407,119,50,169,4.852941176470588,38.92153747682758
Task_18543,2075,135,90,32,122,15.257352941176471,38.62251691877587
Task_18544,2741,457,120,53,173,5.9847161572052405,51.347749126487905
Task_18545,773,155,147,194,341,4.955128205128205,20.271044945818065
Task_18546,2947,126,20,195,215,23.20472440944882,53.67447368514058
Task_18547,2063,183,22,134,156,11.21195652173913,39.64768992716126
Task_18548,1088,617,138,131,269,1.7605177993527508,26.49144623604552
Task_18549,2571,419,67,157,224,6.121428571428571,49.26155179313725
Task_18550,818,416,153,19,172,1.961630695443645,20.409587041128727
Task_18551,1339,99,14,162,176,13.39,27.867114882986176
Task_18552,2598,251,84,180,264,10.30952380952381,49.25662118109691
Task_18553,991,441,94,77,171,2.242081447963801,23.679469555659093
Task_18554,870,304,181,102,283,2.8524590163934427,22.087573158861982
Task_18555,2427,315,103,48,151,7.680379746835443,45.44631395084048
Task_18556,2230,654,92,119,211,3.404580152671756,44.436723603038196
Task_18557,2006,231,81,65,146,8.64655172413793,38.862573269865614
Task_18558,2825,900,59,78,137,3.1354051054384016,54.084518551841484
Task_18559,2815,1010,23,137,160,2.7843719090009893,54.407706641913705
Task_18560,2022,195,84,196,280,10.316326530612244,40.04650623780599
Task_18561,2524,825,119,46,165,3.055690072639225,48.81414193385721
Task_18562,1188,889,117,87,204,1.3348314606741574,28.472737471088593
Task_18563,2087,426,159,59,218,4.887587822014051,41.0566052836163
Task_18564,1718,496,126,176,302,3.456740442655936,36.31428390094778
Task_18565,1953,670,85,181,266,2.910581222056632,40.436857074114364
Task_18566,2441,867,70,182,252,2.8122119815668203,48.79008774967304
Task_18567,810,925,100,14,114,0.8747300215982722,21.39283661850256
Task_18568,804,429,129,100,229,1.869767441860465,21.194218013682942
Task_18569,858,208,64,154,218,4.105263157894737,21.435787816723693
Task_18570,2289,562,88,10,98,4.065719360568384,43.44791927947383
Task_18571,962,340,102,102,204,2.8211143695014664,23.302099054007773
Task_18572,871,754,34,42,76,1.1536423841059602,21.301496871842634
Task_18573,2174,472,59,194,253,4.5961945031712474,43.33142231720353
Task_18574,2488,371,162,103,265,6.688172043010753,47.81953986905102
Task_18575,1448,823,108,118,226,1.7572815533980584,32.622773955909175
Task_18576,813,873,163,53,216,0.9302059496567505,22.434486267874068
Task_18577,1599,745,169,74,243,2.14343163538874,34.619261492934314
Task_18578,2920,607,157,120,277,4.802631578947368,55.50675187268814
Task_18579,979,403,147,120,267,2.4232673267326734,24.082113789562822
Task_18580,1283,703,93,54,147,1.8224431818181819,28.898537814519614
Task_18581,2591,856,103,74,177,3.0233372228704782,50.357998500985
Task_18582,929,1009,71,182,253,0.9198019801980198,25.18701437008536
Task_18583,1861,170,73,40,113,10.883040935672515,35.36990447915598
Task_18584,960,680,50,24,74,1.4096916299559472,22.335022834424805
Task_18585,2632,68,132,66,198,38.14492753623188,47.556857972780826
Task_18586,1114,826,11,25,36,1.347037484885127,24.987999961602338
Task_18587,1957,268,87,73,160,7.275092936802974,38.12091005324163
Task_18588,991,707,63,82,145,1.3997175141242937,24.524246123542866
Task_18589,1174,988,32,195,227,1.187057633973711,28.847934948421983
Task_18590,2572,341,36,182,218,7.52046783625731,48.965209423172944
Task_18591,890,307,48,139,187,2.8896103896103895,22.081352285173992
Task_18592,2713,106,31,86,117,25.35514018691589,48.65267393392843
Task_18593,897,976,189,62,251,0.9181166837256909,24.161050262581487
Task_18594,1800,536,200,21,221,3.35195530726257,36.57813020178137
Task_18595,2745,354,89,45,134,7.732394366197183,50.48343438551939
Task_18596,2472,322,139,100,239,7.6532507739938085,47.278263104878114
Task_18597,2739,219,114,35,149,12.45,50.028246641221834
Task_18598,727,844,152,164,316,0.8603550295857988,21.721501455585784
Task_18599,1305,297,141,151,292,4.379194630872483,29.054705923094374
Task_18600,1182,289,86,41,127,4.075862068965518,25.468971137431893
Task_18601,1303,448,191,74,265,2.9020044543429844,29.097689235928666
Task_18602,616,458,160,119,279,1.3420479302832244,18.515854110537955
Task_18603,2631,140,147,121,268,18.659574468085108,49.00510726838362
Task_18604,2444,277,200,88,288,8.79136690647482,46.82192114635992
Task_18605,1107,137,110,157,267,8.021739130434783,25.014237913717068
Task_18606,1289,618,124,171,295,2.0823909531502425,29.86711702921122
Task_18607,1000,212,78,129,207,4.694835680751174,23.601771730685456
Task_18608,1792,641,194,104,298,2.791277258566978,37.820971363667134
Task_18609,2775,885,47,100,147,3.1320541760722347,53.33480069761594
Task_18610,1404,553,171,194,365,2.5342960288808665,31.833527958282556
Task_18611,2986,998,94,178,272,2.988988988988989,57.85753029454809
Task_18612,1002,507,148,47,195,1.9724409448818898,23.848792039300736
Task_18613,2146,104,63,170,233,20.438095238095237,40.98118647828488
Task_18614,1771,591,57,148,205,2.991554054054054,37.042718867212535
Task_18615,727,203,130,16,146,3.5637254901960786,18.108638260502236
Task_18616,2469,341,38,65,103,7.219298245614035,46.11950677691803
Task_18617,1410,940,123,91,214,1.4984059511158343,32.2059924362194
Task_18618,2398,728,63,124,187,3.2894375857338822,47.276161680514065
Task_18619,1667,895,38,175,213,1.8604910714285714,36.36479444954629
Task_18620,2551,238,80,192,272,10.673640167364017,48.5624292682096
Task_18621,2697,995,15,117,132,2.7078313253012047,52.37417815864507
Task_18622,2778,696,15,44,59,3.985652797704448,51.20565790118524
Task_18623,799,647,176,34,210,1.2330246913580247,21.105344312871637
Task_18624,1460,432,175,152,327,3.371824480369515,32.103692974756086
Task_18625,793,81,86,185,271,9.670731707317072,19.71684918407451
Task_18626,1106,756,18,120,138,1.4610303830911493,26.344934728167917
Task_18627,2686,740,87,127,214,3.624831309041835,51.90902516968833
Task_18628,1060,325,189,109,298,3.2515337423312882,25.23766803213887
Task_18629,2869,653,44,195,239,4.386850152905199,54.80109870556811
Task_18630,1921,953,164,78,242,2.0136268343815513,40.42559126285962
Task_18631,1825,483,83,97,180,3.770661157024793,37.35206285748787
Task_18632,659,357,33,150,183,1.8407821229050279,18.511271510829115
Task_18633,1910,418,155,147,302,4.558472553699284,39.060195031896264
Task_18634,2886,912,180,176,356,3.1610076670317633,56.369420039115916
Task_18635,1106,668,145,84,229,1.6532137518684604,26.61580543209243
Task_18636,2145,281,177,12,189,7.6063829787234045,41.03647603286657
Task_18637,1723,263,85,43,128,6.526515151515151,34.10887957411043
Task_18638,2677,282,66,120,186,9.459363957597173,50.2131894002168
Task_18639,1929,843,58,15,73,2.2855450236966823,37.996389726160395
Task_18640,2054,912,171,15,186,2.249726177437021,41.58413783844319
Task_18641,2713,969,35,127,162,2.796907216494845,52.75199309732482
Task_18642,709,554,148,135,283,1.2774774774774775,20.314548337208233
Task_18643,727,717,160,171,331,1.0125348189415042,21.357321736577195
Task_18644,1948,319,151,76,227,6.0875,38.72068689469575
Task_18645,1323,642,164,40,204,2.057542768273717,29.367332249043063
Task_18646,675,756,67,74,141,0.8916776750330251,19.58593436939213
Task_18647,2987,835,183,197,380,3.5729665071770333,57.8672190264892
Task_18648,2179,951,78,127,205,2.2888655462184873,44.60266058804399
Task_18649,2298,870,119,10,129,2.6383467278989667,44.98130002798181
Task_18650,1109,198,182,96,278,5.57286432160804,25.547221535635003
Task_18651,1992,356,68,79,147,5.579831932773109,39.280783143118036
Task_18652,2857,125,52,36,88,22.674603174603174,50.39593323006513
Task_18653,1685,525,116,180,296,3.203422053231939,35.8628095647906
Task_18654,2447,878,81,97,178,2.783845278725825,48.457670850298406
Task_18655,864,766,182,178,360,1.1264667535853976,23.820569143452477
Task_18656,2196,509,23,16,39,4.305882352941176,41.08590651065533
Task_18657,2232,577,62,177,239,3.86159169550173,44.495128833057684
Task_18658,1334,672,43,117,160,1.9821693907875186,29.89164773590538
Task_18659,2670,640,96,150,246,4.1653666146645865,51.56453314278823
Task_18660,1010,456,75,86,161,2.210065645514223,24.111361979872314
Task_18661,1586,882,114,182,296,1.7961494903737258,35.41541352323479
Task_18662,1601,500,48,128,176,3.1956087824351296,33.87055469579979
Task_18663,2143,655,117,191,308,3.2667682926829267,43.59697795004036
Task_18664,999,494,197,149,346,2.018181818181818,25.08418089477388
Task_18665,2479,971,176,190,366,2.5504115226337447,50.16992909699172
Task_18666,2687,117,49,162,211,22.771186440677965,49.53055639913819
Task_18667,1280,312,152,84,236,4.0894568690095845,28.283618869001554
Task_18668,656,499,53,25,78,1.312,17.04398828913327
Task_18669,2758,300,23,32,55,9.162790697674419,49.57620424089422
Task_18670,2442,626,177,170,347,3.8947368421052633,48.38586394284217
Task_18671,2378,320,113,75,188,7.40809968847352,45.3206501557747
Task_18672,1401,1019,133,149,282,1.3735294117647059,32.74344006144588
Task_18673,1985,342,70,36,106,5.7871720116618075,38.08058474803425
Task_18674,2549,659,148,174,322,3.8621212121212123,50.07837032811034
Task_18675,775,449,114,22,136,1.7222222222222223,19.54583971174456
Task_18676,2790,413,144,153,297,6.739130434782608,52.955984050343396
Task_18677,2462,500,174,41,215,4.9141716566866265,47.00387280399792
Task_18678,1040,186,151,178,329,5.561497326203209,24.735417473363267
Task_18679,836,791,153,142,295,1.0555555555555556,23.127001350000146
Task_18680,1883,246,81,166,247,7.623481781376518,37.887934211241365
Task_18681,1374,856,127,151,278,1.6032672112018669,31.835585114564292
Task_18682,2607,119,117,181,298,21.725,48.68014685145504
Task_18683,2480,712,81,65,146,3.4782608695652173,47.94218328583775
Task_18684,638,962,170,132,302,0.6625129802699896,20.684530104876544
Task_18685,1947,888,195,199,394,2.1901012373453317,41.6207371377895
Task_18686,1228,614,119,87,206,1.9967479674796749,28.30288837826197
Task_18687,1753,775,139,89,228,2.259020618556701,37.24275699090854
Task_18688,1417,353,146,162,308,4.002824858757062,31.097724419898316
Task_18689,2781,630,18,132,150,4.4072900158478605,52.60273842582793
Task_18690,761,760,161,41,202,1.0,20.793318777324693
Task_18691,2779,722,169,69,238,3.843706777316736,53.10402371118428
Task_18692,1946,431,144,67,211,4.50462962962963,38.86997803542486
Task_18693,777,1007,92,114,206,0.7708333333333334,22.463354257122035
Task_18694,551,334,40,193,233,1.644776119402985,17.04312004825736
Task_18695,2075,643,44,159,203,3.222049689440994,41.9786156863067
Task_18696,2348,625,45,137,182,3.7507987220447285,46.09221446382893
Task_18697,1805,947,114,30,144,1.9040084388185654,37.5576644130178
Task_18698,1725,988,153,43,196,1.744186046511628,36.77036440197099
Task_18699,2557,194,55,90,145,13.112820512820512,47.624037673869914
Task_18700,573,539,117,106,223,1.0611111111111111,17.802714394637018
Task_18701,2040,875,89,142,231,2.328767123287671,42.21457689832827
Task_18702,1156,918,17,111,128,1.2578890097932536,27.734198084439075
Task_18703,734,518,91,46,137,1.4142581888246628,19.228646573494533
Task_18704,1342,1020,33,167,200,1.3143976493633693,31.46848840057545
Task_18705,1603,196,44,123,167,8.137055837563452,32.796201701974375
Task_18706,1335,947,142,179,321,1.4082278481012658,31.694272127124965
Task_18707,1910,618,70,43,113,3.08562197092084,37.92956817254785
Task_18708,2427,450,127,135,262,5.381374722838138,47.148832500451704
Task_18709,942,102,155,49,204,9.145631067961165,21.129527753071258
Task_18710,611,1002,138,176,314,0.609172482552343,20.51769315578667
Task_18711,1901,209,141,170,311,9.052380952380952,38.27818914931061
Task_18712,902,978,181,75,256,0.9213483146067416,24.37963865088253
Task_18713,1599,131,169,125,294,12.113636363636363,32.80482896489807
Task_18714,2020,559,32,94,126,3.607142857142857,40.29436205591076
Task_18715,2583,1001,147,100,247,2.5778443113772456,51.24321670144108
Task_18716,686,534,180,159,339,1.2822429906542057,20.17569817313778
Task_18717,1772,711,59,115,174,2.4887640449438204,37.22513980581312
Task_18718,2684,535,121,171,292,5.007462686567164,51.68084825086046
Task_18719,2256,91,97,105,202,24.52173913043478,42.33551859814046
Task_18720,1461,918,159,97,256,1.589771490750816,33.22731527849669
Task_18721,839,71,165,20,185,11.652777777777779,18.94541443727217
Task_18722,1992,1005,179,190,369,1.9801192842942346,42.57182392182049
Task_18723,679,339,190,157,347,1.9970588235294118,19.547968404030613
Task_18724,2869,569,35,178,213,5.033333333333333,54.38802624542205
Task_18725,754,193,120,55,175,3.88659793814433,19.061159131145136
Task_18726,551,326,90,176,266,1.6850152905198776,17.12616274081262
Task_18727,2250,360,10,51,61,6.232686980609419,41.9152610047338
Task_18728,1518,886,106,112,218,1.7113866967305524,33.8827909926419
Task_18729,962,920,49,65,114,1.0445168295331162,24.295910151673883
Task_18730,610,626,188,23,211,0.9728867623604466,18.092532790197644
Task_18731,2131,925,102,58,160,2.301295896328294,42.953829138972395
Task_18732,2197,337,108,121,229,6.5,42.96600285093717
Task_18733,2266,764,192,22,214,2.962091503267974,44.6474355817358
Task_18734,2448,922,134,158,292,2.6522210184182016,49.14545228554649
Task_18735,1390,321,178,168,346,4.316770186335404,30.746136691881834
Task_18736,863,726,65,137,202,1.18707015130674,22.988862939034565
Task_18737,1294,541,100,59,159,2.3874538745387452,28.47833468288901
Task_18738,2440,604,123,92,215,4.033057851239669,47.52323188871174
Task_18739,894,923,198,64,262,0.9675324675324676,24.03522189638775
Task_18740,779,152,11,98,109,5.091503267973856,18.5058074178387
Task_18741,956,467,192,10,202,2.0427350427350426,22.893944133626103
Task_18742,2266,194,110,19,129,11.62051282051282,42.31227559542044
Task_18743,2514,487,82,33,115,5.151639344262295,47.008354498686295
Task_18744,1860,819,66,32,98,2.268292682926829,37.52197154886266
Task_18745,1096,176,18,127,145,6.192090395480226,23.964809836399805
Task_18746,2509,386,196,141,337,6.483204134366925,48.582229662667196
Task_18747,2433,555,61,73,134,4.375899280575539,46.697160261434895
Task_18748,2121,1008,144,110,254,2.1020812685827552,43.989843062652994
Task_18749,2212,429,112,24,136,5.144186046511628,42.240040718259145
Task_18750,2583,990,87,61,148,2.6064581231079718,50.28191952823022
Task_18751,2570,171,76,94,170,14.94186046511628,47.714291298552894
Task_18752,1289,815,52,172,224,1.579656862745098,30.19528105157772
Task_18753,1415,625,29,90,119,2.2603833865814695,30.715464365118894
Task_18754,2749,99,30,105,135,27.49,49.39186614084062
Task_18755,2430,319,12,111,123,7.59375,45.838033892320276
Task_18756,2940,446,200,175,375,6.577181208053691,55.82323998651674
Task_18757,1039,207,197,97,294,4.9951923076923075,24.50696449733714
Task_18758,2649,794,112,106,218,3.332075471698113,51.51976037442279
Task_18759,2401,560,96,171,267,4.279857397504457,47.17504238108822
Task_18760,2766,376,143,196,339,7.336870026525199,52.7044057676988
Task_18761,1572,438,73,142,215,3.580865603644647,33.435977535601545
Task_18762,2132,766,53,128,181,2.7796610169491527,43.1410369309865
Task_18763,769,749,146,161,307,1.0253333333333334,22.017440109314816
Task_18764,1802,524,130,94,224,3.4323809523809525,37.254861010110396
Task_18765,1792,157,101,168,269,11.341772151898734,35.98589727198956
Task_18766,1293,353,161,57,218,3.652542372881356,28.26425775139228
Task_18767,539,77,13,125,138,6.910256410256411,14.61427334358799
Task_18768,2226,165,120,177,297,13.409638554216867,42.99039345741496
Task_18769,2791,426,75,188,263,6.5362997658079625,52.97789122739172
Task_18770,2994,259,55,50,105,11.515384615384615,53.73472415058054
Task_18771,763,412,67,161,228,1.847457627118644,20.651315087749808
Task_18772,2075,410,12,185,197,5.048661800486618,41.191753678953184
Task_18773,1299,442,88,159,247,2.9322799097065464,29.195949452512007
Task_18774,2296,346,26,165,191,6.61671469740634,44.4411388100393
Task_18775,1002,242,14,174,188,4.1234567901234565,23.618220734679294
Task_18776,1467,563,194,77,271,2.601063829787234,32.101225696070905
Task_18777,1439,196,135,21,156,7.304568527918781,29.35710372401729
Task_18778,1058,611,17,89,106,1.7287581699346406,24.78445419340822
Task_18779,1131,351,68,183,251,3.2130681818181817,26.414301519912552
Task_18780,1698,1020,195,147,342,1.6630754162585701,37.761141441921154
Task_18781,2866,378,184,155,339,7.562005277044855,54.23318737057527
Task_18782,2175,162,130,73,203,13.343558282208589,41.34801403998306
Task_18783,2578,252,123,153,276,10.189723320158103,48.948955072331216
Task_18784,2271,788,145,173,318,2.8783269961977185,46.06124578122628
Task_18785,1904,580,182,91,273,3.2771084337349397,39.21567858229077
Task_18786,1639,324,137,179,316,5.0430769230769235,34.574670798769965
Task_18787,740,91,30,162,192,8.043478260869565,18.574887020298792
Task_18788,2264,264,164,101,265,8.543396226415094,43.905066010416625
Task_18789,1143,408,73,91,164,2.7946210268948657,26.197863355512865
Task_18790,2946,565,20,88,108,5.204946996466431,54.621525311044955
Task_18791,2141,980,86,98,184,2.182466870540265,43.81787774694192
Task_18792,1074,991,53,120,173,1.0826612903225807,26.93485021894899
Task_18793,1601,809,121,108,229,1.9765432098765432,35.01555829102127
Task_18794,2041,451,193,77,270,4.515486725663717,40.82735964176536
Task_18795,1100,147,75,145,220,7.4324324324324325,24.868978244124477
Task_18796,2427,167,169,49,218,14.446428571428571,45.15181161151023
Task_18797,2901,887,143,112,255,3.266891891891892,55.97977744835439
Task_18798,2287,407,139,179,318,5.605392156862745,45.10916895311635
Task_18799,1952,263,73,176,249,7.393939393939394,39.06867580796561
Task_18800,1727,901,168,97,265,1.9146341463414633,37.47269973794389
Task_18801,607,625,169,156,325,0.9696485623003195,19.167180436002948
Task_18802,2662,848,167,57,224,3.1354534746760896,51.53791631725951
Task_18803,1601,583,37,101,138,2.7414383561643834,33.71361680853038
Task_18804,614,654,166,168,334,0.9374045801526718,19.437556723894534
Task_18805,1144,878,80,86,166,1.3014789533560864,27.61866376619081
Task_18806,1182,650,196,36,232,1.8156682027649769,27.277225988887228
Task_18807,960,337,141,67,208,2.8402366863905324,22.952877737042325
Task_18808,1298,212,116,116,232,6.093896713615023,28.333526996909853
Task_18809,927,333,41,154,195,2.7754491017964074,22.774504829515703
Task_18810,1761,160,57,179,236,10.937888198757763,35.401437934940894
Task_18811,2519,562,106,175,281,4.474245115452931,49.11120865988435
Task_18812,2060,731,59,57,116,2.814207650273224,40.8068692728198
Task_18813,2652,647,12,152,164,4.092592592592593,50.844836168393336
Task_18814,1474,669,105,134,239,2.2,32.650091328387184
Task_18815,2631,885,121,192,313,2.969525959367946,52.07404170334777
Task_18816,1461,655,149,18,167,2.2271341463414633,31.315084246447153
Task_18817,2881,725,123,13,136,3.96831955922865,53.75177323396414
Task_18818,1448,236,122,26,148,6.109704641350211,29.651941223005636
Task_18819,760,527,200,137,337,1.4393939393939394,21.291588679894428
Task_18820,2667,145,167,40,207,18.267123287671232,48.665493292539416
Task_18821,1348,272,150,159,309,4.937728937728938,29.739472741093376
Task_18822,876,270,115,192,307,3.2324723247232474,22.312302379883054
Task_18823,1752,568,176,122,298,3.07908611599297,36.98380858088961
Task_18824,2936,893,108,174,282,3.2841163310961967,56.76573239617176
Task_18825,1127,893,139,96,235,1.2606263982102908,27.742823463734812
Task_18826,2339,288,85,34,119,8.093425605536332,43.5935644731631
Task_18827,879,298,182,130,312,2.939799331103679,22.382260466150516
Task_18828,2156,435,163,153,316,4.944954128440367,43.08052872896733
Task_18829,2595,886,118,73,191,2.9255918827508456,50.550623372704166
Task_18830,2931,759,32,92,124,3.856578947368421,55.2365462545589
Task_18831,2754,548,90,199,289,5.016393442622951,52.852949665282885
Task_18832,500,893,37,167,204,0.5592841163310962,17.883873966816857
Task_18833,2819,814,162,138,300,3.4588957055214724,54.692431825767606
Task_18834,1919,767,138,24,162,2.4986979166666665,38.87712256359455
Task_18835,1325,218,198,140,338,6.050228310502283,29.293892621745822
Task_18836,1566,600,145,192,337,2.605657237936772,34.41758922747439
Task_18837,826,850,159,40,199,0.9706227967097533,22.201826208750372
Task_18838,1885,998,11,78,89,1.8868868868868869,38.83593609516777
Task_18839,2045,475,103,75,178,4.296218487394958,40.51299162377897
Task_18840,1083,87,18,110,128,12.306818181818182,23.19654944741239
Task_18841,2868,238,150,150,300,12.0,53.581372866825156
Task_18842,1592,874,45,95,140,1.8194285714285714,34.54200812846033
Task_18843,968,734,136,132,268,1.3170068027210884,24.918242794744543
Task_18844,2549,902,91,112,203,2.82281284606866,50.21418253578301
Task_18845,600,283,45,164,209,2.112676056338028,17.53714140056284
Task_18846,2535,692,188,13,201,3.658008658008658,48.60769297773797
Task_18847,1831,479,79,145,224,3.814583333333333,37.711882127038514
Task_18848,2389,465,180,63,243,5.126609442060086,46.1225303612102
Task_18849,1370,577,19,159,178,2.370242214532872,30.439414671056284
Task_18850,2417,831,44,18,62,2.905048076923077,45.78037028425188
Task_18851,867,595,116,115,231,1.4546979865771812,22.68779499838102
Task_18852,978,861,68,152,220,1.134570765661253,25.324390200275648
Task_18853,987,200,188,190,378,4.91044776119403,24.148440717683002
Task_18854,2494,89,83,142,225,27.711111111111112,46.24521265893685
Task_18855,2951,535,192,102,294,5.505597014925373,55.81623268635417
Task_18856,2129,153,195,49,244,13.824675324675324,40.49333924167437
Task_18857,634,906,75,32,107,0.6990077177508269,18.817473889868367
Task_18858,2045,400,38,31,69,5.0997506234413965,38.64988953594203
Task_18859,1282,690,61,150,211,1.8552821997105644,29.638830455067666
Task_18860,2395,210,74,176,250,11.350710900473933,45.87571577162682
Task_18861,872,549,100,145,245,1.5854545454545454,22.7417728080423
Task_18862,1908,719,139,59,198,2.65,39.06335953690239
Task_18863,1713,593,179,168,347,2.8838383838383836,36.733397984985494
Task_18864,2788,676,181,164,345,4.118168389955687,54.00682747529078
Task_18865,1844,335,149,103,252,5.488095238095238,37.45350171688437
Task_18866,2838,876,140,74,214,3.2360319270239453,54.52821071111948
Task_18867,1458,950,22,65,87,1.5331230283911672,31.774042436557
Task_18868,1747,872,197,187,384,2.0011454753722795,38.3392893187069
Task_18869,2625,554,20,51,71,4.72972972972973,48.557630178341924
Task_18870,617,211,74,132,206,2.910377358490566,17.544860921532262
Task_18871,740,709,12,47,59,1.0422535211267605,19.06850307059243
Task_18872,1973,649,170,155,325,3.0353846153846153,40.90934487934948
Task_18873,1360,949,14,99,113,1.431578947368421,30.765430962390166
Task_18874,1188,823,95,43,138,1.441747572815534,27.36651057395683
Task_18875,2156,1020,30,158,188,2.1116552399608226,44.3443709851225
Task_18876,2459,158,188,50,238,15.465408805031446,45.68266425993536
Task_18877,1627,835,59,162,221,1.9461722488038278,35.62145674848435
Task_18878,2745,363,182,74,256,7.541208791208791,51.59678922454288
Task_18879,1304,331,62,171,233,3.927710843373494,28.98104070486723
Task_18880,828,166,72,139,211,4.958083832335329,20.569311344477796
Task_18881,1636,466,109,172,281,3.5032119914346893,34.8200299009196
Task_18882,520,1003,68,95,163,0.5179282868525896,18.42016468297705
Task_18883,934,405,49,89,138,2.3004926108374386,22.67390042555928
Task_18884,2315,831,113,143,256,2.782451923076923,46.56954582123552
Task_18885,1726,199,150,179,329,8.63,35.58195694370857
Task_18886,1243,320,37,78,115,3.872274143302181,27.000875633162803
Task_18887,2187,953,174,89,263,2.292452830188679,44.83184827837604
Task_18888,505,739,162,191,353,0.6824324324324325,18.20417887890045
Task_18889,1782,991,129,178,307,1.7963709677419355,38.903449790238255
Task_18890,2990,577,84,169,253,5.173010380622838,56.49258874906286
Task_18891,2684,199,64,199,263,13.42,50.50519493222021
Task_18892,1154,713,83,122,205,1.6162464985994398,27.569914780689416
Task_18893,1516,831,112,154,266,1.8221153846153846,33.97150637720268
Task_18894,2375,182,58,99,157,12.978142076502733,44.62168163210208
Task_18895,2519,823,166,189,355,3.0570388349514563,50.29025558639061
Task_18896,1716,673,198,161,359,2.5459940652818993,37.07616369654992
Task_18897,2736,339,152,93,245,8.047058823529412,51.512475020030934
Task_18898,2370,856,82,93,175,2.765460910151692,47.085821001939365
Task_18899,2925,600,118,130,248,4.8668885191347755,55.447480054336744
Task_18900,2891,857,26,100,126,3.3694638694638694,54.981448529754175
Task_18901,1536,358,179,76,255,4.278551532033426,32.45984557435178
Task_18902,2631,556,188,179,367,4.723518850987433,51.25893318054602
Task_18903,1149,171,175,107,282,6.680232558139535,25.850249112891785
Task_18904,2335,297,170,45,215,7.8355704697986575,44.31018315644738
Task_18905,2073,528,146,97,243,3.9187145557655954,41.68337345673759
Task_18906,642,697,34,62,96,0.9197707736389685,18.163875545821295
Task_18907,1349,595,78,191,269,2.2634228187919465,30.724375633916953
Task_18908,1838,311,127,187,314,5.891025641025641,37.680744327683726
Task_18909,2318,754,43,118,161,3.070198675496689,45.76915054377124
Task_18910,595,629,136,170,306,0.9444444444444444,18.9380986068959
Task_18911,2497,418,84,119,203,5.959427207637232,47.872218042297156
Task_18912,584,761,188,104,292,0.7664041994750657,19.03303453337952
Task_18913,955,645,99,30,129,1.478328173374613,23.089593067861472
Task_18914,753,401,127,191,318,1.873134328358209,20.83357717896203
Task_18915,623,480,199,186,385,1.2952182952182951,19.256970149720555
Task_18916,858,539,113,10,123,1.5888888888888888,20.929481450376638
Task_18917,846,638,23,82,105,1.323943661971831,21.52502396068868
Task_18918,1252,833,169,188,357,1.501199040767386,30.212201045369458
Task_18919,1415,389,181,178,359,3.628205128205128,31.435927478284203
Task_18920,1268,1001,39,141,180,1.2654690618762474,30.069048529288054
Task_18921,695,213,72,191,263,3.2476635514018692,19.125768052231546
Task_18922,588,362,103,107,210,1.6198347107438016,17.476941056416077
Task_18923,2938,623,152,107,259,4.708333333333333,55.74278951249865
Task_18924,1337,741,129,135,264,1.8018867924528301,30.818733412050122
Task_18925,2863,205,38,149,187,13.898058252427184,52.85627173677502
Task_18926,2732,306,200,148,348,8.899022801302932,51.89539623274597
Task_18927,2061,557,165,154,319,3.693548387096774,41.983458169430406
Task_18928,2590,649,46,108,154,3.9846153846153847,49.653081217708554
Task_18929,1443,383,12,138,150,3.7578125,30.615453627714178
Task_18930,622,1008,36,187,223,0.6164519326065411,20.318264584556655
Task_18931,1817,875,116,26,142,2.074200913242009,37.468206867179745
Task_18932,2447,714,138,93,231,3.4223776223776223,48.09113599655122
Task_18933,1066,864,132,196,328,1.2323699421965317,27.220597063211613
Task_18934,2995,583,168,134,302,5.1284246575342465,56.75071917067447
Task_18935,775,712,88,108,196,1.0869565217391304,21.33313713328882
Task_18936,1028,690,53,94,147,1.487698986975398,25.089376713463896
Task_18937,529,423,25,34,59,1.2476415094339623,14.732591723816872
Task_18938,2769,320,146,148,294,8.626168224299066,52.2862892505731
Task_18939,1684,443,175,153,328,3.7927927927927927,35.69012874269483
Task_18940,2256,902,43,120,163,2.4983388704318936,45.360920987401876
Task_18941,1709,637,151,198,349,2.6786833855799372,36.861487130205894
Task_18942,1467,996,11,156,167,1.4714142427281847,33.12857435780535
Task_18943,2942,370,101,23,124,7.929919137466308,53.44373114898863
Task_18944,1777,506,128,188,316,3.504930966469428,37.36087277811982
Task_18945,2907,340,33,184,217,8.52492668621701,54.250503527630904
Task_18946,2909,653,39,119,158,4.448012232415902,54.76814300529108
Task_18947,2662,432,27,93,120,6.147806004618937,49.84871783799849
Task_18948,640,856,69,67,136,0.7467911318553092,19.19047474613919
Task_18949,2023,981,134,39,173,2.060081466395112,41.35395456505529
Task_18950,604,360,167,124,291,1.6731301939058172,18.11374810820316
Task_18951,1376,725,123,45,168,1.8953168044077136,30.253317463879668
Task_18952,2250,247,17,195,212,9.07258064516129,43.47950041384858
Task_18953,1238,96,47,114,161,12.762886597938145,25.851404280493266
Task_18954,2130,750,132,196,328,2.8362183754993344,43.78717773050386
Task_18955,659,769,145,28,173,0.8558441558441559,19.12095241318882
Task_18956,1505,706,170,50,220,2.128712871287129,32.618667224194894
Task_18957,1086,234,22,173,195,4.621276595744681,24.959967904091624
Task_18958,2409,769,180,181,361,3.1285714285714286,48.39346619091108
Task_18959,1217,915,185,93,278,1.3286026200873362,29.396021484576753
Task_18960,1168,710,181,170,351,1.6427566807313643,28.47508693524848
Task_18961,613,313,21,158,179,1.9522292993630572,17.625593553894124
Task_18962,1644,528,17,108,125,3.107750472589792,34.13436800613186
Task_18963,2694,440,46,23,69,6.108843537414966,48.99728370764779
Task_18964,1847,560,16,96,112,3.2923351158645278,37.29271862417951
Task_18965,1513,572,16,175,191,2.6404886561954624,32.77985575329493
Task_18966,2380,816,60,118,178,2.913096695226438,47.20782254455009
Task_18967,1296,404,130,17,147,3.2,27.743262948110274
Task_18968,687,649,86,91,177,1.0569230769230769,19.56973382619146
Task_18969,2885,300,164,126,290,9.584717607973422,53.99949219680858
Task_18970,1392,449,95,31,126,3.0933333333333333,29.3771601303342
Task_18971,2447,427,12,170,182,5.7172897196261685,47.0107052670191
Task_18972,2597,624,47,177,224,4.1552,50.33038183251197
Task_18973,2065,946,23,42,65,2.180570221752904,40.718671144439
Task_18974,910,102,156,71,227,8.83495145631068,20.98322365261685
Task_18975,2046,658,178,107,285,3.104704097116844,41.84326895799835
Task_18976,1621,497,162,56,218,3.255020080321285,33.92154763188632
Task_18977,642,643,91,92,183,0.9968944099378882,18.925945728747788
Task_18978,2358,909,62,198,260,2.5912087912087913,47.66031592884519
Task_18979,1120,145,21,19,40,7.671232876712328,22.793817096790082
Task_18980,1316,527,172,183,355,2.492424242424242,30.2971064290228
Task_18981,1112,330,194,154,348,3.3595166163141994,26.367527983046756
Task_18982,2123,110,52,59,111,19.126126126126128,39.1001217614209
Task_18983,2385,657,19,11,30,3.6246200607902734,44.50594210577979
Task_18984,1705,968,33,113,146,1.759545923632611,36.61322726662142
Task_18985,803,365,74,52,126,2.1939890710382515,20.08296953822862
Task_18986,2551,1018,27,94,121,2.5034347399411185,49.97585899437905
Task_18987,1008,844,98,195,293,1.1928994082840236,26.089459861862537
Task_18988,1679,755,167,102,269,2.2208994708994707,36.25442112020165
Task_18989,989,455,123,181,304,2.168859649122807,24.660850863756878
Task_18990,2646,404,81,50,131,6.533333333333333,49.232194843768234
Task_18991,620,974,68,41,109,0.6358974358974359,18.826918226651937
Task_18992,1937,539,114,186,300,3.587037037037037,39.92406806183579
Task_18993,2859,747,193,69,262,3.822192513368984,54.55843966402251
Task_18994,1703,963,87,191,278,1.766597510373444,37.39984229017991
Task_18995,1838,590,29,129,158,3.1099830795262267,37.60998513414191
Task_18996,2296,188,22,34,56,12.148148148148149,41.9957562727058
Task_18997,730,964,37,32,69,0.7564766839378239,19.723244177181016
Task_18998,2834,595,86,174,260,4.75503355704698,54.0692053840867
Task_18999,1852,115,10,150,160,15.96551724137931,35.65670822995796
Task_19000,995,622,48,97,145,1.5971107544141252,24.377999404648165
Task_19001,1712,732,116,141,257,2.3356070941336973,36.70843685808529
Task_19002,2135,467,23,144,167,4.561965811965812,42.10787828786352
Task_19003,2361,538,147,122,269,4.380333951762523,46.40078140259131
Task_19004,2331,404,28,38,66,5.7555555555555555,43.1682143848941
Task_19005,2167,255,89,64,153,8.46484375,41.31197218667632
Task_19006,2928,931,19,83,102,3.1416309012875536,55.39795011597965
Task_19007,1877,897,56,149,205,2.0902004454342986,39.684059480799824
Task_19008,2704,655,128,97,225,4.121951219512195,51.999035753128275
Task_19009,2677,892,20,177,197,2.9977603583426653,52.26512376596521
Task_19010,836,613,29,146,175,1.3615635179153094,22.023000880898014
Task_19011,2203,165,73,143,216,13.271084337349398,42.282193341351814
Task_19012,1455,846,157,168,325,1.717827626918536,33.3246640421987
Task_19013,1921,215,155,145,300,8.893518518518519,38.53017321893991
Task_19014,1656,389,134,171,305,4.246153846153846,34.99548338238492
Task_19015,2602,131,29,196,225,19.71212121212121,48.353177406498844
Task_19016,1572,499,11,125,136,3.144,32.94755388690316
Task_19017,1087,182,113,10,123,5.939890710382514,23.46543003239836
Task_19018,2720,367,88,10,98,7.391304347826087,49.63270475145658
Task_19019,1461,595,150,174,324,2.4513422818791946,32.65407254958644
Task_19020,1603,591,29,55,84,2.70777027027027,32.846064143265465
Task_19021,1779,845,78,43,121,2.102836879432624,36.55683915107635
Task_19022,2278,700,153,81,234,3.2496433666191153,45.27821370527462
Task_19023,1460,888,176,52,228,1.642294713160855,32.685597089509436
Task_19024,1405,982,183,171,354,1.429298067141404,33.04901866099879
Task_19025,1541,910,176,84,260,1.6915477497255762,34.39948178767301
Task_19026,2567,911,152,20,172,2.8146929824561404,49.66587416594666
Task_19027,559,188,56,198,254,2.9576719576719577,16.89503690834788
Task_19028,548,388,16,133,149,1.4087403598971722,16.453439282422163
Task_19029,2430,485,62,92,154,5.0,46.59980934555509
Task_19030,1070,297,72,196,268,3.5906040268456376,25.357109452659937
Task_19031,2323,424,57,180,237,5.465882352941176,45.43754947224056
Task_19032,1977,378,134,184,318,5.216358839050132,40.115976620691846
Task_19033,1777,795,123,115,238,2.2324120603015074,37.81114649575867
Task_19034,683,339,184,45,229,2.0088235294117647,18.38889001651671
Task_19035,2860,469,29,17,46,6.085106382978723,51.52986842441288
Task_19036,2301,935,94,146,240,2.4583333333333335,46.61499901457953
Task_19037,587,922,148,180,328,0.6359696641386782,19.94196030066769
Task_19038,752,658,125,191,316,1.1411229135053111,21.5418309061383
Task_19039,2933,817,190,187,377,3.5855745721271393,56.92689282690346
Task_19040,1269,135,13,54,67,9.330882352941176,25.53149747023437
Task_19041,1172,238,181,26,207,4.903765690376569,25.66138885956556
Task_19042,2222,864,182,174,356,2.56878612716763,45.695310895654075
Task_19043,2517,212,46,70,116,11.816901408450704,46.602566634669095
Task_19044,1821,464,90,179,269,3.9161290322580644,37.69251057373021
Task_19045,2003,280,67,88,155,7.128113879003559,39.22585291882139
Task_19046,1349,588,28,38,66,2.2903225806451615,28.21141030180144
Task_19047,1323,578,58,38,96,2.284974093264249,28.185985954562714
Task_19048,775,184,13,94,107,4.1891891891891895,18.919231724689194
Task_19049,1374,989,120,127,247,1.387878787878788,32.03265918097669
Task_19050,2716,954,23,83,106,2.843979057591623,52.18378015227062
Task_19051,2603,69,197,62,259,37.18571428571428,47.36877605663633
Task_19052,1536,263,41,36,77,5.818181818181818,30.208789519009514
Task_19053,2842,341,37,15,52,8.309941520467836,50.89061599380551
Task_19054,1008,397,130,188,318,2.5326633165829144,24.851500693309532
Task_19055,1246,340,124,81,205,3.653958944281525,27.663605950620262
Task_19056,1376,193,132,99,231,7.092783505154639,29.45658159098615
Task_19057,1560,452,34,147,181,3.443708609271523,33.062857987536155
Task_19058,2293,973,164,91,255,2.3542094455852154,46.52834578211773
Task_19059,967,963,22,169,191,1.0031120331950207,25.213826906799653
Task_19060,2189,847,134,170,304,2.581367924528302,44.87912788517871
Task_19061,1947,1009,122,155,277,1.9277227722772277,41.40516927952208
Task_19062,1744,952,73,50,123,1.8300104931794334,36.52397720031879
Task_19063,1614,144,89,92,181,11.13103448275862,32.44709564398578
Task_19064,2272,376,22,129,151,6.026525198938992,43.71744983930875
Task_19065,827,497,92,66,158,1.6606425702811245,20.99481194045605
Task_19066,1080,814,147,113,260,1.3251533742331287,26.876871097289925
Task_19067,1374,277,35,200,235,4.942446043165468,29.907991305926895
Task_19068,502,201,124,105,229,2.485148514851485,15.70010254564094
Task_19069,1476,987,40,109,149,1.4939271255060729,33.02790090901953
Task_19070,2632,294,170,44,214,8.922033898305084,48.9963774476416
Task_19071,2436,862,133,199,332,2.8227114716106603,49.008273221367936
Task_19072,500,620,151,37,188,0.8051529790660226,16.242748110015974
Task_19073,2707,156,47,196,243,17.24203821656051,50.31256555105745
Task_19074,814,944,121,43,164,0.8613756613756614,22.139141427297517
Task_19075,2365,744,26,123,149,3.174496644295302,46.387429569510516
Task_19076,1144,235,77,151,228,4.8474576271186445,26.0812411131993
Task_19077,927,751,171,102,273,1.2327127659574468,24.28245921147884
Task_19078,2939,769,182,33,215,3.8168831168831168,55.406195023150424
Task_19079,2254,488,110,199,309,4.6094069529652355,44.83924329354687
Task_19080,994,877,56,171,227,1.132118451025057,25.67604978133804
Task_19081,1814,647,40,110,150,2.799382716049383,37.33800671000195
Task_19082,2618,341,36,98,134,7.654970760233918,49.02634331238655
Task_19083,1403,266,190,122,312,5.254681647940075,30.5477652914297
Task_19084,528,200,126,129,255,2.626865671641791,16.259593215661237
Task_19085,2031,905,117,125,242,2.2417218543046356,42.21112901063389
Task_19086,2702,171,200,59,259,15.709302325581396,49.865808764048175
Task_19087,2099,166,165,71,236,12.568862275449101,40.31352745516063
Task_19088,2229,982,14,148,162,2.2675483214649033,45.11186024381135
Task_19089,2623,583,155,58,213,4.491438356164384,50.03454718929735
Task_19090,997,745,181,67,248,1.3364611260053618,24.981485667791077
Task_19091,1749,530,24,84,108,3.2937853107344632,35.570953225624315
Task_19092,2420,991,88,150,238,2.439516129032258,48.62053181664285
Task_19093,2032,489,173,39,212,4.146938775510204,40.14519051239986
Task_19094,737,968,79,54,133,0.760577915376677,21.004823123907624
Task_19095,931,916,172,82,254,1.015267175572519,24.656171859179395
Task_19096,2421,846,48,174,222,2.858323494687131,48.2479877058229
Task_19097,2864,508,142,115,257,5.626719056974459,54.2035229936223
Task_19098,1508,207,187,47,234,7.25,31.04540755160217
Task_19099,2110,549,60,145,205,3.8363636363636364,42.27625987596599
Task_19100,2862,406,121,144,265,7.031941031941032,53.914546227814206
Task_19101,2839,748,194,122,316,3.7903871829105475,54.850148169154295
Task_19102,2613,80,115,39,154,32.25925925925926,46.56377355877061
Task_19103,2600,708,143,50,193,3.6671368124118477,49.848641155101944
Task_19104,1299,974,166,157,323,1.3323076923076924,31.191219673025234
Task_19105,1565,459,14,76,90,3.402173913043478,32.092857205463886
Task_19106,2119,479,75,121,196,4.414583333333334,42.114323035326706
Task_19107,1519,991,88,57,145,1.53125,33.41081730461202
Task_19108,1912,154,128,57,185,12.335483870967742,36.963263400088245
Task_19109,1067,205,90,139,229,5.179611650485437,24.676631414051844
Task_19110,1022,314,40,194,234,3.2444444444444445,24.44719022957283
Task_19111,1799,67,188,73,261,26.455882352941178,34.894783788999554
Task_19112,2450,149,120,193,313,16.333333333333332,46.55173075564045
Task_19113,1713,497,191,41,232,3.4397590361445785,35.21326416004007
Task_19114,776,937,92,114,206,0.8272921108742004,22.19450202192679
Task_19115,2002,429,190,73,263,4.655813953488372,40.03775998451719
Task_19116,2208,79,108,51,159,27.6,40.45138904689591
Task_19117,1449,600,35,157,192,2.410981697171381,31.87408351436579
Task_19118,1149,320,175,66,241,3.5794392523364484,26.031297896560748
Task_19119,1530,594,48,41,89,2.5714285714285716,31.5042165459142
Task_19120,1207,285,44,79,123,4.22027972027972,26.395451828982036
Task_19121,2534,83,123,93,216,30.166666666666668,46.6195973023924
Task_19122,1646,778,40,23,63,2.1129653401797177,33.477831557461776
Task_19123,1458,779,34,35,69,1.8692307692307693,30.559636237293358
Task_19124,1837,715,147,63,210,2.565642458100559,38.02672650378946
Task_19125,1125,493,141,167,308,2.277327935222672,26.930852269286902
Task_19126,936,443,89,144,233,2.108108108108108,23.388909145753075
Task_19127,2067,927,69,119,188,2.2273706896551726,42.65681508029895
Task_19128,637,649,175,38,213,0.98,18.650147857271005
Task_19129,1431,584,50,182,232,2.4461538461538463,31.839693385578286
Task_19130,2557,357,31,136,167,7.14245810055866,48.42132926313175
Task_19131,1831,706,44,99,143,2.5898161244695896,37.7569666061106
Task_19132,1524,911,124,22,146,1.6710526315789473,32.99200328454916
Task_19133,2319,477,30,127,157,4.851464435146443,44.858340461713006
Task_19134,1310,862,186,38,224,1.517960602549247,29.946668996927002
Task_19135,1424,184,199,189,388,7.697297297297298,30.953858184651654
Task_19136,564,153,59,136,195,3.6623376623376624,16.268695300973974
Task_19137,516,431,46,53,99,1.1944444444444444,15.235428877065075
Task_19138,1129,824,196,166,362,1.3684848484848484,28.22163246169208
Task_19139,2507,836,69,80,149,2.995221027479092,48.983033253997
Task_19140,1148,147,195,10,205,7.756756756756757,24.708731658238406
Task_19141,880,708,19,11,30,1.2411847672778562,20.856042444587054
Task_19142,1345,98,44,150,194,13.585858585858587,28.054095324323722
Task_19143,2334,504,129,52,181,4.6217821782178214,45.08401736449625
Task_19144,2175,551,105,138,243,3.9402173913043477,43.40348647272483
Task_19145,2797,243,89,83,172,11.46311475409836,51.665094477813625
Task_19146,2097,851,50,55,105,2.461267605633803,41.66282821429255
Task_19147,1485,562,152,148,300,2.6376554174067497,32.78407340201053
Task_19148,556,781,186,74,260,0.710997442455243,18.417830916525364
Task_19149,728,377,142,120,262,1.9259259259259258,20.0058917605765
Task_19150,868,219,101,190,291,3.9454545454545453,21.94228264135646
Task_19151,719,520,176,151,327,1.3800383877159308,20.596035389079844
Task_19152,691,308,55,10,65,2.236245954692557,16.697741483696515
Task_19153,2978,115,136,120,256,25.67241379310345,54.16187947713703
Task_19154,827,644,21,159,180,1.2821705426356589,21.98037615316299
Task_19155,1788,95,153,123,276,18.625,35.32556867579145
Task_19156,2207,477,152,87,239,4.617154811715481,43.51868413180254
Task_19157,1646,663,11,31,42,2.4789156626506026,33.02983580087868
Task_19158,514,934,134,75,209,0.5497326203208556,18.02287464369994
Task_19159,678,900,119,195,314,0.7524972253052165,21.162116369166633
Task_19160,1104,363,137,186,323,3.032967032967033,26.28148857244963
Task_19161,2900,368,48,151,199,7.8590785907859075,54.160085573640565
Task_19162,519,322,118,85,203,1.6068111455108358,16.12284854622872
Task_19163,639,405,178,126,304,1.5738916256157636,18.841131363958787
Task_19164,628,353,120,167,287,1.7740112994350283,18.516343650014438
Task_19165,2977,1022,167,122,289,2.9100684261974585,57.774048936259966
Task_19166,1704,659,58,172,230,2.581818181818182,36.346719946884996
Task_19167,969,134,106,193,299,7.177777777777778,23.023738626862137
Task_19168,1977,242,91,83,174,8.135802469135802,38.74412706326824
Task_19169,1601,437,113,160,273,3.6552511415525113,34.11960419590792
Task_19170,604,445,27,122,149,1.3542600896860986,17.519337805680713
Task_19171,1383,506,85,150,235,2.727810650887574,30.70842150097233
Task_19172,1189,692,14,129,143,1.7157287157287158,27.54917128163893
Task_19173,685,83,10,113,123,8.154761904761905,16.723305026843992
Task_19174,1577,182,130,28,158,8.617486338797814,31.55711318247914
Task_19175,2995,670,159,134,293,4.463487332339791,56.98818742417416
Task_19176,2312,629,55,17,72,3.6698412698412697,43.4190513095314
Task_19177,2516,473,11,60,71,5.30801687763713,46.56239418726008
Task_19178,1330,389,133,22,155,3.41025641025641,28.26690004247011
Task_19179,664,911,112,39,151,0.7280701754385965,19.588534205699915
Task_19180,688,911,172,150,322,0.7543859649122807,21.324635223051754
Task_19181,2804,995,145,188,333,2.8152610441767068,55.243305561242984
Task_19182,2868,863,82,79,161,3.3194444444444446,54.73951923740086
Task_19183,2802,604,114,136,250,4.6314049586776855,53.53017790416211
Task_19184,1484,875,163,162,325,1.6940639269406392,33.865450766218935
Task_19185,2788,236,152,65,217,11.763713080168776,51.54950315950981
Task_19186,2044,683,84,184,268,2.9883040935672516,41.93639380998311
Task_19187,859,791,50,117,167,1.0845959595959596,22.88566054658143
Task_19188,2260,481,27,29,56,4.6887966804979255,42.30367353849055
Task_19189,761,277,131,182,313,2.737410071942446,20.529789551414606
Task_19190,1212,907,134,78,212,1.3348017621145374,28.87993416617222
Task_19191,2075,420,29,78,107,4.92874109263658,40.31373637144237
Task_19192,2244,982,77,21,98,2.2828077314343846,44.07549156456016
Task_19193,2231,796,187,91,278,2.7992471769134255,45.097157793757695
Task_19194,668,1002,40,197,237,0.6660019940179461,21.08140349990438
Task_19195,2761,295,54,173,227,9.327702702702704,51.87615222504619
Task_19196,2091,527,184,187,371,3.960227272727273,42.64562171219248
Task_19197,1577,558,32,73,105,2.821109123434705,32.75478550783597
Task_19198,2407,625,108,190,298,3.8450479233226837,47.63684551179691
Task_19199,637,668,149,19,168,0.9521674140508222,18.425176834804645
Task_19200,1787,243,107,104,211,7.323770491803279,36.05415808533999
Task_19201,1898,760,161,53,214,2.4940867279894876,39.16782151325997
Task_19202,1855,735,105,137,242,2.520380434782609,38.90966082859587
Task_19203,1029,318,113,139,252,3.225705329153605,24.561452601727296
Task_19204,2974,886,48,21,69,3.3528748590755355,54.81378239666583
Task_19205,948,200,38,175,213,4.7164179104477615,22.777069621800205
Task_19206,2102,808,180,170,350,2.5982694684796046,43.58618375115535
Task_19207,2954,120,162,135,297,24.41322314049587,54.082880148806304
Task_19208,886,460,120,57,177,1.9219088937093276,21.95936314197047
Task_19209,2303,912,187,140,327,2.5224534501642935,46.948000261188206
Task_19210,1335,387,25,90,115,3.4407216494845363,28.67182960288225
Task_19211,2370,1012,184,133,317,2.3395853899308983,48.26589656863348
Task_19212,2144,354,200,159,359,6.03943661971831,42.826432466678945
Task_19213,2211,734,79,197,276,3.0081632653061225,44.84726204453286
Task_19214,2937,1013,192,19,211,2.896449704142012,56.038557883558646
Task_19215,1144,998,58,135,193,1.145145145145145,28.228818150396194
Task_19216,1091,214,71,98,169,5.074418604651163,24.781796886146783
Task_19217,1242,701,29,44,73,1.7692307692307692,26.880750508022448
Task_19218,1482,543,31,109,140,2.724264705882353,31.700933794716615
Task_19219,1496,789,41,164,205,1.8936708860759495,33.27643277332218
Task_19220,959,180,122,127,249,5.298342541436464,22.736030034677906
Task_19221,1178,770,162,33,195,1.5278858625162126,27.41816689001588
Task_19222,1621,951,36,84,120,1.7027310924369747,35.00643260828209
Task_19223,1989,885,32,188,220,2.244920993227991,41.47399816771796
Task_19224,2499,488,199,180,379,5.110429447852761,49.00537672507943
Task_19225,1279,425,162,61,223,3.0023474178403755,28.285979762026695
Task_19226,532,960,111,26,137,0.5535900104058272,17.616743145698013
Task_19227,2319,911,61,120,181,2.5427631578947367,46.54039350622767
Task_19228,1391,821,119,173,292,1.6922141119221412,32.09156034481392
Task_19229,1861,581,156,17,173,3.1975945017182132,37.434006880452216
Task_19230,957,712,109,182,291,1.3422159887798037,24.852653315606954
Task_19231,2953,428,151,137,288,6.883449883449884,55.52145721473308
Task_19232,2078,224,29,24,53,9.235555555555555,38.49539688864884
Task_19233,1825,872,75,38,113,2.0904925544100803,37.3637499702045
Task_19234,515,648,114,191,305,0.7935285053929122,17.77667724448362
Task_19235,1912,475,183,120,303,4.016806722689076,39.24067637893804
Task_19236,1817,245,63,70,133,7.3861788617886175,35.890383388292896
Task_19237,560,901,81,198,279,0.6208425720620843,19.337675401585344
Task_19238,1792,892,73,20,93,2.0067189249720045,36.61538002883571
Task_19239,2202,550,169,99,268,3.9963702359346644,43.8773591781629
Task_19240,2583,998,97,114,211,2.5855855855855854,51.099830395174216
Task_19241,870,112,53,137,190,7.699115044247788,20.74153357813823
Task_19242,1381,484,149,10,159,2.8474226804123712,29.3676426044269
Task_19243,2219,290,145,88,233,7.625429553264605,43.06324651613173
Task_19244,2156,426,159,155,314,5.049180327868853,43.0451264961283
Task_19245,849,264,94,23,117,3.2037735849056603,19.95881222144919
Task_19246,2428,113,108,16,124,21.29824561403509,43.988907016470876
Task_19247,2626,385,75,15,90,6.803108808290156,48.172625503268755
Task_19248,2006,177,72,107,179,11.269662921348315,38.86911418893622
Task_19249,1339,395,101,135,236,3.3813131313131315,29.635293752172526
Task_19250,1302,127,35,74,109,10.171875,26.51960263262701
Task_19251,2013,253,112,197,309,7.925196850393701,40.238450862552156
Task_19252,794,186,59,87,146,4.245989304812834,19.863107779331468
Task_19253,1922,352,71,84,155,5.444759206798867,38.149197981916366
Task_19254,2967,132,178,35,213,22.30827067669173,53.31835674541558
Task_19255,2366,497,57,150,207,4.751004016064257,46.17622181067323
Task_19256,1120,560,16,138,154,1.9964349376114081,26.077338921142744
Task_19257,2064,299,128,101,229,6.88,40.70408676130218
Task_19258,682,468,127,66,193,1.4541577825159915,18.879596765466335
Task_19259,1619,173,38,118,156,9.304597701149426,32.341854868153796
Task_19260,838,176,59,166,225,4.734463276836158,20.791740035967134
Task_19261,2838,528,150,135,285,5.3648393194707,54.01223860071087
Task_19262,2090,562,145,53,198,3.7122557726465364,41.513245375098855
Task_19263,1852,283,193,108,301,6.52112676056338,37.63239248998101
Task_19264,1566,78,98,11,109,19.82278481012658,29.71932788561163
Task_19265,904,984,65,76,141,0.917766497461929,23.913094465826873
Task_19266,2342,915,45,113,158,2.556768558951965,46.610563118646375
Task_19267,2885,277,73,61,134,10.377697841726619,52.76575537180398
Task_19268,695,605,32,154,186,1.146864686468647,19.786953422697653
Task_19269,2626,166,110,33,143,15.724550898203592,47.719268542218884
Task_19270,1289,145,133,114,247,8.82876712328767,27.810807677333212
Task_19271,2334,727,134,150,284,3.206043956043956,46.680883305367814
Task_19272,2036,748,151,145,296,2.718291054739653,42.07279602321764
Task_19273,2490,267,132,64,196,9.291044776119403,46.8453720259668
Task_19274,2917,338,102,174,276,8.604719764011799,54.64666121074797
Task_19275,1902,369,100,158,258,5.140540540540541,38.59124616084817
Task_19276,1443,277,101,105,206,5.190647482014389,30.714444798317952
Task_19277,1275,524,20,102,122,2.4285714285714284,28.204068860135322
Task_19278,1533,466,87,141,228,3.2826552462526766,32.86558886961654
Task_19279,924,647,108,31,139,1.4259259259259258,22.603499556300637
Task_19280,2485,295,100,39,139,8.39527027027027,46.176257401798445
Task_19281,573,477,146,165,311,1.198744769874477,18.09328761240698
Task_19282,2917,168,119,190,309,17.2603550295858,53.96923408865948
Task_19283,1993,375,100,61,161,5.300531914893617,39.03897325870865
Task_19284,1048,225,25,197,222,4.6371681415929205,24.490066440033967
Task_19285,1614,1012,149,151,300,1.5932872655478776,36.22173067821689
Task_19286,2381,630,19,31,50,3.77337559429477,44.65999938894464
Task_19287,2140,839,84,57,141,2.5476190476190474,42.771669103301065
Task_19288,1443,688,54,131,185,2.0943396226415096,32.0073367310093
Task_19289,2546,495,197,165,362,5.133064516129032,49.673490066950684
Task_19290,509,741,170,158,328,0.6859838274932615,18.112673602039962
Task_19291,1935,181,167,88,255,10.631868131868131,38.07892488941486
Task_19292,2874,166,50,189,239,17.209580838323355,53.02365399267822
Task_19293,2059,722,142,31,173,2.847856154910097,41.113820819667204
Task_19294,1024,184,88,33,121,5.535135135135135,22.519014734599107
Task_19295,948,243,162,183,345,3.8852459016393444,23.519183097620395
Task_19296,1373,253,52,169,221,5.405511811023622,29.76032661952425
Task_19297,1054,730,186,36,222,1.441860465116279,25.455969949899398
Task_19298,1474,491,174,168,342,2.9959349593495936,32.604200950524785
Task_19299,1954,540,157,18,175,3.611829944547135,38.79732443496214
Task_19300,1021,991,10,170,180,1.029233870967742,26.10090164015178
Task_19301,2731,863,71,67,138,3.1608796296296298,52.31679904254159
Task_19302,1291,444,57,98,155,2.901123595505618,28.4969822951717
Task_19303,2323,90,62,158,220,25.52747252747253,43.59484756196097
Task_19304,2103,661,22,123,145,3.176737160120846,41.94980385869247
Task_19305,2760,872,18,165,183,3.161512027491409,53.402020616720144
Task_19306,2848,357,63,17,80,7.955307262569832,51.346667914111
Task_19307,2465,331,126,67,193,7.424698795180723,46.66614466631797
Task_19308,2480,190,15,157,172,12.984293193717278,46.60808729489483
Task_19309,2479,812,43,30,73,3.0492004920049203,46.859847738519534
Task_19310,2570,655,188,194,382,3.917682926829268,50.69805398899914
Task_19311,2299,138,199,113,312,16.53956834532374,43.92994692301369
Task_19312,2331,915,79,116,195,2.5447598253275108,46.83093407364303
Task_19313,1724,219,175,139,314,7.836363636363636,35.4884567901155
Task_19314,2769,397,141,86,227,6.957286432160804,52.09018846706331
Task_19315,565,980,31,177,208,0.5759429153924567,19.2291800853981
Task_19316,1089,455,81,92,173,2.388157894736842,25.504059437148126
Task_19317,1759,205,155,144,299,8.53883495145631,35.92926114310699
Task_19318,1191,878,167,80,247,1.3549488054607508,28.631681509731354
Task_19319,522,593,122,66,188,0.8787878787878788,16.756354840369344
Task_19320,1670,669,74,80,154,2.4925373134328357,35.119118187837735
Task_19321,2416,505,125,149,274,4.774703557312253,47.227649993425
Task_19322,1516,721,97,180,277,2.0997229916897506,33.72422268406177
Task_19323,1780,444,96,59,155,4.0,35.86141349969386
Task_19324,835,70,183,51,234,11.76056338028169,19.432208239580948
Task_19325,1397,249,31,135,166,5.588,29.722660134176042
Task_19326,1743,155,160,71,231,11.173076923076923,34.603494033115545
Task_19327,1833,858,107,182,289,2.1338766006984864,39.22284104859795
Task_19328,802,85,170,82,252,9.325581395348838,19.499282920665852
Task_19329,2362,939,26,24,50,2.5127659574468084,45.279891642135226
Task_19330,1232,932,180,70,250,1.3204715969989282,29.29496936883848
Task_19331,2072,663,123,69,192,3.1204819277108435,41.5096884631905
Task_19332,940,692,164,132,296,1.3564213564213565,24.47049426872412
Task_19333,2239,442,22,181,203,5.054176072234763,43.930402432187186
Task_19334,826,104,83,79,162,7.866666666666666,19.374627740214226
Task_19335,1810,355,91,14,105,5.084269662921348,35.28019172063107
Task_19336,2155,439,69,83,152,4.8977272727272725,42.088473324079644
Task_19337,1910,499,107,99,206,3.82,38.81192129848228
Task_19338,1831,989,158,25,183,1.8494949494949495,38.32353674972167
Task_19339,2592,943,63,77,140,2.7457627118644066,50.509708703759486
Task_19340,2788,228,191,59,250,12.174672489082969,51.59696704002571
Task_19341,668,768,193,198,391,0.8686605981794538,20.939604732322493
Task_19342,756,1018,191,49,240,0.7419038272816487,21.830914131106336
Task_19343,1356,1022,24,137,161,1.3255131964809383,31.29150716395884
Task_19344,1174,90,94,149,243,12.901098901098901,25.609465691560715
Task_19345,1137,72,146,120,266,15.575342465753424,25.0200946166316
Task_19346,617,488,162,198,360,1.261758691206544,19.091837905124283
Task_19347,2195,860,31,64,95,2.5493612078977934,43.302196693989906
Task_19348,1151,921,129,42,171,1.2483731019522777,27.330364661115283
Task_19349,2519,152,164,59,223,16.464052287581698,46.73026005393985
Task_19350,703,526,66,56,122,1.333965844402277,18.76177411973932
Task_19351,2775,669,155,166,321,4.141791044776119,53.67347366976073
Task_19352,656,638,182,167,349,1.02660406885759,20.0816459135437
Task_19353,1375,478,146,85,231,2.8705636743215033,30.29680335587752
Task_19354,581,959,41,37,78,0.6052083333333333,17.71770726489861
Task_19355,2700,296,34,174,208,9.090909090909092,50.77316851803756
Task_19356,2246,278,50,104,154,8.050179211469533,43.049854934602955
Task_19357,2837,817,79,182,261,3.468215158924205,54.935780688345865
Task_19358,2777,645,39,186,225,4.298761609907121,53.23543353766363
Task_19359,2336,136,66,149,215,17.05109489051095,44.19301681610107
Task_19360,631,715,173,167,340,0.8812849162011173,19.914182166936346
Task_19361,1369,174,43,129,172,7.822857142857143,28.721603111933618
Task_19362,2385,494,192,39,231,4.818181818181818,45.83519214316899
Task_19363,1908,408,75,93,168,4.665036674816626,38.314095920342744
Task_19364,1093,261,54,101,155,4.17175572519084,24.771467554495022
Task_19365,1560,143,66,32,98,10.833333333333334,30.310326563447394
Task_19366,543,1019,174,152,326,0.5323529411764706,19.499417371737923
Task_19367,1871,136,52,128,180,13.656934306569344,36.56771090375174
Task_19368,1344,547,18,48,66,2.4525547445255476,28.123855819137656
Task_19369,556,649,88,42,130,0.8553846153846154,16.86554259769674
Task_19370,2547,840,115,181,296,3.028537455410226,50.509500198589
Task_19371,1880,455,142,56,198,4.12280701754386,37.797033197474924
Task_19372,712,489,168,108,276,1.453061224489796,20.09565182964678
Task_19373,2549,551,43,123,166,4.617753623188406,48.938599820927266
Task_19374,2501,336,97,139,236,7.421364985163205,47.83633304953124
Task_19375,1854,837,109,86,195,2.2124105011933173,38.857455919405794
Task_19376,1760,181,123,92,215,9.67032967032967,35.128288994815144
Task_19377,1999,762,153,78,231,2.6199213630406293,41.01635614467573
Task_19378,2821,257,87,83,170,10.934108527131784,52.074310557789424
Task_19379,2458,188,191,138,329,13.005291005291005,47.053194652106534
Task_19380,608,94,17,51,68,6.4,14.716876147878429
Task_19381,999,910,10,124,134,1.0965971459934138,25.091436349977357
Task_19382,2976,520,41,176,217,5.712092130518234,55.937600411278936
Task_19383,995,858,102,102,204,1.1583236321303843,25.37604400731122
Task_19384,1179,691,28,140,168,1.703757225433526,27.66688941241847
Task_19385,2415,215,25,164,189,11.180555555555555,45.840506227007914
Task_19386,751,503,128,123,251,1.4900793650793651,20.677201695016528
Task_19387,2543,774,158,36,194,3.281290322580645,49.053468729393664
Task_19388,2092,85,104,126,230,24.325581395348838,39.87272046630212
Task_19389,1749,302,158,15,173,5.772277227722772,34.75098589139083
Task_19390,2976,331,60,25,85,8.963855421686747,53.405927543682274
Task_19391,2329,334,147,127,274,6.95223880597015,45.25515558526214
Task_19392,1391,435,109,160,269,3.1903669724770642,30.771562275353883
Task_19393,1855,514,139,82,221,3.6019417475728157,37.96653029453863
Task_19394,1440,109,49,157,206,13.090909090909092,29.781127454199616
Task_19395,1638,711,39,19,58,2.300561797752809,33.06345558438178
Task_19396,2911,756,62,70,132,3.845442536327609,54.867043038203626
Task_19397,942,404,13,138,151,2.325925925925926,22.769875328173214
Task_19398,982,586,148,112,260,1.6729131175468483,24.647617561150906
Task_19399,820,939,52,154,206,0.8723404255319149,22.998734351903376
Task_19400,1897,275,165,188,353,6.8731884057971016,38.667710068446446
Task_19401,506,214,104,143,247,2.353488372093023,15.94243854396718
Task_19402,2979,717,189,122,311,4.149025069637883,56.947415926384
Task_19403,1627,588,71,178,249,2.762308998302207,34.98864545298875
Task_19404,1206,127,119,40,159,9.421875,25.05898111762994
Task_19405,1099,151,37,188,225,7.230263157894737,24.827866288373553
Task_19406,1173,555,62,47,109,2.1097122302158273,25.866363141123358
Task_19407,2465,581,96,108,204,4.2353951890034365,47.879247141500315
Task_19408,716,955,65,177,242,0.7489539748953975,21.63281760240045
Task_19409,2626,955,140,88,228,2.7468619246861925,51.61883363908973
Task_19410,606,876,160,152,312,0.6909920182440137,19.978021049555487
Task_19411,1320,266,182,87,269,4.943820224719101,28.92955744295737
Task_19412,1264,784,123,168,291,1.6101910828025479,29.952652082883493
Task_19413,2031,1023,124,167,291,1.9833984375,42.86051134772686
Task_19414,1601,960,185,82,267,1.6659729448491154,35.53748201610561
Task_19415,2395,165,167,76,243,14.427710843373495,45.05362891312291
Task_19416,733,376,107,161,268,1.9442970822281167,20.168985181805997
Task_19417,2595,785,139,144,283,3.301526717557252,50.98463622341037
Task_19418,2026,84,164,22,186,23.83529411764706,37.7152807841117
Task_19419,1250,629,55,110,165,1.9841269841269842,28.648400507703954
Task_19420,1107,184,35,87,122,5.9837837837837835,24.344073951371133
Task_19421,2670,186,48,131,179,14.27807486631016,49.71939695928817
Task_19422,2306,65,200,116,316,34.93939393939394,43.51818203729194
Task_19423,1982,67,159,119,278,29.147058823529413,38.277229417902596
Task_19424,1633,753,111,104,215,2.1657824933687,35.279000716241256
Task_19425,614,514,76,180,256,1.192233009708738,18.69056506960382
Task_19426,1425,907,134,18,152,1.5693832599118942,31.309444402263892
Task_19427,1221,969,169,90,259,1.2587628865979381,29.511089096184552
Task_19428,1888,517,149,129,278,3.6447876447876446,38.89551174378966
Task_19429,1243,137,24,37,61,9.007246376811594,24.983980253044766
Task_19430,865,977,42,136,178,0.8844580777096115,23.609973436804705
Task_19431,2470,282,56,96,152,8.72791519434629,46.613480771137354
Task_19432,2396,72,168,136,304,32.821917808219176,44.91450810946852
Task_19433,520,133,49,137,186,3.8805970149253732,15.354751860068303
Task_19434,2207,941,185,31,216,2.342887473460722,44.35545070797326
Task_19435,608,406,45,66,111,1.4938574938574938,16.935342814257055
Task_19436,1604,490,154,165,319,3.2668024439918533,34.5509609980049
Task_19437,1361,475,109,120,229,2.8592436974789917,30.18499122599886
Task_19438,2898,752,177,70,247,3.848605577689243,55.13249488652783
Task_19439,2566,546,153,60,213,4.691042047531993,49.0053619028694
Task_19440,1850,535,171,168,339,3.451492537313433,38.68322865362333
Task_19441,2233,581,182,183,365,3.836769759450172,45.03324657434882
Task_19442,868,480,86,180,266,1.8045738045738047,22.61161167346064
Task_19443,1427,538,59,20,79,2.647495361781076,29.257712657662978
Task_19444,627,783,150,60,210,0.7997448979591837,19.06437427203065
Task_19445,1452,741,53,173,226,1.9568733153638813,32.59699336615842
Task_19446,2498,815,140,63,203,3.0612745098039214,48.78020936353462
Task_19447,2586,927,74,196,270,2.7866379310344827,51.36488791362623
Task_19448,2301,400,47,199,246,5.738154613466334,45.052586453473005
Task_19449,1327,476,180,185,365,2.7819706498951784,30.35819350275329
Task_19450,2123,505,85,87,172,4.195652173913044,41.971742528067956
Task_19451,1630,978,116,180,296,1.664964249233912,36.394324566153045
Task_19452,1555,943,196,178,374,1.6472457627118644,35.44587484737597
Task_19453,2592,281,43,14,57,9.191489361702128,46.757683028668716
Task_19454,2614,571,192,148,340,4.56993006993007,50.870682086439594
Task_19455,2573,512,119,91,210,5.015594541910332,49.30742688068214
Task_19456,1232,991,185,198,383,1.2419354838709677,30.495067169464377
Task_19457,741,931,200,29,229,0.7950643776824035,21.197563594699215
Task_19458,2668,198,110,105,215,13.407035175879397,49.85487756410324
Task_19459,1178,656,67,142,209,1.7929984779299848,27.872142445747937
Task_19460,867,548,197,115,312,1.5792349726775956,22.917477949858284
Task_19461,2222,198,82,29,111,11.165829145728644,41.390958748877075
Task_19462,2867,689,126,104,230,4.155072463768116,54.69311950470372
Task_19463,1920,894,13,42,55,2.1452513966480447,38.27501658498372
Task_19464,1048,625,92,151,243,1.6741214057507987,25.80269316462621
Task_19465,2112,93,200,170,370,22.46808510638298,40.928529602359596
Task_19466,1169,1015,94,199,293,1.1505905511811023,29.164711913603323
Task_19467,864,761,67,56,123,1.1338582677165354,22.151924152166107
Task_19468,2413,136,181,70,251,17.613138686131386,45.04675732351888
Task_19469,1220,789,82,95,177,1.5443037974683544,28.663585380498546
Task_19470,2321,901,130,129,259,2.573170731707317,46.87629645588854
Task_19471,512,664,38,36,74,0.7699248120300752,15.373324816041764
Task_19472,1916,878,196,157,353,2.179749715585893,40.85204237107863
Task_19473,1736,894,133,148,281,1.9396648044692737,37.71202843492333
Task_19474,1938,665,149,18,167,2.90990990990991,38.90163096551344
Task_19475,1380,108,104,108,212,12.660550458715596,28.74766497112878
Task_19476,2696,965,191,185,376,2.790890269151139,53.62765302858372
Task_19477,1879,375,62,93,155,4.997340425531915,37.58890979544338
Task_19478,2176,150,114,29,143,14.410596026490067,40.5069340165453
Task_19479,1360,928,125,79,204,1.463939720129171,31.26014176267736
Task_19480,2643,359,34,92,126,7.341666666666667,49.491545143428034
Task_19481,1163,790,77,66,143,1.470290771175727,27.264714450010334
Task_19482,2283,644,130,78,208,3.5395348837209304,45.04034089099366
Task_19483,2644,88,89,68,157,29.707865168539325,47.40687292583644
Task_19484,504,149,82,40,122,3.36,13.844099657067012
Task_19485,1735,822,125,143,268,2.1081409477521262,37.406160514041005
Task_19486,921,177,122,27,149,5.174157303370786,20.898608338140743
Task_19487,2242,404,34,142,176,5.5358024691358025,43.68284059474024
Task_19488,2150,403,34,147,181,5.321782178217822,42.24162796653119
Task_19489,2406,785,196,20,216,3.0610687022900764,46.93756036102118
Task_19490,1068,375,88,59,147,2.8404255319148937,24.356898037446445
Task_19491,885,79,197,140,337,11.0625,21.423875611016893
Task_19492,821,920,164,159,323,0.8914223669923995,23.472147060145662
Task_19493,805,954,50,158,208,0.8429319371727748,22.860437588819348
Task_19494,1910,351,136,156,292,5.426136363636363,38.80860242708982
Task_19495,1348,796,21,53,74,1.6913425345043915,29.1191929010233
Task_19496,1482,762,140,85,225,1.9423328964613369,32.85511526976352
Task_19497,2810,728,105,167,272,3.8545953360768177,54.195262673685875
Task_19498,962,993,10,191,201,0.9678068410462777,25.33219764740834
Task_19499,973,461,150,171,321,2.106060606060606,24.48844899922969
Task_19500,584,215,164,158,322,2.7037037037037037,17.537314709282665
Task_19501,2179,178,65,107,172,12.1731843575419,41.55353130515568
Task_19502,907,99,147,55,202,9.07,20.710255555452434
Task_19503,1933,985,95,58,153,1.960446247464503,39.94966268878978
Task_19504,1406,611,133,200,333,2.2973856209150325,31.91192794888799
Task_19505,2015,966,197,133,330,2.0837642192347468,42.55576212194086
Task_19506,1861,438,40,30,70,4.239179954441913,35.86000163634729
Task_19507,1515,306,80,183,263,4.93485342019544,32.37432462188563
Task_19508,1237,303,61,94,155,4.069078947368421,27.209768364813172
Task_19509,1000,894,70,188,258,1.1173184357541899,25.988927318572195
Task_19510,1035,1020,179,80,259,1.0137120470127325,26.608982983074963
Task_19511,966,348,44,128,172,2.767908309455587,23.269489240957217
Task_19512,570,709,16,87,103,0.8028169014084507,17.367221318110186
Task_19513,1061,524,66,119,185,2.020952380952381,25.434345800209098
Task_19514,524,488,68,87,155,1.0715746421267893,16.417017133007246
Task_19515,2686,220,95,132,227,12.153846153846153,50.29146542135113
Task_19516,613,521,138,162,300,1.1743295019157087,18.809526553797387
Task_19517,1833,557,100,84,184,3.28494623655914,37.54497330400202
Task_19518,2699,413,139,181,320,6.519323671497585,51.6606402233953
Task_19519,1789,318,92,191,283,5.608150470219436,36.80325463456168
Task_19520,1726,186,46,197,243,9.229946524064172,35.20760189603247
Task_19521,1143,950,47,72,119,1.2018927444794953,27.27417519894672
Task_19522,1397,408,193,11,204,3.415647921760391,29.696840269958727
Task_19523,1836,981,140,31,171,1.8696537678207739,38.3511888974736
Task_19524,1634,173,92,167,259,9.39080459770115,33.48953996629197
Task_19525,1886,683,109,70,179,2.757309941520468,38.55067974436776
Task_19526,936,249,50,147,197,3.744,22.727863099822162
Task_19527,774,994,110,45,155,0.7778894472361809,21.468966876926473
Task_19528,1015,157,25,105,130,6.424050632911392,22.58225197576972
Task_19529,1956,911,71,89,160,2.1447368421052633,40.50679437246814
Task_19530,1112,135,41,200,241,8.176470588235293,24.993972764525733
Task_19531,1839,924,42,182,224,1.988108108108108,39.2469901478366
Task_19532,2808,872,171,90,261,3.216494845360825,54.42225834480098
Task_19533,2645,542,47,30,77,4.871086556169429,48.65241455200776
Task_19534,2706,290,191,142,333,9.29896907216495,51.35105884859397
Task_19535,2997,688,53,200,253,4.34978229317852,57.06557336490315
Task_19536,2829,87,48,48,96,32.14772727272727,49.630532383821105
Task_19537,2195,1004,179,173,352,2.18407960199005,45.68413959241488
Task_19538,1692,1010,197,200,397,1.6735905044510386,37.96062620676445
Task_19539,2186,431,36,126,162,5.060185185185185,42.70101398111618
Task_19540,568,877,39,159,198,0.6469248291571754,18.878897343734756
Task_19541,2359,254,50,103,153,9.250980392156864,44.7436587508831
Task_19542,1628,512,22,112,134,3.1734892787524367,33.874742346773566
Task_19543,1895,439,79,70,149,4.306818181818182,37.79830171801024
Task_19544,2735,75,148,89,237,35.98684210526316,49.758774780169865
Task_19545,2185,378,143,130,273,5.7651715039577835,43.12481592575949
Task_19546,2449,793,179,128,307,3.084382871536524,48.78140899296509
Task_19547,2863,803,26,124,150,3.560945273631841,54.4384401641774
Task_19548,915,297,69,62,131,3.0704697986577183,21.72586142644158
Task_19549,1915,71,109,40,149,26.59722222222222,35.4689883622233
Task_19550,2653,656,101,72,173,4.038051750380517,50.63946260256273
Task_19551,2949,918,14,151,165,3.2089227421109903,56.44650449071941
Task_19552,957,164,48,174,222,5.8,22.660681365778206
Task_19553,1125,423,45,109,154,2.6533018867924527,25.73584085114887
Task_19554,563,743,164,111,275,0.7567204301075269,18.544939612683727
Task_19555,942,622,100,84,184,1.5120385232744784,23.60041213118707
Task_19556,2878,212,129,29,158,13.511737089201878,52.19799524192063
Task_19557,1595,667,101,37,138,2.3877245508982035,33.294911693050814
Task_19558,1686,528,29,195,224,3.1871455576559544,35.588096761873324
Task_19559,1353,109,48,170,218,12.3,28.461923917835424
Task_19560,1447,120,117,171,288,11.958677685950413,30.385982376352292
Task_19561,1471,114,133,86,219,12.791304347826086,30.100052233594884
Task_19562,2857,999,89,125,214,2.857,55.44595841256652
Task_19563,2466,637,45,167,212,3.865203761755486,48.216104068819256
Task_19564,1276,489,86,160,246,2.6040816326530614,28.979254471300948
Task_19565,1213,203,15,116,131,5.946078431372549,26.341123046462826
Task_19566,2645,694,161,26,187,3.805755395683453,50.34333894740038
Task_19567,1200,429,154,88,242,2.7906976744186047,27.443251112211225
Task_19568,1487,86,166,82,248,17.091954022988507,30.228050992401325
Task_19569,2943,496,142,22,164,5.921529175050302,54.30512068300239
Task_19570,1268,603,153,157,310,2.0993377483443707,29.534683910739556
Task_19571,2052,113,62,101,163,18.0,38.99454369719543
Task_19572,1339,434,52,22,74,3.0781609195402297,27.486382540485916
Task_19573,1115,939,128,71,199,1.1861702127659575,27.270648485551792
Task_19574,1957,771,40,195,235,2.534974093264249,40.70149867188107
Task_19575,1161,287,46,146,192,4.03125,26.32090281861578
Task_19576,1897,843,20,86,106,2.2476303317535544,38.85259271170409
Task_19577,1171,880,112,153,265,1.3291713961407492,28.604469994555107
Task_19578,2006,616,22,151,173,3.2512155591572123,40.590281556478544
Task_19579,2778,696,160,200,360,3.985652797704448,54.03217316693017
Task_19580,2594,212,97,156,253,12.178403755868544,48.9568600531793
Task_19581,1580,833,132,72,204,1.894484412470024,34.37152324674318
Task_19582,2999,249,93,182,275,11.996,55.66598748216398
Task_19583,1679,564,134,189,323,2.9716814159292033,36.02610737582564
Task_19584,2776,790,137,71,208,3.509481668773704,53.18071787586238
Task_19585,950,506,90,59,149,1.873767258382643,22.955274936402578
Task_19586,896,614,164,195,359,1.4569105691056912,23.900390209769807
Task_19587,1301,657,153,11,164,1.9772036474164134,28.796915162009483
Task_19588,2096,94,184,180,364,22.063157894736843,40.63427291004225
Task_19589,581,605,70,106,176,0.9587458745874587,17.9674411128329
Task_19590,2990,269,123,159,282,11.074074074074074,55.55861370707853
Task_19591,1154,200,116,124,240,5.741293532338308,26.065717887643245
Task_19592,2331,962,51,11,62,2.4205607476635516,44.758485107444834
Task_19593,1652,501,10,12,22,3.2908366533864544,32.33699948104839
Task_19594,2429,403,166,176,342,6.012376237623762,47.44674500596617
Task_19595,750,136,123,169,292,5.474452554744525,19.51760106018111
Task_19596,1983,311,142,16,158,6.355769230769231,38.32010306900397
Task_19597,2440,324,169,17,186,7.507692307692308,45.82383604864831
Task_19598,2305,519,193,171,364,4.4326923076923075,45.95320892073431
Task_19599,1148,443,40,192,232,2.5855855855855854,26.841057964091963
Task_19600,1264,253,32,28,60,4.9763779527559056,25.7868131062245
Task_19601,2236,89,58,86,144,24.844444444444445,41.394006172773956
Task_19602,2489,516,116,30,146,4.81431334622824,47.09710674996253
Task_19603,1348,712,163,179,342,1.8906030855539973,31.31869027452008
Task_19604,1314,1022,83,69,152,1.284457478005865,30.291763898550347
Task_19605,2353,415,175,97,272,5.65625,45.88077392713182
Task_19606,1246,972,63,32,95,1.2805755395683454,28.232804278615586
Task_19607,581,871,187,56,243,0.6662844036697247,18.899277862012656
Task_19608,2726,178,145,131,276,15.22905027932961,50.71327555748328
Task_19609,912,106,81,61,142,8.523364485981308,20.445096223189115
Task_19610,2280,610,84,142,226,3.7315875613747953,45.19293422459816
Task_19611,1309,432,89,199,288,3.023094688221709,29.58600047142087
Task_19612,2262,603,182,152,334,3.7450331125827816,45.37720893880546
Task_19613,1793,245,198,98,296,7.288617886178862,36.537866275952396
Task_19614,1750,674,172,11,183,2.5925925925925926,36.013791555792466
Task_19615,1427,614,101,22,123,2.3203252032520325,30.238131094891582
Task_19616,2835,256,159,60,219,11.03112840466926,52.307792487488484
Task_19617,1920,810,83,177,260,2.367447595561036,40.34922736585037
Task_19618,937,168,174,144,318,5.544378698224852,22.718540092648926
Task_19619,2986,365,93,128,221,8.158469945355192,55.554401822949494
Task_19620,596,933,134,46,180,0.6381156316916489,18.962109865350712
Task_19621,2296,496,70,21,91,4.619718309859155,43.35913702793934
Task_19622,1538,569,154,169,323,2.6982456140350877,33.779820804385935
Task_19623,937,211,156,17,173,4.419811320754717,21.619651638616194
Task_19624,1764,646,30,149,179,2.7264296754250386,36.90387840792021
Task_19625,1941,478,165,107,272,4.052192066805845,39.55059020165191
Task_19626,1839,415,137,47,184,4.420673076923077,36.735885638963865
Task_19627,1752,148,60,142,202,11.758389261744966,35.01269958292703
Task_19628,2990,270,188,111,299,11.033210332103321,55.568589527329436
Task_19629,2634,277,85,62,147,9.474820143884893,48.8437665345301
Task_19630,699,917,51,142,193,0.761437908496732,20.996288250549163
Task_19631,2840,383,153,180,333,7.395833333333333,53.84835382460968
Task_19632,2903,687,175,176,351,4.219476744186046,55.90791418459122
Task_19633,1143,108,83,137,220,10.486238532110091,25.12789215192173
Task_19634,2603,419,80,173,253,6.197619047619048,49.90093352395447
Task_19635,2673,258,127,150,277,10.32046332046332,50.47242196908468
Task_19636,1151,599,195,63,258,1.9183333333333332,27.014645224416217
Task_19637,1839,110,21,148,169,16.56756756756757,35.65834929202153
Task_19638,728,619,195,189,384,1.1741935483870967,21.35331284549888
Task_19639,2560,277,192,191,383,9.20863309352518,49.29371811886036
Task_19640,2566,203,10,25,35,12.57843137254902,45.90765788653736
Task_19641,1345,1002,62,147,209,1.340977068793619,31.53777692521003
Task_19642,1274,338,104,49,153,3.75811209439528,27.339016175483167
Task_19643,2395,532,14,31,45,4.493433395872421,44.5105302449665
Task_19644,2755,699,52,44,96,3.9357142857142855,51.254100424406715
Task_19645,645,839,80,135,215,0.7678571428571429,19.958345067005908
Task_19646,998,361,121,63,184,2.7569060773480665,23.473649414319947
Task_19647,1433,148,128,51,179,9.61744966442953,29.23810548972126
Task_19648,2783,296,91,124,215,9.37037037037037,52.03094576828931
Task_19649,1318,867,77,30,107,1.5184331797235022,29.17968645407301
Task_19650,1209,286,147,151,298,4.2125435540069684,27.52771626227946
Task_19651,1314,239,89,131,220,5.475,28.62698987830999
Task_19652,1709,700,47,30,77,2.4379457917261056,34.32908688773521
Task_19653,1275,171,77,73,150,7.412790697674419,26.845614089488777
Task_19654,2673,361,164,23,187,7.383977900552487,49.67968411870297
Task_19655,2445,843,94,14,108,2.896919431279621,46.973069780805396
Task_19656,2158,380,85,56,141,5.664041994750656,41.59626886197688
Task_19657,1711,1008,182,152,334,1.6957383548067393,37.90121097630385
Task_19658,2151,319,132,131,263,6.721875,42.345363451196775
Task_19659,978,639,81,57,138,1.528125,23.70183831022514
Task_19660,2718,889,200,46,246,3.053932584269663,52.44149954032985
Task_19661,625,800,131,122,253,0.7802746566791511,19.653742289679137
Task_19662,2562,756,23,35,58,3.3844121532364597,47.98101833011489
Task_19663,2440,679,27,63,90,3.588235294117647,46.551044631763034
Task_19664,2283,1014,134,112,246,2.2492610837438423,46.54262275855388
Task_19665,2112,408,190,11,201,5.163814180929095,40.997677158111536
Task_19666,2480,414,90,84,174,5.975903614457831,47.282071841321596
Task_19667,1771,294,66,119,185,6.003389830508475,35.92686272201299
Task_19668,2685,910,50,12,62,2.947310647639956,50.22994721613304
Task_19669,1821,516,139,116,255,3.5222437137330753,37.70884075206754
Task_19670,1921,862,159,41,200,2.2259559675550404,39.5101386603441
Task_19671,862,275,198,49,247,3.1231884057971016,21.206228595935617
Task_19672,2218,940,125,197,322,2.357066950053135,45.74940157044716
Task_19673,2728,81,129,69,198,33.26829268292683,49.11168401337232
Task_19674,2686,233,186,136,322,11.478632478632479,50.76581273064803
Task_19675,812,601,84,14,98,1.3488372093023255,20.193405049286437
Task_19676,1400,527,92,127,219,2.6515151515151514,30.939682944862685
Task_19677,1659,563,100,152,252,2.9414893617021276,35.33201187786103
Task_19678,2688,866,116,123,239,3.1003460207612457,52.483056853931224
Task_19679,2487,783,72,132,204,3.1721938775510203,48.95363636268879
Task_19680,1056,829,56,29,85,1.272289156626506,24.72996795287007
Task_19681,699,466,98,134,232,1.4967880085653105,19.67317193423788
Task_19682,2506,916,118,77,195,2.732824427480916,49.321696090671736
Task_19683,2648,182,189,141,330,14.469945355191257,49.92365502751722
Task_19684,1589,776,24,24,48,2.045045045045045,32.48053139111055
Task_19685,1418,371,170,67,237,3.8118279569892475,30.437999844960306
Task_19686,1160,85,84,87,171,13.488372093023257,24.73939199285199
Task_19687,1669,292,36,66,102,5.696245733788396,33.25702133768964
Task_19688,1031,811,34,114,148,1.269704433497537,25.407504773276205
Task_19689,1049,870,123,151,274,1.2043628013777268,26.665240064317832
Task_19690,1766,452,83,76,159,3.8984547461368653,35.88004919945048
Task_19691,2670,830,180,35,215,3.2129963898916967,51.33988573251756
Task_19692,724,493,162,131,293,1.465587044534413,20.408445416700555
Task_19693,1060,117,86,172,258,8.983050847457626,24.085540581290008
Task_19694,1624,924,40,50,90,1.7556756756756757,34.15573169457807
Task_19695,566,829,136,158,294,0.6819277108433734,19.134313359159396
Task_19696,1209,963,122,160,282,1.254149377593361,29.533001090276738
Task_19697,2249,166,101,81,182,13.467065868263473,42.48083455216858
Task_19698,2403,221,73,133,206,10.824324324324325,45.78277050744808
Task_19699,808,286,122,127,249,2.8153310104529616,20.93271523411896
Task_19700,2202,966,194,73,267,2.277145811789038,44.9173015439981
Task_19701,1795,772,17,52,69,2.3221216041397152,36.10003308810139
Task_19702,2411,534,175,23,198,4.506542056074767,46.16402696566171
Task_19703,1406,136,74,35,109,10.262773722627736,27.940698749500157
Task_19704,1735,505,179,84,263,3.4288537549407114,36.226830623893434
Task_19705,1420,672,186,100,286,2.109955423476969,31.966137221187974
Task_19706,1694,839,36,196,232,2.0166666666666666,36.739537627013
Task_19707,2955,463,130,62,192,6.368534482758621,54.80641186876852
Task_19708,803,789,110,196,306,1.0164556962025317,22.719043448641084
Task_19709,2046,813,60,131,191,2.5135135135135136,42.01016305296711
Task_19710,1901,927,113,31,144,2.0484913793103448,39.02192218859795
Task_19711,2731,867,191,174,365,3.1463133640552994,53.810158986416035
Task_19712,1149,536,191,21,212,2.1396648044692737,26.229988812696252
Task_19713,1668,678,12,114,126,2.456553755522828,35.04183791085639
Task_19714,1668,894,86,123,209,1.8636871508379889,36.23366922414954
Task_19715,2658,157,169,197,366,16.82278481012658,50.11645847700522
Task_19716,2484,440,24,51,75,5.63265306122449,45.937830943884414
Task_19717,1770,197,127,87,214,8.93939393939394,35.58386405610114
Task_19718,1975,713,121,64,185,2.7661064425770308,40.07078625175357
Task_19719,2142,509,124,19,143,4.2,41.44900337062792
Task_19720,1782,139,117,39,156,12.728571428571428,34.20779768200673
Task_19721,1535,887,139,59,198,1.7286036036036037,33.66772109499119
Task_19722,2207,532,55,132,187,4.140712945590995,43.644383220885835
Task_19723,575,593,35,195,230,0.968013468013468,18.132623685816498
Task_19724,983,318,158,40,198,3.0815047021943576,22.934385006252608
Task_19725,2674,138,68,32,100,19.237410071942445,47.88433718251318
Task_19726,1396,635,59,81,140,2.1949685534591197,30.675660911221524
Task_19727,569,597,186,29,215,0.9515050167224081,17.419987543018696
Task_19728,690,991,99,93,192,0.6955645161290323,21.035973676023783
Task_19729,1595,625,88,116,204,2.547923322683706,34.20334839321006
Task_19730,2843,927,191,55,246,3.0635775862068964,54.75690002714175
Task_19731,1660,888,33,135,168,1.8672665916760405,35.92256587187934
Task_19732,1237,764,59,123,182,1.6169934640522876,28.937641132451812
Task_19733,1803,276,186,151,337,6.509025270758123,37.05906718208461
Task_19734,1633,403,28,46,74,4.042079207920792,32.16864018731595
Task_19735,540,222,38,50,88,2.42152466367713,14.795535770812206
Task_19736,1185,916,106,162,268,1.292257360959651,28.950275409500808
Task_19737,665,121,108,29,137,5.450819672131147,16.47445648765353
Task_19738,735,762,57,173,230,0.963302752293578,21.224070753070638
Task_19739,2620,602,69,49,118,4.344941956882256,49.19855997213568
Task_19740,2129,928,160,40,200,2.2917115177610334,43.010585534182134
Task_19741,1007,189,91,62,153,5.3,22.85484207160282
Task_19742,2648,937,195,82,277,2.8230277185501067,52.11127646237492
Task_19743,920,989,169,162,331,0.9292929292929293,25.29964636861115
Task_19744,2404,577,111,133,244,4.159169550173011,47.10975286800789
Task_19745,1650,982,120,162,282,1.6785350966429298,36.634182972232715
Task_19746,2367,817,187,17,204,2.893643031784841,46.349541894058824
Task_19747,2115,580,121,87,208,3.640275387263339,42.25174019234006
Task_19748,1026,482,132,55,187,2.124223602484472,24.298970802553214
Task_19749,2303,110,100,73,173,20.74774774774775,42.57991878058465
Task_19750,1086,206,189,107,296,5.246376811594203,25.240769677160603
Task_19751,716,590,37,17,54,1.2115059221658206,18.176125969129455
Task_19752,1975,830,116,63,179,2.3766546329723224,40.40553428843997
Task_19753,2019,94,149,38,187,21.25263157894737,37.739383431658204
Task_19754,1401,815,114,170,284,1.7169117647058822,32.19089238467364
Task_19755,1234,250,67,98,165,4.916334661354582,27.178906130011
Task_19756,2668,226,36,98,134,11.753303964757709,49.40128062916218
Task_19757,1571,548,64,149,213,2.8615664845173043,33.78130846462748
Task_19758,946,777,154,90,244,1.2159383033419022,24.48811839424793
Task_19759,1822,974,155,125,280,1.8687179487179486,39.28515582153307
Task_19760,1719,345,100,112,212,4.968208092485549,35.34250532703698
Task_19761,1415,294,36,195,231,4.796610169491525,30.587970985467255
Task_19762,2741,645,159,56,215,4.243034055727554,52.113939713294364
Task_19763,1687,752,85,111,196,2.240371845949535,36.06198977064596
Task_19764,2338,309,12,23,35,7.541935483870968,42.68988788449119
Task_19765,689,195,113,75,188,3.5153061224489797,18.2237542321468
Task_19766,1658,866,163,109,272,1.9123414071510958,36.291316612324216
Task_19767,814,930,142,145,287,0.874328678839957,23.207272905997097
Task_19768,1444,974,180,112,292,1.481025641025641,33.28743944076766
Task_19769,1371,157,94,143,237,8.677215189873417,29.19342593384606
Task_19770,2789,664,13,51,64,4.193984962406015,51.46622356013136
Task_19771,1788,622,193,116,309,2.869983948635634,37.7650163527716
Task_19772,878,128,43,147,190,6.8062015503875966,20.963915244214615
Task_19773,504,222,69,39,108,2.2600896860986546,14.302642315760421
Task_19774,1134,257,172,59,231,4.395348837209302,25.48597698264895
Task_19775,2230,256,64,160,224,8.67704280155642,43.310989352552575
Task_19776,782,150,33,52,85,5.178807947019868,18.25352463375115
Task_19777,2187,668,170,14,184,3.2690582959641254,42.911695128661314
Task_19778,884,620,64,192,256,1.423510466988728,23.334975085369887
Task_19779,2670,451,69,118,187,5.907079646017699,50.69425210564622
Task_19780,1503,201,77,161,238,7.4405940594059405,31.69031349263129
Task_19781,2195,451,120,17,137,4.856194690265487,42.00591608875808
Task_19782,1232,923,26,25,51,1.3333333333333333,27.391187117250897
Task_19783,846,739,28,149,177,1.1432432432432433,22.54661230142673
Task_19784,1617,259,137,160,297,6.219230769230769,33.89378227174037
Task_19785,1914,397,112,82,194,4.809045226130653,38.39994558899986
Task_19786,1947,963,151,118,269,2.0197095435684647,41.171956272595885
Task_19787,2261,426,133,92,225,5.295081967213115,44.16156914896129
Task_19788,931,770,73,68,141,1.2075226977950713,23.54677689086088
Task_19789,2012,311,134,29,163,6.448717948717949,39.002680802599315
Task_19790,688,634,64,75,139,1.0834645669291338,19.3429626134002
Task_19791,2983,945,157,192,349,3.153276955602537,58.001624881573946
Task_19792,1053,409,166,129,295,2.5682926829268293,25.41151913373461
Task_19793,2471,940,159,178,337,2.6259298618490967,49.798203763604896
Task_19794,2792,638,188,96,284,4.369327073552426,53.60315384832058
Task_19795,2018,758,88,139,227,2.6587615283267456,41.45796682351988
Task_19796,2353,404,67,104,171,5.809876543209876,45.38745458604863
Task_19797,1913,646,48,165,213,2.956723338485317,39.519306741899186
Task_19798,2964,435,158,101,259,6.798165137614679,55.535341234858855
Task_19799,1779,673,181,148,329,2.6394658753709197,37.91977799814811
Task_19800,2474,575,83,197,280,4.295138888888889,48.50358501992772
Task_19801,2895,768,98,128,226,3.764629388816645,55.40777746524984
Task_19802,2154,471,32,83,115,4.563559322033898,41.92201263544698
Task_19803,1403,811,23,200,223,1.727832512315271,31.966644306976093
Task_19804,2679,602,100,191,291,4.442786069651741,51.84128991722012
Task_19805,1038,797,170,101,271,1.300751879699248,26.17643895215618
Task_19806,1546,885,101,81,182,1.744920993227991,33.98027722262205
Task_19807,1507,412,174,169,343,3.648910411622276,32.88040534994021
Task_19808,2156,795,64,112,176,2.708542713567839,43.57627894857734
Task_19809,2213,929,104,48,152,2.379569892473118,43.99966482876342
Task_19810,1896,688,83,66,149,2.7518142235123366,38.58796365567948
Task_19811,2625,422,21,102,123,6.205673758865248,49.2645901279297
Task_19812,1644,909,41,186,227,1.8065934065934066,36.12595131575534
Task_19813,614,914,72,76,148,0.6710382513661202,19.311072172959967
Task_19814,2704,904,43,195,238,2.9878453038674033,52.97319471399777
Task_19815,867,680,134,88,222,1.2731277533039647,22.809557722063442
Task_19816,1442,145,121,148,269,9.876712328767123,30.370308419475208
Task_19817,1965,280,39,16,55,6.99288256227758,36.82368012447596
Task_19818,1915,666,139,104,243,2.871064467766117,39.59983331069835
Task_19819,626,139,125,95,220,4.4714285714285715,17.147410174240413
Task_19820,2694,727,173,29,202,3.7005494505494507,51.33132232156745
Task_19821,2195,834,132,28,160,2.62874251497006,43.454621668563355
Task_19822,659,230,31,172,203,2.8528138528138527,18.25245659615168
Task_19823,2791,211,79,125,204,13.165094339622641,51.849248392448935
Task_19824,1993,849,86,68,154,2.344705882352941,40.479793278276766
Task_19825,808,128,166,139,305,6.263565891472868,20.414014531686927
Task_19826,1221,178,107,127,234,6.82122905027933,26.777020294639595
Task_19827,834,554,136,128,264,1.5027027027027027,22.216381511263872
Task_19828,713,228,183,182,365,3.11353711790393,19.846125755484238
Task_19829,1801,493,14,66,80,3.645748987854251,35.684593986111686
Task_19830,2720,584,86,190,276,4.64957264957265,52.32424745240275
Task_19831,751,325,116,27,143,2.303680981595092,18.89109427827411
Task_19832,1607,266,102,164,266,6.0187265917602994,33.62598395974681
Task_19833,1315,1010,111,84,195,1.3006923837784372,30.785543978711257
Task_19834,2736,687,127,144,271,3.9767441860465116,52.85517884055459
Task_19835,2156,279,40,63,103,7.7,40.903765683979124
Task_19836,1559,700,111,195,306,2.223965763195435,34.48478135647429
Task_19837,2443,587,198,87,285,4.154761904761905,47.81520131237571
Task_19838,1837,982,99,100,199,1.8687690742624619,39.147669569569175
Task_19839,1580,458,38,42,80,3.4422657952069717,31.788052248302506
Task_19840,585,405,98,184,282,1.4408866995073892,17.965626152433625
Task_19841,1333,281,128,98,226,4.726950354609929,29.076544280901743
Task_19842,1752,233,150,192,342,7.487179487179487,36.185058721458226
Task_19843,2730,876,60,53,113,3.112884834663626,51.92639900499231
Task_19844,903,476,50,53,103,1.8930817610062893,21.58235707838595
Task_19845,2506,723,52,80,132,3.4613259668508287,48.55835148990883
Task_19846,1625,740,124,41,165,2.192982456140351,34.29427534986682
Task_19847,2277,93,172,96,268,24.22340425531915,42.953091982285834
Task_19848,1197,982,66,125,191,1.2177009155645981,29.00985724186802
Task_19849,2534,534,100,98,198,4.736448598130841,48.77947106135167
Task_19850,615,588,53,172,225,1.0441426146010186,18.75097484131257
Task_19851,934,867,61,23,84,1.076036866359447,22.900105942479815
Task_19852,2412,229,91,78,169,10.486956521739131,45.48794620380695
Task_19853,2528,371,171,161,332,6.795698924731183,48.839353378761494
Task_19854,1299,734,103,99,202,1.7673469387755103,29.84335792430113
Task_19855,846,922,150,33,183,0.9165763813651138,22.65169186548197
Task_19856,2678,982,55,137,192,2.7243133265513735,52.56538545984708
Task_19857,1041,626,69,87,156,1.6602870813397128,25.116951323588268
Task_19858,2074,965,99,52,151,2.1469979296066253,42.183659336521636
Task_19859,1645,916,31,173,204,1.7938931297709924,36.0255426220895
Task_19860,2716,740,21,143,164,3.6653171390013495,52.15725163920114
Task_19861,2851,881,170,196,366,3.2324263038548753,55.79214875430521
Task_19862,579,766,63,149,212,0.7548891786179922,18.694662184146228
Task_19863,1103,137,86,81,167,7.992753623188406,24.13909597585615
Task_19864,1815,217,115,28,143,8.325688073394495,35.35919149260859
Task_19865,2727,353,187,153,340,7.703389830508475,51.95072541674881
Task_19866,1323,146,97,22,119,9.0,26.700559293651313
Task_19867,2761,392,198,143,341,7.025445292620865,52.610523598911094
Task_19868,727,706,66,181,247,1.0282885431400284,21.005265716314202
Task_19869,2153,912,184,143,327,2.35815991237678,44.57556884061044
Task_19870,2007,411,176,68,244,4.871359223300971,39.91889843656085
Task_19871,1512,136,41,190,231,11.036496350364963,31.233659185759397
Task_19872,1595,788,81,172,253,2.0215462610899873,35.11037850587681
Task_19873,607,395,14,165,179,1.5328282828282829,17.76223933673386
Task_19874,1756,702,78,90,168,2.4978662873399715,36.8273119792955
Task_19875,1952,876,32,179,211,2.225769669327252,40.805941534147365
Task_19876,1239,786,47,103,150,1.5743329097839898,28.635496304257384
Task_19877,1857,614,168,31,199,3.0195121951219512,37.71054038013276
Task_19878,735,196,184,153,337,3.730964467005076,19.93426651085704
Task_19879,519,974,74,110,184,0.5323076923076923,18.31294417555413
Task_19880,2912,529,156,16,172,5.494339622641509,53.8988483052758
Task_19881,1887,851,129,41,170,2.214788732394366,38.75949166871263
Task_19882,1887,916,134,65,199,2.057797164667394,39.42012821993287
Task_19883,1204,633,200,63,263,1.8990536277602523,27.982775776775807
Task_19884,2868,587,45,62,107,4.877551020408164,53.11816820868293
Task_19885,1417,227,65,152,217,6.214912280701754,30.32034198942378
Task_19886,1732,68,82,180,262,25.10144927536232,34.397303077433925
Task_19887,888,415,20,77,97,2.1346153846153846,21.281300872292263
Task_19888,1845,191,150,59,209,9.609375,36.44105791940523
Task_19889,2121,276,64,79,143,7.657039711191335,41.00524174267762
Task_19890,984,490,36,155,191,2.0040733197556007,24.158949730752976
Task_19891,1576,132,37,176,213,11.849624060150376,32.11586393672717
Task_19892,2801,179,72,126,198,15.561111111111112,51.598732866251645
Task_19893,1994,606,107,48,155,3.2850082372322897,39.55959234358597
Task_19894,1942,372,95,186,281,5.206434316353888,39.388952772968956
Task_19895,544,546,151,98,249,0.9945155393053017,17.511557607202217
Task_19896,2511,899,110,130,240,2.79,49.796490076920044
Task_19897,1511,461,135,11,146,3.2705627705627704,31.349729226118825
Task_19898,871,848,80,152,232,1.0259128386336867,23.59948795827965
Task_19899,740,614,149,114,263,1.2032520325203253,20.872533976592027
Task_19900,862,155,173,188,361,5.5256410256410255,21.755195149854487
Task_19901,992,359,162,75,237,2.7555555555555555,23.770102205256048
Task_19902,2379,824,33,39,72,2.8836363636363638,45.29439267024129
Task_19903,2410,741,117,13,130,3.247978436657682,46.330942677633224
Task_19904,2965,551,11,53,64,5.371376811594203,53.91045001436695
Task_19905,829,878,157,137,294,0.9431171786120591,23.308309752840206
Task_19906,1447,471,145,130,275,3.065677966101695,31.755621746017415
Task_19907,768,420,100,132,232,1.824228028503563,20.656626260277765
Task_19908,2893,729,150,47,197,3.963013698630137,54.50571412661961
Task_19909,2492,716,33,37,70,3.4755927475592747,46.766242657791025
Task_19910,2675,493,66,72,138,5.41497975708502,50.32920318400952
Task_19911,760,871,177,171,348,0.8715596330275229,22.482320655777794
Task_19912,1689,203,157,141,298,8.279411764705882,34.80789595680855
Task_19913,1968,634,190,19,209,3.099212598425197,39.489735707828416
Task_19914,2373,162,192,146,338,14.558282208588958,45.43602447083589
Task_19915,1159,320,193,44,237,3.6105919003115265,25.89776396572536
Task_19916,953,227,51,61,112,4.1798245614035086,21.723584745956177
Task_19917,1050,128,84,179,263,8.13953488372093,24.109807468209794
Task_19918,551,423,10,179,189,1.2995283018867925,16.994209786635206
Task_19919,1577,474,34,65,99,3.32,32.30620169933256
Task_19920,2130,846,167,37,204,2.5147579693034237,42.79787247625711
Task_19921,628,864,171,12,183,0.7260115606936416,19.055908399907366
Task_19922,966,403,143,79,222,2.391089108910891,23.511278496267366
Task_19923,2140,311,137,43,180,6.858974358974359,41.12454794427793
Task_19924,2832,938,134,77,211,3.015974440894569,54.6302408385938
Task_19925,1391,345,127,129,256,4.020231213872832,30.37767269907417
Task_19926,1248,646,177,92,269,1.928902627511592,29.020486105595623
Task_19927,1897,269,162,121,283,7.025925925925926,38.23314281515247
Task_19928,2809,721,160,83,243,3.8905817174515236,53.83155324443978
Task_19929,1120,388,152,101,253,2.879177377892031,26.174504074598833
Task_19930,1283,1006,72,104,176,1.2740814299900696,30.308076684759687
Task_19931,709,980,154,119,273,0.7227319062181448,21.68624401079083
Task_19932,884,169,160,194,354,5.2,22.115811167586873
Task_19933,1453,984,41,68,109,1.4751269035532995,32.091237872088726
Task_19934,1881,1008,170,25,195,1.8642220019821605,39.24794440104127
Task_19935,682,113,105,175,280,5.982456140350878,18.225348503655834
Task_19936,501,911,56,189,245,0.5493421052631579,18.210852934298764
Task_19937,808,669,184,31,215,1.2059701492537314,21.35266785581642
Task_19938,1886,601,40,183,223,3.132890365448505,38.97132864540816
Task_19939,1932,876,187,168,355,2.202964652223489,41.12446936907867
Task_19940,2675,722,190,42,232,3.699861687413555,51.16259433325636
Task_19941,1351,772,26,168,194,1.7477360931435963,30.842106239877364
Task_19942,754,713,144,20,164,1.0560224089635855,20.34363930361926
Task_19943,1176,258,139,70,209,4.54054054054054,26.115374122477277
Task_19944,1483,847,141,61,202,1.7488207547169812,32.7349018736158
Task_19945,1685,718,87,116,203,2.343532684283727,35.917201424426686
Task_19946,2305,226,120,123,243,10.154185022026432,44.34630634349719
Task_19947,3000,478,72,118,190,6.263048016701461,56.017860699827935
Task_19948,943,961,135,130,265,0.9802494802494802,25.22603184842008
Task_19949,675,794,65,133,198,0.8490566037735849,20.200195509572918
Task_19950,1596,979,183,159,342,1.6285714285714286,36.03517992880654
Task_19951,2271,977,76,54,130,2.3220858895705523,45.240668025906906
Task_19952,836,600,95,30,125,1.3910149750415974,20.986953256880756
Task_19953,1552,235,163,155,318,6.576271186440678,32.87058913314285
Task_19954,696,889,88,135,223,0.7820224719101123,20.876620652170605
Task_19955,2533,562,158,131,289,4.49911190053286,49.30445295462806
Task_19956,2883,363,149,134,283,7.920329670329671,54.167901735594704
Task_19957,1705,848,85,27,112,2.0082449941107186,35.30603376457555
Task_19958,2758,707,83,191,274,3.8954802259887007,53.385024224878514
Task_19959,1384,794,158,132,290,1.7408805031446541,31.827602033164027
Task_19960,2321,765,166,64,230,3.0300261096605743,45.9479466046848
Task_19961,2360,285,143,67,210,8.251748251748252,44.92464868742555
Task_19962,2691,157,168,103,271,17.031645569620252,50.07067574782935
Task_19963,2647,234,145,57,202,11.263829787234043,49.184525432420834
Task_19964,1244,399,91,74,165,3.11,27.564481647365227
Task_19965,983,636,108,54,162,1.543171114599686,23.914319781441822
Task_19966,1338,442,46,169,215,3.020316027088036,29.758600607243192
Task_19967,1340,763,43,146,189,1.7539267015706805,30.61297817760996
Task_19968,1328,705,26,41,67,1.8810198300283285,28.266337034646828
Task_19969,659,190,126,161,287,3.450261780104712,18.484292209432173
Task_19970,1429,67,33,43,76,21.014705882352942,26.92966395542001
Task_19971,1264,619,197,16,213,2.0387096774193547,28.291650954994424
Task_19972,2240,776,16,48,64,2.8828828828828827,43.03531375724549
Task_19973,1770,368,102,35,137,4.796747967479675,35.09671305875226
Task_19974,2251,294,74,47,121,7.6305084745762715,42.292701344706906
Task_19975,1229,255,145,196,341,4.80078125,28.00014102842228
Task_19976,883,469,46,140,186,1.8787234042553191,22.43548527856718
Task_19977,2686,553,62,93,155,4.8483754512635375,50.939939582124914
Task_19978,1282,454,158,183,341,2.817582417582418,29.465047124814063
Task_19979,2181,372,18,65,83,5.847184986595174,41.4044789005364
Task_19980,2781,406,28,31,59,6.832923832923833,50.2629500258717
Task_19981,2376,478,39,69,108,4.960334029227558,45.16308594143114
Task_19982,2238,243,109,178,287,9.172131147540984,43.63018032574961
Task_19983,1313,133,57,158,215,9.798507462686567,28.019348406211606
Task_19984,722,541,118,79,197,1.3321033210332103,19.92699945671839
Task_19985,1566,202,117,91,208,7.714285714285714,32.328726969818284
Task_19986,2782,604,114,192,306,4.598347107438016,53.54792898994767
Task_19987,2900,798,99,64,163,3.6295369211514394,54.92060399603926
Task_19988,2015,83,12,78,90,23.988095238095237,37.120119079053225
Task_19989,2889,176,161,159,320,16.322033898305083,53.51490412171211
Task_19990,1333,1017,197,57,254,1.3094302554027506,31.132319531299473
Task_19991,1906,739,18,81,99,2.575675675675676,38.45974863372823
Task_19992,1930,662,128,129,257,2.9110105580693815,39.92459062416327
Task_19993,1669,600,92,116,208,2.777038269550749,35.36359641111707
Task_19994,1235,1014,125,152,277,1.2167487684729064,30.068606609389096
Task_19995,2689,276,144,45,189,9.707581227436823,49.71134623712115
Task_19996,2200,822,72,100,172,2.67314702308627,44.30509869220009
Task_19997,2755,660,70,101,171,4.167927382753404,52.57046989942981
Task_19998,1739,992,79,197,276,1.7512588116817724,38.15985854400475
Task_19999,1255,64,159,179,338,19.307692307692307,27.284112825822216
Task_20000,2159,653,162,117,279,3.301223241590214,43.6049075387207
Task_20001,2567,555,150,65,215,4.616906474820144,49.12840293717213
Task_20002,1512,605,134,10,144,2.495049504950495,31.758559270947035
Task_20003,936,166,128,180,308,5.604790419161676,22.692434821202415
Task_20004,1376,317,52,69,121,4.327044025157233,28.960777193503812
Task_20005,1757,115,151,93,244,15.14655172413793,34.83095411437109
Task_20006,1675,244,57,172,229,6.836734693877551,34.53552781406973
Task_20007,2453,501,195,56,251,4.886454183266932,47.2547229102987
Task_20008,1388,585,110,178,288,2.368600682593857,31.310247760819895
Task_20009,2647,299,146,184,330,8.823333333333334,50.498369396384625
Task_20010,1555,343,53,121,174,4.520348837209302,32.63008847717731
Task_20011,711,294,196,80,276,2.4101694915254237,19.378380290261834
Task_20012,2861,176,13,77,90,16.163841807909606,51.31280146388207
Task_20013,1862,374,18,124,142,4.965333333333334,37.1893408018206
Task_20014,1657,462,94,68,162,3.5788336933045355,34.09685379339431
Task_20015,1819,300,162,26,188,6.043189368770764,35.998247908076394
Task_20016,780,376,178,178,356,2.0689655172413794,21.33411477287377
Task_20017,2320,260,192,17,209,8.88888888888889,43.81911800231526
Task_20018,2059,609,47,195,242,3.375409836065574,41.869869658253634
Task_20019,2625,463,131,95,226,5.657327586206897,50.11788621305039
Task_20020,1558,923,158,148,306,1.6861471861471862,35.080884520554555
Task_20021,2458,494,178,95,273,4.965656565656565,47.78686386447716
Task_20022,707,525,191,141,332,1.344106463878327,20.436512320003143
Task_20023,1322,770,16,136,152,1.7146562905317768,29.90695500630925
Task_20024,2078,283,138,158,296,7.316901408450704,41.25560950069368
Task_20025,1903,445,44,108,152,4.266816143497758,38.09972020699028
Task_20026,2345,162,83,127,210,14.386503067484663,44.42590397674286
Task_20027,1402,778,107,109,216,1.7997432605905006,31.709185835552244
Task_20028,2101,340,68,184,252,6.161290322580645,41.726915390859226
Task_20029,1456,939,86,48,134,1.548936170212766,31.954002081312073
Task_20030,2522,811,188,78,266,3.105911330049261,49.61337793286336
Task_20031,2470,138,63,123,186,17.769784172661872,46.04763823200697
Task_20032,2585,512,111,17,128,5.038986354775829,48.4706749219319
Task_20033,1583,964,115,179,294,1.6404145077720207,35.59562469296691
Task_20034,2436,180,122,99,221,13.458563535911603,45.863653373321085
Task_20035,2742,374,146,120,266,7.312,51.87751577893346
Task_20036,1278,950,118,115,233,1.3438485804416405,30.316905607758716
Task_20037,2284,278,179,129,308,8.186379928315413,44.50584761456588
Task_20038,1566,244,160,162,322,6.391836734693878,33.15154024185243
Task_20039,1730,930,173,81,254,1.8582169709989258,37.40481290017142
Task_20040,695,114,108,23,131,6.043478260869565,16.78520623665881
Task_20041,1044,88,16,199,215,11.730337078651685,23.45129745683255
Task_20042,1311,544,70,173,243,2.4055045871559635,29.824436793054844
Task_20043,2916,663,28,136,164,4.391566265060241,55.079614231959916
Task_20044,2303,275,172,65,237,8.344202898550725,44.11998051378936
Task_20045,1746,407,177,200,377,4.279411764705882,36.84498691774933
Task_20046,1627,777,134,47,181,2.0912596401028276,34.50943919982128
Task_20047,2442,1017,104,112,216,2.398821218074656,48.9364630962206
Task_20048,2020,548,25,115,140,3.6794171220400727,40.2279073341443
Task_20049,1209,643,12,171,183,1.8773291925465838,28.103318229321232
Task_20050,1362,297,134,80,214,4.570469798657718,29.40082024764929
Task_20051,1113,253,104,152,256,4.381889763779528,25.71290363445667
Task_20052,894,323,119,17,136,2.759259259259259,21.011966237634145
Task_20053,1280,608,46,71,117,2.1018062397372743,28.39441902341697
Task_20054,1788,717,165,172,337,2.4902506963788302,38.27144944448921
Task_20055,734,304,194,164,358,2.40655737704918,20.366172359303306
Task_20056,1038,741,83,64,147,1.398921832884097,25.123464917210352
Task_20057,611,1015,72,110,182,0.6013779527559056,19.904718205281018
Task_20058,1528,485,66,116,182,3.1440329218106995,32.68227620060325
Task_20059,2065,373,93,102,195,5.521390374331551,40.85561456194316
Task_20060,666,342,13,159,172,1.9416909620991254,18.51368099757296
Task_20061,1570,496,88,176,264,3.158953722334004,33.75880568039989
Task_20062,2364,678,138,96,234,3.4815905743740796,46.72552832594875
Task_20063,2952,500,57,170,227,5.892215568862276,55.58252411071356
Task_20064,850,394,109,10,119,2.151898734177215,20.297524362847927
Task_20065,1394,587,200,190,390,2.370748299319728,31.888853031667356
Task_20066,1642,129,184,142,326,12.63076923076923,33.64543934473843
Task_20067,1391,635,197,118,315,2.1871069182389937,31.54820217824772
Task_20068,2834,675,107,183,290,4.1923076923076925,54.51223568138905
Task_20069,557,301,11,161,172,1.8443708609271523,16.647265670965364
Task_20070,760,819,178,36,214,0.926829268292683,21.13653013911033
Task_20071,2076,74,68,16,84,27.68,37.213542106490316
Task_20072,979,756,39,198,237,1.2932628797886394,25.097040508575628
Task_20073,2450,462,21,24,45,5.291576673866091,45.10654415318697
Task_20074,2945,548,125,20,145,5.3642987249544625,54.35273430040046
Task_20075,1221,650,134,60,194,1.8755760368663594,27.94847223740346
Task_20076,2748,671,157,95,252,4.089285714285714,52.85056922195849
Task_20077,2325,423,68,161,229,5.4834905660377355,45.408730820950616
Task_20078,2292,675,142,112,254,3.3905325443786984,45.66090349521128
Task_20079,661,443,54,73,127,1.4887387387387387,18.250096323838374
Task_20080,745,407,176,19,195,1.8259803921568627,19.348389340873755
Task_20081,2165,833,168,181,349,2.595923261390887,44.67407899877895
Task_20082,2309,366,22,100,122,6.291553133514986,44.0625688215072
Task_20083,1069,421,51,54,105,2.5331753554502368,24.001414507148528
Task_20084,737,606,39,55,94,1.2141680395387149,19.307233065157842
Task_20085,1850,193,111,180,291,9.536082474226804,37.332198011509675
Task_20086,916,261,48,20,68,3.49618320610687,20.177892442967355
Task_20087,2768,832,105,45,150,3.3229291716686675,52.46473403122644
Task_20088,701,425,120,60,180,1.6455399061032865,18.938972942769908
Task_20089,824,267,127,19,146,3.074626865671642,19.880479514755013
Task_20090,2642,896,159,132,291,2.9453734671125975,52.09563285926481
Task_20091,1455,938,46,86,132,1.549520766773163,32.51447813894674
Task_20092,2265,633,53,36,89,3.5725552050473186,43.22021628075375
Task_20093,651,389,174,55,229,1.6692307692307693,18.281284096216407
Task_20094,2453,615,164,163,327,3.982142857142857,48.42474587810343
Task_20095,2392,631,114,13,127,3.7848101265822787,45.660921671660105
Task_20096,2141,486,20,159,179,4.3963039014373715,42.36235529221634
Task_20097,2620,389,159,98,257,6.717948717948718,49.9324507190336
Task_20098,1995,390,158,94,252,5.10230179028133,40.00417368375141
Task_20099,2776,918,69,179,248,3.0206746463547334,54.23525546084508
Task_20100,2400,816,169,26,195,2.9375764993880047,46.895345751476306
Task_20101,810,319,89,186,275,2.53125,21.253048445905055
Task_20102,2681,815,167,182,349,3.2855392156862746,52.79451990461164
Task_20103,920,839,122,95,217,1.0952380952380953,24.195695281754194
Task_20104,2169,518,29,111,140,4.179190751445087,42.50227837286672
Task_20105,2295,839,36,126,162,2.732142857142857,45.72148700158536
Task_20106,1344,489,115,194,309,2.742857142857143,30.429254443877568
Task_20107,1946,753,87,121,208,2.580901856763926,40.191152718259644
Task_20108,2121,172,193,96,289,12.260115606936417,41.18886649080158
Task_20109,2360,784,33,28,61,3.0063694267515926,44.85132472028795
Task_20110,2951,992,96,122,218,2.971802618328298,56.95607384001742
Task_20111,1072,934,124,17,141,1.146524064171123,25.766179145622957
Task_20112,1839,279,95,157,252,6.567857142857143,37.2744209229379
Task_20113,1427,756,69,84,153,1.8850726552179657,31.56306151438483
Task_20114,1080,459,110,123,233,2.347826086956522,25.70882328148225
Task_20115,1777,1002,119,112,231,1.7716849451645065,38.405641793805536
Task_20116,1415,892,105,52,157,1.5845464725643896,31.513528195802028
Task_20117,1575,231,34,106,140,6.788793103448276,32.16280814512255
Task_20118,666,1021,126,198,324,0.6516634050880626,21.50769803684051
Task_20119,2347,539,189,152,341,4.3462962962962965,46.550799687881785
Task_20120,2359,319,66,60,126,7.371875,44.54068379363599
Task_20121,1828,993,34,13,47,1.8390342052313884,36.857739752100066
Task_20122,1177,328,167,147,314,3.5775075987841944,27.225523587100096
Task_20123,623,820,23,169,192,0.758830694275274,19.417171388109495
Task_20124,1705,483,17,173,190,3.522727272727273,35.51298155461999
Task_20125,2616,90,142,126,268,28.747252747252748,48.30525843888561
Task_20126,2268,838,38,72,110,2.703218116805721,44.70481319385883
Task_20127,2975,366,126,74,200,8.106267029972752,54.993160827105925
Task_20128,1861,980,78,124,202,1.8970438328236494,39.63573672961085
Task_20129,1071,578,15,131,146,1.849740932642487,25.363792843912602
Task_20130,2566,827,73,91,164,3.0990338164251208,50.05440210267915
Task_20131,2267,764,108,143,251,2.9633986928104576,45.57669445061007
Task_20132,2595,720,160,110,270,3.5991678224687935,50.67161440650349
Task_20133,2570,418,68,102,170,6.133651551312649,48.868917451514456
Task_20134,1115,749,91,58,149,1.4866666666666666,26.317318896259675
Task_20135,884,159,187,188,375,5.525,22.185296448031817
Task_20136,2737,640,78,45,123,4.2698907956318255,51.11428050770084
Task_20137,2667,699,199,99,298,3.81,51.84993419735406
Task_20138,2177,540,190,105,295,4.024029574861368,43.58605548029667
Task_20139,1072,887,99,63,162,1.2072072072072073,26.134122300568418
Task_20140,2927,670,66,138,204,4.362146050670641,55.593265989102385
Task_20141,2363,836,146,188,334,2.823178016726404,47.76321147841136
Task_20142,2838,638,156,128,284,4.44131455399061,54.35030841238472
Task_20143,1154,395,87,25,112,2.914141414141414,25.12632612969887
Task_20144,2045,754,173,63,236,2.7086092715231787,41.56105783057334
Task_20145,836,735,186,35,221,1.1358695652173914,22.022531104034744
Task_20146,1707,802,124,172,296,2.1257783312577834,37.068925452008195
Task_20147,2385,488,183,151,334,4.877300613496932,46.955362136084624
Task_20148,1145,239,25,187,212,4.770833333333333,26.009977269880576
Task_20149,1056,303,100,61,161,3.473684210526316,23.98288731736494
Task_20150,609,733,186,73,259,0.829700272479564,18.942848785207786
Task_20151,2489,666,113,154,267,3.7316341829085458,48.87297984716478
Task_20152,2482,846,22,49,71,2.9303423848878394,47.12282064660325
Task_20153,2450,310,165,60,225,7.877813504823151,46.443388512294625
Task_20154,2546,123,98,106,204,20.532258064516128,47.212557238814185
Task_20155,680,889,170,144,314,0.7640449438202247,21.107344705313455
Task_20156,2505,696,64,14,78,3.593974175035868,46.80234256446838
Task_20157,1014,380,96,131,227,2.661417322834646,24.406362199211713
Task_20158,2870,405,123,161,284,7.068965517241379,54.148344580136914
Task_20159,2675,706,110,89,199,3.783592644978784,51.50131949917344
Task_20160,1410,84,90,131,221,16.58823529411765,29.13135649492988
Task_20161,1056,886,79,163,242,1.1905298759864713,26.751051777721056
Task_20162,1910,568,173,188,361,3.3567662565905096,39.86644915557684
Task_20163,2988,102,46,89,135,29.009708737864077,53.236865233958575
Task_20164,567,245,98,178,276,2.3048780487804876,17.1924232639096
Task_20165,1451,651,153,150,303,2.2254601226993866,32.54139554900524
Task_20166,999,121,20,116,136,8.188524590163935,22.08138770144451
Task_20167,566,543,59,86,145,1.0404411764705883,17.226508067823953
Task_20168,2972,987,90,171,261,3.0080971659919027,57.52552601669003
Task_20169,579,716,103,103,206,0.8075313807531381,18.411125678015534
Task_20170,2664,203,199,130,329,13.058823529411764,50.32244339947241
Task_20171,2535,555,151,62,213,4.559352517985611,48.55012055089289
Task_20172,519,90,148,123,271,5.7032967032967035,15.412965380520129
Task_20173,2872,892,72,92,164,3.2161254199328106,55.100957278686735
Task_20174,1911,108,136,69,205,17.53211009174312,36.59531368932344
Task_20175,2061,413,185,106,291,4.978260869565218,41.323807527901266
Task_20176,746,589,82,32,114,1.264406779661017,19.350795899846155
Task_20177,1106,272,120,94,214,4.051282051282051,25.38454727145911
Task_20178,1845,640,109,34,143,2.8783151326053042,37.23073550416569
Task_20179,2680,1019,34,89,123,2.627450980392157,52.0648520454829
Task_20180,1829,937,71,41,112,1.9498933901918976,37.567355204043444
Task_20181,2369,575,80,186,266,4.112847222222222,46.779284782059655
Task_20182,610,727,68,65,133,0.8379120879120879,18.396966239843223
Task_20183,2570,186,142,154,296,13.743315508021391,48.692725203227155
Task_20184,1000,881,14,79,93,1.1337868480725624,24.511821637257484
Task_20185,1838,408,76,75,151,4.493887530562347,36.864340886127444
Task_20186,2851,544,13,31,44,5.231192660550459,51.76041185834227
Task_20187,1074,699,76,73,149,1.5342857142857143,25.663613788181518
Task_20188,2685,393,110,97,207,6.814720812182741,50.76835584892405
Task_20189,2317,907,127,90,217,2.551762114537445,46.5534323039171
Task_20190,2676,776,75,104,179,3.444015444015444,51.75123874241208
Task_20191,1017,358,100,46,146,2.832869080779944,23.291322127619868
Task_20192,1475,305,144,51,195,4.8202614379084965,30.87130710730709
Task_20193,1143,152,51,70,121,7.470588235294118,24.300573639148556
Task_20194,1350,239,113,185,298,5.625,29.647423829717866
Task_20195,1589,806,37,107,144,1.9690210656753409,34.26887806543421
Task_20196,1280,717,142,16,158,1.7827298050139275,28.4785363202633
Task_20197,2434,137,24,138,162,17.63768115942029,45.0806214475499
Task_20198,1691,499,197,94,291,3.382,35.71997414230238
Task_20199,2825,99,114,55,169,28.25,50.608006861530875
Task_20200,765,300,131,33,164,2.5415282392026577,19.274397359814277
Task_20201,1261,578,58,132,190,2.1778929188255614,28.83475771833604
Task_20202,2367,432,40,37,77,5.466512702078522,43.91411041020035
Task_20203,1491,298,26,176,202,4.986622073578595,31.615354009791687
Task_20204,1401,800,169,124,293,1.749063670411985,32.117386934471476
Task_20205,2734,695,169,73,242,3.92816091954023,52.384182778363936
Task_20206,1615,934,129,80,209,1.7272727272727273,35.38602882070212
Task_20207,1893,663,53,13,66,2.8509036144578315,36.86086383768697
Task_20208,749,967,112,161,273,0.7737603305785123,22.281737377474652
Task_20209,2608,94,165,130,295,27.45263157894737,48.286874909234236
Task_20210,1055,197,151,133,284,5.328282828282828,24.74314502340374
Task_20211,1381,175,177,50,227,7.846590909090909,28.725094326347143
Task_20212,2319,429,28,14,42,5.3930232558139535,42.8020375701914
Task_20213,2338,259,27,161,188,8.992307692307692,44.7738710100287
Task_20214,1601,416,33,173,206,3.839328537170264,33.775525904592655
Task_20215,1619,617,122,93,215,2.6197411003236244,34.59896757906248
Task_20216,2088,845,44,177,221,2.4680851063829787,42.92545349182492
Task_20217,2745,709,76,28,104,3.8661971830985915,51.26235412010933
Task_20218,2178,443,79,50,129,4.905405405405405,41.95170164211104
Task_20219,2875,584,112,85,197,4.914529914529915,54.23153613783426
Task_20220,536,146,181,118,299,3.6462585034013606,16.18590154502678
Task_20221,1694,355,52,117,169,4.758426966292135,34.817390960961475
Task_20222,739,783,44,170,214,0.9426020408163265,21.224668718970808
Task_20223,2379,765,15,122,137,3.1057441253263707,46.582217222996285
Task_20224,2803,1016,37,178,215,2.7561455260570304,54.77033965395404
Task_20225,2452,817,55,160,215,2.997555012224939,48.60602853356182
Task_20226,764,341,184,144,328,2.2339181286549707,20.794034723561936
Task_20227,1543,192,38,62,100,7.994818652849741,30.87867538325808
Task_20228,800,421,29,155,184,1.8957345971563981,20.951862867797075
Task_20229,640,708,48,12,60,0.9026798307475318,17.41998477219386
Task_20230,2765,539,112,136,248,5.12037037037037,52.72663947763622
Task_20231,547,664,151,117,268,0.8225563909774436,18.027265586548474
Task_20232,2396,241,99,196,295,9.900826446280991,46.183006567208686
Task_20233,1430,607,11,97,108,2.351973684210526,30.754375791765668
Task_20234,1464,201,196,163,359,7.247524752475248,31.556048763614914
Task_20235,2614,114,33,10,43,22.730434782608697,46.071413644242746
Task_20236,1478,477,36,120,156,3.092050209205021,31.54938326878378
Task_20237,2386,772,65,20,85,3.0866752910737385,45.51337450555649
Task_20238,683,698,165,192,357,0.977110157367668,20.794138771439595
Task_20239,1490,143,61,72,133,10.347222222222221,29.971728698219977
Task_20240,1559,513,164,21,185,3.0330739299610894,32.51350718577491
Task_20241,1148,504,177,93,270,2.273267326732673,27.033421591758426
Task_20242,1596,129,130,109,239,12.276923076923078,32.48083351897612
Task_20243,1908,594,45,20,65,3.2067226890756304,36.94220415213062
Task_20244,1710,963,110,107,217,1.7738589211618256,37.1524314916098
Task_20245,830,938,130,92,222,0.8839190628328009,23.077080352250054
Task_20246,1362,909,198,144,342,1.4967032967032967,32.05880418785885
Task_20247,1590,433,65,95,160,3.6635944700460827,33.244311826793975
Task_20248,2444,1022,76,123,199,2.389051808406647,48.99016763885297
Task_20249,2306,392,70,182,252,5.867684478371501,45.13967554175599
Task_20250,2875,552,81,159,240,5.198915009041591,54.5612499459869
Task_20251,2050,977,43,37,80,2.096114519427403,40.8704742228094
Task_20252,2911,788,31,43,74,3.6894803548795942,53.642033335375544
Task_20253,1298,355,65,103,168,3.646067415730337,28.52592394834228
Task_20254,2537,299,188,139,327,8.456666666666667,48.67975081551341
Task_20255,1757,941,164,52,216,1.865180467091295,37.49741350005314
Task_20256,1983,200,113,11,124,9.865671641791044,37.64989841734717
Task_20257,1926,289,132,180,312,6.641379310344828,38.977919343549225
Task_20258,1854,66,165,51,216,27.671641791044777,35.29532498269424
Task_20259,1421,273,52,12,64,5.186131386861314,28.14125348836353
Task_20260,2069,676,143,199,342,3.056129985228951,42.65600076413548
Task_20261,2125,777,191,123,314,2.7313624678663238,43.622441956940214
Task_20262,2281,665,15,171,186,3.424924924924925,45.189007836457485
Task_20263,2451,872,160,156,316,2.8075601374570445,49.14206098851965
Task_20264,800,787,44,96,140,1.015228426395939,21.6326494370972
Task_20265,2586,375,151,149,300,6.877659574468085,49.608588555833876
Task_20266,1537,757,126,161,287,2.0277044854881265,34.17871530218377
Task_20267,868,847,166,14,180,1.0235849056603774,22.573797078314595
Task_20268,1866,357,129,51,180,5.212290502793296,37.152855968431766
Task_20269,2142,405,157,141,298,5.275862068965517,42.662258931638235
Task_20270,906,929,148,111,259,0.9741935483870968,24.48157772267018
Task_20271,2705,608,134,21,155,4.441707717569787,50.73402623425272
Task_20272,2673,727,136,12,148,3.6717032967032965,50.56993791857525
Task_20273,1260,223,18,83,101,5.625,26.71745045089683
Task_20274,1684,975,157,51,208,1.7254098360655739,36.34448168798236
Task_20275,671,964,144,173,317,0.6953367875647668,21.328046202501685
Task_20276,2612,391,134,68,202,6.663265306122449,49.236857437987574
Task_20277,1528,757,164,34,198,2.015831134564644,32.940120637534726
Task_20278,2807,674,91,200,291,4.158518518518519,54.110169807938796
Task_20279,649,356,164,151,315,1.8179271708683473,18.974166427400323
Task_20280,2066,434,36,191,227,4.749425287356321,41.32204747908524
Task_20281,2821,536,91,139,230,5.253258845437617,53.52625172624362
Task_20282,2822,1015,199,192,391,2.77755905511811,55.85821119387691
Task_20283,2756,657,106,71,177,4.188449848024316,52.276834562030785
Task_20284,1003,994,149,23,172,1.0080402010050251,25.151386829333266
Task_20285,1044,106,79,39,118,9.757009345794392,22.025740794751055
Task_20286,742,112,111,76,187,6.566371681415929,18.21963375761679
Task_20287,550,792,174,190,364,0.6935687263556116,19.11645645107127
Task_20288,2231,627,36,119,155,3.5525477707006368,43.94214253029201
Task_20289,624,139,76,189,265,4.457142857142857,17.53998480605293
Task_20290,1434,1014,179,73,252,1.412807881773399,32.800425023657475
Task_20291,664,73,50,112,162,8.972972972972974,16.90797716204352
Task_20292,688,375,135,183,318,1.8297872340425532,19.711491003098814
Task_20293,2143,585,74,200,274,3.656996587030717,43.29606999883108
Task_20294,2572,546,10,89,99,4.70201096892139,48.40417238332668
Task_20295,1349,600,10,100,110,2.24459234608985,29.491531934077187
Task_20296,1362,852,27,195,222,1.596717467760844,31.435158218566983
Task_20297,1774,750,20,69,89,2.362183754993342,36.2360933274924
Task_20298,1347,644,14,68,82,2.088372093023256,29.05350674790014
Task_20299,2291,949,64,149,213,2.411578947368421,46.44283818185136
Task_20300,2156,101,122,174,296,21.137254901960784,41.366430985602484
Task_20301,2967,1016,37,161,198,2.9174041297935105,57.267754957820834
Task_20302,2914,994,33,60,93,2.928643216080402,54.95932481173605
Task_20303,1683,651,95,177,272,2.581288343558282,36.12611575365181
Task_20304,1848,365,138,161,299,5.049180327868853,37.91298057852739
Task_20305,1974,455,37,17,54,4.328947368421052,37.57257554440776
Task_20306,1301,97,17,62,79,13.275510204081632,25.804666213944532
Task_20307,2848,92,148,112,260,30.623655913978496,51.89566365840792
Task_20308,1938,1017,173,161,334,1.9037328094302555,41.55308369938883
Task_20309,2713,92,81,26,107,29.172043010752688,47.96098494949641
Task_20310,2258,699,153,20,173,3.2257142857142855,44.11032135541425
Task_20311,1452,220,31,56,87,6.570135746606335,29.267357615908598
Task_20312,2546,129,39,29,68,19.584615384615386,45.39519508270408
Task_20313,2535,666,147,11,158,3.800599700149925,48.214962204946055
Task_20314,1232,413,182,28,210,2.975845410628019,27.21677504122293
Task_20315,604,74,69,62,131,8.053333333333333,15.346276368886654
Task_20316,1125,900,128,191,319,1.248612652608213,28.219067405353655
Task_20317,1890,437,142,82,224,4.315068493150685,38.28721228458408
Task_20318,1016,206,180,92,272,4.908212560386473,23.953745500061604
Task_20319,2353,113,36,75,111,20.640350877192983,42.92786195892099
Task_20320,1668,663,69,154,223,2.5120481927710845,35.73375219538641
Task_20321,1997,74,117,95,212,26.626666666666665,38.23635108609881
Task_20322,2212,617,24,75,99,3.5792880258899675,42.8718924713404
Task_20323,2880,664,188,143,331,4.330827067669173,55.3320663066231
Task_20324,702,185,80,57,137,3.774193548387097,17.989833541298854
Task_20325,943,448,35,190,225,2.1002227171492205,23.582055463039115
Task_20326,1025,310,140,146,286,3.2958199356913185,24.635795678150995
Task_20327,2435,445,47,148,195,5.459641255605381,47.01635629203773
Task_20328,2696,625,153,196,349,4.306709265175719,52.452573844552525
Task_20329,2387,116,112,75,187,20.4017094017094,44.146952093581255
Task_20330,2616,542,115,176,291,4.81767955801105,50.62951824592509
Task_20331,2274,548,190,189,379,4.14207650273224,45.649218339993155
Task_20332,1207,76,113,163,276,15.675324675324676,26.210361223512322
Task_20333,2255,142,138,48,186,15.76923076923077,42.064187859084186
Task_20334,1961,220,106,110,216,8.873303167420815,38.75047951113296
Task_20335,2154,150,182,62,244,14.264900662251655,41.065241177319265
Task_20336,887,758,121,162,283,1.168642951251647,23.79901074404201
Task_20337,2602,897,199,139,338,2.8975501113585747,51.68704378174957
Task_20338,2955,528,54,79,133,5.586011342155009,55.040332503768845
Task_20339,664,545,199,122,321,1.216117216117216,19.7229292709942
Task_20340,1686,240,171,19,190,6.995850622406639,33.654711536989744
Task_20341,542,977,43,150,193,0.5541922290388548,18.72456751374971
Task_20342,2731,529,116,189,305,5.152830188679245,52.49063524118983
Task_20343,1930,798,108,75,183,2.415519399249061,39.726157418405535
Task_20344,2837,659,93,17,110,4.298484848484849,52.64839181510928
Task_20345,1424,522,16,191,207,2.7227533460803057,31.30856956874801
Task_20346,1914,657,98,200,298,2.9088145896656536,39.948552646323854
Task_20347,965,183,127,55,182,5.244565217391305,22.35490795064172
Task_20348,2994,858,31,40,71,3.4854481955762515,55.155270378967906
Task_20349,1622,946,73,154,227,1.712777191129884,35.87909793841699
Task_20350,2781,705,23,61,84,3.9390934844192635,51.86809747216811
Task_20351,1218,413,197,83,280,2.9420289855072466,27.82834502741039
Task_20352,1606,812,126,184,310,1.9753997539975399,35.580597143713995
Task_20353,2663,732,127,80,207,3.6330150068212825,51.35931090090227
Task_20354,1068,339,88,112,200,3.1411764705882352,24.930861059400925
Task_20355,1615,959,112,100,212,1.6822916666666667,35.601811452234436
Task_20356,2878,454,17,182,199,6.325274725274725,54.04354271596849
Task_20357,2045,238,120,43,163,8.556485355648535,39.28274501752028
Task_20358,858,156,63,148,211,5.464968152866242,21.00637407213627
Task_20359,1568,186,111,79,190,8.385026737967914,32.26974142359408
Task_20360,2418,218,183,152,335,11.04109589041096,46.557393316011506
Task_20361,2426,149,158,168,326,16.173333333333332,46.195487754150086
Task_20362,816,374,146,43,189,2.176,20.432087859603268
Task_20363,1342,497,50,164,214,2.6947791164658637,30.048916073810773
Task_20364,2911,481,143,12,155,6.039419087136929,53.563104879579946
Task_20365,2124,628,61,16,77,3.3767885532591415,40.48252621273773
Task_20366,1211,444,80,72,152,2.7213483146067414,26.957367830195242
Task_20367,1197,489,76,18,94,2.442857142857143,25.91522418472403
Task_20368,1428,354,155,69,224,4.022535211267606,30.475744320259697
Task_20369,1019,874,34,175,209,1.1645714285714286,25.929078634722185
Task_20370,2470,280,28,148,176,8.790035587188612,46.853746566481426
Task_20371,1680,652,91,152,243,2.572741194486983,35.90343092366875
Task_20372,2214,150,36,100,136,14.66225165562914,41.45265521253105
Task_20373,2343,550,102,96,198,4.252268602540835,45.824366242271196
Task_20374,2223,757,64,78,142,2.9327176781002637,44.143845821545575
Task_20375,1064,505,158,13,171,2.102766798418972,24.540900942451078
Task_20376,2543,464,15,200,215,5.468817204301075,48.89764715684049
Task_20377,1971,662,189,103,292,2.9728506787330318,40.693624615710824
Task_20378,1564,782,63,100,163,1.9974457215836525,34.04386446739658
Task_20379,2220,964,121,166,287,2.300518134715026,45.65263766587105
Task_20380,508,407,124,200,324,1.2450980392156863,16.951331972660373
Task_20381,629,805,32,138,170,0.7803970223325062,19.290533821210047
Task_20382,2504,628,48,162,210,3.9809220985691574,48.804802917265256
Task_20383,2454,72,182,140,322,33.61643835616438,45.909030320585025
Task_20384,2322,665,162,28,190,3.4864864864864864,45.18100842935069
Task_20385,703,538,146,34,180,1.3042671614100185,19.110276570659654
Task_20386,2342,970,61,172,233,2.411946446961895,47.43713125595645
Task_20387,1130,817,200,69,269,1.3814180929095354,27.392903692803973
Task_20388,2987,123,141,55,196,24.088709677419356,53.74094838884931
Task_20389,518,191,60,104,164,2.6979166666666665,15.631775644061454
Task_20390,1909,977,70,138,208,1.9519427402862985,40.44012465300877
Task_20391,1054,557,36,59,95,1.8888888888888888,24.160004228868726
Task_20392,2939,291,41,130,171,10.065068493150685,54.2448914102527
Task_20393,2802,489,137,50,187,5.718367346938775,52.306605605336976
Task_20394,940,354,35,127,162,2.647887323943662,22.738252500118573
Task_20395,944,677,173,98,271,1.392330383480826,24.32524226855683
Task_20396,1995,537,117,139,256,3.70817843866171,40.56884250671725
Task_20397,2686,72,52,166,218,36.794520547945204,49.131691312867446
Task_20398,2506,816,161,124,285,3.0673194614443084,49.651571577910225
Task_20399,2541,356,183,193,376,7.117647058823529,49.23958867170641
Task_20400,713,951,14,94,108,0.7489495798319328,20.462938496273157
Task_20401,1946,196,163,163,326,9.878172588832488,39.01237993299561
Task_20402,2265,766,12,200,212,2.9530638852672753,45.423123460842284
Task_20403,2068,659,178,144,322,3.1333333333333333,42.41587433933328
Task_20404,523,836,51,195,246,0.6248506571087217,18.41681290729463
Task_20405,2377,190,113,176,289,12.44502617801047,45.625919027264906
Task_20406,1979,931,47,99,146,2.1233905579399144,40.853107228634265
Task_20407,2176,638,26,60,86,3.405320813771518,42.075926481150155
Task_20408,2696,233,106,189,295,11.521367521367521,50.87976942979376
Task_20409,2448,174,137,118,255,13.98857142857143,46.21762115776004
Task_20410,545,510,80,13,93,1.066536203522505,15.736461308590597
Task_20411,1567,469,177,184,361,3.3340425531914892,34.11554452713773
Task_20412,2533,124,87,158,245,20.264,47.240190237799965
Task_20413,2692,108,24,94,118,24.69724770642202,48.37147313774428
Task_20414,1977,334,44,114,158,5.901492537313433,38.97954359889421
Task_20415,896,758,71,129,200,1.1805006587615283,23.58030068731472
Task_20416,1344,485,151,137,288,2.765432098765432,30.23839266219132
Task_20417,1424,843,107,193,300,1.6872037914691944,32.7481447550306
Task_20418,1102,255,65,149,214,4.3046875,25.421837603377938
Task_20419,2204,472,135,112,247,4.659619450317125,43.58913586551932
Task_20420,2585,559,91,38,129,4.616071428571429,48.681384821865436
Task_20421,1267,283,101,71,172,4.461267605633803,27.47231485376282
Task_20422,1407,715,179,164,343,1.9650837988826815,32.245166063702534
Task_20423,2918,540,35,96,131,5.393715341959335,54.50661139531618
Task_20424,2236,918,43,152,195,2.4330794341675737,45.34437038519261
Task_20425,597,624,12,108,120,0.9552,17.681013775421427
Task_20426,790,385,98,180,278,2.0466321243523318,21.176394065768623
Task_20427,1723,385,102,193,295,4.463730569948186,36.02974084357859
Task_20428,2283,869,124,166,290,2.6241379310344826,46.36825209455511
Task_20429,2831,708,82,107,189,3.9929478138222847,54.04160776061675
Task_20430,2159,724,34,145,179,2.9779310344827588,43.40856064549496
Task_20431,2325,930,150,33,183,2.497314715359828,46.019164628064736
Task_20432,2375,204,177,73,250,11.585365853658537,45.094906918398955
Task_20433,2734,624,168,12,180,4.3744,51.44304196751659
Task_20434,2135,161,165,42,207,13.179012345679013,40.407131625981314
Task_20435,2389,815,78,95,173,2.9276960784313726,47.31024284650664
Task_20436,1042,1015,73,13,86,1.0255905511811023,25.127738830197075
Task_20437,2632,85,102,147,249,30.6046511627907,48.45617445261147
Task_20438,2284,176,111,89,200,12.903954802259888,43.28210029430603
Task_20439,1195,800,77,188,265,1.491885143570537,28.863291735601496
Task_20440,1543,863,68,134,202,1.7858796296296295,34.25418078349231
Task_20441,2703,910,68,132,200,2.9670691547749724,52.76899878700581
Task_20442,1166,232,146,134,280,5.0042918454935625,26.561030444693404
Task_20443,791,604,110,143,253,1.3074380165289257,21.64511080939646
Task_20444,1179,973,116,160,276,1.2104722792607803,29.06151753200234
Task_20445,755,312,109,134,243,2.412140575079872,20.161516516623742
Task_20446,1602,438,57,178,235,3.6492027334851938,34.06020360049516
Task_20447,1693,123,137,60,197,13.653225806451612,33.36088536551661
Task_20448,1734,816,101,126,227,2.1223990208078334,37.16191064559407
Task_20449,656,811,75,102,177,0.8078817733990148,19.798620213438763
Task_20450,1441,520,27,147,174,2.7658349328214973,31.35342624618869
Task_20451,2885,380,198,149,347,7.572178477690288,54.56783188101931
Task_20452,2293,202,81,17,98,11.295566502463053,42.283731509768465
Task_20453,2312,934,179,122,301,2.4727272727272727,47.015637757188536
Task_20454,2262,916,164,180,344,2.4667393675027265,46.44606159802671
Task_20455,2194,521,179,103,282,4.203065134099617,43.732946874410665
Task_20456,2140,451,144,107,251,4.734513274336283,42.51885394002634
Task_20457,2362,754,114,157,271,3.128476821192053,47.16096831543802
Task_20458,1752,265,172,199,371,6.586466165413534,36.438620149586676
Task_20459,1797,694,183,200,383,2.585611510791367,38.590348237924225
Task_20460,2490,826,46,142,188,3.010882708585248,49.03883317069411
Task_20461,1008,508,16,130,146,1.9803536345776032,24.13801301772432
Task_20462,1733,576,61,155,216,3.003466204506066,36.45412852766105
Task_20463,2401,183,47,199,246,13.048913043478262,45.754278717087686
Task_20464,2220,315,135,94,229,7.025316455696203,43.20870039126765
Task_20465,1635,1013,12,56,68,1.6124260355029585,34.33282784940553
Task_20466,2537,863,78,164,242,2.9363425925925926,50.221700402307015
Task_20467,886,1013,65,142,207,0.873767258382643,24.274128013457343
Task_20468,1411,311,25,84,109,4.522435897435898,29.5434150816448
Task_20469,1103,1007,63,100,163,1.0942460317460319,27.343662269566398
Task_20470,744,275,137,172,309,2.6956521739130435,20.221941763347658
Task_20471,2456,992,131,41,172,2.473313192346425,48.247770499437536
Task_20472,2818,184,111,102,213,15.232432432432432,52.0316555468894
Task_20473,2428,445,100,59,159,5.443946188340807,46.12335373940547
Task_20474,968,623,177,134,311,1.5512820512820513,24.774060570663
Task_20475,2051,462,69,13,82,4.429805615550756,39.2775319261683
Task_20476,2585,177,129,126,255,14.52247191011236,48.38269610219214
Task_20477,2717,775,119,128,247,3.5012886597938144,52.700286169725835
Task_20478,1171,673,78,184,262,1.7373887240356083,28.093731186041225
Task_20479,1084,677,200,139,339,1.59882005899705,26.942288867655236
Task_20480,2860,977,179,125,304,2.9243353783231085,55.851489141511
Task_20481,526,475,148,22,170,1.1050420168067228,15.969906769921549
Task_20482,2250,696,102,56,158,3.2281205164992826,44.12547585380472
Task_20483,1797,487,52,105,157,3.682377049180328,36.65851336859424
Task_20484,2582,362,12,198,210,7.112947658402204,49.131705706918574
Task_20485,562,613,96,75,171,0.9153094462540716,17.41789624402666
Task_20486,1341,837,113,170,283,1.600238663484487,31.304115481714252
Task_20487,2712,545,185,70,255,4.967032967032967,51.56385190539805
Task_20488,1612,361,157,61,218,4.45303867403315,33.32607937075853
Task_20489,2386,627,33,152,185,3.799363057324841,46.72219629585331
Task_20490,2088,728,196,142,338,2.8641975308641974,43.01875338630477
Task_20491,2553,618,19,104,123,4.124394184168013,48.764366600120916
Task_20492,1999,598,113,91,204,3.337228714524207,40.46606558447244
Task_20493,1011,983,115,105,220,1.0274390243902438,26.101644156867632
Task_20494,1313,294,135,11,146,4.450847457627119,27.67671986480775
Task_20495,1094,737,188,40,228,1.4823848238482384,26.143910282699157
Task_20496,1507,918,183,169,352,1.6398258977149076,34.49534421020442
Task_20497,1091,317,98,60,158,3.430817610062893,24.56671187477521
Task_20498,2864,136,16,24,40,20.905109489051096,50.26679114415655
Task_20499,1752,267,155,170,325,6.537313432835821,36.195708780584944
Task_20500,753,92,54,189,243,8.096774193548388,19.097918706883167
Task_20501,2568,158,69,62,131,16.150943396226417,47.048098287359316
Task_20502,562,535,55,93,148,1.0485074626865671,17.170406139528104
Task_20503,1970,715,75,171,246,2.7513966480446927,40.80140665227523
Task_20504,1531,315,181,132,313,4.844936708860759,32.75451368977472
Task_20505,1957,903,81,47,128,2.1648230088495577,39.89184352738069
Task_20506,998,811,144,46,190,1.229064039408867,24.691084598256534
Task_20507,1148,718,199,184,383,1.5966620305980528,28.3479094094176
Task_20508,2699,64,149,189,338,41.52307692307692,49.854843552046994
Task_20509,2207,106,103,195,298,20.626168224299064,42.24512691576326
Task_20510,640,301,71,129,200,2.119205298013245,18.166889887474778
Task_20511,2188,940,180,90,270,2.325185972369819,44.85106585539762
Task_20512,1192,270,65,152,217,4.398523985239852,26.912060093439308
Task_20513,2739,211,189,162,351,12.919811320754716,51.68500769501048
Task_20514,2998,901,180,96,276,3.3237250554323725,57.66012994369924
Task_20515,1402,985,31,196,227,1.4219066937119675,32.47680974492117
Task_20516,2052,836,97,148,245,2.4516129032258065,42.38366824465821
Task_20517,2611,983,107,89,196,2.6534552845528454,51.34226944551244
Task_20518,2758,479,113,10,123,5.745833333333334,50.86381000357591
Task_20519,2858,911,88,33,121,3.133771929824561,53.84828483526496
Task_20520,2532,632,161,147,308,4.0,49.62081746239744
Task_20521,983,138,136,121,257,7.071942446043166,22.967440699640644
Task_20522,2705,341,196,93,289,7.909356725146199,51.227358938376824
Task_20523,1916,972,200,59,259,1.9691675231243577,40.25399684664211
Task_20524,1640,297,81,133,214,5.503355704697986,34.026400247808006
Task_20525,2749,789,59,141,200,3.479746835443038,53.12843960972342
Task_20526,2803,96,33,31,64,28.896907216494846,49.008867028123284
Task_20527,1503,696,180,166,346,2.1563845050215207,33.72300002141987
Task_20528,2731,663,193,126,319,4.1129518072289155,52.88986307527788
Task_20529,1016,326,55,97,152,3.1070336391437308,23.775188476289276
Task_20530,2234,293,154,126,280,7.598639455782313,43.63749865351985
Task_20531,922,940,161,65,226,0.9798087141339001,24.386706389596053
Task_20532,2960,206,26,193,219,14.29951690821256,54.589739622371354
Task_20533,1872,525,38,83,121,3.55893536121673,37.68654536130587
Task_20534,1321,1019,127,147,274,1.2950980392156863,31.429391282561138
Task_20535,705,911,113,94,207,0.7730263157894737,21.012273995781353
Task_20536,2250,384,107,143,250,5.8441558441558445,44.088499299313014
Task_20537,536,316,78,160,238,1.6908517350157728,16.780322581149928
Task_20538,1594,278,178,191,369,5.71326164874552,33.965289659877904
Task_20539,825,806,166,33,199,1.0223048327137547,21.95885146785795
Task_20540,553,365,186,96,282,1.510928961748634,17.24008280913513
Task_20541,1870,873,22,93,115,2.139588100686499,38.684694603910586
Task_20542,924,241,87,176,263,3.8181818181818183,22.71381016749142
Task_20543,768,898,24,76,100,0.8542825361512792,20.952944743597488
Task_20544,1069,640,164,46,210,1.6677067082683308,25.376389551883864
Task_20545,1859,967,146,163,309,1.9204545454545454,40.036144869890364
Task_20546,2012,391,74,163,237,5.13265306122449,40.37717946859592
Task_20547,1298,245,34,72,106,5.276422764227642,27.337330387687896
Task_20548,712,474,13,186,199,1.4989473684210526,19.808120286526485
Task_20549,506,444,65,114,179,1.1370786516853932,16.28496711316352
Task_20550,1136,677,110,18,128,1.6755162241887906,26.048604684255462
Task_20551,1379,904,46,48,94,1.5237569060773481,30.19582875534393
Task_20552,2973,762,164,168,332,3.896461336828309,57.15669003315486
Task_20553,2781,304,21,47,68,9.118032786885246,50.0266980746683
Task_20554,2942,933,14,59,73,3.1498929336188435,54.79814833910202
Task_20555,2634,589,96,53,149,4.464406779661017,49.935005035538836
Task_20556,1980,365,107,197,304,5.409836065573771,40.07649583631447
Task_20557,539,390,128,193,321,1.3785166240409208,17.375479326229108
Task_20558,691,377,180,40,220,1.8280423280423281,18.602796746389327
Task_20559,2267,381,183,122,305,5.93455497382199,44.56462163238942
Task_20560,2899,885,128,65,193,3.2720090293453725,55.32978927651077
Task_20561,2075,547,193,34,227,3.7864963503649633,41.07404265755873
Task_20562,2760,883,78,42,120,3.1221719457013575,52.17997406376034
Task_20563,1846,694,35,16,51,2.656115107913669,36.266364726006664
Task_20564,2478,931,81,106,187,2.6587982832618025,49.139218446031265
Task_20565,2214,212,133,12,145,10.394366197183098,41.62055788091461
Task_20566,2268,139,20,43,63,16.2,41.20742047495421
Task_20567,2876,708,80,46,126,4.056417489421721,53.65360363513523
Task_20568,2371,949,145,72,217,2.4957894736842103,47.32485099930668
Task_20569,2106,593,153,175,328,3.5454545454545454,42.88167766754262
Task_20570,667,404,133,70,203,1.6469135802469135,18.514132588498445
Task_20571,1534,269,90,46,136,5.681481481481481,31.096461301093527
Task_20572,1560,603,91,92,183,2.5827814569536423,33.41034464189345
Task_20573,1637,325,106,27,133,5.021472392638037,32.85023274848979
Task_20574,2165,214,53,138,191,10.069767441860465,41.94960887212304
Task_20575,1039,465,108,39,147,2.2296137339055795,23.960517452178987
Task_20576,2992,408,108,137,245,7.315403422982885,55.87799188030235
Task_20577,1095,802,63,174,237,1.3636363636363635,27.122417530892562
Task_20578,2270,433,39,132,171,5.2304147465437785,44.145587748573234
Task_20579,1487,430,113,90,203,3.4501160092807424,31.84310642841662
Task_20580,764,688,16,123,139,1.1088534107402033,20.712435613008108
Task_20581,2536,240,160,151,311,10.522821576763485,48.39538448563397
Task_20582,2414,201,41,92,133,11.950495049504951,45.31686919995284
Task_20583,651,465,124,173,297,1.3969957081545064,19.244988815407382
Task_20584,2980,549,30,128,158,5.418181818181818,55.562114410297596
Task_20585,2485,819,160,183,343,3.0304878048780486,49.676157437447465
Task_20586,1351,690,35,10,45,1.955137481910275,28.34471796121853
Task_20587,558,711,160,82,242,0.7837078651685393,18.1424909174685
Task_20588,1588,68,59,125,184,23.014492753623188,31.68534986637117
Task_20589,1383,190,49,73,122,7.2408376963350785,28.85016597875392
Task_20590,2849,678,129,186,315,4.195876288659794,54.876421742762524
Task_20591,854,637,106,143,249,1.3385579937304075,22.74172101277631
Task_20592,1817,253,97,93,190,7.153543307086614,36.44064893267744
Task_20593,1461,677,169,97,266,2.1548672566371683,32.565029920463004
Task_20594,2845,599,189,157,346,4.741666666666666,54.65862619396071
Task_20595,1275,406,174,48,222,3.1326781326781328,27.981345264005004
Task_20596,2585,672,199,163,362,3.8410104011887074,50.85390092959957
Task_20597,917,890,97,37,134,1.0291806958473626,23.286458861048047
Task_20598,594,771,66,90,156,0.7694300518134715,18.502971700515666
Task_20599,1716,535,78,82,160,3.201492537313433,35.51239618546476
Task_20600,2917,936,192,152,344,3.113127001067236,56.84646387835892
Task_20601,1090,962,154,90,244,1.1318795430944963,27.328261717997822
Task_20602,1985,706,84,141,225,2.8076379066478077,40.817232219348476
Task_20603,2224,533,29,40,69,4.164794007490637,41.904347758305995
Task_20604,777,75,33,86,119,10.223684210526315,18.153066072178785
Task_20605,2023,653,64,56,120,3.0932721712538225,39.97305137671518
Task_20606,2018,871,99,165,264,2.3142201834862384,42.058687552122116
Task_20607,1420,456,40,151,191,3.1072210065645516,30.94260817220237
Task_20608,1891,240,12,180,192,7.846473029045643,37.676264759267184
Task_20609,577,77,187,180,367,7.397435897435898,16.786881527296206
Task_20610,2170,121,161,77,238,17.78688524590164,41.150800198807545
Task_20611,665,571,45,21,66,1.1625874125874125,17.353687134273382
Task_20612,2380,475,12,43,55,5.0,44.234350425712144
Task_20613,1506,189,86,125,211,7.926315789473684,31.43251760809784
Task_20614,2107,760,118,171,289,2.7687253613666227,43.24172788634295
Task_20615,2464,674,11,33,44,3.6503703703703705,46.0284945962137
Task_20616,2864,127,97,158,255,22.375,52.57498929995308
Task_20617,669,64,158,170,328,10.292307692307693,18.07220777029527
Task_20618,1484,337,49,80,129,4.390532544378698,31.206819481487752
Task_20619,2932,998,125,50,175,2.934934934934935,55.92650155869708
Task_20620,2832,574,130,24,154,4.925217391304348,52.618989673196744
Task_20621,748,126,100,21,121,5.889763779527559,17.58957332538284
Task_20622,1290,953,52,124,176,1.3522012578616351,30.31113203187994
Task_20623,1842,545,191,148,339,3.3736263736263736,38.55898880776821
Task_20624,2872,357,12,92,104,8.022346368715084,52.681987523296925
Task_20625,1186,824,100,144,244,1.4375757575757575,28.553666122592187
Task_20626,2954,949,75,166,241,3.1094736842105264,57.094523428907046
Task_20627,2544,919,39,138,177,2.765217391304348,50.09372604969405
Task_20628,1170,855,156,109,265,1.3668224299065421,28.446629053371854
Task_20629,2719,708,57,96,153,3.834978843441467,51.946686341541785
Task_20630,2213,529,139,17,156,4.175471698113207,42.67064029784714
Task_20631,2764,959,106,137,243,2.879166666666667,54.01667607483436
Task_20632,1800,616,51,108,159,2.9173419773095626,37.14909595739805
Task_20633,662,495,64,105,169,1.3346774193548387,18.8574774516798
Task_20634,946,160,96,193,289,5.875776397515528,22.80244880325662
Task_20635,1119,107,141,117,258,10.36111111111111,24.859203902991112
Task_20636,1201,563,140,43,183,2.129432624113475,27.078236517307676
Task_20637,2392,517,14,125,139,4.617760617760617,46.02740513765382
Task_20638,1439,786,160,64,224,1.8284625158831005,32.013441224744085
Task_20639,2839,892,58,11,69,3.1791713325867863,52.56431211616248
Task_20640,2923,621,34,109,143,4.69935691318328,54.80165109442424
Task_20641,638,399,24,111,135,1.595,17.845223484576888
Task_20642,1310,423,178,176,354,3.089622641509434,29.857913736786884
Task_20643,2000,1007,133,78,211,1.9841269841269842,41.70556907477225
Task_20644,1986,669,109,145,254,2.964179104477612,40.843529967851076
Task_20645,532,1003,76,86,162,0.5298804780876494,18.46434090742731
Task_20646,1095,954,171,168,339,1.1465968586387434,27.96295078246675
Task_20647,1297,302,37,68,105,4.2805280528052805,27.48189091062947
Task_20648,1472,326,79,83,162,4.5015290519877675,31.013199000196504
Task_20649,2066,885,107,182,289,2.3318284424379234,42.998787033143
Task_20650,2662,290,147,181,328,9.147766323024054,50.69011219644627
Task_20651,1658,340,183,20,203,4.86217008797654,33.61668938819879
Task_20652,2653,564,109,42,151,4.695575221238938,49.809469073570654
Task_20653,847,692,148,62,210,1.2222222222222223,22.229116385572052
Task_20654,2973,969,28,32,60,3.0649484536082476,55.104714823786566
Task_20655,2697,695,121,32,153,3.875,50.92163140071921
Task_20656,1305,731,172,125,297,1.7827868852459017,30.401319095186846
Task_20657,1356,988,96,182,278,1.3710819009100101,31.967283504410783
Task_20658,1394,741,28,55,83,1.8787061994609164,29.998439497503046
Task_20659,1346,387,82,170,252,3.4690721649484537,29.885806767821748
Task_20660,1520,679,133,131,264,2.235294117647059,33.5182564697095
Task_20661,548,869,180,23,203,0.6298850574712643,18.032833784559053
Task_20662,2545,773,67,181,248,3.2881136950904395,50.12578360644955
Task_20663,2142,450,15,33,48,4.749445676274944,40.25555237192569
Task_20664,2121,574,92,133,225,3.688695652173913,42.54079498709809
Task_20665,1048,625,152,121,273,1.6741214057507987,25.886268366131418
Task_20666,2868,125,101,65,166,22.761904761904763,51.69889195245265
Task_20667,1502,746,47,83,130,2.0107095046854084,32.69252058985173
Task_20668,2038,658,190,89,279,3.0925644916540214,41.62055800604468
Task_20669,1755,498,31,58,89,3.5170340681362724,35.00319145065979
Task_20670,2953,658,112,117,229,4.48103186646434,55.971397013195315
Task_20671,1996,851,31,29,60,2.3427230046948355,39.284836178702385
Task_20672,2239,822,67,51,118,2.720534629404617,43.99765857825694
Task_20673,2599,150,143,164,307,17.211920529801326,48.834592371467345
Task_20674,1283,584,131,52,183,2.1931623931623934,28.705530030854643
Task_20675,1405,191,12,19,31,7.317708333333333,27.59239691251848
Task_20676,546,300,81,55,136,1.813953488372093,15.82354497808602
Task_20677,1302,709,116,77,193,1.8338028169014085,29.591444084746882
Task_20678,1412,1013,169,84,253,1.3925049309664694,32.60266349037974
Task_20679,2612,195,65,34,99,13.326530612244898,47.38794806064869
Task_20680,1966,468,71,12,83,4.1918976545842215,37.961457334305685
Task_20681,1326,250,72,191,263,5.282868525896414,29.216925005066127
Task_20682,762,641,89,35,124,1.1869158878504673,19.900588240279017
Task_20683,1590,924,159,10,169,1.718918918918919,34.15966923602218
Task_20684,847,697,83,92,175,1.2134670487106016,22.349037905099753
Task_20685,1425,600,132,179,311,2.3710482529118138,32.048391733635576
Task_20686,566,337,43,177,220,1.6745562130177514,17.21455435946776
Task_20687,2056,737,52,41,93,2.785907859078591,40.30348001198649
Task_20688,2503,813,145,58,203,3.074938574938575,48.81559569945773
Task_20689,947,269,128,137,265,3.5074074074074075,23.161233829527536
Task_20690,2610,124,24,180,204,20.88,48.27707868422495
Task_20691,1520,214,152,88,240,7.069767441860465,31.781733857853038
Task_20692,594,467,16,22,38,1.2692307692307692,15.66760992835914
Task_20693,1308,837,196,47,243,1.5608591885441527,29.937030076125968
Task_20694,2299,343,125,196,321,6.683139534883721,45.12416729769225
Task_20695,2340,576,59,118,177,4.055459272097054,45.8132629305276
Task_20696,2933,94,157,159,316,30.873684210526317,53.52557239514173
Task_20697,2781,409,176,121,297,6.782926829268293,52.75331905867828
Task_20698,1261,694,55,147,202,1.814388489208633,29.276168297696188
Task_20699,2495,615,36,160,196,4.050324675324675,48.509675357996315
Task_20700,1994,871,82,181,263,2.286697247706422,41.73771158760699
Task_20701,2031,765,166,16,182,2.651436031331593,40.739061545857595
Task_20702,1449,840,156,181,337,1.72294887039239,33.28409565687969
Task_20703,2159,935,23,90,113,2.3066239316239314,43.460489455428934
Task_20704,2780,763,117,85,202,3.6387434554973823,53.31769738187858
Task_20705,2047,901,153,149,302,2.2694013303769403,42.757801397625606
Task_20706,1445,786,194,76,270,1.8360864040660736,32.43868033929528
Task_20707,837,1010,195,116,311,0.827893175074184,23.883823462161377
Task_20708,1844,311,44,12,56,5.910256410256411,35.04293018567639
Task_20709,2376,226,126,163,289,10.466960352422907,45.73359967460471
Task_20710,2011,376,55,132,187,5.334217506631299,40.03672103071859
Task_20711,1122,295,138,126,264,3.7905405405405403,25.99209049474166
Task_20712,2619,649,24,135,159,4.029230769230769,50.158759888115696
Task_20713,1321,254,170,136,306,5.180392156862745,29.2047625958338
Task_20714,1506,81,80,103,183,18.365853658536587,30.43423919529614
Task_20715,1317,880,198,62,260,1.4948921679909195,30.473600864450773
Task_20716,852,717,20,179,199,1.1866295264623956,22.744685067404067
Task_20717,529,744,78,194,272,0.7100671140939597,18.288333328473083
Task_20718,745,856,42,100,142,0.8693115519253208,20.98311923650002
Task_20719,507,358,125,124,249,1.4122562674094707,16.34326972911936
Task_20720,2769,355,131,179,310,7.77808988764045,52.52483796161514
Task_20721,1100,191,41,26,67,5.729166666666667,23.184500438548742
Task_20722,2941,787,138,17,155,3.732233502538071,55.014671882083945
Task_20723,829,150,36,31,67,5.490066225165563,18.57324916326146
Task_20724,2311,688,164,150,314,3.3541364296081277,46.32897798841436
Task_20725,1656,273,187,86,273,6.043795620437956,34.27527672669442
Task_20726,749,728,127,140,267,1.027434842249657,21.424500938165732
Task_20727,2997,407,11,164,175,7.345588235294118,55.61598516886293
Task_20728,2537,559,182,15,197,4.5303571428571425,48.18762523346873
Task_20729,2508,916,63,132,195,2.7350054525627043,49.669287157475935
Task_20730,1121,200,96,35,131,5.577114427860696,24.308962981673233
Task_20731,2340,187,167,89,256,12.446808510638299,44.78966200521702
Task_20732,2552,466,34,77,111,5.464668094218416,48.10858126221899
Task_20733,1348,178,119,198,317,7.5307262569832405,29.258586984130137
Task_20734,2450,631,190,43,233,3.8765822784810124,47.31679670056394
Task_20735,1435,877,161,130,291,1.6343963553530751,32.89511621046247
Task_20736,2536,880,27,28,55,2.8785471055618617,47.92035485471323
Task_20737,2116,488,54,83,137,4.32719836400818,41.60324359590252
Task_20738,2203,686,76,113,189,3.2066957787481805,44.05820577818722
Task_20739,1566,802,181,192,373,1.950186799501868,35.21140127311721
Task_20740,750,825,23,92,115,0.9079903147699758,20.671916717183876
Task_20741,2456,856,63,137,200,2.865810968494749,48.687702342929036
Task_20742,2058,186,192,30,222,11.005347593582888,39.62675333274
Task_20743,1584,990,144,161,305,1.598385469223007,35.71530202331283
Task_20744,2580,974,47,64,111,2.646153846153846,49.99502277699761
Task_20745,1414,394,12,116,128,3.579746835443038,30.24554923403772
Task_20746,1228,681,106,111,217,1.8005865102639296,28.658171999789886
Task_20747,1430,752,196,154,350,1.899070385126162,32.74173069717286
Task_20748,515,74,133,31,164,6.866666666666666,13.91643621117985
Task_20749,2807,473,57,149,206,5.921940928270042,53.07348514253555
Task_20750,2456,191,83,182,265,12.791666666666666,46.81455735559516
Task_20751,1373,464,73,58,131,2.9526881720430107,29.458078030523314
Task_20752,2615,209,119,33,152,12.452380952380953,47.981087705670596
Task_20753,891,123,61,67,128,7.185483870967742,20.41589475639133
Task_20754,1426,72,187,135,322,19.534246575342465,29.81648881915899
Task_20755,1744,760,183,55,238,2.2917214191852824,36.786211885944894
Task_20756,826,286,86,155,241,2.8780487804878048,21.182515631478626
Task_20757,1285,808,132,77,209,1.588380716934487,29.67537482614043
Task_20758,1521,921,76,100,176,1.6496746203904555,33.872714968782965
Task_20759,1676,474,37,178,215,3.528421052631579,35.21395121367494
Task_20760,1756,153,47,62,109,11.402597402597403,33.706401326086485
Task_20761,1254,859,155,103,258,1.458139534883721,29.742648136101835
Task_20762,2196,168,53,159,212,12.994082840236686,42.15709866243873
Task_20763,1680,804,93,121,214,2.0869565217391304,36.24151901962908
Task_20764,1251,544,55,183,238,2.295412844036697,28.86367879110979
Task_20765,2310,355,154,187,341,6.48876404494382,45.4155715977827
Task_20766,2899,184,131,114,245,15.67027027027027,53.47146345508353
Task_20767,1059,464,167,163,330,2.2774193548387096,25.888012161537816
Task_20768,2857,409,124,35,159,6.96829268292683,52.584500258709376
Task_20769,1770,174,134,72,206,10.114285714285714,35.03701867462022
Task_20770,788,580,25,147,172,1.3562822719449226,21.122056742933996
Task_20771,2456,668,124,186,310,3.671150971599402,48.5973241290442
Task_20772,1522,1023,122,160,282,1.486328125,34.700640894479335
Task_20773,1173,515,111,52,163,2.2732558139534884,26.672715860143523
Task_20774,1710,448,62,137,199,3.8084632516703785,35.57994865528059
Task_20775,2068,613,81,44,125,3.3680781758957656,40.45465275434923
Task_20776,2664,103,33,30,63,25.615384615384617,47.04058199577296
Task_20777,741,516,167,62,229,1.4332688588007736,20.081005280049677
Task_20778,2664,836,147,23,170,3.182795698924731,50.9582864011012
Task_20779,2815,362,149,166,315,7.754820936639119,53.27989853376575
Task_20780,2889,849,41,97,138,3.398823529411765,54.99424456747921
Task_20781,2771,542,134,77,211,5.1031307550644565,52.411878734201416
Task_20782,2709,722,154,86,240,3.7468879668049793,52.24707617048849
Task_20783,1494,100,92,159,251,14.792079207920793,30.735140325787512
Task_20784,2536,981,104,170,274,2.5824847250509166,50.66038836935534
Task_20785,616,328,49,194,243,1.872340425531915,18.198311025530703
Task_20786,570,731,54,182,236,0.7786885245901639,18.59870156280677
Task_20787,2220,768,143,180,323,2.886866059817945,45.22339790442453
Task_20788,1314,725,10,131,141,1.8099173553719008,29.609652872574
Task_20789,1209,874,48,144,192,1.3817142857142857,28.90292230881188
Task_20790,875,131,136,120,256,6.628787878787879,21.227940318808542
Task_20791,2153,601,159,194,353,3.5764119601328903,43.79187276098518
Task_20792,2219,409,83,13,96,5.412195121951219,41.8529801360652
Task_20793,2714,671,125,119,244,4.038690476190476,52.29767733493801
Task_20794,2282,759,74,181,255,3.0026315789473683,45.93293711538616
Task_20795,1838,420,143,156,299,4.365795724465558,37.92693179135207
Task_20796,2475,985,194,142,336,2.5101419878296145,49.944592973017755
Task_20797,2789,240,67,125,192,11.572614107883817,51.8921721666791
Task_20798,1946,380,73,80,153,5.107611548556431,38.559406346473956
Task_20799,1166,136,94,93,187,8.510948905109489,25.400829687301663
Task_20800,1703,306,74,127,201,5.547231270358306,34.9926168872675
Task_20801,1581,229,107,97,204,6.873913043478261,32.73703098811877
Task_20802,2050,1011,55,82,137,2.025691699604743,42.221766972085476
Task_20803,749,829,106,65,171,0.9024096385542169,21.016579985405837
Task_20804,1078,723,130,12,142,1.488950276243094,25.177883984563877
Task_20805,2364,465,98,35,133,5.072961373390558,44.83754452305209
Task_20806,2896,650,154,108,262,4.448540706605223,55.17866719737598
Task_20807,2251,688,139,151,290,3.267053701015965,45.27187902763081
Task_20808,1131,1000,174,94,268,1.12987012987013,28.233407194330628
Task_20809,1494,290,54,133,187,5.134020618556701,31.57622559358738
Task_20810,735,855,103,176,279,0.8586448598130841,21.733089642467622
Task_20811,2433,1006,90,29,119,2.4160873882820257,47.403831226731484
Task_20812,2005,422,154,45,199,4.739952718676123,39.43652354773293
Task_20813,587,451,109,93,202,1.2986725663716814,17.61912351063189
Task_20814,2358,723,173,172,345,3.2569060773480665,47.355668139898114
Task_20815,2003,567,132,151,283,3.5264084507042255,40.930151158829815
Task_20816,1288,234,116,15,131,5.480851063829787,26.941786567677728
Task_20817,2573,702,173,145,318,3.660028449502134,50.533963038817944
Task_20818,2133,69,100,88,188,30.47142857142857,40.05524322164897
Task_20819,1483,752,55,14,69,1.9694555112881806,30.64307690258062
Task_20820,756,422,168,172,340,1.7872340425531914,21.018405455284345
Task_20821,2036,520,15,10,25,3.907869481765835,38.504190875516564
Task_20822,977,861,55,115,170,1.1334106728538282,24.977210191539914
Task_20823,2697,546,99,129,228,4.93053016453382,51.573774687170534
Task_20824,2138,806,109,141,250,2.6493184634448577,43.65707121854111
Task_20825,1520,371,183,147,330,4.086021505376344,32.862804863538436
Task_20826,2992,595,166,10,176,5.02013422818792,55.40928607559437
Task_20827,606,395,191,129,320,1.5303030303030303,18.36410258937818
Task_20828,723,1019,42,76,118,0.7088235294117647,21.068982390353458
Task_20829,1695,279,101,29,130,6.053571428571429,33.60838276150768
Task_20830,1715,683,120,198,318,2.507309941520468,36.96111283390719
Task_20831,1583,674,150,141,291,2.3451851851851853,34.63685355665394
Task_20832,1949,773,146,65,211,2.5180878552971575,40.01067084902539
Task_20833,2016,162,46,167,213,12.368098159509202,39.255463589961174
Task_20834,1729,354,178,16,194,4.870422535211268,34.72263187847438
Task_20835,2853,484,96,105,201,5.882474226804124,53.69183432258071
Task_20836,2275,163,39,25,64,13.871951219512194,41.43682105180984
Task_20837,2357,522,132,121,253,4.506692160611855,46.21255495877722
Task_20838,2596,500,106,100,206,5.181636726546906,49.682855296061234
Task_20839,1685,551,145,127,272,3.052536231884058,35.759284243447105
Task_20840,1972,561,135,51,186,3.508896797153025,39.50665364578227
Task_20841,2205,879,165,114,279,2.5056818181818183,45.037770772571015
Task_20842,823,487,110,71,181,1.6864754098360655,21.131835455536926
Task_20843,1599,452,105,93,198,3.5298013245033113,33.68331698658897
Task_20844,1155,589,147,54,201,1.9576271186440677,26.763461635016682
Task_20845,2864,591,149,160,309,4.837837837837838,54.77153745591128
Task_20846,1875,214,128,108,236,8.720930232558139,37.457437073904224
Task_20847,1609,955,151,31,182,1.6830543933054394,34.747246381581874
Task_20848,1680,700,161,52,213,2.3965763195435095,35.51291278379055
Task_20849,1838,566,140,16,156,3.241622574955908,36.84425334440122
Task_20850,2905,875,18,179,197,3.3162100456621006,55.82669510821366
Task_20851,810,645,41,111,152,1.2538699690402477,21.346155765322663
Task_20852,1208,387,193,92,285,3.11340206185567,27.64290160108635
Task_20853,2254,96,99,164,263,23.237113402061855,42.6543623166989
Task_20854,690,727,101,69,170,0.9478021978021978,19.75023246443157
Task_20855,1846,181,101,99,200,10.142857142857142,36.49438711740524
Task_20856,2095,995,86,77,163,2.103413654618474,42.875234835278945
Task_20857,1545,975,195,129,324,1.5829918032786885,35.060195872912615
Task_20858,547,644,131,29,160,0.8480620155038759,16.793284139906476
Task_20859,521,859,138,197,335,0.6058139534883721,18.775741816591317
Task_20860,1402,651,178,118,296,2.1503067484662575,31.686844743921785
Task_20861,2269,402,171,99,270,5.630272952853598,44.46828982936241
Task_20862,602,349,74,131,205,1.72,17.730671948374937
Task_20863,2601,864,187,40,227,3.006936416184971,50.411416221505114
Task_20864,2157,874,62,155,217,2.4651428571428573,44.10940587555424
Task_20865,1714,1019,125,51,176,1.6803921568627451,36.81402560871205
Task_20866,2240,351,97,145,242,6.363636363636363,43.79477224280464
Task_20867,2605,117,193,49,242,22.076271186440678,47.61877837755025
Task_20868,2191,993,23,109,132,2.204225352112676,44.340964805175155
Task_20869,749,619,106,63,169,1.2080645161290322,20.264586077513123
Task_20870,1121,764,152,22,174,1.465359477124183,26.3233659862595
Task_20871,592,825,169,119,288,0.7167070217917676,19.421308330161434
Task_20872,676,864,191,108,299,0.7815028901734105,20.84635456636722
Task_20873,1014,626,130,194,324,1.6172248803827751,25.687776343762224
Task_20874,2053,459,30,161,191,4.46304347826087,40.97961063784158
Task_20875,1765,637,194,190,384,2.7664576802507836,37.89444055729219
Task_20876,1176,230,51,63,114,5.090909090909091,25.496453499222927
Task_20877,917,876,63,114,177,1.0456100342075256,24.10234326203088
Task_20878,2143,686,121,77,198,3.119359534206696,42.865561878950594
Task_20879,2381,925,170,77,247,2.5712742980561556,47.60540590364928
Task_20880,1346,386,59,27,86,3.4780361757105944,27.839976261493035
Task_20881,2057,814,63,97,160,2.5239263803680982,41.8524985139852
Task_20882,2990,891,119,93,212,3.3520179372197307,57.164446588835496
Task_20883,1805,921,166,67,233,1.9577006507592192,38.27954526148615
Task_20884,590,369,177,179,356,1.5945945945945945,18.2941684573773
Task_20885,1518,307,54,171,225,4.928571428571429,32.252947909839534
Task_20886,1351,876,152,116,268,1.540478905359179,31.407567069325648
Task_20887,1696,142,108,132,240,11.86013986013986,34.19300492065798
Task_20888,817,726,11,84,95,1.123796423658872,21.147317217889785
Task_20889,1660,653,46,88,134,2.53822629969419,34.87560414515721
Task_20890,1547,197,194,42,236,7.813131313131313,31.640237138339526
Task_20891,2143,780,56,136,192,2.7439180537772088,43.455790159525954
Task_20892,1598,275,120,187,307,5.7898550724637685,33.733006790844954
Task_20893,2853,729,59,167,226,3.908219178082192,54.742192910243
Task_20894,1543,760,58,163,221,2.0275952693823918,34.05840169096453
Task_20895,763,72,142,186,328,10.452054794520548,19.544269123023206
Task_20896,2354,491,124,108,232,4.784552845528455,45.95154833054831
Task_20897,767,862,80,119,199,0.8887601390498262,21.83662024975891
Task_20898,950,974,121,117,238,0.9743589743589743,25.23207859425018
Task_20899,2073,597,179,143,322,3.4665551839464883,42.297798998618106
Task_20900,2915,761,170,19,189,3.825459317585302,54.79776886262719
Task_20901,1192,279,138,143,281,4.257142857142857,27.14747158110413
Task_20902,2904,580,174,200,374,4.998278829604131,55.721287782071215
Task_20903,634,237,102,33,135,2.6638655462184873,16.71025405242091
Task_20904,2534,241,63,189,252,10.47107438016529,48.22445968840312
Task_20905,1478,245,29,65,94,6.008130081300813,29.97287150796473
Task_20906,575,1014,95,47,142,0.5665024630541872,18.600432353706555
Task_20907,2795,1004,194,153,347,2.781094527363184,55.14054993382873
Task_20908,1230,956,112,61,173,1.2852664576802508,28.90694880912569
Task_20909,1564,1010,125,52,177,1.5469831849653808,34.44855308801187
Task_20910,2725,434,16,148,164,6.264367816091954,51.31623995779225
Task_20911,530,886,101,104,205,0.5975197294250282,18.2738974252914
Task_20912,1030,407,43,200,243,2.5245098039215685,24.92758330571773
Task_20913,1218,671,114,111,225,1.8125,28.504658903309405
Task_20914,1593,699,61,106,167,2.275714285714286,34.280088428027426
Task_20915,2189,527,90,73,163,4.145833333333333,42.835498757374125
Task_20916,973,226,68,188,256,4.286343612334802,23.53652089414018
Task_20917,1419,632,43,199,242,2.241706161137441,31.788653905860542
Task_20918,2554,849,27,153,180,3.0047058823529413,50.052586289654926
Task_20919,1172,290,83,146,229,4.027491408934708,26.67334972187408
Task_20920,969,910,113,128,241,1.0636663007683864,25.338694763715967
Task_20921,1531,140,15,114,129,10.858156028368795,30.617246433532717
Task_20922,1265,702,91,184,275,1.7994310099573259,29.67746240346216
Task_20923,2338,268,60,59,119,8.691449814126393,43.74244077315123
Task_20924,867,873,48,197,245,0.9919908466819222,23.763573630291205
Task_20925,2680,357,79,37,116,7.4860335195530725,49.203732739524355
Task_20926,2801,72,182,57,239,38.36986301369863,50.37953000643851
Task_20927,2139,339,156,10,166,6.291176470588235,41.0487527154816
Task_20928,2322,579,179,67,246,4.003448275862069,45.45518278219233
Task_20929,1504,868,80,128,208,1.7307249712313004,33.63673601444912
Task_20930,963,672,48,92,140,1.4309063893016345,23.89219301781785
Task_20931,2325,846,65,147,212,2.7449822904368357,46.65220022641381
Task_20932,2310,803,88,26,114,2.873134328358209,44.76020951176156
Task_20933,2167,340,64,200,264,6.354838709677419,42.84545179506859
Task_20934,2273,379,154,43,197,5.981578947368421,43.5386801325981
Task_20935,701,163,49,33,82,4.274390243902439,16.893597097526452
Task_20936,893,519,131,128,259,1.7173076923076922,23.048025123189273
Task_20937,818,109,172,92,264,7.4363636363636365,20.01386502205274
Task_20938,2852,727,128,163,291,3.9175824175824174,54.937202646018704
Task_20939,1259,812,142,135,277,1.5485854858548584,29.819652315560912
Task_20940,2081,738,53,17,70,2.8159675236806496,40.103682464374806
Task_20941,2898,880,29,184,213,3.2894438138479,55.82901610099497
Task_20942,2654,635,144,21,165,4.172955974842767,50.176031979073706
Task_20943,2185,81,81,177,258,26.646341463414632,41.54315660325518
Task_20944,2870,645,129,165,294,4.442724458204334,54.97873187335117
Task_20945,2433,797,98,191,289,3.0488721804511276,48.5559303194017
Task_20946,2793,713,128,21,149,3.911764705882353,52.47167256584916
Task_20947,1572,896,184,86,270,1.7525083612040133,34.90348864217602
Task_20948,1848,337,122,187,309,5.4674556213017755,37.90346691007918
Task_20949,1276,400,29,93,122,3.1820448877805485,27.86166211904056
Task_20950,2927,698,38,166,204,4.187410586552217,55.655634157140206
Task_20951,1823,101,16,120,136,17.872549019607842,34.90139684976963
Task_20952,2416,710,37,89,126,3.39803094233474,47.06159723375131
Task_20953,2393,451,152,169,321,5.29424778761062,46.92970293422368
Task_20954,1918,458,79,85,164,4.178649237472767,38.60003416522494
Task_20955,2568,804,147,63,210,3.190062111801242,49.88629541976735
Task_20956,2007,420,170,67,237,4.767220902612826,39.916826727851976
Task_20957,2654,139,60,24,84,18.957142857142856,47.40037125113641
Task_20958,1247,515,60,133,193,2.4166666666666665,28.432799563553175
Task_20959,613,838,62,36,98,0.7306317044100119,18.01443264343898
Task_20960,2370,800,156,68,224,2.958801498127341,46.813399431249415
Task_20961,1768,799,99,173,272,2.21,37.92098789216548
Task_20962,1903,740,61,91,152,2.5681511470985154,39.06367994607043
Task_20963,1711,995,48,167,215,1.7178714859437751,37.40637790502019
Task_20964,2317,85,74,105,179,26.941860465116278,43.193550146921005
Task_20965,2771,880,60,184,244,3.145289443813848,54.02334713346613
Task_20966,1729,912,95,192,287,1.8937568455640745,37.75891076181161
Task_20967,2687,314,179,26,205,8.53015873015873,49.861111742771776
Task_20968,2969,440,46,58,104,6.732426303854876,54.15408220643561
Task_20969,726,740,80,35,115,0.979757085020243,19.58564857276891
Task_20970,1425,597,57,119,176,2.382943143812709,31.383225621982533
Task_20971,1199,109,74,125,199,10.9,25.953863485398102
Task_20972,1882,515,53,82,135,3.647286821705426,38.01855706249839
Task_20973,2572,354,28,31,59,7.245070422535211,46.78121900944377
Task_20974,1207,629,77,55,132,1.915873015873016,27.3332841209325
Task_20975,1678,712,109,154,263,2.3534361851332397,36.15341230078688
Task_20976,1168,699,54,161,215,1.6685714285714286,27.88471891601751
Task_20977,2223,420,146,79,225,5.280285035629453,43.4710977309999
Task_20978,1325,578,114,122,236,2.2884283246977546,29.9741695664205
Task_20979,2243,248,200,199,399,9.008032128514056,44.2630303581392
Task_20980,914,894,75,20,95,1.0212290502793295,22.842661489738664
Task_20981,1409,244,35,116,151,5.751020408163265,29.64701383113994
Task_20982,921,867,127,123,250,1.0610599078341014,24.47831320006227
Task_20983,1085,649,41,170,211,1.6692307692307693,26.352217975412856
Task_20984,523,473,137,157,294,1.1033755274261603,17.196888506915695
Task_20985,2834,220,46,55,101,12.823529411764707,51.21216417954495
Task_20986,950,796,86,74,160,1.191969887076537,23.909750861054082
Task_20987,2157,443,51,188,239,4.858108108108108,42.924799664103034
Task_20988,1842,597,185,142,327,3.080267558528428,38.66064996009661
Task_20989,1124,732,187,146,333,1.5334242837653478,27.70090270486916
Task_20990,638,153,195,55,250,4.142857142857143,17.22958400188227
Task_20991,1160,608,171,143,314,1.9047619047619047,27.83745086772785
Task_20992,1622,417,95,142,237,3.8803827751196174,34.20932776997311
Task_20993,704,509,133,52,185,1.380392156862745,19.30411655138143
Task_20994,691,439,15,101,116,1.5704545454545455,18.577857057591466
Task_20995,1654,1013,159,60,219,1.631163708086785,36.05479070576866
Task_20996,2219,850,167,11,178,2.607520564042303,43.980064180534306
Task_20997,995,646,113,76,189,1.5378670788253477,24.475698499168825
Task_20998,2735,83,47,117,164,32.55952380952381,49.52147242729589
Task_20999,2279,995,16,160,176,2.288152610441767,46.12543685153377
Task_21000,590,506,193,195,388,1.1637080867850098,18.83461271409263
Task_21001,635,1010,153,62,215,0.6280909990108803,20.080043302915183
Task_21002,710,615,180,173,353,1.1525974025974026,20.883545465447632
Task_21003,2422,168,109,53,162,14.331360946745562,44.93638035947447
Task_21004,1952,919,185,74,259,2.121739130434783,40.82640013758096
Task_21005,1080,142,84,192,276,7.5524475524475525,24.754981266136024
Task_21006,1197,418,163,31,194,2.856801909307876,26.618352177162222
Task_21007,2326,582,57,24,81,3.9897084048027445,43.9493079495802
Task_21008,687,132,75,24,99,5.165413533834586,16.50813767076801
Task_21009,1300,440,76,22,98,2.947845804988662,27.440218421800406
Task_21010,867,758,193,54,247,1.1422924901185771,22.92219241158597
Task_21011,2445,329,18,67,85,7.409090909090909,45.46429137348512
Task_21012,2358,714,131,164,295,3.297902097902098,47.09026325271133
Task_21013,1430,882,93,23,116,1.6194790486976218,31.150298356953652
Task_21014,581,1000,107,175,282,0.5804195804195804,19.88071968807191
Task_21015,586,560,29,160,189,1.0445632798573976,17.947278609995845
Task_21016,1926,587,132,57,189,3.2755102040816326,38.897258819823335
Task_21017,2078,734,129,182,311,2.8272108843537413,42.816105742247544
Task_21018,1818,834,38,148,186,2.1772455089820357,38.37286589304848
Task_21019,1589,396,147,17,164,4.002518891687657,32.53055924608962
Task_21020,2010,317,84,165,249,6.320754716981132,40.10549661034499
Task_21021,2177,945,87,68,155,2.3012684989429175,43.69752088604009
Task_21022,2408,453,120,113,233,5.3039647577092515,46.69493021191394
Task_21023,632,864,132,40,172,0.730635838150289,19.079474733189773
Task_21024,1293,734,23,199,222,1.7591836734693878,29.978464404583132
Task_21025,2032,602,101,124,225,3.369817578772803,41.19928805270974
Task_21026,2331,191,14,149,163,12.140625,44.19366171163464
Task_21027,2413,767,75,183,258,3.1419270833333335,48.05406417321152
Task_21028,1927,538,133,142,275,3.575139146567718,39.58537603107124
Task_21029,2014,958,101,185,286,2.100104275286757,42.39295440375995
Task_21030,1495,569,70,43,113,2.6228070175438596,31.203108246619312
Task_21031,2226,334,95,42,137,6.6447761194029855,42.240745901503196
Task_21032,1017,721,130,44,174,1.4085872576177285,24.617977309034703
Task_21033,1003,179,15,168,183,5.572222222222222,23.015224927673614
Task_21034,2777,713,188,147,335,3.8893557422969187,53.87973962967993
Task_21035,1276,402,78,79,157,3.166253101736973,28.070562202409537
Task_21036,2567,982,143,45,188,2.6113936927772126,50.04412227917382
Task_21037,2545,586,118,92,210,4.335604770017036,49.106166377412144
Task_21038,2242,700,197,99,296,3.1982881597717547,45.1119484021527
Task_21039,2207,690,12,170,182,3.193921852387844,44.05220822188991
Task_21040,2423,382,99,72,171,6.326370757180157,46.083503405488365
Task_21041,2842,188,23,26,49,15.037037037037036,50.568895264158385
Task_21042,2315,439,173,115,288,5.261363636363637,45.42812752005892
Task_21043,2162,281,94,59,153,7.666666666666667,41.334285605075415
Task_21044,2640,744,161,112,273,3.5436241610738257,51.476577069911436
Task_21045,1012,196,25,59,84,5.137055837563452,22.25662413228804
Task_21046,2339,783,158,35,193,2.983418367346939,45.84922186707198
Task_21047,1902,675,180,50,230,2.8136094674556213,38.855136663846615
Task_21048,2814,185,186,84,270,15.129032258064516,52.18533070211503
Task_21049,762,923,108,117,225,0.8246753246753247,22.040461659305834
Task_21050,2265,661,122,140,262,3.421450151057402,45.26616748262859
Task_21051,771,820,24,100,124,0.9390986601705238,21.165259653174186
Task_21052,2234,355,187,11,198,6.275280898876405,42.73891665289426
Task_21053,1404,209,30,184,214,6.685714285714286,30.018196281320623
Task_21054,1435,876,161,113,274,1.6362599771949828,32.79047102693618
Task_21055,1035,256,166,158,324,4.027237354085603,24.80569346658596
Task_21056,2977,915,152,108,260,3.25,57.288397974071984
Task_21057,2336,673,40,96,136,3.4658753709198815,45.66924057649976
Task_21058,683,543,141,81,222,1.255514705882353,19.41901891343467
Task_21059,1384,786,45,77,122,1.758576874205845,30.696908260957233
Task_21060,2765,637,127,132,259,4.33385579937304,53.084129418641645
Task_21061,1450,494,40,198,238,2.9292929292929295,31.8188885745717
Task_21062,2236,674,116,156,272,3.3125925925925928,44.91636667762898
Task_21063,634,920,23,71,94,0.6883821932681867,19.020036988810062
Task_21064,2699,787,122,25,147,3.4251269035532994,51.21512107148167
Task_21065,1592,523,93,101,194,3.0381679389312977,33.84696255588232
Task_21066,621,267,69,179,248,2.3171641791044775,18.059950450597977
Task_21067,1433,944,105,182,287,1.5164021164021164,33.10020651787459
Task_21068,1222,414,76,104,180,2.944578313253012,27.587970554028203
Task_21069,2982,811,67,177,244,3.6724137931034484,57.14473907656665
Task_21070,1554,188,60,199,259,8.222222222222221,32.60752582074312
Task_21071,2449,382,30,10,40,6.394255874673629,44.69434744417267
Task_21072,1881,582,52,35,87,3.2264150943396226,36.962405004797446
Task_21073,778,317,138,81,219,2.4465408805031448,20.251202743744404
Task_21074,2069,234,144,42,186,8.804255319148936,39.74752513695646
Task_21075,1387,872,159,133,292,1.5887743413516608,32.09865462313797
Task_21076,1266,259,129,87,216,4.869230769230769,27.813739548723944
Task_21077,679,397,78,158,236,1.7060301507537687,19.285624219970433
Task_21078,1284,514,42,200,242,2.4932038834951458,29.28178467841802
Task_21079,2356,208,58,133,191,11.272727272727273,44.93244683004315
Task_21080,2215,604,115,36,151,3.6611570247933884,43.00738704310269
Task_21081,1723,685,100,110,210,2.511661807580175,36.47833509081363
Task_21082,2614,949,26,154,180,2.751578947368421,51.31297527997865
Task_21083,2336,621,116,94,210,3.7556270096463025,45.95571016189913
Task_21084,1115,75,41,108,149,14.671052631578947,23.690587493660406
Task_21085,1698,566,59,52,111,2.994708994708995,34.50046848168201
Task_21086,1831,250,48,139,187,7.294820717131474,36.763563218107116
Task_21087,2810,593,62,167,229,4.730639730639731,53.639605728463835
Task_21088,1924,751,145,113,258,2.5585106382978724,40.089730211732395
Task_21089,1838,927,50,95,145,1.980603448275862,38.71497824429644
Task_21090,1756,770,102,71,173,2.277561608300908,36.76583514477647
Task_21091,1366,560,32,112,144,2.4349376114081998,29.945706246507118
Task_21092,744,1008,172,113,285,0.7373637264618434,22.278318050314084
Task_21093,1173,955,147,79,226,1.2269874476987448,28.476948680358507
Task_21094,2987,884,96,107,203,3.375141242937853,57.09904196622866
Task_21095,1742,523,152,114,266,3.3244274809160306,36.52697024008471
Task_21096,1056,307,87,153,240,3.4285714285714284,24.87943076250656
Task_21097,2253,136,52,103,155,16.445255474452555,42.11940217956526
Task_21098,1449,376,86,168,254,3.843501326259947,31.40425970647401
Task_21099,2170,462,50,192,242,4.686825053995681,43.21153050954742
Task_21100,930,71,171,193,364,12.916666666666666,22.337569221849773
Task_21101,1098,398,90,132,222,2.7518796992481205,25.75834882207263
Task_21102,2221,454,153,75,228,4.881318681318682,43.48358273610506
Task_21103,503,302,184,127,311,1.66006600660066,16.427977686015847
Task_21104,2373,640,96,175,271,3.702028081123245,47.00990895967659
Task_21105,572,947,11,157,168,0.6033755274261603,18.97690794743969
Task_21106,2813,516,114,36,150,5.44100580270793,52.190156736560766
Task_21107,924,345,127,59,186,2.6705202312138727,22.226626141888108
Task_21108,1579,154,19,97,116,10.187096774193549,31.161872736146453
Task_21109,2589,508,134,177,311,5.086444007858546,50.18403431134518
Task_21110,2953,179,132,15,147,16.405555555555555,52.89571716260767
Task_21111,796,448,163,102,265,1.7728285077951003,21.279035324757388
Task_21112,2775,775,129,158,287,3.5760309278350517,53.843409801658744
Task_21113,767,894,144,194,338,0.8569832402234637,22.652969528393484
Task_21114,1534,272,174,50,224,5.619047619047619,31.70702399619253
Task_21115,2399,397,125,34,159,6.027638190954774,45.29505434292016
Task_21116,1898,564,81,48,129,3.35929203539823,37.83693991570964
Task_21117,1525,324,170,10,180,4.6923076923076925,31.33438311119687
Task_21118,2727,867,190,175,365,3.141705069124424,53.74824635128518
Task_21119,617,767,22,169,191,0.8033854166666666,19.12595525575414
Task_21120,2817,210,71,17,88,13.350710900473933,50.53330525589487
Task_21121,2685,590,85,175,260,4.543147208121828,51.74082990209229
Task_21122,1978,83,85,11,96,23.547619047619047,36.10311987502387
Task_21123,1352,530,17,164,181,2.5461393596986817,29.98851222479895
Task_21124,2357,773,53,38,91,3.045219638242894,45.174669750366775
Task_21125,2571,89,132,107,239,28.566666666666666,47.43264449486145
Task_21126,1354,805,56,110,166,1.6799007444168734,30.830457282357603
Task_21127,1695,109,44,97,141,15.409090909090908,32.965486700008526
Task_21128,1775,368,24,48,72,4.8102981029810294,34.38103251841078
Task_21129,1203,955,181,28,209,1.25836820083682,28.45324797910507
Task_21130,2471,1021,175,19,194,2.4178082191780823,48.60202532338074
Task_21131,1649,500,41,152,193,3.291417165668663,34.720954193896425
Task_21132,999,602,84,149,233,1.6567164179104477,24.90917192202026
Task_21133,1563,993,166,178,344,1.5724346076458753,35.56322015488384
Task_21134,1477,355,60,73,133,4.148876404494382,30.957343257976706
Task_21135,933,104,18,119,137,8.885714285714286,20.90162038647837
Task_21136,779,155,41,128,169,4.993589743589744,19.31808690633768
Task_21137,2502,664,173,20,193,3.762406015037594,47.97355427682311
Task_21138,1792,227,159,126,285,7.859649122807017,36.441600540106016
Task_21139,652,353,48,177,225,1.8418079096045197,18.704478309244042
Task_21140,1532,633,70,99,169,2.416403785488959,33.108210684845425
Task_21141,1304,111,169,94,263,11.642857142857142,27.762049761591857
Task_21142,1603,832,17,188,205,1.9243697478991597,35.08614996710552
Task_21143,866,713,53,56,109,1.2128851540616246,21.764178509992007
Task_21144,1531,787,16,183,199,1.9428934010152283,33.78537089264672
Task_21145,2469,159,87,108,195,15.43125,46.2153498925019
Task_21146,1834,693,81,139,220,2.642651296829971,38.402528034527464
Task_21147,1361,531,123,192,315,2.558270676691729,30.85510661260868
Task_21148,765,402,65,20,85,1.8982630272952854,18.680621262984086
Task_21149,706,425,103,95,198,1.6572769953051643,19.483714658540624
Task_21150,1541,781,112,152,264,1.9705882352941178,34.2000204435665
Task_21151,1616,611,123,64,187,2.6405228758169934,34.08219004314603
Task_21152,561,869,141,28,169,0.6448275862068965,18.05398804459439
Task_21153,2230,906,111,74,185,2.4586549062844543,44.82738678228943
Task_21154,1484,180,62,40,102,8.19889502762431,29.212096993877307
Task_21155,2308,710,150,11,161,3.246132208157525,44.794264373802086
Task_21156,2842,550,50,22,72,5.157894736842105,51.68160007827955
Task_21157,2329,239,20,78,98,9.704166666666667,43.50935258173786
Task_21158,2818,700,118,42,160,4.019971469329529,52.898535328620206
Task_21159,1837,444,61,97,158,4.128089887640449,37.19227239903409
Task_21160,1575,109,38,80,118,14.318181818181818,30.793253414852146
Task_21161,813,384,144,186,330,2.1116883116883116,21.776060529053286
Task_21162,1666,725,114,124,238,2.2947658402203857,35.847309784169575
Task_21163,2697,684,103,128,231,3.937226277372263,52.0241895691946
Task_21164,2808,943,92,141,233,2.9745762711864407,54.632381710071314
Task_21165,796,926,168,145,313,0.8586839266450917,23.026871324260274
Task_21166,1502,512,91,156,247,2.9278752436647175,32.66759720569259
Task_21167,1190,177,118,85,203,6.685393258426966,26.009255414759533
Task_21168,848,489,116,156,272,1.7306122448979593,22.34136491757515
Task_21169,2438,1013,94,40,134,2.4043392504930967,47.76612321790548
Task_21170,1600,225,196,114,310,7.079646017699115,33.49716408179332
Task_21171,2815,421,60,195,255,6.670616113744076,53.319883072396294
Task_21172,1974,667,41,79,120,2.9550898203592815,39.68323193045925
Task_21173,2085,857,129,176,305,2.43006993006993,43.275838477902596
Task_21174,1002,565,180,112,292,1.7703180212014133,25.042981441743592
Task_21175,1804,333,129,155,284,5.401197604790419,37.03466097909176
Task_21176,710,269,80,150,230,2.6296296296296298,19.330188764475402
Task_21177,938,437,198,22,220,2.141552511415525,22.61596865856353
Task_21178,1239,543,117,191,308,2.2775735294117645,28.928157680487747
Task_21179,2178,617,36,188,224,3.5242718446601944,43.66285290025001
Task_21180,2615,131,125,195,320,19.810606060606062,49.02001685052986
Task_21181,1198,452,29,72,101,2.644591611479029,26.360127924439706
Task_21182,2276,570,178,142,320,3.9859894921190895,45.416246777257186
Task_21183,1245,911,60,170,230,1.3651315789473684,29.80187223173319
Task_21184,1064,933,179,134,313,1.139186295503212,27.23971313227962
Task_21185,1307,665,22,80,102,1.9624624624624625,28.867900461352875
Task_21186,2394,210,112,194,306,11.345971563981042,46.078145983477015
Task_21187,2948,324,99,133,232,9.070769230769232,54.831289932345896
Task_21188,1975,671,200,177,377,2.9389880952380953,41.2768649146173
Task_21189,722,832,48,177,225,0.8667466986794717,21.228924952318753
Task_21190,1502,244,132,133,265,6.130612244897959,31.84102182165671
Task_21191,1988,177,171,150,321,11.168539325842696,39.29807519596957
Task_21192,1501,766,123,37,160,1.9569752281616688,32.26639034125146
Task_21193,877,493,118,123,241,1.7753036437246963,22.6248896838084
Task_21194,1067,387,192,167,359,2.75,25.90723391970236
Task_21195,1091,602,155,131,286,1.8092868988391377,26.582181541067524
Task_21196,588,647,105,170,275,0.9074074074074074,18.743717660752985
Task_21197,2742,461,118,44,162,5.935064935064935,50.98102782934641
Task_21198,2686,245,70,31,101,10.91869918699187,48.82144766164647
Task_21199,2398,744,180,30,210,3.2187919463087247,46.73333157977518
Task_21200,1466,796,168,114,282,1.8393977415307403,33.08393261566842
Task_21201,2626,157,137,199,336,16.620253164556964,49.47975833162264
Task_21202,957,389,160,161,321,2.453846153846154,23.993078720322966
Task_21203,2796,93,26,172,198,29.74468085106383,50.8710679103044
Task_21204,2427,531,89,189,278,4.56203007518797,47.54108830323555
Task_21205,1660,338,166,119,285,4.896755162241888,34.725475879310615
Task_21206,2701,485,40,189,229,5.55761316872428,51.54039939280862
Task_21207,1708,749,31,100,131,2.2773333333333334,35.92451562185525
Task_21208,993,993,124,187,311,0.9989939637826962,26.390487210357822
Task_21209,606,483,99,136,235,1.2520661157024793,18.246249815029696
Task_21210,665,922,196,97,293,0.7204767063921993,20.901772522133317
Task_21211,1141,104,19,32,51,10.866666666666667,23.07522698923619
Task_21212,1840,530,128,31,159,3.465160075329567,36.87979244583544
Task_21213,2885,561,194,176,370,5.133451957295374,55.30612380087948
Task_21214,1282,121,10,104,114,10.508196721311476,26.29344304740903
Task_21215,1507,372,74,100,174,4.040214477211796,31.922617555187298
Task_21216,2011,236,56,115,171,8.485232067510548,39.41482257900025
Task_21217,2522,866,34,104,138,2.908881199538639,49.180692624218686
Task_21218,2100,124,116,188,304,16.8,40.768636515387705
Task_21219,524,973,79,110,189,0.5379876796714579,18.437500682034322
Task_21220,2349,686,195,85,280,3.4192139737991267,46.59904174149389
Task_21221,2389,148,53,48,101,16.033557046979865,43.32513953720714
Task_21222,958,378,158,159,317,2.5277044854881265,23.952988794282586
Task_21223,1224,497,70,132,202,2.4578313253012047,28.05411479755165
Task_21224,2699,318,68,79,147,8.460815047021944,50.333536879381114
Task_21225,1910,607,152,170,322,3.1414473684210527,39.787619386615766
Task_21226,2554,647,107,134,241,3.941358024691358,49.6958230983783
Task_21227,1340,294,28,34,62,4.5423728813559325,27.113015723003155
Task_21228,2219,87,72,26,98,25.21590909090909,40.06485905982867
Task_21229,2158,411,114,73,187,5.237864077669903,42.08407944130237
Task_21230,1916,69,26,85,111,27.37142857142857,35.84742946495887
Task_21231,2631,543,79,195,274,4.836397058823529,50.88148796087998
Task_21232,2439,359,114,41,155,6.775,45.76787058568371
Task_21233,2471,1006,146,175,321,2.4538232373386295,49.927381350197685
Task_21234,2993,831,70,66,136,3.597355769230769,56.37343143119494
Task_21235,2410,490,185,69,254,4.908350305498982,46.59251089952036
Task_21236,1873,88,176,41,217,21.04494382022472,35.56953308264399
Task_21237,1522,798,163,83,246,1.9048811013767208,33.697758845769236
Task_21238,1819,149,69,106,175,12.126666666666667,35.849497894858175
Task_21239,825,982,82,91,173,0.8392675483214649,22.889436760540587
Task_21240,2310,342,37,162,199,6.73469387755102,44.718942843545726
Task_21241,2009,928,121,27,148,2.16254036598493,40.742768678712245
Task_21242,2517,925,83,67,150,2.7181425485961124,49.115368988335376
Task_21243,1167,189,54,43,97,6.1421052631578945,24.58283679557537
Task_21244,613,731,73,54,127,0.837431693989071,18.25438090082989
Task_21245,1842,532,78,116,194,3.455909943714822,37.88422249960295
Task_21246,555,322,123,63,186,1.7182662538699691,16.348392328602227
Task_21247,1744,222,166,124,290,7.820627802690583,35.68502821230947
Task_21248,1148,657,160,49,209,1.7446808510638299,26.755757014216574
Task_21249,1023,340,67,132,199,3.0,24.36284241695968
Task_21250,1538,657,31,131,162,2.337386018237082,33.14725833746748
Task_21251,1604,819,130,172,302,1.9560975609756097,35.51705622206638
Task_21252,2654,474,154,51,205,5.5873684210526315,50.126256806862216
Task_21253,2109,354,74,51,125,5.940845070422535,40.58883568763164
Task_21254,2447,890,186,132,318,2.7463524130190797,49.108763958780266
Task_21255,1159,717,111,141,252,1.6142061281337048,27.86558887630788
Task_21256,2191,624,26,72,98,3.5056,42.53921408560382
Task_21257,914,147,13,25,38,6.175675675675675,19.67222254794323
Task_21258,1116,910,164,117,281,1.2250274423710208,27.827683104163942
Task_21259,2460,427,160,126,286,5.747663551401869,47.690778474930845
Task_21260,2484,329,154,147,301,7.527272727272727,47.84046323949662
Task_21261,2892,126,53,47,100,22.771653543307085,51.011464472626926
Task_21262,864,613,193,116,309,1.4071661237785016,23.04929191912801
Task_21263,2695,253,190,116,306,10.61023622047244,50.88232783017177
Task_21264,2777,498,200,45,245,5.565130260521042,52.110649716275354
Task_21265,1814,602,100,155,255,3.0082918739635156,37.92755060784661
Task_21266,1019,706,103,34,137,1.4413012729844412,24.267524273918625
Task_21267,672,317,20,137,157,2.1132075471698113,18.279970924785093
Task_21268,2034,535,36,82,118,3.794776119402985,40.2557688167847
Task_21269,1188,283,95,111,206,4.183098591549296,26.722848463085523
Task_21270,2830,66,106,187,293,42.23880597014925,51.7085507292792
Task_21271,2331,263,51,41,92,8.829545454545455,43.12014230850665
Task_21272,2102,536,26,56,82,3.914338919925512,40.543525272704805
Task_21273,2561,399,44,114,158,6.4025,48.43541765472251
Task_21274,1450,786,37,179,216,1.8424396442185516,32.62101790193478
Task_21275,2572,986,68,47,115,2.6058763931104356,49.5628021453883
Task_21276,2162,716,194,171,365,3.01534170153417,44.3175154943202
Task_21277,1130,797,30,189,219,1.4160401002506267,27.541001803225544
Task_21278,1014,856,24,84,108,1.1831971995332555,24.916786335581122
Task_21279,1924,647,22,131,153,2.9691358024691357,39.07366281390739
Task_21280,2069,388,67,130,197,5.318766066838046,41.054469168569035
Task_21281,2793,735,127,199,326,3.7948369565217392,54.23835480086581
Task_21282,976,487,151,115,266,2.0,24.28768947888176
Task_21283,2852,796,147,158,305,3.5784190715181934,55.21051697091449
Task_21284,959,168,138,69,207,5.674556213017752,22.19253679528025
Task_21285,591,946,43,134,177,0.6240760295670539,19.343132266064604
Task_21286,718,242,74,143,217,2.954732510288066,19.307343625041085
Task_21287,1727,417,177,55,232,4.131578947368421,35.405660944906195
Task_21288,1173,734,157,46,203,1.5959183673469388,27.30313278552865
Task_21289,2167,242,136,177,313,8.91769547325103,42.620571871754116
Task_21290,652,191,70,178,248,3.3958333333333335,18.290122491247097
Task_21291,1261,385,167,121,288,3.266839378238342,28.582890405395474
Task_21292,1376,774,142,168,310,1.7754838709677419,31.781560051367098
Task_21293,1161,335,50,82,132,3.455357142857143,26.093949839346795
Task_21294,1762,680,26,148,174,2.5873715124816448,36.93734926901822
Task_21295,1916,479,105,166,271,3.9916666666666667,39.24003021858504
Task_21296,1474,227,138,42,180,6.464912280701754,30.306343617905142
Task_21297,1721,597,50,140,190,2.8779264214046822,36.21913037219836
Task_21298,1833,1024,109,102,211,1.7882926829268293,39.26998098182498
Task_21299,2088,630,131,75,206,3.3090332805071316,41.84070977747602
Task_21300,648,807,93,139,232,0.801980198019802,19.997392637373768
Task_21301,1501,930,184,121,305,1.6122448979591837,34.15531176581053
Task_21302,2833,186,87,63,150,15.149732620320856,51.69600911101761
Task_21303,612,821,101,27,128,0.7445255474452555,18.306933378106077
Task_21304,1130,978,158,197,355,1.1542390194075587,28.706462016392965
Task_21305,2350,597,180,113,293,3.9297658862876252,46.50981198902988
Task_21306,2665,309,196,114,310,8.596774193548388,50.62546647698866
Task_21307,1355,427,78,16,94,3.1658878504672896,28.224682823376824
Task_21308,1555,233,20,47,67,6.645299145299146,30.393221148394233
Task_21309,1570,474,30,27,57,3.305263157894737,31.380172260963253
Task_21310,769,724,170,135,305,1.0606896551724139,21.892870109451746
Task_21311,920,164,137,190,327,5.575757575757576,22.548147088322754
Task_21312,2494,116,158,138,296,21.316239316239315,46.76767167363184
Task_21313,2919,813,142,167,309,3.585995085995086,56.356707155746996
Task_21314,793,700,144,119,263,1.1312410841654779,21.969887224131472
Task_21315,1806,990,184,187,371,1.822401614530777,39.58231640512107
Task_21316,2996,93,33,17,50,31.872340425531913,51.782214425819916
Task_21317,2755,952,39,36,75,2.8908709338929697,51.66939863301001
Task_21318,2296,949,82,141,223,2.4168421052631577,46.52718494929946
Task_21319,1962,634,118,45,163,3.089763779527559,39.25833744264725
Task_21320,778,134,101,146,247,5.762962962962963,19.712960056897288
Task_21321,502,647,118,172,290,0.7746913580246914,17.4722242818581
Task_21322,2235,561,191,43,234,3.9768683274021353,43.69394842253515
Task_21323,629,839,74,152,226,0.7488095238095238,19.781814187556467
Task_21324,2364,631,34,63,97,3.740506329113924,45.27509790844852
Task_21325,1340,698,179,40,219,1.9170243204577968,29.879042051237203
Task_21326,676,759,45,105,150,0.8894736842105263,19.641148428849075
Task_21327,1413,373,56,85,141,3.77807486631016,30.136805627472388
Task_21328,792,832,89,67,156,0.9507803121248499,21.461742923026176
Task_21329,2754,908,130,92,222,3.0297029702970297,53.48642100084259
Task_21330,1467,529,170,152,322,2.767924528301887,32.50002222871277
Task_21331,2432,522,95,133,228,4.6500956022944555,47.31521836889106
Task_21332,2254,237,65,158,223,9.470588235294118,43.61281534654095
Task_21333,2899,169,168,111,279,17.05294117647059,53.432978434539216
Task_21334,2341,148,193,33,226,15.711409395973154,43.68854630923065
Task_21335,2047,207,108,189,297,9.841346153846153,40.54033426670819
Task_21336,1729,805,51,96,147,2.1451612903225805,36.62573653581923
Task_21337,2405,121,155,127,282,19.71311475409836,45.37067900738497
Task_21338,2684,81,184,46,230,32.73170731707317,48.26959632049159
Task_21339,2476,942,81,155,236,2.625662778366914,49.44804569567725
Task_21340,1487,702,197,53,250,2.1152204836415365,32.63806644070792
Task_21341,2535,156,90,147,237,16.146496815286625,47.51896303960738
Task_21342,921,257,167,105,272,3.5697674418604652,22.695555431723346
Task_21343,2296,114,136,184,320,19.965217391304346,43.80616580900695
Task_21344,2544,709,13,185,198,3.583098591549296,49.5905235134234
Task_21345,1386,677,94,44,138,2.0442477876106193,30.061799242097397
Task_21346,2260,723,132,136,268,3.1215469613259668,45.403431143212856
Task_21347,2668,1022,120,78,198,2.6080156402737047,52.279617755846694
Task_21348,2935,1013,146,189,335,2.8944773175542404,57.385919341158534
Task_21349,1004,649,153,113,266,1.5446153846153847,25.191584737050686
Task_21350,1253,800,78,184,262,1.564294631710362,29.762088476302647
Task_21351,780,613,173,115,288,1.270358306188925,21.61558519416231
Task_21352,2873,171,127,95,222,16.703488372093023,52.74792028364482
Task_21353,2093,555,170,140,310,3.764388489208633,42.42271449081947
Task_21354,2406,1000,200,53,253,2.4035964035964037,48.1414141959794
Task_21355,2797,828,113,149,262,3.37394451145959,54.232700771938404
Task_21356,678,564,81,178,259,1.2,19.850857377883273
Task_21357,1734,783,62,93,155,2.211734693877551,36.58744278529985
Task_21358,807,337,131,185,316,2.3875739644970415,21.46742999403141
Task_21359,2379,585,118,30,148,4.059726962457338,45.55073920097988
Task_21360,2038,359,138,116,254,5.661111111111111,40.63003670112942
Task_21361,759,855,46,132,178,0.8866822429906542,21.570089949890413
Task_21362,999,220,12,113,125,4.520361990950226,22.956351652837526
Task_21363,2025,546,104,94,198,3.7020109689213894,40.73848982946595
Task_21364,1475,565,139,152,291,2.606007067137809,32.60047026250968
Task_21365,1203,556,186,26,212,2.1597845601436267,27.196860739353824
Task_21366,1064,605,182,160,342,1.7557755775577557,26.445436088254507
Task_21367,786,700,124,179,303,1.1212553495007134,22.12493944689029
Task_21368,1108,418,167,187,354,2.6443914081145583,26.66139141787632
Task_21369,2980,668,70,111,181,4.45440956651719,56.24038498976295
Task_21370,2634,500,28,120,148,5.25748502994012,49.85399088642177
Task_21371,644,127,196,101,297,5.03125,17.72461006826965
Task_21372,546,235,189,193,382,2.3135593220338984,17.323911130546858
Task_21373,2712,536,96,92,188,5.050279329608938,51.48347850640092
Task_21374,1332,138,162,152,314,9.582733812949641,28.766362581864087
Task_21375,2574,830,122,11,133,3.0974729241877257,49.23178255770214
Task_21376,532,749,75,167,242,0.7093333333333334,18.176519105431986
Task_21377,1348,826,33,47,80,1.629987908101572,29.298024158184237
Task_21378,826,332,44,33,77,2.4804804804804803,19.20389661135113
Task_21379,2080,64,191,102,293,32.0,39.85537298528221
Task_21380,1667,915,194,170,364,1.8198689956331877,37.09030368176224
Task_21381,1017,992,81,90,171,1.0241691842900302,25.90802601750076
Task_21382,2502,542,23,71,94,4.607734806629834,47.192733405689985
Task_21383,2758,492,185,140,325,5.594320486815416,52.81650029281004
Task_21384,826,619,196,36,232,1.332258064516129,21.547558294916637
Task_21385,2726,529,56,104,160,5.143396226415095,51.50804903573962
Task_21386,1446,582,105,72,177,2.4802744425385934,31.315878062169485
Task_21387,2638,916,132,126,258,2.876772082878953,51.9372419456372
Task_21388,1595,108,93,33,126,14.63302752293578,30.963919753985653
Task_21389,2867,126,142,83,225,22.5748031496063,52.213460177783084
Task_21390,751,450,180,135,315,1.665188470066519,20.84678416775846
Task_21391,1871,762,40,148,188,2.4521625163826997,39.01666979251821
Task_21392,1349,749,193,163,356,1.7986666666666666,31.489436139329744
Task_21393,2648,982,68,180,248,2.693794506612411,52.40898243489309
Task_21394,2318,78,93,23,116,29.341772151898734,41.72849477495281
Task_21395,1522,67,46,198,244,22.38235294117647,31.00671121983319
Task_21396,1299,532,87,173,260,2.4371482176360226,29.561125778809714
Task_21397,892,710,164,88,252,1.2545710267229255,23.430600844924196
Task_21398,1183,749,73,154,227,1.5773333333333333,28.28591764307852
Task_21399,2031,513,198,57,255,3.9513618677042803,40.62510974499983
Task_21400,2125,350,86,165,251,6.054131054131054,41.99480822622416
Task_21401,1847,535,34,51,85,3.4458955223880596,36.54092680481762
Task_21402,1525,900,125,66,191,1.6925638179800222,33.57310909531273
Task_21403,1096,743,91,178,269,1.4731182795698925,27.042252571522898
Task_21404,1512,830,19,18,37,1.8194945848375452,31.25171235709117
Task_21405,901,334,128,149,277,2.68955223880597,22.716001828358333
Task_21406,1405,483,15,23,38,2.902892561983471,28.54535576108624
Task_21407,2034,691,165,155,320,2.939306358381503,41.98511957015406
Task_21408,1238,624,78,194,272,1.9808,29.075164144998595
Task_21409,2415,668,199,145,344,3.609865470852018,48.0410538061308
Task_21410,1888,977,46,139,185,1.9304703476482619,39.93310392459492
Task_21411,2407,582,138,73,211,4.128644939965695,46.706656658335795
Task_21412,2594,761,13,39,52,3.404199475065617,48.46377291724244
Task_21413,2522,417,159,188,347,6.033492822966507,49.00483254231182
Task_21414,2564,67,30,95,125,37.705882352941174,46.13776799377076
Task_21415,1423,405,28,67,95,3.5049261083743843,29.6483421881555
Task_21416,2798,199,58,10,68,13.99,49.60647837957603
Task_21417,1091,805,170,83,253,1.3535980148883375,26.879869536114114
Task_21418,1666,115,19,12,31,14.362068965517242,31.119724307584537
Task_21419,946,108,157,132,289,8.678899082568808,22.308136840453724
Task_21420,1212,916,62,123,185,1.321701199563795,28.9871447437984
Task_21421,757,491,170,123,293,1.5386178861788617,20.92400571066093
Task_21422,2792,195,118,25,143,14.244897959183673,50.68560083509765
Task_21423,1081,525,45,98,143,2.055133079847909,25.346278138686184
Task_21424,2969,726,180,46,226,4.083906464924347,55.815401921303504
Task_21425,2171,137,176,171,347,15.731884057971014,42.151922716009075
Task_21426,1406,65,164,99,263,21.303030303030305,29.213733847619427
Task_21427,2692,363,178,76,254,7.395604395604396,50.75900383125188
Task_21428,1354,725,49,10,59,1.8650137741046833,28.54972315991914
Task_21429,890,397,147,90,237,2.236180904522613,22.443895201617313
Task_21430,633,701,84,94,178,0.9017094017094017,19.01979752190944
Task_21431,2824,367,145,188,333,7.673913043478261,53.552691478247105
Task_21432,1559,552,181,33,214,2.819168173598553,32.859401707278884
Task_21433,2557,180,157,51,208,14.12707182320442,47.353300293065104
Task_21434,2035,449,97,187,284,4.522222222222222,41.124153189952246
Task_21435,2871,527,97,125,222,5.4375,54.24058015525642
Task_21436,2125,826,86,80,166,2.569528415961306,42.9250005511983
Task_21437,1790,366,67,19,86,4.877384196185286,34.828029992368045
Task_21438,879,289,177,79,256,3.0310344827586206,21.923782504195604
Task_21439,2983,400,89,146,235,7.438902743142145,55.65577532740324
Task_21440,1691,591,40,75,115,2.856418918918919,34.92360772142863
Task_21441,1431,828,189,36,225,1.7261761158021713,31.733678704719633
Task_21442,1588,637,183,116,299,2.489028213166144,34.59952070705436
Task_21443,2509,186,131,68,199,13.417112299465241,46.93316264278325
Task_21444,2396,680,66,167,233,3.518355359765051,47.3873893337557
Task_21445,2583,784,48,27,75,3.2904458598726114,48.39551995943904
Task_21446,2862,160,41,128,169,17.77639751552795,52.18517760889845
Task_21447,2523,705,109,149,258,3.5736543909348444,49.48685023868791
Task_21448,2520,359,181,127,308,7.0,48.51431921903835
Task_21449,2059,558,170,57,227,3.6833631484794274,41.08568352850018
Task_21450,679,152,54,78,132,4.437908496732026,17.34232069673502
Task_21451,2709,669,198,77,275,4.043283582089552,52.124105991326864
Task_21452,2237,441,107,147,254,5.0610859728506785,44.0938039160888
Task_21453,2706,591,92,28,120,4.570945945945946,50.44133987997835
Task_21454,1183,667,70,52,122,1.7709580838323353,26.873379237759654
Task_21455,1130,864,188,64,252,1.30635838150289,27.47901288949159
Task_21456,2534,479,35,72,107,5.279166666666667,47.69197472964667
Task_21457,710,555,141,82,223,1.276978417266187,19.926119992431804
Task_21458,1626,112,168,162,330,14.389380530973451,33.26755955750201
Task_21459,1691,633,190,137,327,2.667192429022082,36.37526113914889
Task_21460,1197,145,106,90,196,8.198630136986301,26.01652501269741
Task_21461,2843,329,160,152,312,8.615151515151515,53.57497754940196
Task_21462,1392,693,50,12,62,2.005763688760807,29.066837817186855
Task_21463,2816,998,65,55,120,2.818818818818819,53.6866621004117
Task_21464,911,383,17,39,56,2.3723958333333335,20.625920643920228
Task_21465,2741,742,140,163,303,3.6890982503364738,53.28024860451794
Task_21466,1285,961,114,187,301,1.3357588357588357,30.873927377826217
Task_21467,2100,535,147,165,312,3.917910447761194,42.51548968881579
Task_21468,875,762,129,162,291,1.146788990825688,23.65752004180473
Task_21469,1734,302,150,176,326,5.7227722772277225,36.04394609907318
Task_21470,590,516,21,147,168,1.1411992263056092,17.725763796937873
Task_21471,539,277,161,67,228,1.9388489208633093,16.194457879405437
Task_21472,1955,660,131,186,317,2.957639939485628,40.66825512157312
Task_21473,759,705,121,43,164,1.075070821529745,20.478710658797365
Task_21474,2579,376,155,71,226,6.840848806366048,48.81119858420127
Task_21475,1040,978,108,162,270,1.062308478038815,26.854647931322503
Task_21476,1823,754,36,23,59,2.414569536423841,36.210635731547264
Task_21477,1373,710,76,69,145,1.9310829817158932,30.392371762368345
Task_21478,2992,617,76,139,215,4.841423948220065,56.494372247327675
Task_21479,2314,589,54,99,153,3.922033898305085,45.10313248400984
Task_21480,2575,232,13,106,119,11.051502145922747,47.75677469642026
Task_21481,2459,584,82,139,221,4.203418803418804,47.95020884070283
Task_21482,2192,760,108,147,255,2.8804204993429696,44.39988311003854
Task_21483,2893,874,54,166,220,3.3062857142857145,55.80370792797638
Task_21484,2258,835,175,62,237,2.700956937799043,45.1546832026198
Task_21485,569,265,20,97,117,2.1390977443609023,16.18237034847341
Task_21486,2924,515,74,172,246,5.666666666666667,55.270730431597656
Task_21487,1329,310,184,196,380,4.273311897106109,29.93964747069
Task_21488,2852,472,20,101,121,6.029598308668076,52.990411889742
Task_21489,556,123,71,104,175,4.483870967741935,15.768312775353138
Task_21490,1995,209,185,77,262,9.5,39.23888172362755
Task_21491,2359,468,68,87,155,5.029850746268656,45.49464972379591
Task_21492,1087,86,42,74,116,12.494252873563218,22.951882395912122
Task_21493,1898,90,196,15,211,20.857142857142858,35.8618421325016
Task_21494,2750,736,22,80,102,3.7313432835820897,51.94838641833474
Task_21495,2560,657,64,49,113,3.8905775075987843,48.32808121510718
Task_21496,2171,405,136,69,205,5.347290640394089,42.3121392879793
Task_21497,2380,579,167,77,244,4.103448275862069,46.487798561515014
Task_21498,1634,101,13,177,190,16.019607843137255,32.66027745212808
Task_21499,2784,293,23,68,91,9.46938775510204,50.77644515195713
Task_21500,2774,641,65,37,102,4.320872274143302,51.46602358506581
Task_21501,2039,757,85,106,191,2.6899736147757256,41.6241191806864
Task_21502,769,283,138,151,289,2.7077464788732395,20.521998916543584
Task_21503,914,697,48,87,135,1.3094555873925502,23.191700058704907
Task_21504,904,144,133,162,295,6.23448275862069,22.028113102825767
Task_21505,1556,941,36,165,201,1.6518046709129512,34.67132572506102
Task_21506,2313,320,44,44,88,7.205607476635514,43.011670297251705
Task_21507,2217,654,28,82,110,3.384732824427481,43.43776831765519
Task_21508,1473,685,78,13,91,2.1472303206997085,30.88606070346206
Task_21509,2967,925,55,75,130,3.2041036717062634,56.39568770481328
Task_21510,1516,444,105,105,210,3.406741573033708,32.432139639138605
Task_21511,842,87,46,52,98,9.568181818181818,18.66391185441383
Task_21512,2676,151,48,56,104,17.605263157894736,48.08320857852209
Task_21513,1865,853,102,111,213,2.1838407494145198,39.267670069910025
Task_21514,1773,227,129,57,186,7.776315789473684,35.25858524699086
Task_21515,2228,784,96,109,205,2.838216560509554,44.77205401860181
Task_21516,2033,667,118,182,300,3.0434131736526946,41.84324520579541
Task_21517,1546,388,146,171,317,3.974293059125964,33.305868124251525
Task_21518,1042,778,147,134,281,1.337612323491656,26.28860625481109
Task_21519,2480,709,36,73,109,3.492957746478873,47.645033962843655
Task_21520,2183,947,10,112,122,2.3027426160337554,43.90996850691039
Task_21521,681,729,177,48,225,0.9328767123287671,19.701005374948977
Task_21522,2973,924,198,58,256,3.214054054054054,56.84915601426093
Task_21523,1984,502,69,54,123,3.944333996023857,39.07374147916537
Task_21524,2783,281,76,34,110,9.868794326241135,50.51414805299584
Task_21525,2499,822,158,47,205,3.0364520048602675,48.592441987016294
Task_21526,2105,493,99,47,146,4.261133603238866,40.95817263991933
Task_21527,1789,779,190,47,237,2.2935897435897434,37.3535521873901
Task_21528,1096,825,154,25,179,1.3268765133171914,26.165429218258478
Task_21529,2084,515,152,79,231,4.038759689922481,41.60492822673053
Task_21530,1438,711,59,81,140,2.019662921348315,31.5783903981855
Task_21531,2576,213,54,10,64,12.037383177570094,46.14471351992961
Task_21532,2646,392,180,117,297,6.732824427480916,50.55448767569184
Task_21533,2241,901,54,168,222,2.484478935698448,45.56910200486888
Task_21534,1816,163,10,34,44,11.073170731707316,34.09649921598835
Task_21535,2192,391,46,47,93,5.591836734693878,41.42085261654529
Task_21536,2004,478,126,18,144,4.1837160751565765,39.15095467130665
Task_21537,2062,812,122,99,221,2.5362853628536284,42.27349087269
Task_21538,1323,660,189,191,380,2.0015128593040847,30.94931151927638
Task_21539,1599,465,95,198,293,3.4313304721030042,34.333660992891886
Task_21540,2571,364,41,73,114,7.043835616438356,48.08038427889651
Task_21541,1109,701,81,82,163,1.5797720797720798,26.500941570391486
Task_21542,1732,989,79,174,253,1.7494949494949494,37.902242409517875
Task_21543,2718,283,123,116,239,9.570422535211268,51.053832537698874
Task_21544,2952,673,23,174,197,4.379821958456973,55.93004349492565
Task_21545,878,147,102,108,210,5.9324324324324325,21.188812921308788
Task_21546,2649,437,137,132,269,6.0479452054794525,50.64704422948714
Task_21547,2986,549,132,88,220,5.429090909090909,56.00251864950264
Task_21548,1272,929,184,131,315,1.367741935483871,30.549802525592415
Task_21549,1459,312,81,33,114,4.661341853035144,29.75157601453989
Task_21550,2882,877,80,45,125,3.28246013667426,54.18401556500927
Task_21551,2652,350,120,113,233,7.555555555555555,50.21322670425724
Task_21552,2526,365,77,19,96,6.901639344262295,46.563678877113766
Task_21553,2534,953,164,199,363,2.6561844863731654,50.985030309843296
Task_21554,2240,823,148,28,176,2.7184466019417477,44.30733258273346
Task_21555,2096,874,123,18,141,2.3954285714285715,41.82259272497505
Task_21556,2799,111,83,71,154,24.991071428571427,50.140155964671116
Task_21557,1648,107,154,162,316,15.25925925925926,33.50086656259411
Task_21558,724,765,120,43,163,0.9451697127937336,20.193918989937803
Task_21559,2698,553,191,95,286,4.870036101083032,51.83547715841791
Task_21560,504,942,44,48,92,0.5344644750795334,16.549960887521845
Task_21561,1385,753,162,31,193,1.836870026525199,30.642374879199608
Task_21562,855,976,91,91,182,0.8751279426816786,23.356355583020118
Task_21563,1060,749,68,123,191,1.4133333333333333,26.132468203686457
Task_21564,907,443,101,90,191,2.0427927927927927,22.648785564657828
Task_21565,892,342,85,96,181,2.6005830903790086,22.09739604439245
Task_21566,2579,458,137,78,215,5.618736383442266,49.162504229632674
Task_21567,2616,463,15,73,88,5.637931034482759,48.679671722701606
Task_21568,1600,934,107,97,204,1.7112299465240641,35.2744621965507
Task_21569,877,327,101,47,148,2.673780487804878,20.96761034678062
Task_21570,1509,512,179,32,211,2.9415204678362574,31.93338005335102
Task_21571,1878,802,78,178,256,2.3387297633872977,39.67356267901298
Task_21572,2756,874,49,127,176,3.149714285714286,53.377737098129764
Task_21573,2511,912,164,175,339,2.750273822562979,50.349261216792456
Task_21574,2457,910,37,40,77,2.6970362239297474,46.867152767936865
Task_21575,2907,609,145,106,251,4.7655737704918035,55.16956384568838
Task_21576,2230,958,99,96,195,2.3253388946819604,45.30319018700866
Task_21577,1904,293,92,65,157,6.476190476190476,37.39206863443794
Task_21578,1471,607,30,90,120,2.419407894736842,31.551168656336902
Task_21579,2259,583,43,33,76,3.868150684931507,42.656019054447675
Task_21580,1917,68,110,149,259,27.782608695652176,37.2159188294024
Task_21581,532,659,183,154,337,0.806060606060606,18.155485390365317
Task_21582,869,563,187,195,382,1.5407801418439717,23.428706998451236
Task_21583,2955,113,50,110,160,25.92105263157895,53.01662751220406
Task_21584,2886,458,22,122,144,6.287581699346405,53.67715468444677
Task_21585,809,885,152,180,332,0.9130925507900677,23.249991130491804
Task_21586,2976,837,84,58,142,3.551312649164678,56.02615999136384
Task_21587,1742,492,38,29,67,3.5334685598377282,34.14374647415386
Task_21588,711,725,64,168,232,0.9793388429752066,20.737173207793244
Task_21589,2198,576,199,165,364,3.8093587521663776,44.43221071102615
Task_21590,2051,107,113,163,276,18.99074074074074,39.65599649673138
Task_21591,711,456,41,180,221,1.5557986870897156,19.861802699687853
Task_21592,1051,201,133,110,243,5.202970297029703,24.436402057377574
Task_21593,2010,725,200,13,213,2.768595041322314,40.44931504753833
Task_21594,2610,811,180,150,330,3.2142857142857144,51.52454017320289
Task_21595,537,969,200,83,283,0.5536082474226804,18.891069071697412
Task_21596,1840,426,177,76,253,4.309133489461359,37.48176219469884
Task_21597,1336,679,159,96,255,1.964705882352941,30.540204913603585
Task_21598,1144,862,133,187,320,1.3256083429895713,28.418602656128055
Task_21599,1364,451,112,180,292,3.017699115044248,30.528173441211084
Task_21600,2191,417,130,109,239,5.241626794258373,43.164153308582485
Task_21601,2738,450,173,68,241,6.070953436807096,51.60211861077398
Task_21602,1908,628,150,162,312,3.0333863275039747,39.76538146259339
Task_21603,1151,831,178,126,304,1.3834134615384615,28.264849683325256
Task_21604,1852,93,16,17,33,19.70212765957447,33.598514783521864
Task_21605,2615,998,144,20,164,2.6176176176176176,50.695314672095776
Task_21606,1315,859,142,19,161,1.5290697674418605,29.53999824960385
Task_21607,2506,453,114,33,147,5.5198237885462555,47.14149009082947
Task_21608,1311,786,57,79,136,1.6658195679796697,29.763048754821444
Task_21609,2432,831,29,48,77,2.923076923076923,46.272885570581074
Task_21610,1610,319,15,141,156,5.03125,33.11556770155453
Task_21611,2749,506,117,159,276,5.422090729783037,52.52650889613227
Task_21612,1416,900,85,158,243,1.5715871254162042,32.46540814573128
Task_21613,1673,610,110,46,156,2.738134206219313,34.46839192755518
Task_21614,811,340,101,72,173,2.378299120234604,20.474531132421692
Task_21615,827,67,188,130,318,12.161764705882353,20.419560947428714
Task_21616,2577,291,84,44,128,8.825342465753424,47.678446672923315
Task_21617,1740,857,133,194,327,2.027972027972028,37.9350545277649
Task_21618,2147,669,171,165,336,3.2044776119402987,43.792550352383294
Task_21619,767,518,117,20,137,1.4778420038535645,19.636372249204992
Task_21620,2422,867,197,177,374,2.7903225806451615,48.959128558452925
Task_21621,1133,204,13,133,146,5.5268292682926825,25.134561480799604
Task_21622,2458,797,195,169,364,3.080200501253133,49.25354616656517
Task_21623,2792,875,172,61,233,3.1872146118721463,53.71245931231127
Task_21624,2004,1011,184,135,319,1.9802371541501975,42.474650182248546
Task_21625,1160,72,114,12,126,15.89041095890411,23.39852061652176
Task_21626,2784,568,190,10,200,4.8927943760984185,52.14782361659408
Task_21627,1799,646,75,83,158,2.7805255023183926,37.16115479603034
Task_21628,1884,711,194,71,265,2.646067415730337,39.0586626187956
Task_21629,2493,397,52,62,114,6.263819095477387,46.74222970639897
Task_21630,606,80,199,55,254,7.481481481481482,16.12138613014567
Task_21631,1828,370,196,165,361,4.92722371967655,37.89832418093631
Task_21632,714,551,27,122,149,1.2934782608695652,19.57691120267343
Task_21633,1811,655,168,185,353,2.760670731707317,38.53252843822213
Task_21634,1980,552,177,64,241,3.580470162748644,39.92458516387984
Task_21635,1213,800,20,68,88,1.5143570536828963,27.465699592285414
Task_21636,2661,958,58,174,232,2.7747653806047965,52.45585569674689
Task_21637,1391,902,129,103,232,1.5404208194905868,31.940729063915295
Task_21638,512,1012,167,90,257,0.5054294175715696,18.580899587479212
Task_21639,2024,670,60,41,101,3.0163934426229506,39.607427343539314
Task_21640,1252,114,85,85,170,10.88695652173913,26.354306972075772
Task_21641,823,951,189,180,369,0.8644957983193278,23.83566268852094
Task_21642,1427,945,130,108,238,1.5084566596194504,32.678907658276906
Task_21643,1040,275,69,94,163,3.7681159420289854,24.163529291297674
Task_21644,1013,676,97,104,201,1.4963072378138849,25.119688258269253
Task_21645,1260,1010,27,127,154,1.2462908011869436,29.622987820047843
Task_21646,2668,696,75,12,87,3.8278335724533714,49.80541951541249
Task_21647,814,226,186,106,292,3.5859030837004404,20.99425354260884
Task_21648,1983,518,35,13,48,3.820809248554913,37.837701700604995
Task_21649,1364,812,200,189,389,1.6777367773677736,32.09645437516276
Task_21650,1282,965,103,161,264,1.3271221532091098,30.633901947000552
Task_21651,605,906,105,38,143,0.6670341786108048,18.726701724560275
Task_21652,949,109,18,32,50,8.627272727272727,20.053001373969693
Task_21653,2851,545,126,106,232,5.221611721611722,53.99160647363652
Task_21654,2052,221,10,198,208,9.243243243243244,40.244494453201185
Task_21655,693,92,127,35,162,7.451612903225806,16.713001785804867
Task_21656,2032,553,159,71,230,3.667870036101083,40.7465992722396
Task_21657,2298,406,188,153,341,5.646191646191646,45.34549081744575
Task_21658,1587,805,39,137,176,1.968982630272953,34.56901694556148
Task_21659,2420,113,35,51,86,21.228070175438596,43.64166926290529
Task_21660,2907,307,161,153,314,9.438311688311689,54.52005517834797
Task_21661,2136,425,37,127,164,5.014084507042254,41.98836276011487
Task_21662,2356,287,126,31,157,8.180555555555555,44.23439667073756
Task_21663,2406,239,161,39,200,10.025,45.16237670823633
Task_21664,1825,534,84,23,107,3.411214953271028,36.14690600589379
Task_21665,2464,1023,108,190,298,2.40625,49.78769927593131
Task_21666,2394,360,65,88,153,6.631578947368421,45.62064397765585
Task_21667,823,988,181,64,245,0.8321536905965622,23.01632084624283
Task_21668,1739,185,200,42,242,9.349462365591398,34.617958745989725
Task_21669,1605,335,127,117,244,4.776785714285714,33.657964437639585
Task_21670,2623,87,105,178,283,29.806818181818183,48.530805019193984
Task_21671,2165,976,37,75,112,2.21596724667349,43.602300459329534
Task_21672,1652,771,198,173,371,2.139896373056995,36.44040815634312
Task_21673,2085,466,102,85,187,4.464668094218416,41.27784305347375
Task_21674,2559,451,31,165,196,5.661504424778761,48.98536240565786
Task_21675,883,574,95,167,262,1.5356521739130435,23.117145725894858
Task_21676,1527,879,191,132,323,1.7352272727272726,34.50621252160138
Task_21677,2413,540,136,177,313,4.460258780036969,47.50947339983126
Task_21678,1332,968,30,126,156,1.3746130030959753,30.705967753321207
Task_21679,2857,243,11,190,201,11.709016393442623,52.99958652415202
Task_21680,847,483,161,34,195,1.75,21.27490385123315
Task_21681,1321,211,57,198,255,6.231132075471698,28.98344915736703
Task_21682,2255,952,102,192,294,2.366211962224554,46.23955800298935
Task_21683,2542,469,144,44,188,5.408510638297872,48.03160642220269
Task_21684,2206,657,54,87,141,3.3525835866261398,43.60785888065161
Task_21685,2434,815,131,42,173,2.982843137254902,47.35238843323995
Task_21686,2945,99,148,37,185,29.45,52.32857195788185
Task_21687,1763,967,66,14,80,1.8212809917355373,36.16224997557027
Task_21688,2484,600,80,124,204,4.1331114808652245,48.30974653908985
Task_21689,924,529,140,156,296,1.7433962264150944,23.777921271724647
Task_21690,1652,457,65,197,262,3.606986899563319,35.06528724025744
Task_21691,2522,1019,76,104,180,2.4725490196078432,50.07764366355582
Task_21692,2997,209,46,129,175,14.271428571428572,54.91650849421535
Task_21693,2683,679,65,141,206,3.945588235294118,51.76273452587785
Task_21694,1865,607,92,65,157,3.067434210526316,37.79277597815187
Task_21695,2272,93,105,48,153,24.170212765957448,41.34918058271862
Task_21696,1176,759,57,61,118,1.5473684210526315,26.889177156971428
Task_21697,2547,758,167,149,316,3.355731225296443,50.295395717247196
Task_21698,801,496,17,176,193,1.6116700201207244,21.250682482937414
Task_21699,1495,268,188,27,215,5.557620817843866,30.904555086862803
Task_21700,2674,580,20,189,209,4.602409638554217,51.30441130608202
Task_21701,2107,329,178,50,228,6.384848484848485,40.97766330027431
Task_21702,1361,410,125,109,234,3.3114355231143553,29.984378941851478
Task_21703,2108,119,36,31,67,17.566666666666666,38.40334948998431
Task_21704,1431,354,173,134,307,4.030985915492958,31.276883057213542
Task_21705,1162,409,123,198,321,2.8341463414634145,27.35470629663757
Task_21706,700,540,131,61,192,1.2939001848428835,19.333882104801805
Task_21707,1477,792,149,123,272,1.8625472887767969,33.213879317654154
Task_21708,1630,547,120,166,286,2.9744525547445257,34.99602840153556
Task_21709,780,208,72,68,140,3.7320574162679425,19.365007871829516
Task_21710,2416,931,36,45,81,2.592274678111588,46.591767565156026
Task_21711,560,114,184,47,231,4.869565217391305,15.325939359148578
Task_21712,1560,606,15,127,142,2.57001647446458,33.15420782795555
Task_21713,2127,124,158,46,204,17.016,39.96893591812769
Task_21714,572,452,59,80,139,1.2626931567328918,17.007957436750182
Task_21715,1010,522,177,56,233,1.9311663479923518,24.394729084851594
Task_21716,777,822,93,155,248,0.9441069258809235,22.16754214450965
Task_21717,1446,413,161,37,198,3.4927536231884058,30.573633036690165
Task_21718,2530,754,99,71,170,3.3509933774834435,48.965703877540506
Task_21719,2210,648,166,91,257,3.4052388289676427,44.20468595644917
Task_21720,667,816,121,108,229,0.8164014687882497,20.225445353520293
Task_21721,2866,277,154,96,250,10.309352517985612,53.420004176681864
Task_21722,1310,453,60,89,149,2.8854625550660793,28.836808748275942
Task_21723,578,630,98,121,219,0.9160063391442155,18.205691863290046
Task_21724,2235,290,55,66,121,7.680412371134021,42.412088256609664
Task_21725,1961,715,129,30,159,2.738826815642458,39.3743637524174
Task_21726,1955,994,176,152,328,1.964824120603015,41.71081851736372
Task_21727,2160,906,108,106,214,2.3814773980154356,44.10425174300522
Task_21728,1211,604,39,99,138,2.0016528925619834,27.576503353140208
Task_21729,1683,492,110,119,229,3.413793103448276,35.33488924098759
Task_21730,2623,837,83,129,212,3.1300715990453463,51.28508348938407
Task_21731,778,287,64,31,95,2.701388888888889,18.626101531335994
Task_21732,1872,677,58,99,157,2.7610619469026547,38.42889063032079
Task_21733,1117,964,168,78,246,1.1575129533678756,27.69385579989941
Task_21734,2374,419,72,133,205,5.652380952380953,46.00860883658759
Task_21735,2792,322,81,98,179,8.643962848297214,52.101668266248275
Task_21736,2110,489,111,182,293,4.3061224489795915,42.46582125484549
Task_21737,1204,214,189,53,242,5.6,26.55716751350883
Task_21738,1382,920,28,12,40,1.500542888165038,29.49366876759751
Task_21739,752,692,20,198,218,1.0851370851370852,21.157492952648393
Task_21740,1137,304,108,140,248,3.7278688524590162,26.207107230517163
Task_21741,2826,217,174,162,336,12.963302752293577,53.01523073233957
Task_21742,530,245,136,179,315,2.154471544715447,16.78086982835075
Task_21743,1986,298,131,74,205,6.642140468227424,39.14133690806731
Task_21744,2428,450,162,143,305,5.383592017738359,47.37019141772805
Task_21745,1451,950,155,197,352,1.5257623554153523,33.71898945885631
Task_21746,1139,81,151,157,308,13.890243902439025,25.298549345703165
Task_21747,1874,887,41,116,157,2.1103603603603602,39.100597779262074
Task_21748,709,821,146,29,175,0.8625304136253041,20.095686420803155
Task_21749,1202,483,128,155,283,2.4834710743801653,27.988018320281935
Task_21750,1775,188,188,41,229,9.39153439153439,35.218444271906804
Task_21751,2891,886,195,21,216,3.2593010146561445,54.939739951102716
Task_21752,637,888,77,98,175,0.7165354330708661,19.840417045750637
Task_21753,2547,383,54,181,235,6.6328125,48.842370676289875
Task_21754,2863,708,182,62,244,4.038081805359662,54.37157742556957
Task_21755,1674,117,131,176,307,14.186440677966102,34.00266087233031
Task_21756,981,674,170,195,365,1.4533333333333334,25.460350583029136
Task_21757,1509,490,40,60,100,3.0733197556008145,31.161146556813534
Task_21758,1091,881,112,195,307,1.2369614512471656,27.57326214890944
Task_21759,2653,863,144,11,155,3.0706018518518516,50.69060201617334
Task_21760,1927,131,34,76,110,14.598484848484848,36.406341846435176
Task_21761,2038,805,71,174,245,2.5285359801488836,42.15540271525255
Task_21762,1832,904,130,131,261,2.0243093922651934,39.14921461028409
Task_21763,538,407,155,54,209,1.3186274509803921,16.45483696759226
Task_21764,1839,535,189,173,362,3.4309701492537314,38.620053300436886
Task_21765,1995,246,108,107,215,8.076923076923077,39.37340893072635
Task_21766,1521,843,155,130,285,1.802132701421801,34.138492761076726
Task_21767,2687,997,144,147,291,2.6923847695390783,53.1460480620299
Task_21768,1087,357,17,138,155,3.036312849162011,24.93704450879819
Task_21769,1856,774,10,112,122,2.3948387096774195,38.18934196891835
Task_21770,756,842,195,131,326,0.896797153024911,22.18572825390918
Task_21771,1152,316,159,166,325,3.634069400630915,26.86858834285579
Task_21772,1771,862,163,97,260,2.0521436848203938,38.02601945523711
Task_21773,1599,665,40,131,171,2.400900900900901,34.2582516395837
Task_21774,2563,367,68,81,149,6.9646739130434785,48.37676221137385
Task_21775,2929,338,16,40,56,8.640117994100295,52.46053738285209
Task_21776,960,890,48,139,187,1.0774410774410774,24.91023029134985
Task_21777,2404,181,59,89,148,13.208791208791208,44.89192105869509
Task_21778,1560,111,173,199,372,13.928571428571429,32.4540349024541
Task_21779,695,866,88,141,229,0.8016147635524798,20.809686923297523
Task_21780,1285,845,109,89,198,1.5189125295508275,29.872052693381615
Task_21781,1055,882,179,31,210,1.1947904869762174,25.903480619294697
Task_21782,997,1015,11,61,72,0.9812992125984252,24.286650870919733
Task_21783,2594,463,31,90,121,5.5905172413793105,48.90364426774113
Task_21784,1465,931,142,83,225,1.5718884120171674,33.074560017971244
Task_21785,1278,182,35,134,169,6.983606557377049,27.489148969690095
Task_21786,879,322,52,11,63,2.721362229102167,19.748151869105115
Task_21787,795,504,12,111,123,1.5742574257425743,20.48900655118325
Task_21788,653,276,200,30,230,2.357400722021661,17.717194627203973
Task_21789,2338,954,107,176,283,2.4481675392670157,47.48799650694044
Task_21790,1659,231,99,148,247,7.150862068965517,34.217983696114764
Task_21791,2452,497,143,188,331,4.923694779116466,48.08583337028055
Task_21792,1666,708,178,121,299,2.3497884344146684,36.06469448139449
Task_21793,1610,99,112,117,229,16.1,32.365036830470515
Task_21794,1726,849,118,190,308,2.030588235294118,37.59683319614313
Task_21795,2736,1023,125,73,198,2.671875,53.24611922103429
Task_21796,1956,977,50,160,210,2.0,41.25191344217636
Task_21797,1525,432,170,70,240,3.5219399538106235,32.34236355767411
Task_21798,643,311,180,136,316,2.0608974358974357,18.7192884186225
Task_21799,1090,88,182,31,213,12.247191011235955,23.336506798448482
Task_21800,2434,737,39,130,169,3.2981029810298104,47.7105371021316
Task_21801,2537,822,188,89,277,3.0826245443499394,50.031594833801684
Task_21802,1373,309,173,115,288,4.429032258064516,30.09869435630192
Task_21803,2906,745,140,38,178,3.89544235924933,54.64845253238149
Task_21804,2963,378,35,156,191,7.8179419525065965,55.11647138554903
Task_21805,2526,117,26,43,69,21.406779661016948,44.99814270117696
Task_21806,962,954,21,70,91,1.0073298429319373,24.020575928762824
Task_21807,2694,1012,40,136,176,2.6594274432379073,52.75338395610441
Task_21808,2159,1006,35,35,70,2.143992055610725,42.37978072256928
Task_21809,1812,801,45,169,214,2.2593516209476308,38.383451429505975
Task_21810,2903,295,90,81,171,9.807432432432432,53.48930468567345
Task_21811,1029,1017,153,80,233,1.0108055009823183,26.387442077592798
Task_21812,2809,346,115,45,160,8.095100864553315,51.592631486861244
Task_21813,1674,725,14,104,118,2.3057851239669422,35.1197295822272
Task_21814,640,292,140,157,297,2.1843003412969284,18.556473543938484
Task_21815,1314,920,195,79,274,1.4267100977198697,30.821931600948755
Task_21816,531,353,167,21,188,1.5,15.756246139641036
Task_21817,532,139,27,176,203,3.8,15.652733493649343
Task_21818,2964,665,99,108,207,4.45045045045045,56.05723784474579
Task_21819,1120,981,85,13,98,1.140529531568228,26.30419142064322
Task_21820,2009,419,61,89,150,4.783333333333333,39.7457545552521
Task_21821,725,67,112,114,226,10.661764705882353,18.387070502391808
Task_21822,741,221,107,26,133,3.3378378378378377,18.34238587552187
Task_21823,1665,831,68,186,254,2.001201923076923,36.398229170027804
Task_21824,2897,989,129,167,296,2.926262626262626,56.50079777805843
Task_21825,2504,802,103,111,214,3.1183063511830635,49.2369287843408
Task_21826,718,331,175,128,303,2.1626506024096384,19.898583896092898
Task_21827,2709,535,139,140,279,5.05410447761194,51.97264848337761
Task_21828,1767,374,194,181,375,4.712,37.03293871657953
Task_21829,708,607,170,16,186,1.1644736842105263,19.294577211491397
Task_21830,859,569,56,11,67,1.5070175438596491,20.168325697473154
Task_21831,1395,66,131,120,251,20.82089552238806,28.995176058024004
Task_21832,2660,571,94,49,143,4.65034965034965,50.077790404195184
Task_21833,723,998,28,59,87,0.7237237237237237,20.472927307801843
Task_21834,2969,1022,92,137,229,2.9022482893450636,57.406494202916186
Task_21835,2320,639,191,197,388,3.625,46.71920223782288
Task_21836,2619,748,72,63,135,3.4966622162883847,50.1670508146517
Task_21837,1678,907,54,170,224,1.8480176211453745,36.678780532118246
Task_21838,2024,66,41,82,123,30.208955223880597,37.65291811769313
Task_21839,2386,710,33,122,155,3.3558368495077358,46.652554126524954
Task_21840,1779,682,137,175,312,2.604685212298682,37.91096363135487
Task_21841,1009,245,66,199,265,4.1016260162601625,24.22986215512719
Task_21842,2991,868,194,41,235,3.4418872266973533,56.640360657022846
Task_21843,2694,440,65,143,208,6.108843537414966,51.180082859883235
Task_21844,2383,371,47,180,227,6.405913978494624,46.1401462969202
Task_21845,826,210,50,154,204,3.914691943127962,20.90213952959797
Task_21846,2063,296,45,101,146,6.946127946127946,40.15392682598475
Task_21847,1040,855,188,35,223,1.2149532710280373,25.63786579426348
Task_21848,1803,618,50,26,76,2.912762520193861,35.51608683664785
Task_21849,2734,686,115,52,167,3.97962154294032,51.95120052362384
Task_21850,551,232,95,87,182,2.3648068669527897,16.24684549404371
Task_21851,2278,883,151,169,320,2.576923076923077,46.47234737398984
Task_21852,927,69,121,200,321,13.242857142857142,22.094830664381494
Task_21853,1492,118,152,131,283,12.53781512605042,30.9824621562188
Task_21854,909,127,118,136,254,7.1015625,21.75315114911537
Task_21855,2589,509,58,42,100,5.076470588235294,48.04240086891179
Task_21856,2996,429,155,116,271,6.967441860465116,56.097905438248425
Task_21857,1720,146,82,76,158,11.700680272108844,33.670268788181936
Task_21858,611,90,87,43,130,6.714285714285714,15.094280357888783
Task_21859,2459,909,36,24,60,2.7021978021978024,46.77932746270039
Task_21860,1756,819,77,27,104,2.1414634146341465,35.93552702892592
Task_21861,527,339,57,69,126,1.55,15.732431893583017
Task_21862,840,537,174,99,273,1.5613382899628252,22.250435892071437
Task_21863,1879,836,137,115,252,2.2449223416965354,39.61814400572897
Task_21864,1508,424,126,137,263,3.548235294117647,32.527284322120714
Task_21865,2730,817,33,141,174,3.337408312958435,52.71244854294574
Task_21866,737,872,142,173,315,0.8442153493699885,21.974463915738756
Task_21867,2555,944,167,125,292,2.7037037037037037,50.86124323436692
Task_21868,2912,434,124,96,220,6.694252873563219,54.55424090442995
Task_21869,1568,865,178,127,305,1.8106235565819861,35.03731254795215
Task_21870,1656,553,192,59,251,2.9891696750902526,34.78895342478391
Task_21871,686,629,127,164,291,1.0888888888888888,20.25925618159374
Task_21872,2133,164,200,177,377,12.927272727272728,41.88024017202411
Task_21873,1604,175,165,132,297,9.113636363636363,33.1190898559197
Task_21874,2180,76,94,162,256,28.31168831168831,41.36207264164741
Task_21875,2562,901,40,69,109,2.8403547671840355,49.45583694535035
Task_21876,2193,667,115,115,230,3.282934131736527,43.963807754630345
Task_21877,1662,793,161,55,216,2.093198992443325,35.490924041305625
Task_21878,815,338,184,72,256,2.4041297935103243,20.94050621500424
Task_21879,1533,150,180,183,363,10.152317880794701,32.3162752415804
Task_21880,1613,371,37,18,55,4.336021505376344,31.591459540094885
Task_21881,2031,200,187,31,218,10.104477611940299,39.17151792498592
Task_21882,2170,237,101,176,277,9.117647058823529,42.48591457274049
Task_21883,1151,238,126,162,288,4.815899581589958,26.42160930571593
Task_21884,1688,304,128,33,161,5.534426229508196,33.76850293112218
Task_21885,1287,424,128,65,193,3.028235294117647,28.345063624862444
Task_21886,991,512,196,132,328,1.9317738791423003,24.90794949807579
Task_21887,2985,826,90,93,183,3.6094316807738815,56.71460066994633
Task_21888,2524,595,186,81,267,4.23489932885906,48.99075596120579
Task_21889,1931,589,188,195,383,3.272881355932203,40.37488896323264
Task_21890,2384,184,10,91,101,12.886486486486486,44.23011367772062
Task_21891,1423,218,20,122,142,6.497716894977169,29.71953396540003
Task_21892,1629,429,130,190,320,3.7883720930232556,34.79287151138716
Task_21893,2741,105,138,117,255,25.858490566037737,50.322247326495024
Task_21894,2588,352,119,152,271,7.331444759206799,49.4361272452662
Task_21895,1479,713,16,109,125,2.0714285714285716,32.12875021717104
Task_21896,2724,649,114,26,140,4.190769230769231,51.116170950578415
Task_21897,1985,553,145,145,290,3.583032490974729,40.62342774453319
Task_21898,1118,856,199,152,351,1.3045507584597433,28.06217765502467
Task_21899,1908,428,116,66,182,4.4475524475524475,38.0883912907023
Task_21900,1051,535,142,124,266,1.960820895522388,25.63882815030297
Task_21901,1927,224,138,125,263,8.564444444444444,38.46213044289498
Task_21902,1185,1021,43,97,140,1.159491193737769,28.485095826353074
Task_21903,2140,241,32,47,79,8.84297520661157,39.79823149214429
Task_21904,2856,150,198,199,397,18.91390728476821,53.34147026928409
Task_21905,1277,575,27,135,162,2.217013888888889,28.750687605363655
Task_21906,1641,139,76,96,172,11.721428571428572,32.95876324229746
Task_21907,2838,278,24,36,60,10.172043010752688,50.73228388337574
Task_21908,2789,732,150,136,286,3.8049113233287857,53.892884521696296
Task_21909,988,982,188,43,231,1.005086469989827,25.210470956548267
Task_21910,2428,377,55,61,116,6.423280423280423,45.56234367802142
Task_21911,1107,361,18,128,146,3.0580110497237567,25.24424941536414
Task_21912,1942,389,32,13,45,4.97948717948718,36.74595550291746
Task_21913,2581,520,25,123,148,4.953934740882917,49.07957794106895
Task_21914,1740,808,133,136,269,2.150803461063041,37.43599238225976
Task_21915,2649,208,97,141,238,12.674641148325358,49.71960327877722
Task_21916,2762,80,143,124,267,34.098765432098766,50.48941468843149
Task_21917,1859,441,58,109,167,4.205882352941177,37.68282505690791
Task_21918,1867,598,151,179,330,3.1168614357262103,39.12747799145201
Task_21919,1868,720,95,44,139,2.590846047156727,37.82791037292771
Task_21920,1015,245,116,20,136,4.126016260162602,22.695631341836535
Task_21921,2261,588,122,135,257,3.838709677419355,44.94177535983539
Task_21922,1970,867,198,70,268,2.269585253456221,40.88502641291912
Task_21923,2261,177,125,195,320,12.702247191011235,43.66592284500765
Task_21924,1099,693,100,52,152,1.5835734870317002,25.834312700984366
Task_21925,655,676,137,153,290,0.9675036927621861,19.923329351825465
Task_21926,2225,286,168,152,320,7.7526132404181185,43.68917744767784
Task_21927,581,117,169,174,343,4.923728813559322,16.96981067420049
Task_21928,2341,947,54,134,188,2.469409282700422,47.080479592931574
Task_21929,2320,768,95,100,195,3.0169050715214563,46.123750508435705
Task_21930,2581,104,104,106,210,24.580952380952382,47.58528789691973
Task_21931,2091,327,173,197,370,6.375,42.002667411020425
Task_21932,2581,76,143,22,165,33.51948051948052,46.202636679114725
Task_21933,2975,187,117,100,217,15.824468085106384,54.642389529682184
Task_21934,609,837,107,57,164,0.7267303102625299,18.81304613921932
Task_21935,2921,301,69,181,250,9.672185430463577,54.54503584036565
Task_21936,1694,444,200,186,386,3.8067415730337077,36.161396799953444
Task_21937,2047,504,35,165,200,4.0534653465346535,41.08670328220547
Task_21938,1640,562,27,66,93,2.9129662522202486,33.54852651878964
Task_21939,1830,259,131,160,291,7.038461538461538,37.232611944093215
Task_21940,1362,707,86,165,251,1.923728813559322,31.054474057467093
Task_21941,2560,617,36,157,193,4.142394822006472,49.52753792506243
Task_21942,679,688,176,116,292,0.9854862119013063,20.302553666494912
Task_21943,2410,399,39,109,148,6.025,45.98544513823995
Task_21944,1198,789,170,119,289,1.5164556962025317,28.812424529744604
Task_21945,1830,706,143,150,293,2.5884016973125883,38.671750068161124
Task_21946,1846,379,186,120,306,4.8578947368421055,37.8987704373071
Task_21947,2983,801,106,174,280,3.7194513715710724,57.21247452743694
Task_21948,2572,113,41,136,177,22.56140350877193,47.323889154408114
Task_21949,854,198,176,27,203,4.291457286432161,20.520508499187475
Task_21950,2238,436,160,177,337,5.121281464530893,44.51140525940993
Task_21951,2778,893,39,73,112,3.1073825503355703,52.998156092882844
Task_21952,2747,705,170,73,243,3.8909348441926346,52.62624632741203
Task_21953,1573,594,187,133,320,2.6436974789915966,34.34646896066128
Task_21954,1039,239,180,143,323,4.329166666666667,24.7856128990138
Task_21955,1638,980,86,109,195,1.6697247706422018,35.928279465177255
Task_21956,663,373,15,62,77,1.7727272727272727,17.02758610331405
Task_21957,2411,551,91,107,198,4.367753623188406,46.891453587310046
Task_21958,762,733,78,74,152,1.0381471389645776,20.76656140379603
Task_21959,1795,248,65,166,231,7.208835341365462,36.449026653209636
Task_21960,1969,459,97,56,153,4.280434782608696,38.88079560200908
Task_21961,1243,348,35,92,127,3.561604584527221,27.287324249993997
Task_21962,1396,721,119,33,152,1.9335180055401662,30.38460505239027
Task_21963,1515,946,63,101,164,1.5997888067581838,33.78171858240186
Task_21964,2136,795,170,196,366,2.6834170854271355,44.19442319130376
Task_21965,1213,162,100,42,142,7.441717791411043,25.347980800551692
Task_21966,1903,799,13,79,92,2.37875,38.56805958831351
Task_21967,1629,76,42,50,92,21.155844155844157,30.70730378021993
Task_21968,2786,364,185,78,263,7.632876712328767,52.34163480142063
Task_21969,1059,83,73,192,265,12.607142857142858,23.978683828144025
Task_21970,2319,258,18,61,79,8.953667953667953,42.87694398193281
Task_21971,2253,479,62,112,174,4.69375,44.09971692284088
Task_21972,2538,722,60,121,181,3.5103734439834025,49.421568238508435
Task_21973,2850,456,71,193,264,6.236323851203501,54.0177564103599
Task_21974,892,722,51,124,175,1.2337482710926695,23.29323292547186
Task_21975,708,873,137,25,162,0.8100686498855835,20.077352924880923
Task_21976,2510,374,192,160,352,6.693333333333333,48.653336913885404
Task_21977,1302,847,84,65,149,1.5353773584905661,29.635528916819613
Task_21978,2018,595,135,200,335,3.3859060402684564,41.562613522158564
Task_21979,2958,887,165,181,346,3.331081081081081,57.39423490406716
Task_21980,2800,784,69,79,148,3.56687898089172,53.44059610434988
Task_21981,2579,847,62,50,112,3.0412735849056602,49.172583815804465
Task_21982,1911,679,120,161,281,2.8102941176470586,39.832144407218074
Task_21983,2071,516,28,182,210,4.005802707930368,41.5508728874831
Task_21984,2535,725,104,38,142,3.4917355371900825,48.413129296569
Task_21985,1743,978,153,63,216,1.780388151174668,37.37513996551611
Task_21986,2776,838,86,99,185,3.3087008343265794,53.433217390363716
Task_21987,1002,882,180,11,191,1.1347678369195924,24.849136191475665
Task_21988,2384,457,48,13,61,5.205240174672489,44.018420491811305
Task_21989,1764,894,164,40,204,1.970949720670391,37.13918742700738
Task_21990,2397,105,12,192,204,22.61320754716981,44.74012045995847
Task_21991,735,589,170,155,325,1.2457627118644068,21.05044133734535
Task_21992,2065,1009,105,35,140,2.0445544554455446,41.83327249088645
Task_21993,730,411,114,94,208,1.7718446601941749,19.843050266517235
Task_21994,2424,882,185,99,284,2.7451868629671576,48.51175092490919
Task_21995,1072,335,76,114,190,3.1904761904761907,25.044161506461126
Task_21996,1752,84,195,176,371,20.611764705882354,35.24356618812059
Task_21997,2710,391,80,57,137,6.913265306122449,50.345142128426424
Task_21998,2286,198,173,99,272,11.487437185929648,44.06765994351233
Task_21999,2572,779,124,173,297,3.2974358974358973,50.707014258300184
Task_22000,2438,279,134,78,212,8.707142857142857,46.31320394972753
Task_22001,1372,884,57,89,146,1.5502824858757063,31.098490939715777
Task_22002,1982,95,158,119,277,20.645833333333332,38.36977284287124
Task_22003,1987,191,45,17,62,10.348958333333334,37.009354241445244
Task_22004,1635,666,30,140,170,2.451274362818591,34.847283939335114
Task_22005,1839,532,190,116,306,3.450281425891182,38.27457100356718
Task_22006,701,483,29,13,42,1.4483471074380165,17.3727381554848
Task_22007,2164,146,12,118,130,14.72108843537415,40.609038249903605
Task_22008,1988,672,148,86,234,2.9539375928677565,40.64168792303957
Task_22009,2364,199,54,188,242,11.82,45.34328115670033
Task_22010,2016,312,101,21,122,6.440894568690096,38.544541697465924
Task_22011,1248,341,192,176,368,3.6491228070175437,28.676526162667113
Task_22012,1644,1003,193,148,341,1.6374501992031874,36.84963165892623
Task_22013,1292,509,181,134,315,2.533333333333333,29.608286302375166
Task_22014,2591,326,199,121,320,7.92354740061162,49.5698353109456
Task_22015,2192,337,154,112,266,6.485207100591716,43.04049027770324
Task_22016,1502,313,124,46,170,4.7834394904458595,30.968704267269256
Task_22017,950,495,128,37,165,1.9153225806451613,22.845934303861895
Task_22018,2669,989,54,53,107,2.695959595959596,51.15250055069581
Task_22019,2364,911,98,12,110,2.5921052631578947,45.883193477452515
Task_22020,670,237,63,176,239,2.8151260504201683,18.68684137346464
Task_22021,1365,786,184,24,208,1.7344345616264294,30.420430862413397
Task_22022,2781,485,157,13,170,5.722222222222222,51.65865457335749
Task_22023,1811,895,180,27,207,2.021205357142857,37.86511066410747
Task_22024,2722,839,41,117,158,3.2404761904761905,52.392787677210215
Task_22025,2999,265,89,186,275,11.274436090225564,55.6729259931649
Task_22026,2393,266,18,104,122,8.962546816479401,45.04446737833482
Task_22027,2415,974,41,172,213,2.476923076923077,48.46187637611377
Task_22028,1624,1007,189,26,215,1.6111111111111112,35.29912333912485
Task_22029,1362,519,119,33,152,2.6192307692307693,29.213236996764653
Task_22030,2506,153,64,194,258,16.272727272727273,47.24312834502481
Task_22031,1534,398,89,149,238,3.844611528822055,32.738976822568404
Task_22032,2413,151,32,155,187,15.875,45.226556699404625
Task_22033,2725,972,164,83,247,2.800616649537513,53.3062034473971
Task_22034,2868,423,154,47,201,6.764150943396227,53.14198778393848
Task_22035,2371,840,10,29,39,2.8192627824019025,45.001420199276396
Task_22036,2976,811,83,21,104,3.665024630541872,55.16496914703308
Task_22037,1294,539,189,183,372,2.3962962962962964,30.063164265211196
Task_22038,847,936,92,151,243,0.9039487726787621,23.540433718719967
Task_22039,2120,700,56,194,250,3.0242510699001426,43.18692998356787
Task_22040,2021,534,63,183,246,3.777570093457944,41.057507980718476
Task_22041,2024,832,191,85,276,2.4297719087635055,41.89020408589038
Task_22042,2612,280,58,44,102,9.295373665480428,47.60255775477299
Task_22043,2679,272,173,75,248,9.813186813186814,50.20149480630109
Task_22044,2121,967,186,49,235,2.1911157024793386,43.26624912980677
Task_22045,1987,798,80,157,237,2.4868585732165207,41.25791190103755
Task_22046,1142,604,189,37,226,1.887603305785124,26.490228293025847
Task_22047,2463,608,148,130,278,4.044334975369458,48.291645461539964
Task_22048,2871,234,103,195,298,12.217021276595744,53.67019384494324
Task_22049,1944,729,40,44,84,2.663013698630137,38.464158231820996
Task_22050,1785,1022,109,34,143,1.7448680351906158,37.46096607557561
Task_22051,1589,72,25,194,219,21.767123287671232,31.941094166714986
Task_22052,563,510,81,47,128,1.101761252446184,16.584326902670814
Task_22053,1043,708,39,57,96,1.471086036671368,24.421932707133625
Task_22054,2308,879,55,137,192,2.6227272727272726,46.38098949258181
Task_22055,1492,401,163,78,241,3.711442786069652,31.891584262882702
Task_22056,1941,896,80,19,99,2.1638795986622075,38.95196303443914
Task_22057,1287,725,168,128,296,1.7727272727272727,30.097385606200522
Task_22058,687,200,130,110,240,3.417910447761194,18.673861287882428
Task_22059,1235,66,88,12,100,18.432835820895523,24.181659498892582
Task_22060,898,758,190,88,278,1.1831357048748352,23.79365642721915
Task_22061,2198,88,47,87,134,24.696629213483146,40.706561884349156
Task_22062,2622,564,130,24,154,4.64070796460177,49.26153263095117
Task_22063,1565,865,198,45,243,1.8071593533487298,34.06380721611227
Task_22064,708,854,48,187,235,0.8280701754385965,21.126503000658055
Task_22065,2333,100,142,81,223,23.099009900990097,43.44449672093973
Task_22066,1939,847,82,135,217,2.286556603773585,40.516694524471944
Task_22067,1480,302,103,165,268,4.884488448844884,31.750465593176468
Task_22068,638,896,75,144,219,0.7112597547380156,20.172653152712545
Task_22069,549,802,102,128,230,0.6836861768368617,18.449152618558795
Task_22070,947,205,164,108,272,4.597087378640777,22.936287968365665
Task_22071,875,75,182,129,311,11.513157894736842,21.116087690036398
Task_22072,2052,651,157,36,193,3.147239263803681,40.88417272542766
Task_22073,1204,963,33,123,156,1.2489626556016598,28.643965759232753
Task_22074,1365,836,195,120,315,1.6308243727598566,31.752196233403264
Task_22075,1508,522,72,85,157,2.8833652007648185,32.15321965155732
Task_22076,2831,759,128,86,214,3.725,54.17928631095432
Task_22077,1169,906,118,154,272,1.288864388092613,28.672071217935905
Task_22078,2887,946,127,91,218,3.0485744456177404,55.69010188958028
Task_22079,2360,723,78,165,243,3.2596685082872927,46.98431136615159
Task_22080,2732,826,18,72,90,3.3035066505441355,51.688115944283595
Task_22081,2846,765,60,86,146,3.715404699738903,54.1268968211902
Task_22082,2550,548,67,85,152,4.644808743169399,48.69951935728927
Task_22083,1662,111,58,15,73,14.839285714285714,31.085645678733957
Task_22084,1011,778,107,179,286,1.2978177150192554,25.871703145888855
Task_22085,1081,634,137,196,333,1.7023622047244094,26.81734050290916
Task_22086,1890,138,136,67,203,13.597122302158274,36.589753442580424
Task_22087,1604,934,68,88,156,1.7155080213903744,34.98698922977084
Task_22088,1424,706,44,78,122,2.014144271570014,31.10967052781612
Task_22089,640,871,47,50,97,0.7339449541284404,18.617886034041106
Task_22090,2616,704,139,135,274,3.7106382978723405,51.008446365925955
Task_22091,552,709,151,173,324,0.7774647887323943,18.610702268408026
Task_22092,953,518,160,166,326,1.836223506743738,24.365947565574164
Task_22093,2146,468,92,167,259,4.575692963752665,42.8004837855837
Task_22094,2785,678,101,60,161,4.101620029455081,52.55654675387661
Task_22095,1262,963,28,13,41,1.3091286307053942,27.757494432755067
Task_22096,2335,207,72,37,109,11.225961538461538,43.173860070506144
Task_22097,659,678,33,97,130,0.9705449189985272,19.10796534020613
Task_22098,1662,532,13,68,81,3.1181988742964353,33.68765862480512
Task_22099,2414,594,193,142,335,4.057142857142857,47.74560547911407
Task_22100,1761,103,68,178,246,16.932692307692307,35.034463713113766
Task_22101,2289,371,28,49,77,6.153225806451613,42.55174422958246
Task_22102,2782,656,156,194,350,4.2343987823439875,53.91482446523012
Task_22103,1976,382,137,177,314,5.1592689295039165,40.085024881330895
Task_22104,1860,235,195,48,243,7.88135593220339,36.75505050242737
Task_22105,520,525,145,71,216,0.9885931558935361,16.698917292280456
Task_22106,907,390,52,97,149,2.319693094629156,22.302832575027356
Task_22107,2207,482,59,174,233,4.569358178053831,43.76661135984443
Task_22108,1248,441,68,30,98,2.823529411764706,26.67434905615188
Task_22109,2635,127,67,45,112,20.5859375,47.0912039602016
Task_22110,2379,155,150,10,160,15.25,43.74313907069544
Task_22111,2297,567,109,107,216,4.044014084507042,45.21918374117309
Task_22112,837,325,119,65,184,2.567484662576687,20.83569274275367
Task_22113,2910,990,62,86,148,2.936427850655903,55.844580125496584
Task_22114,2036,85,174,79,253,23.674418604651162,38.75319657562408
Task_22115,978,246,118,52,170,3.9595141700404857,22.726864575943768
Task_22116,655,996,13,143,156,0.6569709127382146,20.291039196797843
Task_22117,508,465,132,68,200,1.090128755364807,16.14308617528307
Task_22118,1245,1003,106,167,273,1.2400398406374502,30.19699806799856
Task_22119,2605,246,137,18,155,10.54655870445344,47.91755375525784
Task_22120,2353,282,126,76,202,8.314487632508834,44.88357903289269
Task_22121,1197,730,63,128,191,1.637482900136799,28.281123995628814
Task_22122,2706,432,133,171,304,6.249422632794457,51.747590285801415
Task_22123,1487,698,97,87,184,2.127324749642346,32.53955499403012
Task_22124,1182,479,182,132,314,2.4625,27.764794722252716
Task_22125,820,972,153,139,292,0.8427543679342241,23.44513727877405
Task_22126,1521,302,29,151,180,5.01980198019802,31.961862817575327
Task_22127,551,934,183,172,355,0.5893048128342246,19.52093767444482
Task_22128,2602,225,60,122,182,11.513274336283185,48.78826606355313
Task_22129,2196,739,41,19,60,2.9675675675675675,41.98740396410296
Task_22130,779,859,35,39,74,0.9058139534883721,20.16351869198645
Task_22131,1563,991,200,140,340,1.5756048387096775,35.48328696411863
Task_22132,2314,572,97,110,207,4.038394415357766,45.47584431040608
Task_22133,823,178,186,34,220,4.597765363128492,19.858775915897056
Task_22134,1074,716,80,140,220,1.497907949790795,26.398643057062184
Task_22135,2988,572,112,162,274,5.214659685863874,56.51933955547215
Task_22136,2339,201,58,136,194,11.57920792079208,44.65434515938847
Task_22137,1067,427,59,139,198,2.4929906542056073,25.337539807205257
Task_22138,2231,858,81,62,143,2.5972060535506403,44.332116012417515
Task_22139,2742,648,64,11,75,4.224961479198767,50.32873991751199
Task_22140,1998,836,32,135,167,2.3870967741935485,41.10057732951563
Task_22141,757,161,56,189,245,4.672839506172839,19.635335494542133
Task_22142,1681,283,14,174,188,5.919014084507042,34.48686563919505
Task_22143,1901,367,121,45,166,5.165760869565218,37.47415705878848
Task_22144,1375,86,93,143,236,15.804597701149426,28.696105164689744
Task_22145,816,917,134,33,167,0.8888888888888888,22.054111373959447
Task_22146,2736,1004,136,147,283,2.7223880597014927,53.90832301683605
Task_22147,1630,586,12,101,113,2.7768313458262353,33.981062637384774
Task_22148,1113,226,200,66,266,4.903083700440528,25.262983818912414
Task_22149,2867,206,104,87,191,13.85024154589372,52.79099485526452
Task_22150,2177,159,151,115,266,13.60625,41.97034444902458
Task_22151,1862,839,107,148,255,2.216666666666667,39.4200439008122
Task_22152,1157,908,29,143,172,1.2728272827282727,27.982140731603664
Task_22153,1452,164,200,150,350,8.8,30.98140426772642
Task_22154,2973,596,79,128,207,4.9798994974874375,56.06710600987508
Task_22155,1547,913,35,161,196,1.6925601750547046,34.413022749155424
Task_22156,2262,252,67,91,158,8.940711462450594,43.228877892128445
Task_22157,1298,901,96,47,143,1.4390243902439024,29.41331366866915
Task_22158,1510,379,49,175,224,3.973684210526316,32.38990549722039
Task_22159,1463,991,112,71,183,1.4747983870967742,32.83108253345587
Task_22160,2898,530,41,20,61,5.4576271186440675,52.44312152132522
Task_22161,1259,466,12,192,204,2.69593147751606,28.49880921142378
Task_22162,2605,443,11,47,58,5.867117117117117,47.71865958383231
Task_22163,1906,174,143,44,187,10.891428571428571,36.74793694947096
Task_22164,2873,711,49,127,176,4.035112359550562,54.71844560646292
Task_22165,2878,862,22,12,34,3.3348783314020856,52.96361923053629
Task_22166,1774,621,55,129,184,2.852090032154341,37.02762274847886
Task_22167,1277,348,17,76,93,3.659025787965616,27.168494825784467
Task_22168,1285,596,58,65,123,2.152428810720268,28.432970542255703
Task_22169,2700,861,70,14,84,3.1322505800464038,50.822256768550176
Task_22170,2951,335,156,195,351,8.782738095238095,55.54278021812013
Task_22171,2857,502,130,35,165,5.679920477137177,53.045236053124114
Task_22172,2640,1008,133,127,260,2.616451932606541,52.266486023269216
Task_22173,1268,750,83,52,135,1.688415446071904,28.668231280481354
Task_22174,1160,690,55,182,237,1.678726483357453,27.859490077601972
Task_22175,808,328,16,143,159,2.4559270516717326,20.467913342589593
Task_22176,1251,348,144,41,185,3.5845272206303727,27.19858616159779
Task_22177,2951,1012,17,37,54,2.9131293188548866,54.921782291626215
Task_22178,847,267,19,130,149,3.16044776119403,20.850711984542713
Task_22179,2675,285,186,191,377,9.353146853146853,51.113222695520676
Task_22180,2751,515,55,54,109,5.3313953488372094,50.9719510679598
Task_22181,2004,987,132,120,252,2.02834008097166,42.076120475501625
Task_22182,1850,551,67,163,230,3.351449275362319,38.309900071070295
Task_22183,1942,581,85,60,145,3.336769759450172,38.89498370378396
Task_22184,2812,210,160,32,192,13.327014218009479,51.42464217123907
Task_22185,1562,856,111,67,178,1.822637106184364,33.95204016785939
Task_22186,1215,528,132,131,263,2.2967863894139886,28.210245234736018
Task_22187,2907,639,141,85,226,4.5421875,55.04486099115109
Task_22188,1950,992,54,98,152,1.9637462235649548,40.614651537345296
Task_22189,904,829,129,70,199,1.0891566265060242,23.55084115014077
Task_22190,2864,352,103,53,156,8.113314447592067,52.771666176842224
Task_22191,1421,747,23,84,107,1.8997326203208555,31.04147137912752
Task_22192,1468,371,40,104,144,3.946236559139785,30.958513487499193
Task_22193,2749,862,200,118,318,3.1853997682502895,53.78577387211643
Task_22194,796,776,109,32,141,1.0244530244530246,21.036548826207714
Task_22195,1281,623,19,20,39,2.0528846153846154,26.971067352026726
Task_22196,1916,358,96,148,244,5.337047353760446,38.70633707179136
Task_22197,867,378,54,143,197,2.287598944591029,22.018976838390714
Task_22198,2839,536,164,108,272,5.286778398510242,53.95576274872133
Task_22199,2301,174,10,62,72,13.148571428571428,42.087191462783395
Task_22200,1672,150,145,119,264,11.072847682119205,33.966690148922666
Task_22201,2309,723,109,193,302,3.1892265193370166,46.416437883310174
Task_22202,608,653,120,159,279,0.9296636085626911,19.07834478086819
Task_22203,2356,333,176,26,202,7.053892215568863,44.67868931242708
Task_22204,1948,648,197,30,227,3.0015408320493067,39.379883091218666
Task_22205,2034,64,70,186,256,31.29230769230769,39.12364246918759
Task_22206,2748,219,135,53,188,12.49090909090909,50.69721232641576
Task_22207,1922,271,122,151,273,7.0661764705882355,38.63413555091089
Task_22208,873,858,71,82,153,1.0162980209545984,23.033337471607698
Task_22209,1680,301,162,83,245,5.562913907284768,34.613485273825695
Task_22210,2060,731,82,111,193,2.814207650273224,41.92768089803626
Task_22211,924,213,200,146,346,4.317757009345795,22.989672684258625
Task_22212,2969,584,38,34,72,5.075213675213675,53.887489288386064
Task_22213,2855,1022,37,83,120,2.790811339198436,54.80005335049489
Task_22214,1077,264,154,71,225,4.064150943396227,24.680076860639712
Task_22215,1383,986,123,184,307,1.4012158054711246,32.5199680617314
Task_22216,1614,959,169,191,360,1.68125,36.38640771339237
Task_22217,1604,293,94,98,192,5.45578231292517,33.25784456682285
Task_22218,1781,439,61,104,165,4.047727272727273,36.44344229319351
Task_22219,690,936,169,194,363,0.736392742796158,21.678183186620497
Task_22220,862,253,182,83,265,3.393700787401575,21.6144113653995
Task_22221,1998,752,139,62,201,2.653386454183267,40.61359600536968
Task_22222,1413,824,73,126,199,1.7127272727272727,32.021333410034664
Task_22223,1517,236,43,43,86,6.40084388185654,30.160972040204182
Task_22224,1699,475,80,24,104,3.569327731092437,33.90173701300974
Task_22225,2945,889,114,163,277,3.308988764044944,56.85714379070953
Task_22226,2638,288,195,128,323,9.1280276816609,50.20333761620443
Task_22227,669,245,123,178,301,2.7195121951219514,18.912334029933373
Task_22228,1594,288,63,176,239,5.515570934256055,33.458372769383836
Task_22229,1182,97,95,52,147,12.061224489795919,24.541118026283595
Task_22230,2506,589,161,148,309,4.247457627118644,49.0782185989633
Task_22231,2879,538,17,101,118,5.341372912801484,53.571913299286656
Task_22232,2435,432,76,76,152,5.6235565819861435,46.377178352867105
Task_22233,2114,564,33,99,132,3.741592920353982,41.77838039160946
Task_22234,938,489,126,96,222,1.9142857142857144,23.494549829294925
Task_22235,1874,987,137,184,321,1.8967611336032388,40.42083683407672
Task_22236,690,271,108,176,284,2.536764705882353,19.248738865607958
Task_22237,1342,316,161,40,201,4.233438485804417,28.618353905580587
Task_22238,744,226,136,53,189,3.2775330396475773,19.091872649095276
Task_22239,2219,982,123,115,238,2.2573753814852493,45.3972048676138
Task_22240,2428,116,189,20,209,20.752136752136753,44.59953665370054
Task_22241,1142,228,180,162,342,4.986899563318778,26.488779301929323
Task_22242,2325,494,61,124,185,4.696969696969697,45.34753028600255
Task_22243,1729,679,161,13,174,2.5426470588235293,35.667331571425265
Task_22244,1990,667,74,127,201,2.9790419161676644,40.69589901644276
Task_22245,2207,261,92,135,227,8.423664122137405,42.87977867724924
Task_22246,2601,200,128,137,265,12.940298507462687,49.037537590446654
Task_22247,2983,561,89,48,137,5.307829181494662,54.98573754448602
Task_22248,1958,206,22,81,103,9.458937198067632,37.694838400775076
Task_22249,2376,531,18,152,170,4.466165413533835,46.15341879718633
Task_22250,1360,441,153,126,279,3.076923076923077,30.295285176250744
Task_22251,1248,755,101,176,277,1.6507936507936507,29.557649141739073
Task_22252,742,627,127,85,212,1.1815286624203822,20.59644711207773
Task_22253,2742,686,177,21,198,3.9912663755458517,51.86844852027591
Task_22254,1990,761,68,166,234,2.611548556430446,41.2092808861543
Task_22255,2300,464,30,16,46,4.946236559139785,42.650435541898496
Task_22256,2902,896,105,121,226,3.2352285395763656,55.90630579987212
Task_22257,2785,408,147,119,266,6.809290953545232,52.670628758827924
Task_22258,2324,847,57,145,202,2.740566037735849,46.58817570790281
Task_22259,2479,72,46,171,217,33.95890410958904,45.846586844441305
Task_22260,1017,487,178,12,190,2.084016393442623,23.868262459814247
Task_22261,2470,489,152,173,325,5.040816326530612,48.295884899396945
Task_22262,2588,487,118,150,268,5.30327868852459,49.86679034348333
Task_22263,1979,423,140,181,321,4.6674528301886795,40.30386245764311
Task_22264,1752,757,194,48,242,2.311345646437995,36.730437636801135
Task_22265,2928,837,48,40,88,3.4940334128878283,54.386596581273125
Task_22266,1156,736,132,83,215,1.5685210312075983,27.528236209820392
Task_22267,1174,888,179,55,234,1.3205849268841394,28.127666425751567
Task_22268,2419,828,154,55,209,2.9179734620024127,47.562147667142646
Task_22269,1180,86,138,134,272,13.563218390804598,25.77942022187366
Task_22270,2581,236,89,110,199,10.890295358649789,48.50520237342331
Task_22271,1012,645,37,123,160,1.5665634674922602,24.679362276410064
Task_22272,669,795,52,35,87,0.8404522613065326,18.595380114643692
Task_22273,523,610,124,123,247,0.855973813420622,17.394824025370937
Task_22274,1142,529,50,68,118,2.1547169811320757,25.94674419350355
Task_22275,2247,907,170,40,210,2.4746696035242293,44.859998636384695
Task_22276,1130,204,129,96,225,5.512195121951219,25.620577284328004
Task_22277,2007,619,89,110,199,3.2370967741935486,40.69835831916756
Task_22278,1870,320,113,28,141,5.825545171339564,36.558519895454374
Task_22279,2075,312,82,147,229,6.6293929712460065,41.031974209662756
Task_22280,1622,381,105,162,267,4.2460732984293195,34.247085304439715
Task_22281,1162,252,87,92,179,4.592885375494071,25.94562002807915
Task_22282,2266,589,152,125,277,3.840677966101695,45.09961601345825
Task_22283,2945,848,166,110,276,3.4687868080094226,56.64633538284113
Task_22284,2762,968,58,65,123,2.850361197110423,52.99535782994064
Task_22285,2890,89,49,198,247,32.111111111111114,52.64982504654488
Task_22286,1701,365,42,98,140,4.647540983606557,34.619635438314454
Task_22287,2045,586,92,174,266,3.48381601362862,41.62024680560376
Task_22288,1090,466,133,63,196,2.3340471092077086,25.35200010390928
Task_22289,1147,940,85,197,282,1.2189160467587672,28.526033470812706
Task_22290,1731,746,163,24,187,2.317269076305221,35.99657008660916
Task_22291,1321,964,129,156,285,1.3689119170984456,31.336135579721343
Task_22292,2031,138,161,35,196,14.611510791366907,38.54570530860061
Task_22293,1408,870,118,77,195,1.6165327210103329,31.782028058547564
Task_22294,1744,138,66,38,104,12.546762589928058,33.17516703230457
Task_22295,1497,992,74,91,165,1.5075528700906344,33.61315361353497
Task_22296,2825,98,40,51,91,28.535353535353536,49.81368366860852
Task_22297,2456,417,22,147,169,5.875598086124402,47.035179378656295
Task_22298,729,324,184,67,251,2.243076923076923,19.45180258551031
Task_22299,2419,1009,53,183,236,2.395049504950495,48.81334110181816
Task_22300,1740,702,160,22,182,2.4751066856330013,35.95739851588699
Task_22301,515,102,79,148,227,5.0,15.333195225601495
Task_22302,2113,655,143,45,188,3.221036585365854,41.82715836470698
Task_22303,739,353,11,115,126,2.0875706214689265,19.30933019909551
Task_22304,1188,337,18,127,145,3.514792899408284,26.442102162241188
Task_22305,2335,446,112,187,299,5.223713646532438,45.922626208700045
Task_22306,2351,757,119,184,303,3.1015831134564644,47.17993294344279
Task_22307,2239,380,36,198,234,5.876640419947506,43.924296932454276
Task_22308,1085,550,118,135,253,1.969147005444646,26.1816958357834
Task_22309,2619,966,58,115,173,2.7083764219234747,51.43081561016987
Task_22310,2827,381,171,40,211,7.400523560209424,52.36968025420936
Task_22311,2317,604,91,52,143,3.8297520661157023,44.89877788161014
Task_22312,2550,733,89,103,192,3.474114441416894,49.61690059517031
Task_22313,2527,433,93,176,269,5.82258064516129,48.805998687318386
Task_22314,699,328,160,43,203,2.1246200607902734,18.501597943621135
Task_22315,1936,310,153,79,232,6.22508038585209,38.596858482515934
Task_22316,786,439,88,140,228,1.7863636363636364,20.95367656962875
Task_22317,2067,599,161,82,243,3.445,41.69247630969582
Task_22318,717,147,37,198,235,4.844594594594595,18.854365534168057
Task_22319,2547,805,186,122,308,3.160049627791563,50.36738621565894
Task_22320,2257,519,98,134,232,4.3403846153846155,44.54831859123633
Task_22321,629,128,124,81,205,4.875968992248062,16.884521914918064
Task_22322,1217,829,85,176,261,1.466265060240964,29.18841560590887
Task_22323,2298,845,67,117,184,2.7163120567375887,46.01805347364991
Task_22324,2500,383,171,136,307,6.510416666666667,48.28726846936197
Task_22325,999,642,126,188,314,1.5536547433903578,25.416882109592255
Task_22326,1266,223,65,67,132,5.651785714285714,27.103514660680776
Task_22327,2043,428,77,82,159,4.7622377622377625,40.33831961431956
Task_22328,2156,751,160,82,242,2.867021276595745,43.576321879172916
Task_22329,1062,453,76,169,245,2.33920704845815,25.59343587980362
Task_22330,2181,479,128,26,154,4.54375,42.03771736308013
Task_22331,951,303,107,152,259,3.1282894736842106,23.330164777857593
Task_22332,2595,125,135,43,178,20.595238095238095,47.17617465641785
Task_22333,1080,1004,53,141,194,1.0746268656716418,27.220427289802092
Task_22334,2892,83,187,133,320,34.42857142857143,52.80815145293735
Task_22335,2745,754,155,187,342,3.6357615894039736,53.59240182179477
Task_22336,1205,387,125,152,277,3.1056701030927836,27.699128682866725
Task_22337,699,68,125,145,270,10.130434782608695,18.216702021675864
Task_22338,2388,953,27,31,58,2.50314465408805,45.80388839450896
Task_22339,2342,404,65,114,179,5.782716049382716,45.29179719978981
Task_22340,2714,1001,178,65,243,2.708582834331337,52.98811735602224
Task_22341,1121,78,191,149,340,14.189873417721518,25.141889608158873
Task_22342,1179,187,104,139,243,6.2712765957446805,26.477615047696887
Task_22343,1459,911,116,98,214,1.599780701754386,32.99450155460331
Task_22344,1631,410,104,114,218,3.9683698296836982,34.19220074775684
Task_22345,1584,303,195,94,289,5.2105263157894735,33.382069078570034
Task_22346,2556,457,27,81,108,5.580786026200873,48.084762294526335
Task_22347,2951,272,91,178,269,10.80952380952381,54.92196239510557
Task_22348,2159,629,131,23,154,3.426984126984127,42.140279108190846
Task_22349,559,863,114,145,259,0.6469907407407407,18.9538845335476
Task_22350,548,542,102,157,259,1.0092081031307552,17.63470564289169
Task_22351,2396,458,20,44,64,5.22004357298475,44.38691331461116
Task_22352,666,229,124,76,200,2.8956521739130436,18.036387233368647
Task_22353,822,233,139,165,304,3.5128205128205128,21.28440722008836
Task_22354,2887,687,74,71,145,4.196220930232558,54.35269593201118
Task_22355,1778,586,82,143,225,3.028960817717206,37.19619495385314
Task_22356,2091,304,127,46,173,6.855737704918033,40.28887352694256
Task_22357,1336,1014,192,11,203,1.3162561576354679,30.60225167924762
Task_22358,856,532,107,155,262,1.6060037523452158,22.555936073785478
Task_22359,1212,672,17,17,34,1.8008915304606241,25.941371072044742
Task_22360,2841,527,77,88,165,5.380681818181818,53.474364842405386
Task_22361,2563,166,159,108,267,15.347305389221557,48.05743931781043
Task_22362,1840,113,143,150,293,16.140350877192983,36.456451648308615
Task_22363,1080,347,118,140,258,3.103448275862069,25.490074740634373
Task_22364,1556,1001,169,172,341,1.5528942115768463,35.45477527998756
Task_22365,649,211,183,37,220,3.061320754716981,17.41571414681354
Task_22366,1459,157,197,188,385,9.234177215189874,31.288914955618015
Task_22367,559,678,131,60,191,0.8232695139911634,17.576164836195503
Task_22368,2849,475,99,29,128,5.985294117647059,52.61729223982662
Task_22369,2133,189,44,41,85,11.226315789473684,39.85300215763722
Task_22370,1093,616,181,153,334,1.7714748784440844,26.892721251130084
Task_22371,2354,324,50,11,61,7.243076923076923,43.10093854245315
Task_22372,2815,712,106,19,125,3.9481065918653577,52.557510325825696
Task_22373,2075,276,60,83,143,7.490974729241877,40.30180441913277
Task_22374,2697,373,151,38,189,7.211229946524064,50.19428388261293
Task_22375,2143,837,142,149,291,2.5572792362768495,44.029689555262394
Task_22376,1482,367,148,152,300,4.0271739130434785,32.12076180390368
Task_22377,2290,612,108,124,232,3.735725938009788,45.34842604190587
Task_22378,1688,603,12,56,68,2.794701986754967,33.86794517823612
Task_22379,2570,69,194,149,343,36.714285714285715,47.81221287711799
Task_22380,991,416,40,71,111,2.3764988009592325,23.15291395051244
Task_22381,2578,771,12,16,28,3.339378238341969,47.87978896509151
Task_22382,2329,239,176,87,263,9.704166666666667,44.75006603313121
Task_22383,2759,754,78,71,149,3.6543046357615894,52.52980689845939
Task_22384,2130,760,110,83,193,2.7989487516425755,42.970540253446586
Task_22385,1609,623,172,40,212,2.578525641025641,33.873505780151284
Task_22386,1376,618,84,181,265,2.222940226171244,31.13429016042861
Task_22387,679,67,100,159,259,9.985294117647058,17.882732341775444
Task_22388,556,963,55,136,191,0.5767634854771784,18.962750749804858
Task_22389,2900,633,50,188,238,4.574132492113565,55.29513584090475
Task_22390,1914,526,98,10,108,3.6318785578747628,37.52187276089537
Task_22391,1875,544,63,42,105,3.4403669724770642,36.86834920777341
Task_22392,2836,214,140,134,274,13.190697674418605,52.84056862962933
Task_22393,2496,914,181,99,280,2.7278688524590162,49.734528798059465
Task_22394,651,83,133,113,246,7.75,17.31688019543039
Task_22395,1858,347,51,183,234,5.339080459770115,37.84915161241676
Task_22396,1092,430,15,144,159,2.5336426914153134,25.291944467965155
Task_22397,1324,313,84,185,269,4.2165605095541405,29.363921992607487
Task_22398,616,360,108,58,166,1.706371191135734,17.350701396843995
Task_22399,682,619,80,23,103,1.1,18.31975338480359
Task_22400,1427,567,184,136,320,2.512323943661972,31.95393361594157
Task_22401,1326,580,97,105,202,2.2822719449225475,29.825813291630382
Task_22402,2476,930,73,17,90,2.659505907626208,47.54569802284232
Task_22403,2008,745,119,119,238,2.6916890080428955,41.32030770731365
Task_22404,2405,650,170,123,293,3.69431643625192,47.56362847030516
Task_22405,816,341,135,162,297,2.3859649122807016,21.50317207967102
Task_22406,1474,682,96,100,196,2.158125915080527,32.45478053374385
Task_22407,2663,344,118,118,236,7.718840579710145,50.3875444407185
Task_22408,1223,575,51,21,72,2.123263888888889,26.100879366953876
Task_22409,717,810,77,76,153,0.8840937114673243,20.37613136151641
Task_22410,692,1020,115,116,231,0.6777668952007836,21.374983025104196
Task_22411,2514,137,123,15,138,18.217391304347824,45.54981493142765
Task_22412,1438,380,118,159,277,3.774278215223097,31.37336094452014
Task_22413,2056,182,38,59,97,11.234972677595628,38.73826289010813
Task_22414,2599,430,44,74,118,6.03016241299304,48.761777786008984
Task_22415,659,564,136,74,210,1.1663716814159293,18.980750995345783
Task_22416,2285,982,162,199,361,2.3245167853509665,47.120595404124494
Task_22417,1434,716,131,76,207,2.0,31.762383556055592
Task_22418,2139,276,169,110,279,7.722021660649819,42.04834887504902
Task_22419,2754,485,81,30,111,5.666666666666667,50.76470866995936
Task_22420,1008,265,180,74,254,3.789473684210526,23.791816543542776
Task_22421,2327,562,198,66,264,4.1332149200710475,45.55684213824063
Task_22422,806,722,35,110,145,1.1147994467496543,21.551894963591668
Task_22423,2960,190,190,197,387,15.497382198952879,55.29833368004989
Task_22424,748,190,22,157,179,3.9162303664921465,19.32753602784472
Task_22425,1411,816,127,75,202,1.7270501835985312,31.671792090133177
Task_22426,2438,720,69,88,157,3.381414701803051,47.541341257008035
Task_22427,2867,78,118,174,292,36.29113924050633,52.31062359748361
Task_22428,2857,93,29,190,219,30.393617021276597,51.96273182871232
Task_22429,2810,323,116,91,207,8.67283950617284,52.414544085566796
Task_22430,2706,781,84,10,94,3.4603580562659846,50.751878227678496
Task_22431,862,127,132,60,192,6.734375,20.27494201623945
Task_22432,1228,673,136,176,312,1.8219584569732938,29.156686778135107
Task_22433,1918,884,85,46,131,2.167231638418079,39.12985383701565
Task_22434,502,909,172,124,296,0.5516483516483517,18.283297509743665
Task_22435,1766,922,74,80,154,1.9133261105092092,37.429148410580076
Task_22436,2509,163,118,101,219,15.298780487804878,46.980703955633466
Task_22437,1734,592,189,124,313,2.9241146711635753,36.8450668360364
Task_22438,728,966,144,105,249,0.7528438469493278,21.733337932888862
Task_22439,2767,139,68,199,267,19.764285714285716,51.301115141263466
Task_22440,2268,755,78,165,243,3.0,45.627438550186106
Task_22441,836,233,103,93,196,3.572649572649573,20.896813038849753
Task_22442,1694,120,77,178,255,14.0,34.222894267978454
Task_22443,2920,529,11,125,136,5.509433962264151,54.38559123768465
Task_22444,967,762,128,54,182,1.2673656618610747,24.20612968452309
Task_22445,920,805,43,61,104,1.1414392059553349,22.872848889920068
Task_22446,1580,588,72,60,132,2.6825127334465195,33.13442575291264
Task_22447,2266,68,106,68,174,32.84057971014493,41.70255922349428
Task_22448,2376,390,47,75,122,6.076726342710997,45.15578044368548
Task_22449,581,370,97,87,184,1.5660377358490567,17.12933046650532
Task_22450,2223,631,13,88,101,3.517405063291139,43.275914207423746
Task_22451,2862,307,163,100,263,9.292207792207792,53.50097774467224
Task_22452,702,629,103,51,154,1.1142857142857143,19.3087187815232
Task_22453,699,128,129,157,286,5.4186046511627906,18.639027800080676
Task_22454,2162,798,95,31,126,2.7058823529411766,42.67092131423661
Task_22455,2721,291,139,169,308,9.318493150684931,51.518671061262545
Task_22456,1618,581,196,24,220,2.7800687285223367,33.85153443754991
Task_22457,650,579,170,84,254,1.1206896551724137,19.162035972143816
Task_22458,2194,904,193,56,249,2.4243093922651933,44.41541580666212
Task_22459,2490,1019,26,61,87,2.4411764705882355,48.25483735552703
Task_22460,967,202,179,143,322,4.763546798029557,23.51835606557663
Task_22461,702,447,124,27,151,1.5669642857142858,18.52761120070794
Task_22462,2905,390,52,182,234,7.429667519181586,54.52920727398091
Task_22463,872,64,83,88,171,13.415384615384616,20.26828695729111
Task_22464,1280,676,134,102,236,1.8906942392909896,29.538681466263046
Task_22465,2290,1002,143,107,250,2.2831505483549352,46.62692216307678
Task_22466,2372,314,109,95,204,7.53015873015873,45.517722870075055
Task_22467,1088,111,168,78,246,9.714285714285714,24.017592557079094
Task_22468,2442,439,75,80,155,5.55,46.64681748987427
Task_22469,1546,128,62,40,102,11.984496124031008,29.77762821853994
Task_22470,1066,263,102,87,189,4.037878787878788,24.542684445860615
Task_22471,1925,718,145,40,185,2.677329624478442,39.04133540910768
Task_22472,1597,627,188,186,374,2.5429936305732483,35.15132455836416
Task_22473,2800,362,156,114,270,7.7134986225895315,52.76356282785264
Task_22474,2122,225,93,180,273,9.389380530973451,41.70961991664322
Task_22475,619,924,129,55,184,0.6691891891891892,19.37926032897837
Task_22476,1167,859,149,168,317,1.3569767441860465,28.732352965478142
Task_22477,2381,717,51,15,66,3.316155988857939,44.771148666247655
Task_22478,1467,581,105,200,305,2.520618556701031,32.65758148529813
Task_22479,1160,67,26,108,134,17.058823529411764,24.21069749659625
Task_22480,2543,155,42,111,153,16.30128205128205,46.76866222109869
Task_22481,1966,104,30,74,104,18.723809523809525,36.70836379176631
Task_22482,1055,539,25,78,103,1.9537037037037037,24.48695652624971
Task_22483,2761,726,108,67,175,3.797799174690509,52.52707855719516
Task_22484,1820,590,145,88,233,3.0795262267343486,37.72820364305361
Task_22485,1822,565,102,44,146,3.2190812720848054,36.676963830853914
Task_22486,2146,973,135,147,282,2.2032854209445585,44.4576148974387
Task_22487,2039,417,149,168,317,4.87799043062201,41.19677642606414
Task_22488,2692,217,132,15,147,12.34862385321101,49.16073865516278
Task_22489,622,787,102,189,291,0.7893401015228426,19.835514340719623
Task_22490,1856,933,148,163,311,1.9871520342612419,39.89195582734958
Task_22491,1208,67,105,15,120,17.764705882352942,24.00167175323274
Task_22492,2790,232,155,87,242,11.974248927038627,51.91088618376916
Task_22493,2267,863,199,108,307,2.6238425925925926,46.08759780722185
Task_22494,2489,867,27,72,99,2.8675115207373274,48.00718943868185
Task_22495,805,748,91,28,119,1.074766355140187,20.87149713798451
Task_22496,1150,579,200,199,399,1.9827586206896552,28.05359853569604
Task_22497,1334,728,185,10,195,1.8299039780521262,29.66456165255001
Task_22498,1806,282,14,165,179,6.381625441696113,36.39695875043815
Task_22499,1723,886,40,60,100,1.9425028184892899,35.791455680617005
Task_22500,576,535,125,152,277,1.0746268656716418,18.14093961487806
Task_22501,2590,571,114,147,261,4.527972027972028,50.13311199583535
Task_22502,1281,251,84,74,158,5.083333333333333,27.521911325527025
Task_22503,2614,144,81,49,130,18.02758620689655,47.3230850864067
Task_22504,2547,483,148,37,185,5.262396694214876,48.153645395441025
Task_22505,1222,717,104,57,161,1.701949860724234,27.917630081428285
Task_22506,2994,127,26,48,74,23.390625,52.49774634101589
Task_22507,2429,430,45,119,164,5.635730858468677,46.63060391543777
Task_22508,1004,614,90,132,222,1.632520325203252,24.935739462020404
Task_22509,1699,79,127,23,150,21.2375,32.252099343281
Task_22510,2194,389,195,193,388,5.625641025641026,43.91427176440177
Task_22511,1634,612,42,149,191,2.66557911908646,34.82781226334331
Task_22512,2593,552,184,150,334,4.688969258589512,50.4531458102677
Task_22513,1910,365,139,80,219,5.218579234972678,38.31508007827185
Task_22514,1218,624,24,103,127,1.9488,27.732546658225626
Task_22515,1882,284,187,91,278,6.603508771929825,37.926531920888955
Task_22516,2256,979,142,13,155,2.3020408163265307,44.764864141019245
Task_22517,500,806,65,165,230,0.6195786864931846,17.846456805756493
Task_22518,1740,657,141,83,224,2.6443768996960486,36.611408592352284
Task_22519,2683,381,105,97,202,7.023560209424084,50.6739016853368
Task_22520,1707,795,87,48,135,2.1444723618090453,35.5020215133318
Task_22521,1591,1011,106,195,301,1.5721343873517786,35.89385671522948
Task_22522,1092,107,132,29,161,10.11111111111111,23.17631852732464
Task_22523,2368,329,130,165,295,7.175757575757576,46.00525987682187
Task_22524,2215,881,37,74,111,2.5113378684807257,44.08465029550729
Task_22525,2216,399,13,15,28,5.54,40.971460225778344
Task_22526,2129,346,116,121,237,6.1354466858789625,41.956809500178686
Task_22527,1844,630,52,80,132,2.9223454833597464,37.77966692705731
Task_22528,1712,708,67,77,144,2.414668547249647,35.86563388207328
Task_22529,1744,191,173,108,281,9.083333333333334,35.50505033633498
Task_22530,2325,799,104,17,121,2.90625,44.96004234083359
Task_22531,976,828,114,74,188,1.1773220747889024,24.709724656543077
Task_22532,2636,837,101,138,239,3.1455847255369926,51.59028133897393
Task_22533,1092,316,167,85,252,3.444794952681388,25.395025960628583
Task_22534,1616,107,70,14,84,14.962962962962964,30.74922582916986
Task_22535,1096,353,62,75,137,3.096045197740113,24.928686919509108
Task_22536,583,853,90,83,173,0.6826697892271663,18.760868408938553
Task_22537,963,903,154,171,325,1.0652654867256637,25.663592154426656
Task_22538,2196,470,76,95,171,4.662420382165605,43.12520465404449
Task_22539,924,367,90,79,169,2.510869565217391,22.45133658389999
Task_22540,2613,1024,83,190,273,2.549268292682927,52.07505718547413
Task_22541,1987,672,181,170,351,2.9524517087667164,41.34263661377603
Task_22542,2236,628,79,41,120,3.5548489666136724,43.05934889976691
Task_22543,1957,264,15,45,60,7.384905660377359,36.81218405275374
Task_22544,2794,885,17,92,109,3.1534988713318284,53.21615697783154
Task_22545,919,954,60,31,91,0.962303664921466,23.07366583389693
Task_22546,1735,752,143,157,300,2.304116865869854,37.352543332693664
Task_22547,609,859,178,14,192,0.708139534883721,18.830257253148826
Task_22548,1385,852,132,131,263,1.6236811254396248,31.9005284977551
Task_22549,836,804,133,57,190,1.0385093167701864,22.305928211247693
Task_22550,2527,995,192,18,210,2.53714859437751,49.47153926390467
Task_22551,608,615,128,198,326,0.987012987012987,19.22521009947612
Task_22552,2684,235,157,79,236,11.372881355932204,50.16853306258216
Task_22553,1953,558,162,140,302,3.493738819320215,40.17935739513775
Task_22554,580,341,98,189,287,1.695906432748538,17.755745315947213
Task_22555,2965,141,19,127,146,20.880281690140844,53.289363246607216
Task_22556,2947,266,43,53,96,11.037453183520599,53.18069392313939
Task_22557,995,283,175,104,279,3.5035211267605635,23.980488438573147
Task_22558,2667,118,61,198,259,22.41176470588235,49.48834432203687
Task_22559,2042,148,87,114,201,13.704697986577182,39.46578942079634
Task_22560,935,360,24,86,110,2.590027700831025,22.204664307260618
Task_22561,790,238,91,154,245,3.305439330543933,20.512744056493347
Task_22562,522,207,114,126,240,2.5096153846153846,16.115786974297034
Task_22563,2512,700,104,124,228,3.5834522111269616,49.12496885075668
Task_22564,2475,372,88,130,218,6.6353887399463805,47.403769531483526
Task_22565,2961,466,136,193,329,6.340471092077088,56.04065487594016
Task_22566,2058,340,149,114,263,6.035190615835777,40.92060099792469
Task_22567,709,492,166,198,364,1.438133874239351,20.586077571136823
Task_22568,1589,621,118,116,234,2.554662379421222,34.27218382930847
Task_22569,2905,513,130,58,188,5.651750972762646,54.1423757774657
Task_22570,2768,901,82,121,203,3.0687361419068737,53.73706958383172
Task_22571,2719,170,54,13,67,15.900584795321638,48.24360297743462
Task_22572,2079,873,169,20,189,2.3787185354691074,41.90710796879957
Task_22573,2471,838,115,185,300,2.945172824791418,49.32298303683999
Task_22574,1866,501,10,191,201,3.7171314741035855,38.20033560726781
Task_22575,2667,380,135,19,154,7.0,49.358891971714804
Task_22576,2138,972,191,197,388,2.197327852004111,44.878775078373415
Task_22577,1978,283,25,45,70,6.964788732394366,37.199597697327064
Task_22578,1352,873,21,111,132,1.5469107551487413,30.630267329272016
Task_22579,1071,740,83,61,144,1.4453441295546559,25.556368248673664
Task_22580,853,299,85,114,199,2.8433333333333333,21.447691860754663
Task_22581,1989,746,75,118,193,2.6626506024096384,40.88296787464573
Task_22582,2470,639,82,64,146,3.859375,47.5373356333458
Task_22583,1725,693,149,53,202,2.4855907780979827,36.16355683019316
Task_22584,1685,942,27,112,139,1.7868504772004241,36.15086420914087
Task_22585,1521,630,65,44,109,2.410459587955626,31.636788893212437
Task_22586,2786,866,56,153,209,3.2133794694348325,54.01418897000763
Task_22587,1929,281,166,10,176,6.840425531914893,37.552813335204156
Task_22588,1771,849,129,160,289,2.083529411764706,38.18021319211896
Task_22589,563,629,104,135,239,0.8936507936507937,18.07131445443815
Task_22590,885,671,29,128,157,1.3169642857142858,22.705687467949158
Task_22591,2114,404,94,114,208,5.219753086419753,41.780993220399466
Task_22592,2167,188,86,96,182,11.465608465608465,41.722457962999634
Task_22593,1106,898,199,69,268,1.2302558398220245,27.26619113202302
Task_22594,1864,365,107,184,291,5.092896174863388,38.16375578084513
Task_22595,2112,401,75,180,255,5.253731343283582,42.10259275181236
Task_22596,2857,532,79,61,140,5.360225140712946,53.191078629189406
Task_22597,2061,895,19,96,115,2.3002232142857144,41.78295211386497
Task_22598,620,368,12,61,73,1.6802168021680217,16.246819649436272
Task_22599,2640,939,43,140,183,2.8085106382978724,51.70213834298274
Task_22600,2639,1013,52,50,102,2.6025641025641026,50.5472679659089
Task_22601,2232,260,200,120,320,8.551724137931034,43.660765182740924
Task_22602,1176,699,147,84,231,1.68,27.83013032512576
Task_22603,1753,764,57,111,168,2.291503267973856,37.03108725584869
Task_22604,2719,75,67,155,222,35.776315789473685,49.686291108080724
Task_22605,1783,933,196,24,220,1.9089935760171306,37.56515912765075
Task_22606,1457,671,147,83,230,2.168154761904762,32.19984040647016
Task_22607,2345,690,109,74,183,3.393632416787265,45.95832033157671
Task_22608,1641,1022,88,111,199,1.6041055718475072,36.12555195347075
Task_22609,1311,628,130,148,278,2.0842607313195547,30.1364871160422
Task_22610,1813,469,45,50,95,3.8574468085106384,35.75864696209095
Task_22611,2910,83,164,187,351,34.642857142857146,53.3091851065466
Task_22612,2868,382,10,159,169,7.488250652741514,53.433801998071765
Task_22613,1472,743,74,20,94,1.978494623655914,31.089416249068105
Task_22614,1693,426,53,173,226,3.9648711943793913,35.4195449195946
Task_22615,2687,677,46,137,183,3.9631268436578173,51.63643869847334
Task_22616,2620,824,59,151,210,3.175757575757576,51.25429798139643
Task_22617,2307,319,200,169,369,7.209375,45.345733668828416
Task_22618,2752,299,121,137,258,9.173333333333334,51.7650438613309
Task_22619,908,837,104,33,137,1.0835322195704058,22.946766131288225
Task_22620,1852,450,48,30,78,4.106430155210643,35.85477050506068
Task_22621,2673,878,61,123,184,3.0409556313993176,52.06440067306347
Task_22622,2814,875,107,99,206,3.212328767123288,54.317797944627046
Task_22623,1207,134,77,102,179,8.940740740740742,26.12333272600152
Task_22624,2406,272,46,174,220,8.813186813186814,46.11587636810177
Task_22625,1466,113,89,117,206,12.859649122807017,30.12146820056408
Task_22626,1447,551,162,194,356,2.621376811594203,32.46754165175398
Task_22627,972,907,76,193,269,1.0704845814977975,25.617080744400912
Task_22628,1235,255,199,142,341,4.82421875,28.015790129676237
Task_22629,996,204,70,104,174,4.8585365853658535,23.30492782197307
Task_22630,1615,803,105,61,166,2.0087064676616917,34.55367324842656
Task_22631,1698,319,36,72,108,5.30625,33.96204199566541
Task_22632,2787,725,163,163,326,3.8388429752066116,54.05895863110927
Task_22633,1723,119,82,184,266,14.358333333333333,34.692767244256956
Task_22634,604,467,109,96,205,1.2905982905982907,18.00077501621881
Task_22635,2576,680,112,149,261,3.7826725403817916,50.26092163641689
Task_22636,863,199,54,40,94,4.315,19.67365842544083
Task_22637,1242,86,182,121,303,14.275862068965518,26.87235422973698
Task_22638,2256,90,34,96,130,24.791208791208792,41.58912894097809
Task_22639,898,861,69,125,194,1.0417633410672853,23.87155196576936
Task_22640,2614,123,147,19,166,21.080645161290324,47.40888409714466
Task_22641,1686,981,152,63,215,1.7169042769857434,36.476680703453525
Task_22642,1147,836,102,130,232,1.3703703703703705,27.905346862823915
Task_22643,1566,121,54,14,68,12.836065573770492,29.671417202298272
Task_22644,950,712,13,69,82,1.332398316970547,22.96817864889776
Task_22645,926,787,62,199,261,1.1751269035532994,24.530180187958624
Task_22646,767,485,160,132,292,1.5781893004115226,21.072243818541285
Task_22647,1671,217,177,170,347,7.665137614678899,34.83845092378723
Task_22648,507,375,197,174,371,1.3484042553191489,17.02672543032106
Task_22649,1792,262,143,43,186,6.813688212927756,35.47245584714702
Task_22650,1371,783,181,144,325,1.7487244897959184,31.762770841343798
Task_22651,2542,893,46,194,240,2.843400447427293,50.39650852258544
Task_22652,1005,882,40,173,213,1.1381653454133636,25.744574343854357
Task_22653,2153,610,124,132,256,3.523731587561375,43.29230991562988
Task_22654,1985,366,137,159,296,5.408719346049046,40.06714203676882
Task_22655,2686,151,80,119,199,17.67105263157895,49.71132449113815
Task_22656,593,308,34,172,206,1.919093851132686,17.48818362227364
Task_22657,2566,851,107,184,291,3.011737089201878,50.826849516516155
Task_22658,2301,379,42,171,213,6.0552631578947365,44.76974155184965
Task_22659,1480,642,28,149,177,2.301710730948678,32.37103767213491
Task_22660,540,492,54,49,103,1.0953346855983772,15.690734061404243
Task_22661,1892,594,194,52,246,3.179831932773109,38.68622575466261
Task_22662,1433,445,25,20,45,3.213004484304933,28.867752713534703
Task_22663,2121,807,68,26,94,2.625,41.61272950761085
Task_22664,1343,659,153,122,275,2.0348484848484847,30.688577678708416
Task_22665,2520,250,41,38,79,10.0398406374502,45.819238606074585
Task_22666,1731,299,41,29,70,5.77,33.37014170769252
Task_22667,1112,335,151,165,316,3.3095238095238093,26.255591014753065
Task_22668,1629,337,80,125,205,4.819526627218935,33.933402889405144
Task_22669,632,799,169,142,311,0.79,20.052280978734228
Task_22670,2158,529,172,98,270,4.071698113207547,43.13466651299861
Task_22671,2852,505,142,167,309,5.636363636363637,54.31438576582328
Task_22672,2443,446,125,65,190,5.465324384787472,46.69517935436395
Task_22673,676,372,94,144,238,1.8123324396782843,19.104750073385237
Task_22674,1948,745,199,133,332,2.611260053619303,40.81399453462842
Task_22675,1564,719,121,71,192,2.172222222222222,33.68365711838572
Task_22676,750,400,143,12,155,1.8703241895261846,19.100184389556727
Task_22677,1905,658,17,180,197,2.890743550834598,39.27858293532137
Task_22678,1485,858,22,63,85,1.728754365541327,31.920865615092357
Task_22679,1656,811,77,178,255,2.039408866995074,36.17991173753134
Task_22680,2269,847,56,139,195,2.6757075471698113,45.67954634913798
Task_22681,1225,185,178,182,360,6.586021505376344,27.69048291475617
Task_22682,1172,830,136,105,241,1.4103489771359807,28.279739310928125
Task_22683,1244,306,92,12,104,4.052117263843648,26.193719040993614
Task_22684,2476,890,135,138,273,2.7789001122334454,49.37424929683332
Task_22685,2684,676,82,150,232,3.964549483013294,51.871735993500856
Task_22686,2730,331,45,153,198,8.22289156626506,51.31056193832209
Task_22687,2417,633,101,182,283,3.812302839116719,47.74125907090755
Task_22688,887,79,28,54,82,11.0875,19.267034426584036
Task_22689,2806,544,72,167,239,5.148623853211009,53.45676790026537
Task_22690,1156,163,73,42,115,7.048780487804878,24.23853492908142
Task_22691,2991,141,187,130,317,21.06338028169014,54.924865571481824
Task_22692,2452,562,69,146,215,4.355239786856128,47.78274294333146
Task_22693,2175,560,50,148,198,3.877005347593583,43.34217663346332
Task_22694,1841,271,111,113,224,6.768382352941177,37.0773892211268
Task_22695,827,396,175,107,282,2.0831234256926954,21.703349101170982
Task_22696,1157,169,143,176,319,6.805882352941176,26.236930587909118
Task_22697,2414,901,110,106,216,2.6762749445676275,48.12239141674606
Task_22698,1004,521,185,106,291,1.9233716475095786,24.93710189990111
Task_22699,2962,708,139,190,329,4.1777150916784205,56.830426483417455
Task_22700,2214,938,173,184,357,2.357827476038339,45.818478293434985
Task_22701,1485,953,55,93,148,1.5566037735849056,33.12560031658598
Task_22702,1500,150,183,136,319,9.933774834437086,31.52903645594542
Task_22703,605,795,65,157,222,0.7600502512562815,19.2705455271181
Task_22704,2878,237,122,31,153,12.092436974789916,52.25339884879819
Task_22705,1453,232,18,152,170,6.236051502145923,30.564659288678957
Task_22706,2158,272,70,28,98,7.904761904761905,40.54490467580735
Task_22707,2290,762,72,155,227,3.001310615989515,45.90415479805774
Task_22708,806,814,69,149,218,0.9889570552147239,22.445411543312655
Task_22709,1655,94,104,45,149,17.42105263157895,31.633548281741536
Task_22710,2649,903,20,158,178,2.9303097345132745,51.72020782830649
Task_22711,1207,152,170,30,200,7.888888888888889,25.732017807691495
Task_22712,2503,175,178,137,315,14.221590909090908,47.38775635107235
Task_22713,1391,470,111,185,296,2.9532908704883227,31.041273367202646
Task_22714,2102,583,32,194,226,3.5993150684931505,42.3522239964251
Task_22715,1492,997,62,150,212,1.4949899799599198,33.88594803452302
Task_22716,727,620,57,33,90,1.1706924315619969,18.931881185674687
Task_22717,2590,379,19,25,44,6.815789473684211,47.05508889076797
Task_22718,955,992,36,148,184,0.9617321248741189,25.085373107758613
Task_22719,2046,439,19,15,34,4.65,38.440977233821776
Task_22720,943,401,63,68,131,2.345771144278607,22.58526355946199
Task_22721,1571,340,76,142,218,4.607038123167156,33.12308694246108
Task_22722,1732,416,17,134,151,4.15347721822542,35.28788846179644
Task_22723,2618,513,16,130,146,5.093385214007782,49.64344028079555
Task_22724,684,489,78,99,177,1.3959183673469389,19.233703241932336
Task_22725,2854,886,67,67,134,3.217587373167982,54.35898739012055
Task_22726,742,855,121,12,133,0.866822429906542,20.358527062228667
Task_22727,722,486,91,139,230,1.482546201232033,20.097211960819987
Task_22728,1903,306,40,137,177,6.198697068403908,37.984923788186805
Task_22729,1631,657,60,125,185,2.478723404255319,34.87870638049684
Task_22730,1433,597,34,22,56,2.3963210702341136,29.543854875493405
Task_22731,1672,689,34,22,56,2.4231884057971014,33.61757431663576
Task_22732,2667,746,175,115,290,3.570281124497992,51.991620915882834
Task_22733,2855,705,170,25,195,4.043909348441926,53.73211007937104
Task_22734,1331,436,169,115,284,3.045766590389016,29.82678860731488
Task_22735,2742,790,92,182,274,3.4664981036662454,53.35204390412483
Task_22736,802,100,80,67,147,7.9405940594059405,18.691938427078227
Task_22737,1061,505,185,105,290,2.0968379446640317,25.78336887070356
Task_22738,840,834,154,92,246,1.0059880239520957,22.94984327044111
Task_22739,1276,890,69,42,111,1.4320987654320987,28.665256643232173
Task_22740,830,547,182,56,238,1.5145985401459854,21.62960141094049
Task_22741,1391,351,73,161,234,3.9517045454545454,30.40490068326059
Task_22742,839,554,174,109,283,1.5117117117117118,22.353335725165334
Task_22743,2753,149,30,99,129,18.35333333333333,49.94113480945588
Task_22744,1776,333,196,14,210,5.317365269461078,35.4657424278789
Task_22745,896,405,170,140,310,2.206896551724138,22.998183055303404
Task_22746,2302,842,21,113,134,2.730723606168446,45.589580958474244
Task_22747,1096,718,40,100,140,1.5243393602225312,26.093071558734664
Task_22748,2222,803,92,182,274,2.763681592039801,45.15444847744686
Task_22749,612,746,186,48,234,0.8192771084337349,18.648913999229144
Task_22750,2430,564,89,108,197,4.300884955752212,47.2104673579554
Task_22751,2280,167,165,112,277,13.571428571428571,43.65305405652813
Task_22752,2704,649,180,199,379,4.16,52.795205993931766
Task_22753,2516,733,65,33,98,3.4277929155313354,47.60908524232392
Task_22754,511,505,41,16,57,1.0098814229249011,14.708644132435387
Task_22755,1001,193,150,143,293,5.15979381443299,23.88838295513935
Task_22756,1775,449,110,77,187,3.9444444444444446,36.21540158723004
Task_22757,1804,1022,144,100,244,1.7634408602150538,38.93657619869534
Task_22758,2978,595,59,151,210,4.996644295302014,56.200227151674845
Task_22759,1461,618,96,50,146,2.360258481421648,31.252426893630894
Task_22760,848,812,136,136,272,1.0430504305043051,23.269677682518704
Task_22761,1106,135,118,92,210,8.132352941176471,24.524940367776495
Task_22762,864,296,176,145,321,2.909090909090909,22.201203583091058
Task_22763,2016,712,180,50,230,2.8274894810659186,40.77706520842874
Task_22764,1675,899,125,98,223,1.8611111111111112,36.43383044286599
Task_22765,2110,416,20,143,163,5.059952038369304,41.51296568908874
Task_22766,1699,620,66,21,87,2.7359098228663448,34.212445812576036
Task_22767,2292,708,36,106,142,3.232722143864598,45.07598431370201
Task_22768,1533,581,23,158,181,2.634020618556701,33.03558880531521
Task_22769,1210,90,10,134,144,13.296703296703297,25.24560587186187
Task_22770,1472,209,159,120,279,7.0095238095238095,31.28770265941064
Task_22771,2477,620,65,188,253,3.9887278582930756,48.5936030087465
Task_22772,2498,314,184,119,303,7.93015873015873,47.97803626253165
Task_22773,2094,799,48,121,169,2.6175,42.555366324767505
Task_22774,1216,846,66,190,256,1.435655253837072,29.30049028420891
Task_22775,875,645,115,100,215,1.3544891640866874,22.882917966297992
Task_22776,2385,1015,46,68,114,2.34744094488189,47.14588607720081
Task_22777,1950,967,76,30,106,2.0144628099173554,39.492638610264244
Task_22778,1392,1022,73,46,119,1.3607038123167154,30.936204931423642
Task_22779,1989,696,196,99,295,2.8536585365853657,41.087284250742925
Task_22780,1189,549,66,162,228,2.1618181818181816,27.82963463991027
Task_22781,1690,905,145,123,268,1.8653421633554084,36.922101524341585
Task_22782,1053,162,174,177,351,6.460122699386503,24.728701711796234
Task_22783,1168,296,169,153,322,3.9326599326599325,27.023604973957703
Task_22784,666,508,192,146,338,1.3084479371316307,19.768789607807285
Task_22785,1843,987,159,184,343,1.8653846153846154,40.02874036909296
Task_22786,2533,394,82,22,104,6.412658227848102,46.82574147813258
Task_22787,608,937,63,162,225,0.6481876332622601,19.8863720374021
Task_22788,851,438,81,174,255,1.938496583143508,22.24532772490166
Task_22789,2043,809,66,53,119,2.522222222222222,40.89423991086907
Task_22790,1087,769,143,65,208,1.4116883116883117,26.314413345436108
Task_22791,2738,775,186,64,250,3.5283505154639174,52.67577242464955
Task_22792,1152,691,14,18,32,1.6647398843930636,25.08668222794273
Task_22793,765,824,49,43,92,0.9272727272727272,20.332434353911918
Task_22794,2766,851,97,196,293,3.2464788732394365,54.03000668494271
Task_22795,780,317,33,30,63,2.452830188679245,18.365839019907636
Task_22796,2346,480,116,62,178,4.877338877338877,45.13836952008933
Task_22797,714,670,45,68,113,1.0640834575260805,19.580830006177717
Task_22798,2436,770,92,41,133,3.159533073929961,47.00150825720977
Task_22799,2520,864,66,98,164,2.913294797687861,49.47744715700131
Task_22800,2078,445,76,134,210,4.6591928251121075,41.439828135658935
Task_22801,1539,745,178,189,367,2.0630026809651474,34.57459038378536
Task_22802,2718,477,174,71,245,5.686192468619247,51.43055653354321
Task_22803,2052,877,102,55,157,2.337129840546697,41.55021779987488
Task_22804,2718,803,194,143,337,3.3805970149253732,53.23178579356505
Task_22805,2769,1017,197,88,285,2.7200392927308448,54.33521206206754
Task_22806,782,692,183,158,341,1.1284271284271283,22.177256638962945
Task_22807,580,219,60,45,105,2.6363636363636362,15.298693646217925
Task_22808,1660,638,18,151,169,2.5978090766823163,35.148188687584
Task_22809,1145,355,68,96,164,3.216292134831461,26.126910697601563
Task_22810,1253,257,90,139,229,4.8565891472868215,27.79211544791451
Task_22811,1008,895,191,178,369,1.125,26.54212596019735
Task_22812,2931,218,37,170,207,13.383561643835616,54.131470921155476
Task_22813,2749,983,147,27,174,2.7936991869918697,52.84327676013913
Task_22814,2151,472,177,87,264,4.547568710359408,42.72876398523465
Task_22815,2386,183,190,144,334,12.967391304347826,45.82410969629049
Task_22816,2680,220,59,117,176,12.126696832579185,49.9787001628526
Task_22817,1580,703,172,197,369,2.2443181818181817,35.113682433101836
Task_22818,2157,99,131,97,228,21.57,40.92424882142358
Task_22819,1488,942,97,127,224,1.5779427359490987,33.60866327730149
Task_22820,2426,415,199,60,259,5.831730769230769,46.57105742674469
Task_22821,2521,165,59,161,220,15.186746987951807,47.31443783037833
Task_22822,1108,553,129,186,315,2.0,26.909479090282357
Task_22823,2567,808,42,109,151,3.173053152039555,49.779800187494224
Task_22824,2631,330,121,120,241,7.948640483383686,49.85872869101496
Task_22825,2815,558,128,52,180,5.035778175313059,52.88322220734366
Task_22826,2002,776,184,46,230,2.5765765765765765,40.67163328744514
Task_22827,2544,83,170,148,318,30.285714285714285,47.366108500075576
Task_22828,2984,242,95,78,173,12.279835390946502,54.60576790524559
Task_22829,2496,193,150,111,261,12.8659793814433,47.29076215942988
Task_22830,1428,706,94,114,208,2.01980198019802,31.878294136729448
Task_22831,2703,299,50,198,248,9.01,51.132863801773766
Task_22832,1937,717,82,195,277,2.6977715877437327,40.437066147131276
Task_22833,2909,111,142,105,247,25.973214285714285,52.962099338468995
Task_22834,1709,105,97,106,203,16.12264150943396,33.865042389222026
Task_22835,1649,581,87,193,280,2.8333333333333335,35.3770138662303
Task_22836,1918,1001,184,196,380,1.9141716566866267,41.445088478555704
Task_22837,1243,481,197,177,374,2.578838174273859,29.073132439903162
Task_22838,1675,769,99,112,211,2.175324675324675,35.98968213648441
Task_22839,582,584,143,81,224,0.9948717948717949,17.99665898494739
Task_22840,2734,542,41,62,103,5.0349907918968695,50.82772530719435
Task_22841,2742,616,120,101,221,4.4440842787682335,52.436254667234984
Task_22842,1808,376,54,176,230,4.795755968169761,37.09731273117324
Task_22843,667,616,127,33,160,1.0810372771474879,18.5907536295747
Task_22844,2077,71,103,26,129,28.84722222222222,37.89969241678726
Task_22845,971,622,19,73,92,1.5585874799357946,23.138858743594557
Task_22846,745,935,183,116,299,0.7959401709401709,22.17074150773816
Task_22847,1009,475,185,111,296,2.119747899159664,24.901718792190717
Task_22848,713,574,178,108,286,1.24,20.41074674628854
Task_22849,2868,408,86,192,278,7.012224938875305,54.10540847974983
Task_22850,1360,309,129,110,239,4.387096774193548,29.664962812245978
Task_22851,2082,202,96,130,226,10.25615763546798,40.674827057864796
Task_22852,1165,983,166,78,244,1.1839430894308942,28.513374164784484
Task_22853,1386,435,140,13,153,3.1788990825688073,29.246659654089843
Task_22854,847,103,82,179,261,8.14423076923077,20.732549496697445
Task_22855,566,664,66,102,168,0.8511278195488722,17.860157499239488
Task_22856,2552,417,35,17,52,6.105263157894737,46.580010687169164
Task_22857,2512,196,97,172,269,12.751269035532994,47.709457400638236
Task_22858,618,126,172,152,324,4.866141732283465,17.5042815006966
Task_22859,2959,142,185,178,363,20.692307692307693,54.71042827353987
Task_22860,2872,881,117,138,255,3.256235827664399,55.53958558725674
Task_22861,1941,677,144,155,299,2.8628318584070795,40.373381335058745
Task_22862,2907,192,194,24,218,15.062176165803109,52.96074763786276
Task_22863,1417,845,58,162,220,1.6749408983451537,32.30725744044985
Task_22864,1373,128,62,98,160,10.643410852713178,28.277667151915523
Task_22865,686,473,125,116,241,1.4472573839662448,19.48808404816776
Task_22866,2340,923,113,73,186,2.5324675324675323,46.5749722592275
Task_22867,1685,78,112,188,300,21.329113924050635,33.85297635858994
Task_22868,2330,906,108,177,285,2.5689084895259096,47.222052542934115
Task_22869,2449,72,126,102,228,33.54794520547945,45.351426442386554
Task_22870,1941,82,70,141,211,23.3855421686747,37.47638494417693
Task_22871,1596,136,129,126,255,11.64963503649635,32.61048579265047
Task_22872,2820,279,84,182,266,10.071428571428571,52.879963403705005
Task_22873,1942,508,170,181,351,3.8153241650294696,40.12698011493174
Task_22874,1799,711,20,39,59,2.526685393258427,35.70604249911522
Task_22875,2451,211,55,119,174,11.56132075471698,46.32093585810197
Task_22876,888,358,36,50,86,2.4735376044568245,20.730282335138515
Task_22877,2091,485,182,111,293,4.302469135802469,42.04810557311398
Task_22878,2350,959,199,158,357,2.4479166666666665,48.00086765275642
Task_22879,1810,562,184,99,283,3.2149200710479575,37.77596722551836
Task_22880,1644,1018,93,55,148,1.6133464180569186,35.593265430735656
Task_22881,1737,665,161,76,237,2.608108108108108,36.53759406526208
Task_22882,513,667,23,96,119,0.7679640718562875,16.517717402558493
Task_22883,2479,781,173,25,198,3.170076726342711,48.028719943616096
Task_22884,2685,488,56,197,253,5.49079754601227,51.47648865549245
Task_22885,1789,721,77,17,94,2.4778393351800556,36.02609965265603
Task_22886,664,222,171,84,255,2.977578475336323,18.33850242511708
Task_22887,1231,820,172,117,289,1.4993909866017052,29.42857133119891
Task_22888,1402,592,41,163,204,2.3642495784148396,31.166089772754827
Task_22889,1451,439,154,75,229,3.297727272727273,31.252556577844288
Task_22890,1129,106,99,179,278,10.551401869158878,25.191774794859807
Task_22891,2029,139,125,12,137,14.492857142857142,37.931802222784334
Task_22892,559,356,185,24,209,1.5658263305322129,16.330992626797563
Task_22893,2469,651,34,18,52,3.78680981595092,46.021764359414895
Task_22894,726,693,158,75,233,1.0461095100864553,20.55729044243537
Task_22895,2315,253,58,49,107,9.114173228346457,42.98234354696705
Task_22896,2201,870,14,189,203,2.5269804822043627,44.69731324043722
Task_22897,517,822,168,50,218,0.6281895504252734,17.620988560229865
Task_22898,1022,474,18,69,87,2.1515789473684213,23.436645848764254
Task_22899,2128,619,127,172,299,3.432258064516129,43.17729952679782
Task_22900,1268,975,41,109,150,1.2991803278688525,29.638476472304163
Task_22901,1686,433,48,196,244,3.8847926267281108,35.43393998778584
Task_22902,1320,759,109,113,222,1.736842105263158,30.370475412830235
Task_22903,2097,851,180,197,377,2.461267605633803,43.802540620965004
Task_22904,1509,1013,155,37,192,1.4881656804733727,33.42252820785999
Task_22905,680,152,194,168,362,4.444444444444445,18.8548537469967
Task_22906,2075,424,51,16,67,4.882352941176471,39.002687420314125
Task_22907,2582,197,179,179,358,13.04040404040404,49.245128639020045
Task_22908,2518,717,60,147,207,3.5069637883008355,49.282075977179964
Task_22909,1156,611,75,27,102,1.8888888888888888,25.791220763838968
Task_22910,1229,120,187,152,339,10.15702479338843,27.1582725759442
Task_22911,2515,563,180,112,292,4.459219858156028,49.008295697632796
Task_22912,536,449,68,46,114,1.191111111111111,15.68047340203587
Task_22913,2395,484,75,92,167,4.938144329896907,46.263385273206296
Task_22914,1657,339,123,170,293,4.873529411764705,34.792146032404155
Task_22915,2718,850,42,104,146,3.1938895417156288,52.30174419894859
Task_22916,1815,239,103,154,257,7.5625,36.762875277681566
Task_22917,2640,661,165,152,317,3.987915407854985,51.47126779974485
Task_22918,1750,846,162,154,316,2.0661157024793386,37.95103825397463
Task_22919,2222,751,135,135,270,2.9547872340425534,44.896931724922865
Task_22920,1182,231,160,42,202,5.094827586206897,25.81226234751361
Task_22921,850,661,61,119,180,1.283987915407855,22.426051583294697
Task_22922,2288,438,41,105,146,5.211845102505695,44.179457900906925
Task_22923,2397,472,192,44,236,5.067653276955602,45.97589410091749
Task_22924,2136,276,63,108,171,7.7111913357400725,41.52014000808273
Task_22925,2213,882,20,89,109,2.506228765571914,44.02956041121246
Task_22926,1647,762,160,86,246,2.1585845347313235,35.575878859720625
Task_22927,2408,637,169,44,213,3.774294670846395,46.574531940000156
Task_22928,1052,781,110,142,252,1.3452685421994885,26.337361988664853
Task_22929,1609,816,101,120,221,1.9694002447980417,35.14563521491062
Task_22930,2497,651,138,54,192,3.829754601226994,48.17193951504637
Task_22931,776,954,128,77,205,0.812565445026178,22.08341963985851
Task_22932,1907,775,179,41,220,2.457474226804124,39.106993320753304
Task_22933,2926,968,164,15,179,3.019607843137255,55.54789844045988
Task_22934,2030,237,74,45,119,8.529411764705882,38.508458671420506
Task_22935,1622,78,69,200,269,20.531645569620252,32.80700512591651
Task_22936,1529,435,188,123,311,3.506880733944954,33.090700039052
Task_22937,894,674,41,19,60,1.3244444444444445,21.193991127981008
Task_22938,1369,851,163,97,260,1.6068075117370892,31.60894063966938
Task_22939,2815,82,26,169,195,33.91566265060241,51.06096213727923
Task_22940,1812,802,191,52,243,2.25653798256538,38.057909779447506
Task_22941,835,217,165,161,326,3.830275229357798,21.529710013244635
Task_22942,1199,122,27,188,215,9.747967479674797,26.139684679061087
Task_22943,2112,214,120,31,151,9.82325581395349,40.086791379544934
Task_22944,1423,718,37,14,51,1.9791376912378302,29.6338959330984
Task_22945,500,480,67,198,265,1.0395010395010396,16.812311964849766
Task_22946,1790,778,161,133,294,2.2978177150192556,38.24283229148434
Task_22947,1053,461,33,188,221,2.279220779220779,25.335278874575597
Task_22948,895,115,117,82,199,7.7155172413793105,20.942171186401783
Task_22949,1906,239,139,140,279,7.941666666666666,38.27905063271008
Task_22950,1915,285,108,92,200,6.695804195804196,38.104683396385056
Task_22951,2644,273,102,197,299,9.64963503649635,50.23714766690389
Task_22952,1184,618,160,114,274,1.9127625201938612,28.025992047140395
Task_22953,2319,844,199,80,279,2.744378698224852,46.585465760529594
Task_22954,2376,689,46,77,123,3.4434782608695653,46.152865907416874
Task_22955,2624,756,142,34,176,3.466314398943197,50.18979458882504
Task_22956,2014,924,24,129,153,2.1772972972972973,41.36848830121306
Task_22957,2307,386,47,129,176,5.961240310077519,44.65729412068674
Task_22958,1107,723,77,169,246,1.5290055248618784,27.115769413371126
Task_22959,2845,854,188,171,359,3.327485380116959,55.5442418252541
Task_22960,2682,809,46,101,147,3.311111111111111,51.6180768685804
Task_22961,2515,681,92,163,255,3.687683284457478,49.29900354604734
Task_22962,592,634,168,30,198,0.9322834645669291,17.836484049456814
Task_22963,1538,173,132,52,184,8.839080459770114,31.188622311424307
Task_22964,1567,197,192,128,320,7.914141414141414,32.979096144285116
Task_22965,2078,865,81,166,247,2.399538106235566,42.96711679573514
Task_22966,2041,857,80,180,260,2.378787878787879,42.435031902266196
Task_22967,1542,532,81,77,158,2.893058161350844,32.6079012585807
Task_22968,2047,433,99,175,274,4.716589861751152,41.19357350740858
Task_22969,2819,582,53,96,149,4.835334476843911,53.180967514436695
Task_22970,2081,676,15,113,128,3.073855243722304,41.716400050181974
Task_22971,1210,149,35,107,142,8.066666666666666,25.671125902621455
Task_22972,1074,852,82,45,127,1.2590855803048067,25.489260783157107
Task_22973,2171,215,99,153,252,10.050925925925926,42.27472077635863
Task_22974,1407,562,134,91,225,2.4991119005328595,31.072432958287532
Task_22975,1613,163,199,109,308,9.835365853658537,33.266535155618975
Task_22976,586,849,177,30,207,0.6894117647058824,18.58306928337515
Task_22977,1446,962,192,49,241,1.5015576323987538,32.579350147273594
Task_22978,1148,740,15,62,77,1.5492577597840755,25.83679397551221
Task_22979,2244,280,133,19,152,7.98576512455516,42.316861372859016
Task_22980,551,310,23,13,36,1.7717041800643087,14.39414576235454
Task_22981,2386,746,65,193,258,3.1941097724230256,47.5799710786473
Task_22982,1365,601,140,35,175,2.2674418604651163,29.758441922736058
Task_22983,1325,197,30,87,117,6.691919191919192,27.942486297569257
Task_22984,1261,881,21,64,85,1.4297052154195011,28.45287726390427
Task_22985,1153,522,33,18,51,2.204588910133843,24.770879023559456
Task_22986,2480,725,197,76,273,3.4159779614325068,48.65769473737904
Task_22987,2964,793,64,144,208,3.7329974811083124,56.588046348879764
Task_22988,1216,118,97,63,160,10.218487394957982,25.40132855294876
Task_22989,2662,441,156,159,315,6.02262443438914,51.112864994540566
Task_22990,1525,364,121,87,208,4.178082191780822,32.219943381949506
Task_22991,2196,517,115,190,305,4.239382239382239,43.98299459231481
Task_22992,723,297,190,95,285,2.4261744966442955,19.75316136159289
Task_22993,1918,215,148,191,339,8.87962962962963,38.72601050837026
Task_22994,1518,183,69,169,238,8.25,31.810144085759575
Task_22995,2719,279,104,77,181,9.710714285714285,50.535106607005815
Task_22996,2496,242,15,52,67,10.271604938271604,45.47716607937394
Task_22997,2775,282,123,103,226,9.80565371024735,51.87358296671781
Task_22998,866,512,15,196,211,1.6881091617933723,22.465606328517584
Task_22999,839,322,14,114,128,2.5975232198142413,20.93509895379743
Task_23000,1935,781,21,74,95,2.4744245524296673,38.9932727338739
Task_23001,755,587,55,104,159,1.284013605442177,20.401878442064707
Task_23002,1053,453,37,27,64,2.3193832599118944,23.10307652266087
Task_23003,2920,126,22,143,165,22.992125984251967,52.828260335340936
Task_23004,859,397,126,33,159,2.158291457286432,20.92584025942214
Task_23005,2886,183,75,192,267,15.684782608695652,53.56409714288851
Task_23006,2100,733,113,181,294,2.861035422343324,43.083392714967765
Task_23007,2343,166,32,164,196,14.029940119760479,44.30194986599881
Task_23008,2345,767,71,14,85,3.0533854166666665,44.89864280396591
Task_23009,1144,404,38,24,62,2.8246913580246913,24.359941835887422
Task_23010,1479,118,118,134,252,12.428571428571429,30.642644738706526
Task_23011,834,583,107,60,167,1.428082191780822,21.46795289477248
Task_23012,2972,410,178,153,331,7.231143552311435,55.97927604630015
Task_23013,2494,212,120,127,247,11.708920187793428,47.300727480034034
Task_23014,983,969,175,103,278,1.01340206185567,25.854631381828842
Task_23015,2607,580,175,166,341,4.487091222030981,50.819519082180896
Task_23016,2626,955,136,109,245,2.7468619246861925,51.78536381830063
Task_23017,2109,76,149,35,184,27.38961038961039,38.979289759953375
Task_23018,2272,330,110,45,155,6.86404833836858,43.019389574658796
Task_23019,1155,1014,83,118,201,1.1379310344827587,28.42301429666321
Task_23020,649,349,25,46,71,1.8542857142857143,16.444583853662458
Task_23021,2749,650,80,106,186,4.22273425499232,52.52487991000479
Task_23022,555,467,46,194,240,1.185897435897436,17.522428648021144
Task_23023,2238,1024,194,18,212,2.1834146341463416,44.99096915628731
Task_23024,989,972,102,100,202,1.0164439876670093,25.622862406282778
Task_23025,1906,450,14,104,118,4.226164079822617,37.92391304323215
Task_23026,2139,211,54,97,151,10.089622641509434,41.137599258035856
Task_23027,2798,437,172,136,308,6.3881278538812785,53.18688047110178
Task_23028,2647,921,80,160,240,2.870932754880694,52.11749174913516
Task_23029,2155,522,185,80,265,4.120458891013384,42.90891682947872
Task_23030,2827,897,161,113,274,3.148106904231626,54.925657014905276
Task_23031,1905,492,133,67,200,3.864097363083164,38.36771297519975
Task_23032,561,882,186,181,367,0.6353340883352209,19.580677380986433
Task_23033,1358,354,83,161,244,3.825352112676056,29.91343018166013
Task_23034,2863,460,58,117,175,6.210412147505423,53.708225144863626
Task_23035,957,373,191,29,220,2.5588235294117645,22.788086570745122
Task_23036,750,966,192,130,322,0.7755946225439504,22.469899249807355
Task_23037,644,674,96,85,181,0.9540740740740741,19.064977195486552
Task_23038,2917,568,12,13,25,5.126537785588752,52.60369968579074
Task_23039,1716,969,65,133,198,1.7690721649484535,37.28836776342866
Task_23040,2323,313,133,94,227,7.398089171974522,44.821531795834595
Task_23041,1805,304,38,35,73,5.918032786885246,34.54667659775584
Task_23042,1835,776,127,60,187,2.3616473616473614,38.0172690142976
Task_23043,1933,945,155,85,240,2.043340380549683,40.63804557694959
Task_23044,2695,556,152,18,170,4.838420107719928,50.527408092588445
Task_23045,2039,559,119,83,202,3.6410714285714287,40.93813705175749
Task_23046,610,546,30,177,207,1.1151736745886653,18.411962680466928
Task_23047,2111,574,126,97,223,3.671304347826087,42.341382773082
Task_23048,1120,988,154,23,177,1.1324570273003034,27.04066310767386
Task_23049,2685,957,146,17,163,2.8027139874739038,51.63802519522678
Task_23050,800,952,109,149,258,0.8394543546694648,22.927843839469773
Task_23051,696,727,113,48,161,0.9560439560439561,19.5327481926526
Task_23052,1887,177,99,71,170,10.601123595505618,36.64672693062096
Task_23053,2379,607,172,188,360,3.9128289473684212,47.41276924039827
Task_23054,1885,606,169,144,313,3.1054365733113674,39.309864658397814
Task_23055,1226,761,182,84,266,1.6089238845144358,28.972812208492645
Task_23056,2245,895,200,196,396,2.505580357142857,46.36902067617596
Task_23057,1253,621,137,28,165,2.014469453376206,28.01384956626798
Task_23058,761,741,165,163,328,1.0256064690026954,21.963510360401443
Task_23059,1206,826,150,97,247,1.4582829504232164,28.849758393920194
Task_23060,1461,871,103,36,139,1.6754587155963303,31.800267920957012
Task_23061,1645,840,106,100,206,1.9560047562425684,35.6937923557065
Task_23062,2856,458,76,68,144,6.222222222222222,53.04787761412228
Task_23063,1291,815,140,60,200,1.5821078431372548,29.582167235982684
Task_23064,1063,984,81,50,131,1.0791878172588834,25.97980771189749
Task_23065,1917,279,172,184,356,6.8464285714285715,39.005346176057216
Task_23066,590,146,30,162,192,4.01360544217687,16.550257307236887
Task_23067,1998,136,14,58,72,14.583941605839415,37.05282898512008
Task_23068,2632,731,73,152,225,3.5956284153005464,51.21111538863346
Task_23069,1349,551,33,53,86,2.443840579710145,28.73227473986547
Task_23070,1163,678,52,65,117,1.7128129602356406,26.693738202118265
Task_23071,1530,687,89,187,276,2.2238372093023258,33.81681704868032
Task_23072,740,624,191,42,233,1.184,20.228013045154672
Task_23073,2716,720,85,173,258,3.766990291262136,52.632656507493415
Task_23074,1849,399,37,64,101,4.6225,36.46808199339707
Task_23075,1998,1007,119,67,186,1.9821428571428572,41.363274728462144
Task_23076,2384,143,176,24,200,16.555555555555557,44.13802659867245
Task_23077,504,472,151,192,343,1.06553911205074,17.168974622746948
Task_23078,2331,807,127,177,304,2.88490099009901,47.01410651036531
Task_23079,2533,947,79,63,142,2.6719409282700424,49.44387490819105
Task_23080,504,1004,164,73,237,0.5014925373134328,18.26767975931656
Task_23081,1405,571,118,41,159,2.4562937062937062,30.10378030756986
Task_23082,2259,346,80,14,94,6.510086455331412,42.25222660631406
Task_23083,1625,103,185,59,244,15.625,32.25881275638312
Task_23084,2953,185,106,200,306,15.876344086021506,54.73808598339671
Task_23085,2483,760,193,26,219,3.2628120893561103,48.14278049001778
Task_23086,1017,625,188,128,316,1.6246006389776357,25.599367264203085
Task_23087,2182,297,29,87,116,7.322147651006712,41.78488464404098
Task_23088,1985,751,23,78,101,2.639627659574468,39.84773154687205
Task_23089,1205,529,72,105,177,2.2735849056603774,27.663487373369282
Task_23090,2909,305,12,35,47,9.506535947712418,51.898734079775245
Task_23091,1621,945,108,53,161,1.7135306553911205,35.013846533852394
Task_23092,650,912,14,58,72,0.7119386637458927,18.649742972252827
Task_23093,2736,910,88,17,105,3.0032930845225025,51.68121720104358
Task_23094,2256,720,89,61,150,3.128987517337032,44.234454355821214
Task_23095,529,763,106,125,231,0.6924083769633508,18.00438964471172
Task_23096,1138,988,64,109,173,1.1506572295247726,27.942949241386756
Task_23097,1137,910,95,59,154,1.2480790340285401,27.08195595339114
Task_23098,1617,681,166,73,239,2.370967741935484,34.63340616867843
Task_23099,2143,329,168,72,240,6.493939393939394,41.84208361287631
Task_23100,1487,98,137,65,202,15.02020202020202,29.760074532752174
Task_23101,2411,105,165,195,360,22.745283018867923,45.724130635569246
Task_23102,2604,257,168,40,208,10.093023255813954,48.39501486176007
Task_23103,1226,1008,19,51,70,1.2150644202180376,27.84447426550494
Task_23104,695,913,89,37,126,0.7603938730853391,19.892471072820438
Task_23105,1024,598,80,68,148,1.7095158597662772,24.477627669794217
Task_23106,2510,589,156,60,216,4.254237288135593,48.26968878995348
Task_23107,2110,316,10,122,132,6.65615141955836,40.8963832127174
Task_23108,1118,693,124,138,262,1.6109510086455332,27.182129031409886
Task_23109,2840,256,83,176,259,11.050583657587548,53.09650264417383
Task_23110,1246,939,119,103,222,1.325531914893617,29.708586998652624
Task_23111,1920,254,133,197,330,7.529411764705882,38.867168334168085
Task_23112,725,352,74,88,162,2.0538243626062322,19.320229967305004
Task_23113,1102,890,199,193,392,1.2368125701459034,28.155602759906667
Task_23114,1774,891,103,67,170,1.9887892376681615,37.36666465275058
Task_23115,1305,403,127,99,226,3.23019801980198,29.01912995243687
Task_23116,1601,307,141,120,261,5.1980519480519485,33.58278639000789
Task_23117,900,669,89,87,176,1.3432835820895523,23.04477424376422
Task_23118,1039,893,144,105,249,1.162192393736018,26.3888009426384
Task_23119,1172,309,125,54,179,3.7806451612903227,26.027544060521965
Task_23120,2229,678,62,58,120,3.2827687776141383,43.34950731794337
Task_23121,1258,123,28,35,63,10.14516129032258,25.038587974211836
Task_23122,2112,998,148,151,299,2.114114114114114,44.079054165264175
Task_23123,2731,212,134,198,332,12.821596244131456,51.52986538258026
Task_23124,2477,136,72,106,178,18.080291970802918,46.113967340584274
Task_23125,2769,889,60,138,198,3.1112359550561797,53.74508024821436
Task_23126,2001,192,89,24,113,10.367875647668393,37.97715807500283
Task_23127,1879,484,89,26,115,3.8742268041237113,36.9222798551483
Task_23128,1314,915,123,195,318,1.4344978165938864,31.272297637989073
Task_23129,2416,880,101,136,237,2.742338251986379,48.22711807728056
Task_23130,887,350,11,118,129,2.527065527065527,21.67475700763607
Task_23131,2712,402,52,181,233,6.729528535980148,51.50964783568202
Task_23132,1163,199,193,154,347,5.815,26.740016811637428
Task_23133,1036,473,140,197,337,2.1856540084388185,25.633682120415397
Task_23134,2227,964,184,184,368,2.3077720207253885,46.15502143698149
Task_23135,1193,854,36,48,84,1.3953216374269006,27.05869874019631
Task_23136,1441,961,11,15,26,1.497920997920998,30.439625430641325
Task_23137,2522,186,97,130,227,13.48663101604278,47.59687805033615
Task_23138,1953,767,61,181,242,2.54296875,40.69389364307953
Task_23139,1263,484,23,129,152,2.6041237113402063,28.091559048584944
Task_23140,2665,549,60,131,191,4.845454545454546,50.98058929937588
Task_23141,2724,899,130,12,142,3.026666666666667,51.85223314777169
Task_23142,1263,386,110,41,151,3.2635658914728682,27.233868880506098
Task_23143,1948,76,107,28,135,25.2987012987013,36.021210390020684
Task_23144,1218,201,143,105,248,6.02970297029703,27.08767433049213
Task_23145,2188,80,14,32,46,27.012345679012345,39.053140332809214
Task_23146,1182,923,85,158,243,1.2792207792207793,28.798346374754647
Task_23147,2705,468,67,113,180,5.767590618336887,51.25482712504883
Task_23148,1098,654,80,163,243,1.6763358778625954,26.748217820590497
Task_23149,652,769,50,81,131,0.8467532467532467,19.354791934674036
Task_23150,916,416,150,51,201,2.196642685851319,22.413740623190844
Task_23151,593,850,102,74,176,0.6968272620446534,18.832849219141234
Task_23152,2785,791,89,157,246,3.5164141414141414,53.84490135511502
Task_23153,2445,368,141,115,256,6.626016260162602,47.10622015715938
Task_23154,682,989,45,102,147,0.6888888888888889,20.611583664930023
Task_23155,1527,483,73,169,242,3.1549586776859506,33.02852306331746
Task_23156,534,222,196,142,338,2.3946188340807173,16.819229224190394
Task_23157,713,309,93,186,279,2.3,19.764767118883025
Task_23158,1002,705,47,95,142,1.4192634560906516,24.64801418463674
Task_23159,1627,488,14,121,135,3.32719836400818,33.79621479554918
Task_23160,741,893,111,89,200,0.8288590604026845,21.420323979013528
Task_23161,2134,546,148,169,317,3.9012797074954295,43.11731448592946
Task_23162,1702,355,59,128,187,4.780898876404494,35.07371825920687
Task_23163,1018,375,184,50,234,2.7074468085106385,23.929515671436516
Task_23164,2664,208,49,144,193,12.746411483253588,49.8463609654363
Task_23165,2508,820,29,83,112,3.0548112058465287,48.582547979768435
Task_23166,2540,392,118,19,137,6.463104325699746,47.29410441487604
Task_23167,1027,824,58,81,139,1.2448484848484849,25.371360235448915
Task_23168,1665,411,62,69,131,4.04126213592233,34.03734591849556
Task_23169,2421,728,189,167,356,3.3209876543209877,48.411639266853435
Task_23170,1239,77,145,69,214,15.884615384615385,25.858385373565174
Task_23171,2144,758,26,178,204,2.8247694334650855,43.43442704850825
Task_23172,1266,791,129,117,246,1.5984848484848484,29.72851114644614
Task_23173,861,815,44,183,227,1.0551470588235294,23.312334262243258
Task_23174,873,809,16,22,38,1.0777777777777777,21.23286142985899
Task_23175,1208,979,182,147,329,1.2326530612244897,29.759459156131115
Task_23176,1665,323,35,87,122,5.138888888888889,33.774381065187036
Task_23177,949,360,156,88,244,2.628808864265928,23.261053359250354
Task_23178,2322,169,10,121,131,13.658823529411764,43.270511290204695
Task_23179,2676,303,30,156,186,8.802631578947368,50.25444114686227
Task_23180,1003,764,32,151,183,1.3111111111111111,25.160662199172066
Task_23181,726,467,42,40,82,1.5512820512820513,18.38398787835342
Task_23182,1267,884,16,162,178,1.431638418079096,29.70685046405016
Task_23183,2450,183,53,188,241,13.315217391304348,46.53736568385839
Task_23184,2040,150,97,108,205,13.509933774834437,39.50016379092964
Task_23185,605,692,64,181,245,0.873015873015873,19.053288450243773
Task_23186,2996,327,29,48,77,9.134146341463415,53.5716801475968
Task_23187,1579,511,185,139,324,3.083984375,34.20627615458769
Task_23188,534,820,112,141,253,0.6504263093788063,18.392111503170586
Task_23189,2955,707,184,108,292,4.173728813559322,56.42940926123968
Task_23190,1901,559,17,82,99,3.3946428571428573,37.818666439724346
Task_23191,864,1024,165,130,295,0.8429268292682927,24.303347196237862
Task_23192,2966,66,157,14,171,44.26865671641791,51.96551714160072
Task_23193,2928,722,46,25,71,4.049792531120332,53.63653056891198
Task_23194,1498,209,42,108,150,7.133333333333334,30.913944422373515
Task_23195,1148,215,196,66,262,5.314814814814815,25.759840289777838
Task_23196,2427,99,107,84,191,24.27,44.811163869540245
Task_23197,963,437,110,83,193,2.1986301369863015,23.474771731826134
Task_23198,1842,385,162,43,205,4.772020725388601,36.775378365984075
Task_23199,2834,534,47,174,221,5.297196261682243,53.77717073590619
Task_23200,2776,85,41,56,97,32.27906976744186,48.98977754021763
Task_23201,1142,842,40,177,217,1.3546856465005932,27.83955187408939
Task_23202,2631,898,13,185,198,2.9265850945494996,51.56217813707159
Task_23203,1903,335,188,173,361,5.663690476190476,38.9805237766816
Task_23204,2417,896,76,20,96,2.6945373467112597,46.53732072629695
Task_23205,759,298,40,94,134,2.5384615384615383,19.502690877998155
Task_23206,1434,309,27,166,193,4.625806451612903,30.699836015220466
Task_23207,984,813,86,39,125,1.2088452088452089,23.968345883212432
Task_23208,2796,840,196,18,214,3.32461355529132,53.267562810399674
Task_23209,2823,913,16,54,70,3.088621444201313,52.86561602581961
Task_23210,2797,156,86,130,216,17.81528662420382,51.497857586293286
Task_23211,2739,237,196,93,289,11.508403361344538,51.390182713486446
Task_23212,2954,537,198,68,266,5.4907063197026025,55.41785253901582
Task_23213,1854,875,13,199,212,2.1164383561643834,39.26244600488667
Task_23214,2644,139,124,82,206,18.885714285714286,48.71923225387681
Task_23215,1633,828,22,145,167,1.9698431845597104,35.291530216477874
Task_23216,2746,697,138,35,173,3.9340974212034383,51.91710827247801
Task_23217,2176,227,174,188,362,9.543859649122806,42.94431779234977
Task_23218,1272,553,54,68,122,2.296028880866426,28.066064284946748
Task_23219,1323,766,10,177,187,1.7249022164276402,30.323170984658574
Task_23220,1073,183,65,61,126,5.831521739130435,23.76796043332514
Task_23221,1566,933,105,37,142,1.676659528907923,33.70771810762361
Task_23222,1839,66,102,168,270,27.44776119402985,36.08990726919959
Task_23223,1264,1019,178,156,334,1.2392156862745098,30.806416836370357
Task_23224,1712,970,17,51,68,1.7631307929969104,35.36488655863783
Task_23225,1973,926,130,165,295,2.128371089536138,41.65496745117834
Task_23226,2630,73,165,185,350,35.54054054054054,48.863293374110604
Task_23227,2250,644,147,74,221,3.488372093023256,44.51497652409756
Task_23228,601,632,19,86,105,0.9494470774091627,17.6076582058769
Task_23229,2680,136,34,133,167,19.562043795620436,49.11046184410916
Task_23230,2513,294,98,157,255,8.51864406779661,47.98880912197249
Task_23231,1990,551,134,108,242,3.6050724637681157,40.425666284086745
Task_23232,2185,530,168,103,271,4.114877589453861,43.56967156511711
Task_23233,2584,537,44,183,227,4.802973977695167,49.84523105294005
Task_23234,2877,977,82,144,226,2.941717791411043,55.83922275248336
Task_23235,2954,773,108,191,299,3.8165374677002584,56.775367958448555
Task_23236,1147,265,64,135,199,4.31203007518797,26.07868692489968
Task_23237,2004,405,159,156,315,4.935960591133005,40.5771565641984
Task_23238,2948,562,10,182,192,5.236234458259325,55.473782383751534
Task_23239,1036,919,168,66,234,1.126086956521739,26.068268832900923
Task_23240,2154,125,50,52,102,17.095238095238095,39.64199523141858
Task_23241,669,461,72,152,224,1.448051948051948,19.221912836700806
Task_23242,1777,940,33,136,169,1.8884165781083952,37.94407273736352
Task_23243,2365,454,132,27,159,5.197802197802198,44.91502201843256
Task_23244,1433,924,30,71,101,1.5491891891891891,31.498219773456402
Task_23245,2303,975,141,169,310,2.3596311475409837,47.11020705552644
Task_23246,1319,704,76,65,141,1.8709219858156028,29.477760300767105
Task_23247,1705,656,163,56,219,2.5951293759512937,35.7579111752918
Task_23248,2791,297,29,37,66,9.365771812080537,50.075735993706616
Task_23249,2472,866,147,166,313,2.85121107266436,49.457177126630405
Task_23250,1363,518,48,141,189,2.626204238921002,30.259894201197337
Task_23251,2338,773,106,85,191,3.020671834625323,46.295293443058334
Task_23252,1935,331,103,51,154,5.828313253012048,37.89735501664497
Task_23253,2594,584,31,42,73,4.434188034188034,47.97084903229904
Task_23254,749,88,17,47,64,8.415730337078651,16.676388925571686
Task_23255,867,547,162,97,259,1.582116788321168,22.677484450217026
Task_23256,1669,427,48,76,124,3.899532710280374,34.133249653408434
Task_23257,1768,783,132,129,261,2.2551020408163267,37.755304212941546
Task_23258,642,790,30,179,209,0.8116308470290771,19.70434790560022
Task_23259,1809,324,31,155,186,5.5661538461538465,36.6097554443794
Task_23260,1835,297,127,166,293,6.157718120805369,37.460468718042726
Task_23261,1849,717,56,131,187,2.5752089136490253,38.557648193372415
Task_23262,1786,698,24,23,47,2.5550786838340485,35.34442094345209
Task_23263,2943,911,64,149,213,3.226973684210526,56.65566122247361
Task_23264,1580,826,137,65,202,1.9105199516324063,34.28930812957963
Task_23265,2418,905,181,60,241,2.6688741721854305,47.91978821169675
Task_23266,1497,572,160,177,337,2.612565445026178,33.214848558362455
Task_23267,1233,556,42,173,215,2.213644524236984,28.44508297377331
Task_23268,2802,780,36,22,58,3.587708066581306,51.8114223821647
Task_23269,1051,621,114,48,162,1.689710610932476,24.742608853257124
Task_23270,2343,933,49,89,138,2.5085653104925054,46.645099435817365
Task_23271,2884,910,42,129,171,3.1657519209659712,55.38720242472636
Task_23272,2391,232,153,178,331,10.261802575107296,46.20450925691093
Task_23273,567,483,101,30,131,1.171487603305785,16.453117722081796
Task_23274,764,398,23,142,165,1.9147869674185463,20.198156147219695
Task_23275,2250,579,184,15,199,3.8793103448275863,43.71578282961358
Task_23276,2070,379,55,126,181,5.447368421052632,40.9199680493859
Task_23277,1142,892,195,194,389,1.2788353863381858,28.78684094192501
Task_23278,2562,908,17,35,52,2.8184818481848186,48.40251897908001
Task_23279,686,697,192,172,364,0.9828080229226361,20.847913257743684
Task_23280,986,737,83,125,208,1.3360433604336044,24.95411593050218
Task_23281,1464,754,139,120,259,1.9390728476821193,32.826602384014755
Task_23282,1022,265,133,172,305,3.8421052631578947,24.56495946301835
Task_23283,2625,301,136,165,301,8.69205298013245,49.99904921861842
Task_23284,2350,198,79,101,180,11.809045226130653,44.7088089220107
Task_23285,1843,65,33,127,160,27.924242424242426,35.14496891327968
Task_23286,2130,105,192,175,367,20.09433962264151,41.31066105324606
Task_23287,2366,521,145,50,195,4.532567049808429,45.55703470067908
Task_23288,1766,435,120,167,287,4.0504587155963305,36.797948612802195
Task_23289,915,781,155,192,347,1.170076726342711,24.65557252665468
Task_23290,2567,244,192,58,250,10.477551020408164,48.17617276464697
Task_23291,1432,244,110,89,199,5.844897959183673,30.33058893792033
Task_23292,1054,744,119,114,233,1.414765100671141,26.12051192795315
Task_23293,1371,310,47,194,241,4.408360128617363,30.014491406258696
Task_23294,2536,509,64,45,109,4.972549019607843,47.24545870975549
Task_23295,2470,918,81,199,280,2.687704026115343,49.54089231582727
Task_23296,2715,389,71,75,146,6.961538461538462,50.72941159367861
Task_23297,1361,450,87,55,142,3.0177383592017737,29.173932794611332
Task_23298,1556,938,116,117,233,1.6570820021299255,34.721289374428714
Task_23299,2003,502,108,70,178,3.982107355864811,39.82617969099075
Task_23300,1328,643,24,169,193,2.062111801242236,30.087771838570404
Task_23301,1999,900,132,98,230,2.218645948945616,41.60236434076145
Task_23302,1759,758,48,76,124,2.3175230566534912,36.60377567006616
Task_23303,581,281,126,34,160,2.0602836879432624,16.16932863392417
Task_23304,2033,157,88,200,288,12.867088607594937,39.88693588647977
Task_23305,2588,680,171,62,233,3.8002936857562406,49.87736904202827
Task_23306,1880,193,27,147,174,9.690721649484535,37.15773767309037
Task_23307,2602,861,159,142,301,3.0185614849187936,51.41205913603877
Task_23308,2409,779,42,103,145,3.0884615384615386,47.1774221233532
Task_23309,1534,619,59,111,170,2.4741935483870967,33.12081664536408
Task_23310,1416,361,172,166,338,3.911602209944751,31.2489769699115
Task_23311,1823,452,53,157,210,4.024282560706402,37.46516373925946
Task_23312,2846,498,156,34,190,5.703406813627255,52.95358499369227
Task_23313,2061,128,81,182,263,15.976744186046512,40.05745375521388
Task_23314,701,1017,141,93,234,0.6886051080550099,21.476451227504906
Task_23315,2391,497,131,74,205,4.801204819277109,46.20675566487467
Task_23316,1796,1014,44,37,81,1.7694581280788177,37.0730060808099
Task_23317,653,549,172,91,263,1.1872727272727273,19.204166240346417
Task_23318,1329,758,42,164,206,1.7509881422924902,30.52924809697052
Task_23319,1374,944,130,167,297,1.453968253968254,32.17725143349414
Task_23320,954,937,105,78,183,1.0170575692963753,24.72077900310477
Task_23321,2400,204,89,90,179,11.707317073170731,45.35116928324164
Task_23322,2691,708,194,20,214,3.7954866008462624,51.201064873889344
Task_23323,2629,692,150,30,180,3.7936507936507935,50.0886268833471
Task_23324,1741,466,153,185,338,3.728051391862955,36.758040476700764
Task_23325,1117,951,196,26,222,1.1733193277310925,27.124590770945016
Task_23326,1552,480,54,138,192,3.226611226611227,33.15402091425869
Task_23327,2988,702,160,102,262,4.250355618776672,56.792289733354586
Task_23328,685,715,199,86,285,0.9567039106145251,20.358763881749457
Task_23329,961,915,58,129,187,1.0491266375545851,25.002210815872658
Task_23330,2953,99,112,187,299,29.53,53.875398151293815
Task_23331,615,405,73,129,202,1.5147783251231528,18.070293851851456
Task_23332,2547,181,171,19,190,13.994505494505495,46.857485492314225
Task_23333,2372,608,187,100,287,3.8949096880131364,46.847072462200295
Task_23334,1830,715,36,116,152,2.5558659217877095,37.81233157806704
Task_23335,1503,504,155,68,223,2.976237623762376,32.14526595976259
Task_23336,1281,894,165,193,358,1.4312849162011174,30.861643505978567
Task_23337,1575,332,107,98,205,4.72972972972973,32.977490122730025
Task_23338,1151,791,116,120,236,1.4532828282828283,27.825494390463206
Task_23339,1424,480,85,46,131,2.9604989604989607,30.0386795709632
Task_23340,2692,406,22,27,49,6.614250614250614,48.84596460983445
Task_23341,1519,194,92,17,109,7.78974358974359,30.295366389827965
Task_23342,996,859,112,142,254,1.158139534883721,25.678974385891753
Task_23343,1881,309,91,12,103,6.067741935483871,36.24806683890276
Task_23344,1368,723,143,33,176,1.8895027624309393,30.188023579374832
Task_23345,894,896,145,41,186,0.9966555183946488,23.2991854608
Task_23346,1814,784,150,97,247,2.310828025477707,38.40557011933447
Task_23347,2337,691,71,83,154,3.3771676300578033,45.76925607415009
Task_23348,763,948,78,108,186,0.804004214963119,21.957383682833285
Task_23349,1682,999,29,122,151,1.682,36.33859399532313
Task_23350,1332,208,181,104,285,6.373205741626794,29.077445675633594
Task_23351,2224,544,176,190,366,4.080733944954129,44.78761783436957
Task_23352,1492,234,29,198,227,6.348936170212766,31.574679400922125
Task_23353,1870,450,121,46,167,4.146341463414634,37.25432540131094
Task_23354,842,558,31,81,112,1.5062611806797854,21.296716110329815
Task_23355,2583,141,132,87,219,18.190140845070424,47.86962234030643
Task_23356,1719,764,20,26,46,2.2470588235294118,34.51743106776457
Task_23357,1233,693,132,45,177,1.776657060518732,27.94988513276336
Task_23358,2835,892,163,164,327,3.1746920492721165,55.35039881275983
Task_23359,807,322,66,88,154,2.498452012383901,20.424112925790247
Task_23360,2213,560,86,98,184,3.944741532976827,43.640569075701514
Task_23361,1874,358,143,86,229,5.220055710306407,37.809431418780754
Task_23362,694,996,191,140,331,0.6960882647943831,21.79672846407718
Task_23363,807,869,69,41,110,0.9275862068965517,21.27584583664883
Task_23364,2443,126,107,163,270,19.236220472440944,46.00033366531806
Task_23365,1402,404,143,188,331,3.4617283950617286,31.166925160686635
Task_23366,2451,779,18,168,186,3.1423076923076922,48.23707098305575
Task_23367,2127,877,66,111,177,2.4225512528473803,43.38313792219062
Task_23368,2772,239,49,25,74,11.55,49.549183374731264
Task_23369,2931,812,145,191,336,3.6051660516605164,56.70055551610286
Task_23370,1779,542,175,164,339,3.276243093922652,37.57539548539774
Task_23371,2788,278,76,44,120,9.992831541218639,50.62431463341921
Task_23372,1642,776,108,26,134,2.113256113256113,34.34958685425131
Task_23373,2281,509,186,180,366,4.472549019607843,45.56332774473545
Task_23374,751,914,113,119,232,0.8207650273224044,21.872835092851584
Task_23375,1921,377,82,112,194,5.082010582010582,38.604319521224205
Task_23376,2821,611,197,147,344,4.609477124183006,54.29323300752344
Task_23377,1589,723,160,177,337,2.1947513812154695,35.14519235584397
Task_23378,2531,591,88,194,282,4.275337837837838,49.3850324360642
Task_23379,1922,330,81,143,224,5.806646525679758,38.656145811747
Task_23380,1549,538,47,21,68,2.8738404452690167,31.154876946399085
Task_23381,2183,263,170,18,188,8.268939393939394,41.56067082009586
Task_23382,1026,684,197,86,283,1.4978102189781022,25.623730645378146
Task_23383,1229,312,11,181,192,3.926517571884984,27.455973455439093
Task_23384,2225,153,64,102,166,14.448051948051948,42.14500138679173
Task_23385,922,185,53,75,128,4.956989247311828,21.796688745204236
Task_23386,673,716,139,153,292,0.9386331938633193,20.352832539836403
Task_23387,2455,817,186,51,237,3.0012224938875307,48.20938264667726
Task_23388,1432,769,99,15,114,1.8597402597402597,30.680265088913682
Task_23389,2898,187,45,29,74,15.414893617021276,51.52837458154028
Task_23390,854,474,179,178,357,1.7978947368421052,22.818127355702448
Task_23391,1932,315,72,164,236,6.113924050632911,38.85531352984204
Task_23392,1426,468,68,174,242,3.0405117270788913,31.40260519887123
Task_23393,2147,688,63,174,237,3.11611030478955,43.48649174496384
Task_23394,680,106,174,97,271,6.355140186915888,17.983168049762778
Task_23395,2970,163,185,133,318,18.109756097560975,54.742292766043825
Task_23396,2941,527,199,127,326,5.570075757575758,55.81285990293721
Task_23397,815,809,133,156,289,1.0061728395061729,22.825000462551234
Task_23398,1080,371,136,173,309,2.903225806451613,25.84527260898166
Task_23399,1306,989,185,190,375,1.3191919191919192,31.63133920069345
Task_23400,2372,733,13,101,114,3.231607629427793,46.19496592891616
Task_23401,889,420,55,192,247,2.111638954869359,22.796651598455355
Task_23402,2436,93,116,166,282,25.914893617021278,45.61131388207857
Task_23403,2627,423,34,31,65,6.195754716981132,47.91093132206632
Task_23404,2247,100,27,48,75,22.247524752475247,40.502792852534476
Task_23405,1446,64,185,54,239,22.246153846153845,29.169866527411457
Task_23406,2252,707,172,145,317,3.1807909604519775,45.46042861319682
Task_23407,579,128,136,139,275,4.488372093023256,16.67417731969613
Task_23408,2512,549,35,171,206,4.567272727272727,48.62903502743325
Task_23409,561,360,144,17,161,1.554016620498615,15.982248924237346
Task_23410,1053,781,101,63,164,1.3465473145780051,25.60543472071421
Task_23411,2664,327,159,82,241,8.121951219512194,50.24338280999748
Task_23412,1525,383,198,189,387,3.9713541666666665,33.29929985106966
Task_23413,2292,767,181,141,322,2.984375,46.29922973301135
Task_23414,1002,676,188,35,223,1.480059084194978,24.47026715855692
Task_23415,2484,201,156,177,333,12.297029702970297,47.5599131234178
Task_23416,1862,741,146,166,312,2.509433962264151,39.39733090699119
Task_23417,2882,432,74,88,162,6.655889145496536,53.70980701415302
Task_23418,2939,738,20,183,203,3.976995940460081,55.967973520020614
Task_23419,639,489,57,121,178,1.3040816326530613,18.542958337569875
Task_23420,2228,363,116,144,260,6.1208791208791204,43.71711388570733
Task_23421,1619,607,43,96,139,2.6628289473684212,34.129010020118656
Task_23422,1357,230,174,41,215,5.874458874458875,28.630023083717134
Task_23423,2831,425,144,51,195,6.645539906103286,52.72154015532376
Task_23424,642,773,51,28,79,0.8294573643410853,17.894016386206257
Task_23425,505,737,11,26,37,0.6842818428184282,15.430642640287916
Task_23426,2991,395,27,57,84,7.553030303030303,54.178618414259034
Task_23427,2430,912,59,107,166,2.661555312157722,48.22177393646893
Task_23428,2688,527,33,68,101,5.090909090909091,50.156264470606665
Task_23429,605,565,86,102,188,1.068904593639576,18.131566427014985
Task_23430,1004,957,184,149,333,1.048016701461378,26.48411756448691
Task_23431,1066,201,163,103,266,5.2772277227722775,24.76657573549653
Task_23432,2458,783,165,33,198,3.135204081632653,47.75337021592572
Task_23433,1810,963,137,14,151,1.8775933609958506,37.62134483489156
Task_23434,528,560,164,91,255,0.9411764705882353,17.272254053293878
Task_23435,2003,314,131,181,312,6.358730158730158,40.282154731689246
Task_23436,2534,430,86,195,281,5.879350348027843,48.910657573457314
Task_23437,1354,752,137,12,149,1.798140770252324,29.773178159775266
Task_23438,2478,420,176,176,352,5.885985748218527,48.32336384654932
Task_23439,2353,701,99,67,166,3.3518518518518516,45.98980858982031
Task_23440,581,389,86,114,200,1.4897435897435898,17.34460960150599
Task_23441,2788,821,150,21,171,3.391727493917275,52.85424539123704
Task_23442,1401,94,108,64,172,14.74736842105263,28.14669480450529
Task_23443,1410,617,146,30,176,2.2815533980582523,30.52099226808876
Task_23444,1435,594,194,43,237,2.411764705882353,31.14338295067377
Task_23445,806,839,200,131,331,0.9595238095238096,22.98625378889692
Task_23446,1815,844,65,73,138,2.1479289940828403,37.80666871681104
Task_23447,1133,529,152,138,290,2.137735849056604,27.047029609973606
Task_23448,2264,468,152,102,254,4.8272921108742,44.54285101942605
Task_23449,1078,889,22,108,130,1.2112359550561798,26.304708048707113
Task_23450,1278,452,97,147,244,2.8211920529801326,28.91312422070382
Task_23451,1063,162,119,188,307,6.521472392638037,24.704177460551993
Task_23452,2137,802,187,137,324,2.6612702366127023,43.95637787742381
Task_23453,516,730,68,175,243,0.7058823529411765,17.897305612990277
Task_23454,2127,381,168,48,216,5.5680628272251305,41.35415497005156
Task_23455,1219,735,90,144,234,1.65625,28.789664920440725
Task_23456,1140,148,99,102,201,7.651006711409396,25.26862415248912
Task_23457,2121,970,91,41,132,2.184346035015448,42.60483256432415
Task_23458,2650,950,122,98,220,2.786540483701367,52.02878886529779
Task_23459,2748,921,149,91,240,2.980477223427332,53.508518331532606
Task_23460,2835,532,166,57,223,5.318949343339587,53.27145371519458
Task_23461,2313,861,146,115,261,2.683294663573086,46.613134641923956
Task_23462,2128,427,189,38,227,4.97196261682243,41.54398115290524
Task_23463,2370,163,27,13,40,14.451219512195122,42.61429743762637
Task_23464,2695,144,114,161,275,18.586206896551722,50.152258600191054
Task_23465,2445,240,65,35,100,10.145228215767634,44.90397227764175
Task_23466,2999,576,76,33,109,5.197573656845754,54.92054766359855
Task_23467,2897,463,122,85,207,6.243534482758621,54.232535758507986
Task_23468,1356,382,10,183,193,3.5404699738903394,29.699342891054695
Task_23469,2340,973,37,22,59,2.402464065708419,45.06136521565437
Task_23470,2096,644,167,178,345,3.2496124031007754,42.96557278259598
Task_23471,876,378,35,13,48,2.311345646437995,19.87081792166199
Task_23472,2779,611,165,98,263,4.540849673202614,53.19869760268225
Task_23473,2589,838,22,25,47,3.0858164481525625,48.526876317266534
Task_23474,1684,936,135,162,297,1.7972251867662754,37.1112107739852
Task_23475,1115,910,61,25,86,1.2239297475301867,25.893404057680613
Task_23476,1161,455,88,154,242,2.5460526315789473,27.02308366179784
Task_23477,964,702,76,176,252,1.3712660028449501,24.807088586668282
Task_23478,2288,268,70,162,232,8.50557620817844,44.31180014637986
Task_23479,1656,66,48,116,164,24.71641791044776,32.54393307515787
Task_23480,1718,1014,142,44,186,1.6926108374384237,36.675351394251
Task_23481,2139,166,136,194,330,12.808383233532934,41.78161054671886
Task_23482,2998,321,18,152,170,9.31055900621118,55.297949304041744
Task_23483,1460,629,116,169,285,2.3174603174603177,32.561777333247086
Task_23484,1654,645,40,150,190,2.5603715170278636,35.235305739007885
Task_23485,1092,309,10,182,192,3.52258064516129,25.281373057361193
Task_23486,1276,831,155,93,248,1.5336538461538463,29.93929198356832
Task_23487,1848,770,126,53,179,2.396887159533074,38.236244228820986
Task_23488,1459,821,53,111,164,1.7749391727493917,32.52579814950283
Task_23489,1907,936,65,31,96,2.0352187833511204,38.61125002795409
Task_23490,2925,1018,12,181,193,2.8704612365063786,56.555376607792645
Task_23491,1479,879,27,142,169,1.6806818181818182,33.011704762849185
Task_23492,2822,917,19,39,58,3.074074074074074,52.595086311177965
Task_23493,2322,383,160,166,326,6.046875,45.60060448116078
Task_23494,1750,286,51,102,153,6.097560975609756,35.2292748921135
Task_23495,906,824,183,51,234,1.0981818181818181,23.67453235884385
Task_23496,815,655,73,107,180,1.2423780487804879,21.82499243405898
Task_23497,731,379,55,62,117,1.9236842105263159,18.768356767597872
Task_23498,2090,224,56,86,142,9.28888888888889,40.33519077987066
Task_23499,1490,422,69,91,160,3.5224586288416075,31.592185772001443
Task_23500,1672,885,136,76,212,1.8871331828442437,36.081783984592214
Task_23501,1017,458,178,113,291,2.215686274509804,24.955224558518278
Task_23502,1232,660,48,132,180,1.8638426626323752,28.554120995964
Task_23503,2207,893,97,54,151,2.4686800894854586,44.04332301919698
Task_23504,1246,274,134,127,261,4.530909090909091,27.870778079676413
Task_23505,1909,391,56,120,176,4.869897959183674,38.392724827757256
Task_23506,2395,875,140,143,283,2.7340182648401825,48.096340043159934
Task_23507,1632,765,186,51,237,2.1305483028720626,35.008106884766164
Task_23508,514,335,65,12,77,1.5297619047619047,14.138257191684131
Task_23509,1229,938,92,27,119,1.308839190628328,28.120971800533937
Task_23510,2768,274,121,151,272,10.065454545454546,52.01153783892418
Task_23511,1151,477,31,44,75,2.407949790794979,24.754157756207288
Task_23512,724,636,22,135,157,1.1365777080062793,20.022182340730243
Task_23513,1753,1016,39,165,204,1.7236971484759096,38.034625282835385
Task_23514,2351,729,45,22,67,3.2205479452054795,44.458337736594615
Task_23515,1655,232,158,65,223,7.103004291845494,33.66510361646714
Task_23516,2023,64,102,164,266,31.123076923076923,38.93419663948208
Task_23517,1514,992,71,166,237,1.5246727089627392,34.347316164584136
Task_23518,523,727,28,25,53,0.7184065934065934,15.922935791022093
Task_23519,2279,846,22,22,44,2.690672963400236,43.58753041334347
Task_23520,663,870,75,80,155,0.7611940298507462,19.833330114103013
Task_23521,2789,77,128,117,245,35.756410256410255,50.786620536988785
Task_23522,1102,1009,176,18,194,1.0910891089108912,26.86073712406974
Task_23523,964,150,157,101,258,6.3841059602649,22.756240961794575
Task_23524,1148,626,55,92,147,1.8309409888357258,26.780581442515842
Task_23525,2622,288,119,30,149,9.07266435986159,48.432915305206734
Task_23526,2847,999,108,24,132,2.847,54.113739911219994
Task_23527,2877,392,175,190,365,7.320610687022901,54.62302476700879
Task_23528,905,137,132,61,193,6.557971014492754,21.012262205849744
Task_23529,1566,909,30,35,65,1.720879120879121,32.63970043982015
Task_23530,1133,282,175,96,271,4.003533568904594,26.13912768846251
Task_23531,1444,181,95,71,166,7.934065934065934,29.78762318730281
Task_23532,1328,470,188,199,387,2.819532908704883,30.474690319345175
Task_23533,1064,493,196,185,381,2.1538461538461537,26.320569365886087
Task_23534,2768,395,164,77,241,6.98989898989899,52.01770736812926
Task_23535,603,934,76,181,257,0.6449197860962567,19.991167124978055
Task_23536,2794,636,56,133,189,4.3861852433281,53.29273183745189
Task_23537,1101,724,100,185,285,1.5186206896551724,27.152519391752136
Task_23538,2180,580,46,191,237,3.7521514629948367,43.6593475065269
Task_23539,2989,343,34,129,163,8.688953488372093,55.181089829942685
Task_23540,2510,388,160,141,301,6.4524421593830334,48.44247323510924
Task_23541,1070,254,25,11,36,4.196078431372549,22.40246124270629
Task_23542,931,1006,36,51,87,0.9245283018867925,23.564971388999925
Task_23543,2611,783,103,128,231,3.330357142857143,50.97401394757029
Task_23544,2778,664,168,134,302,4.177443609022556,53.572580466432136
Task_23545,2972,162,193,152,345,18.233128834355828,54.92031109402216
Task_23546,1319,635,19,10,29,2.0738993710691824,27.54700974461255
Task_23547,1834,802,160,121,281,2.2839352428393522,38.938640599482156
Task_23548,1010,243,148,106,254,4.139344262295082,23.975657060479183
Task_23549,2411,994,56,88,144,2.423115577889447,47.92115950129491
Task_23550,977,95,156,165,321,10.177083333333334,22.858254809688372
Task_23551,1159,534,116,197,313,2.166355140186916,27.664538804451272
Task_23552,1629,831,130,167,297,1.9579326923076923,35.920637011458716
Task_23553,1497,679,82,133,215,2.2014705882352943,32.97807006265209
Task_23554,1761,608,182,137,319,2.8916256157635467,37.36917922958353
Task_23555,1613,93,113,78,191,17.159574468085108,31.866055268770513
Task_23556,1170,725,173,27,200,1.6115702479338843,27.16400515742309
Task_23557,1599,267,67,158,225,5.9664179104477615,33.38388477317461
Task_23558,2359,581,98,148,246,4.053264604810996,46.44514032942616
Task_23559,762,1001,38,38,76,0.7604790419161677,20.37683264256546
Task_23560,1687,278,105,24,129,6.046594982078853,33.448529838881406
Task_23561,2590,161,105,137,242,15.987654320987655,48.40572491714203
Task_23562,2831,116,91,47,138,24.196581196581196,50.455989516136526
Task_23563,2176,935,131,172,303,2.324786324786325,44.94601448119236
Task_23564,1333,431,89,109,198,3.0856481481481484,29.425079829640925
Task_23565,1493,458,57,122,179,3.252723311546841,32.03863348216195
Task_23566,610,625,76,186,262,0.9744408945686901,18.99302049490583
Task_23567,1810,795,198,35,233,2.2738693467336684,37.686174723829545
Task_23568,2183,439,33,45,78,4.961363636363636,41.084671368210174
Task_23569,2213,348,35,188,223,6.340974212034384,43.34151824859583
Task_23570,1126,178,89,34,123,6.290502793296089,23.973884268202298
Task_23571,1165,633,72,198,270,1.837539432176656,27.93696561318575
Task_23572,1654,377,145,124,269,4.375661375661376,34.69366196722544
Task_23573,1738,247,11,148,159,7.008064516129032,34.888613929324094
Task_23574,2549,500,63,45,108,5.087824351297405,47.408480435737125
Task_23575,708,256,164,164,328,2.754863813229572,19.665423542999406
Task_23576,2642,577,156,51,207,4.570934256055363,50.27769062418641
Task_23577,1972,791,71,160,231,2.48989898989899,40.98239048506024
Task_23578,2893,869,84,138,222,3.325287356321839,55.695856060768016
Task_23579,844,573,33,164,197,1.470383275261324,22.18427255710225
Task_23580,1193,957,197,13,210,1.245302713987474,28.194712055059124
Task_23581,2630,878,90,71,161,2.9920364050056882,50.79611217598162
Task_23582,1414,199,159,119,278,7.07,30.339519187927895
Task_23583,1522,644,185,198,383,2.3596899224806203,34.07493942224694
Task_23584,1831,797,121,58,179,2.2944862155388472,37.990448067987835
Task_23585,1832,354,23,80,103,5.16056338028169,36.223248755736975
Task_23586,2568,900,46,62,108,2.8501664816870145,49.37330777104429
Task_23587,2675,185,74,187,261,14.381720430107526,50.2125397635862
Task_23588,1862,767,157,154,311,2.4244791666666665,39.45653190309812
Task_23589,2323,797,76,93,169,2.911027568922306,46.12775235276944
Task_23590,1960,461,96,104,200,4.242424242424242,39.47549258711143
Task_23591,1623,235,66,157,223,6.877118644067797,33.64428656634639
Task_23592,2289,744,33,67,100,3.07248322147651,44.51764299959248
Task_23593,2469,620,71,96,167,3.975845410628019,47.93065942600339
Task_23594,2536,395,64,19,83,6.404040404040404,46.62071848355553
Task_23595,2149,868,162,77,239,2.472957422324511,43.71543444656648
Task_23596,1655,436,158,178,336,3.7871853546910756,35.281372594708195
Task_23597,2443,191,189,70,259,12.723958333333334,46.15951641861025
Task_23598,2979,126,136,159,295,23.456692913385826,54.5431432098591
Task_23599,1332,470,151,132,283,2.828025477707006,29.971057562032623
Task_23600,2919,272,107,193,300,10.692307692307692,54.57856166713507
Task_23601,2255,396,160,127,287,5.680100755667507,44.35060842818793
Task_23602,1543,840,33,155,188,1.834720570749108,34.069991151313495
Task_23603,1385,209,14,151,165,6.595238095238095,29.403330263929103
Task_23604,2224,306,146,160,306,7.244299674267101,43.691454772029864
Task_23605,2057,878,178,155,333,2.340159271899886,42.99309455740663
Task_23606,2275,648,168,80,248,3.505392912172573,45.13301792707523
Task_23607,2575,402,27,55,82,6.389578163771712,47.59304425231387
Task_23608,2139,494,172,69,241,4.321212121212121,42.25665370455057
Task_23609,1351,293,85,177,262,4.595238095238095,29.677613704157064
Task_23610,1855,906,83,167,250,2.0452039691289965,39.55873270694871
Task_23611,1966,221,17,84,101,8.855855855855856,37.838008626639976
Task_23612,743,932,182,152,334,0.7963558413719185,22.340302798407322
Task_23613,2543,732,85,86,171,3.469304229195089,49.291245446183176
Task_23614,1567,703,80,16,96,2.225852272727273,32.46391777845137
Task_23615,1547,567,143,84,227,2.7235915492957745,33.28415594580116
Task_23616,1616,834,37,170,207,1.9353293413173653,35.34663971454794
Task_23617,2961,327,176,152,328,9.027439024390244,55.50625559572662
Task_23618,2547,347,114,17,131,7.318965517241379,47.23940788972225
Task_23619,535,423,166,53,219,1.2617924528301887,16.5446964892395
Task_23620,1117,693,169,184,353,1.6095100864553313,27.643863345045833
Task_23621,815,913,198,102,300,0.8916849015317286,23.168219510275435
Task_23622,1351,980,124,17,141,1.3771661569826708,30.298959199792566
Task_23623,2861,218,15,46,61,13.06392694063927,50.956909331347845
Task_23624,543,663,183,103,286,0.8177710843373494,18.021419027586706
Task_23625,1677,177,71,142,213,9.42134831460674,33.94752058655206
Task_23626,1529,832,184,23,207,1.8355342136854742,33.17215839758958
Task_23627,2150,990,55,151,206,2.169525731584258,44.30680155003083
Task_23628,1984,483,56,61,117,4.099173553719008,38.877955623245306
Task_23629,954,957,173,186,359,0.9958246346555324,25.876046689131766
Task_23630,682,895,14,180,194,0.7611607142857143,20.609973100295733
Task_23631,2720,835,29,115,144,3.2535885167464116,52.26163374908534
Task_23632,513,952,93,15,108,0.5383001049317944,16.891767489827018
Task_23633,1490,683,76,96,172,2.1783625730994154,32.666618769768654
Task_23634,1245,760,30,180,210,1.636005256241787,29.232766684838555
Task_23635,1384,847,194,83,277,1.6320754716981132,31.79405331282305
Task_23636,1541,770,77,84,161,1.9987029831387808,33.48329476588544
Task_23637,1697,645,135,37,172,2.626934984520124,35.146472348444235
Task_23638,1921,142,168,156,324,13.433566433566433,38.1511309446201
Task_23639,1088,868,135,48,183,1.2520138089758344,26.276785075758355
Task_23640,924,416,123,121,244,2.2158273381294964,23.15071136362181
Task_23641,903,308,91,48,139,2.9223300970873787,21.287464180243486
Task_23642,562,784,179,35,214,0.7159235668789808,18.01450559413507
Task_23643,1183,106,167,95,262,11.05607476635514,25.844272320237362
Task_23644,1694,768,119,14,133,2.2028608582574774,35.086419596466655
Task_23645,2306,880,200,153,353,2.6174801362088536,47.031918969483606
Task_23646,2895,73,53,183,236,39.12162162162162,52.520207956542656
Task_23647,2855,746,32,97,129,3.821954484605087,54.167083692053865
Task_23648,2484,267,93,122,215,9.26865671641791,47.236580456995306
Task_23649,2690,697,98,93,191,3.853868194842407,51.71036383283732
Task_23650,2862,222,52,199,251,12.834080717488789,53.34688554787058
Task_23651,1983,704,162,141,303,2.8127659574468087,41.120948427439956
Task_23652,1518,123,58,143,201,12.241935483870968,31.109291740621554
Task_23653,1836,512,102,55,157,3.5789473684210527,36.98177391202786
Task_23654,1531,414,45,43,88,3.689156626506024,30.960641889043092
Task_23655,515,308,121,145,266,1.6666666666666667,16.460247802250873
Task_23656,1253,850,148,115,263,1.472385428907168,29.739008283158125
Task_23657,768,738,191,18,209,1.0392422192151556,20.787361522435045
Task_23658,2809,380,136,25,161,7.3727034120734904,51.704392824419244
Task_23659,1068,878,84,129,213,1.2150170648464165,26.675445662275916
Task_23660,2524,942,44,22,66,2.676564156945917,47.880315853656754
Task_23661,1753,285,80,130,210,6.129370629370629,35.74970602505373
Task_23662,2906,870,72,160,232,3.3363949483352466,56.03235841746031
Task_23663,859,194,13,61,74,4.4051282051282055,19.596927525883412
Task_23664,778,204,31,168,199,3.795121951219512,20.021437143812026
Task_23665,1711,620,109,31,140,2.755233494363929,35.01076689941844
Task_23666,1819,907,47,45,92,2.003303964757709,37.08887700719131
Task_23667,2201,221,126,199,325,9.914414414414415,43.165963693947326
Task_23668,766,704,29,101,130,1.0865248226950355,20.787304428225774
Task_23669,1955,650,70,101,171,3.003072196620584,39.86783785469866
Task_23670,1247,216,94,20,114,5.746543778801843,26.050869662506187
Task_23671,640,141,177,139,316,4.507042253521127,17.900846169114903
Task_23672,2273,312,31,150,181,7.261980830670926,43.87217065886392
Task_23673,895,917,113,179,292,0.9749455337690632,24.51858448557141
Task_23674,2222,387,71,143,214,5.72680412371134,43.55310440191917
Task_23675,2986,171,72,146,218,17.36046511627907,54.66095668552151
Task_23676,740,682,78,194,272,1.083455344070278,21.259727929485646
Task_23677,2658,77,95,143,238,34.07692307692308,48.749399236475874
Task_23678,1875,214,57,167,224,8.720930232558139,37.556288615750454
Task_23679,1277,231,147,92,239,5.504310344827586,28.012696408974843
Task_23680,2879,553,157,76,233,5.196750902527076,54.24964618378723
Task_23681,749,610,122,187,309,1.225859247135843,21.312213308145733
Task_23682,2608,373,141,156,297,6.973262032085562,49.94665355052649
Task_23683,2501,140,41,73,114,17.73758865248227,45.58823244825229
Task_23684,1117,906,22,55,77,1.2315325248070563,25.869390818047624
Task_23685,2171,956,107,47,154,2.2685475444096133,43.42425285337716
Task_23686,588,778,185,191,376,0.754813863928113,19.63280204998865
Task_23687,2538,957,141,75,216,2.6492693110647183,50.040082403850896
Task_23688,1982,695,141,151,292,2.8477011494252875,41.041937966697155
Task_23689,1170,602,12,59,71,1.9402985074626866,25.663142043090076
Task_23690,1866,905,196,185,381,2.0596026490066226,40.31107514627562
Task_23691,1682,73,75,14,89,22.72972972972973,31.06488243633005
Task_23692,2275,615,10,59,69,3.6931818181818183,43.18649057756275
Task_23693,529,1000,128,133,261,0.5284715284715285,18.911184763610578
Task_23694,2987,1020,109,72,181,2.9255631733594516,57.110340913658995
Task_23695,2736,853,66,50,116,3.2037470725995316,51.844341591337745
Task_23696,604,1022,45,40,85,0.5904203323558163,18.589008978260253
Task_23697,2033,249,69,16,85,8.132,38.28574823157991
Task_23698,1927,686,28,97,125,2.8049490538573507,39.16089336381347
Task_23699,1457,777,81,190,271,1.8727506426735219,32.99734225524295
Task_23700,669,890,193,119,312,0.7508417508417509,20.853643938077884
Task_23701,1545,606,108,183,291,2.545304777594728,33.883355678722715
Task_23702,1237,686,121,55,176,1.8005822416302766,28.227893629979743
Task_23703,2937,691,18,124,142,4.244219653179191,55.22808704157669
Task_23704,1357,270,133,46,179,5.007380073800738,28.604986816172836
Task_23705,2855,175,119,100,219,16.22159090909091,52.4530464351746
Task_23706,1677,606,63,144,207,2.7627677100494235,35.60517748956696
Task_23707,1133,545,104,155,259,2.0750915750915753,26.982424058838586
Task_23708,2506,113,183,13,196,21.982456140350877,45.70267149106692
Task_23709,692,854,177,67,244,0.8093567251461988,20.52161087456526
Task_23710,778,528,21,142,163,1.4706994328922496,20.73031709634704
Task_23711,2655,372,98,137,235,7.117962466487936,50.38380040847911
Task_23712,1460,137,81,185,266,10.579710144927537,30.65663891328575
Task_23713,2075,242,179,196,375,8.539094650205762,41.47444792912475
Task_23714,2075,226,32,31,63,9.140969162995594,38.50787555138876
Task_23715,2041,272,145,60,205,7.476190476190476,39.75483021427274
Task_23716,1721,536,168,124,292,3.2048417132216014,36.367558200290105
Task_23717,1402,488,51,41,92,2.867075664621677,29.169475823854054
Task_23718,1972,552,113,56,169,3.566003616636528,39.39893115191323
Task_23719,2070,514,151,82,233,4.019417475728155,41.424538168274935
Task_23720,1332,709,158,165,323,1.876056338028169,30.949731803498576
Task_23721,959,240,172,76,248,3.979253112033195,22.917287666317105
Task_23722,2468,706,90,29,119,3.490806223479491,47.019477255146974
Task_23723,1431,601,63,100,163,2.377076411960133,31.371485183215956
Task_23724,2307,622,114,45,159,3.7030497592295344,44.54040996445328
Task_23725,2225,341,102,65,167,6.505847953216374,42.784630490653306
Task_23726,1699,257,14,90,104,6.5852713178294575,33.808726443656546
Task_23727,727,700,187,57,244,1.037089871611983,20.509684439220162
Task_23728,1241,287,53,75,128,4.309027777777778,27.18890505630098
Task_23729,2156,622,119,176,295,3.460674157303371,43.61807138000427
Task_23730,573,1020,19,62,81,0.5612144955925563,17.940107213536134
Task_23731,1632,725,29,118,147,2.2479338842975207,34.71238396310384
Task_23732,2419,96,32,152,184,24.938144329896907,44.801281169879616
Task_23733,2372,186,72,89,161,12.684491978609625,44.85524466392801
Task_23734,2379,309,11,97,108,7.674193548387096,44.80787153637419
Task_23735,2758,170,30,172,202,16.128654970760234,50.91411653011182
Task_23736,1027,744,138,98,236,1.378523489932886,25.69037645874485
Task_23737,2854,207,172,163,335,13.721153846153847,53.413660822101555
Task_23738,1186,497,34,37,71,2.3815261044176705,25.396825152162677
Task_23739,1945,751,179,163,342,2.586436170212766,40.87429728142228
Task_23740,2829,440,113,155,268,6.414965986394558,53.534999562652125
Task_23741,636,143,68,137,205,4.416666666666667,17.418709306565088
Task_23742,948,672,48,100,148,1.4086181277860328,23.69468406205628
Task_23743,1104,774,15,200,215,1.424516129032258,27.03865883896819
Task_23744,2888,1003,39,33,72,2.8764940239043826,53.92461924107405
Task_23745,2582,389,179,106,285,6.62051282051282,49.46160256109005
Task_23746,1052,741,156,87,243,1.417789757412399,26.02773283084845
Task_23747,809,598,19,137,156,1.350584307178631,21.266424210141448
Task_23748,2180,308,178,172,350,7.055016181229774,43.21852555890384
Task_23749,2700,227,182,163,345,11.842105263157896,51.106958016503654
Task_23750,2782,433,103,45,148,6.410138248847926,51.417687936297426
Task_23751,737,954,57,88,145,0.7717277486910995,21.275668424405357
Task_23752,2226,1021,170,181,351,2.1780821917808217,46.235482449991004
Task_23753,643,965,159,96,255,0.6656314699792961,20.54227553387151
Task_23754,2434,432,66,47,113,5.621247113163972,45.63139289416721
Task_23755,711,473,135,79,214,1.5,19.62149994513489
Task_23756,1549,430,160,146,306,3.593967517401392,33.4023875071863
Task_23757,1802,338,50,114,164,5.315634218289086,36.46950122462085
Task_23758,533,594,164,54,218,0.8957983193277311,17.074473673447017
Task_23759,882,688,40,165,205,1.2801161103047896,23.15682832795505
Task_23760,1580,176,173,27,200,8.926553672316384,31.685639414338564
Task_23761,662,983,136,67,203,0.6727642276422764,20.41746694515399
Task_23762,2887,490,14,40,54,5.879837067209776,52.29128112125732
Task_23763,855,774,13,25,38,1.103225806451613,20.855184395830886
Task_23764,855,884,180,134,314,0.9661016949152542,23.815913566932267
Task_23765,2809,796,96,71,167,3.5244667503136764,53.53749236693353
Task_23766,2949,714,145,10,155,4.124475524475525,54.909684362117986
Task_23767,1257,873,95,42,137,1.4382151029748285,28.607143839650565
Task_23768,2599,835,10,162,172,3.1088516746411483,50.66288536744474
Task_23769,2280,175,162,39,201,12.954545454545455,42.72522768347728
Task_23770,1208,146,162,54,216,8.217687074829932,26.005791326001795
Task_23771,2584,522,183,61,244,4.940726577437858,49.349344133429504
Task_23772,2049,795,123,184,307,2.5741206030150754,42.53257510968907
Task_23773,2141,440,174,134,308,4.854875283446712,42.79547395824011
Task_23774,1095,117,186,99,285,9.279661016949152,24.69469771997964
Task_23775,2300,111,76,18,94,20.535714285714285,41.57122451658211
Task_23776,1100,605,116,131,247,1.8151815181518152,26.558304383360365
Task_23777,2460,232,158,45,203,10.55793991416309,45.99617921158873
Task_23778,2084,184,71,68,139,11.264864864864865,39.876853595671456
Task_23779,2548,773,21,23,44,3.291989664082687,47.64041649202631
Task_23780,1646,495,101,17,118,3.318548387096774,33.21455830606555
Task_23781,1094,332,196,73,269,3.285285285285285,25.384666461877178
Task_23782,2038,540,172,78,250,3.767097966728281,41.01983052041642
Task_23783,1916,94,76,116,192,20.16842105263158,37.0315050597891
Task_23784,2687,767,68,160,228,3.4986979166666665,52.23428021489537
Task_23785,1438,149,64,164,228,9.586666666666666,30.217546150590703
Task_23786,1928,125,174,145,319,15.301587301587302,38.07220857118139
Task_23787,1140,211,44,177,221,5.377358490566038,25.891915327227625
Task_23788,2565,87,126,46,172,29.147727272727273,46.152748913125436
Task_23789,2541,713,195,138,333,3.5588235294117645,50.119122230348715
Task_23790,2477,253,167,13,180,9.751968503937007,46.14212213187998
Task_23791,1206,472,60,109,169,2.5496828752642706,27.456562843851202
Task_23792,1430,458,29,183,212,3.1154684095860565,31.241399655384118
Task_23793,787,66,40,35,75,11.746268656716419,16.83645256382938
Task_23794,909,604,14,134,148,1.5024793388429751,22.845626028626793
Task_23795,1173,729,80,57,137,1.606849315068493,27.096719883441036
Task_23796,2775,996,179,65,244,2.7833500501504513,53.943699189203734
Task_23797,991,193,133,63,196,5.108247422680412,22.95963077027625
Task_23798,2293,574,86,75,161,3.9878260869565216,44.56487500397534
Task_23799,1735,142,46,109,155,12.132867132867133,33.9626814534718
Task_23800,1625,86,98,42,140,18.67816091954023,31.080561879440168
Task_23801,1125,878,45,185,230,1.2798634812286689,27.761608542089395
Task_23802,1179,549,59,182,241,2.1436363636363636,27.75171111558784
Task_23803,1823,235,110,60,170,7.72457627118644,35.983770199309724
Task_23804,776,772,163,38,201,1.0038809831824063,21.06424106897511
Task_23805,1053,634,124,91,215,1.6582677165354331,25.63318462032869
Task_23806,555,380,116,61,177,1.4566929133858268,16.44570793733831
Task_23807,1766,943,96,40,136,1.8707627118644068,36.863381318256494
Task_23808,2605,970,95,109,204,2.682801235839341,51.32489517110125
Task_23809,1943,232,32,32,64,8.339055793991417,36.4266114793024
Task_23810,1273,888,19,73,92,1.4319460067491563,28.763228093491676
Task_23811,2812,729,47,157,204,3.852054794520548,53.949111971479
Task_23812,2883,441,107,78,185,6.52262443438914,53.753005425221374
Task_23813,1766,392,145,28,173,4.493638676844784,35.41358696834423
Task_23814,1480,561,102,109,211,2.6334519572953736,32.24345131236205
Task_23815,1518,569,142,194,336,2.663157894736842,33.55835712856052
Task_23816,1623,909,29,12,41,1.7835164835164836,33.2938944642162
Task_23817,1056,890,67,34,101,1.1851851851851851,25.138361578020067
Task_23818,1729,489,83,75,158,3.5285714285714285,35.41863169192501
Task_23819,1348,400,14,114,128,3.361596009975062,29.237103873335922
Task_23820,2339,360,91,177,268,6.479224376731302,45.5467895820563
Task_23821,1809,73,78,171,249,24.445945945945947,35.61195675607064
Task_23822,2799,636,90,156,246,4.39403453689168,53.59037382442916
Task_23823,2433,552,61,120,181,4.399638336347197,47.21543326695568
Task_23824,2311,506,183,102,285,4.558185404339251,45.54922382164935
Task_23825,1208,425,154,77,231,2.835680751173709,27.384381249543935
Task_23826,1869,980,20,81,101,1.9051987767584098,38.74041980402601
Task_23827,1844,838,175,132,307,2.197854588796186,39.34264784504305
Task_23828,2718,654,51,131,182,4.149618320610687,52.105637649938245
Task_23829,587,610,137,113,250,0.9607201309328969,18.402870425968153
Task_23830,1602,336,108,116,224,4.753709198813056,33.5222076516331
Task_23831,2919,949,17,199,216,3.0726315789473686,56.36900776913098
Task_23832,1187,342,48,192,240,3.4606413994169096,27.22133838045556
Task_23833,1268,176,148,91,239,7.163841807909605,27.406491622113734
Task_23834,2792,928,177,76,253,3.005382131324004,54.147515998219376
Task_23835,846,127,165,183,348,6.609375,21.25410726759957
Task_23836,682,841,69,68,137,0.8099762470308789,19.828303029212424
Task_23837,2708,988,67,20,87,2.738119312436805,51.33614467235851
Task_23838,2597,730,153,172,325,3.5526675786593707,51.07360078613251
Task_23839,644,916,125,154,279,0.7022900763358778,20.547263216885288
Task_23840,2248,416,126,172,298,5.390887290167866,44.421174395732066
Task_23841,2091,596,197,131,328,3.5025125628140703,42.58913895153088
Task_23842,1549,646,41,73,114,2.394126738794436,32.80911083143876
Task_23843,2252,844,181,157,338,2.66508875739645,46.002121678883405
Task_23844,526,792,84,78,162,0.6633039092055486,17.584193051139632
Task_23845,817,660,199,18,217,1.2360060514372164,21.354087597390244
Task_23846,1327,594,20,159,179,2.230252100840336,29.816308979632936
Task_23847,1285,883,61,156,217,1.4536199095022624,30.27262013414222
Task_23848,2105,324,57,117,174,6.476923076923077,41.25391361976623
Task_23849,1987,654,116,119,235,3.033587786259542,40.688420801510425
Task_23850,1519,899,43,157,200,1.6877777777777778,33.94050247703257
Task_23851,2765,369,200,82,282,7.472972972972973,52.169698627567904
Task_23852,548,751,89,92,181,0.7287234042553191,17.920255186483043
Task_23853,1843,352,108,114,222,5.220963172804533,37.37504007289244
Task_23854,2326,759,113,77,190,3.0605263157894735,45.95284268013511
Task_23855,1309,902,195,21,216,1.449612403100775,29.92891251473934
Task_23856,720,782,56,14,70,0.9195402298850575,18.834928631688186
Task_23857,1820,336,10,116,126,5.400593471810089,36.3540085017774
Task_23858,1465,932,78,37,115,1.570203644158628,31.785061295952588
Task_23859,2614,93,64,134,198,27.80851063829787,48.0296972475959
Task_23860,1238,678,137,16,153,1.8232695139911634,27.65811173119044
Task_23861,1581,661,41,16,57,2.38821752265861,31.998163153790102
Task_23862,2202,824,146,24,170,2.669090909090909,43.596670641395974
Task_23863,2247,212,21,118,139,10.549295774647888,42.683197801363995
Task_23864,2668,496,52,106,158,5.368209255533199,50.482097224501736
Task_23865,2249,738,85,37,122,3.0433017591339646,43.6867915989977
Task_23866,782,102,19,28,47,7.592233009708738,17.341727643572113
Task_23867,1517,142,83,59,142,10.608391608391608,30.275989985006046
Task_23868,2780,999,63,182,245,2.78,54.5371620382842
Task_23869,2694,103,154,44,198,25.903846153846153,48.61048839685416
Task_23870,2682,207,67,84,151,12.89423076923077,49.63338136056799
Task_23871,1487,836,136,13,149,1.7765830346475509,32.13240431542395
Task_23872,1500,316,50,12,62,4.73186119873817,29.577657618943757
Task_23873,580,167,174,112,286,3.4523809523809526,16.886224696423437
Task_23874,948,381,111,21,132,2.481675392670157,22.08988452136009
Task_23875,2401,462,118,57,175,5.185745140388769,45.93721224930898
Task_23876,1872,535,138,112,250,3.4925373134328357,38.548344161383795
Task_23877,1061,95,47,83,130,11.052083333333334,22.79718207509262
Task_23878,1080,968,130,143,273,1.1145510835913313,27.424931870431276
Task_23879,2049,593,175,59,234,3.4494949494949494,41.06217252456246
Task_23880,2150,271,28,71,99,7.904411764705882,40.73112379957967
Task_23881,2269,525,199,68,267,4.313688212927756,44.53798700895177
Task_23882,660,83,188,12,200,7.857142857142857,16.324717854327055
Task_23883,2883,709,31,196,227,4.06056338028169,55.12873048897944
Task_23884,2860,918,157,94,251,3.1120783460282917,55.3761287003525
Task_23885,538,680,25,72,97,0.7900146842878121,16.558464456823984
Task_23886,732,337,185,92,277,2.165680473372781,19.917315239569135
Task_23887,1382,656,89,34,123,2.103500761035008,29.73403225842334
Task_23888,1421,788,36,147,183,1.8010139416983524,31.928713399806778
Task_23889,2019,958,42,50,92,2.105318039624609,40.57651383959132
Task_23890,2149,628,113,199,312,3.416534181240064,43.63651533817341
Task_23891,1992,86,146,105,251,22.896551724137932,38.37588264496568
Task_23892,696,228,105,190,295,3.039301310043668,19.27385995693954
Task_23893,1060,626,47,32,79,1.6905901116427433,23.911685894322392
Task_23894,1333,603,32,105,137,2.206953642384106,29.498592880524274
Task_23895,1647,343,175,151,326,4.787790697674419,34.768051090204104
Task_23896,1535,270,11,153,164,5.6642066420664205,31.939651511590636
Task_23897,2055,183,95,104,199,11.168478260869565,39.945064412980635
Task_23898,1210,904,190,105,295,1.3370165745856353,29.361653869673148
Task_23899,2160,746,33,178,211,2.891566265060241,43.702495578227875
Task_23900,701,1019,55,193,248,0.6872549019607843,21.753781682264712
Task_23901,2650,538,175,15,190,4.916512059369202,49.874888602859166
Task_23902,1756,490,148,145,293,3.576374745417515,36.81072660459561
Task_23903,1528,91,175,72,247,16.608695652173914,30.69654062405434
Task_23904,1740,328,127,157,284,5.288753799392097,36.00876855981767
Task_23905,2476,116,166,134,300,21.162393162393162,46.496728684913556
Task_23906,908,557,30,168,198,1.6272401433691757,23.191161854255157
Task_23907,1449,358,97,109,206,4.036211699164346,31.0904649156529
Task_23908,2657,999,20,11,31,2.657,49.887810729700355
Task_23909,2802,640,187,169,356,4.3712948517940715,54.17111254550207
Task_23910,2788,149,17,94,111,18.586666666666666,50.10348128868035
Task_23911,2031,374,121,76,197,5.416,40.08180630610054
Task_23912,2999,211,58,33,91,14.14622641509434,53.40360401087929
Task_23913,1280,677,18,59,77,1.887905604719764,27.689538562693997
Task_23914,1475,105,183,70,253,13.915094339622641,29.94329492561657
Task_23915,1054,189,87,144,231,5.5473684210526315,24.417993412494422
Task_23916,1695,452,69,67,136,3.7417218543046356,34.62492129025927
Task_23917,2223,869,127,22,149,2.5551724137931036,43.93248481409338
Task_23918,2307,618,148,59,207,3.726978998384491,45.10559394986592
Task_23919,1275,633,17,192,209,2.0110410094637223,29.293676660190112
Task_23920,730,816,130,25,155,0.8935128518971848,20.201842166916748
Task_23921,1487,744,32,137,169,1.9959731543624162,32.732003963035524
Task_23922,1405,541,175,62,237,2.592250922509225,30.721272529480913
Task_23923,541,806,40,57,97,0.6703841387856257,17.03181169839294
Task_23924,1030,1005,37,79,116,1.0238568588469186,25.694815697642117
Task_23925,1487,496,115,196,311,2.9919517102615694,32.7271829632409
Task_23926,2924,452,160,84,244,6.454746136865342,54.79139330984154
Task_23927,822,821,186,40,226,1.0,22.055765847881815
Task_23928,629,306,196,126,322,2.04885993485342,18.49440537941584
Task_23929,2903,428,154,70,224,6.766899766899767,54.065758526425704
Task_23930,2238,451,13,104,117,4.951327433628318,43.178711553545746
Task_23931,846,592,65,47,112,1.4266441821247893,20.893596239855388
Task_23932,1485,649,33,116,149,2.2846153846153845,32.16495669909937
Task_23933,1043,334,187,199,386,3.1134328358208956,25.526406875403847
Task_23934,2033,915,192,94,286,2.21943231441048,42.420191357668735
Task_23935,975,346,104,173,277,2.809798270893372,23.960040523208153
Task_23936,2539,146,88,178,266,17.272108843537413,47.650219877022124
Task_23937,1017,649,29,112,141,1.5646153846153845,24.641971168031045
Task_23938,2032,413,57,184,241,4.908212560386473,40.82032509057498
Task_23939,2526,136,62,161,223,18.437956204379564,47.19939434125282
Task_23940,2845,333,177,28,205,8.517964071856287,52.447598538526755
Task_23941,2106,724,182,199,381,2.9048275862068964,43.56870193393265
Task_23942,1827,918,32,111,143,1.9880304678998912,38.360512835152726
Task_23943,2608,808,37,159,196,3.223733003708282,50.916560604989506
Task_23944,2405,304,173,59,232,7.885245901639344,45.741666123555525
Task_23945,522,119,154,49,203,4.35,14.69396481765967
Task_23946,2536,163,121,24,145,15.463414634146341,46.26158640158767
Task_23947,1770,840,170,113,283,2.1046373365041617,38.04039955406123
Task_23948,2022,511,60,31,91,3.94921875,38.99588581375252
Task_23949,936,299,141,29,170,3.12,21.950750044029913
Task_23950,1750,316,69,71,140,5.520504731861199,35.108939900195224
Task_23951,2971,249,81,147,228,11.884,54.97529045329649
Task_23952,2286,438,157,28,185,5.207289293849659,43.85148694672111
Task_23953,963,145,190,62,252,6.595890410958904,22.286613776147515
Task_23954,2534,315,14,129,143,8.018987341772151,47.63461299323357
Task_23955,1659,699,46,191,237,2.37,35.782581080475545
Task_23956,543,405,183,112,295,1.3374384236453203,17.256798112947774
Task_23957,1487,571,41,184,225,2.5996503496503496,32.57156730403407
Task_23958,879,250,133,129,262,3.50199203187251,21.99896895242468
Task_23959,526,873,154,34,188,0.6018306636155606,17.692966008509867
Task_23960,932,971,88,171,259,0.9588477366255144,25.037819035376632
Task_23961,2014,499,177,114,291,4.028,40.869433131658184
Task_23962,2411,697,125,75,200,3.4541547277936964,47.141111997539134
Task_23963,1177,634,59,187,246,1.853543307086614,28.015829625445136
Task_23964,1346,613,151,134,285,2.192182410423453,30.654880353609517
Task_23965,1438,764,48,30,78,1.8797385620915033,30.288327145967454
Task_23966,2766,861,169,71,240,3.2088167053364267,53.38940589722707
Task_23967,1280,322,77,57,134,3.9628482972136223,27.506312353152357
Task_23968,2426,282,32,27,59,8.57243816254417,44.24686420149255
Task_23969,892,694,180,61,241,1.283453237410072,23.07416188410407
Task_23970,2385,140,35,64,99,16.914893617021278,43.51351891380616
Task_23971,1984,534,44,78,122,3.708411214953271,39.43717298132441
Task_23972,2401,646,122,92,214,3.7109737248840804,47.03431597888355
Task_23973,1604,823,181,135,316,1.9466019417475728,35.53836814882653
Task_23974,2703,371,131,81,212,7.266129032258065,50.8456810704402
Task_23975,1607,574,176,64,240,2.794782608695652,34.083293868184505
Task_23976,2909,699,137,101,238,4.155714285714286,55.42175900841323
Task_23977,1889,816,66,148,214,2.3121175030599757,39.66872806715177
Task_23978,1933,467,104,88,192,4.130341880341881,38.939117791003234
Task_23979,2932,814,40,35,75,3.5975460122699388,54.034008735714046
Task_23980,2133,714,27,82,109,2.983216783216783,42.27007187973876
Task_23981,1224,978,90,34,124,1.250255362614913,28.270116489939856
Task_23982,2446,289,48,198,246,8.434482758620689,46.987097585305484
Task_23983,2586,842,127,198,325,3.0676156583629894,51.289309124528266
Task_23984,2840,625,156,73,229,4.536741214057508,53.78218260700495
Task_23985,536,986,190,90,280,0.5430597771023303,18.946287393451758
Task_23986,2929,938,149,181,330,3.119275825346113,57.02228332553202
Task_23987,2347,688,43,154,197,3.4063860667634254,46.39441006919392
Task_23988,1683,525,96,82,178,3.199619771863118,35.07097274685753
Task_23989,1632,774,173,91,264,2.1058064516129034,35.475516634122336
Task_23990,2363,779,67,171,238,3.0294871794871794,47.201553956533594
Task_23991,852,345,80,184,264,2.46242774566474,22.022148708309345
Task_23992,2360,910,16,55,71,2.5905598243688255,45.52852623993706
Task_23993,2407,113,21,73,94,21.114035087719298,43.536921104713635
Task_23994,1444,626,165,122,287,2.303030303030303,32.239090773828465
Task_23995,557,93,43,39,82,5.925531914893617,13.937339664270405
Task_23996,1471,301,61,86,147,4.870860927152318,30.872645496806086
Task_23997,794,953,23,57,80,0.8322851153039832,21.131308787564233
Task_23998,1036,647,36,39,75,1.5987654320987654,23.511218118826147
Task_23999,927,504,158,197,355,1.8356435643564357,24.086616336166117
Task_24000,2190,347,155,44,199,6.293103448275862,42.1218154147272
Task_24001,1534,583,22,78,100,2.6267123287671232,32.14230857376018
Task_24002,762,437,147,13,160,1.7397260273972603,19.42229515013607
Task_24003,2677,926,157,87,244,2.887810140237325,52.40481982635901
Task_24004,2074,521,178,119,297,3.9731800766283527,41.92409401341376
Task_24005,1250,858,25,155,180,1.4551804423748544,29.368647463115703
Task_24006,2306,954,95,178,273,2.4146596858638745,46.94907568619834
Task_24007,1579,468,50,77,127,3.366737739872068,32.993617128690154
Task_24008,2617,931,104,56,160,2.8079399141630903,50.68126597066075
Task_24009,958,602,82,163,245,1.5887230514096187,24.335870251251137
Task_24010,574,946,38,127,165,0.6061246040126715,18.979971791139643
Task_24011,1642,586,150,81,231,2.7972742759795572,34.83249226212393
Task_24012,1921,723,128,16,144,2.653314917127072,38.6017084282653
Task_24013,1402,127,181,48,229,10.953125,28.712010210682635
Task_24014,2241,859,43,51,94,2.605813953488372,43.88986740194796
Task_24015,1168,288,182,78,260,4.041522491349481,26.484959366673092
Task_24016,529,154,98,131,229,3.412903225806452,15.825680547681861
Task_24017,2922,390,81,133,214,7.4731457800511505,54.617476171182375
Task_24018,2366,881,115,147,262,2.6825396825396823,47.56679794827031
Task_24019,1505,341,89,22,111,4.400584795321637,30.493329160069425
Task_24020,1824,939,98,198,296,1.9404255319148935,39.3914762935941
Task_24021,2708,611,136,67,203,4.42483660130719,51.47618831993251
Task_24022,1068,75,188,105,293,14.052631578947368,24.02131108336845
Task_24023,2005,987,113,118,231,2.029352226720648,41.99438711471927
Task_24024,2039,277,106,117,223,7.33453237410072,40.229113482018434
Task_24025,1166,764,128,91,219,1.5241830065359476,27.816329196723547
Task_24026,997,239,56,121,177,4.154166666666667,23.475652445935527
Task_24027,981,888,17,86,103,1.1034870641169854,24.369734083678832
Task_24028,1288,901,15,135,150,1.4279379157427938,29.744897244085546
Task_24029,2737,615,83,110,193,4.443181818181818,52.27653263061001
Task_24030,2536,500,165,74,239,5.06187624750499,48.66522005931865
Task_24031,1210,807,125,36,161,1.4975247524752475,27.779394619755887
Task_24032,647,472,55,146,201,1.3678646934460887,18.800108146943913
Task_24033,2882,570,85,22,107,5.047285464098073,52.98992090256835
Task_24034,2484,896,200,20,220,2.769230769230769,48.53885283728173
Task_24035,2245,728,14,123,137,3.0795610425240056,44.34469283725351
Task_24036,1681,602,174,23,197,2.7877280265339968,34.815887560956604
Task_24037,1617,899,136,120,256,1.7966666666666666,35.688265315423806
Task_24038,711,254,170,176,346,2.788235294117647,19.805053556107357
Task_24039,583,907,43,168,211,0.6420704845814978,19.297537302492188
Task_24040,995,920,108,37,145,1.0803474484256244,24.72921698629167
Task_24041,2770,454,57,23,80,6.087912087912088,50.47546161400283
Task_24042,2946,857,103,107,210,3.4335664335664338,56.388567488851
Task_24043,2484,83,12,126,138,29.571428571428573,45.11747913357624
Task_24044,1173,446,24,111,135,2.6241610738255035,26.465055790656436
Task_24045,1852,128,12,11,23,14.356589147286822,34.08351416733882
Task_24046,1737,298,32,199,231,5.809364548494983,35.680882148420196
Task_24047,2958,757,157,151,308,3.9023746701846966,56.77018830368909
Task_24048,672,189,147,120,267,3.536842105263158,18.542493904046932
Task_24049,1737,398,92,113,205,4.353383458646617,35.77828961889328
Task_24050,1271,732,36,49,85,1.7339699863574352,27.942174962189238
Task_24051,710,655,193,24,217,1.0823170731707317,19.70412807445867
Task_24052,1544,608,104,85,189,2.535303776683087,33.188416999290716
Task_24053,1516,359,15,86,101,4.211111111111111,31.222224881498438
Task_24054,517,784,17,102,119,0.6585987261146496,17.03592852721251
Task_24055,2589,384,62,148,210,6.724675324675324,49.346285911508424
Task_24056,2589,249,51,155,206,10.356,48.897213473206335
Task_24057,2730,656,27,165,192,4.155251141552512,52.32660004028151
Task_24058,2961,647,180,153,333,4.569444444444445,56.584584687822975
Task_24059,2317,771,200,96,296,3.0012953367875648,46.55299350744871
Task_24060,1758,954,94,126,220,1.8408376963350785,37.950209782003334
Task_24061,843,809,173,22,195,1.0407407407407407,22.166587201485857
Task_24062,2339,699,120,37,157,3.3414285714285716,45.31544738597384
Task_24063,2021,427,146,157,303,4.72196261682243,40.86523363104445
Task_24064,2926,124,80,178,258,23.408,53.597423295802194
Task_24065,1181,256,172,34,206,4.595330739299611,25.890389949560586
Task_24066,2664,945,134,137,271,2.8160676532769555,52.514534109773194
Task_24067,1394,948,89,85,174,1.4689146469968388,31.699710106826043
Task_24068,886,379,144,137,281,2.331578947368421,22.622528364531018
Task_24069,2173,110,104,137,241,19.576576576576578,41.40460209043471
Task_24070,1949,273,119,143,262,7.113138686131387,39.00653694898313
Task_24071,2965,277,63,57,120,10.66546762589928,53.64145388054936
Task_24072,2137,476,115,199,314,4.480083857442348,42.97096520158124
Task_24073,2605,549,49,80,129,4.736363636363636,49.63553416147323
Task_24074,2906,370,63,121,184,7.83288409703504,54.11972783719363
Task_24075,802,246,139,75,214,3.2469635627530367,20.2972519540544
Task_24076,2842,658,161,80,241,4.312594840667678,54.11370565148937
Task_24077,789,362,58,151,209,2.1735537190082646,20.79987523775395
Task_24078,2562,1009,178,188,366,2.5366336633663367,51.600690797598816
Task_24079,1183,981,28,96,124,1.204684317718941,28.18885001152196
Task_24080,1529,149,133,84,217,10.193333333333333,31.32127527721236
Task_24081,2293,293,92,11,103,7.799319727891157,42.72575765616293
Task_24082,1517,187,82,162,244,8.069148936170214,31.91517598191346
Task_24083,2491,920,72,146,218,2.7046688382193267,49.529404319581396
Task_24084,2915,801,92,45,137,3.634663341645885,54.6737639871883
Task_24085,1638,756,177,40,217,2.163804491413474,34.771623757695814
Task_24086,2326,534,24,178,202,4.347663551401869,45.60136803423014
Task_24087,2891,777,128,83,211,3.7159383033419022,55.16304839504543
Task_24088,2901,870,195,181,376,3.330654420206659,56.572993232540874
Task_24089,2168,755,179,30,209,2.867724867724868,43.11974404759718
Task_24090,2730,800,133,123,256,3.4082397003745317,53.01808716777489
Task_24091,576,433,182,169,351,1.327188940092166,18.202495057455668
Task_24092,1142,877,17,85,102,1.3006833712984054,26.845793099797167
Task_24093,1921,162,187,11,198,11.785276073619633,36.93262472505551
Task_24094,696,282,22,99,121,2.4593639575971733,18.260558561354866
Task_24095,2618,573,197,122,319,4.560975609756097,50.80766326504958
Task_24096,1249,1024,94,59,153,1.2185365853658536,29.21445154372986
Task_24097,2253,520,119,70,189,4.324376199616123,43.91362258962189
Task_24098,1994,638,77,165,242,3.1205007824726136,40.91480892992356
Task_24099,2175,361,138,159,297,6.00828729281768,43.06075874036344
Task_24100,2485,305,103,56,159,8.120915032679738,46.57142788217356
Task_24101,2060,980,72,26,98,2.0998980632008153,41.22989783809641
Task_24102,2289,150,15,11,26,15.158940397350994,41.158288762611086
Task_24103,2638,295,96,109,205,8.912162162162161,49.67627211631041
Task_24104,554,781,134,110,244,0.7084398976982097,18.47735850379114
Task_24105,1771,598,163,28,191,2.956594323873122,36.250433329247336
Task_24106,1965,774,74,200,274,2.535483870967742,41.07141117016551
Task_24107,981,959,118,37,155,1.021875,24.623013894418325
Task_24108,1325,321,119,37,156,4.114906832298137,28.05139729405835
Task_24109,2558,1013,180,101,281,2.5226824457593686,51.039127259853764
Task_24110,652,116,134,79,213,5.572649572649572,17.10357239650975
Task_24111,1338,379,151,38,189,3.5210526315789474,28.71332914148176
Task_24112,2605,741,195,20,215,3.51078167115903,49.947345379301815
Task_24113,2366,459,122,83,205,5.143478260869565,45.8075867179025
Task_24114,2192,545,175,190,365,4.014652014652015,44.27961791832164
Task_24115,1117,546,59,127,186,2.0420475319926874,26.398730802375614
Task_24116,2773,112,191,116,307,24.539823008849556,51.13125127019919
Task_24117,1726,663,147,98,245,2.5993975903614457,36.60456101367792
Task_24118,1989,1000,110,145,255,1.9870129870129871,41.928978865092965
Task_24119,648,849,161,125,286,0.7623529411764706,20.321819780534113
Task_24120,1421,342,41,38,79,4.142857142857143,28.76183713165319
Task_24121,969,522,19,90,109,1.852772466539197,23.20706737002536
Task_24122,2497,780,196,149,345,3.1971830985915495,49.703117841601795
Task_24123,1213,847,82,50,132,1.4304245283018868,27.922090584159463
Task_24124,800,975,104,155,259,0.819672131147541,23.012192728315096
Task_24125,1789,434,177,158,335,4.11264367816092,37.36188398154439
Task_24126,1306,338,46,76,122,3.8525073746312684,28.060024319828855
Task_24127,2423,583,40,131,171,4.148972602739726,47.049467857114074
Task_24128,716,883,132,131,263,0.8099547511312217,21.39583266923617
Task_24129,2281,330,27,30,57,6.891238670694864,42.12753457896842
Task_24130,2534,476,51,190,241,5.312368972746331,49.01134791846312
Task_24131,1265,699,42,16,58,1.8071428571428572,27.113637074863508
Task_24132,680,876,35,182,217,0.7753705815279361,20.63455715258834
Task_24133,880,466,86,194,280,1.8843683083511777,22.841274056450235
Task_24134,1027,204,33,200,233,5.009756097560976,24.16114490909723
Task_24135,1370,461,112,150,262,2.965367965367965,30.47573938456233
Task_24136,1947,793,137,193,330,2.452141057934509,41.02719760234523
Task_24137,883,925,59,78,137,0.9535637149028078,23.416905482474434
Task_24138,2564,448,15,104,119,5.710467706013363,48.335287066439825
Task_24139,2230,258,16,137,153,8.61003861003861,42.646134037417234
Task_24140,757,836,100,151,251,0.9044205495818399,21.869808451694652
Task_24141,903,412,64,129,193,2.1864406779661016,22.65788787531906
Task_24142,2040,66,146,171,317,30.44776119402985,39.44732065046295
Task_24143,1962,774,182,18,200,2.5316129032258066,39.78441861598514
Task_24144,2912,367,193,35,228,7.913043478260869,53.73934264712554
Task_24145,2992,732,28,30,58,4.081855388813097,54.688445763634725
Task_24146,2892,104,19,93,112,27.542857142857144,51.37284279000601
Task_24147,872,358,145,88,233,2.4289693593314765,21.987037676665164
Task_24148,1008,642,17,110,127,1.567651632970451,24.38373834910142
Task_24149,1276,172,22,140,162,7.375722543352601,27.04969010128096
Task_24150,2168,464,169,111,280,4.662365591397849,43.14069666033919
Task_24151,1848,385,145,149,294,4.787564766839378,37.93848215348541
Task_24152,1931,406,77,43,120,4.744471744471745,37.53867758253663
Task_24153,2820,921,75,69,144,3.058568329718004,53.954807826410196
Task_24154,2024,452,105,52,157,4.467991169977925,39.80155827308243
Task_24155,2389,239,100,83,183,9.954166666666667,45.278398450123895
Task_24156,957,194,115,92,207,4.907692307692308,22.685748635668933
Task_24157,1064,601,93,193,286,1.7674418604651163,26.26739620309466
Task_24158,2098,949,107,162,269,2.208421052631579,43.58570717722633
Task_24159,1786,925,85,88,173,1.9287257019438444,37.95408951337007
Task_24160,2579,444,180,71,251,5.795505617977528,49.14946319291918
Task_24161,1084,757,104,146,250,1.4300791556728232,26.75970153609052
Task_24162,981,914,148,113,261,1.0721311475409836,25.60170785028004
Task_24163,757,198,79,171,250,3.8040201005025125,20.009348755848738
Task_24164,1867,908,63,82,145,2.053905390539054,39.0742735984948
Task_24165,1978,104,180,114,294,18.83809523809524,38.5007757481306
Task_24166,1261,214,50,25,75,5.865116279069768,25.601036747312943
Task_24167,2059,1006,80,66,146,2.044687189672294,42.173988110234575
Task_24168,1497,171,151,168,319,8.703488372093023,31.594819877442614
Task_24169,638,80,181,171,352,7.8765432098765435,17.661741575019025
Task_24170,1354,885,191,132,323,1.528216704288939,31.75437039353184
Task_24171,1859,965,69,113,182,1.9244306418219461,39.41889323280244
Task_24172,776,319,133,89,222,2.425,20.312775136783298
Task_24173,2253,493,169,169,338,4.560728744939271,44.92625208381981
Task_24174,1129,616,47,16,63,1.8298217179902756,24.670780589510475
Task_24175,2917,482,14,147,161,6.0393374741200825,54.38972286174558
Task_24176,1765,713,119,70,189,2.4719887955182074,36.79531338103384
Task_24177,1728,738,69,195,264,2.3382949932341,37.16380328074893
Task_24178,1992,552,165,27,192,3.602169981916817,39.58890119416501
Task_24179,1845,788,56,103,159,2.338403041825095,38.36510101394574
Task_24180,1343,345,191,31,222,3.8815028901734103,28.81987469428464
Task_24181,1421,85,41,94,135,16.523255813953487,28.512772564462693
Task_24182,965,740,126,112,238,1.302294197031039,24.710524268938187
Task_24183,1498,442,122,92,214,3.381489841986456,32.0880317489825
Task_24184,1833,662,18,200,218,2.764705882352941,38.30085133877227
Task_24185,1876,1009,180,92,272,1.8574257425742575,40.11333601698752
Task_24186,1925,892,166,39,205,2.1556550951847706,39.687075964387155
Task_24187,760,610,86,115,201,1.2438625204582652,20.8397563293499
Task_24188,1493,325,169,113,282,4.579754601226994,32.01908671342333
Task_24189,938,924,73,119,192,1.0140540540540541,24.663118234437317
Task_24190,1021,1017,55,186,241,1.0029469548133596,26.58918533907561
Task_24191,2783,648,97,37,134,4.288135593220339,52.055464466631776
Task_24192,2532,892,149,94,243,2.83538633818589,50.06147797618903
Task_24193,2913,769,177,136,313,3.7831168831168833,56.09569326827695
Task_24194,1963,369,133,174,307,5.305405405405406,39.800580190026594
Task_24195,1429,502,178,14,192,2.840954274353877,30.438971488985725
Task_24196,2914,456,97,26,123,6.3763676148796495,53.31440908359025
Task_24197,713,139,94,44,138,5.0928571428571425,17.332626065786965
Task_24198,668,840,166,149,315,0.7942925089179548,20.777655524594387
Task_24199,2017,185,162,159,321,10.844086021505376,39.97726595931546
Task_24200,2147,1019,29,19,48,2.104901960784314,41.99101720831535
Task_24201,2608,714,200,176,376,3.6475524475524477,51.433114420888444
Task_24202,2488,911,44,171,215,2.7280701754385963,49.433609877609115
Task_24203,1071,448,156,171,327,2.3853006681514475,26.025665938603975
Task_24204,2327,684,56,176,232,3.397080291970803,46.30793351018868
Task_24205,1506,610,10,52,62,2.46481178396072,30.98857099633831
Task_24206,1473,516,43,84,127,2.849129593810445,31.461391402308294
Task_24207,1178,247,127,142,269,4.75,26.763668381592677
Task_24208,2055,647,185,160,345,3.1712962962962963,42.29927229791964
Task_24209,951,914,43,145,188,1.039344262295082,24.806759609575845
Task_24210,2431,276,87,122,209,8.776173285198556,46.32604668322387
Task_24211,702,74,146,77,223,9.36,17.61886462732105
Task_24212,2111,119,178,190,368,17.591666666666665,41.20597705927947
Task_24213,697,165,75,75,150,4.198795180722891,17.76277033960419
Task_24214,2709,279,14,108,122,9.675,50.10075390500001
Task_24215,1908,103,111,139,250,18.346153846153847,37.23841012476567
Task_24216,2922,803,135,169,304,3.6343283582089554,56.353176615930714
Task_24217,1062,300,122,137,259,3.528239202657807,25.053420693056328
Task_24218,1953,525,113,28,141,3.7129277566539924,38.53885608080358
Task_24219,2266,277,69,127,196,8.151079136690647,43.78251860879411
Task_24220,2725,865,90,142,232,3.1466512702078524,53.056820916143074
Task_24221,1451,616,146,190,336,2.3517017828200975,32.639136900553794
Task_24222,1812,811,26,166,192,2.231527093596059,38.26864937247832
Task_24223,2481,114,76,112,188,21.57391304347826,46.07440722022009
Task_24224,1483,590,47,32,79,2.509306260575296,30.49803264993642
Task_24225,2216,928,86,56,142,2.385360602798708,44.224704772943774
Task_24226,1302,919,87,154,241,1.4152173913043478,30.645092469808493
Task_24227,1031,905,84,104,188,1.1379690949227372,26.002386909076108
Task_24228,1940,639,10,138,148,3.03125,39.304991049024615
Task_24229,2749,827,97,53,150,3.320048309178744,52.472045955245704
Task_24230,2297,729,135,90,225,3.1465753424657534,45.71544116935257
Task_24231,1248,1012,148,80,228,1.2319842053307009,29.85451922497793
Task_24232,2874,184,181,199,380,15.535135135135135,53.810077165771794
Task_24233,2504,526,157,146,303,4.751423149905123,48.81483183603839
Task_24234,883,938,159,58,217,0.9403620873269436,23.692420539521052
Task_24235,730,295,38,182,220,2.4662162162162162,19.68839062748403
Task_24236,911,262,76,25,101,3.463878326996198,20.76689490641956
Task_24237,2802,649,17,195,212,4.310769230769231,53.54704758910594
Task_24238,1570,654,89,124,213,2.3969465648854964,33.970816300364724
Task_24239,1609,265,19,156,175,6.048872180451128,33.19524471668601
Task_24240,1033,213,173,32,205,4.827102803738318,23.40641577821293
Task_24241,1133,815,134,195,329,1.3884803921568627,28.143856734560874
Task_24242,2497,114,56,67,123,21.713043478260868,45.282305927865316
Task_24243,1474,519,174,112,286,2.8346153846153848,32.35836694160097
Task_24244,2042,636,40,14,54,3.205651491365777,39.18646066056218
Task_24245,840,746,64,105,169,1.1244979919678715,22.42245759734789
Task_24246,1229,497,109,139,248,2.467871485943775,28.278413139136457
Task_24247,975,979,122,145,267,0.9948979591836735,25.822571600227764
Task_24248,2181,540,43,107,150,4.031423290203327,42.81355868053308
Task_24249,2838,1018,199,62,261,2.785083415112856,55.02474052120908
Task_24250,1772,345,49,59,108,5.121387283236994,34.96481376662195
Task_24251,2897,660,123,83,206,4.382753403933434,54.86536527444721
Task_24252,1176,551,10,19,29,2.130434782608696,24.99505947467952
Task_24253,2295,624,96,172,268,3.672,45.70595966856815
Task_24254,2292,241,20,144,164,9.47107438016529,43.81026236453919
Task_24255,1235,475,169,165,334,2.5945378151260505,28.729657027695364
Task_24256,1345,830,68,112,180,1.618531889290012,30.843872993589745
Task_24257,1930,732,168,130,298,2.6330150068212825,40.33050351384634
Task_24258,1817,171,137,75,212,10.563953488372093,35.82791732834961
Task_24259,2566,341,199,34,233,7.502923976608187,48.19765345467767
Task_24260,1607,585,175,149,324,2.742320819112628,34.898054179917814
Task_24261,2336,461,27,48,75,5.0562770562770565,43.54563187418876
Task_24262,2835,771,24,189,213,3.672279792746114,54.48073309557495
Task_24263,734,595,177,118,295,1.2315436241610738,20.863804793658783
Task_24264,1971,293,113,75,188,6.704081632653061,38.7925495803907
Task_24265,980,169,12,68,80,5.764705882352941,21.519549749673644
Task_24266,527,549,140,54,194,0.9581818181818181,16.745375311157
Task_24267,2152,562,27,45,72,3.822380106571936,40.865601355601214
Task_24268,2402,832,112,149,261,2.883553421368547,47.98242137092518
Task_24269,2812,875,108,50,158,3.2100456621004567,53.44261135429599
Task_24270,625,456,183,113,296,1.3676148796498906,18.719890396564626
Task_24271,2747,727,62,123,185,3.7733516483516483,52.77127224739769
Task_24272,1089,556,164,134,298,1.9551166965888689,26.465172528670752
Task_24273,1621,244,141,127,268,6.616326530612245,33.72577017691895
Task_24274,1600,512,144,149,293,3.1189083820662766,34.41685986125842
Task_24275,1334,759,94,106,200,1.7552631578947369,30.49314663355103
Task_24276,1040,567,66,200,266,1.8309859154929577,25.753620853934063
Task_24277,2556,984,13,142,155,2.5949238578680203,50.194682439398655
Task_24278,654,324,79,93,172,2.0123076923076924,18.234975245536816
Task_24279,2960,645,146,157,303,4.58204334365325,56.433024278176184
Task_24280,2544,127,31,69,100,19.875,45.96331709709997
Task_24281,2482,524,165,160,325,4.727619047619048,48.579752809701915
Task_24282,1748,484,109,137,246,3.6041237113402063,36.44137560833284
Task_24283,1982,854,191,125,316,2.31812865497076,41.609326006039346
Task_24284,2872,705,53,61,114,4.067988668555241,53.676621079219046
Task_24285,1065,174,32,112,144,6.085714285714285,23.492380371776708
Task_24286,2630,983,13,64,77,2.6727642276422765,50.14093459615725
Task_24287,957,591,181,131,312,1.616554054054054,24.52953230835071
Task_24288,810,154,71,186,257,5.225806451612903,20.530730585427143
Task_24289,1757,707,177,103,280,2.481638418079096,37.39103496755617
Task_24290,1588,378,78,104,182,4.189973614775726,33.26043892179895
Task_24291,2575,649,76,187,263,3.9615384615384617,50.278565805217085
Task_24292,2384,935,173,135,308,2.547008547008547,48.21026941786916
Task_24293,580,1000,180,34,214,0.5794205794205795,19.050927417648797
Task_24294,905,665,58,76,134,1.3588588588588588,22.873320379792972
Task_24295,712,81,182,80,262,8.682926829268293,18.058553192831905
Task_24296,2846,716,88,105,193,3.9693165969316597,54.23945915783043
Task_24297,1893,806,148,97,245,2.345724907063197,39.7168250972307
Task_24298,2732,725,132,16,148,3.763085399449036,51.49018601006883
Task_24299,2879,585,47,135,182,4.912969283276451,54.383156863223405
Task_24300,1298,240,124,187,311,5.385892116182573,28.890923415707316
Task_24301,1518,400,130,43,173,3.7855361596009973,31.534611982144387
Task_24302,1851,704,190,123,313,2.625531914893617,39.04869489463412
Task_24303,2576,500,43,169,212,5.141716566866267,49.51107590540827
Task_24304,536,389,28,158,186,1.3743589743589744,16.627314578195502
Task_24305,1417,867,174,119,293,1.6324884792626728,32.571751263208746
Task_24306,1067,227,176,95,271,4.6798245614035086,24.896093031511782
Task_24307,1381,848,170,51,221,1.6266195524146054,31.234512434461582
Task_24308,969,92,15,143,158,10.419354838709678,21.57210408018661
Task_24309,1305,1006,183,123,306,1.2959285004965244,31.244637785527956
Task_24310,1167,345,167,73,240,3.3728323699421967,26.4505461504849
Task_24311,1771,186,181,189,370,9.470588235294118,36.4704717270935
Task_24312,1196,447,41,84,125,2.669642857142857,26.810814917902846
Task_24313,1380,893,167,53,220,1.5436241610738255,31.38613661505828
Task_24314,1224,617,152,143,295,1.9805825242718447,28.793519166749466
Task_24315,2977,411,168,175,343,7.225728155339806,56.14808517162631
Task_24316,1615,576,27,80,107,2.79896013864818,33.552420378444886
Task_24317,1572,201,171,172,343,7.782178217821782,33.20189030835815
Task_24318,1142,961,196,87,283,1.187110187110187,28.307237080828013
Task_24319,904,138,181,112,293,6.503597122302159,21.87229134882335
Task_24320,1131,484,50,105,155,2.331958762886598,26.12361032708397
Task_24321,1448,766,119,129,248,1.8878748370273795,32.57412467147517
Task_24322,2246,520,41,58,99,4.310940499040307,42.881326530812466
Task_24323,1909,823,129,71,200,2.316747572815534,39.511906131625665
Task_24324,845,950,119,64,183,0.8885383806519453,22.960359408920358
Task_24325,1242,168,198,27,225,7.349112426035503,26.44058075570796
Task_24326,2836,666,128,168,296,4.251874062968516,54.52039840133572
Task_24327,1461,282,114,83,197,5.162544169611308,30.871069349074816
Task_24328,2276,272,179,114,293,8.336996336996338,44.26852696862633
Task_24329,598,228,159,78,237,2.611353711790393,17.177507993104136
Task_24330,1937,890,137,165,302,2.1739618406285075,41.00402370546104
Task_24331,2466,699,144,17,161,3.5228571428571427,47.26213719963899
Task_24332,1521,230,161,108,269,6.584415584415584,32.07359429743415
Task_24333,2993,126,89,45,134,23.566929133858267,53.03088512530772
Task_24334,733,585,11,54,65,1.2508532423208192,18.680203738042085
Task_24335,1816,70,102,141,243,25.577464788732396,35.56798955780214
Task_24336,1893,140,54,86,140,13.425531914893616,36.416857790497765
Task_24337,2465,247,162,32,194,9.939516129032258,46.09640002009604
Task_24338,2404,742,106,192,298,3.2355316285329745,47.96161126841173
Task_24339,2417,670,168,104,272,3.602086438152012,47.69444205524089
Task_24340,1429,190,71,71,142,7.481675392670157,29.669541724119043
Task_24341,584,800,61,162,223,0.7290886392009988,19.02467029559679
Task_24342,2312,388,127,96,223,5.943444730077121,44.92044992871041
Task_24343,1748,738,156,143,299,2.365358592692828,37.4897094348796
Task_24344,2841,493,21,63,84,5.751012145748988,52.236280069204575
Task_24345,2803,105,139,42,181,26.443396226415093,50.22296898074936
Task_24346,1801,384,103,166,269,4.677922077922078,37.10382630534401
Task_24347,1732,478,151,169,320,3.615866388308977,36.54936545422609
Task_24348,2266,102,85,102,187,22.0,42.465190245301805
Task_24349,2096,580,27,56,83,3.6075731497418246,40.61234424193823
Task_24350,2560,899,114,53,167,2.8444444444444446,49.87884191577277
Task_24351,955,205,138,150,288,4.635922330097087,23.19625951177811
Task_24352,1908,642,164,157,321,2.967340590979782,39.84271149917103
Task_24353,1585,753,17,183,200,2.1021220159151195,34.524997368031116
Task_24354,2254,455,133,160,293,4.942982456140351,44.603218882252726
Task_24355,1523,542,17,143,160,2.8047882136279925,32.45292887901088
Task_24356,2939,893,198,130,328,3.2874720357941833,56.956093411915106
Task_24357,1505,605,87,145,232,2.4834983498349836,32.885390725559574
Task_24358,946,664,19,49,68,1.4225563909774437,22.20994600118209
Task_24359,1574,575,49,193,242,2.732638888888889,34.134960961863015
Task_24360,1210,737,16,72,88,1.6395663956639566,27.28889406599755
Task_24361,2223,658,94,112,206,3.3732928679817906,44.30832126488604
Task_24362,1480,239,95,199,294,6.166666666666667,31.713849434438515
Task_24363,760,753,71,33,104,1.0079575596816976,20.034896910770986
Task_24364,2190,185,47,14,61,11.774193548387096,40.11321116394114
Task_24365,1177,413,84,120,204,2.842995169082126,26.973021251387408
Task_24366,821,343,17,52,69,2.386627906976744,19.329316302380317
Task_24367,2204,384,38,106,144,5.724675324675324,42.64842559827523
Task_24368,2659,762,102,16,118,3.4849279161205766,50.09572638144164
Task_24369,2926,337,18,152,170,8.65680473372781,54.21532970655303
Task_24370,595,325,116,196,312,1.8251533742331287,18.074568746319585
Task_24371,737,214,115,165,280,3.427906976744186,19.770805665192025
Task_24372,538,487,93,38,131,1.1024590163934427,16.131523858565412
Task_24373,2712,225,57,145,202,12.0,50.684226055721915
Task_24374,1252,896,168,44,212,1.3957636566332219,29.066256775413834
Task_24375,939,666,34,103,137,1.4077961019490255,23.41447157603041
Task_24376,2988,872,138,44,182,3.422680412371134,56.34450048569372
Task_24377,2680,344,19,104,123,7.768115942028985,49.878901127659056
Task_24378,623,169,150,69,219,3.664705882352941,16.945400901196653
Task_24379,2283,761,136,189,325,2.9960629921259843,46.221712487870654
Task_24380,1524,322,94,56,150,4.718266253869969,31.422128621587376
Task_24381,1186,834,60,185,245,1.4203592814371258,28.72299525061106
Task_24382,1315,465,198,65,263,2.8218884120171674,29.23602397531437
Task_24383,2397,636,112,186,298,3.7629513343799057,47.50747653707047
Task_24384,1865,558,39,126,165,3.336314847942755,38.12809529036101
Task_24385,1854,294,123,104,227,6.284745762711864,37.362282988788046
Task_24386,2684,262,128,79,207,10.20532319391635,50.13924752132417
Task_24387,740,882,124,200,324,0.8380520951302378,22.133046464437285
Task_24388,2276,844,59,124,183,2.693491124260355,45.66754641694289
Task_24389,2760,740,103,40,143,3.7246963562753037,52.02340317799473
Task_24390,1828,596,108,119,227,3.0619765494137354,37.951361364625576
Task_24391,1248,403,30,50,80,3.089108910891089,26.438980380166512
Task_24392,542,318,92,40,132,1.6990595611285266,15.573729623002377
Task_24393,2451,221,75,36,111,11.04054054054054,45.069967270521126
Task_24394,1881,810,72,83,155,2.3193588162762024,38.95559039171368
Task_24395,1181,503,12,122,134,2.3432539682539684,26.76704023713495
Task_24396,909,579,193,132,325,1.5672413793103448,23.762753798048607
Task_24397,669,553,63,190,253,1.2075812274368232,19.68430351740872
Task_24398,2004,734,35,41,76,2.726530612244898,39.119787641328635
Task_24399,2272,188,80,71,151,12.02116402116402,42.98106471024506
Task_24400,1098,514,141,195,336,2.1320388349514565,26.736672057220613
Task_24401,2966,188,120,73,193,15.693121693121693,54.1827243563449
Task_24402,2375,422,90,88,178,5.614657210401892,45.70154157625584
Task_24403,1400,760,64,130,194,1.8396846254927726,31.6233690281682
Task_24404,722,846,104,110,214,0.8524203069657615,21.109584068829616
Task_24405,2099,571,97,163,260,3.6695804195804196,42.38464680078991
Task_24406,1073,614,49,78,127,1.7447154471544715,25.47116446069022
Task_24407,1885,333,130,26,156,5.6437125748503,36.90675610689814
Task_24408,1233,164,44,107,151,7.472727272727273,26.163730774593702
Task_24409,2891,523,157,197,354,5.517175572519084,55.23706320680392
Task_24410,1155,339,13,37,50,3.3970588235294117,24.35805121951623
Task_24411,2632,502,33,65,98,5.2326043737574555,49.119224868853365
Task_24412,1210,851,68,192,260,1.42018779342723,29.237642967644863
Task_24413,935,414,64,146,210,2.253012048192771,23.272139727133695
Task_24414,2331,657,92,191,283,3.5425531914893615,46.4759710747268
Task_24415,1196,1005,10,43,53,1.1888667992047715,27.19062711562762
Task_24416,2129,769,157,153,310,2.764935064935065,43.6867096815202
Task_24417,1839,572,78,71,149,3.2094240837696337,37.38333194449991
Task_24418,500,922,154,130,284,0.5417118093174431,18.275553346350023
Task_24419,549,584,71,62,133,0.9384615384615385,16.902054844656387
Task_24420,909,739,131,157,288,1.2283783783783784,24.10832277011136
Task_24421,1387,684,29,172,201,2.024817518248175,31.205817601469516
Task_24422,2124,430,144,121,265,4.928074245939675,42.2810394615123
Task_24423,561,140,174,138,312,3.978723404255319,16.623543354280546
Task_24424,1889,579,70,81,151,3.2568965517241377,38.33176052827862
Task_24425,800,535,118,87,205,1.492537313432836,21.235446225343676
Task_24426,1621,267,184,132,316,6.048507462686567,34.029113900448614
Task_24427,1506,1001,167,141,308,1.5029940119760479,34.46824626729242
Task_24428,2039,297,141,149,290,6.842281879194631,40.64725463795418
Task_24429,2501,330,183,58,241,7.555891238670695,47.39915371580198
Task_24430,1296,764,98,174,272,1.6941176470588235,30.32483230907269
Task_24431,624,474,152,78,230,1.3136842105263158,18.30242106640634
Task_24432,2027,768,62,147,209,2.635890767230169,41.670777460983885
Task_24433,526,598,58,30,88,0.8781302170283807,15.714042554481162
Task_24434,2008,303,85,134,219,6.605263157894737,39.84172497806885
Task_24435,1516,411,18,51,69,3.679611650485437,30.534788424013126
Task_24436,1981,441,43,125,168,4.481900452488688,39.59067925128869
Task_24437,1039,355,45,107,152,2.918539325842697,24.146821697481233
Task_24438,1551,475,185,105,290,3.258403361344538,33.44557596021014
Task_24439,2396,291,83,102,185,8.205479452054794,45.730518885863866
Task_24440,2038,561,176,187,363,3.626334519572954,41.87865997760806
Task_24441,2045,526,47,199,246,3.8804554079696394,41.408470012190485
Task_24442,1469,163,151,77,228,8.957317073170731,30.37582509913044
Task_24443,521,622,153,117,270,0.8362760834670947,17.494463425751768
Task_24444,1551,931,22,187,209,1.6641630901287554,34.596487881707525
Task_24445,2760,416,23,80,103,6.618705035971223,51.11162052679921
Task_24446,1780,316,126,151,277,5.615141955835962,36.56089055505509
Task_24447,1302,467,174,193,367,2.782051282051282,29.95468534625658
Task_24448,2020,861,34,162,196,2.34338747099768,41.758664414322915
Task_24449,1796,869,62,93,155,2.064367816091954,37.837742169161146
Task_24450,1844,82,100,102,202,22.216867469879517,35.79540673942285
Task_24451,1883,236,152,85,237,7.9451476793248945,37.5579821037625
Task_24452,2614,240,66,10,76,10.846473029045644,47.014056230937626
Task_24453,2041,261,142,10,152,7.790076335877862,39.0201443767242
Task_24454,1810,1003,83,66,149,1.802788844621514,38.20746875285156
Task_24455,2755,93,22,13,35,29.30851063829787,47.8443038351615
Task_24456,879,176,99,42,141,4.966101694915254,20.152456020993977
Task_24457,1413,159,130,108,238,8.83125,29.7899075281609
Task_24458,2927,534,119,45,164,5.471028037383178,54.24321846186502
Task_24459,2142,931,117,59,176,2.2982832618025753,43.31334663062777
Task_24460,2485,352,96,200,296,7.039660056657223,47.99758921353131
Task_24461,2419,247,63,175,238,9.754032258064516,46.34636147435349
Task_24462,1112,401,151,152,303,2.7661691542288556,26.389475953371672
Task_24463,1732,857,105,56,161,2.0186480186480185,36.45207259559905
Task_24464,2588,599,133,14,147,4.3133333333333335,48.81087212156394
Task_24465,2122,281,30,147,177,7.524822695035461,41.37272317448829
Task_24466,2078,516,148,194,342,4.019342359767892,42.28420151937029
Task_24467,1026,132,191,198,389,7.714285714285714,24.322983635948134
Task_24468,2681,465,195,85,280,5.753218884120171,51.14906347885806
Task_24469,2991,351,185,79,264,8.497159090909092,55.5666292870381
Task_24470,2436,751,127,104,231,3.2393617021276597,48.06586604384777
Task_24471,1338,440,146,15,161,3.0340136054421767,28.572282092349653
Task_24472,514,704,125,138,263,0.7290780141843972,17.697001669511806
Task_24473,1256,887,18,124,142,1.4144144144144144,29.161105391110386
Task_24474,2516,90,76,34,110,27.64835164835165,44.835977276826675
Task_24475,1722,479,99,37,136,3.5875,34.707767484381336
Task_24476,1953,755,45,110,155,2.5833333333333335,39.92953819852736
Task_24477,681,552,137,109,246,1.2314647377938517,19.656796112529964
Task_24478,2892,438,29,187,216,6.587699316628702,54.340487207098185
Task_24479,2894,651,112,149,261,4.438650306748467,55.20576757833876
Task_24480,2324,304,138,122,260,7.619672131147541,45.00264185068303
Task_24481,932,871,144,93,237,1.0688073394495412,24.53880510894423
Task_24482,2807,533,68,32,100,5.2565543071161045,51.690344645711825
Task_24483,1386,625,122,103,225,2.2140575079872202,31.010085178494688
Task_24484,1167,440,54,102,156,2.6462585034013606,26.525806535951222
Task_24485,920,995,23,70,93,0.9236947791164659,23.5543885023018
Task_24486,2484,379,85,146,231,6.536842105263158,47.69889037662049
Task_24487,2515,936,136,172,308,2.6840981856990394,50.343447851844566
Task_24488,2929,182,87,137,224,16.005464480874316,53.84308020749963
Task_24489,1328,210,141,33,174,6.293838862559242,27.897456872418065
Task_24490,2553,890,26,112,138,2.8653198653198655,49.7277662840882
Task_24491,1917,516,47,46,93,3.7079303675048356,37.455342678761774
Task_24492,2478,618,127,122,249,4.003231017770598,48.418556422282826
Task_24493,1671,364,158,74,232,4.578082191780822,34.5017307287514
Task_24494,2559,183,169,193,362,13.907608695652174,48.75159288930272
Task_24495,1698,926,118,34,152,1.831715210355987,35.808694878532094
Task_24496,529,722,132,51,183,0.7316735822959889,17.217686542641776
Task_24497,1101,526,69,161,230,2.0891840607210628,26.366694486280323
Task_24498,1764,1003,22,122,144,1.7569721115537849,37.61787443161838
Task_24499,986,134,57,42,99,7.303703703703704,20.999838999386245
Task_24500,2833,487,96,177,273,5.805327868852459,53.815073305800944
Task_24501,846,129,196,53,249,6.507692307692308,20.31175773206168
Task_24502,1732,456,76,19,95,3.789934354485777,34.29123064253928
Task_24503,1912,899,147,138,285,2.1244444444444444,40.519713535010546
Task_24504,705,787,198,63,261,0.8946700507614214,20.60968472340745
Task_24505,2429,248,118,145,263,9.755020080321286,46.50962542184416
Task_24506,1418,455,12,97,109,3.1096491228070176,30.117126818629163
Task_24507,816,390,160,101,261,2.0869565217391304,21.40690186355144
Task_24508,1786,914,176,161,337,1.951912568306011,38.83793529760215
Task_24509,2114,285,91,125,216,7.391608391608392,41.42204903188971
Task_24510,1717,848,57,118,175,2.022379269729093,36.78679287824214
Task_24511,697,654,34,121,155,1.0641221374045802,19.624736202243653
Task_24512,1074,946,111,61,172,1.1341077085533262,26.394456231349864
Task_24513,690,575,29,112,141,1.1979166666666667,19.224354100758763
Task_24514,2721,1008,152,31,183,2.696729435084242,52.54168255313573
Task_24515,2215,400,18,66,84,5.523690773067331,42.0362482759267
Task_24516,1133,850,133,27,160,1.3313748531139835,26.653076331109187
Task_24517,1567,146,146,98,244,10.65986394557823,32.13030574803763
Task_24518,628,397,65,87,152,1.5778894472361809,17.76220898653583
Task_24519,1754,682,94,100,194,2.568081991215227,36.88349356538192
Task_24520,1521,553,187,200,387,2.7454873646209386,33.79409806113721
Task_24521,1262,742,165,48,213,1.6985195154777928,28.778015961141673
Task_24522,2557,520,148,138,286,4.907869481765835,49.546295667277946
Task_24523,1358,567,126,197,323,2.390845070422535,30.96425596744358
Task_24524,1350,612,149,78,227,2.202283849918434,30.248649158280724
Task_24525,2777,359,97,176,273,7.713888888888889,52.50158722588444
Task_24526,1203,511,47,89,136,2.349609375,27.20439371609724
Task_24527,1553,304,114,22,136,5.091803278688524,31.398750429465682
Task_24528,2494,756,118,12,130,3.2945838837516512,47.70734737173228
Task_24529,948,400,190,164,354,2.3640897755610975,24.03868760791455
Task_24530,2616,927,153,181,334,2.8189655172413794,52.04616234717719
Task_24531,1843,1008,161,67,228,1.8265609514370664,39.1294227202742
Task_24532,2374,999,127,80,207,2.374,47.61593306649713
Task_24533,2729,632,191,198,389,4.311216429699842,53.18071686543931
Task_24534,1484,315,120,107,227,4.69620253164557,31.58704994853555
Task_24535,2438,247,155,155,310,9.830645161290322,46.874615374543076
Task_24536,1361,786,56,178,234,1.7293519695044473,31.322967049158706
Task_24537,1546,814,58,24,82,1.8969325153374232,32.2964402008252
Task_24538,2241,930,76,128,204,2.407089151450054,45.51666582217765
Task_24539,1970,888,32,110,142,2.2159730033745784,40.52369559754311
Task_24540,1171,729,198,27,225,1.604109589041096,27.30496379521043
Task_24541,1137,647,154,57,211,1.7546296296296295,26.68217086456492
Task_24542,2915,877,150,78,228,3.3200455580865604,55.875786071143814
Task_24543,2241,790,174,191,365,2.8331226295828067,45.83044350893156
Task_24544,1843,492,114,192,306,3.738336713995943,38.32187773862422
Task_24545,537,620,90,114,204,0.8647342995169082,17.406184460709525
Task_24546,2436,442,115,173,288,5.498871331828442,47.43803192833863
Task_24547,2304,948,27,69,96,2.42781875658588,45.311533696629816
Task_24548,1140,134,65,41,106,8.444444444444445,23.52717510246117
Task_24549,626,967,108,109,217,0.6466942148760331,20.094470875624157
Task_24550,914,359,116,93,209,2.5388888888888888,22.59648186416361
Task_24551,2888,618,141,102,243,4.665589660743134,54.85550415109238
Task_24552,1500,639,125,81,206,2.34375,32.63744043965805
Task_24553,1395,171,11,28,39,8.11046511627907,27.407310546000527
Task_24554,1082,845,183,62,245,1.2789598108747045,26.582128892905313
Task_24555,970,947,143,30,173,1.0232067510548524,24.565293742001753
Task_24556,827,871,39,88,127,0.948394495412844,22.298893849878763
Task_24557,2820,292,189,33,222,9.62457337883959,51.99165331301486
Task_24558,2868,140,85,131,216,20.340425531914892,52.529969225608575
Task_24559,522,747,124,180,304,0.6978609625668449,18.239465935316158
Task_24560,2296,647,163,31,194,3.54320987654321,44.745006001421416
Task_24561,1047,982,48,125,173,1.0651068158697863,26.471757728436767
Task_24562,1850,845,59,142,201,2.186761229314421,39.066362035044
Task_24563,1716,104,132,10,142,16.34285714285714,32.736718425197125
Task_24564,1949,142,37,103,140,13.62937062937063,37.231719919719986
Task_24565,2766,663,137,10,147,4.1656626506024095,51.841664177288614
Task_24566,1050,245,31,45,76,4.2682926829268295,22.409997816053888
Task_24567,2127,560,142,16,158,3.7914438502673797,41.41049937885348
Task_24568,1727,706,131,84,215,2.442715700141443,36.517277672836165
Task_24569,1932,300,153,94,247,6.4186046511627906,38.68477007723824
Task_24570,1784,721,88,102,190,2.4709141274238227,37.4111599217259
Task_24571,2221,610,74,139,213,3.635024549918167,44.24624713770341
Task_24572,1755,746,94,149,243,2.3493975903614457,37.39230246067246
Task_24573,1778,952,29,11,40,1.8656873032528856,35.858802702922446
Task_24574,531,898,171,166,337,0.5906562847608454,19.00096636203283
Task_24575,1148,254,78,132,210,4.5019607843137255,26.099585861468118
Task_24576,2008,1020,129,178,307,1.9666993143976494,42.57494215528557
Task_24577,1226,428,50,12,62,2.8578088578088576,25.605212681207927
Task_24578,2596,515,86,15,101,5.0310077519379846,48.184698916849065
Task_24579,2658,1004,166,94,260,2.644776119402985,52.4842570374492
Task_24580,2171,846,191,111,302,2.563164108618654,44.495307016023844
Task_24581,1151,175,132,160,292,6.5397727272727275,25.99228817854933
Task_24582,1969,325,154,19,173,6.039877300613497,38.32807038839109
Task_24583,2125,728,80,53,133,2.914951989026063,42.22542880460019
Task_24584,2332,829,80,40,120,2.8096385542168676,45.2046434755789
Task_24585,2156,307,18,112,130,7.0,41.58290405548873
Task_24586,648,120,19,108,127,5.355371900826446,16.47226732221517
Task_24587,2019,1011,158,17,175,1.9950592885375493,41.298517716006984
Task_24588,796,317,22,190,212,2.50314465408805,20.749914374482177
Task_24589,1725,78,162,94,256,21.835443037974684,34.139741744905514
Task_24590,1894,750,70,23,93,2.5219707057256993,37.846445546274495
Task_24591,1822,812,41,185,226,2.241082410824108,38.63839394041174
Task_24592,1701,280,16,79,95,6.05338078291815,33.73158098891974
Task_24593,2475,618,51,59,110,3.998384491114701,47.04046445748144
Task_24594,616,557,57,110,167,1.103942652329749,18.272918248981767
Task_24595,2187,244,105,30,135,8.926530612244898,41.26696510783022
Task_24596,1191,688,138,18,156,1.7285921625544267,26.979613079675612
Task_24597,1866,258,169,185,354,7.204633204633205,38.1185726773238
Task_24598,2897,937,40,20,60,3.088486140724947,53.703641130105865
Task_24599,1874,534,147,32,179,3.502803738317757,37.62703181518547
Task_24600,2320,997,139,14,153,2.3246492985971945,45.79186882463576
Task_24601,2554,970,155,94,249,2.630278063851699,50.680614513493786
Task_24602,2849,367,71,101,172,7.741847826086956,53.12237714299069
Task_24603,2258,406,101,132,233,5.547911547911548,44.19498023211194
Task_24604,2491,1011,172,57,229,2.4614624505928853,49.35982492681918
Task_24605,1305,936,187,111,298,1.3927427961579508,30.981459363503472
Task_24606,1285,977,22,60,82,1.3139059304703475,28.981943036218965
Task_24607,2918,602,178,188,366,4.839137645107795,55.95988442207573
Task_24608,1040,912,11,61,72,1.1391018619934283,24.611044412711696
Task_24609,595,732,14,78,92,0.8117326057298773,17.64179407631339
Task_24610,1932,249,131,183,314,7.728,38.94638210423938
Task_24611,625,140,124,171,295,4.432624113475177,17.603368831800655
Task_24612,830,872,83,174,257,0.9507445589919816,23.174259780243464
Task_24613,859,504,131,199,330,1.700990099009901,22.886896805205424
Task_24614,2158,188,13,36,49,11.417989417989418,39.80072430177494
Task_24615,2740,931,98,124,222,2.939914163090129,53.439436323830954
Task_24616,1402,562,137,166,303,2.4902309058614565,31.509691808076614
Task_24617,2487,814,98,27,125,3.0515337423312885,47.743550939547085
Task_24618,1422,835,94,192,286,1.700956937799043,32.63733357012985
Task_24619,2313,579,182,78,260,3.9879310344827585,45.543628554757
Task_24620,2601,460,188,69,257,5.642082429501085,49.53200631723298
Task_24621,535,838,96,156,252,0.6376638855780691,18.500742497915244
Task_24622,1945,532,33,21,54,3.649155722326454,37.42617606945566
Task_24623,929,465,153,24,177,1.9935622317596566,22.373056684571782
Task_24624,1212,481,18,135,153,2.5145228215767634,27.284502596465888
Task_24625,1279,490,70,30,100,2.604887983706721,27.379430206960482
Task_24626,2288,531,15,153,168,4.3007518796992485,44.75181018885237
Task_24627,1571,287,79,160,239,5.454861111111111,33.06084713610966
Task_24628,2001,413,119,44,163,4.833333333333333,39.17565321293688
Task_24629,1011,1022,76,179,255,0.9882697947214076,26.541149149439462
Task_24630,864,802,111,195,306,1.0759651307596514,23.724276261315243
Task_24631,2533,886,100,22,122,2.855693348365276,48.56880707880156
Task_24632,712,827,128,58,186,0.8599033816425121,20.43872761530174
Task_24633,1289,87,94,191,285,14.647727272727273,27.644405992057898
Task_24634,2537,716,61,115,176,3.5383542538354256,49.36522500529849
Task_24635,2203,427,155,166,321,5.147196261682243,43.83988336040395
Task_24636,2921,573,125,62,187,5.088850174216028,54.58374043743131
Task_24637,986,609,34,185,219,1.616393442622951,24.716946826246584
Task_24638,2846,748,199,26,225,3.7997329773030706,53.88265045210405
Task_24639,701,636,191,85,276,1.1004709576138147,20.259367852085965
Task_24640,1293,444,171,45,216,2.90561797752809,28.315390130168343
Task_24641,1847,695,128,112,240,2.653735632183908,38.61198009825759
Task_24642,530,478,56,119,175,1.1064718162839249,16.74263769366115
Task_24643,683,163,110,11,121,4.164634146341464,16.740077035312748
Task_24644,2633,677,51,141,192,3.883480825958702,50.92974641597959
Task_24645,2934,737,167,77,244,3.975609756097561,55.763705660038255
Task_24646,2868,621,106,138,244,4.610932475884244,54.6056149715947
Task_24647,858,613,101,106,207,1.3973941368078175,22.479889354498685
Task_24648,2292,763,76,34,110,3.0,44.31603190848926
Task_24649,647,176,192,87,279,3.6553672316384183,17.801510544288462
Task_24650,2001,626,155,58,213,3.1913875598086126,40.32061518154399
Task_24651,1984,745,42,95,137,2.6595174262734584,40.31509871900563
Task_24652,2307,638,158,52,210,3.6103286384976525,45.23556294960509
Task_24653,2205,315,142,131,273,6.977848101265823,43.23069190477128
Task_24654,1766,468,102,176,278,3.76545842217484,36.87655460652669
Task_24655,1370,393,30,118,148,3.4771573604060912,29.51265854472317
Task_24656,846,329,57,86,143,2.5636363636363635,21.038436569109958
Task_24657,1753,245,64,156,220,7.126016260162602,35.71114556617821
Task_24658,742,930,38,37,75,0.7969924812030075,19.845520170954728
Task_24659,700,160,78,100,178,4.3478260869565215,18.28708966970626
Task_24660,1830,622,96,14,110,2.937399678972713,36.51739135718214
Task_24661,2030,1014,39,59,98,2.0,41.04992861191054
Task_24662,954,597,187,173,360,1.5953177257525084,24.778637886604173
Task_24663,697,687,179,172,351,1.0130813953488371,20.880774191296766
Task_24664,2313,1006,125,137,262,2.2969215491559085,47.10191259681022
Task_24665,713,448,149,131,280,1.5879732739420935,20.04615833447087
Task_24666,514,341,30,164,194,1.5029239766081872,16.230025219547482
Task_24667,2396,556,137,68,205,4.301615798922801,46.368649468362406
Task_24668,1465,142,133,44,177,10.244755244755245,29.53243899907619
Task_24669,1897,644,53,37,90,2.9410852713178293,37.466356473509975
Task_24670,2113,946,141,84,225,2.2312565997888067,43.42681180092046
Task_24671,1089,211,50,50,100,5.136792452830188,23.486773257580428
Task_24672,1271,699,12,37,49,1.8157142857142856,27.31198644356932
Task_24673,1818,812,149,110,259,2.236162361623616,38.6010623892996
Task_24674,624,409,102,148,250,1.5219512195121951,18.405177458402516
Task_24675,2719,106,171,117,288,25.411214953271028,50.13211712759135
Task_24676,2792,191,89,24,113,14.541666666666666,50.46567129967577
Task_24677,1796,519,110,117,227,3.453846153846154,37.1978426657106
Task_24678,1792,447,73,92,165,4.0,36.61008956575598
Task_24679,1242,665,93,195,288,1.864864864864865,29.311635664158885
Task_24680,560,307,190,74,264,1.8181818181818181,16.89057054571619
Task_24681,2477,150,81,53,134,16.403973509933774,45.45582377455661
Task_24682,2693,1016,132,125,257,2.647984267453294,53.11486696296182
Task_24683,1769,584,163,44,207,3.023931623931624,36.2599942024909
Task_24684,1498,927,111,120,231,1.6142241379310345,33.763477153538766
Task_24685,2363,204,45,118,163,11.526829268292683,44.77793608762121
Task_24686,983,578,128,145,273,1.697754749568221,24.745452263109787
Task_24687,2990,420,49,14,63,7.102137767220903,53.487108966791
Task_24688,915,80,116,24,140,11.296296296296296,19.9139314018698
Task_24689,2228,306,122,83,205,7.257328990228013,43.11470117575714
Task_24690,1134,102,200,94,294,11.009708737864077,25.170078576747116
Task_24691,1212,115,114,46,160,10.448275862068966,25.06188170091703
Task_24692,1967,750,190,65,255,2.6191744340878826,40.42218515196935
Task_24693,880,523,32,83,115,1.6793893129770991,21.918457175157325
Task_24694,2120,371,112,128,240,5.698924731182796,41.921585720891066
Task_24695,1987,519,21,58,79,3.8211538461538463,38.492059103702736
Task_24696,1150,129,180,57,237,8.846153846153847,25.047958209354686
Task_24697,1379,460,131,141,272,2.9913232104121477,30.646897828181682
Task_24698,2307,548,105,158,263,4.202185792349726,45.603480843056296
Task_24699,1663,260,158,141,299,6.371647509578544,34.60530755828188
Task_24700,1188,418,172,25,197,2.835322195704057,26.434262062934824
Task_24701,674,889,140,137,277,0.7573033707865169,20.80183893447349
Task_24702,1001,943,63,129,192,1.0603813559322033,25.748838633068534
Task_24703,2389,295,66,13,79,8.070945945945946,43.78105302218089
Task_24704,1415,622,38,153,191,2.2712680577849116,31.389909767468534
Task_24705,1775,90,96,94,190,19.505494505494507,34.69434522041893
Task_24706,2367,341,158,34,192,6.921052631578948,44.865333340818246
Task_24707,2809,675,178,31,209,4.155325443786983,53.02668883896842
Task_24708,1984,772,98,28,126,2.5666235446313066,39.72690533877395
Task_24709,1386,960,76,145,221,1.4422476586888657,32.113470842498025
Task_24710,1203,308,20,135,155,3.8932038834951457,26.635452927244685
Task_24711,558,776,106,131,237,0.7181467181467182,18.51898554817467
Task_24712,2020,329,187,163,350,6.121212121212121,40.74657533998746
Task_24713,2186,805,187,176,363,2.7121588089330024,44.97502444473093
Task_24714,1308,87,80,198,278,14.863636363636363,27.97028348044262
Task_24715,1285,309,59,79,138,4.145161290322581,27.854955621843036
Task_24716,547,643,112,134,246,0.8493788819875776,17.88874151480003
Task_24717,2611,982,101,145,246,2.6561546286876907,51.68916649560322
Task_24718,877,657,199,28,227,1.3328267477203648,22.445459931347653
Task_24719,2752,154,31,22,53,17.75483870967742,48.81135124302285
Task_24720,2813,992,157,21,178,2.8328298086606245,53.853029031683086
Task_24721,846,763,199,87,286,1.1073298429319371,22.999071565792605
Task_24722,690,221,185,24,209,3.108108108108108,17.968983137992694
Task_24723,1319,964,104,57,161,1.366839378238342,30.209517293663026
Task_24724,805,899,69,191,260,0.8944444444444445,22.95379419286725
Task_24725,931,158,32,171,203,5.855345911949685,22.060116465064024
Task_24726,2028,673,14,109,123,3.0089020771513355,40.638699594648706
Task_24727,1819,139,12,155,167,12.992857142857142,35.58261512684633
Task_24728,644,638,146,122,268,1.0078247261345852,19.442052325600088
Task_24729,2599,135,140,98,238,19.110294117647058,48.27500986955437
Task_24730,2572,927,43,170,213,2.771551724137931,50.80412505617712
Task_24731,616,314,179,110,289,1.9555555555555555,18.142074266706164
Task_24732,594,366,151,178,329,1.6185286103542234,18.22485971690188
Task_24733,2825,330,115,114,229,8.534743202416918,52.86399839713937
Task_24734,2227,324,176,47,223,6.852307692307693,42.76725030583369
Task_24735,2908,101,34,49,83,28.50980392156863,51.130305964594406
Task_24736,2389,1002,28,117,145,2.38185443668993,47.5473114908331
Task_24737,679,276,166,53,219,2.4512635379061374,18.36580186388083
Task_24738,2120,356,158,26,184,5.938375350140056,40.92326295002285
Task_24739,1505,465,174,24,198,3.2296137339055795,31.59605753475486
Task_24740,2147,601,34,172,206,3.5664451827242525,43.01409695307641
Task_24741,948,264,126,22,148,3.577358490566038,21.810866378922373
Task_24742,1244,353,31,46,77,3.5141242937853105,25.898482578829285
Task_24743,678,615,197,91,288,1.1006493506493507,19.913641686017602
Task_24744,1024,792,168,110,278,1.2912988650693569,25.98387435968031
Task_24745,633,161,57,72,129,3.9074074074074074,16.651711310708187
Task_24746,1423,416,164,87,251,3.4124700239808154,30.96772123915615
Task_24747,2328,109,41,74,115,21.163636363636364,42.58166664603607
Task_24748,1907,825,92,113,205,2.3087167070217918,39.82036336104239
Task_24749,1293,585,70,117,187,2.2064846416382253,29.320121064468207
Task_24750,2655,522,53,104,157,5.076481835564054,50.35299670981979
Task_24751,505,551,193,135,328,0.9148550724637681,17.312320774548837
Task_24752,2289,930,103,81,184,2.4586466165413534,45.91184185025023
Task_24753,1346,952,74,45,119,1.4123819517313747,29.941147193354
Task_24754,1973,120,165,118,283,16.305785123966942,38.56112935818653
Task_24755,1601,614,134,146,280,2.603252032520325,34.69154606279916
Task_24756,2143,922,35,125,160,2.3217768147345614,43.50104519766046
Task_24757,1244,488,74,14,88,2.5439672801635993,26.594378809248933
Task_24758,2860,246,19,84,103,11.578947368421053,52.11282331698069
Task_24759,1202,680,68,167,235,1.765051395007342,28.46618069023101
Task_24760,1902,866,164,102,266,2.1937716262975777,40.1200983698294
Task_24761,723,672,48,86,134,1.074294205052006,20.04465683823224
Task_24762,881,780,107,112,219,1.1280409731113956,23.40102185172012
Task_24763,2419,887,153,198,351,2.724099099099099,48.90121290461516
Task_24764,1901,724,100,195,295,2.6220689655172413,39.92781419324133
Task_24765,984,677,49,181,230,1.4513274336283186,24.98859853919258
Task_24766,2568,215,81,162,243,11.88888888888889,48.56754598274639
Task_24767,1733,782,167,131,298,2.2132822477650063,37.36738344730738
Task_24768,853,353,200,39,239,2.4096045197740112,21.173767384880346
Task_24769,989,476,146,155,301,2.0733752620545074,24.67530376407102
Task_24770,732,691,95,30,125,1.0578034682080926,19.7373822658396
Task_24771,2104,568,169,48,217,3.6977152899824253,41.59837212350145
Task_24772,2254,905,195,53,248,2.487858719646799,45.414244624124336
Task_24773,805,1007,136,200,336,0.7986111111111112,23.633793941427854
Task_24774,699,115,35,99,134,6.025862068965517,17.302268208961816
Task_24775,1938,434,18,112,130,4.455172413793103,38.5554669295245
Task_24776,1249,845,190,170,360,1.4763593380614657,30.177927345285312
Task_24777,1107,504,189,110,299,2.1920792079207922,26.55637452411118
Task_24778,676,629,72,140,212,1.073015873015873,19.726163863537064
Task_24779,2129,376,200,133,333,5.647214854111406,42.50702868180749
Task_24780,878,654,153,84,237,1.3404580152671757,22.96357982118255
Task_24781,1788,401,122,190,312,4.447761194029851,37.18250184694682
Task_24782,746,428,143,127,270,1.7389277389277389,20.484104589913734
Task_24783,2269,827,57,94,151,2.7403381642512077,45.184950412263824
Task_24784,2737,918,58,91,149,2.9782372143634386,52.88440098559894
Task_24785,1337,168,107,67,174,7.911242603550296,27.920762752200943
Task_24786,1185,775,24,64,88,1.527061855670103,26.914771147990493
Task_24787,779,433,128,24,152,1.794930875576037,19.656124950705557
Task_24788,943,408,157,34,191,2.3056234718826407,22.55096045557296
Task_24789,2355,558,78,36,114,4.212880143112701,44.72270476139792
Task_24790,2081,67,105,197,302,30.602941176470587,40.047231332246874
Task_24791,2508,554,19,198,217,4.518918918918919,48.64179397930064
Task_24792,1987,720,83,120,203,2.7558945908460473,40.78866915934553
Task_24793,2428,307,24,105,129,7.883116883116883,45.91025148916995
Task_24794,2507,281,115,41,156,8.890070921985815,46.577861500140834
Task_24795,1075,488,106,60,166,2.198364008179959,25.019553764318655
Task_24796,1817,734,16,44,60,2.472108843537415,36.102960059896155
Task_24797,708,130,77,121,198,5.404580152671755,18.42453132014718
Task_24798,1172,1024,64,50,114,1.1434146341463414,27.509897471252838
Task_24799,2010,210,61,91,152,9.5260663507109,39.02146755244536
Task_24800,2752,392,58,192,250,7.002544529262087,52.19962150863466
Task_24801,1923,483,81,77,158,3.9731404958677685,38.48391584721999
Task_24802,1815,642,25,86,111,2.822706065318818,37.04586483416217
Task_24803,1446,150,200,54,254,9.57615894039735,29.970802372429187
Task_24804,1587,722,119,93,212,2.195020746887967,34.40744520986348
Task_24805,651,213,194,28,222,3.042056074766355,17.438459990425816
Task_24806,2784,1009,163,188,351,2.756435643564356,55.05115956338047
Task_24807,1439,702,83,192,275,2.046941678520626,32.4817277805454
Task_24808,1472,835,63,179,242,1.7607655502392345,33.26898708205299
Task_24809,2610,814,112,52,164,3.2024539877300615,50.39478548454994
Task_24810,1545,988,36,165,201,1.5621840242669363,34.617096264564616
Task_24811,1659,969,146,40,186,1.7103092783505154,35.602839858207034
Task_24812,1404,97,23,22,45,14.326530612244898,26.878777814251947
Task_24813,781,103,110,42,152,7.509615384615385,18.118817606979285
Task_24814,1086,302,161,104,265,3.5841584158415842,25.418065421083487
Task_24815,1015,235,63,34,97,4.3008474576271185,22.204447370926307
Task_24816,971,962,13,111,124,1.008307372793354,24.73706367475683
Task_24817,591,449,25,14,39,1.3133333333333332,15.505841546608679
Task_24818,1426,486,101,125,226,2.9281314168377826,31.24262487905483
Task_24819,1499,137,58,124,182,10.86231884057971,30.733150799364562
Task_24820,1636,852,50,85,135,1.917936694021102,35.176645489483924
Task_24821,2054,943,18,12,30,2.1758474576271185,40.158911535406865
Task_24822,725,927,194,161,355,0.78125,22.147475051507133
Task_24823,2757,957,197,179,376,2.8778705636743216,54.56051381421516
Task_24824,2208,878,180,159,339,2.5119453924914676,45.41857447250237
Task_24825,2984,461,68,50,118,6.458874458874459,54.517762504142276
Task_24826,1698,86,107,48,155,19.517241379310345,32.32477464012465
Task_24827,2210,140,47,89,136,15.673758865248226,41.3518153678827
Task_24828,2335,476,156,30,186,4.89517819706499,44.761471033931514
Task_24829,1258,970,130,200,330,1.2955715756951596,30.609421289106773
Task_24830,2823,394,86,110,196,7.146835443037975,52.85662512950623
Task_24831,1734,567,20,152,172,3.0528169014084505,36.12840444078275
Task_24832,1588,637,127,137,264,2.489028213166144,34.47255724192297
Task_24833,2745,405,22,67,89,6.761083743842365,50.51925734817112
Task_24834,2533,484,91,130,221,5.222680412371134,48.74457552197209
Task_24835,680,202,77,36,113,3.3497536945812807,17.08449193407493
Task_24836,534,454,186,125,311,1.1736263736263737,17.345664061623268
Task_24837,2822,689,149,89,238,4.089855072463768,53.951818292944814
Task_24838,920,974,165,132,297,0.9435897435897436,25.058269849785642
Task_24839,1318,411,72,51,123,3.1990291262135924,28.198436331093756
Task_24840,1347,747,50,46,96,1.8008021390374331,29.15309528063675
Task_24841,639,354,127,37,164,1.8,17.470364709599163
Task_24842,2121,176,185,132,317,11.983050847457626,41.34750991325291
Task_24843,1394,1011,19,70,89,1.3774703557312253,30.999702416034072
Task_24844,1844,809,147,54,201,2.276543209876543,38.36448591178778
Task_24845,1544,541,123,125,248,2.848708487084871,33.38398679524085
Task_24846,1874,746,37,94,131,2.5087014725568944,38.62466980415898
Task_24847,2451,795,96,13,109,3.079145728643216,46.890118630361
Task_24848,509,406,176,46,222,1.2506142506142506,15.839535340384856
Task_24849,1821,340,83,120,203,5.340175953079179,36.94609588237854
Task_24850,989,466,140,11,151,2.1177730192719486,23.075268574353544
Task_24851,1113,420,66,35,101,2.643705463182898,24.479975801562347
Task_24852,1382,679,128,101,229,2.0323529411764705,31.130664822299607
Task_24853,1169,555,38,118,156,2.102517985611511,26.89197546462499
Task_24854,1675,915,136,186,322,1.8286026200873362,37.05122592868623
Task_24855,1897,602,89,22,111,3.145936981757877,37.533977904804644
Task_24856,1396,150,175,176,351,9.245033112582782,30.09301414606603
Task_24857,2055,951,169,96,265,2.158613445378151,42.824073768569825
Task_24858,2468,249,180,39,219,9.872,46.264666109990664
Task_24859,1350,726,130,93,223,1.8569463548830811,30.71517047362353
Task_24860,1504,904,142,144,286,1.661878453038674,34.07023875401157
Task_24861,1369,712,86,200,286,1.9200561009817672,31.39000223753492
Task_24862,1218,825,150,93,243,1.4745762711864407,28.96807670511079
Task_24863,2016,832,43,106,149,2.4201680672268906,41.14361243572465
Task_24864,1714,790,190,10,200,2.1668773704171933,35.90032183577899
Task_24865,1054,310,114,29,143,3.3890675241157555,23.656316755045832
Task_24866,1878,749,130,67,197,2.504,38.737697447525115
Task_24867,1058,987,136,16,152,1.0708502024291497,25.764321415307908
Task_24868,1356,93,179,50,229,14.425531914893616,27.572393320131052
Task_24869,577,514,12,36,48,1.120388349514563,15.780619809798594
Task_24870,2027,67,159,137,296,29.808823529411764,39.08814835055838
Task_24871,2029,558,110,68,178,3.629695885509839,40.41486508286827
Task_24872,2202,242,47,47,94,9.061728395061728,41.06084242701387
Task_24873,2961,282,24,51,75,10.462897526501767,52.94240477634836
Task_24874,1901,672,168,94,262,2.824665676077266,39.46127635841882
Task_24875,2103,501,22,39,61,4.1892430278884465,39.86547412835949
Task_24876,758,76,116,44,160,9.844155844155845,17.50222853278207
Task_24877,2227,340,97,116,213,6.530791788856305,43.378878656055235
Task_24878,1883,723,35,53,88,2.600828729281768,37.746402714815474
Task_24879,794,744,122,107,229,1.0657718120805368,21.967285843260896
Task_24880,2353,908,102,24,126,2.5885588558855885,45.930078205930194
Task_24881,1453,674,193,187,380,2.1525925925925926,33.046285708710386
Task_24882,1639,287,76,58,134,5.690972222222222,33.07938245657449
Task_24883,2461,185,78,117,195,13.231182795698924,46.436884508396965
Task_24884,869,832,63,104,167,1.043217286914766,23.12139896324685
Task_24885,1845,75,92,78,170,24.276315789473685,35.240708900985574
Task_24886,2945,624,36,167,203,4.712,55.706994764877955
Task_24887,1087,636,82,90,172,1.706436420722135,26.029373594412473
Task_24888,1685,109,169,57,226,15.318181818181818,33.1779583040832
Task_24889,1963,1011,52,108,160,1.9397233201581028,40.94586727966052
Task_24890,1863,798,195,153,348,2.3316645807259073,39.734490004992615
Task_24891,2202,966,61,99,160,2.277145811789038,44.56861805503641
Task_24892,1713,414,165,169,334,4.127710843373494,36.10618520899774
Task_24893,2547,227,185,73,258,11.171052631578947,47.9366184364512
Task_24894,2269,743,73,149,222,3.049731182795699,45.48051025966267
Task_24895,2882,1011,163,162,325,2.847826086956522,56.45512611879085
Task_24896,1602,883,63,73,136,1.8122171945701357,34.55886703733658
Task_24897,1055,611,59,175,234,1.723856209150327,25.926776515806495
Task_24898,1457,141,165,23,188,10.26056338028169,29.449771684202073
Task_24899,2204,773,199,109,308,2.847545219638243,44.81390500973748
Task_24900,1481,275,177,141,318,5.365942028985507,31.86588315789696
Task_24901,1391,317,33,66,99,4.3742138364779874,28.8457289661248
Task_24902,2285,501,146,155,301,4.551792828685259,45.27132091073111
Task_24903,629,311,116,38,154,2.016025641025641,16.983914402597883
Task_24904,2804,401,189,180,369,6.975124378109452,53.50153010131182
Task_24905,2904,782,37,59,96,3.7088122605363987,54.182850355253485
Task_24906,2563,139,172,81,253,18.307142857142857,47.61587763295291
Task_24907,628,276,73,49,122,2.267148014440433,16.683377685807113
Task_24908,2682,953,100,162,262,2.811320754716981,52.820826079037865
Task_24909,1630,661,85,154,239,2.4622356495468276,35.13129166293244
Task_24910,1221,695,136,189,325,1.7543103448275863,29.178594340610925
Task_24911,2065,575,199,174,373,3.5850694444444446,42.37667458439493
Task_24912,768,447,39,46,85,1.7142857142857142,18.998261545916908
Task_24913,2917,310,148,136,284,9.379421221864952,54.528704131127746
Task_24914,1893,164,175,199,374,11.472727272727273,38.11480456498751
Task_24915,2150,135,139,104,243,15.808823529411764,41.24581998055823
Task_24916,2579,540,82,33,115,4.767097966728281,48.20848710479024
Task_24917,821,682,43,45,88,1.2020497803806736,20.627865175501512
Task_24918,964,905,108,76,184,1.0640176600441502,24.735221215212743
Task_24919,980,386,175,178,353,2.5322997416020674,24.516607374197985
Task_24920,1796,327,178,56,234,5.475609756097561,36.211859961891925
Task_24921,981,1017,144,136,280,0.9636542239685658,26.073385586626443
Task_24922,757,221,42,10,52,3.40990990990991,17.533881968083875
Task_24923,2439,212,68,144,212,11.450704225352112,46.37267884719074
Task_24924,2969,224,46,72,118,13.195555555555556,53.83658461514426
Task_24925,2332,822,137,76,213,2.833535844471446,46.34706777258984
Task_24926,2355,839,44,191,235,2.8035714285714284,47.2207005244847
Task_24927,1535,703,126,40,166,2.180397727272727,32.75658661662981
Task_24928,2136,201,46,168,214,10.574257425742575,41.55100699913383
Task_24929,1848,580,24,191,215,3.180722891566265,38.25645432541058
Task_24930,1268,902,133,39,172,1.4042081949058693,29.140032108913797
Task_24931,2904,1021,140,126,266,2.8414872798434443,56.5162719650231
Task_24932,1772,127,39,47,86,13.84375,33.40931222282736
Task_24933,2721,828,191,27,218,3.2822677925211097,52.12390228145389
Task_24934,2933,328,62,21,83,8.914893617021276,52.70539848075895
Task_24935,1560,491,46,60,106,3.1707317073170733,32.02743798128831
Task_24936,2649,136,190,55,245,19.335766423357665,48.73209314076285
Task_24937,2627,115,114,48,162,22.646551724137932,47.40591884546242
Task_24938,1244,118,48,21,69,10.453781512605042,24.742628469729464
Task_24939,670,579,14,128,142,1.1551724137931034,18.929786820424525
Task_24940,1417,442,195,28,223,3.198645598194131,30.295659462563723
Task_24941,2492,516,59,38,97,4.820116054158607,46.49986990309503
Task_24942,2121,148,97,61,158,14.234899328859061,39.91915830118197
Task_24943,2354,866,33,74,107,2.7151095732410613,46.11011148527506
Task_24944,1572,86,168,173,341,18.06896551724138,32.29484359983416
Task_24945,2423,845,88,124,212,2.8640661938534278,48.0571254049108
Task_24946,2799,832,57,134,191,3.360144057623049,54.00140345044153
Task_24947,1340,544,153,84,237,2.458715596330275,29.97906813237032
Task_24948,1576,880,173,52,225,1.7888762769580022,34.480415250301995
Task_24949,2724,167,188,174,362,16.214285714285715,51.12850071085424
Task_24950,1351,759,88,46,134,1.7776315789473685,29.7274994190095
Task_24951,2493,464,45,15,60,5.361290322580645,45.777710288064874
Task_24952,2822,279,147,189,336,10.07857142857143,53.22745460173328
Task_24953,1609,573,130,115,245,2.803135888501742,34.48601819993075
Task_24954,2129,99,23,187,210,21.29,40.52519333778151
Task_24955,1980,321,106,156,262,6.149068322981367,39.68013923939
Task_24956,1189,194,124,146,270,6.097435897435897,26.75382237941132
Task_24957,2603,138,88,97,185,18.72661870503597,48.07150517468882
Task_24958,1628,208,121,199,320,7.7894736842105265,34.04753545351608
Task_24959,651,769,126,17,143,0.8454545454545455,18.685709657276337
Task_24960,2381,567,35,54,89,4.191901408450704,45.14352550740327
Task_24961,705,868,21,196,217,0.8112773302646721,20.983071608183806
Task_24962,2982,426,46,104,150,6.983606557377049,55.1333828365127
Task_24963,1881,630,30,124,154,2.9809825673534074,38.35483698942037
Task_24964,2317,618,84,199,283,3.74313408723748,46.1447374879781
Task_24965,2800,811,15,101,116,3.4482758620689653,53.22416589662581
Task_24966,1044,739,13,84,97,1.4108108108108108,24.774487965452654
Task_24967,2421,169,166,36,202,14.241176470588234,44.94211032729513
Task_24968,2737,391,96,25,121,6.982142857142857,50.219181079028566
Task_24969,1413,234,149,78,227,6.012765957446809,30.025495614065136
Task_24970,1329,238,133,82,215,5.560669456066946,28.71601073114832
Task_24971,1059,803,12,90,102,1.3171641791044777,25.310354521825047
Task_24972,810,960,45,122,167,0.8428720083246618,22.609502502241124
Task_24973,2258,729,81,34,115,3.0931506849315067,43.72002239579077
Task_24974,2219,625,61,124,185,3.5447284345047922,44.08709973223392
Task_24975,1111,470,179,116,295,2.358811040339703,26.503402881897483
Task_24976,2905,379,102,154,256,7.644736842105263,54.47805591878548
Task_24977,2252,1017,199,52,251,2.212180746561886,45.73550269764993
Task_24978,1222,860,85,101,186,1.4192799070847852,28.88248675874661
Task_24979,1518,143,110,162,272,10.541666666666666,31.58224261515964
Task_24980,1296,493,41,185,226,2.623481781376518,29.307491736783977
Task_24981,833,737,175,12,187,1.1287262872628727,21.69015494953756
Task_24982,2199,426,175,36,211,5.149882903981265,42.5736241906064
Task_24983,2604,109,100,102,202,23.672727272727272,47.93888224819326
Task_24984,1496,559,57,83,140,2.6714285714285713,32.035215172193226
Task_24985,1351,714,181,147,328,1.8895104895104895,31.262438974942388
Task_24986,1837,553,11,52,63,3.315884476534296,36.06095209329278
Task_24987,1268,388,114,34,148,3.2596401028277633,27.33650115957566
Task_24988,1466,197,148,70,218,7.404040404040404,30.565178364350235
Task_24989,2829,705,51,118,169,4.007082152974505,53.93746402159354
Task_24990,2286,126,152,113,265,18.0,43.433511902714116
Task_24991,1659,141,39,54,93,11.683098591549296,32.001409011368494
Task_24992,2876,195,125,165,290,14.673469387755102,53.513175280655666
Task_24993,1351,802,197,72,269,1.6824408468244085,30.94528762468845
Task_24994,723,469,32,25,57,1.5382978723404255,17.968159987795353
Task_24995,1087,813,152,75,227,1.3353808353808354,26.617644310083957
Task_24996,708,484,12,153,165,1.4597938144329896,19.525241373134673
Task_24997,1410,864,68,194,262,1.630057803468208,32.49491255398282
Task_24998,2809,551,179,11,190,5.088768115942029,52.44240377439838
Task_24999,2257,679,71,13,84,3.3191176470588237,43.246155029644875
Task_25000,1361,336,185,20,205,4.0385756676557865,28.915125545647935
Task_25001,1439,69,16,68,84,20.557142857142857,27.855091148603986
Task_25002,727,983,141,123,264,0.7388211382113821,21.848298833605345
Task_25003,1546,359,19,42,61,4.294444444444444,30.647203178106178
Task_25004,529,127,60,44,104,4.1328125,13.738238951076355
Task_25005,1385,212,83,51,134,6.502347417840376,28.75218580205775
Task_25006,2842,477,168,171,339,5.945606694560669,54.20585260537505
Task_25007,1934,323,106,169,275,5.969135802469136,39.037084086130406
Task_25008,1017,186,80,17,97,5.438502673796791,22.23824176825218
Task_25009,1520,403,87,60,147,3.762376237623762,31.588975343334585
Task_25010,619,320,160,86,246,1.928348909657321,17.913232317188932
Task_25011,2789,888,196,59,255,3.137232845894263,53.80744171902065
Task_25012,1808,1011,33,32,65,1.7865612648221343,36.79875740789701
Task_25013,2880,489,160,157,317,5.877551020408164,54.72693661460244
Task_25014,2363,835,79,25,104,2.826555023923445,45.56301632388898
Task_25015,2627,671,76,91,167,3.9092261904761907,50.53003249936864
Task_25016,986,192,165,88,253,5.108808290155441,23.372650522568573
Task_25017,1005,392,176,59,235,2.5572519083969465,23.901831162295412
Task_25018,1911,597,95,173,268,3.1956521739130435,39.54318968502198
Task_25019,2057,115,47,169,216,17.732758620689655,39.56346060558086
Task_25020,1361,105,11,150,161,12.839622641509434,27.87600753920275
Task_25021,881,448,167,163,330,1.9621380846325167,23.020195721648403
Task_25022,1846,885,161,137,298,2.0835214446952595,39.48748477799866
Task_25023,507,800,114,78,192,0.6329588014981273,17.474055708553845
Task_25024,1404,828,125,52,177,1.6936067551266587,31.35427644945132
Task_25025,2245,574,177,161,338,3.9043478260869566,45.04706725355288
Task_25026,1857,98,50,179,229,18.757575757575758,36.36189668153698
Task_25027,1472,455,108,122,230,3.2280701754385963,31.885882136250682
Task_25028,2824,913,190,172,362,3.089715536105033,55.411304858986455
Task_25029,665,656,179,193,372,1.0121765601217656,20.403273556665635
Task_25030,1807,251,33,35,68,7.170634920634921,34.384789201833826
Task_25031,2340,133,165,54,219,17.46268656716418,43.72847025331134
Task_25032,2385,503,102,193,295,4.732142857142857,46.889571219301615
Task_25033,1067,720,120,141,261,1.4798890429958391,26.428824077796218
Task_25034,2654,420,12,124,136,6.304038004750594,49.82064609084714
Task_25035,1083,181,47,93,140,5.950549450549451,23.913090894106286
Task_25036,1846,785,105,93,198,2.3486005089058524,38.64413856287784
Task_25037,1595,514,181,114,295,3.0970873786407767,34.301748114266026
Task_25038,2274,556,70,109,179,4.082585278276481,44.70272410345432
Task_25039,832,996,103,28,131,0.8345035105315948,22.254426156923277
Task_25040,1056,229,80,123,203,4.591304347826087,24.503534878596977
Task_25041,1976,180,159,128,287,10.917127071823204,38.95273860772027
Task_25042,1830,240,177,179,356,7.593360995850622,37.48625346687684
Task_25043,2147,336,159,95,254,6.370919881305638,42.259863677039405
Task_25044,616,211,166,35,201,2.9056603773584904,16.795798068325784
Task_25045,1812,1001,149,120,269,1.8083832335329342,39.15360751843077
Task_25046,2225,969,178,81,259,2.2938144329896906,45.39250413706211
Task_25047,1485,444,92,124,216,3.337078651685393,32.00404482517009
Task_25048,1670,520,34,46,80,3.2053742802303264,33.41410794931513
Task_25049,2944,388,72,129,201,7.5681233933161955,54.9009962305056
Task_25050,1326,321,180,60,240,4.118012422360248,28.77426462559434
Task_25051,683,148,111,62,173,4.583892617449664,17.466068510740527
Task_25052,1683,468,30,65,95,3.588486140724947,33.960414453615975
Task_25053,1293,551,136,62,198,2.342391304347826,28.803554694964593
Task_25054,1439,174,185,147,332,8.222857142857142,30.69241773101317
Task_25055,963,363,189,112,301,2.6456043956043955,23.843304575453278
Task_25056,1291,885,183,157,340,1.4571106094808126,30.8582861675043
Task_25057,2366,86,177,170,347,27.195402298850574,44.76883777828749
Task_25058,2765,683,144,109,253,4.042397660818714,53.169430170565114
Task_25059,1270,989,20,28,48,1.2828282828282829,28.173860067200366
Task_25060,1106,566,124,10,134,1.9506172839506173,25.138606313570605
Task_25061,796,218,16,94,110,3.634703196347032,19.536081260622016
Task_25062,2301,640,86,114,200,3.5897035881435255,45.41271194675838
Task_25063,1950,852,49,38,87,2.2860492379835873,38.955001119212746
Task_25064,1023,263,200,127,327,3.875,24.607343489403206
Task_25065,621,556,158,14,172,1.1149012567324954,17.677388414407112
Task_25066,1414,161,152,78,230,8.728395061728396,29.567607680151564
Task_25067,1092,868,15,124,139,1.2566168009205985,26.485547568745034
Task_25068,921,843,60,29,89,1.0912322274881516,22.688345152964434
Task_25069,1676,331,73,196,269,5.048192771084337,35.05607217796229
Task_25070,1558,632,19,17,36,2.4612954186413902,31.333096004052816
Task_25071,2021,197,64,119,183,10.207070707070708,39.54903152842523
Task_25072,2834,146,58,97,155,19.27891156462585,51.39906192675147
Task_25073,1271,512,25,35,60,2.4775828460038984,26.715333451914542
Task_25074,1347,507,129,136,265,2.6515748031496065,30.250304715310875
Task_25075,1760,891,58,64,122,1.9730941704035874,36.81257387980082
Task_25076,925,221,21,133,154,4.166666666666667,21.905202910831875
Task_25077,1585,188,57,146,203,8.386243386243386,32.763672713639515
Task_25078,1998,525,116,63,179,3.7984790874524714,39.80998485668602
Task_25079,1508,67,30,25,55,22.176470588235293,27.975443862067042
Task_25080,1921,218,90,168,258,8.771689497716896,38.38007989999584
Task_25081,1884,276,184,152,336,6.8014440433212995,38.3363065655144
Task_25082,1783,122,99,133,232,14.495934959349594,35.37438369213732
Task_25083,1362,1020,136,28,164,1.3339862879529873,30.976813302765773
Task_25084,2263,313,167,130,297,7.207006369426751,44.2476775371799
Task_25085,1048,873,183,200,383,1.1990846681922196,27.22178598918453
Task_25086,1581,916,72,32,104,1.7241003271537623,33.47244735188781
Task_25087,2890,905,44,50,94,3.1898454746136866,54.20765732207358
Task_25088,2163,417,132,46,178,5.1746411483253585,41.83532948764832
Task_25089,1991,509,200,147,347,3.903921568627451,40.83806764809082
Task_25090,2123,929,75,64,139,2.282795698924731,42.89743060816449
Task_25091,1781,802,63,182,245,2.2179327521793275,38.093241623977036
Task_25092,2848,948,83,134,217,3.0010537407797684,55.22747652308136
Task_25093,931,172,178,29,207,5.381502890173411,21.492789066883052
Task_25094,2514,637,197,162,359,3.9404388714733543,49.603451370121356
Task_25095,1655,249,97,16,113,6.62,32.56309219736706
Task_25096,2121,371,128,20,148,5.701612903225806,40.71082130779313
Task_25097,666,134,74,161,235,4.933333333333334,17.995992622476276
Task_25098,681,65,125,149,274,10.318181818181818,17.987905055902363
Task_25099,1267,937,36,48,84,1.3507462686567164,28.50284016207246
Task_25100,2087,999,118,68,186,2.087,42.74864782137388
Task_25101,756,704,165,155,320,1.0723404255319149,21.714224439700416
Task_25102,2758,972,66,162,228,2.8345323741007196,54.00864113348454
Task_25103,1197,904,36,95,131,1.3226519337016576,28.344527144885124
Task_25104,1618,129,43,138,181,12.446153846153846,32.51063701284016
Task_25105,1251,894,103,189,292,1.3977653631284916,30.082920060795107
Task_25106,2108,116,117,58,175,18.017094017094017,39.60509708915984
Task_25107,2258,793,108,129,237,2.8438287153652393,45.44137813321106
Task_25108,2435,882,138,75,213,2.757644394110985,48.160331831784454
Task_25109,2938,271,81,60,141,10.801470588235293,53.580545907623424
Task_25110,2481,961,48,182,230,2.579002079002079,49.60561040201409
Task_25111,1697,618,105,159,264,2.741518578352181,36.17144060543078
Task_25112,1379,302,183,97,280,4.551155115511551,30.136365492764327
Task_25113,684,683,106,148,254,1.0,20.190095346317545
Task_25114,999,530,87,78,165,1.88135593220339,24.132217000594768
Task_25115,1955,434,65,159,224,4.494252873563219,39.560029989829765
Task_25116,2748,541,96,121,217,5.070110701107011,52.309900685333254
Task_25117,2863,550,144,55,199,5.19600725952813,53.669310771309
Task_25118,2961,200,34,167,201,14.73134328358209,54.48749356746941
Task_25119,515,698,141,33,174,0.7367668097281831,16.635169561376312
Task_25120,746,393,174,14,188,1.8934010152284264,19.252908792449592
Task_25121,970,661,69,62,131,1.4652567975830815,23.73208946204569
Task_25122,1692,585,19,139,158,2.887372013651877,35.27946481664696
Task_25123,655,101,10,110,120,6.421568627450981,16.332473652121703
Task_25124,968,529,167,23,190,1.8264150943396227,23.261793758093727
Task_25125,2367,830,32,188,220,2.848375451263538,47.29147613533164
Task_25126,2906,89,47,104,151,32.28888888888889,51.8823579819145
Task_25127,1588,986,41,90,131,1.6089159067882473,34.80498162087959
Task_25128,940,495,194,56,250,1.8951612903225807,23.278485338530313
Task_25129,2795,403,28,67,95,6.9183168316831685,51.352172586156264
Task_25130,1778,517,144,79,223,3.4324324324324325,36.73056059119084
Task_25131,2839,357,61,149,210,7.930167597765363,53.21142823771661
Task_25132,1117,886,137,188,325,1.2593010146561443,28.07487893531299
Task_25133,1586,216,36,166,202,7.308755760368664,32.847852623997994
Task_25134,2252,192,91,139,230,11.66839378238342,43.342218952376435
Task_25135,1326,208,42,165,207,6.344497607655502,28.73724777963704
Task_25136,1411,534,137,163,300,2.6373831775700936,31.546108879600144
Task_25137,1228,635,28,128,156,1.930817610062893,28.067732943328423
Task_25138,1764,787,23,167,190,2.238578680203046,37.42448657669184
Task_25139,1002,486,119,193,312,2.0574948665297743,25.01780604487958
Task_25140,2105,915,191,88,279,2.2980349344978164,43.46823891605411
Task_25141,1683,794,127,89,216,2.116981132075472,36.13894771374698
Task_25142,866,842,151,41,192,1.0272835112692764,22.70958547685044
Task_25143,1015,204,49,29,78,4.951219512195122,21.82043902041687
Task_25144,1746,532,101,153,254,3.275797373358349,36.621951131421596
Task_25145,1113,145,125,150,275,7.623287671232877,25.216909709229057
Task_25146,974,540,192,161,353,1.8003696857670979,24.881651129717067
Task_25147,2254,225,10,30,40,9.973451327433628,41.14494576194827
Task_25148,867,230,106,12,118,3.7532467532467533,20.037349106179203
Task_25149,967,143,160,111,271,6.715277777777778,22.822831996119387
Task_25150,2215,1009,78,57,135,2.1930693069306932,44.47423027284358
Task_25151,730,93,192,77,269,7.76595744680851,18.30066049935584
Task_25152,1640,72,145,100,245,22.465753424657535,32.76661622330001
Task_25153,2025,119,19,85,104,16.875,37.88385531330267
Task_25154,2097,977,155,86,241,2.144171779141104,43.35303617144311
Task_25155,2665,342,82,79,161,7.769679300291545,49.84700865509842
Task_25156,2300,650,163,191,354,3.533026113671275,46.27518898962254
Task_25157,1868,662,163,93,256,2.8174962292609353,38.8688685531069
Task_25158,1961,236,11,15,26,8.274261603375528,36.35999606959909
Task_25159,2238,465,45,37,82,4.802575107296137,42.30797017921635
Task_25160,1436,965,95,128,223,1.4865424430641823,32.85958084689237
Task_25161,2897,148,117,64,181,19.44295302013423,52.42402682737133
Task_25162,1961,917,80,59,139,2.136165577342048,40.19450038819501
Task_25163,1857,346,139,86,225,5.351585014409222,37.48275995074504
Task_25164,1021,867,114,128,242,1.1762672811059909,26.034356691703735
Task_25165,1316,616,23,191,214,2.1329011345218802,29.940165489049505
Task_25166,1511,903,38,14,52,1.6714601769911503,31.597976576295594
Task_25167,915,495,81,175,256,1.844758064516129,23.44329369438275
Task_25168,732,906,81,74,155,0.8070562293274531,20.904992400685185
Task_25169,1265,154,151,195,346,8.161290322580646,28.044790005419
Task_25170,975,330,33,12,45,2.945619335347432,21.260729511467318
Task_25171,2873,330,176,194,370,8.6797583081571,54.3758965511739
Task_25172,2456,780,139,195,334,3.144686299615877,49.0714243140431
Task_25173,1976,288,100,68,168,6.837370242214533,38.63094614953605
Task_25174,1501,144,125,200,325,10.351724137931035,31.624280156357912
Task_25175,1671,330,176,86,262,5.04833836858006,34.654613319711295
Task_25176,2555,950,48,112,160,2.6866456361724502,50.13148582934554
Task_25177,2140,619,174,16,190,3.4516129032258065,42.05851492669024
Task_25178,1286,103,176,197,373,12.365384615384615,28.10532164937236
Task_25179,2272,812,142,101,243,2.7945879458794587,45.708662696612485
Task_25180,728,358,81,95,176,2.0278551532033426,19.576387029342683
Task_25181,1881,95,101,78,179,19.59375,35.93574701002127
Task_25182,2716,304,19,15,34,8.904918032786885,48.586859351513716
Task_25183,1361,465,138,181,319,2.9206008583690988,30.648326660445772
Task_25184,602,403,52,147,199,1.49009900990099,17.883283031376227
Task_25185,1506,937,10,122,132,1.605543710021322,33.30026290593818
Task_25186,1096,120,118,103,221,9.057851239669422,24.462166968810227
Task_25187,2995,394,45,135,180,7.582278481012659,55.58472875329668
Task_25188,862,648,48,23,71,1.3281972265023112,20.686217593833288
Task_25189,2434,522,86,92,178,4.653919694072658,46.94796539781498
Task_25190,1963,655,63,11,74,2.9923780487804876,37.987689595957775
Task_25191,2724,611,140,28,168,4.450980392156863,51.237997560022514
Task_25192,2043,676,93,190,283,3.017725258493353,42.00352994141147
Task_25193,1960,486,76,97,173,4.024640657084189,39.49170723169251
Task_25194,2696,899,79,55,134,2.9955555555555557,51.76093563204793
Task_25195,2486,712,106,51,157,3.4866760168302946,47.88160901742848
Task_25196,2820,903,18,161,179,3.1194690265486726,54.43789210301646
Task_25197,2285,316,156,66,222,7.208201892744479,43.896337960818705
Task_25198,2880,509,11,140,151,5.647058823529412,53.76974646597379
Task_25199,2303,262,161,107,268,8.756653992395437,44.53652220473797
Task_25200,893,285,170,113,283,3.1223776223776225,22.405858820622587
Task_25201,2955,460,112,57,169,6.40997830802603,54.6554692560588
Task_25202,1681,693,38,145,183,2.422190201729107,35.73981347558597
Task_25203,1056,990,121,152,273,1.0655903128153381,27.144168033166384
Task_25204,2337,477,152,141,293,4.889121338912134,45.9604844667514
Task_25205,2104,238,69,196,265,8.803347280334728,41.49467251480454
Task_25206,1679,831,46,104,150,2.0180288461538463,35.78792189838986
Task_25207,2388,90,94,140,234,26.24175824175824,44.603071764685644
Task_25208,1957,366,196,160,356,5.332425068119891,39.896075531430434
Task_25209,705,827,196,198,394,0.8514492753623188,21.7217700642226
Task_25210,2368,915,31,159,190,2.5851528384279474,47.39208700691389
Task_25211,508,998,91,49,140,0.5085085085085085,17.54912364464805
Task_25212,1085,320,109,58,167,3.38006230529595,24.631365756020177
Task_25213,2707,592,25,173,198,4.564924114671164,51.79287604457741
Task_25214,2850,430,160,174,334,6.612529002320185,54.15957137650946
Task_25215,1948,859,120,139,259,2.2651162790697676,40.84982334971239
Task_25216,2826,488,183,154,337,5.779141104294479,53.95456453570031
Task_25217,2698,396,194,120,314,6.795969773299748,51.47167720257107
Task_25218,1880,939,125,29,154,2.0,38.74427047550388
Task_25219,520,451,102,157,259,1.1504424778761062,16.918162930743122
Task_25220,1152,676,196,11,207,1.7016248153618907,26.66452066910243
Task_25221,1584,246,124,130,254,6.412955465587045,33.089499218537576
Task_25222,2284,633,165,153,318,3.6025236593059935,45.75004951248594
Task_25223,1574,625,43,128,171,2.5143769968051117,33.73926189426907
Task_25224,1452,967,171,78,249,1.5,33.03982980032746
Task_25225,1833,610,35,157,192,3.0,37.98686857914394
Task_25226,2947,307,173,47,220,9.568181818181818,54.07988255232113
Task_25227,2768,833,183,192,375,3.3189448441247,54.36125565850144
Task_25228,1326,322,51,160,211,4.105263157894737,29.21531862277745
Task_25229,2799,701,28,107,135,3.9871794871794872,53.01740269426199
Task_25230,2850,433,127,182,309,6.566820276497696,54.06856786163621
Task_25231,2431,68,150,56,206,35.231884057971016,44.407653351684644
Task_25232,1792,393,72,91,163,4.548223350253807,36.39770252519567
Task_25233,2710,703,89,194,283,3.8494318181818183,52.600311786185046
Task_25234,2886,97,19,27,46,29.448979591836736,50.227900815339126
Task_25235,2814,456,145,28,173,6.157549234135668,52.20840254185078
Task_25236,2704,814,104,110,214,3.3177914110429447,52.441781743163595
Task_25237,2765,555,95,139,234,4.973021582733813,52.729764312640334
Task_25238,2415,162,183,120,303,14.815950920245399,45.90234333199516
Task_25239,1699,714,152,149,301,2.3762237762237763,36.65626164671527
Task_25240,2504,244,149,52,201,10.220408163265306,47.004171928491964
Task_25241,2517,101,45,92,137,24.676470588235293,45.82049554070827
Task_25242,1282,315,85,150,235,4.056962025316456,28.497946810491552
Task_25243,2250,759,136,185,321,2.960526315789474,45.66875778358269
Task_25244,1130,307,137,148,285,3.668831168831169,26.284712302257656
Task_25245,1894,446,72,77,149,4.237136465324385,37.94907020043441
Task_25246,1793,453,133,74,207,3.949339207048458,36.60792513935393
Task_25247,2034,674,176,11,187,3.013333333333333,40.53574813820053
Task_25248,1222,396,116,75,191,3.0780856423173804,27.317961263041273
Task_25249,1581,467,38,188,226,3.378205128205128,33.73806333354327
Task_25250,1339,724,53,30,83,1.846896551724138,28.816917473066606
Task_25251,1091,492,37,175,212,2.212981744421907,25.99237933542437
Task_25252,1419,615,118,53,171,2.3035714285714284,30.8838698948659
Task_25253,2140,795,152,31,183,2.6884422110552766,42.670475004198636
Task_25254,2656,486,165,17,182,5.453798767967146,49.75746776172533
Task_25255,2521,836,120,104,224,3.01194743130227,49.6476446015447
Task_25256,1891,1019,81,75,156,1.853921568627451,39.64045574424368
Task_25257,1019,788,46,63,109,1.291508238276299,24.60678076966143
Task_25258,2452,788,23,134,157,3.1077313054499367,47.94651364573503
Task_25259,2915,85,179,150,329,33.895348837209305,53.258491456155504
Task_25260,925,635,147,28,175,1.4544025157232705,22.889078180494533
Task_25261,2909,857,170,100,270,3.3904428904428903,56.06248658606993
Task_25262,2858,759,142,38,180,3.7605263157894737,53.947270568703324
Task_25263,1137,77,21,24,45,14.576923076923077,22.473396034101103
Task_25264,2677,174,147,56,203,15.297142857142857,49.26451958056381
Task_25265,2530,1021,176,124,300,2.475538160469667,50.7396653013652
Task_25266,1442,814,180,147,327,1.7693251533742331,32.99745359151561
Task_25267,2771,889,124,186,310,3.113483146067416,54.28254842591516
Task_25268,2419,76,87,34,121,31.415584415584416,43.188817561702784
Task_25269,2851,173,139,168,307,16.385057471264368,52.885370822332085
Task_25270,1734,504,106,126,232,3.4336633663366336,36.20426547060889
Task_25271,1222,886,73,116,189,1.3776775648252537,29.088550418332527
Task_25272,1924,679,23,169,192,2.8294117647058825,39.63611186775766
Task_25273,2815,168,41,52,93,16.65680473372781,50.47460605729484
Task_25274,2510,505,21,123,144,4.9604743083003955,47.879658289930944
Task_25275,2830,613,65,109,174,4.609120521172638,53.66420858925125
Task_25276,1266,128,56,57,113,9.813953488372093,25.842934612313982
Task_25277,2539,526,93,132,225,4.817836812144212,49.0353760449516
Task_25278,2805,631,196,108,304,4.438291139240507,53.86617985816616
Task_25279,1941,475,109,16,125,4.0777310924369745,37.944933113806435
Task_25280,2204,504,107,68,175,4.364356435643565,42.99968872384656
Task_25281,2628,457,35,59,94,5.737991266375546,48.73269666432629
Task_25282,855,255,121,43,164,3.33984375,20.56280343751795
Task_25283,802,297,19,76,95,2.6912751677852347,19.533606867336665
Task_25284,1945,864,37,58,95,2.2485549132947975,39.24041269712695
Task_25285,506,587,18,197,215,0.8605442176870748,16.948781506028556
Task_25286,1461,688,142,152,294,2.1204644412191582,32.777835616407515
Task_25287,2761,260,190,195,385,10.578544061302683,52.423162065182645
Task_25288,2413,773,158,186,344,3.1175710594315245,48.4001015687725
Task_25289,2949,347,168,162,330,8.474137931034482,55.40979559747026
Task_25290,2506,224,36,31,67,11.137777777777778,45.319953548252634
Task_25291,1084,531,153,21,174,2.037593984962406,25.003013281908235
Task_25292,1366,287,167,142,309,4.743055555555555,30.049278916096473
Task_25293,2690,410,68,129,197,6.545012165450122,50.9508140005051
Task_25294,2553,274,156,150,306,9.283636363636363,48.76512554575095
Task_25295,1924,669,173,198,371,2.8716417910447762,40.4665144668032
Task_25296,2942,372,79,17,96,7.887399463806971,53.170085863896645
Task_25297,799,517,193,181,374,1.5424710424710424,22.120237264706603
Task_25298,2826,667,126,145,271,4.230538922155689,54.218789691443
Task_25299,1195,836,59,25,84,1.4277180406212664,26.858246491925858
Task_25300,1512,690,62,79,141,2.1881331403762663,32.687320032778366
Task_25301,2727,853,36,195,231,3.193208430913349,53.144340387103334
Task_25302,2945,343,124,11,135,8.561046511627907,53.51242576341442
Task_25303,1439,117,10,199,209,12.194915254237289,29.840621478324525
Task_25304,1409,600,159,47,206,2.344425956738769,30.634676668342724
Task_25305,2165,506,26,166,192,4.270216962524655,42.898102526320734
Task_25306,1230,526,61,143,204,2.333965844402277,28.260247794159937
Task_25307,929,514,27,127,154,1.803883495145631,22.906473534427963
Task_25308,1395,254,154,46,200,5.470588235294118,29.256777310610786
Task_25309,652,942,139,25,164,0.6914103923647932,19.70134605598538
Task_25310,1499,691,12,101,113,2.1661849710982657,32.23557433358622
Task_25311,1055,455,144,118,262,2.31359649122807,25.423866611307897
Task_25312,1468,316,180,107,287,4.630914826498422,31.6077729521116
Task_25313,2070,379,73,85,158,5.447368421052632,40.596871151372916
Task_25314,2072,93,50,69,119,22.04255319148936,38.435088828590914
Task_25315,1790,1003,22,118,140,1.7828685258964143,38.00041590659429
Task_25316,831,826,191,133,324,1.0048367593712213,23.255139891700793
Task_25317,2454,367,50,127,177,6.668478260869565,46.97915572363066
Task_25318,1512,150,75,181,256,10.013245033112582,31.586970675593815
Task_25319,1255,613,145,161,306,2.043973941368078,29.34792921112096
Task_25320,2170,968,200,170,370,2.239422084623323,45.25271284327382
Task_25321,1765,298,97,183,280,5.903010033444816,36.331182463169974
Task_25322,1738,455,131,70,201,3.81140350877193,35.61153595022365
Task_25323,1671,631,55,187,242,2.643987341772152,35.81200957510331
Task_25324,1023,91,33,71,104,11.119565217391305,21.770812295427277
Task_25325,534,716,10,14,24,0.7447698744769874,15.541683875662583
Task_25326,582,346,136,122,258,1.6772334293948126,17.569981448506997
Task_25327,2752,518,17,127,144,5.302504816955684,51.735406816261694
Task_25328,2903,310,129,12,141,9.334405144694534,52.77790740128017
Task_25329,552,693,10,104,114,0.7953890489913544,17.206692242662157
Task_25330,1923,756,185,100,285,2.5402906208718625,40.19216559245909
Task_25331,2283,797,142,39,181,2.8609022556390977,44.93552599546428
Task_25332,1972,663,199,189,388,2.9698795180722892,41.2713552740323
Task_25333,2511,200,24,71,95,12.492537313432836,46.17369337473064
Task_25334,2927,627,180,118,298,4.660828025477707,55.77324918514057
Task_25335,2479,998,75,138,213,2.4814814814814814,49.553047257985924
Task_25336,1392,313,70,85,155,4.43312101910828,29.649458744328527
Task_25337,2235,555,169,173,342,4.01978417266187,44.86380784977399
Task_25338,1600,517,44,173,217,3.088803088803089,34.1420136524171
Task_25339,1842,873,101,133,234,2.1075514874141876,39.092434283704954
Task_25340,1699,418,168,181,349,4.054892601431981,35.982751403935445
Task_25341,943,679,156,110,266,1.386764705882353,24.303151490075752
Task_25342,1623,825,34,139,173,1.9648910411622276,35.19059105755927
Task_25343,1099,660,153,110,263,1.6626323751891074,26.741895262761393
Task_25344,2268,1000,135,40,175,2.265734265734266,45.313818051906274
Task_25345,1193,168,79,73,152,7.059171597633136,25.509273375780307
Task_25346,2689,255,59,75,134,10.50390625,49.787142435207706
Task_25347,504,954,161,40,201,0.5277486910994764,17.731110642934816
Task_25348,2277,71,121,42,163,31.625,41.39087974710716
Task_25349,1399,703,91,163,254,1.9872159090909092,31.677760466008575
Task_25350,822,1012,60,196,256,0.8114511352418559,23.559005243755035
Task_25351,2001,186,86,21,107,10.70053475935829,37.85153303411369
Task_25352,1194,620,152,64,216,1.922705314009662,27.578999717296643
Task_25353,605,789,180,74,254,0.7658227848101266,19.080946618252774
Task_25354,1906,755,11,161,172,2.5211640211640214,39.43173647211945
Task_25355,1073,805,60,151,211,1.3312655086848635,26.634526320498953
Task_25356,2696,966,136,74,210,2.7880041365046537,52.541511785794995
Task_25357,1419,117,168,20,188,12.025423728813559,28.63782725719558
Task_25358,2875,483,188,172,360,5.940082644628099,54.843977964473936
Task_25359,1808,86,99,58,157,20.7816091954023,34.329177482216544
Task_25360,2078,811,189,112,301,2.5591133004926108,42.90945163198317
Task_25361,2768,866,64,117,181,3.192618223760092,53.512898017401966
Task_25362,1310,902,57,100,157,1.4507198228128462,30.17641222230465
Task_25363,2436,194,19,33,52,12.492307692307692,44.22218138918527
Task_25364,1027,669,14,17,31,1.5328358208955224,23.01488012141665
Task_25365,2861,1020,15,177,192,2.802154750244858,55.55655696105754
Task_25366,2908,956,72,64,136,3.038662486938349,55.404451252470324
Task_25367,2404,832,148,175,323,2.885954381752701,48.33166060883928
Task_25368,2332,955,135,101,236,2.4393305439330546,47.07425991907735
Task_25369,1575,253,132,172,304,6.200787401574803,33.258523866004005
Task_25370,2537,149,90,127,217,16.913333333333334,47.396079828265535
Task_25371,767,813,186,39,225,0.9422604422604423,21.286110660231042
Task_25372,908,294,11,26,37,3.077966101694915,20.080174302791665
Task_25373,2609,869,129,115,244,2.9988505747126437,51.25153028868152
Task_25374,854,184,67,200,267,4.616216216216216,21.510224035832394
Task_25375,1927,629,40,19,59,3.0587301587301585,37.36173727516871
Task_25376,1206,1002,124,86,210,1.2023928215353938,29.11288091054487
Task_25377,2112,864,107,77,184,2.4416184971098267,42.8335022882709
Task_25378,2230,84,34,30,64,26.235294117647058,39.896484933508624
Task_25379,990,837,178,68,246,1.1813842482100239,25.150738391137622
Task_25380,2359,297,74,113,187,7.916107382550336,45.236472163831856
Task_25381,1683,887,157,112,269,1.8952702702702702,36.743615294820806
Task_25382,904,238,18,135,153,3.782426778242678,21.631475814736365
Task_25383,2313,850,195,176,371,2.717978848413631,47.163955930833616
Task_25384,1188,369,180,28,208,3.210810810810811,26.370780428964153
Task_25385,2380,208,183,148,331,11.38755980861244,45.894506851370785
Task_25386,1159,962,155,73,228,1.2035306334371756,28.181166773532173
Task_25387,983,988,116,48,164,0.993933265925177,25.005520901184273
Task_25388,1884,83,49,117,166,22.428571428571427,36.25693864152616
Task_25389,2700,253,100,33,133,10.62992125984252,49.42721420003921
Task_25390,914,502,43,22,65,1.8170974155069584,20.997086597557104
Task_25391,801,501,101,120,221,1.595617529880478,21.352212505817047
Task_25392,2472,343,146,41,187,7.186046511627907,46.5042324291638
Task_25393,2138,531,52,21,73,4.018796992481203,40.43832085518154
Task_25394,2033,594,26,62,88,3.4168067226890755,39.73183558121561
Task_25395,1037,633,171,191,362,1.635646687697161,26.240728935771177
Task_25396,1925,832,117,166,283,2.310924369747899,40.548970516109435
Task_25397,747,972,14,123,137,0.7677286742034943,21.402081931072633
Task_25398,1749,585,137,161,298,2.984641638225256,37.04715966075344
Task_25399,2979,827,139,102,241,3.597826086956522,56.949579350732904
Task_25400,2990,263,70,165,235,11.325757575757576,55.40560551638351
Task_25401,1403,268,44,104,148,5.215613382899628,29.620947137397735
Task_25402,995,854,117,185,302,1.1637426900584795,25.92701906375115
Task_25403,1088,686,58,131,189,1.5836972343522562,26.386905726370156
Task_25404,2107,818,96,127,223,2.572649572649573,43.06891791501014
Task_25405,2604,1011,78,33,111,2.5731225296442686,50.05652576690229
Task_25406,1563,331,14,143,157,4.707831325301205,32.41945355288989
Task_25407,2292,206,197,197,394,11.072463768115941,44.85316729814864
Task_25408,1507,88,133,129,262,16.93258426966292,30.867248288081367
Task_25409,1050,993,139,184,323,1.056338028169014,27.33062545902092
Task_25410,2831,480,54,10,64,5.885654885654886,51.10771743918095
Task_25411,671,701,11,187,198,0.9558404558404558,19.801475822664795
Task_25412,2313,930,122,190,312,2.484425349087003,47.16827344676407
Task_25413,1851,644,88,121,209,2.869767441860465,38.347448869866376
Task_25414,2536,609,125,53,178,4.157377049180328,48.62246158705523
Task_25415,1109,695,70,171,241,1.5933908045977012,27.07196147455329
Task_25416,1293,541,55,41,96,2.385608856088561,27.593556773501685
Task_25417,554,211,92,179,271,2.6132075471698113,16.859137940316643
Task_25418,2331,881,136,180,316,2.642857142857143,47.30398195325379
Task_25419,1663,1018,198,38,236,1.631992149165849,36.07733649752196
Task_25420,2560,722,125,188,313,3.540802213001383,50.43163113443544
Task_25421,2380,954,111,198,309,2.492146596858639,48.30297401364692
Task_25422,2534,196,137,17,154,12.862944162436548,46.58393260505816
Task_25423,732,698,65,147,212,1.0472103004291846,20.8476364197689
Task_25424,1850,819,123,156,279,2.2560975609756095,39.28745793100964
Task_25425,2861,709,115,198,313,4.029577464788733,55.17330839711493
Task_25426,1889,577,101,150,251,3.2681660899653977,39.0109233305544
Task_25427,1246,586,128,104,232,2.122657580919932,28.703809569390327
Task_25428,2212,177,199,170,369,12.426966292134832,43.077179983473684
Task_25429,2747,746,12,120,132,3.677376171352075,52.37112437089008
Task_25430,1719,329,113,23,136,5.209090909090909,34.1153260648886
Task_25431,2964,606,54,25,79,4.883031301482702,53.896164019870604
Task_25432,1210,667,174,176,350,1.811377245508982,29.024139406491713
Task_25433,1379,726,152,44,196,1.8968363136176065,30.47839243650492
Task_25434,2760,737,139,166,305,3.7398373983739837,53.57887707449013
Task_25435,2649,593,193,172,365,4.459595959595959,51.64313404563526
Task_25436,990,593,153,102,255,1.6666666666666667,24.75895180268074
Task_25437,1426,851,55,73,128,1.6737089201877935,31.845932753850466
Task_25438,1607,687,14,86,100,2.3357558139534884,33.67126514960283
Task_25439,640,885,187,137,324,0.7223476297968398,20.55579917081008
Task_25440,1302,714,107,116,223,1.8209790209790209,29.9675572747298
Task_25441,1619,212,16,58,74,7.60093896713615,31.539953740253946
Task_25442,2522,575,146,54,200,4.378472222222222,48.36219309827328
Task_25443,1135,298,62,199,261,3.7959866220735785,26.36805984775712
Task_25444,1821,881,185,158,343,2.064625850340136,39.312513108802875
Task_25445,2949,795,103,188,291,3.7047738693467336,56.725019071975034
Task_25446,1552,718,121,112,233,2.1585535465924894,33.979444194724984
Task_25447,2189,83,147,80,227,26.05952380952381,41.063159632058074
Task_25448,1382,225,119,165,284,6.115044247787611,30.01184404057935
Task_25449,2435,503,170,143,313,4.8313492063492065,47.68898014898898
Task_25450,1217,158,61,148,209,7.654088050314465,26.66550585329338
Task_25451,2740,113,150,109,259,24.035087719298247,50.39530545467355
Task_25452,2967,730,59,176,235,4.0588235294117645,56.60500987372973
Task_25453,2400,777,56,95,151,3.0848329048843186,47.11920678626894
Task_25454,2685,817,32,77,109,3.28239608801956,51.26277430320598
Task_25455,2682,515,155,52,207,5.1976744186046515,50.76731099117327
Task_25456,2030,750,190,117,307,2.70306258322237,41.992542597080494
Task_25457,1915,695,10,20,30,2.7514367816091956,37.16340972120737
Task_25458,1210,755,83,130,213,1.6005291005291005,28.635429418475436
Task_25459,768,736,75,111,186,1.0420624151967435,21.334576762849533
Task_25460,2020,296,105,161,266,6.801346801346801,40.2528522173355
Task_25461,804,503,19,121,140,1.5952380952380953,20.836554172790027
Task_25462,1787,143,31,90,121,12.409722222222221,34.45399289304658
Task_25463,1396,96,75,95,170,14.391752577319588,28.68799085916116
Task_25464,2211,529,195,167,362,4.1716981132075475,44.482094169833694
Task_25465,2897,581,16,50,66,4.97766323024055,52.858440592723014
Task_25466,714,861,154,159,313,0.8283062645011601,21.546504154175647
Task_25467,2541,979,109,157,266,2.592857142857143,50.67827484082858
Task_25468,1661,680,192,120,312,2.4390602055800295,35.95498890759503
Task_25469,1402,285,177,183,360,4.9020979020979025,30.901646039877985
Task_25470,2606,67,86,78,164,38.3235294117647,47.124128204789685
Task_25471,880,1017,52,147,199,0.8644400785854617,24.14869812823763
Task_25472,1912,380,113,93,206,5.018372703412074,38.43955314281853
Task_25473,608,334,199,122,321,1.8149253731343284,18.240711832976384
Task_25474,1006,172,144,145,289,5.815028901734104,23.674461517367074
Task_25475,1400,897,157,76,233,1.55902004454343,31.875015901074295
Task_25476,2281,873,145,188,333,2.6098398169336385,46.575107035574604
Task_25477,1783,535,85,86,171,3.326492537313433,36.63192661814839
Task_25478,2118,614,74,147,221,3.44390243902439,42.67547617918577
Task_25479,2513,266,117,130,247,9.411985018726591,47.80875548876219
Task_25480,2833,196,57,121,178,14.380710659898478,52.327227336478565
Task_25481,2442,665,16,78,94,3.6666666666666665,46.677738106383565
Task_25482,2361,562,182,107,289,4.19360568383659,46.545684615199185
Task_25483,1464,885,64,43,107,1.652370203160271,31.457210063582068
Task_25484,1387,830,16,190,206,1.6690734055354994,31.666071045849833
Task_25485,1914,547,36,189,225,3.4927007299270074,39.266270710905204
Task_25486,1723,567,92,52,144,3.033450704225352,35.40018827202249
Task_25487,1083,878,58,98,156,1.2320819112627985,26.492865951769435
Task_25488,2153,197,89,195,284,10.873737373737374,42.14430504088813
Task_25489,2342,589,80,38,118,3.9694915254237286,44.613816018793415
Task_25490,1146,761,119,155,274,1.5039370078740157,27.88681168144605
Task_25491,2640,624,188,149,337,4.224,51.439503353077875
Task_25492,2339,746,106,58,164,3.1311914323962515,45.84581810919564
Task_25493,539,578,149,10,159,0.9309153713298791,16.491995029488393
Task_25494,886,237,167,51,218,3.722689075630252,21.43994807546257
Task_25495,859,169,65,84,149,5.052941176470588,20.429041621173162
Task_25496,1854,631,79,171,250,2.9335443037974684,38.713360437317185
Task_25497,2353,779,178,79,257,3.0166666666666666,46.81720453903009
Task_25498,622,589,16,113,129,1.0542372881355933,18.166477720600763
Task_25499,881,888,188,70,258,0.9910011248593926,23.699616625428774
Task_25500,2400,420,18,103,121,5.7007125890736345,45.667849906772425
Task_25501,2466,496,182,104,286,4.961770623742455,47.978283786401505
Task_25502,723,562,175,117,292,1.2841918294849024,20.575302329296672
Task_25503,671,681,58,173,231,0.9838709677419355,19.97553283487724
Task_25504,1123,474,61,128,189,2.3642105263157895,26.309852943835157
Task_25505,1262,158,149,169,318,7.937106918238993,27.85672515058575
Task_25506,2946,800,76,88,164,3.6779026217228465,55.995931452141
Task_25507,1215,290,135,138,273,4.175257731958763,27.504048331066468
Task_25508,2602,758,43,116,159,3.4281949934123848,50.23881699170016
Task_25509,1716,927,51,20,71,1.8491379310344827,34.94219233425567
Task_25510,2517,616,160,152,312,4.079416531604538,49.357776323960785
Task_25511,2991,194,97,193,290,15.338461538461539,55.35977444659682
Task_25512,1815,979,54,166,220,1.8520408163265305,39.049456339984765
Task_25513,2898,489,56,39,95,5.914285714285715,52.82940786434571
Task_25514,2329,311,176,14,190,7.464743589743589,44.0432286225224
Task_25515,1013,759,129,163,292,1.3328947368421054,25.862315689514606
Task_25516,1926,819,196,100,296,2.348780487804878,40.486099191297676
Task_25517,574,859,31,46,77,0.6674418604651163,17.16860534577108
Task_25518,1194,734,156,30,186,1.6244897959183673,27.521860372958468
Task_25519,2017,809,193,60,253,2.4901234567901236,41.320474060791796
Task_25520,1973,433,137,40,177,4.546082949308755,38.86364051759693
Task_25521,1531,179,121,35,156,8.505555555555556,30.59339832290583
Task_25522,1932,425,59,130,189,4.535211267605634,38.963691422156806
Task_25523,1011,320,101,192,293,3.149532710280374,24.545755226306245
Task_25524,811,258,193,147,340,3.1312741312741315,21.32867806769595
Task_25525,2004,690,102,183,285,2.9001447178002895,41.390075374846994
Task_25526,1219,782,59,23,82,1.5568326947637292,27.04261566845156
Task_25527,777,739,72,134,206,1.05,21.63160122087039
Task_25528,2432,381,161,176,337,6.366492146596858,47.398563054859345
Task_25529,1936,957,32,80,112,2.020876826722338,39.929886584118016
Task_25530,1925,716,186,42,228,2.684797768479777,39.24501597304329
Task_25531,1592,532,95,34,129,2.9868667917448404,32.85530692564151
Task_25532,1459,142,47,170,217,10.202797202797203,30.389613001854247
Task_25533,2931,331,13,114,127,8.828313253012048,53.89853787312881
Task_25534,2451,634,53,116,169,3.8598425196850394,47.69623743863276
Task_25535,2204,522,93,199,292,4.21414913957935,44.11873905399523
Task_25536,1476,174,163,79,242,8.434285714285714,30.673319379700786
Task_25537,1557,77,153,103,256,19.96153846153846,31.521423526429118
Task_25538,1231,91,146,188,334,13.380434782608695,26.968690133798685
Task_25539,1829,481,113,42,155,3.7946058091286305,36.515173252584994
Task_25540,2472,145,127,114,241,16.931506849315067,46.421850837697185
Task_25541,942,362,37,40,77,2.5950413223140494,21.151321076684116
Task_25542,928,603,46,81,127,1.5364238410596027,23.03338243133237
Task_25543,1750,161,132,86,218,10.802469135802468,34.886307979555234
Task_25544,2564,215,135,177,312,11.87037037037037,48.78406013904307
Task_25545,2303,461,20,193,213,4.984848484848484,45.07121673321103
Task_25546,2993,946,19,171,190,3.160506863780359,57.39784098010535
Task_25547,1256,631,114,190,304,1.9873417721518987,29.45353835700482
Task_25548,2798,137,96,20,116,20.27536231884058,49.860783432384295
Task_25549,1817,165,196,77,273,10.94578313253012,36.083678190892364
Task_25550,2104,918,56,143,199,2.2894450489662677,43.310518085893335
Task_25551,1481,868,106,92,198,1.7042577675489068,33.06936726852818
Task_25552,2634,350,187,131,318,7.504273504273504,50.337991057084764
Task_25553,1994,289,146,172,318,6.875862068965517,40.06821124428536
Task_25554,1192,505,111,119,230,2.355731225296443,27.60741445996506
Task_25555,1924,326,196,181,377,5.883792048929664,39.366337946700256
Task_25556,2500,192,37,106,143,12.953367875647668,46.63167825801003
Task_25557,2978,754,181,18,199,3.9443708609271524,55.81273628892841
Task_25558,1513,516,53,98,151,2.9264990328820115,32.21770911304852
Task_25559,684,934,179,15,194,0.7315508021390374,20.16194598339347
Task_25560,949,187,34,70,104,5.047872340425532,21.612723835159688
Task_25561,2911,685,53,144,197,4.243440233236152,55.35933690492889
Task_25562,1000,946,39,103,142,1.0559662090813093,25.257552160257728
Task_25563,691,345,115,183,298,1.9971098265895955,19.574040563080835
Task_25564,2834,612,182,96,278,4.623164763458401,54.158390053195916
Task_25565,2793,747,72,161,233,3.733957219251337,53.86130035816666
Task_25566,2885,550,111,134,245,5.235934664246824,54.64572941572112
Task_25567,2980,265,25,42,67,11.203007518796992,52.981767232655464
Task_25568,1036,861,150,24,174,1.2018561484918793,25.30601969342987
Task_25569,2486,965,145,158,303,2.5734989648033126,49.93129844786146
Task_25570,2780,897,65,52,117,3.0957683741648108,52.814238362862454
Task_25571,1772,443,195,134,329,3.990990990990991,37.059587156982836
Task_25572,649,143,74,194,268,4.506944444444445,18.000085249507126
Task_25573,770,831,54,103,157,0.9254807692307693,21.392981629161536
Task_25574,1207,1011,28,153,181,1.1926877470355732,29.131552298061887
Task_25575,2433,478,63,23,86,5.079331941544885,45.31514871587415
Task_25576,673,761,158,25,183,0.8832020997375328,19.346895569097786
Task_25577,1125,183,110,179,289,6.114130434782608,25.77754384789499
Task_25578,2315,478,86,140,226,4.832985386221294,45.27229271412977
Task_25579,2044,75,172,176,348,26.894736842105264,39.65315101105984
Task_25580,2099,579,84,28,112,3.6189655172413793,40.707512800447326
Task_25581,1128,982,134,16,150,1.1475076297049847,26.857496321019298
Task_25582,713,779,102,23,125,0.9141025641025641,19.679917629827568
Task_25583,1175,109,68,31,99,10.681818181818182,23.943437492800324
Task_25584,2452,292,169,119,288,8.368600682593856,47.106180125225535
Task_25585,2152,498,80,58,138,4.312625250501002,41.88501599699466
Task_25586,2202,855,88,120,208,2.572429906542056,44.56290688429063
Task_25587,1599,199,49,138,187,7.995,32.959811419002314
Task_25588,672,738,181,117,298,0.9093369418132612,20.379169869077433
Task_25589,2246,95,183,197,380,23.395833333333332,43.09281514160571
Task_25590,2822,303,72,147,219,9.282894736842104,52.784841220818954
Task_25591,1019,918,93,65,158,1.1088139281828073,25.357139895926807
Task_25592,2403,815,180,15,195,2.9448529411764706,46.86527363409355
Task_25593,1384,596,115,189,304,2.318257956448911,31.369657013807906
Task_25594,1959,198,184,118,302,9.844221105527637,39.07543842368052
Task_25595,2060,783,193,183,376,2.627551020408163,42.97884086795051
Task_25596,2048,562,144,27,171,3.6376554174067497,40.36594114965438
Task_25597,1985,231,173,164,337,8.556034482758621,39.79452465778273
Task_25598,1515,817,114,195,309,1.852078239608802,34.166021491082546
Task_25599,1592,223,11,200,211,7.107142857142857,33.00385501881387
Task_25600,1690,769,44,25,69,2.1948051948051948,34.18396959626394
Task_25601,1339,558,195,94,289,2.395348837209302,30.32424911861334
Task_25602,1800,914,32,195,227,1.9672131147540983,38.61130491624372
Task_25603,2648,721,32,144,176,3.667590027700831,51.115820545514936
Task_25604,738,894,12,13,25,0.8245810055865922,19.337375473020572
Task_25605,1404,559,166,122,288,2.507142857142857,31.39981924662459
Task_25606,1171,523,140,47,187,2.234732824427481,26.525163777082934
Task_25607,2467,953,15,38,53,2.5859538784067087,47.09275045754591
Task_25608,1364,481,197,35,232,2.8298755186721993,29.6324310421921
Task_25609,2568,726,44,92,136,3.53232462173315,49.47165279284787
Task_25610,2624,318,61,25,86,8.225705329153605,47.78902292995656
Task_25611,1489,453,176,26,202,3.2797356828193833,31.354140170961312
Task_25612,1099,989,154,67,221,1.11010101010101,27.209491491067553
Task_25613,1842,451,99,153,252,4.075221238938053,37.87575581954706
Task_25614,1807,452,165,52,217,3.988962472406181,36.75773422447422
Task_25615,1781,748,190,193,383,2.3778371161548733,38.4956273127978
Task_25616,2696,915,133,152,285,2.943231441048035,53.01296509405089
Task_25617,2113,161,13,180,193,13.04320987654321,40.65258102793685
Task_25618,2177,361,50,142,192,6.013812154696133,42.69241005202841
Task_25619,2207,911,36,105,141,2.419956140350877,44.360465069131614
Task_25620,2593,144,53,53,106,17.882758620689657,46.71102230602858
Task_25621,2879,982,51,30,81,2.928789420142421,54.05848124061066
Task_25622,1793,394,87,195,282,4.539240506329114,37.071234199910634
Task_25623,1394,733,117,83,200,1.8991825613079019,31.260185472129432
Task_25624,563,1015,97,151,248,0.5541338582677166,19.43747372285461
Task_25625,1608,106,117,110,227,15.02803738317757,32.38686330752862
Task_25626,2424,754,73,38,111,3.2105960264900664,46.43103785602895
Task_25627,734,833,140,186,326,0.8800959232613909,21.875720716359158
Task_25628,1929,735,45,157,202,2.620923913043478,39.95904880419284
Task_25629,1180,202,112,78,190,5.812807881773399,26.062459642504546
Task_25630,3000,137,11,93,104,21.73913043478261,53.38226672545795
Task_25631,1012,828,117,35,152,1.220747889022919,24.641326384306822
Task_25632,2410,999,78,56,134,2.41,47.544697583794324
Task_25633,2494,569,138,23,161,4.375438596491228,47.330716576582596
Task_25634,585,360,78,56,134,1.6204986149584488,16.648195669217372
Task_25635,2395,610,13,99,112,3.9198036006546646,46.114348844683015
Task_25636,1975,220,189,25,214,8.936651583710407,38.28988543299363
Task_25637,2729,693,105,13,118,3.9322766570605188,50.99640396241562
Task_25638,874,701,77,162,239,1.245014245014245,23.28165882277325
Task_25639,1346,104,111,20,131,12.81904761904762,26.906691750930793
Task_25640,2774,398,17,126,143,6.9523809523809526,51.683386256579205
Task_25641,865,264,83,144,227,3.2641509433962264,21.723589885229472
Task_25642,1403,506,17,70,87,2.767258382642998,29.545805659586463
Task_25643,1746,122,75,196,271,14.195121951219512,35.145914737162336
Task_25644,2511,294,145,113,258,8.511864406779662,47.901971542204905
Task_25645,910,228,56,62,118,3.9737991266375547,21.107057705881534
Task_25646,1982,955,183,39,222,2.073221757322176,40.862924301539714
Task_25647,1250,423,67,153,220,2.94811320754717,28.345201907734197
Task_25648,868,558,113,129,242,1.552772808586762,22.669539603034707
Task_25649,1957,882,64,77,141,2.216308040770102,40.26890585991275
Task_25650,556,714,11,54,65,0.7776223776223776,16.362987633269224
Task_25651,2663,646,37,23,60,4.115919629057187,49.17698266852298
Task_25652,2787,153,118,197,315,18.0974025974026,51.89162702858434
Task_25653,510,362,168,12,180,1.4049586776859504,15.366714834673937
Task_25654,1463,521,22,46,68,2.8026819923371646,29.876950599589858
Task_25655,1384,469,195,44,239,2.9446808510638296,29.944625924178727
Task_25656,1253,713,55,196,251,1.7549019607843137,29.48788503382536
Task_25657,1744,144,52,19,71,12.027586206896551,32.76296178777441
Task_25658,1803,877,147,170,317,2.0535307517084282,38.915263209505966
Task_25659,1180,758,181,51,232,1.5546772068511199,27.799377225506287
Task_25660,903,79,58,162,220,11.2875,21.271852400303597
Task_25661,2560,218,148,70,218,11.689497716894977,47.87444006634573
Task_25662,2943,413,174,188,362,7.108695652173913,55.721435352972094
Task_25663,1860,456,142,24,166,4.070021881838074,37.05415284283651
Task_25664,2551,486,64,17,81,5.238193018480493,47.183050558220906
Task_25665,675,986,173,40,213,0.6838905775075987,20.49398552480736
Task_25666,2790,352,101,35,136,7.903682719546742,51.18277362036781
Task_25667,1089,628,70,51,121,1.7313195548489666,25.20702628858388
Task_25668,2503,604,151,150,301,4.137190082644628,49.045373160974975
Task_25669,2580,512,112,34,146,5.029239766081871,48.5274987307647
Task_25670,897,472,135,103,238,1.8964059196617336,22.84624135964006
Task_25671,1419,234,172,47,219,6.038297872340426,29.66812923612032
Task_25672,1734,459,101,151,252,3.7695652173913046,36.18737113592524
Task_25673,2056,976,76,120,196,2.104401228249744,42.68050485009502
Task_25674,2064,662,136,193,329,3.1131221719457014,42.4653462598899
Task_25675,2291,636,148,168,316,3.596546310832025,45.88338367386687
Task_25676,1286,1008,46,166,212,1.2745292368681864,30.61208377318482
Task_25677,2194,301,87,96,183,7.264900662251655,42.514456515091304
Task_25678,2932,548,133,121,254,5.340619307832423,55.404987552993326
Task_25679,574,384,185,185,370,1.490909090909091,18.130727998714978
Task_25680,1488,621,129,114,243,2.392282958199357,32.710232222295936
Task_25681,2514,808,21,103,124,3.107540173053152,48.7666491032309
Task_25682,2280,415,116,186,302,5.480769230769231,44.96284337023197
Task_25683,1894,361,170,66,236,5.232044198895028,37.926601161641656
Task_25684,1335,1022,159,123,282,1.3049853372434017,31.661415693171403
Task_25685,1633,660,141,139,280,2.470499243570348,35.33245355869646
Task_25686,2020,253,56,94,150,7.952755905511811,39.38835244042776
Task_25687,1302,753,27,70,97,1.726790450928382,28.822406726733607
Task_25688,636,943,199,125,324,0.673728813559322,20.682273268217966
Task_25689,2148,498,77,35,112,4.304609218436874,41.218722161175485
Task_25690,2083,725,66,146,212,2.869146005509642,42.44552535348106
Task_25691,582,336,166,129,295,1.7270029673590503,17.71546627150639
Task_25692,1261,588,123,113,236,2.140916808149406,28.9788358905838
Task_25693,602,126,133,12,145,4.74015748031496,15.503989815144083
Task_25694,1187,808,111,65,176,1.4672435105067985,27.84838358512908
Task_25695,699,881,13,85,98,0.7925170068027211,19.845356376775374
Task_25696,2616,314,18,47,65,8.304761904761905,47.44345585550213
Task_25697,1764,990,103,175,278,1.7800201816347123,38.46657305812298
Task_25698,1706,335,121,12,133,5.0773809523809526,33.910849770629206
Task_25699,1715,867,76,165,241,1.9758064516129032,37.20688535305623
Task_25700,2656,740,146,196,342,3.5843454790823213,52.151561629438824
Task_25701,2536,957,67,134,201,2.6471816283924845,50.27826023516624
Task_25702,616,164,157,78,235,3.7333333333333334,17.03053812182691
Task_25703,1163,87,161,118,279,13.215909090909092,25.52639184902453
Task_25704,2055,538,67,135,202,3.8126159554730985,41.34728386701812
Task_25705,2262,996,72,75,147,2.2688064192577735,45.487142113582564
Task_25706,2232,73,129,164,293,30.16216216216216,42.34690353113581
Task_25707,705,992,163,93,256,0.7099697885196374,21.545339700159747
Task_25708,2881,838,189,158,347,3.433849821215733,55.99127855131934
Task_25709,2233,762,39,149,188,2.926605504587156,44.75298936886026
Task_25710,2213,372,155,123,278,5.932975871313673,43.56015298758431
Task_25711,2079,636,59,107,166,3.2637362637362637,41.79564015883799
Task_25712,1872,422,22,119,141,4.425531914893617,37.491297108691555
Task_25713,1144,198,118,141,259,5.748743718592965,26.05167228547515
Task_25714,1068,366,31,35,66,2.9100817438692097,23.05446881488615
Task_25715,2132,222,137,81,218,9.560538116591928,41.320716442375776
Task_25716,2150,170,180,10,190,12.573099415204679,40.532905929415996
Task_25717,1861,552,156,179,335,3.365280289330922,38.909455507961276
Task_25718,1607,960,135,157,292,1.672216441207076,35.922264886580685
Task_25719,2991,420,153,14,167,7.104513064133017,54.77246220987279
Task_25720,985,520,128,158,286,1.890595009596929,24.686841235474997
Task_25721,1157,197,135,116,251,5.843434343434343,26.17938348918496
Task_25722,1102,299,106,171,277,3.6733333333333333,25.813539458007455
Task_25723,2114,644,52,190,242,3.277519379844961,42.87607193937614
Task_25724,2447,561,21,20,41,4.354092526690391,45.27081195735701
Task_25725,2860,870,96,159,255,3.283582089552239,55.353449564087384
Task_25726,2590,664,108,117,225,3.8947368421052633,50.222865958013905
Task_25727,805,186,57,153,210,4.304812834224599,20.502017270430127
Task_25728,2552,435,13,149,162,5.853211009174312,48.49073602826676
Task_25729,1048,784,191,103,294,1.3350318471337579,26.41542513072397
Task_25730,1057,677,93,113,206,1.5589970501474926,25.890283356940632
Task_25731,942,209,51,42,93,4.485714285714286,20.99886729153531
Task_25732,742,748,135,186,321,0.9906542056074766,21.71967078847162
Task_25733,1199,590,96,186,282,2.0287648054145517,28.325290015247273
Task_25734,1500,754,45,82,127,1.9867549668874172,32.6523072241776
Task_25735,974,884,47,93,140,1.1005649717514123,24.712975007083045
Task_25736,2802,1006,87,42,129,2.7825223435948363,53.487766280995
Task_25737,976,828,122,194,316,1.1773220747889024,25.630845663151018
Task_25738,2027,722,107,28,135,2.8035961272475793,40.28896081248241
Task_25739,958,901,189,133,322,1.0620842572062084,25.50895216977528
Task_25740,1547,728,129,30,159,2.122085048010974,32.85686698098142
Task_25741,1033,117,139,51,190,8.754237288135593,22.739079276958364
Task_25742,1547,382,164,38,202,4.039164490861618,32.09132576963024
Task_25743,2690,602,88,185,273,4.461028192371476,51.8843627003772
Task_25744,2913,66,99,136,235,43.47761194029851,52.6711750485154
Task_25745,2527,522,51,176,227,4.831739961759082,48.965724229627476
Task_25746,2709,866,141,76,217,3.124567474048443,52.476098103494486
Task_25747,2188,738,162,54,216,2.9607577807848444,43.659757154027055
Task_25748,1256,334,51,19,70,3.7492537313432837,25.78341884631281
Task_25749,1721,795,189,175,364,2.1620603015075375,37.57978321640682
Task_25750,2082,455,29,53,82,4.565789473684211,39.980308689642705
Task_25751,588,572,99,145,244,1.0261780104712042,18.296203095362994
Task_25752,1480,513,126,102,228,2.8793774319066148,32.158317363613364
Task_25753,865,410,135,84,219,2.104622871046229,21.95659104339397
Task_25754,830,239,90,187,277,3.4583333333333335,21.33552221384427
Task_25755,732,806,153,76,229,0.9070631970260223,21.041149908316417
Task_25756,1841,995,160,97,257,1.8483935742971886,39.5351329175363
Task_25757,741,610,93,145,238,1.2127659574468086,20.834374856518178
Task_25758,2795,287,85,155,240,9.70486111111111,52.353150308354905
Task_25759,2959,252,152,163,315,11.695652173913043,55.15939571797403
Task_25760,2524,836,40,191,231,3.015531660692951,49.86413571239664
Task_25761,1534,215,129,39,168,7.101851851851852,31.115579299432497
Task_25762,766,950,112,189,301,0.8054679284963197,22.651386614073285
Task_25763,2419,391,55,85,140,6.170918367346939,46.10402944856303
Task_25764,1327,664,119,103,222,1.9954887218045112,30.18404358542352
Task_25765,2472,994,101,166,267,2.4844221105527637,49.649282468336345
Task_25766,2874,642,46,165,211,4.469673405909798,54.692194195344634
Task_25767,1436,944,15,30,45,1.5195767195767196,30.62036141640942
Task_25768,1580,686,160,105,265,2.2998544395924307,34.45692807349676
Task_25769,1844,797,41,94,135,2.31077694235589,38.252821894354184
Task_25770,2342,819,35,48,83,2.8560975609756096,45.137892709107895
Task_25771,1682,1013,12,124,136,1.6587771203155819,36.29074547498486
Task_25772,1109,683,185,44,229,1.621345029239766,26.233427676773672
Task_25773,2853,467,10,100,110,6.096153846153846,52.87946769169284
Task_25774,2584,555,18,37,55,4.64748201438849,47.69942423262733
Task_25775,2228,619,178,110,288,3.5935483870967744,44.62057387100881
Task_25776,2365,325,80,155,235,7.254601226993865,45.712347880669114
Task_25777,1929,793,148,85,233,2.429471032745592,40.0694996834518
Task_25778,833,262,147,167,314,3.167300380228137,21.601527811103313
Task_25779,732,849,190,26,216,0.8611764705882353,20.726313442040887
Task_25780,2574,103,144,72,216,24.75,47.11148481593407
Task_25781,2432,558,83,89,172,4.350626118067979,47.07904393503478
Task_25782,2313,511,181,33,214,4.517578125,44.667098536238406
Task_25783,1324,966,155,105,260,1.3691830403309204,31.20243300384941
Task_25784,1476,648,52,118,170,2.274268104776579,32.305493545808744
Task_25785,2912,662,15,35,50,4.392156862745098,53.19141382899348
Task_25786,656,681,92,166,258,0.9618768328445748,19.80379459315974
Task_25787,1447,141,180,31,211,10.190140845070422,29.48030513477934
Task_25788,536,818,99,147,246,0.6544566544566545,18.39743358935463
Task_25789,2792,605,159,181,340,4.6072607260726075,53.84660718893682
Task_25790,1534,192,48,24,72,7.948186528497409,29.99251033419912
Task_25791,1213,308,142,119,261,3.925566343042071,27.449674997406785
Task_25792,1191,667,140,45,185,1.782934131736527,27.236775652359878
Task_25793,2204,547,117,83,200,4.021897810218978,43.50357920354949
Task_25794,2746,660,72,102,174,4.154311649016641,52.462832287112086
Task_25795,2538,468,34,73,107,5.411513859275053,47.733388097295354
Task_25796,1006,268,30,173,203,3.7397769516728623,23.8669433475083
Task_25797,1332,275,137,44,181,4.826086956521739,28.213112711107865
Task_25798,2716,282,10,46,56,9.597173144876326,48.91198251791756
Task_25799,1610,878,14,155,169,1.8316268486916951,35.110340115968846
Task_25800,2820,472,91,30,121,5.961945031712474,51.883613619037675
Task_25801,933,206,191,75,266,4.507246376811594,22.46678265743839
Task_25802,632,221,40,70,110,2.8468468468468466,16.78141713716632
Task_25803,1963,469,43,152,195,4.176595744680851,39.605513041750406
Task_25804,751,551,19,158,177,1.3605072463768115,20.490264813908748
Task_25805,1971,265,157,82,239,7.409774436090226,39.06200350804662
Task_25806,2696,719,41,45,86,3.7444444444444445,50.33966902824679
Task_25807,1687,679,25,49,74,2.4808823529411765,33.98132646280472
Task_25808,622,324,94,196,290,1.9138461538461538,18.409535465676466
Task_25809,996,889,195,46,241,1.1191011235955055,25.11711903631442
Task_25810,2706,538,36,157,193,5.020408163265306,51.58671950702358
Task_25811,2085,499,26,39,65,4.17,39.55550454066816
Task_25812,1196,735,179,143,322,1.625,28.826125773009057
Task_25813,1692,156,183,87,270,10.777070063694268,34.18253975449895
Task_25814,1459,168,18,10,28,8.633136094674557,28.22159296018802
Task_25815,1289,399,55,106,161,3.2225,28.378628317667097
Task_25816,1290,259,42,173,215,4.961538461538462,28.392592886592606
Task_25817,1748,185,54,103,157,9.397849462365592,34.76703509371172
Task_25818,665,870,147,56,203,0.7634902411021814,19.905579398085695
Task_25819,2608,100,174,61,235,25.821782178217823,47.57147836608417
Task_25820,1622,343,17,57,74,4.715116279069767,31.994402363733414
Task_25821,2977,148,114,73,187,19.97986577181208,53.763879405597
Task_25822,884,596,37,179,216,1.4807370184254607,23.025648902157428
Task_25823,1191,520,24,51,75,2.285988483685221,25.72599279098928
Task_25824,1503,94,155,128,283,15.821052631578947,30.884629013822018
Task_25825,1314,470,143,95,238,2.789808917197452,29.44255237731734
Task_25826,1673,141,119,65,184,11.78169014084507,33.07561054231514
Task_25827,1236,504,86,86,172,2.4475247524752475,27.85091581628296
Task_25828,1693,453,43,162,205,3.7290748898678414,35.34013325588396
Task_25829,2134,223,111,43,154,9.526785714285714,40.44482840086135
Task_25830,932,674,103,182,285,1.3807407407407408,24.304557631804567
Task_25831,2319,392,135,178,313,5.900763358778626,45.54199444387032
Task_25832,1047,536,112,97,209,1.9497206703910615,25.31053321608191
Task_25833,2534,714,200,94,294,3.5440559440559443,49.764479080933334
Task_25834,1687,586,176,164,340,2.8739352640545146,36.26218073059715
Task_25835,2109,548,65,176,241,3.841530054644809,42.46531357686279
Task_25836,790,65,85,42,127,11.969696969696969,17.54663073269137
Task_25837,986,467,153,92,245,2.106837606837607,24.20296607100411
Task_25838,747,587,170,152,322,1.2704081632653061,21.219630166094962
Task_25839,1505,803,140,129,269,1.8718905472636815,33.68699379532437
Task_25840,1500,626,142,70,212,2.3923444976076556,32.43401545082164
Task_25841,1036,223,17,34,51,4.625,22.04804433977081
Task_25842,2491,252,104,110,214,9.845849802371541,47.23183624924227
Task_25843,1989,225,118,176,294,8.800884955752212,39.659454998248684
Task_25844,1679,753,14,15,29,2.226790450928382,33.6028520208693
Task_25845,1944,312,58,24,82,6.210862619808307,36.998035066804924
Task_25846,2238,954,119,127,246,2.343455497382199,45.66477742753105
Task_25847,1224,826,57,166,223,1.4800483675937122,29.18141826269516
Task_25848,2982,992,110,132,242,3.003021148036254,57.56246314649633
Task_25849,2935,435,61,128,189,6.731651376146789,54.86449101920824
Task_25850,2424,588,106,199,305,4.115449915110356,47.833206797185596
Task_25851,1686,643,137,154,291,2.6180124223602483,36.190141803590656
Task_25852,967,719,126,154,280,1.3430555555555554,24.942172962286477
Task_25853,1463,910,191,91,282,1.605927552140505,33.288538429956105
Task_25854,1074,398,185,14,199,2.691729323308271,24.521741193120434
Task_25855,851,559,139,62,201,1.519642857142857,21.828028219402
Task_25856,1464,393,73,123,196,3.715736040609137,31.468793808433805
Task_25857,2161,704,10,39,49,3.0652482269503545,41.38824058117741
Task_25858,777,698,194,164,358,1.111587982832618,22.202076027527472
Task_25859,2757,949,104,159,263,2.9021052631578947,53.99691227714472
Task_25860,1398,758,28,151,179,1.841897233201581,31.44622611191127
Task_25861,1870,884,95,54,149,2.1129943502824857,38.71087049507581
Task_25862,2634,93,43,26,69,28.02127659574468,46.366002755671474
Task_25863,1919,759,17,129,146,2.525,39.332565136108094
Task_25864,1673,473,43,46,89,3.529535864978903,33.43733647550952
Task_25865,2423,310,167,29,196,7.790996784565916,45.658610594757164
Task_25866,912,657,13,158,171,1.3860182370820668,23.312306509202376
Task_25867,1949,671,53,75,128,2.900297619047619,39.62289411887347
Task_25868,964,373,193,135,328,2.5775401069518717,24.04639979033031
Task_25869,1578,323,18,144,162,4.87037037037037,32.716112069084694
Task_25870,2886,707,37,140,177,4.076271186440678,54.866719629803164
Task_25871,2362,104,31,70,101,22.495238095238093,42.87757046358331
Task_25872,519,439,182,197,379,1.1795454545454545,17.473523009226955
Task_25873,1290,1022,61,93,154,1.2609970674486803,30.191438159006314
Task_25874,2050,664,173,66,239,3.082706766917293,41.380411541116665
Task_25875,888,630,129,121,250,1.4072900158478605,23.22369143039469
Task_25876,1313,414,113,60,173,3.163855421686747,28.539028621145224
Task_25877,1178,247,108,178,286,4.75,26.89306086144371
Task_25878,1726,888,187,47,234,1.9415073115860517,36.68144195830035
Task_25879,2299,758,22,200,222,3.028985507246377,45.999377805616604
Task_25880,1132,920,30,175,205,1.229098805646037,27.844675147665416
Task_25881,1416,516,91,41,132,2.738878143133462,30.016600451987802
Task_25882,2254,510,110,179,289,4.410958904109589,44.79056800236908
Task_25883,1051,842,194,110,304,1.246737841043891,26.68053285509988
Task_25884,2994,127,186,179,365,23.390625,55.13388531148115
Task_25885,2899,701,19,36,55,4.12962962962963,53.13548593385107
Task_25886,1242,364,78,135,213,3.4027397260273973,27.96420978244915
Task_25887,1283,737,164,98,262,1.7384823848238482,29.881683617255348
Task_25888,2429,301,36,141,177,8.043046357615895,46.29853258232052
Task_25889,1377,377,19,49,68,3.642857142857143,28.12609011854371
Task_25890,2616,431,15,72,87,6.055555555555555,48.5513091836475
Task_25891,1446,456,147,39,186,3.164113785557987,30.63268088435264
Task_25892,2516,150,146,194,340,16.662251655629138,47.71934672071828
Task_25893,960,833,88,99,187,1.1510791366906474,24.585772399419042
Task_25894,1423,691,106,181,287,2.05635838150289,32.19624748081768
Task_25895,2085,666,60,148,208,3.125937031484258,42.268620528913225
Task_25896,1772,565,38,27,65,3.1307420494699647,34.83595554815529
Task_25897,1151,374,172,186,358,3.0693333333333332,27.21804340077689
Task_25898,2622,676,187,176,363,3.8729689807976366,51.47618581204114
Task_25899,1592,709,126,30,156,2.2422535211267607,33.496845299828045
Task_25900,1207,823,44,143,187,1.4648058252427185,28.632361827350838
Task_25901,2806,115,146,162,308,24.189655172413794,51.75276322825395
Task_25902,818,792,129,92,221,1.0315258511979823,22.38631107399581
Task_25903,948,470,95,175,270,2.0127388535031847,23.90733029210085
Task_25904,684,1018,200,96,296,0.6712463199214916,21.540348500241503
Task_25905,2219,483,192,49,241,4.5847107438016526,43.32164733768392
Task_25906,1706,273,160,118,278,6.226277372262774,35.201312124799564
Task_25907,2223,315,57,139,196,7.034810126582278,43.2464563479295
Task_25908,906,196,179,129,308,4.598984771573604,22.46724747880715
Task_25909,1193,416,29,37,66,2.8609112709832134,25.19541859875422
Task_25910,2126,766,93,51,144,2.771838331160365,42.386342337408365
Task_25911,1893,180,197,84,281,10.458563535911603,37.4787040097793
Task_25912,1132,452,41,32,73,2.498896247240618,24.384528841186434
Task_25913,2298,445,126,100,226,5.1524663677130045,44.877200919264936
Task_25914,2022,162,45,26,71,12.404907975460123,37.49134764901614
Task_25915,1258,811,66,121,187,1.5492610837438423,29.442034748969025
Task_25916,1472,332,130,47,177,4.42042042042042,30.63556824002868
Task_25917,2192,153,96,11,107,14.233766233766234,40.39086960151215
Task_25918,2731,815,133,45,178,3.346813725490196,52.07797084600089
Task_25919,2477,97,148,61,209,25.275510204081634,45.31678600974599
Task_25920,2370,1024,46,162,208,2.3121951219512193,47.88822217285773
Task_25921,2201,724,72,200,272,3.035862068965517,44.64374102897116
Task_25922,2358,570,100,109,209,4.129597197898423,46.16607401375207
Task_25923,2525,1019,76,96,172,2.4754901960784315,50.11325559060867
Task_25924,2596,696,12,192,204,3.7245337159253946,50.39849057913008
Task_25925,1536,286,159,18,177,5.351916376306621,31.3671427599549
Task_25926,2679,421,73,85,158,6.348341232227488,50.37228226749417
Task_25927,1094,811,164,170,334,1.3472906403940887,27.506454217040723
Task_25928,863,543,167,59,226,1.5863970588235294,22.07262151942044
Task_25929,2328,352,100,122,222,6.594900849858357,45.05857978370424
Task_25930,803,291,138,128,266,2.75,20.947893179819378
Task_25931,2230,249,81,127,208,8.92,43.14818374927274
Task_25932,2434,119,196,188,384,20.283333333333335,46.35645467485153
Task_25933,1876,791,117,86,203,2.3686868686868685,39.100529450491855
Task_25934,2596,125,195,151,346,20.603174603174605,48.71555550003931
Task_25935,751,448,35,133,168,1.6726057906458798,20.14470553848301
Task_25936,761,363,47,92,139,2.090659340659341,19.746034406176708
Task_25937,1286,983,157,149,306,1.306910569105691,30.91045059641087
Task_25938,1044,889,196,65,261,1.1730337078651685,26.255093159569597
Task_25939,694,270,19,186,205,2.5608856088560885,18.952454719120386
Task_25940,573,414,131,137,268,1.380722891566265,17.66762439949296
Task_25941,893,759,109,194,303,1.175,24.043475348995187
Task_25942,1557,995,178,137,315,1.5632530120481927,35.283532175537204
Task_25943,1878,510,22,128,150,3.675146771037182,37.9126323683666
Task_25944,2454,344,25,199,224,7.113043478260869,47.13206523848766
Task_25945,1635,259,64,63,127,6.288461538461538,32.9657690034033
Task_25946,2414,203,185,140,325,11.833333333333334,46.3726758462505
Task_25947,1826,226,99,50,149,8.044052863436123,35.72055193849077
Task_25948,2789,953,108,129,237,2.9234800838574424,54.35532549848917
Task_25949,2798,335,74,148,222,8.327380952380953,52.53320016387264
Task_25950,2368,652,35,155,190,3.6263399693721285,46.5777275789681
Task_25951,1612,906,44,104,148,1.7772877618522602,34.94383459883435
Task_25952,1674,344,39,193,232,4.852173913043479,34.84618774892392
Task_25953,2765,665,44,22,66,4.151651651651652,50.82812431688898
Task_25954,1066,764,184,62,246,1.3934640522875816,26.07632257852947
Task_25955,2877,517,61,32,93,5.554054054054054,52.564334058680345
Task_25956,2628,875,54,163,217,3.0,51.59005213914835
Task_25957,714,95,106,176,282,7.4375,18.56982851216012
Task_25958,1823,553,35,139,174,3.2906137184115525,37.518688469779235
Task_25959,2106,81,200,200,400,25.682926829268293,40.92986332501376
Task_25960,1697,477,20,198,218,3.5502092050209204,35.56003624239182
Task_25961,899,273,190,188,378,3.281021897810219,22.999746191707647
Task_25962,2411,512,108,13,121,4.699805068226121,45.416542945867796
Task_25963,1908,580,80,166,246,3.2839931153184163,39.37551455673613
Task_25964,2324,420,89,136,225,5.520190023752969,45.23419668385992
Task_25965,2434,298,49,108,157,8.14046822742475,46.14061649178024
Task_25966,890,812,150,175,325,1.0947109471094711,24.22733953282623
Task_25967,2835,423,179,31,210,6.686320754716981,52.62876935455526
Task_25968,1069,522,104,166,270,2.043977055449331,25.96266416416732
Task_25969,1237,697,50,168,218,1.7722063037249283,29.023402826502092
Task_25970,2178,996,27,43,70,2.184553660982949,42.66309762148696
Task_25971,555,92,13,106,119,5.967741935483871,14.712274008855864
Task_25972,505,881,155,55,210,0.572562358276644,17.58822618650691
Task_25973,2056,763,93,120,213,2.6910994764397906,42.06434370527468
Task_25974,2324,352,30,60,90,6.5835694050991505,43.5322054180119
Task_25975,1894,239,11,18,29,7.891666666666667,35.33434208723492
Task_25976,1934,81,21,174,195,23.585365853658537,37.253683539453924
Task_25977,2211,184,60,45,105,11.95135135135135,40.933214350838334
Task_25978,1220,165,113,78,191,7.349397590361446,26.357517303711717
Task_25979,2020,790,116,113,229,2.553729456384324,41.60186860028175
Task_25980,1728,410,54,86,140,4.204379562043796,35.23371520895143
Task_25981,2496,730,19,123,142,3.414500683994528,48.36492034242678
Task_25982,740,118,122,179,301,6.218487394957983,19.304642749564266
Task_25983,1331,766,106,127,233,1.7353324641460235,30.636618023359336
Task_25984,1408,832,77,139,216,1.6902761104441777,32.06965340347696
Task_25985,1872,500,125,98,223,3.7365269461077846,38.30217105348664
Task_25986,1477,559,115,113,228,2.6375,32.27213212154515
Task_25987,1820,456,65,162,227,3.982494529540481,37.5121915697865
Task_25988,2830,414,59,143,202,6.819277108433735,53.21940312725926
Task_25989,1382,107,41,105,146,12.796296296296296,28.033240309726455
Task_25990,2623,529,91,133,224,4.949056603773585,50.3328465155021
Task_25991,1446,414,158,69,227,3.4843373493975904,30.967795115863595
Task_25992,1024,759,111,35,146,1.3473684210526315,24.66420094278067
Task_25993,1429,390,153,184,337,3.6547314578005117,31.57030400265363
Task_25994,644,283,91,48,139,2.267605633802817,17.112428666787576
Task_25995,1301,807,81,156,237,1.6101485148514851,30.402640313203136
Task_25996,1100,382,95,15,110,2.8720626631853787,24.2279560524742
Task_25997,2839,796,82,102,184,3.562107904642409,54.38136207457336
Task_25998,1277,177,71,148,219,7.174157303370786,27.673630490713805
Task_25999,1620,398,154,178,332,4.06015037593985,34.586983113027586
Task_26000,1752,311,138,53,191,5.615384615384615,35.318181153481504
Task_26001,883,707,11,75,86,1.247175141242938,21.98156372947771
Task_26002,533,758,185,154,339,0.7022397891963109,18.571001803008933
Task_26003,1393,880,123,34,157,1.5811577752553916,30.87113056066731
Task_26004,1762,946,32,95,127,1.8606124604012673,37.39290301292292
Task_26005,2625,1022,10,103,113,2.565982404692082,51.10791045400341
Task_26006,1713,772,143,18,161,2.216041397153946,35.56642293760442
Task_26007,2642,538,160,153,313,4.901669758812616,51.09376600462912
Task_26008,2070,641,130,145,275,3.2242990654205608,42.18044363142669
Task_26009,1813,703,138,73,211,2.575284090909091,37.68075433744645
Task_26010,1621,1000,110,10,120,1.6193806193806193,34.39337989760421
Task_26011,1626,748,174,82,256,2.170894526034713,35.2338854008754
Task_26012,2267,983,193,44,237,2.303861788617886,45.533301928796014
Task_26013,1669,746,11,111,122,2.2342704149933064,35.13795359092308
Task_26014,2983,623,98,151,249,4.780448717948718,56.47914815233935
Task_26015,531,103,35,120,155,5.105769230769231,14.723194293082116
Task_26016,1614,164,79,174,253,9.781818181818181,33.20486023476482
Task_26017,2283,749,45,150,195,3.044,45.56905436446424
Task_26018,1280,827,199,31,230,1.5458937198067633,29.369804961996888
Task_26019,1901,596,72,11,83,3.184254606365159,37.33564771626656
Task_26020,918,284,26,79,105,3.221052631578947,21.541475727175563
Task_26021,2984,507,177,182,359,5.874015748031496,56.65802266041269
Task_26022,2953,461,154,156,310,6.391774891774892,55.75769526290137
Task_26023,1877,833,187,175,362,2.2505995203836933,40.16083402145896
Task_26024,2893,971,82,179,261,2.9763374485596708,56.28308321911897
Task_26025,1379,70,156,177,333,19.422535211267604,29.19127306918918
Task_26026,727,896,193,185,378,0.810479375696767,22.207766726722927
Task_26027,2008,210,40,188,228,9.516587677725118,39.63344871623256
Task_26028,2305,805,160,53,213,2.859801488833747,45.75209926023894
Task_26029,1949,716,55,12,67,2.7182705718270572,37.91502643788086
Task_26030,518,733,178,182,360,0.7057220708446866,18.38708511504186
Task_26031,672,316,29,163,192,2.1198738170347005,18.67692259833686
Task_26032,1063,747,33,105,138,1.4211229946524064,25.640286822944457
Task_26033,874,800,48,80,128,1.0911360799001248,22.995431395751314
Task_26034,637,509,79,120,199,1.2490196078431373,18.68285761221344
Task_26035,1403,70,181,171,352,19.760563380281692,29.64349637541945
Task_26036,2042,230,117,48,165,8.83982683982684,39.27200433990942
Task_26037,2485,155,37,57,94,15.929487179487179,45.11064497197424
Task_26038,2766,658,40,163,203,4.197268588770865,52.96965050716202
Task_26039,1650,794,131,146,277,2.0754716981132075,36.01718839098656
Task_26040,1773,898,89,200,289,1.9721913236929922,38.40199777193511
Task_26041,1524,430,30,197,227,3.5359628770301623,32.72863974299677
Task_26042,2954,425,54,13,67,6.934272300469484,52.89143049025002
Task_26043,1744,448,52,104,156,3.884187082405345,35.68869415755787
Task_26044,841,945,57,18,75,0.8890063424947146,21.308239800942598
Task_26045,1595,367,133,156,289,4.334239130434782,33.86470632795803
Task_26046,2058,135,58,75,133,15.132352941176471,38.85843414592798
Task_26047,2638,735,140,19,159,3.5842391304347827,50.08870234595397
Task_26048,2078,664,45,182,227,3.124812030075188,42.245636737356634
Task_26049,1491,881,136,29,165,1.6904761904761905,32.588193669096874
Task_26050,1404,491,105,149,254,2.8536585365853657,31.071573029470326
Task_26051,2165,84,149,102,251,25.470588235294116,41.069066617760015
Task_26052,2901,1022,104,30,134,2.835777126099707,55.09095257335244
Task_26053,2290,873,140,194,334,2.620137299771167,46.731012314700386
Task_26054,586,795,132,27,159,0.7361809045226131,17.90777146378509
Task_26055,893,396,55,131,186,2.2493702770780857,22.38642437370596
Task_26056,1914,668,24,188,212,2.8609865470852016,39.56115065125827
Task_26057,1894,261,41,99,140,7.229007633587786,37.29168974610696
Task_26058,691,689,177,49,226,1.0014492753623188,19.67112170170568
Task_26059,2322,985,142,166,308,2.3549695740365113,47.42901562906775
Task_26060,1090,610,153,97,250,1.7839607201309329,26.394187845910505
Task_26061,2400,223,162,42,204,10.714285714285714,45.029053781851395
Task_26062,2347,613,159,98,257,3.8224755700325734,46.33639891850044
Task_26063,972,562,121,141,262,1.7264653641207814,24.465861469493916
Task_26064,1147,229,134,199,333,4.98695652173913,26.58484234476568
Task_26065,1992,489,96,164,260,4.0653061224489795,40.43037999489446
Task_26066,1888,950,89,192,281,1.9852786540483702,40.33814934909393
Task_26067,679,684,73,168,241,0.9912408759124087,20.15001114059574
Task_26068,1472,851,138,141,279,1.727699530516432,33.3626485826984
Task_26069,1746,262,157,124,281,6.638783269961977,35.81781511637207
Task_26070,2558,105,74,38,112,24.132075471698112,45.75469093157787
Task_26071,1569,273,182,31,213,5.726277372262774,32.11382126518786
Task_26072,2178,69,175,147,322,31.114285714285714,41.584595475124075
Task_26073,1497,178,141,192,333,8.363128491620111,31.672351925988234
Task_26074,1509,909,85,39,124,1.6582417582417583,32.51754246547642
Task_26075,559,1022,118,39,157,0.5464320625610948,18.419067072748653
Task_26076,2138,156,35,198,233,13.617834394904458,41.27022074762916
Task_26077,2716,324,196,71,267,8.356923076923078,50.98539566281634
Task_26078,2034,323,130,24,154,6.277777777777778,39.16726811672128
Task_26079,1385,438,84,133,217,3.154897494305239,30.422101508650528
Task_26080,621,378,115,155,270,1.6385224274406331,18.390112376510324
Task_26081,2507,819,28,49,77,3.0573170731707315,47.436366487134144
Task_26082,1792,998,37,14,51,1.7937937937937938,36.35129842969274
Task_26083,1442,450,119,136,255,3.197339246119734,31.52830489110156
Task_26084,1347,209,98,119,217,6.414285714285715,29.037564294512336
Task_26085,1691,610,181,61,242,2.76759410801964,35.47972748902982
Task_26086,1476,799,60,168,228,1.845,33.15685193501738
Task_26087,1495,74,20,79,99,19.933333333333334,28.976703706644916
Task_26088,1556,216,18,114,132,7.170506912442396,31.804518961201307
Task_26089,1078,512,177,129,306,2.101364522417154,26.181787395926193
Task_26090,2152,748,102,130,232,2.8731642189586113,43.599998455472814
Task_26091,517,719,97,146,243,0.7180555555555556,17.752603130139246
Task_26092,2493,512,63,197,260,4.859649122807017,48.54366162698744
Task_26093,1384,631,100,177,277,2.189873417721519,31.340036959247303
Task_26094,735,918,177,102,279,0.7997823721436343,21.837174637839894
Task_26095,1708,363,10,192,202,4.6923076923076925,35.26022701523833
Task_26096,1320,553,24,137,161,2.3826714801444044,29.325727534146072
Task_26097,923,150,101,27,128,6.112582781456954,20.79671663887159
Task_26098,1846,891,163,140,303,2.069506726457399,39.53309106303275
Task_26099,1984,816,121,40,161,2.4283965728274173,40.07288814793264
Task_26100,889,1002,48,162,210,0.8863409770687937,24.313009862974653
Task_26101,1519,742,137,122,259,2.0444145356662182,33.663422898128225
Task_26102,2987,127,40,78,118,23.3359375,53.14811900634772
Task_26103,943,160,121,23,144,5.857142857142857,21.09109378255109
Task_26104,2405,309,103,104,207,7.758064516129032,46.03546393997912
Task_26105,1736,521,110,56,166,3.3256704980842913,35.604314267808284
Task_26106,1306,214,60,164,224,6.074418604651163,28.570569893822604
Task_26107,1630,976,174,24,198,1.668372569089048,35.17384416128054
Task_26108,2366,849,88,180,268,2.783529411764706,47.50100318402301
Task_26109,2921,611,154,92,246,4.772875816993464,55.30282435940928
Task_26110,1364,826,38,113,151,1.649334945586457,30.76060572460801
Task_26111,1608,111,67,104,171,14.357142857142858,32.105183848453734
Task_26112,1380,525,78,185,263,2.623574144486692,30.959333020368955
Task_26113,2141,634,93,146,239,3.3716535433070867,43.160530509957255
Task_26114,2188,535,185,172,357,4.082089552238806,44.12190801391271
Task_26115,1633,553,196,13,209,2.9476534296028882,33.91922787792871
Task_26116,1172,464,105,80,185,2.520430107526882,26.77200703515848
Task_26117,2470,301,167,28,195,8.178807947019868,46.36091425223793
Task_26118,531,471,19,104,123,1.125,16.218914292097338
Task_26119,2970,148,55,64,119,19.93288590604027,52.992595420914164
Task_26120,2417,193,180,175,355,12.458762886597938,46.561496364554905
Task_26121,2283,270,159,193,352,8.424354243542435,44.75376301233047
Task_26122,1098,618,162,68,230,1.7738287560581583,26.113192636888026
Task_26123,626,149,191,192,383,4.173333333333333,18.12351669693796
Task_26124,2219,920,194,29,223,2.409337676438654,44.50504208958032
Task_26125,1439,1004,118,77,195,1.4318407960199004,32.64730928200735
Task_26126,693,689,128,162,290,1.0043478260869565,20.53402142257035
Task_26127,1047,960,111,13,124,1.0894901144640998,25.343292724146465
Task_26128,1356,758,98,82,180,1.7865612648221343,30.634267766267783
Task_26129,1045,287,119,124,243,3.6284722222222223,24.651025057077618
Task_26130,2010,709,148,182,330,2.8309859154929575,41.746126220725195
Task_26131,1542,490,17,69,86,3.140529531568228,31.688536778426055
Task_26132,2618,650,120,175,295,4.021505376344086,51.022488380845836
Task_26133,2203,653,195,169,364,3.3685015290519877,44.761137643266046
Task_26134,1546,785,72,141,213,1.9669211195928753,34.10565166771354
Task_26135,2499,209,111,166,277,11.9,47.560188615849405
Task_26136,2851,347,32,128,160,8.192528735632184,52.855938112547484
Task_26137,2879,782,104,134,238,3.676883780332056,55.257050439907324
Task_26138,2371,291,49,200,249,8.11986301369863,45.86115867693298
Task_26139,2163,584,197,83,280,3.6974358974358976,43.332670420287776
Task_26140,2546,191,175,41,216,13.260416666666666,47.31996967540035
Task_26141,837,126,101,58,159,6.590551181102362,19.514933870691397
Task_26142,1179,626,19,172,191,1.8803827751196172,27.667846290247628
Task_26143,2505,746,163,190,353,3.353413654618474,49.81915387452909
Task_26144,576,363,25,160,185,1.5824175824175823,17.185502850397345
Task_26145,1776,715,53,134,187,2.4804469273743015,37.40185521661195
Task_26146,2921,1011,119,170,289,2.8863636363636362,56.92264026946452
Task_26147,972,485,133,89,222,2.0,23.93909189464374
Task_26148,2928,512,30,99,129,5.707602339181286,54.50700585124937
Task_26149,587,754,173,161,334,0.7774834437086092,19.331773394029884
Task_26150,2406,792,188,135,323,3.034047919293821,48.17940120859529
Task_26151,1670,596,20,119,139,2.797319932998325,34.83827262387024
Task_26152,508,840,140,28,168,0.6040428061831153,17.15989797094672
Task_26153,2381,705,11,88,99,3.3725212464589234,45.87762652158282
Task_26154,1171,156,135,14,149,7.45859872611465,24.66671596922886
Task_26155,730,290,166,168,334,2.508591065292096,20.155752720318425
Task_26156,2423,1013,28,118,146,2.3895463510848125,48.126383989202594
Task_26157,1223,837,106,138,244,1.4594272076372314,29.171429899809283
Task_26158,1537,89,185,22,207,17.07777777777778,30.22786392070566
Task_26159,1925,590,113,19,132,3.257191201353638,38.21374157104314
Task_26160,2253,424,83,61,144,5.301176470588235,43.299364143456444
Task_26161,701,1002,55,37,92,0.6989032901296112,20.092204446498364
Task_26162,1098,90,172,128,300,12.065934065934066,24.63536804231214
Task_26163,2311,1021,47,39,86,2.261252446183953,45.207089286182196
Task_26164,1244,719,14,67,81,1.7277777777777779,27.657905884732187
Task_26165,1767,487,192,21,213,3.6209016393442623,35.863671502843395
Task_26166,2115,627,133,22,155,3.3678343949044587,41.45179737171046
Task_26167,1419,996,193,137,330,1.423269809428285,33.15623830383749
Task_26168,965,330,41,189,230,2.915407854984894,23.57491406934442
Task_26169,1979,496,94,22,116,3.9818913480885314,38.55653725918348
Task_26170,1523,381,124,47,171,3.986910994764398,31.539082410062303
Task_26171,1300,618,60,20,80,2.10016155088853,27.668579457871303
Task_26172,1788,840,11,34,45,2.126040428061831,35.85709830489754
Task_26173,1601,897,142,74,216,1.7828507795100224,34.99370848877888
Task_26174,1055,545,195,57,252,1.9322344322344323,25.259726919473604
Task_26175,937,718,166,12,178,1.3031988873435327,23.240815677106152
Task_26176,2317,696,108,50,158,3.3242467718794835,45.03823843489199
Task_26177,667,285,130,27,157,2.332167832167832,17.496390417651305
Task_26178,670,564,133,79,212,1.1858407079646018,19.234978339972404
Task_26179,2340,626,124,117,241,3.7320574162679425,46.21498079485152
Task_26180,1069,509,152,170,322,2.096078431372549,26.162094277813605
Task_26181,2461,774,96,117,213,3.1754838709677418,48.479799227222834
Task_26182,2266,81,146,35,181,27.634146341463413,41.48799462976461
Task_26183,1811,885,163,114,277,2.044018058690745,38.804545644832245
Task_26184,542,975,64,10,74,0.555327868852459,16.624394245567732
Task_26185,2552,450,98,128,226,5.658536585365853,48.959040000373214
Task_26186,1935,373,140,82,222,5.17379679144385,38.78167486630635
Task_26187,1226,310,75,189,264,3.942122186495177,27.842719445200427
Task_26188,2491,120,51,22,73,20.58677685950413,44.37683126242041
Task_26189,1298,278,141,80,221,4.652329749103942,28.35743020298176
Task_26190,2675,128,159,22,181,20.73643410852713,48.47613531174594
Task_26191,2821,863,86,97,183,3.2650462962962963,54.25414553736504
Task_26192,2034,293,66,112,178,6.918367346938775,40.04703529640822
Task_26193,1490,256,67,133,200,5.797665369649805,31.47434562924748
Task_26194,836,361,20,135,155,2.3093922651933703,21.001749880716794
Task_26195,2270,545,30,153,183,4.157509157509158,44.609185937453766
Task_26196,1919,457,170,197,367,4.189956331877729,39.694958271627286
Task_26197,1524,795,98,166,264,1.914572864321608,33.99905434243448
Task_26198,726,364,72,138,210,1.989041095890411,19.78515374274188
Task_26199,1129,352,53,93,146,3.198300283286119,25.64612673190072
Task_26200,2035,519,192,95,287,3.9134615384615383,41.23346229705813
Task_26201,787,694,123,120,243,1.1323741007194246,21.76756471583464
Task_26202,652,97,91,197,288,6.653061224489796,17.6786584297873
Task_26203,895,431,117,55,172,2.071759259259259,21.988483231322817
Task_26204,573,201,191,157,348,2.8366336633663365,17.43339305741545
Task_26205,2644,996,192,85,277,2.6519558676028083,52.23050287362992
Task_26206,2304,774,68,175,243,2.972903225806452,46.278239340433295
Task_26207,2202,652,55,193,248,3.3721286370597245,44.32409929701231
Task_26208,1857,761,180,33,213,2.437007874015748,38.23078331838143
Task_26209,1699,672,59,193,252,2.524517087667162,36.438336842178835
Task_26210,1766,917,143,100,243,1.9237472766884531,38.01726552500417
Task_26211,1509,156,84,84,168,9.611464968152866,30.763311643128215
Task_26212,2246,1011,103,194,297,2.219367588932806,46.29700862130991
Task_26213,750,963,34,146,180,0.7780082987551867,21.78003306936206
Task_26214,1591,971,91,38,129,1.6368312757201646,34.22658789463889
Task_26215,1225,845,136,173,309,1.4479905437352245,29.57220475902312
Task_26216,1698,275,151,97,248,6.1521739130434785,34.94411968442069
Task_26217,1560,470,19,166,185,3.3121019108280256,33.14369605517595
Task_26218,2174,959,167,99,266,2.2645833333333334,44.70930591341286
Task_26219,619,316,96,151,247,1.9526813880126184,18.074357439563627
Task_26220,2318,204,25,13,38,11.307317073170731,41.964722269098665
Task_26221,2409,357,164,52,216,6.729050279329609,45.96730843174785
Task_26222,1890,879,21,91,112,2.147727272727273,38.93772906137127
Task_26223,1038,248,190,56,246,4.168674698795181,24.019581233114597
Task_26224,1517,549,200,56,256,2.7581818181818183,32.610832884076466
Task_26225,1536,653,175,171,346,2.3486238532110093,34.11853063882119
Task_26226,1724,258,68,67,135,6.656370656370656,34.44860210058388
Task_26227,2694,973,27,147,174,2.7659137577002055,52.62265004247814
Task_26228,1109,899,189,161,350,1.2322222222222223,28.058187787024263
Task_26229,1922,327,150,163,313,5.859756097560975,39.02322783033615
Task_26230,1368,772,179,110,289,1.7697283311772316,31.468927110784705
Task_26231,1580,265,14,186,200,5.93984962406015,32.9142413991523
Task_26232,2464,112,37,108,145,21.805309734513273,45.07109393429344
Task_26233,1533,130,156,105,261,11.702290076335878,31.583235855282442
Task_26234,2506,260,91,66,157,9.601532567049809,46.75003075486279
Task_26235,1296,650,182,198,380,1.9907834101382489,30.5006925528601
Task_26236,1534,874,119,17,136,1.7531428571428571,32.86388090449733
Task_26237,1971,582,82,96,178,3.3807890222984565,39.97599358115284
Task_26238,1247,747,177,10,187,1.6671122994652405,28.28531845065082
Task_26239,811,926,157,150,307,0.8748651564185544,23.24484523493408
Task_26240,1392,244,100,186,286,5.681632653061224,30.275526875724193
Task_26241,2189,355,167,60,227,6.148876404494382,42.47783493293099
Task_26242,2961,420,164,199,363,7.033254156769596,56.050313031856376
Task_26243,2956,863,86,78,164,3.4212962962962963,56.171212973944996
Task_26244,1080,771,110,99,209,1.3989637305699483,26.480102181255457
Task_26245,2632,531,107,115,222,4.947368421052632,50.44704353109372
Task_26246,1440,572,102,139,241,2.513089005235602,31.82385420525034
Task_26247,2167,996,144,141,285,2.1735205616850553,44.86666252814888
Task_26248,923,277,66,168,234,3.320143884892086,22.791219778293907
Task_26249,1541,393,128,196,324,3.9111675126903553,33.311122243283855
Task_26250,669,486,69,112,181,1.373716632443532,19.0222022591116
Task_26251,1299,729,94,17,111,1.7794520547945205,28.489385635714537
Task_26252,598,733,72,141,213,0.8147138964577657,18.86893650236522
Task_26253,1266,324,59,56,115,3.8953846153846152,26.95768760958468
Task_26254,1119,829,137,190,327,1.3481927710843373,27.956135625990928
Task_26255,998,76,26,31,57,12.96103896103896,20.336839238931045
Task_26256,2596,643,138,29,167,4.031055900621118,49.34331271039951
Task_26257,1286,965,63,126,189,1.3312629399585922,30.36422505628131
Task_26258,1335,184,59,160,219,7.216216216216216,28.78794876667781
Task_26259,1446,741,154,180,334,1.9487870619946093,32.92692281350548
Task_26260,2410,890,169,119,288,2.7048260381593714,48.368226517036135
Task_26261,817,474,48,140,188,1.72,21.447929051181628
Task_26262,1746,592,40,159,199,2.9443507588532882,36.582478930734155
Task_26263,2522,591,137,122,259,4.260135135135135,49.07450752567274
Task_26264,555,205,18,184,202,2.6941747572815533,16.528298298678976
Task_26265,2699,684,91,36,127,3.9401459854014598,50.7776539128723
Task_26266,1462,163,119,74,193,8.914634146341463,30.098499194515394
Task_26267,2133,558,123,79,202,3.815742397137746,42.387254082308694
Task_26268,2740,654,138,96,234,4.183206106870229,52.60507368205961
Task_26269,1449,98,41,171,212,14.636363636363637,29.800833139826878
Task_26270,2509,840,32,29,61,2.9833531510107014,47.378582592023726
Task_26271,1278,724,185,185,370,1.7627586206896553,30.36878132336695
Task_26272,838,384,81,100,181,2.1766233766233767,21.389500081104057
Task_26273,2151,739,36,158,194,2.906756756756757,43.44029447349424
Task_26274,2212,123,145,166,311,17.838709677419356,42.527287152110794
Task_26275,618,902,19,45,64,0.6843853820598007,17.990345974613486
Task_26276,948,731,85,174,259,1.2950819672131149,24.591292154135573
Task_26277,586,348,178,106,284,1.679083094555874,17.733283639954355
Task_26278,737,922,16,32,48,0.7984832069339112,19.676091864615014
Task_26279,2086,530,64,51,115,3.928436911487759,40.55332168701151
Task_26280,1199,572,53,167,220,2.0924956369982546,28.025990619913173
Task_26281,1278,122,194,161,355,10.390243902439025,28.022050974595313
Task_26282,1969,74,118,104,222,26.253333333333334,37.83729840047639
Task_26283,2826,1013,199,177,376,2.78698224852071,55.82576857439059
Task_26284,592,415,66,71,137,1.4230769230769231,17.061982208994973
Task_26285,1333,122,94,173,267,10.83739837398374,28.530557838514184
Task_26286,2236,435,174,109,283,5.128440366972477,44.13342886833692
Task_26287,2501,696,123,64,187,3.588235294117647,48.367234057815885
Task_26288,1524,290,58,21,79,5.237113402061856,30.041066920288102
Task_26289,1777,630,36,110,146,2.8161648177496037,36.714583668845286
Task_26290,2584,164,69,110,179,15.66060606060606,48.02254714387078
Task_26291,1244,960,168,36,204,1.2944849115504682,29.101316769603944
Task_26292,2304,709,107,170,277,3.2450704225352114,46.14679638348633
Task_26293,1758,108,156,110,266,16.128440366972477,34.9355058975512
Task_26294,1569,842,58,168,226,1.8612099644128113,34.75550380090174
Task_26295,1790,611,115,13,128,2.9248366013071894,36.200715522562696
Task_26296,2290,907,135,185,320,2.5220264317180616,46.76082974344421
Task_26297,2315,644,145,87,232,3.5891472868217056,45.73009698198236
Task_26298,1816,760,91,168,259,2.3863337713534825,38.491417112563155
Task_26299,587,361,103,138,241,1.6215469613259668,17.643137812888178
Task_26300,972,1005,69,49,118,0.9662027833001988,24.424147614241885
Task_26301,2574,174,200,102,302,14.708571428571428,48.39337214239905
Task_26302,2279,697,175,99,274,3.2650429799426934,45.58943818488246
Task_26303,1395,983,174,166,340,1.4176829268292683,32.823220820596084
Task_26304,1109,223,96,55,151,4.950892857142857,24.51785529442448
Task_26305,2587,244,145,105,250,10.559183673469388,48.87375270275633
Task_26306,1963,449,37,63,100,4.362222222222222,38.41311660553313
Task_26307,1194,312,91,126,217,3.8146964856230032,26.97362508530183
Task_26308,2261,635,142,124,266,3.5550314465408803,45.1152258362512
Task_26309,679,929,171,83,254,0.7301075268817204,20.8280926417084
Task_26310,2052,907,71,156,227,2.2599118942731278,42.587891731316624
Task_26311,1901,157,78,71,149,12.031645569620252,36.64779256078196
Task_26312,2327,337,151,163,314,6.884615384615385,45.466776055456826
Task_26313,1987,754,96,195,291,2.6317880794701987,41.37378802249341
Task_26314,2182,545,113,26,139,3.9963369963369964,42.18588743415867
Task_26315,2702,806,111,180,291,3.34820322180917,52.83463094051397
Task_26316,923,718,19,110,129,1.2837273991655076,23.362301717346508
Task_26317,1093,500,196,70,266,2.1816367265469063,25.837061613791658
Task_26318,2827,565,143,57,200,4.9946996466431095,53.14748347499477
Task_26319,1527,164,165,169,334,9.254545454545454,32.11969457692879
Task_26320,2197,629,158,196,354,3.4873015873015873,44.584788745533864
Task_26321,2919,295,59,147,206,9.861486486486486,54.24120689640595
Task_26322,2010,577,37,100,137,3.4775086505190314,40.15960513558867
Task_26323,2955,462,164,78,242,6.382289416846652,55.24887734318826
Task_26324,945,236,161,96,257,3.9873417721518987,22.952612557056636
Task_26325,2268,550,95,88,183,4.116152450090744,44.441867799082104
Task_26326,840,529,50,52,102,1.5849056603773586,20.67719088934992
Task_26327,1093,169,27,123,150,6.429411764705883,23.9573167524795
Task_26328,2111,779,85,83,168,2.7064102564102566,42.590899773093206
Task_26329,1226,701,182,80,262,1.7464387464387465,28.737407180542437
Task_26330,1059,165,43,179,222,6.379518072289157,24.2176010282168
Task_26331,2181,710,73,125,198,3.067510548523207,43.83946590115257
Task_26332,2508,373,129,137,266,6.705882352941177,48.197014956889184
Task_26333,2268,681,192,129,321,3.3255131964809386,45.62656700369288
Task_26334,1613,977,147,183,330,1.6492842535787322,36.27946684084326
Task_26335,515,933,173,64,237,0.5513918629550322,18.062277103538634
Task_26336,2400,1019,62,169,231,2.3529411764705883,48.49538547043945
Task_26337,1267,828,134,97,231,1.5283474065138722,29.761438871708474
Task_26338,2424,488,54,86,140,4.957055214723926,46.50223799230907
Task_26339,2413,542,21,91,112,4.443830570902394,46.16138677614072
Task_26340,744,947,138,65,203,0.7848101265822784,21.474546242487495
Task_26341,835,629,167,20,187,1.3253968253968254,21.429917717823912
Task_26342,2384,946,46,105,151,2.5174234424498416,47.32100314941008
Task_26343,1795,243,15,99,114,7.35655737704918,35.470126929295226
Task_26344,1712,134,50,130,180,12.681481481481482,34.06746533308887
Task_26345,593,265,11,174,185,2.2293233082706765,17.177896430906426
Task_26346,2258,546,56,94,150,4.127970749542961,44.125013802583
Task_26347,2165,575,125,135,260,3.7586805555555554,43.39374980752899
Task_26348,1344,239,28,51,79,5.6,27.361688498370288
Task_26349,2346,250,54,152,206,9.346613545816734,45.02897720292685
Task_26350,1980,989,172,125,297,2.0,41.91215850230262
Task_26351,999,596,141,104,245,1.6733668341708543,24.868698692708268
Task_26352,1933,1007,175,130,305,1.9176587301587302,41.26664845867708
Task_26353,1782,175,125,188,313,10.125,36.080943233492626
Task_26354,566,485,16,179,195,1.1646090534979423,17.45915012284949
Task_26355,1367,407,24,108,132,3.3504901960784315,29.44832310660196
Task_26356,2957,644,172,74,246,4.584496124031007,55.825375219140874
Task_26357,2126,301,168,193,361,7.039735099337748,42.421010016587694
Task_26358,625,374,195,180,375,1.6666666666666667,18.95070807746843
Task_26359,1776,906,124,175,299,1.9581036383682469,38.50386067677973
Task_26360,1202,140,26,118,144,8.52482269503546,25.46238822691319
Task_26361,1387,113,99,125,224,12.166666666666666,28.987234006982586
Task_26362,666,898,51,64,115,0.7408231368186874,19.494466044468318
Task_26363,1561,527,83,121,204,2.956439393939394,33.440384982718776
Task_26364,1403,364,50,51,101,3.8438356164383563,29.09096241966456
Task_26365,1148,739,199,76,275,1.5513513513513513,27.581096340509717
Task_26366,2204,298,86,104,190,7.37123745819398,42.69987155365317
Task_26367,2839,992,92,103,195,2.8590130916414904,55.049670703494115
Task_26368,2472,683,112,30,142,3.6140350877192984,47.26855019818651
Task_26369,1008,150,108,23,131,6.675496688741722,22.005909848775236
Task_26370,2356,914,195,139,334,2.574863387978142,47.82413645697584
Task_26371,1318,940,198,169,367,1.4006376195536663,31.595862551012114
Task_26372,724,586,78,86,164,1.233390119250426,20.05642122610138
Task_26373,1629,729,19,137,156,2.2315068493150685,34.72135295258191
Task_26374,1441,255,172,199,371,5.62890625,31.489619988721916
Task_26375,1984,613,104,130,234,3.231270358306189,40.52324510600292
Task_26376,2639,724,20,123,143,3.64,50.619169714717806
Task_26377,516,574,128,193,321,0.8973913043478261,17.622787763276417
Task_26378,1263,369,19,94,113,3.4135135135135135,27.492089523268476
Task_26379,1958,451,37,126,163,4.331858407079646,39.23756807958732
Task_26380,1034,785,22,60,82,1.3155216284987277,24.409878532395712
Task_26381,979,335,87,103,190,2.9136904761904763,23.450482736982263
Task_26382,1062,997,131,63,194,1.0641282565130261,26.53834596181254
Task_26383,1586,343,95,200,295,4.6104651162790695,33.74562304915059
Task_26384,2253,509,177,70,247,4.41764705882353,44.14471712075783
Task_26385,879,970,74,165,239,0.9052523171987642,24.193760089567245
Task_26386,1892,717,41,23,64,2.635097493036212,37.17932442728877
Task_26387,979,286,17,49,66,3.4111498257839723,21.502252800765888
Task_26388,688,597,90,71,161,1.1505016722408026,19.119319775305087
Task_26389,1642,180,51,170,221,9.07182320441989,33.48422993256201
Task_26390,1343,924,14,173,187,1.451891891891892,31.111442258417785
Task_26391,621,297,190,118,308,2.0838926174496644,18.264446604410832
Task_26392,777,511,56,140,196,1.517578125,20.96474927104958
Task_26393,1627,991,131,50,181,1.6401209677419355,35.24035998595082
Task_26394,1867,958,44,54,98,1.9468196037539103,38.27995814518288
Task_26395,768,381,47,199,246,2.0104712041884816,20.73521401282193
Task_26396,2772,549,34,119,153,5.04,52.20854133911007
Task_26397,1818,67,148,10,158,26.735294117647058,33.84818088103964
Task_26398,2160,80,13,144,157,26.666666666666668,40.15403819404742
Task_26399,687,697,64,170,234,0.9842406876790831,20.28502454902347
Task_26400,2426,167,37,170,207,14.44047619047619,45.70506509884087
Task_26401,2959,446,64,159,223,6.619686800894854,55.485701913271875
Task_26402,2349,718,53,194,247,3.267037552155772,46.85996946329946
Task_26403,2555,211,190,51,241,12.05188679245283,47.80747675892794
Task_26404,905,596,60,186,246,1.5159128978224456,23.54918829553685
Task_26405,2061,852,179,36,215,2.4161781946072685,41.75576549612298
Task_26406,2423,192,192,31,223,12.55440414507772,45.4099170176622
Task_26407,1003,611,60,64,124,1.6388888888888888,24.00760345842728
Task_26408,2561,1022,53,199,252,2.5034213098729228,51.19969658008373
Task_26409,2454,876,77,161,238,2.798175598631699,48.924820351882154
Task_26410,2161,874,159,83,242,2.4697142857142858,44.04088197131936
Task_26411,622,454,159,103,262,1.367032967032967,18.49826112256488
Task_26412,1864,781,87,14,101,2.3836317135549874,37.43236558876091
Task_26413,2750,634,166,33,199,4.330708661417323,51.91274452146053
Task_26414,1998,782,169,80,249,2.5517241379310347,41.17066023967496
Task_26415,2459,718,140,156,296,3.420027816411683,48.695562051986904
Task_26416,2158,134,38,23,61,15.985185185185186,39.22826916709526
Task_26417,1437,89,130,140,270,15.966666666666667,29.830735881463138
Task_26418,598,1024,96,92,188,0.5834146341463414,19.680766253144313
Task_26419,1771,71,167,139,306,24.59722222222222,35.15368712971139
Task_26420,2516,929,194,137,331,2.7053763440860217,50.38980366080273
Task_26421,2450,503,152,109,261,4.861111111111111,47.64224512880835
Task_26422,1044,407,56,156,212,2.5588235294117645,24.99784026647126
Task_26423,622,522,105,83,188,1.1892925430210326,18.242667075343032
Task_26424,2846,810,198,82,280,3.5092478421701605,54.86424229986045
Task_26425,949,780,113,170,283,1.2151088348271446,24.865656702913714
Task_26426,1434,685,133,154,287,2.0903790087463556,32.312170476093094
Task_26427,2531,148,50,71,121,16.986577181208055,46.170114190471644
Task_26428,1069,637,85,86,171,1.6755485893416928,25.636241324293447
Task_26429,2143,969,192,185,377,2.209278350515464,44.88150596870573
Task_26430,1797,310,159,66,225,5.778135048231511,36.172889449738285
Task_26431,2785,638,137,31,168,4.358372456964006,52.30175722296395
Task_26432,2488,779,197,65,262,3.18974358974359,48.79844319792134
Task_26433,2371,853,140,79,219,2.7763466042154565,47.16283171363611
Task_26434,603,499,181,73,254,1.206,18.05749846304329
Task_26435,1642,745,62,24,86,2.201072386058981,33.62218029984429
Task_26436,2653,504,197,174,371,5.253465346534654,51.450346632843626
Task_26437,2839,475,115,102,217,5.964285714285714,53.50081019664301
Task_26438,2799,238,37,53,90,11.711297071129707,50.699476615255314
Task_26439,1495,76,35,182,217,19.415584415584416,30.476976824067492
Task_26440,1373,428,94,145,239,3.2004662004662006,30.317444050351423
Task_26441,2653,540,112,146,258,4.903881700554528,51.016222583811384
Task_26442,2601,965,186,76,262,2.6925465838509317,51.27700658302334
Task_26443,2770,133,66,164,230,20.671641791044777,51.09925262902923
Task_26444,1691,925,176,188,364,1.826133909287257,37.528052086116794
Task_26445,1577,122,145,77,222,12.821138211382113,31.75332209333079
Task_26446,562,832,38,96,134,0.6746698679471789,18.212861305819434
Task_26447,2090,628,110,81,191,3.3227344992050876,41.87766020362726
Task_26448,1421,859,101,138,239,1.6523255813953488,32.39475702952911
Task_26449,1684,520,50,115,165,3.232245681381958,35.21387974926156
Task_26450,546,863,168,115,283,0.6319444444444444,18.81944184372337
Task_26451,2497,814,98,65,163,3.063803680981595,48.606706023474885
Task_26452,1113,360,38,186,224,3.0831024930747923,25.97791484991011
Task_26453,781,721,101,114,215,1.0817174515235457,21.62958463809237
Task_26454,1188,210,185,173,358,5.630331753554502,27.241216419780475
Task_26455,1752,203,14,96,110,8.588235294117647,34.598173098489866
Task_26456,1005,224,63,88,151,4.466666666666667,23.21830572853938
Task_26457,1800,389,167,123,290,4.615384615384615,37.13594008944239
Task_26458,2460,943,20,118,138,2.6059322033898304,48.42787579901884
Task_26459,1040,575,54,20,74,1.8055555555555556,23.10734436851358
Task_26460,871,89,75,18,93,9.677777777777777,18.798986959502514
Task_26461,1028,869,24,21,45,1.181609195402299,23.96779342766814
Task_26462,1909,384,115,126,241,4.958441558441558,38.62775525092052
Task_26463,2548,759,103,184,287,3.3526315789473684,50.23498423960442
Task_26464,2795,597,133,169,302,4.673913043478261,53.67968331109578
Task_26465,1898,301,120,54,174,6.28476821192053,37.45735163587836
Task_26466,1215,210,193,31,224,5.758293838862559,26.353721212184833
Task_26467,755,309,108,119,227,2.435483870967742,20.05782114192324
Task_26468,770,863,67,135,202,0.8912037037037037,21.94647770649213
Task_26469,2162,163,181,66,247,13.182926829268293,41.296892778033246
Task_26470,2587,494,178,37,215,5.226262626262626,48.97149313928842
Task_26471,975,102,167,84,251,9.466019417475728,22.334984147151204
Task_26472,2197,526,147,132,279,4.16888045540797,43.825440437867236
Task_26473,1199,295,125,146,271,4.050675675675675,27.270295685729305
Task_26474,696,721,139,196,335,0.96398891966759,20.97800449528973
Task_26475,2366,874,135,112,247,2.704,47.426019583068694
Task_26476,2629,905,93,167,260,2.901766004415011,51.867836293479826
Task_26477,2805,190,170,19,189,14.68586387434555,51.18663294680443
Task_26478,2141,473,122,138,260,4.5168776371308015,42.691809278930116
Task_26479,1532,470,27,97,124,3.2526539278131636,32.17812862187393
Task_26480,1362,792,36,187,223,1.7175283732660782,31.266078761509004
Task_26481,2634,435,96,144,240,6.041284403669724,50.2976361961787
Task_26482,635,770,116,88,204,0.8236057068741893,19.361508803597285
Task_26483,1456,226,45,46,91,6.41409691629956,29.202090488130196
Task_26484,1739,232,25,179,204,7.463519313304721,35.32075710594858
Task_26485,746,769,98,67,165,0.9688311688311688,20.803766087891585
Task_26486,2428,812,54,95,149,2.986469864698647,47.705861972199635
Task_26487,1771,236,25,55,80,7.472573839662447,34.23927406383206
Task_26488,1226,752,47,31,78,1.6281540504648075,26.907868823131064
Task_26489,848,355,88,122,210,2.3820224719101124,21.561940285122393
Task_26490,2647,533,43,29,72,4.956928838951311,48.65114174438577
Task_26491,2733,457,99,40,139,5.967248908296943,50.63114652929837
Task_26492,2653,665,134,150,284,3.9834834834834836,51.538190354632015
Task_26493,1710,546,151,43,194,3.126142595978062,35.15297309697669
Task_26494,2056,425,180,107,287,4.826291079812207,41.267229196773
Task_26495,1353,370,20,33,53,3.646900269541779,27.57653298095779
Task_26496,1665,372,117,96,213,4.463806970509383,34.58625489246092
Task_26497,2357,838,92,35,127,2.8092967818831944,45.88136021542462
Task_26498,2453,688,15,156,171,3.560232220609579,47.871543252026264
Task_26499,2019,1019,46,55,101,1.9794117647058824,40.9120119215548
Task_26500,1788,785,168,36,204,2.2748091603053435,37.17182267761996
Task_26501,1493,197,145,174,319,7.540404040404041,31.874059589137307
Task_26502,2650,758,103,48,151,3.4914361001317524,50.41208225708386
Task_26503,2627,591,128,181,309,4.4375,51.04914743176054
Task_26504,2167,366,196,49,245,5.9046321525885554,42.13420415180172
Task_26505,2802,318,27,89,116,8.783699059561128,51.63969702100906
Task_26506,802,851,26,67,93,0.9413145539906104,21.238275299809434
Task_26507,1008,409,102,119,221,2.4585365853658536,24.35124052215363
Task_26508,1838,997,158,181,339,1.8416833667334669,39.958128045288156
Task_26509,1497,649,38,143,181,2.3030769230769232,32.67567375687948
Task_26510,2534,741,122,139,261,3.4150943396226414,49.7734150104954
Task_26511,2694,233,31,147,178,11.512820512820513,50.23458868483422
Task_26512,621,602,125,45,170,1.0298507462686568,17.934520940162113
Task_26513,1362,943,183,42,225,1.4427966101694916,31.020761485272004
Task_26514,572,639,24,65,89,0.89375,16.907010622520286
Task_26515,2283,216,87,75,162,10.52073732718894,43.22937342048968
Task_26516,510,386,184,158,342,1.317829457364341,16.9544655917793
Task_26517,2613,330,87,127,214,7.8942598187311175,49.42289481321553
Task_26518,2894,483,61,19,80,5.979338842975206,52.47191239040621
Task_26519,1983,333,96,75,171,5.937125748502994,39.01098908229623
Task_26520,2625,520,192,148,340,5.038387715930902,50.88094981754163
Task_26521,2281,698,80,94,174,3.263233190271817,45.19683347283681
Task_26522,2575,824,144,153,297,3.121212121212121,50.86645367493418
Task_26523,2071,284,134,129,263,7.266666666666667,40.9571921947399
Task_26524,1077,481,40,154,194,2.2344398340248963,25.610223558887057
Task_26525,2526,144,165,14,179,17.420689655172414,46.205166028884385
Task_26526,1344,947,155,123,278,1.4177215189873418,31.56103145226625
Task_26527,1836,883,192,82,274,2.076923076923077,39.06285783612518
Task_26528,1388,368,58,81,139,3.761517615176152,29.696752479638178
Task_26529,1023,325,33,19,52,3.138036809815951,22.089837380986193
Task_26530,2538,813,190,68,258,3.117936117936118,49.66906057532929
Task_26531,771,923,158,196,354,0.8344155844155844,22.880290837796952
Task_26532,2238,219,199,104,303,10.172727272727272,43.50425255471891
Task_26533,1358,639,12,22,34,2.121875,28.233265973818757
Task_26534,2955,187,143,117,260,15.71808510638298,54.54553317871551
Task_26535,1079,104,119,185,304,10.276190476190477,24.52409633464194
Task_26536,703,133,127,27,154,5.246268656716418,17.198105219354055
Task_26537,2561,459,86,53,139,5.567391304347826,48.21582803978257
Task_26538,1798,381,132,125,257,4.706806282722513,36.932370280065534
Task_26539,1221,90,116,65,181,13.417582417582418,25.43600192975563
Task_26540,2302,118,129,154,283,19.34453781512605,43.75785453145073
Task_26541,715,494,64,196,260,1.4444444444444444,20.29022421927316
Task_26542,1221,785,107,143,250,1.5534351145038168,29.023790298040954
Task_26543,1620,833,120,149,269,1.9424460431654675,35.6316827178617
Task_26544,956,999,138,24,162,0.956,24.467536092132004
Task_26545,1787,116,105,186,291,15.273504273504274,35.69565965672425
Task_26546,1667,560,98,135,233,2.971479500891266,35.34290147653898
Task_26547,2224,766,121,28,149,2.8996088657105608,43.680360493646674
Task_26548,2698,636,89,69,158,4.235478806907379,51.031652621413436
Task_26549,1097,606,171,68,239,1.8072487644151565,26.109192895910535
Task_26550,1469,292,174,66,240,5.013651877133106,30.994184784052123
Task_26551,532,579,76,194,270,0.9172413793103448,17.66723913684844
Task_26552,742,864,191,162,353,0.8578034682080925,22.184821551944108
Task_26553,1069,342,176,102,278,3.116618075801749,25.334436915760495
Task_26554,1492,724,191,160,351,2.057931034482759,33.649911710855825
Task_26555,2326,540,74,171,245,4.299445471349353,45.877231760773014
Task_26556,772,348,138,24,162,2.2120343839541547,19.398429518160448
Task_26557,2705,780,142,22,164,3.463508322663252,51.44190442431441
Task_26558,1698,973,96,181,277,1.7433264887063655,37.37990746663115
Task_26559,1153,432,163,28,191,2.6628175519630486,25.94134348332658
Task_26560,1508,347,141,60,201,4.333333333333333,31.562084720317927
Task_26561,2411,348,173,180,353,6.908309455587393,47.03340151908137
Task_26562,2932,212,41,28,69,13.765258215962442,52.01726204043397
Task_26563,1358,204,115,89,204,6.624390243902439,29.043989020525117
Task_26564,1937,257,89,94,183,7.507751937984496,38.27716590773978
Task_26565,2108,376,19,67,86,5.591511936339523,40.30371317953492
Task_26566,871,540,149,145,294,1.609981515711645,22.947985646268677
Task_26567,683,842,166,121,287,0.8102016607354685,20.839775140655963
Task_26568,2791,335,77,155,232,8.306547619047619,52.48420044975854
Task_26569,1765,629,65,92,157,2.8015873015873014,36.57223619296712
Task_26570,2873,909,109,100,209,3.157142857142857,55.380091460050494
Task_26571,2220,685,163,59,222,3.2361516034985423,44.00692066045298
Task_26572,1111,515,14,111,125,2.1531007751937983,25.69411681968714
Task_26573,2300,421,99,31,130,5.450236966824645,43.658251809113494
Task_26574,2155,153,176,197,373,13.993506493506494,42.19237884005605
Task_26575,1780,506,124,171,295,3.510848126232742,37.288799257035215
Task_26576,513,898,126,16,142,0.5706340378197998,17.13048108160687
Task_26577,2959,377,189,85,274,7.828042328042328,55.228566455085506
Task_26578,2598,964,57,185,242,2.6922279792746115,51.534080698638085
Task_26579,2915,526,72,133,205,5.531309297912713,54.92134624932106
Task_26580,987,333,78,160,238,2.9550898203592815,23.980236589489493
Task_26581,1136,486,79,72,151,2.3326488706365502,25.93564207132664
Task_26582,1079,884,79,185,264,1.2192090395480226,27.23620259541758
Task_26583,676,487,165,141,306,1.3852459016393444,19.703057501695934
Task_26584,835,284,90,96,186,2.9298245614035086,21.022365058266708
Task_26585,1256,227,176,55,231,5.508771929824562,27.323772474584118
Task_26586,599,610,158,98,256,0.9803600654664485,18.609808902050876
Task_26587,1355,971,153,82,235,1.3940329218106995,31.48867609579557
Task_26588,2108,181,113,196,309,11.582417582417582,41.267199874837594
Task_26589,643,663,22,186,208,0.9683734939759037,19.292740123895438
Task_26590,1159,317,81,74,155,3.6446540880503147,25.826231017007988
Task_26591,1780,75,199,33,232,23.42105263157895,34.06464734855732
Task_26592,2092,939,137,130,267,2.225531914893617,43.4035839205584
Task_26593,1545,684,29,24,53,2.2554744525547443,31.56513693346719
Task_26594,1608,849,29,198,227,1.891764705882353,35.37632874825855
Task_26595,2909,228,16,146,162,12.703056768558952,53.407366720040066
Task_26596,2272,560,130,49,179,4.049910873440285,44.11730832566684
Task_26597,2207,987,187,21,208,2.233805668016194,44.38031191063388
Task_26598,1947,666,150,95,245,2.91904047976012,40.11598696921494
Task_26599,1299,805,25,84,109,1.6116625310173698,29.33594742725055
Task_26600,2277,771,178,31,209,2.949481865284974,44.901921058720454
Task_26601,1161,116,96,62,158,9.923076923076923,24.48469451144479
Task_26602,1802,136,107,77,184,13.153284671532846,35.15025798903488
Task_26603,700,520,121,138,259,1.3435700575815739,19.976690629079233
Task_26604,2741,275,187,35,222,9.931159420289855,50.68505195973922
Task_26605,2650,973,37,176,213,2.7207392197125255,52.19970338061541
Task_26606,2029,213,128,16,144,9.481308411214954,38.63891303559224
Task_26607,2345,1000,150,49,199,2.3426573426573425,46.756359071888
Task_26608,2110,239,175,165,340,8.791666666666666,41.81325183657385
Task_26609,2330,391,145,160,305,5.9438775510204085,45.65028798520351
Task_26610,2710,791,198,95,293,3.4217171717171717,52.812136192179246
Task_26611,1173,299,117,106,223,3.91,26.597405075222458
Task_26612,1278,535,130,187,317,2.3843283582089554,29.555221531211092
Task_26613,1173,404,158,52,210,2.8962962962962964,26.538769861228918
Task_26614,1963,974,57,60,117,2.013333333333333,40.075101573584824
Task_26615,1569,767,165,171,336,2.04296875,34.95234327340551
Task_26616,1156,140,111,66,177,8.198581560283689,24.842724678738403
Task_26617,1737,434,142,176,318,3.9931034482758623,36.48866796968393
Task_26618,1319,395,126,18,144,3.330808080808081,28.043123330350227
Task_26619,2390,967,96,95,191,2.46900826446281,47.83833176993941
Task_26620,1985,746,19,162,181,2.6572958500669346,40.71617062457655
Task_26621,2188,712,68,85,153,3.0687237026647964,43.48440855255648
Task_26622,2156,632,111,133,244,3.406003159557662,43.356792448523784
Task_26623,2281,710,135,95,230,3.208157524613221,45.47731396841033
Task_26624,2028,588,42,49,91,3.443123938879457,39.532774220326324
Task_26625,2251,425,18,151,169,5.284037558685446,43.82572631380973
Task_26626,1346,441,41,75,116,3.0452488687782804,28.97652274832468
Task_26627,2616,464,65,12,77,5.625806451612903,47.835215468063886
Task_26628,1971,402,107,141,248,4.890818858560794,39.72120756944678
Task_26629,1522,816,17,101,118,1.8629130966952265,32.95586859454667
Task_26630,687,382,42,146,188,1.793733681462141,19.080699103374407
Task_26631,1575,748,118,62,180,2.102803738317757,33.79112291201449
Task_26632,2634,676,17,126,143,3.8906942392909896,50.365773536820484
Task_26633,1740,800,55,179,234,2.1722846441947565,37.38593214252755
Task_26634,729,117,62,183,245,6.177966101694915,18.901794852850248
Task_26635,1623,454,102,189,291,3.5670329670329672,34.64589476813038
Task_26636,2336,622,158,160,318,3.749598715890851,46.54902956210365
Task_26637,1005,575,63,128,191,1.7447916666666667,24.757090003458902
Task_26638,1071,299,145,131,276,3.57,25.260277447486317
Task_26639,1470,659,145,135,280,2.227272727272727,32.74171214023725
Task_26640,1513,877,173,179,352,1.7232346241457859,34.477773825078664
Task_26641,1540,96,186,136,322,15.876288659793815,31.667418252705673
Task_26642,2787,735,155,123,278,3.786684782608696,53.81555903218052
Task_26643,2263,757,197,63,260,2.9854881266490767,45.13217875761626
Task_26644,957,574,129,65,194,1.6643478260869564,23.603024457871573
Task_26645,1435,642,56,100,156,2.2317262830482116,31.401434687359565
Task_26646,2458,213,84,102,186,11.485981308411215,46.401203981338234
Task_26647,1549,885,158,47,205,1.7483069977426637,33.72617759664521
Task_26648,1221,528,186,175,361,2.3081285444234405,28.811435360314068
Task_26649,2044,627,108,160,268,3.254777070063694,41.71491463168376
Task_26650,1086,314,122,166,288,3.447619047619048,25.651668615624967
Task_26651,2311,378,111,169,280,6.097625329815304,45.20701040531139
Task_26652,2111,600,66,182,248,3.512479201331115,42.71015154864305
Task_26653,1416,182,18,39,57,7.737704918032787,28.089938044908667
Task_26654,2280,382,35,99,134,5.953002610966058,43.78815299445099
Task_26655,593,419,97,157,254,1.411904761904762,17.973678802812366
Task_26656,2289,391,107,126,233,5.839285714285714,44.62721172298913
Task_26657,2935,771,175,117,292,3.801813471502591,56.3280302843145
Task_26658,503,666,99,78,177,0.7541229385307346,16.761711489406633
Task_26659,1520,679,117,181,298,2.235294117647059,33.744791662233986
Task_26660,2898,1014,141,116,257,2.8551724137931034,56.344129245624664
Task_26661,2090,923,15,121,136,2.261904761904762,42.499771557139205
Task_26662,1335,249,168,183,351,5.34,29.680666516128706
Task_26663,2227,719,145,82,227,3.0930555555555554,44.533000032705445
Task_26664,2753,894,42,108,150,3.075977653631285,52.99227684001215
Task_26665,516,490,133,42,175,1.0509164969450102,15.987953582893498
Task_26666,1951,740,56,164,220,2.6329284750337383,40.45611104763126
Task_26667,1483,690,37,35,72,2.14616497829233,30.695234175306908
Task_26668,1488,406,132,113,245,3.656019656019656,32.0366652926051
Task_26669,2728,241,73,68,141,11.272727272727273,50.26105428498723
Task_26670,1317,1002,161,74,235,1.313060817547358,30.884173784246215
Task_26671,2076,777,91,26,117,2.6683804627249357,40.990556501267626
Task_26672,733,961,159,134,293,0.761954261954262,22.05935280000662
Task_26673,2201,770,47,43,90,2.85473411154345,42.7214721754566
Task_26674,822,825,193,64,257,0.9951573849878934,22.56339483079486
Task_26675,698,368,29,185,214,1.89159891598916,19.384276538303467
Task_26676,2179,771,187,29,216,2.8225388601036268,43.37423647977486
Task_26677,2218,592,67,89,156,3.740303541315346,43.658906039938394
Task_26678,2289,773,60,141,201,2.9573643410852712,45.79454080172224
Task_26679,1410,355,14,17,31,3.960674157303371,28.09451934795681
Task_26680,2611,636,131,27,158,4.0989010989010985,49.38978753617216
Task_26681,623,435,44,20,64,1.4288990825688073,16.130370707010382
Task_26682,1627,425,39,101,140,3.81924882629108,33.6207500759303
Task_26683,2430,696,12,132,144,3.486370157819225,47.217351515810854
Task_26684,2286,508,40,42,82,4.491159135559921,43.18628286061837
Task_26685,1421,478,73,44,117,2.9665970772442587,29.67200835139893
Task_26686,2583,482,105,44,149,5.3478260869565215,48.45406095290293
Task_26687,2311,85,25,172,197,26.872093023255815,43.20560217074236
Task_26688,1732,83,97,67,164,20.61904761904762,33.3355149083229
Task_26689,2359,771,194,115,309,3.055699481865285,47.276509010417804
Task_26690,1295,366,149,140,289,3.5286103542234333,29.09202909810081
Task_26691,2793,902,188,151,339,3.0930232558139537,54.75123066901057
Task_26692,822,171,179,46,225,4.77906976744186,19.82576648091225
Task_26693,1409,383,28,70,98,3.6692708333333335,29.369414480074536
Task_26694,1159,327,91,17,108,3.533536585365854,24.942917489756187
Task_26695,1824,500,99,172,271,3.6407185628742513,37.86124954796819
Task_26696,2716,609,80,167,247,4.452459016393442,52.26939813098503
Task_26697,1310,626,43,175,218,2.0893141945773523,29.900207304180523
Task_26698,1194,937,97,27,124,1.2729211087420043,27.62849562492836
Task_26699,1605,358,121,165,286,4.47075208913649,33.993177700204775
Task_26700,1521,355,36,81,117,4.272471910112359,31.521864213613238
Task_26701,2584,871,36,145,181,2.963302752293578,50.60213290686274
Task_26702,2398,367,82,131,213,6.516304347826087,46.231011589803934
Task_26703,2624,651,163,54,217,4.024539877300613,50.296121456133754
Task_26704,1288,951,116,183,299,1.3529411764705883,30.875613104725996
Task_26705,1681,395,65,72,137,4.244949494949495,34.25967454906219
Task_26706,2828,357,94,27,121,7.899441340782123,51.64052753934169
Task_26707,1001,748,61,150,211,1.3364485981308412,25.313306291054317
Task_26708,2653,703,163,78,241,3.768465909090909,51.2361459975345
Task_26709,2168,103,76,143,219,20.846153846153847,41.278487749203755
Task_26710,837,665,99,23,122,1.2567567567567568,21.02227185394805
Task_26711,2688,938,145,189,334,2.862619808306709,53.233151591164734
Task_26712,2236,921,167,11,178,2.4251626898047722,44.470958227234746
Task_26713,612,429,26,75,101,1.4232558139534883,16.99801022887983
Task_26714,2242,756,132,154,286,2.961690885072655,45.32942078170032
Task_26715,1776,639,24,121,145,2.775,36.70415672776998
Task_26716,1179,278,192,70,262,4.225806451612903,26.468300991760543
Task_26717,2588,246,130,142,272,10.477732793522268,49.05044246196743
Task_26718,843,440,67,51,118,1.91156462585034,20.6911497514764
Task_26719,1468,893,119,87,206,1.6420581655480984,32.96423062657672
Task_26720,2868,954,65,67,132,3.0031413612565445,54.80551946465334
Task_26721,2932,803,101,189,290,3.646766169154229,56.4778275477481
Task_26722,581,394,153,188,341,1.4708860759493672,18.135413053107104
Task_26723,2507,362,40,47,87,6.90633608815427,46.22107613197764
Task_26724,1208,132,149,112,261,9.082706766917294,26.485491200589944
Task_26725,717,1011,159,181,340,0.708498023715415,22.30709635660047
Task_26726,1228,694,27,62,89,1.766906474820144,27.301136139395137
Task_26727,2566,367,196,27,223,6.9728260869565215,48.21182688201916
Task_26728,2082,479,171,55,226,4.3375,41.19733744853446
Task_26729,530,738,36,186,222,0.7171853856562923,17.962235898831576
Task_26730,896,428,141,124,265,2.0885780885780885,22.844508519472242
Task_26731,1418,249,23,119,142,5.672,29.74649630662591
Task_26732,1772,182,120,176,296,9.683060109289617,36.00130007380656
Task_26733,521,583,90,78,168,0.8921232876712328,16.72489043798247
Task_26734,2315,446,66,166,232,5.178970917225951,45.35073472916249
Task_26735,2909,314,94,15,109,9.234920634920634,52.609201788924054
Task_26736,2499,937,107,133,240,2.6641791044776117,49.72938196952007
Task_26737,1371,239,171,171,342,5.7125,30.156952753875455
Task_26738,1089,919,160,74,234,1.183695652173913,27.01052111645606
Task_26739,996,800,189,136,325,1.243445692883895,25.811725769563278
Task_26740,1414,422,69,154,223,3.342789598108747,30.950348917151675
Task_26741,1559,508,55,85,140,3.06286836935167,32.87080585835217
Task_26742,2932,441,150,146,296,6.633484162895928,55.28150485124055
Task_26743,940,303,40,142,182,3.0921052631578947,22.766627883205572
Task_26744,627,795,200,41,241,0.7876884422110553,19.052089835623168
Task_26745,634,634,19,15,34,0.9984251968503937,16.84905612995153
Task_26746,578,224,128,164,292,2.568888888888889,17.345522966904145
Task_26747,2873,969,97,88,185,2.961855670103093,55.35914584269559
Task_26748,2113,243,85,26,111,8.65983606557377,39.804416159324184
Task_26749,874,939,160,85,245,0.9297872340425531,23.858692610344864
Task_26750,2357,906,127,55,182,2.5986769570011026,46.67714421361233
Task_26751,1313,337,193,59,252,3.8846153846153846,28.674137572865913
Task_26752,2637,447,62,170,232,5.886160714285714,50.44605856580845
Task_26753,1482,715,77,115,192,2.069832402234637,32.74777193604996
Task_26754,648,230,15,28,43,2.8051948051948052,15.872944903177112
Task_26755,2936,496,161,85,246,5.907444668008048,55.13374036822517
Task_26756,2490,367,34,174,208,6.766304347826087,47.6969419870155
Task_26757,772,739,184,35,219,1.0432432432432432,21.009315167933003
Task_26758,2199,575,184,137,321,3.8177083333333335,44.21001756395594
Task_26759,1065,778,195,26,221,1.3671373555840822,25.750662425945112
Task_26760,676,323,45,139,184,2.0864197530864197,18.679029123367524
Task_26761,2953,217,93,47,140,13.545871559633028,53.430955617134195
Task_26762,996,885,78,60,138,1.1241534988713318,24.805520654980118
Task_26763,1734,746,110,19,129,2.321285140562249,35.681824618711794
Task_26764,2869,380,116,122,238,7.530183727034121,53.78383918520088
Task_26765,2460,872,11,88,99,2.8178694158075603,47.65311566435168
Task_26766,723,976,170,130,300,0.7400204708290685,21.935816517507817
Task_26767,2331,866,119,86,205,2.688581314878893,46.55272589148589
Task_26768,2257,86,20,109,129,25.942528735632184,41.538764896902784
Task_26769,2481,646,103,180,283,3.8346213292117466,48.79317394103225
Task_26770,2455,348,90,55,145,7.034383954154728,46.2721630261523
Task_26771,2595,732,36,156,192,3.540245566166439,50.439917409401524
Task_26772,2118,440,37,34,71,4.802721088435374,39.9501738084433
Task_26773,576,953,192,61,253,0.6037735849056604,19.137345601483783
Task_26774,2121,787,108,160,268,2.6916243654822334,43.43728403841468
Task_26775,1533,688,172,59,231,2.2249637155297535,33.17490669664223
Task_26776,2711,963,189,81,270,2.8122406639004147,53.12477421675106
Task_26777,566,171,20,57,77,3.2906976744186047,14.753485647048501
Task_26778,924,674,45,177,222,1.3688888888888888,23.913904152574947
Task_26779,2515,918,112,64,176,2.736670293797606,49.2299168029046
Task_26780,1341,175,56,190,246,7.619318181818182,28.856872610697838
Task_26781,1099,479,139,11,150,2.2895833333333333,24.852942017750152
Task_26782,708,614,40,155,195,1.1512195121951219,20.101395906925216
Task_26783,2592,883,119,30,149,2.932126696832579,49.883595088574545
Task_26784,708,520,115,131,246,1.3589251439539347,20.03449789203081
Task_26785,2545,966,186,142,328,2.6318510858324715,50.95858100960938
Task_26786,2485,641,110,131,241,3.870716510903427,48.579553732913006
Task_26787,818,469,120,177,297,1.7404255319148936,21.94727910978935
Task_26788,1857,1009,107,181,288,1.8386138613861387,40.06661384746276
Task_26789,2632,901,162,125,287,2.917960088691796,51.9245243586487
Task_26790,2585,839,34,138,172,3.0773809523809526,50.47014545231881
Task_26791,1629,785,196,11,207,2.072519083969466,34.57111001782069
Task_26792,1853,872,169,100,269,2.122565864833906,39.37298563389157
Task_26793,2500,784,40,72,112,3.1847133757961785,48.20951898447466
Task_26794,2200,574,143,107,250,3.8260869565217392,43.858694295574985
Task_26795,533,288,128,67,195,1.8442906574394464,15.983900144001275
Task_26796,2514,664,114,45,159,3.780451127819549,47.951953384628034
Task_26797,1058,159,117,81,198,6.6125,23.824153164739652
Task_26798,2216,176,79,174,253,12.519774011299434,42.69283672454417
Task_26799,679,750,149,127,276,0.9041278295605859,20.445524649237132
Task_26800,2821,901,174,65,239,3.1274944567627494,54.35326680430728
Task_26801,1814,678,99,46,145,2.6715758468335786,36.916407742374204
Task_26802,1625,882,159,180,339,1.840317100792752,36.22423831371377
Task_26803,2560,727,125,159,284,3.5164835164835164,50.2741751982775
Task_26804,1309,642,69,42,111,2.035769828926905,28.425965947635756
Task_26805,2599,542,138,157,295,4.786372007366483,50.350520235443184
Task_26806,1463,150,79,174,253,9.688741721854305,30.775358932899294
Task_26807,2910,312,162,98,260,9.297124600638977,54.26875952320745
Task_26808,1095,574,153,52,205,1.9043478260869566,25.817379762472996
Task_26809,2326,896,33,28,61,2.593088071348941,44.66294593847729
Task_26810,2486,568,194,12,206,4.3690685413005275,47.45893750008768
Task_26811,2565,454,177,52,229,5.637362637362638,48.815997962057054
Task_26812,1336,819,188,49,237,1.6292682926829267,30.37367103934407
Task_26813,2720,257,191,10,201,10.542635658914728,50.091699193936385
Task_26814,1069,1010,94,140,234,1.0573689416419387,27.2168720617522
Task_26815,1833,745,161,53,214,2.4571045576407506,38.09119208017148
Task_26816,2749,691,199,157,356,3.972543352601156,53.47592010288084
Task_26817,1636,384,188,26,214,4.249350649350649,33.512581432278196
Task_26818,1564,458,86,105,191,3.4074074074074074,33.111233362278774
Task_26819,646,182,137,22,159,3.530054644808743,16.810524640593442
Task_26820,1034,813,131,133,264,1.2702702702702702,26.17803400272942
Task_26821,938,898,180,108,288,1.0433815350389322,24.992877159741525
Task_26822,2059,941,183,137,320,2.185774946921444,43.13602508094493
Task_26823,2041,236,85,113,198,8.611814345991561,40.00211788939806
Task_26824,788,760,51,91,142,1.0354796320630748,21.402985618540598
Task_26825,533,204,125,182,307,2.6,16.663691887350648
Task_26826,1776,750,28,31,59,2.3648468708388815,35.449160865065345
Task_26827,1245,985,176,144,320,1.2626774847870184,30.322693670229793
Task_26828,1266,431,52,193,245,2.9305555555555554,28.79275539497182
Task_26829,1512,475,183,70,253,3.176470588235294,32.33242228501201
Task_26830,2100,326,193,49,242,6.422018348623853,40.926713852256505
Task_26831,1418,887,186,128,314,1.5968468468468469,32.757525352639725
Task_26832,1585,984,114,88,202,1.6091370558375635,35.086251019441114
Task_26833,2552,1006,112,184,296,2.5342601787487586,51.111515882128494
Task_26834,1922,173,75,99,174,11.045977011494253,37.558988420736085
Task_26835,809,430,39,48,87,1.877030162412993,19.637774687772804
Task_26836,1712,437,169,128,297,3.9086757990867578,35.93764270990184
Task_26837,2478,697,68,68,136,3.5501432664756445,47.80631675258481
Task_26838,1803,440,168,83,251,4.08843537414966,37.042348929381134
Task_26839,2387,279,52,25,77,8.525,43.62527725581529
Task_26840,1853,520,69,78,147,3.5566218809980805,37.588615468497295
Task_26841,653,528,146,198,344,1.2344045368620038,19.71093930190268
Task_26842,2660,946,37,102,139,2.808870116156283,51.63978898575476
Task_26843,716,551,157,75,232,1.2971014492753623,19.949930254182707
Task_26844,1563,677,60,173,233,2.3053097345132745,34.1843276995182
Task_26845,603,78,78,57,135,7.632911392405063,15.313574442733461
Task_26846,957,736,184,200,384,1.2985074626865671,25.358410781278565
Task_26847,2130,513,185,187,372,4.143968871595331,43.22282790012076
Task_26848,1203,966,193,45,238,1.2440537745604965,28.617003835920304
Task_26849,1044,938,58,62,120,1.1118210862619808,25.43227686851579
Task_26850,1133,623,14,144,158,1.8157051282051282,26.54799624219036
Task_26851,2950,333,11,76,87,8.832335329341317,53.52361566820242
Task_26852,2060,182,153,62,215,11.256830601092895,39.782479518396364
Task_26853,2202,133,177,130,307,16.432835820895523,42.37744955111678
Task_26854,2209,293,191,99,290,7.51360544217687,43.241790339479735
Task_26855,1840,744,125,161,286,2.469798657718121,38.933687030790495
Task_26856,2766,728,33,53,86,3.794238683127572,51.73291338610297
Task_26857,1618,782,200,51,251,2.0664112388250317,34.90241918408082
Task_26858,1826,461,79,124,203,3.9523809523809526,37.44960863202938
Task_26859,1027,728,144,23,167,1.4087791495198903,24.70659010254762
Task_26860,821,85,199,144,343,9.546511627906977,20.479511533060194
Task_26861,2321,215,183,139,322,10.74537037037037,44.93648562311614
Task_26862,2185,715,151,16,167,3.0516759776536313,42.961062527635114
Task_26863,2459,313,107,113,220,7.8312101910828025,46.97498868500852
Task_26864,1869,921,14,19,33,2.027114967462039,37.14997775448145
Task_26865,2531,507,156,39,195,4.982283464566929,48.026299425302795
Task_26866,1082,670,192,37,229,1.6125186289120714,25.77644955791648
Task_26867,1176,662,63,22,85,1.7737556561085972,25.986586301865486
Task_26868,503,980,12,73,85,0.5127420998980632,16.866223430299627
Task_26869,2321,741,124,133,257,3.128032345013477,46.37234051684674
Task_26870,2555,823,189,56,245,3.1007281553398056,49.8640883185028
Task_26871,1923,955,92,32,124,2.0115062761506275,39.28883957337617
Task_26872,2792,161,48,100,148,17.234567901234566,50.7912481514301
Task_26873,1389,185,87,15,102,7.467741935483871,28.051000016123933
Task_26874,2827,127,44,43,87,22.0859375,50.02867891624826
Task_26875,1284,267,150,72,222,4.791044776119403,27.970969458378534
Task_26876,1768,634,173,44,217,2.784251968503937,36.44674741890545
Task_26877,831,786,122,19,141,1.0559085133418042,21.55097238364786
Task_26878,1035,963,198,36,234,1.0736514522821576,25.93968541225593
Task_26879,1410,391,166,184,350,3.5969387755102042,31.331488549515118
Task_26880,1083,319,82,194,276,3.384375,25.6494528632608
Task_26881,601,700,93,105,198,0.8573466476462197,18.698581059140714
Task_26882,2983,592,140,124,264,5.03035413153457,56.403661362224135
Task_26883,2571,719,100,144,244,3.5708333333333333,50.22093536745016
Task_26884,577,512,59,183,242,1.124756335282651,18.022080547135236
Task_26885,570,535,169,23,192,1.0634328358208955,17.006105772662753
Task_26886,2341,811,104,21,125,2.8830049261083746,45.364420641157274
Task_26887,604,311,17,136,153,1.935897435897436,17.101553639201146
Task_26888,1448,781,190,151,341,1.8516624040920715,33.072233290062705
Task_26889,1818,729,81,112,193,2.4904109589041097,38.10056617797208
Task_26890,2576,217,26,134,160,11.81651376146789,48.029275613944264
Task_26891,1548,574,33,140,173,2.692173913043478,33.21325283787039
Task_26892,2295,697,94,32,126,3.2879656160458453,44.49528440302421
Task_26893,1076,499,149,123,272,2.152,25.94724832532602
Task_26894,1555,342,21,175,196,4.533527696793003,32.74057535589656
Task_26895,1951,457,86,198,284,4.259825327510917,39.78911562762308
Task_26896,1193,315,52,176,228,3.7753164556962027,27.163181942560694
Task_26897,2524,868,15,87,102,2.904487917146145,48.79933213049848
Task_26898,2023,636,144,173,317,3.1758241758241756,41.650621340633776
Task_26899,2211,763,145,30,175,2.893979057591623,43.661936723897576
Task_26900,2604,140,117,56,173,18.46808510638298,47.66289015608908
Task_26901,2272,793,129,159,288,2.861460957178841,45.937016689497085
Task_26902,2479,852,16,164,180,2.906213364595545,48.87236509890403
Task_26903,1408,701,194,78,272,2.005698005698006,31.64831668478446
Task_26904,1746,249,174,139,313,6.984,35.93861380759191
Task_26905,2262,551,168,117,285,4.0978260869565215,44.939579115450385
Task_26906,1623,957,191,96,287,1.6941544885177453,36.082850698831315
Task_26907,986,707,149,29,178,1.3926553672316384,24.094868405741238
Task_26908,2754,529,69,64,133,5.19622641509434,51.65194778986966
Task_26909,1452,913,41,125,166,1.588621444201313,32.658038681337665
Task_26910,886,131,85,156,241,6.712121212121212,21.3996289325181
Task_26911,734,689,157,41,198,1.063768115942029,20.17173693846765
Task_26912,740,581,195,98,293,1.2714776632302405,20.887779818335137
Task_26913,972,956,30,154,184,1.0156739811912225,25.22321094268894
Task_26914,735,247,103,59,162,2.963709677419355,18.762602944983694
Task_26915,1949,842,142,36,178,2.3119810201660735,39.77240336302018
Task_26916,1601,282,77,154,231,5.657243816254417,33.4802425950285
Task_26917,1128,427,40,50,90,2.635514018691589,24.763497449669796
Task_26918,2745,177,20,14,34,15.42134831460674,48.55256676188904
Task_26919,1233,489,164,126,290,2.516326530612245,28.486737977554498
Task_26920,2159,813,40,174,214,2.652334152334152,43.90766682956623
Task_26921,1964,101,72,72,144,19.254901960784313,37.090225194941915
Task_26922,648,534,158,194,352,1.2112149532710281,19.68063609012124
Task_26923,2269,852,135,44,179,2.660023446658851,44.884271528692835
Task_26924,1994,577,164,44,208,3.449826989619377,39.8053914683445
Task_26925,2743,222,68,128,196,12.300448430493274,51.116769669884974
Task_26926,2358,786,183,119,302,2.9961880559085134,47.28202884795746
Task_26927,1554,513,143,113,256,3.0233463035019454,33.472218538155836
Task_26928,2063,819,179,20,199,2.515853658536585,41.53315823465837
Task_26929,2029,882,103,72,175,2.2978482446206114,41.48036242905858
Task_26930,1141,326,94,41,135,3.489296636085627,25.056641771276848
Task_26931,2938,367,164,179,343,7.983695652173913,55.388047710149635
Task_26932,1449,228,44,95,139,6.327510917030568,30.201853214718295
Task_26933,1290,281,16,96,112,4.574468085106383,27.57892190595061
Task_26934,2969,670,50,119,169,4.424739195230998,56.04550204638152
Task_26935,1946,796,46,21,67,2.4416562107904642,38.2452989292867
Task_26936,2357,671,188,170,358,3.5074404761904763,47.2315983454918
Task_26937,1160,721,11,134,145,1.6066481994459834,27.1913651359957
Task_26938,730,700,153,136,289,1.0413694721825963,21.130068606877515
Task_26939,2222,335,15,155,170,6.613095238095238,43.07762136665241
Task_26940,2160,102,13,22,35,20.97087378640777,38.82091556863468
Task_26941,790,1013,84,138,222,0.7790927021696252,22.7888062014796
Task_26942,2291,991,13,13,26,2.309475806451613,44.030342837412064
Task_26943,2562,822,120,25,145,3.1130012150668285,49.171776608736614
Task_26944,2651,285,170,47,217,9.26923076923077,49.30802806780047
Task_26945,1927,664,96,106,202,2.8977443609022555,39.609451409776874
Task_26946,625,517,176,37,213,1.2065637065637065,17.988404947568448
Task_26947,1900,72,103,15,118,26.027397260273972,34.8531596968465
Task_26948,2810,160,51,79,130,17.453416149068325,51.02603241141506
Task_26949,656,147,17,186,203,4.4324324324324325,17.681737994679764
Task_26950,2987,735,45,16,61,4.0584239130434785,54.472955634260565
Task_26951,724,416,168,142,310,1.73621103117506,20.300532316349095
Task_26952,2675,591,122,15,137,4.518581081081081,50.04811573330968
Task_26953,952,326,135,190,325,2.91131498470948,23.77334923101291
Task_26954,2350,533,118,134,252,4.400749063670412,46.15156296170775
Task_26955,1225,486,16,38,54,2.515400410677618,25.955717918217925
Task_26956,2217,274,163,188,351,8.061818181818182,43.71299318565834
Task_26957,2938,816,171,126,297,3.5960832313341493,56.552980657388254
Task_26958,581,533,58,96,154,1.0880149812734083,17.44683117130977
Task_26959,2227,331,52,178,230,6.707831325301205,43.58027021263931
Task_26960,2751,830,84,31,115,3.3104693140794224,51.86857030670239
Task_26961,2540,252,143,30,173,10.039525691699605,47.17991579072061
Task_26962,1578,101,154,108,262,15.470588235294118,32.03697820102091
Task_26963,1158,749,140,179,319,1.544,28.277628538628264
Task_26964,2279,508,127,125,252,4.477406679764243,44.93402026551411
Task_26965,2935,628,71,110,181,4.666136724960254,55.38624282686687
Task_26966,1331,296,37,158,195,4.481481481481482,29.059402798304948
Task_26967,1627,748,138,110,248,2.172229639519359,35.32587399931329
Task_26968,2349,802,68,148,216,2.925280199252802,46.91765597347965
Task_26969,1923,176,153,197,350,10.864406779661017,38.46831015963142
Task_26970,649,473,78,94,172,1.369198312236287,18.59259601382603
Task_26971,1357,808,109,29,138,1.6773794808405438,29.953741083414414
Task_26972,2752,630,131,189,320,4.361331220285262,53.2144400387491
Task_26973,704,955,183,107,290,0.7364016736401674,21.502146055439116
Task_26974,2514,710,74,109,183,3.5358649789029535,48.986165459812945
Task_26975,1543,759,193,171,364,2.030263157894737,34.64170563712342
Task_26976,1706,467,86,193,279,3.6452991452991452,35.91330136598455
Task_26977,632,904,109,144,253,0.6983425414364641,20.184573606797304
Task_26978,2277,324,186,17,203,7.006153846153846,43.336446967860944
Task_26979,2404,440,23,40,63,5.45124716553288,44.48452324406651
Task_26980,2822,641,91,172,263,4.395638629283489,54.07564571239475
Task_26981,936,882,118,143,261,1.0600226500566252,24.841298320763652
Task_26982,2684,831,73,126,199,3.2259615384615383,52.194046038242824
Task_26983,955,725,28,183,211,1.315426997245179,24.47905892940611
Task_26984,1491,754,90,155,245,1.9748344370860926,33.236885071267736
Task_26985,1510,694,138,27,165,2.172661870503597,32.29252133323805
Task_26986,1946,536,17,197,214,3.623836126629423,39.64375191014573
Task_26987,803,637,33,75,108,1.2586206896551724,20.84031108944734
Task_26988,2014,109,23,25,48,18.30909090909091,36.74274626232278
Task_26989,1214,386,103,108,211,3.136950904392765,27.47635976247913
Task_26990,1840,511,26,90,116,3.59375,37.058273257607375
Task_26991,2503,324,146,120,266,7.701538461538462,47.92640841526039
Task_26992,572,870,109,154,263,0.6567164179104478,19.212696834236645
Task_26993,840,458,14,19,33,1.8300653594771241,19.4063618385341
Task_26994,1515,626,150,164,314,2.416267942583732,33.54682326826923
Task_26995,1724,830,165,98,263,2.0746089049338146,37.175822617945656
Task_26996,2916,915,53,93,146,3.183406113537118,55.7246043582947
Task_26997,1145,882,38,112,150,1.2967157417893544,27.405024142639164
Task_26998,1564,950,97,18,115,1.6445846477392219,33.33414370183335
Task_26999,1313,765,146,118,264,1.7140992167101827,30.474872977116757
Task_27000,1816,941,166,176,342,1.9278131634819533,39.44175841467784
Task_27001,2616,355,51,175,226,7.348314606741573,49.818318256419644
Task_27002,1487,269,128,140,268,5.507407407407407,31.71356064847851
Task_27003,1999,683,12,120,132,2.922514619883041,40.32390334505367
Task_27004,698,1017,69,120,189,0.6856581532416502,21.360772870209956
Task_27005,2382,731,133,132,265,3.2540983606557377,47.34182107411573
Task_27006,2587,839,126,84,210,3.079761904761905,50.535729153732206
Task_27007,2796,931,117,197,314,3.0,54.84422582980314
Task_27008,971,864,22,12,34,1.1225433526011561,22.858014106733048
Task_27009,2427,75,33,163,196,31.93421052631579,44.932312108271965
Task_27010,1993,248,116,184,300,8.004016064257028,39.84495699475417
Task_27011,876,831,183,125,308,1.0528846153846154,23.918243224027236
Task_27012,1980,218,25,56,81,9.04109589041096,37.55828290713145
Task_27013,2014,305,108,73,181,6.5816993464052285,39.4115452215369
Task_27014,2287,456,146,152,298,5.00437636761488,45.139607326900034
Task_27015,1968,827,97,176,273,2.3768115942028984,41.191937209301805
Task_27016,1117,183,36,37,73,6.070652173913044,23.423587904592537
Task_27017,982,932,82,106,188,1.052518756698821,25.32371189863144
Task_27018,2455,669,27,94,121,3.6641791044776117,47.361431179116266
Task_27019,1031,121,148,150,298,8.450819672131148,23.858378479720074
Task_27020,2988,209,78,107,185,14.228571428571428,54.81287854204361
Task_27021,1839,830,104,132,236,2.2129963898916967,38.9184903808622
Task_27022,2146,875,30,46,76,2.449771689497717,41.801807646896755
Task_27023,1778,837,57,115,172,2.1217183770883055,37.69485478826876
Task_27024,2679,154,72,44,116,17.283870967741937,48.107809718496696
Task_27025,2268,495,170,76,246,4.57258064516129,44.44753632060414
Task_27026,2445,780,166,46,212,3.1306017925736236,47.621293068175106
Task_27027,2315,446,13,167,180,5.178970917225951,44.99430626146313
Task_27028,2039,123,13,62,75,16.443548387096776,37.56672178324194
Task_27029,1022,611,136,131,267,1.6699346405228759,25.41846272209324
Task_27030,2644,708,174,136,310,3.7291960507757405,51.62833383945942
Task_27031,2924,645,14,65,79,4.526315789473684,53.84104390914032
Task_27032,1500,363,59,114,173,4.1208791208791204,31.802290521819796
Task_27033,1311,224,133,60,193,5.826666666666667,27.999271855094197
Task_27034,1231,487,10,144,154,2.5225409836065573,27.595886451643793
Task_27035,784,399,178,148,326,1.96,21.2908274893248
Task_27036,1346,395,51,96,147,3.398989898989899,29.269626059987605
Task_27037,2117,471,125,51,176,4.485169491525424,41.47239444904142
Task_27038,579,624,133,110,243,0.9264,18.295104771516453
Task_27039,2684,266,160,122,282,10.05243445692884,50.657226103627615
Task_27040,2492,483,87,182,269,5.148760330578512,48.34578044597217
Task_27041,1600,693,180,93,273,2.3054755043227666,34.797665686460356
Task_27042,1026,1021,197,30,227,1.0039138943248533,25.89527498521886
Task_27043,2960,889,11,30,41,3.3258426966292136,54.5369515850549
Task_27044,629,169,61,88,149,3.7,16.775380804449693
Task_27045,2987,271,143,152,295,10.981617647058824,55.56696252009832
Task_27046,1361,856,20,173,193,1.588098016336056,31.238180885997537
Task_27047,2755,320,35,67,102,8.582554517133957,50.527052707825725
Task_27048,1348,579,197,100,297,2.3241379310344827,30.584207831088637
Task_27049,2119,790,167,45,212,2.678887484197219,42.46768152269862
Task_27050,1410,787,80,43,123,1.7893401015228427,30.559012997572854
Task_27051,2847,226,64,125,189,12.541850220264317,52.73306837719178
Task_27052,2555,336,66,147,213,7.5816023738872405,48.668187690977184
Task_27053,2079,527,157,172,329,3.9375,42.244340997278584
Task_27054,1204,80,10,112,122,14.864197530864198,24.83176435406807
Task_27055,1083,293,116,90,206,3.683673469387755,25.02305597918523
Task_27056,1823,96,182,16,198,18.79381443298969,34.63170782918927
Task_27057,1511,998,191,50,241,1.5125125125125125,33.71417092244089
Task_27058,2454,354,119,63,182,6.912676056338028,46.47387295033476
Task_27059,1723,576,161,108,269,2.9861351819757367,36.39862761020722
Task_27060,2478,972,33,137,170,2.5467625899280577,49.15789758875919
Task_27061,2109,504,181,186,367,4.176237623762376,42.837521491706696
Task_27062,1796,632,83,94,177,2.8372827804107423,37.30653285395684
Task_27063,2709,372,116,10,126,7.262734584450402,49.82979858683584
Task_27064,1069,413,179,104,283,2.582125603864734,25.586675168168217
Task_27065,1872,357,72,38,110,5.229050279329609,36.39812381389274
Task_27066,1541,103,30,28,58,14.817307692307692,29.403217692536913
Task_27067,655,950,166,24,190,0.6887486855941115,19.871160536719913
Task_27068,2510,406,85,132,217,6.167076167076167,48.11655944845814
Task_27069,2094,668,162,59,221,3.1300448430493275,41.95309251956825
Task_27070,2397,303,66,72,138,7.884868421052632,45.29613282186984
Task_27071,2103,154,118,122,240,13.567741935483872,40.6679113329325
Task_27072,556,152,82,158,240,3.633986928104575,16.4009975857626
Task_27073,2181,488,39,52,91,4.460122699386503,41.79646305146406
Task_27074,1373,678,190,107,297,2.0220913107511045,31.30026192829015
Task_27075,790,446,61,24,85,1.767337807606264,19.187340297554183
Task_27076,2404,542,53,80,133,4.427255985267035,46.37046568011829
Task_27077,2787,693,116,23,139,4.015850144092219,52.21036633346242
Task_27078,1873,300,103,68,171,6.222591362126246,37.038471479550665
Task_27079,2027,168,142,182,324,11.994082840236686,39.990160690878156
Task_27080,2552,572,30,180,210,4.453752181500873,49.35629062030035
Task_27081,1345,529,143,136,279,2.5377358490566038,30.35112998379888
Task_27082,1657,786,183,74,257,2.1054637865311308,35.72909177749029
Task_27083,1393,347,184,121,305,4.002873563218391,30.624941478363294
Task_27084,2250,669,136,88,224,3.3582089552238807,44.747203637028996
Task_27085,2975,922,152,65,217,3.2231852654387865,56.76005576434088
Task_27086,681,850,50,112,162,0.800235017626322,20.22007774505619
Task_27087,1375,380,116,133,249,3.608923884514436,30.212298492357576
Task_27088,2151,77,49,83,132,27.576923076923077,39.88609607307856
Task_27089,882,889,179,16,195,0.9910112359550561,23.11293742638126
Task_27090,2008,522,107,32,139,3.8393881453154877,39.38913705680206
Task_27091,636,306,185,175,360,2.0716612377850163,18.84818334978969
Task_27092,1991,843,62,183,245,2.359004739336493,41.549761360247246
Task_27093,1669,461,177,135,312,3.6125541125541125,35.41188349849666
Task_27094,2790,373,13,37,50,7.459893048128342,50.334281134255775
Task_27095,2040,132,63,142,205,15.338345864661655,39.403350459162
Task_27096,2407,740,135,199,334,3.2483130904183537,48.17536317001886
Task_27097,2239,854,83,66,149,2.6187134502923977,44.54151211724366
Task_27098,1020,662,163,39,202,1.5384615384615385,24.61663089124241
Task_27099,1646,109,146,25,171,14.963636363636363,31.986829270904725
Task_27100,2754,646,133,168,301,4.256568778979907,53.18060382110838
Task_27101,1161,853,122,10,132,1.3594847775175645,26.88510327497843
Task_27102,2543,770,122,12,134,3.298313878080415,48.54251143937601
Task_27103,2262,291,30,131,161,7.7465753424657535,43.385198716419644
Task_27104,2489,206,169,76,245,12.02415458937198,46.942579917764256
Task_27105,1215,1005,160,30,190,1.2077534791252484,28.72539495905644
Task_27106,1539,900,51,43,94,1.7081021087680355,32.622895775107224
Task_27107,1301,704,48,106,154,1.845390070921986,29.43196636897099
Task_27108,2499,402,184,39,223,6.200992555831266,47.30278003034146
Task_27109,961,511,53,77,130,1.876953125,23.334301575299122
Task_27110,1462,525,34,39,73,2.779467680608365,29.82458273874531
Task_27111,1503,366,40,18,58,4.0953678474114446,29.829430963171443
Task_27112,1441,512,104,115,219,2.8089668615984404,31.51619547429084
Task_27113,2049,668,199,154,353,3.062780269058296,42.297649445496425
Task_27114,2133,690,29,32,61,3.0868306801736614,40.92259997032986
Task_27115,1789,81,175,156,331,21.817073170731707,35.58674353593985
Task_27116,981,298,70,58,128,3.280936454849498,22.819952624992755
Task_27117,2635,397,77,146,223,6.6206030150753765,50.17307261250385
Task_27118,2495,176,33,122,155,14.096045197740112,46.119536902580336
Task_27119,1808,353,193,89,282,5.107344632768362,37.015912554691305
Task_27120,2483,743,194,176,370,3.3373655913978495,49.517296807718616
Task_27121,1103,806,56,55,111,1.3667905824039652,25.774746883627326
Task_27122,2234,143,16,53,69,15.51388888888889,40.874552089324915
Task_27123,2416,475,119,143,262,5.07563025210084,47.067768841020495
Task_27124,1534,565,126,155,281,2.7102473498233217,33.494059639752585
Task_27125,2979,616,82,93,175,4.828200972447326,55.9756683783724
Task_27126,1711,348,95,41,136,4.902578796561604,34.13803579566736
Task_27127,681,161,15,38,53,4.203703703703703,16.338432133711205
Task_27128,2888,416,99,123,222,6.925659472422062,54.13650762730318
Task_27129,2692,186,37,42,79,14.39572192513369,48.45934601392998
Task_27130,997,169,99,102,201,5.864705882352941,23.075084436060404
Task_27131,1656,872,104,52,156,1.8969072164948453,35.291713622361804
Task_27132,2163,573,147,123,270,3.768292682926829,43.38320194205959
Task_27133,618,194,70,122,192,3.169230769230769,17.414392298304588
Task_27134,2414,836,96,117,213,2.884109916367981,47.929513355921564
Task_27135,2960,239,200,57,257,12.333333333333334,54.396000134924826
Task_27136,1924,742,129,194,323,2.58950201884253,40.47326047862652
Task_27137,2041,202,116,167,283,10.054187192118226,40.33108067647985
Task_27138,2334,534,85,72,157,4.3626168224299064,45.050017259635524
Task_27139,1979,246,100,151,251,8.012145748987853,39.347378399250225
Task_27140,959,917,41,171,212,1.0446623093681917,25.09163905788021
Task_27141,954,269,22,143,165,3.533333333333333,22.785589001139886
Task_27142,1725,743,56,30,86,2.318548387096774,34.97660259116825
Task_27143,1692,807,21,144,165,2.094059405940594,36.17102477652617
Task_27144,1872,800,27,19,46,2.337078651685393,36.93048846074859
Task_27145,2864,128,198,128,326,22.2015503875969,52.855461345448894
Task_27146,1134,101,162,197,359,11.117647058823529,25.63009287863782
Task_27147,2417,249,139,67,206,9.668,45.67778457758499
Task_27148,834,515,110,23,133,1.6162790697674418,20.742492921621828
Task_27149,1998,259,112,128,240,7.684615384615385,39.61061512997398
Task_27150,2093,567,126,68,194,3.6848591549295775,41.55422560952494
Task_27151,521,834,91,117,208,0.6239520958083832,18.022754466118794
Task_27152,2091,569,65,22,87,3.668421052631579,40.23439064328037
Task_27153,2081,337,23,161,184,6.15680473372781,40.94043648119929
Task_27154,690,441,175,145,320,1.5610859728506787,19.86101511257133
Task_27155,1379,643,131,154,285,2.141304347826087,31.300733865200176
Task_27156,1060,386,126,158,284,2.739018087855297,25.442068897955735
Task_27157,1092,923,132,63,195,1.1818181818181819,26.79781721308162
Task_27158,2743,974,38,138,176,2.8133333333333335,53.41430194540774
Task_27159,2581,756,17,44,61,3.4095112285336855,48.24676257318197
Task_27160,1159,315,115,200,315,3.6677215189873418,26.980792360225962
Task_27161,1659,437,23,109,132,3.787671232876712,34.16709829734726
Task_27162,1318,664,99,89,188,1.981954887218045,29.810073802197724
Task_27163,2241,155,158,121,279,14.365384615384615,43.02298561224137
Task_27164,635,721,188,74,262,0.8795013850415513,19.369610795106986
Task_27165,2501,394,86,65,151,6.331645569620253,47.097665421134145
Task_27166,1078,793,103,186,289,1.3576826196473553,27.017764816961357
Task_27167,873,562,123,121,244,1.5506216696269983,22.75847601227636
Task_27168,2092,267,200,96,296,7.8059701492537314,41.358203801297186
Task_27169,2583,251,145,186,331,10.25,49.32050778876842
Task_27170,2646,762,20,38,58,3.467889908256881,49.348412194247146
Task_27171,1665,971,31,93,124,1.712962962962963,35.85586231482856
Task_27172,962,748,166,164,330,1.2843791722296396,25.17869834057345
Task_27173,879,523,152,167,319,1.6774809160305344,23.166469142320256
Task_27174,1507,347,146,18,164,4.330459770114943,31.07782379824968
Task_27175,2671,490,74,114,188,5.439918533604888,50.824175243413755
Task_27176,608,752,132,164,296,0.8074369189907038,19.47691897547976
Task_27177,945,301,28,46,74,3.129139072847682,20.95573247410073
Task_27178,2115,275,79,178,257,7.663043478260869,41.726036581170625
Task_27179,695,990,181,127,308,0.7013118062563067,21.66832611153211
Task_27180,2843,425,82,34,116,6.673708920187793,52.00915922690721
Task_27181,633,325,56,188,244,1.9417177914110428,18.426906253444823
Task_27182,1729,962,156,159,315,1.7954309449636552,37.9817545509104
Task_27183,2923,249,55,36,91,11.692,52.37157655414092
Task_27184,1477,705,138,182,320,2.092067988668555,33.24553012003423
Task_27185,1196,170,130,111,241,6.994152046783626,26.408855313553357
Task_27186,2165,186,96,109,205,11.577540106951872,41.83398679932308
Task_27187,1080,275,197,66,263,3.9130434782608696,24.8922751186383
Task_27188,2791,392,178,35,213,7.10178117048346,51.84200000210841
Task_27189,1135,848,190,142,332,1.336866902237927,28.220723743713965
Task_27190,1452,949,190,171,361,1.528421052631579,33.73418517663003
Task_27191,1642,959,80,157,237,1.7104166666666667,36.279198769611156
Task_27192,2923,591,18,71,89,4.9375,53.976361348268846
Task_27193,1475,373,55,44,99,3.943850267379679,29.885048052831433
Task_27194,1115,87,68,24,92,12.670454545454545,22.617086598037236
Task_27195,1887,547,24,179,203,3.4434306569343067,38.69780134180371
Task_27196,1159,390,131,68,199,2.9641943734015346,26.229892892364507
Task_27197,2853,733,85,114,199,3.8869209809264307,54.49154374557062
Task_27198,1050,475,163,147,310,2.2058823529411766,25.666607587361582
Task_27199,2829,220,35,37,72,12.800904977375566,50.45132415995247
Task_27200,1592,540,19,109,128,2.942698706099815,33.5384097403313
Task_27201,1119,397,96,161,257,2.8115577889447234,26.30106071932856
Task_27202,2725,382,197,162,359,7.114882506527415,52.11628058401084
Task_27203,1325,474,118,153,271,2.789473684210526,29.84962593914288
Task_27204,2089,734,134,124,258,2.8421768707482995,42.66646395720735
Task_27205,1818,574,138,110,248,3.161739130434783,37.80495870202145
Task_27206,2666,710,20,107,127,3.749648382559775,50.9320282205328
Task_27207,2371,1005,168,134,302,2.356858846918489,48.19381924230456
Task_27208,610,343,53,147,200,1.7732558139534884,17.850684262113834
Task_27209,2758,629,109,178,287,4.377777777777778,53.14142421130443
Task_27210,1960,945,37,157,194,2.0718816067653276,41.06500799419867
Task_27211,1370,222,145,200,345,6.143497757847534,30.13805399991718
Task_27212,2765,985,32,108,140,2.8042596348884383,53.40948685005262
Task_27213,2510,691,86,99,185,3.6271676300578033,48.756617124695
Task_27214,1253,444,36,120,156,2.8157303370786515,27.88312073233438
Task_27215,2459,389,13,29,42,6.305128205128205,45.03330751113108
Task_27216,670,157,146,86,232,4.2405063291139244,17.90083304095913
Task_27217,1577,236,129,193,322,6.654008438818566,33.34274234532828
Task_27218,1943,378,49,200,249,5.12664907651715,39.3865816762099
Task_27219,2596,675,17,157,174,3.8402366863905324,50.11754969170912
Task_27220,1989,705,154,143,297,2.81728045325779,41.19501881287119
Task_27221,1584,503,33,108,141,3.142857142857143,33.20512343486998
Task_27222,568,756,165,10,175,0.750330250990753,17.586606894900736
Task_27223,2513,320,198,113,311,7.8286604361370715,48.26328963604547
Task_27224,1718,932,118,152,270,1.8413719185423365,37.50119844231407
Task_27225,1674,315,29,168,197,5.2974683544303796,34.54818001042445
Task_27226,2094,805,29,11,40,2.598014888337469,40.407819862120355
Task_27227,1793,502,199,103,302,3.5646123260437377,37.413735437820115
Task_27228,590,778,122,125,247,0.7573812580231065,18.97518894229111
Task_27229,2513,592,181,69,250,4.237774030354132,48.53260031787648
Task_27230,1583,1005,163,163,326,1.573558648111332,35.814247426646894
Task_27231,1596,210,79,31,110,7.563981042654029,31.50466763288001
Task_27232,2690,264,158,173,331,10.150943396226415,51.04030798189185
Task_27233,2074,494,198,131,329,4.18989898989899,41.999462082848574
Task_27234,2464,977,119,75,194,2.5194274028629855,48.8286683115116
Task_27235,2337,116,146,165,311,19.974358974358974,44.40552899795258
Task_27236,1117,569,151,27,178,1.9596491228070176,25.713162941302016
Task_27237,1086,611,63,142,205,1.7745098039215685,26.235843776916244
Task_27238,867,956,58,42,100,0.9059561128526645,22.282857959959113
Task_27239,2349,993,130,84,214,2.36317907444668,47.26331664069725
Task_27240,1812,410,121,197,318,4.408759124087592,37.628805043130974
Task_27241,2348,964,95,121,216,2.433160621761658,47.305316152370914
Task_27242,1769,901,105,77,182,1.9611973392461197,37.504912311120194
Task_27243,2294,807,22,189,211,2.839108910891089,46.0080470882482
Task_27244,1874,241,44,21,65,7.743801652892562,35.325796321651275
Task_27245,1780,787,52,125,177,2.2588832487309647,37.61969526069982
Task_27246,1388,371,177,154,331,3.7311827956989245,30.789274055129138
Task_27247,1408,499,196,70,266,2.816,30.820771685303043
Task_27248,2483,93,38,195,233,26.414893617021278,46.15919471312003
Task_27249,2884,675,163,143,306,4.266272189349112,55.317686884664624
Task_27250,1594,976,130,124,254,1.631525076765609,35.546253264415064
Task_27251,2795,570,128,44,172,4.89492119089317,52.28627166800742
Task_27252,2765,183,159,96,255,15.027173913043478,51.41636460503017
Task_27253,2539,708,110,30,140,3.5811001410437235,48.39756247792938
Task_27254,758,944,41,44,85,0.8021164021164021,20.55273989472186
Task_27255,1360,625,91,151,242,2.1725239616613417,30.74463536314286
Task_27256,2201,755,105,161,266,2.9113756613756614,44.59688383084085
Task_27257,2267,599,123,103,226,3.7783333333333333,44.885104540962125
Task_27258,1811,630,169,145,314,2.8700475435816166,38.21950897200444
Task_27259,1658,383,129,44,173,4.317708333333333,33.68878853757738
Task_27260,2941,536,107,174,281,5.476722532588455,55.70808783850706
Task_27261,2899,1014,59,103,162,2.8561576354679805,55.84761593002088
Task_27262,1940,617,37,25,62,3.1391585760517797,37.66114860399461
Task_27263,1658,321,88,146,234,5.149068322981367,34.40600635905611
Task_27264,2080,454,111,127,238,4.571428571428571,41.549607702321715
Task_27265,1795,965,192,91,283,1.8581780538302277,38.738089370493505
Task_27266,2180,383,106,106,212,5.677083333333333,42.75215350920032
Task_27267,2266,822,124,115,239,2.753341433778858,45.6473841176018
Task_27268,2798,277,122,126,248,10.06474820143885,52.35184136637156
Task_27269,517,340,60,199,259,1.5161290322580645,16.684766829988607
Task_27270,1361,664,114,146,260,2.0466165413533837,30.95687502841079
Task_27271,1077,795,80,75,155,1.3530150753768844,26.005735611553195
Task_27272,1912,391,109,46,155,4.877551020408164,37.54788334483007
Task_27273,2137,783,35,35,70,2.725765306122449,41.33581831468551
Task_27274,2629,110,150,159,309,23.684684684684683,48.91207620611687
Task_27275,2704,581,19,39,58,4.646048109965636,49.66518350928152
Task_27276,2744,463,200,157,357,5.913793103448276,52.66935036378658
Task_27277,1068,186,151,179,330,5.711229946524064,25.183190588777478
Task_27278,2008,563,70,135,205,3.5602836879432624,40.69406815762978
Task_27279,1659,917,188,143,331,1.8071895424836601,36.78143954242967
Task_27280,815,733,194,102,296,1.1103542234332424,22.542197128192026
Task_27281,2096,897,105,73,178,2.334075723830735,42.59443140266274
Task_27282,2250,347,19,88,107,6.4655172413793105,42.87627934068659
Task_27283,2635,601,145,195,340,4.377076411960133,51.36799693344218
Task_27284,1327,628,61,200,261,2.109697933227345,30.456620932111644
Task_27285,1516,655,164,134,298,2.3109756097560976,33.537441369184826
Task_27286,1423,241,148,138,286,5.880165289256198,30.684557579409717
Task_27287,1659,567,128,127,255,2.920774647887324,35.32151349295078
Task_27288,925,209,71,108,179,4.404761904761905,22.217629816950723
Task_27289,2021,631,176,112,288,3.1977848101265822,41.3830481256683
Task_27290,1964,650,101,120,221,3.0168970814132106,40.24990505762403
Task_27291,2949,867,182,159,341,3.3974654377880182,57.13413099179619
Task_27292,2656,78,193,24,217,33.620253164556964,47.75306537968121
Task_27293,1777,278,59,113,172,6.369175627240144,35.89349520378077
Task_27294,2178,621,84,81,165,3.5016077170418005,43.163294367129566
Task_27295,2498,109,176,140,316,22.70909090909091,46.842110159759066
Task_27296,1680,264,65,66,131,6.339622641509434,33.781264675245055
Task_27297,1831,193,176,120,296,9.438144329896907,36.96692875367908
Task_27298,893,845,197,128,325,1.0555555555555556,24.31194219741145
Task_27299,647,1007,171,53,224,0.6418650793650794,20.380062724204414
Task_27300,628,520,22,146,168,1.2053742802303262,18.349486952522653
Task_27301,2251,218,45,96,141,10.278538812785389,42.86051218687757
Task_27302,2262,496,16,195,211,4.551307847082495,44.51671356461685
Task_27303,2229,339,20,159,179,6.555882352941176,43.272188928481704
Task_27304,2145,659,110,41,151,3.25,42.064640966038645
Task_27305,1188,209,113,14,127,5.6571428571428575,25.22236832531887
Task_27306,1409,338,28,141,169,4.156342182890856,30.210483341440973
Task_27307,1499,428,79,102,181,3.4941724941724943,31.99901226880095
Task_27308,2509,286,123,45,168,8.742160278745645,46.767922671383936
Task_27309,2237,324,156,96,252,6.883076923076923,43.64982510473908
Task_27310,2926,89,182,27,209,32.51111111111111,52.128711030119696
Task_27311,2986,259,164,161,325,11.484615384615385,55.654680155414916
Task_27312,1423,855,33,77,110,1.6623831775700935,31.440779792564204
Task_27313,1782,922,24,97,121,1.9306608884073673,37.49318382587472
Task_27314,2893,857,104,118,222,3.371794871794872,55.61902280656269
Task_27315,2934,990,88,22,110,2.9606458123107973,55.152732470968374
Task_27316,1792,733,144,45,189,2.44141689373297,37.00231511764114
Task_27317,1723,322,110,179,289,5.3343653250774,35.774715797267795
Task_27318,1461,557,80,179,259,2.618279569892473,32.3022502826341
Task_27319,2465,560,97,70,167,4.393939393939394,47.308443807287794
Task_27320,2126,744,157,103,260,2.8536912751677854,43.26218984213796
Task_27321,1748,282,23,101,124,6.176678445229682,34.96205420175975
Task_27322,1661,517,126,198,324,3.2065637065637067,35.61003413834843
Task_27323,2201,350,29,181,210,6.27065527065527,43.077827331744594
Task_27324,2891,767,126,157,283,3.7643229166666665,55.636429181749044
Task_27325,1559,487,85,83,168,3.194672131147541,32.928935433346716
Task_27326,1433,633,127,189,316,2.2602523659305995,32.31572196601304
Task_27327,1879,135,33,121,154,13.816176470588236,36.11401234468667
Task_27328,1905,868,34,32,66,2.192174913693901,37.894930578195336
Task_27329,2218,251,21,62,83,8.801587301587302,41.49223421462808
Task_27330,2113,189,98,106,204,11.121052631578948,40.98111139700081
Task_27331,2277,1018,27,184,211,2.2345436702649657,46.39779811863833
Task_27332,2650,769,156,183,339,3.4415584415584415,52.11524280334712
Task_27333,2011,82,77,101,178,24.228915662650603,38.36705723620116
Task_27334,2827,848,161,48,209,3.32979976442874,53.89801399240525
Task_27335,2941,532,94,193,287,5.51782363977486,55.76033265404106
Task_27336,561,801,102,103,205,0.699501246882793,18.462076780254737
Task_27337,1001,187,94,144,238,5.324468085106383,23.664042016871587
Task_27338,1533,761,25,23,48,2.0118110236220472,31.543992370469695
Task_27339,534,659,53,126,179,0.8090909090909091,17.432469185257652
Task_27340,1171,297,193,47,240,3.9295302013422817,26.05576403061062
Task_27341,2186,514,138,106,244,4.244660194174758,43.41699092776855
Task_27342,2168,726,31,97,128,2.9821182943603852,43.302244346129974
Task_27343,1335,980,67,112,179,1.3608562691131498,31.106231018399896
Task_27344,2704,660,186,34,220,4.090771558245083,51.362910267448314
Task_27345,887,110,174,113,287,7.990990990990991,21.359630362947666
Task_27346,1128,849,71,176,247,1.3270588235294118,27.83183255704707
Task_27347,2651,856,168,27,195,3.093348891481914,50.998932267385534
Task_27348,1942,73,48,87,135,26.243243243243242,36.558442419366315
Task_27349,2840,594,38,43,81,4.773109243697479,52.27053639191096
Task_27350,2565,889,16,130,146,2.8820224719101124,49.99389324967791
Task_27351,1704,833,47,16,63,2.0431654676258995,34.45588471344413
Task_27352,995,187,134,125,259,5.292553191489362,23.625865001290318
Task_27353,2578,652,20,48,68,3.9479326186830015,48.01010251757905
Task_27354,711,356,157,13,170,1.9915966386554622,18.484722052149234
Task_27355,1777,126,99,153,252,13.992125984251969,35.42419645291037
Task_27356,1304,411,78,11,89,3.1650485436893203,27.31341084751602
Task_27357,2572,311,175,84,259,8.243589743589743,48.813502790136745
Task_27358,1197,113,180,171,351,10.5,26.637687638175546
Task_27359,1628,162,128,45,173,9.987730061349692,32.20516617399779
Task_27360,2455,264,75,96,171,9.264150943396226,46.54120659143687
Task_27361,2259,288,96,149,245,7.8166089965397925,43.898920989615625
Task_27362,2112,622,181,104,285,3.390048154093098,42.77060601461242
Task_27363,2978,1018,68,150,218,2.9224730127576053,57.57162350028084
Task_27364,2218,834,124,105,229,2.6562874251497006,44.86467466888473
Task_27365,2381,757,122,108,230,3.1411609498680737,47.21476882267734
Task_27366,1746,551,104,100,204,3.1630434782608696,36.37911367202616
Task_27367,2118,177,45,197,242,11.898876404494382,41.014339346108414
Task_27368,2818,617,55,57,112,4.559870550161812,52.38925637912789
Task_27369,1287,465,188,70,258,2.7618025751072963,28.761608281335896
Task_27370,1262,244,130,92,222,5.151020408163265,27.74367772010221
Task_27371,2891,863,71,182,253,3.346064814814815,55.89963471860394
Task_27372,2362,781,21,98,119,3.020460358056266,46.181228995187205
Task_27373,1117,296,55,120,175,3.760942760942761,25.550195933183776
Task_27374,1764,318,38,182,220,5.529780564263323,36.1129976847028
Task_27375,2107,793,107,29,136,2.6536523929471034,41.7881611506407
Task_27376,1475,639,164,111,275,2.3046875,32.700581574158
Task_27377,516,433,20,143,163,1.1889400921658986,16.26961049072921
Task_27378,1470,395,94,90,184,3.712121212121212,31.34787376463967
Task_27379,2169,95,104,86,190,22.59375,40.716558701345924
Task_27380,1519,906,191,163,354,1.6747519294377067,34.648461124087
Task_27381,1804,868,185,164,349,2.0759493670886076,39.038524852480684
Task_27382,2489,180,114,129,243,13.751381215469614,46.848871678674634
Task_27383,1948,904,133,199,332,2.152486187845304,41.40696094310285
Task_27384,1974,199,69,109,178,9.87,38.75987210550549
Task_27385,1746,873,42,30,72,1.997711670480549,35.441475911063414
Task_27386,2897,796,58,32,90,3.6348808030112925,53.749218879316196
Task_27387,671,192,75,169,244,3.476683937823834,18.550164732444074
Task_27388,826,137,132,88,220,5.9855072463768115,20.155981621690948
Task_27389,1343,127,115,90,205,10.4921875,28.210485978154463
Task_27390,1103,909,70,32,102,1.212087912087912,25.95810030709558
Task_27391,911,819,49,20,69,1.1109756097560977,21.971938734789536
Task_27392,589,791,174,159,333,0.7436868686868687,19.40677687839251
Task_27393,1302,868,111,155,266,1.4982738780207134,30.654508167100886
Task_27394,719,382,110,30,140,1.877284595300261,18.55155141550251
Task_27395,2892,79,146,95,241,36.15,52.38586091471293
Task_27396,1283,693,100,32,132,1.8487031700288183,28.44218730740637
Task_27397,1092,389,190,46,236,2.8,25.069842452782193
Task_27398,2917,327,47,91,138,8.893292682926829,53.721020709261346
Task_27399,1196,845,17,115,132,1.41371158392435,28.044514076882862
Task_27400,2955,104,108,48,156,28.142857142857142,52.36387128009602
Task_27401,746,887,88,52,140,0.8400900900900901,20.863815973748235
Task_27402,1976,313,28,183,211,6.292993630573249,39.38955868336361
Task_27403,1156,669,58,167,225,1.7253731343283583,27.654868379340698
Task_27404,1632,155,91,62,153,10.461538461538462,32.183685646832416
Task_27405,828,952,44,170,214,0.8688352570828961,23.17078724116966
Task_27406,1018,615,110,159,269,1.6525974025974026,25.417645625340356
Task_27407,932,900,185,48,233,1.0344062153163152,24.151685690561482
Task_27408,1259,489,189,68,257,2.5693877551020408,28.388263955668535
Task_27409,2211,130,97,165,262,16.87786259541985,42.36300436258259
Task_27410,1124,584,79,101,180,1.9213675213675214,26.561027050450676
Task_27411,1585,405,112,153,265,3.9039408866995076,33.717152635815275
Task_27412,510,97,196,47,243,5.204081632653061,14.331620294738913
Task_27413,1088,561,120,194,314,1.9359430604982206,26.62505578131315
Task_27414,843,673,86,80,166,1.2507418397626113,22.063549245525735
Task_27415,1194,339,153,81,234,3.511764705882353,26.968610076880562
Task_27416,2020,603,175,106,281,3.3443708609271523,41.238420426804105
Task_27417,870,743,74,13,87,1.1693548387096775,21.549366972989763
Task_27418,1768,509,166,120,286,3.466666666666667,36.99304348327895
Task_27419,2772,214,33,87,120,12.893023255813954,50.83002649547947
Task_27420,2950,587,41,81,122,5.017006802721088,54.927367641608235
Task_27421,1383,216,90,43,133,6.373271889400922,28.527968577915733
Task_27422,2199,194,122,103,225,11.276923076923078,42.42782202122774
Task_27423,2023,841,114,109,223,2.4026128266033253,41.77577729251069
Task_27424,1915,727,70,132,202,2.6304945054945055,39.71992164095017
Task_27425,2029,992,153,182,335,2.0433031218529707,42.952803605658495
Task_27426,2086,829,189,50,239,2.513253012048193,42.29279609528998
Task_27427,2254,419,172,136,308,5.366666666666666,44.51825699340403
Task_27428,1177,739,54,163,217,1.5905405405405406,28.137980322374563
Task_27429,1805,1019,192,183,375,1.7696078431372548,39.65521088555195
Task_27430,1227,746,79,33,112,1.642570281124498,27.4253563787949
Task_27431,2435,691,110,179,289,3.51878612716763,48.23243010702519
Task_27432,1676,507,26,129,155,3.2992125984251968,34.75164218667086
Task_27433,2858,870,74,106,180,3.2812858783008036,54.933114444600754
Task_27434,1456,930,99,20,119,1.5639097744360901,31.577795483267654
Task_27435,720,184,161,184,345,3.891891891891892,19.645247558143534
Task_27436,2233,828,69,103,172,2.6936067551266585,44.86359896758279
Task_27437,2988,925,120,165,285,3.226781857451404,57.69024124504737
Task_27438,2298,206,91,151,242,11.101449275362318,44.19472717634782
Task_27439,1958,881,15,121,136,2.2199546485260773,40.277377895353844
Task_27440,565,1019,184,90,274,0.553921568627451,19.459460193291928
Task_27441,1234,502,10,94,104,2.4532803180914513,27.249947572243943
Task_27442,765,464,179,43,222,1.6451612903225807,20.05879634230071
Task_27443,1474,121,97,31,128,12.081967213114755,29.3142492054628
Task_27444,2411,98,34,169,203,24.353535353535353,44.86648959566586
Task_27445,1980,885,62,137,199,2.234762979683973,41.23163880186205
Task_27446,2363,582,36,90,126,4.0531732418524875,45.815278348918135
Task_27447,1157,745,38,137,175,1.5509383378016086,27.526452128792968
Task_27448,1400,701,105,125,230,1.9943019943019944,31.52414198536464
Task_27449,1730,464,164,66,230,3.7204301075268815,35.63863344556567
Task_27450,1407,246,65,24,89,5.696356275303644,28.390103321209505
Task_27451,2649,927,95,186,281,2.8545258620689653,52.34782810607299
Task_27452,1006,621,160,162,322,1.617363344051447,25.48957193255082
Task_27453,1466,880,173,154,327,1.6640181611804767,33.59305803452235
Task_27454,2741,599,164,97,261,4.568333333333333,52.56896036706416
Task_27455,1156,816,27,171,198,1.4149326805385556,27.877665433138265
Task_27456,1155,632,167,20,187,1.8246445497630333,26.497995403342383
Task_27457,1230,993,200,137,337,1.2374245472837022,30.172818638139777
Task_27458,2980,713,174,92,266,4.173669467787115,56.65199770858403
Task_27459,2181,312,58,90,148,6.968051118210862,42.142609999585964
Task_27460,891,221,159,103,262,4.013513513513513,22.053967608737945
Task_27461,2384,750,158,40,198,3.174434087882823,46.485253110447104
Task_27462,834,77,124,11,135,10.692307692307692,18.461565618000787
Task_27463,2191,126,178,195,373,17.251968503937007,42.545292840028885
Task_27464,2127,463,200,131,331,4.584051724137931,42.74765895070286
Task_27465,1655,592,29,128,157,2.790893760539629,34.71229962519062
Task_27466,2169,469,111,93,204,4.614893617021276,42.78733766707152
Task_27467,535,589,128,126,254,0.9067796610169492,17.56547753911442
Task_27468,898,695,19,170,189,1.2902298850574712,23.342531055276385
Task_27469,2418,898,193,64,257,2.689655172413793,48.02271795446663
Task_27470,1809,540,199,183,382,3.343807763401109,38.26571995055313
Task_27471,1130,785,53,162,215,1.4376590330788803,27.517452862737255
Task_27472,1164,718,74,77,151,1.6189151599443672,27.18556236490512
Task_27473,2347,528,43,191,234,4.4366729678638945,46.107119019251456
Task_27474,2822,126,99,191,290,22.22047244094488,52.0982144897474
Task_27475,1185,741,115,32,147,1.5970350404312668,27.15847797218809
Task_27476,2524,341,29,15,44,7.380116959064328,45.76406880700768
Task_27477,2870,854,168,198,366,3.3567251461988303,56.01147949207412
Task_27478,2701,267,189,16,205,10.078358208955224,49.84126492591809
Task_27479,536,915,94,138,232,0.5851528384279476,18.65178167958536
Task_27480,1965,277,36,129,165,7.068345323741007,38.804156849363444
Task_27481,2058,606,118,26,144,3.3904448105436575,40.473865020859904
Task_27482,2228,954,30,65,95,2.3329842931937175,44.12005332721096
Task_27483,1342,680,150,171,321,1.9706314243759178,31.01746417183095
Task_27484,945,397,80,125,205,2.3743718592964824,23.306290525672022
Task_27485,1403,1013,190,80,270,1.383629191321499,32.50597277295994
Task_27486,1460,906,113,192,305,1.609702315325248,33.53524652513004
Task_27487,1702,99,169,94,263,17.02,33.90860919207558
Task_27488,2952,125,190,58,248,23.428571428571427,53.42569912938411
Task_27489,583,997,170,48,218,0.5841683366733467,19.13023812856044
Task_27490,1058,221,129,32,161,4.7657657657657655,23.537379507855494
Task_27491,2950,876,181,54,235,3.363740022805017,56.250888950745
Task_27492,2856,966,16,115,131,2.953464322647363,54.7882426451179
Task_27493,684,1017,89,54,143,0.6719056974459725,20.46686024488069
Task_27494,950,516,48,172,220,1.8375241779497098,23.903082723210673
Task_27495,1705,817,127,115,242,2.084352078239609,36.7570458311912
Task_27496,683,418,123,77,200,1.630071599045346,18.915710848062783
Task_27497,2508,630,135,198,333,3.974643423137876,49.42179677932099
Task_27498,2032,244,72,45,117,8.293877551020408,38.55909905086286
Task_27499,1416,472,83,183,266,2.9936575052854124,31.340872019255162
Task_27500,1121,171,89,182,271,6.517441860465116,25.455617519025555
Task_27501,2872,75,149,63,212,37.78947368421053,51.40972552009342
Task_27502,2888,890,108,27,135,3.2413019079685745,54.439521108252215
Task_27503,1966,611,10,164,174,3.212418300653595,39.949423218464055
Task_27504,1372,601,109,125,234,2.2790697674418605,30.78598574195861
Task_27505,596,725,52,155,207,0.8209366391184573,18.78577162726006
Task_27506,2254,742,18,148,166,3.0336473755047106,44.87939263742754
Task_27507,2114,261,91,47,138,8.068702290076336,40.25748854088204
Task_27508,1236,530,108,139,247,2.327683615819209,28.48864197790441
Task_27509,2524,337,108,170,278,7.4674556213017755,48.43057252512892
Task_27510,1698,193,174,181,355,8.75257731958763,35.22331073156813
Task_27511,805,582,164,94,258,1.3807890222984562,21.749718494137014
Task_27512,2935,753,57,67,124,3.8925729442970822,55.091862078692266
Task_27513,1311,567,157,32,189,2.308098591549296,28.8695009644311
Task_27514,1740,721,85,72,157,2.409972299168975,36.2333800905377
Task_27515,2134,836,40,178,218,2.5495818399044206,43.607342141409866
Task_27516,2126,235,116,146,262,9.008474576271187,41.67193764181838
Task_27517,2842,944,142,131,273,3.0074074074074075,55.332238328496146
Task_27518,855,249,126,119,245,3.42,21.525198793562197
Task_27519,2506,507,129,121,250,4.933070866141732,48.50974218543781
Task_27520,2625,170,173,152,325,15.350877192982455,49.38387941199779
Task_27521,2446,404,72,180,252,6.0395061728395065,47.37923118856884
Task_27522,656,850,95,130,225,0.7708578143360753,20.179386880107007
Task_27523,2274,645,151,22,173,3.5201238390092877,44.19611986663681
Task_27524,1231,257,183,175,358,4.771317829457364,28.084317593371562
Task_27525,2834,728,148,180,328,3.887517146776406,54.84690328423577
Task_27526,1624,484,90,67,157,3.3484536082474228,33.5470044384216
Task_27527,2882,726,95,44,139,3.9642365887207704,53.90959065957413
Task_27528,2731,418,122,111,233,6.5178997613365155,51.6889208263536
Task_27529,2903,422,124,97,221,6.862884160756501,54.37796840325597
Task_27530,2724,437,69,100,169,6.219178082191781,51.36017169877045
Task_27531,1808,533,23,107,130,3.385767790262172,36.81039348617653
Task_27532,1435,947,155,189,344,1.5137130801687764,33.40836479076023
Task_27533,2827,511,98,57,155,5.521484375,52.65772467118213
Task_27534,1766,156,154,103,257,11.248407643312103,35.41986966059326
Task_27535,1347,529,31,66,97,2.5415094339622644,28.842622304192105
Task_27536,1843,773,26,29,55,2.3811369509043927,36.61244029574319
Task_27537,2089,699,97,78,175,2.9842857142857144,41.98077415736227
Task_27538,2334,170,119,108,227,13.649122807017545,44.28841397727513
Task_27539,993,875,51,186,237,1.1335616438356164,25.756874365046908
Task_27540,2292,253,95,30,125,9.023622047244094,42.888889271906066
Task_27541,872,126,38,123,161,6.866141732283465,20.349108247664336
Task_27542,1677,699,181,69,250,2.395714285714286,35.629396468663536
Task_27543,1994,804,155,78,233,2.4770186335403728,41.07747456089675
Task_27544,1676,478,73,17,90,3.498956158663883,33.45216749751635
Task_27545,1450,615,191,147,338,2.353896103896104,32.56614464371976
Task_27546,2842,202,110,136,246,14.0,52.7628318829724
Task_27547,1331,448,133,200,333,2.964365256124722,30.210423077113376
Task_27548,582,657,166,88,254,0.8844984802431611,18.400451264866025
Task_27549,2527,416,136,97,233,6.059952038369304,48.46184002982506
Task_27550,2975,452,95,64,159,6.567328918322295,54.84963285167206
Task_27551,1173,728,161,21,182,1.6090534979423867,27.0724935338453
Task_27552,1967,280,65,86,151,7.0,38.590697313454186
Task_27553,625,941,83,182,265,0.6634819532908705,20.351116455616594
Task_27554,1057,378,200,133,333,2.7889182058047495,25.55329026286354
Task_27555,1090,647,164,61,225,1.6820987654320987,26.004569336072077
Task_27556,2674,865,41,71,112,3.087759815242494,51.215496154216176
Task_27557,1510,651,136,107,243,2.315950920245399,33.1424167404756
Task_27558,2016,1021,171,102,273,1.9726027397260273,42.440178266570236
Task_27559,1566,911,73,70,143,1.7171052631578947,34.04130100603728
Task_27560,938,421,128,197,325,2.2227488151658767,23.864539055072797
Task_27561,730,627,169,152,321,1.1624203821656052,21.06254145166925
Task_27562,2935,133,143,192,335,21.902985074626866,54.13582012903766
Task_27563,1077,661,13,145,158,1.6268882175226587,25.760549046245114
Task_27564,1204,531,150,111,261,2.263157894736842,28.007178402000708
Task_27565,1248,562,51,187,238,2.216696269982238,28.907131119917263
Task_27566,867,317,122,31,153,2.7264150943396226,20.74686231642306
Task_27567,2790,96,141,61,202,28.762886597938145,50.18680459621097
Task_27568,1328,792,133,109,242,1.6746532156368221,30.684123770486433
Task_27569,2283,121,139,26,165,18.71311475409836,42.241719482698166
Task_27570,2934,841,164,152,316,3.4845605700712587,56.69191890713078
Task_27571,658,928,111,186,297,0.7082884822389667,20.92946074107239
Task_27572,1086,944,63,161,224,1.1492063492063491,27.317779467295768
Task_27573,2288,984,60,124,184,2.3228426395939086,46.29825476507782
Task_27574,708,331,154,61,215,2.1325301204819276,18.91688439222037
Task_27575,964,290,52,23,75,3.3127147766323026,21.117134064507724
Task_27576,1984,798,106,94,200,2.4831038798498124,40.89133067701679
Task_27577,2737,670,84,38,122,4.078986587183309,51.204652699217405
Task_27578,2096,686,63,51,114,3.0509461426491993,41.2137483133943
Task_27579,1551,646,80,94,174,2.3972179289026276,33.470722182423586
Task_27580,2320,291,144,120,264,7.945205479452055,44.90918121720159
Task_27581,593,842,124,64,188,0.7034400948991696,18.765506547166137
Task_27582,2683,885,99,150,249,3.028216704288939,52.549651163157726
Task_27583,2333,816,104,47,151,2.8555691554467564,45.56275855310788
Task_27584,2519,798,47,175,222,3.1526908635794744,49.632049143515054
Task_27585,1166,212,185,97,282,5.474178403755869,26.475287521379613
Task_27586,2290,217,71,117,188,10.504587155963304,43.86490201974974
Task_27587,1840,202,121,164,285,9.064039408866995,37.16286932279489
Task_27588,2127,509,111,184,295,4.170588235294118,42.81107690945316
Task_27589,1723,173,109,22,131,9.902298850574713,33.40686144402747
Task_27590,1180,963,85,24,109,1.2240663900414939,27.31998522235072
Task_27591,836,674,46,79,125,1.2385185185185186,21.731409210395316
Task_27592,1048,810,191,104,295,1.2922318125770653,26.48774875023975
Task_27593,2558,256,91,82,173,9.95330739299611,47.96903597996076
Task_27594,1669,619,47,144,191,2.6919354838709677,35.42028257247397
Task_27595,2786,374,21,197,218,7.429333333333333,52.451873979167935
Task_27596,1392,131,24,197,221,10.545454545454545,29.267554212705363
Task_27597,885,125,172,124,296,7.023809523809524,21.523220628213963
Task_27598,2078,332,151,88,239,6.24024024024024,41.00461542191506
Task_27599,2232,238,50,169,219,9.338912133891213,43.295502040295325
Task_27600,2480,933,106,133,239,2.6552462526766596,49.41132113919673
Task_27601,1752,75,55,61,116,23.05263157894737,33.11408162778382
Task_27602,1304,563,185,115,300,2.3120567375886525,29.872738805692816
Task_27603,847,103,121,181,302,8.14423076923077,20.86456870932863
Task_27604,2933,155,103,36,139,18.80128205128205,52.42093310324524
Task_27605,1366,561,71,97,168,2.4306049822064058,30.28355398975007
Task_27606,906,468,118,69,187,1.931769722814499,22.39091927396574
Task_27607,2196,860,153,47,200,2.5505226480836236,43.888003859589084
Task_27608,2369,597,68,15,83,3.9615384615384617,44.72037931813245
Task_27609,1994,533,106,135,241,3.7340823970037453,40.46680056005462
Task_27610,513,877,109,72,181,0.5842824601366743,17.66000656558987
Task_27611,2496,113,108,175,283,21.894736842105264,46.76340679807661
Task_27612,1589,707,68,174,242,2.244350282485876,34.73580088429076
Task_27613,1348,941,179,174,353,1.4309978768577494,32.01861173544666
Task_27614,959,959,138,139,277,0.9989583333333333,25.52298538114702
Task_27615,928,279,196,74,270,3.3142857142857145,22.64544551970978
Task_27616,1357,1020,77,21,98,1.3290891283055828,30.177763317635595
Task_27617,628,309,51,35,86,2.0258064516129033,16.27864416147143
Task_27618,892,852,50,178,228,1.0457209847596718,24.00529823859561
Task_27619,1748,722,57,105,162,2.4177040110650068,36.69822120944564
Task_27620,1104,118,130,162,292,9.277310924369749,24.965048161565864
Task_27621,1600,243,120,132,252,6.557377049180328,33.32572108444183
Task_27622,1356,666,65,149,214,2.032983508245877,30.750751885890292
Task_27623,1769,883,23,162,185,2.001131221719457,37.746281445855715
Task_27624,2657,779,194,194,388,3.4064102564102563,52.49456108733174
Task_27625,1917,528,32,11,43,3.623818525519849,36.782466401812265
Task_27626,1516,613,113,68,181,2.469055374592834,32.47008020417386
Task_27627,2977,966,164,115,279,3.078593588417787,57.54383935367385
Task_27628,2852,427,69,147,216,6.663551401869159,53.68229796649491
Task_27629,1544,597,117,177,294,2.5819397993311037,33.84396301229873
Task_27630,2539,558,138,182,320,4.542039355992844,49.60113187184087
Task_27631,1319,383,39,141,180,3.4348958333333335,29.020772765692282
Task_27632,2614,785,14,62,76,3.3256997455470736,49.19207301863694
Task_27633,1987,606,126,163,289,3.2734761120263594,40.84490419608937
Task_27634,2847,86,10,60,70,32.724137931034484,49.77054328661011
Task_27635,1470,449,140,128,268,3.2666666666666666,32.01516023121075
Task_27636,1361,401,164,173,337,3.3855721393034828,30.51357816517819
Task_27637,1207,987,124,182,306,1.2216599190283401,29.71601684753554
Task_27638,1699,559,145,13,158,3.0339285714285715,34.639615879391386
Task_27639,1065,353,38,64,102,3.0084745762711864,23.90763298780941
Task_27640,1830,497,84,119,203,3.674698795180723,37.57068020029879
Task_27641,902,746,172,33,205,1.2074966532797857,23.03136614217952
Task_27642,1837,935,163,143,306,1.9626068376068375,39.54524717018326
Task_27643,1744,646,148,55,203,2.6955177743431222,36.27150754592548
Task_27644,1665,647,134,187,321,2.5694444444444446,36.05367665152022
Task_27645,1546,1016,124,157,281,1.52015732546706,35.0503820077326
Task_27646,670,914,93,74,167,0.73224043715847,20.180883467582404
Task_27647,2996,387,163,109,272,7.721649484536083,55.95110834411736
Task_27648,1865,558,125,143,268,3.336314847942755,38.63706943200034
Task_27649,1871,775,63,105,168,2.411082474226804,38.926721080177025
Task_27650,707,664,182,30,212,1.063157894736842,19.71914997431846
Task_27651,1101,652,24,103,127,1.6860643185298623,25.958157693339057
Task_27652,963,828,14,164,178,1.1616405307599518,24.703733736957087
Task_27653,661,292,62,150,212,2.255972696245734,18.562224723148827
Task_27654,1238,496,122,186,308,2.4909456740442657,28.75706059418438
Task_27655,1732,356,47,43,90,4.851540616246498,33.9771636873653
Task_27656,2489,186,148,92,240,13.310160427807487,47.05370949255132
Task_27657,2581,662,180,159,339,3.8929110105580693,50.64935222620894
Task_27658,1934,98,76,184,260,19.535353535353536,37.76099070380526
Task_27659,951,125,110,88,198,7.5476190476190474,21.954321893668162
Task_27660,2105,645,159,81,240,3.2585139318885448,42.391707995362545
Task_27661,873,780,83,87,170,1.117797695262484,22.960964964243725
Task_27662,2912,485,92,163,255,5.991769547325103,54.95746237468924
Task_27663,675,391,126,112,238,1.721938775510204,19.078109592081635
Task_27664,2003,89,156,97,253,22.255555555555556,38.589792881381264
Task_27665,1160,955,115,81,196,1.213389121338912,28.136119387507716
Task_27666,1910,738,162,24,186,2.584573748308525,38.802418544425244
Task_27667,891,414,156,48,204,2.146987951807229,21.849036224946456
Task_27668,1379,553,94,81,175,2.4891696750902526,30.29880915276489
Task_27669,1696,931,157,88,245,1.8197424892703862,36.88386221555688
Task_27670,615,775,186,161,347,0.7925257731958762,19.898870152382667
Task_27671,2128,487,119,180,299,4.360655737704918,42.76845228988126
Task_27672,640,603,15,12,27,1.0596026490066226,16.771792359134576
Task_27673,1773,208,169,156,325,8.483253588516746,36.29621587553917
Task_27674,813,592,63,19,82,1.3709949409780775,19.990734873800317
Task_27675,521,819,188,67,255,0.6353658536585366,17.917429719957784
Task_27676,632,700,121,147,268,0.9015691868758916,19.53950440126942
Task_27677,1173,621,146,14,160,1.8858520900321543,26.503674377922337
Task_27678,2350,948,51,150,201,2.476290832455216,47.3499365858169
Task_27679,1443,181,125,123,248,7.928571428571429,30.39404283560724
Task_27680,2026,346,56,39,95,5.838616714697406,38.55847481083408
Task_27681,2331,535,177,110,287,4.348880597014926,45.97970357058667
Task_27682,1157,600,28,29,57,1.9251247920133112,25.226201140132414
Task_27683,1538,979,195,182,377,1.5693877551020408,35.27823954519833
Task_27684,1193,868,27,92,119,1.3728423475258917,27.86304036545943
Task_27685,605,589,25,25,50,1.0254237288135593,16.521621010620006
Task_27686,1759,974,59,160,219,1.804102564102564,38.13311883264988
Task_27687,2667,300,93,59,152,8.86046511627907,49.42269671665375
Task_27688,2686,822,34,16,50,3.2636695018226,49.96727555235836
Task_27689,1848,450,186,77,263,4.097560975609756,37.73779974409833
Task_27690,2535,783,78,96,174,3.233418367346939,49.549416400284834
Task_27691,2559,432,176,11,187,5.909930715935335,48.07384305723613
Task_27692,2125,142,35,129,164,14.86013986013986,40.41498832462724
Task_27693,2647,836,154,25,179,3.162485065710872,50.76644341701752
Task_27694,672,493,89,50,139,1.360323886639676,18.237661698689845
Task_27695,690,996,107,145,252,0.6920762286860582,21.398843572961667
Task_27696,2156,275,154,65,219,7.811594202898551,41.715411474631175
Task_27697,2423,686,137,63,200,3.526928675400291,47.17291780909142
Task_27698,2561,84,75,131,206,30.129411764705882,47.20694525400279
Task_27699,1712,460,27,29,56,3.713665943600868,33.56164321873397
Task_27700,2775,251,58,184,242,11.011904761904763,52.01991982305711
Task_27701,2792,307,194,106,300,9.064935064935066,52.56971885077805
Task_27702,1570,981,123,137,260,1.5987780040733197,35.22753856517277
Task_27703,2401,790,170,76,246,3.0353982300884956,47.48874015799125
Task_27704,1131,116,134,28,162,9.666666666666666,23.938377764140924
Task_27705,838,131,155,124,279,6.348484848484849,20.754957119231154
Task_27706,1483,528,151,81,232,2.8034026465028354,32.13634690545697
Task_27707,1988,100,35,16,51,19.683168316831683,36.11668252743596
Task_27708,2169,619,148,122,270,3.4983870967741937,43.622632159602084
Task_27709,1730,173,153,105,258,9.942528735632184,34.89143997910792
Task_27710,2488,561,118,195,313,4.427046263345196,48.79067451413298
Task_27711,1839,916,104,76,180,2.005452562704471,38.658966986939895
Task_27712,2690,116,56,66,122,22.99145299145299,48.31399795736999
Task_27713,2307,582,118,87,205,3.9571183533447685,45.28503358832817
Task_27714,520,327,177,67,244,1.5853658536585367,16.107840929228033
Task_27715,1824,282,30,164,194,6.445229681978798,36.789394309531666
Task_27716,2692,833,10,49,59,3.2278177458033572,50.34148615743379
Task_27717,1086,495,124,28,152,2.189516129032258,24.760546992932646
Task_27718,1878,570,151,131,282,3.2889667250437826,38.92644429982527
Task_27719,1860,482,113,145,258,3.8509316770186337,38.27378134485486
Task_27720,1583,946,147,29,176,1.6715945089757127,34.28171890946973
Task_27721,1321,220,178,13,191,5.97737556561086,27.81709474593028
Task_27722,1359,697,136,73,209,1.9469914040114613,30.461481169611087
Task_27723,962,518,157,120,277,1.8535645472061657,24.220161890560025
Task_27724,607,695,161,151,312,0.8721264367816092,19.322458916259833
Task_27725,2532,1023,164,132,296,2.47265625,50.771286008575544
Task_27726,894,496,31,43,74,1.7987927565392354,20.778563083680343
Task_27727,2300,505,15,164,179,4.545454545454546,44.94643372700504
Task_27728,1595,652,20,61,81,2.442572741194487,32.87805802702628
Task_27729,2165,125,57,26,83,17.182539682539684,39.48731964358523
Task_27730,1863,402,188,81,269,4.622828784119107,37.91481117226153
Task_27731,1556,779,37,14,51,1.994871794871795,31.930998361753666
Task_27732,879,746,178,74,252,1.176706827309237,23.228526186794557
Task_27733,2793,73,52,102,154,37.74324324324324,49.97555936310787
Task_27734,631,666,27,192,219,0.9460269865067467,19.18121793088017
Task_27735,2140,524,169,69,238,4.076190476190476,42.35511603757444
Task_27736,964,460,17,103,120,2.0911062906724514,23.016623993709914
Task_27737,1523,373,37,181,218,4.072192513368984,32.48568572843832
Task_27738,2959,270,47,147,194,10.918819188191883,54.69832280844137
Task_27739,2014,737,76,30,106,2.7289972899728996,39.789256319389644
Task_27740,1320,857,57,165,222,1.5384615384615385,30.791970981783848
Task_27741,2009,749,197,90,287,2.6786666666666665,41.49527656475667
Task_27742,1802,410,176,70,246,4.384428223844282,36.68215485204325
Task_27743,683,679,103,179,282,1.0044117647058823,20.333502099820674
Task_27744,870,781,155,78,233,1.1125319693094629,23.143838105570456
Task_27745,737,781,24,159,183,0.9424552429667519,20.97210691205584
Task_27746,1723,980,32,30,62,1.7563710499490317,35.35796912309298
Task_27747,1129,559,13,168,181,2.0160714285714287,26.57235708853726
Task_27748,1048,783,146,12,158,1.336734693877551,24.998546128981683
Task_27749,2999,824,65,79,144,3.6351515151515152,56.68033298893346
Task_27750,1850,709,177,105,282,2.6056338028169015,38.88241733624164
Task_27751,2732,790,69,178,247,3.4538558786346396,53.13084478817007
Task_27752,1994,824,64,142,206,2.416969696969697,41.3052699984512
Task_27753,2693,683,124,169,293,3.9371345029239766,52.297204464496566
Task_27754,661,369,10,178,188,1.7864864864864864,18.618960349787205
Task_27755,2441,884,64,108,172,2.75819209039548,48.339954574724736
Task_27756,766,601,176,20,196,1.2724252491694352,20.304129419915636
Task_27757,1392,371,13,138,151,3.7419354838709675,29.784339114077422
Task_27758,2013,994,27,155,182,2.023115577889447,41.93216833333923
Task_27759,2765,845,14,71,85,3.268321513002364,52.22144848577546
Task_27760,1641,958,138,47,185,1.7111574556830031,35.30677668942619
Task_27761,817,588,17,136,153,1.3870967741935485,21.2854146614918
Task_27762,672,233,13,138,151,2.871794871794872,17.952433224261316
Task_27763,1343,347,29,17,46,3.8591954022988504,27.125885951379797
Task_27764,2358,826,136,120,256,2.8512696493349456,47.20146869267251
Task_27765,1632,910,128,192,320,1.7914379802414928,36.35411595110066
Task_27766,1817,746,37,178,215,2.43239625167336,38.3043764280657
Task_27767,622,200,148,125,273,3.0945273631840795,17.8185942906936
Task_27768,1421,687,196,161,357,2.065406976744186,32.43825443380725
Task_27769,2725,408,81,28,109,6.662591687041565,50.02229581515124
Task_27770,2707,903,163,118,281,2.9944690265486726,53.08187485907837
Task_27771,2470,343,63,38,101,7.180232558139535,45.638337945147576
Task_27772,2783,735,60,59,119,3.78125,52.31491079440297
Task_27773,1378,467,125,126,251,2.9444444444444446,30.536664297493832
Task_27774,1026,318,52,164,216,3.2163009404388716,24.46045113933374
Task_27775,1195,432,143,192,335,2.759815242494226,28.004386604334893
Task_27776,515,207,14,153,167,2.4759615384615383,15.652758763914287
Task_27777,988,416,63,115,178,2.369304556354916,23.89858098642765
Task_27778,614,355,114,131,245,1.7247191011235956,18.05912264174317
Task_27779,2323,459,98,179,277,5.05,45.668346409145016
Task_27780,2324,871,74,187,261,2.665137614678899,46.984773580666996
Task_27781,1763,591,166,130,296,2.9780405405405403,37.233338017815676
Task_27782,1522,365,166,170,336,4.158469945355192,32.935695204538185
Task_27783,616,490,39,65,104,1.2545824847250509,17.28704430217665
Task_27784,1991,686,195,167,362,2.898107714701601,41.49517943115533
Task_27785,1022,865,16,47,63,1.1801385681293302,24.046924460194614
Task_27786,2690,783,69,43,112,3.431122448979592,50.74551485246392
Task_27787,2150,663,99,83,182,3.2379518072289155,42.898589263574856
Task_27788,2111,654,176,66,242,3.2229007633587785,42.328600224645726
Task_27789,1049,696,128,107,235,1.5050215208034434,25.902063791423387
Task_27790,1627,714,130,59,189,2.2755244755244757,34.552859211765
Task_27791,1459,257,175,186,361,5.655038759689923,31.716761964758536
Task_27792,2190,172,88,90,178,12.658959537572255,41.64396705025913
Task_27793,1123,706,47,88,135,1.5884016973125885,26.49925773756236
Task_27794,1906,183,119,101,220,10.358695652173912,37.674212519287686
Task_27795,1074,989,36,195,231,1.084848484848485,27.25883801251281
Task_27796,989,376,75,72,147,2.623342175066313,23.325262718445675
Task_27797,1657,564,58,51,109,2.932743362831858,33.787097176072635
Task_27798,2868,128,197,153,350,22.232558139534884,53.063241294263264
Task_27799,1934,732,80,134,214,2.6384720327421554,40.07444107646254
Task_27800,683,547,175,29,204,1.2463503649635037,18.93297630976843
Task_27801,2111,350,93,141,234,6.014245014245014,41.739752981896686
Task_27802,2328,304,135,100,235,7.632786885245902,44.92096001968306
Task_27803,2000,134,39,63,102,14.814814814814815,37.3904360857837
Task_27804,1694,296,107,69,176,5.703703703703703,34.246872055104255
Task_27805,563,480,46,162,208,1.1704781704781704,17.495222256153635
Task_27806,1692,538,164,119,283,3.1391465677179964,35.866829918839635
Task_27807,1595,878,200,130,330,1.8145620022753128,35.62260038808011
Task_27808,793,348,20,65,85,2.2722063037249285,19.37721935346885
Task_27809,1622,391,51,93,144,4.137755102040816,33.57666390437827
Task_27810,1746,997,173,13,186,1.749498997995992,36.968025016409634
Task_27811,2738,958,172,153,325,2.855057351407716,53.99458199596446
Task_27812,1336,208,68,197,265,6.392344497607655,29.259948067423114
Task_27813,590,131,157,124,281,4.46969696969697,16.859584410481215
Task_27814,1104,954,132,194,326,1.156020942408377,28.085088849518048
Task_27815,1042,757,60,124,184,1.3746701846965699,25.80048853836833
Task_27816,683,125,116,189,305,5.420634920634921,18.48002890536389
Task_27817,516,628,161,174,335,0.8203497615262321,17.810368466862016
Task_27818,2969,639,94,33,127,4.6390625,54.98166897545476
Task_27819,2415,301,181,83,264,7.996688741721854,46.31993846935911
Task_27820,1217,488,103,154,257,2.488752556237219,28.122604285156118
Task_27821,2576,367,163,105,268,7.0,49.21470550107381
Task_27822,2268,914,145,182,327,2.4786885245901638,46.46121089423813
Task_27823,644,1000,32,49,81,0.6433566433566433,19.129753353222238
Task_27824,2501,233,152,86,238,10.688034188034187,47.32543315821034
Task_27825,1416,176,24,86,110,8.0,28.728229240831453
Task_27826,1319,452,97,150,247,2.911699779249448,29.579991776374925
Task_27827,619,293,124,164,288,2.1054421768707483,18.197370035544477
Task_27828,949,314,67,62,129,3.0126984126984127,22.33076995858299
Task_27829,900,209,43,102,145,4.285714285714286,21.46718554897676
Task_27830,1030,718,19,17,36,1.4325452016689848,23.23176062280707
Task_27831,743,885,107,42,149,0.8386004514672686,20.623505057190062
Task_27832,2110,164,51,20,71,12.787878787878787,38.68756872558965
Task_27833,1879,172,165,167,332,10.861271676300579,37.66926449895437
Task_27834,842,1022,63,14,77,0.823069403714565,21.571942003924068
Task_27835,1807,937,149,82,231,1.9264392324093818,38.577476278828385
Task_27836,1897,234,63,130,193,8.072340425531914,37.783707762307536
Task_27837,2428,927,173,73,246,2.6163793103448274,48.282356698702834
Task_27838,1898,941,151,30,181,2.0148619957537157,39.27707335402052
Task_27839,879,816,128,53,181,1.0758873929008568,23.020184116969688
Task_27840,1872,348,184,121,305,5.363896848137536,38.20485613213451
Task_27841,2196,894,95,116,211,2.453631284916201,44.648707295057655
Task_27842,1663,853,184,10,194,1.9473067915690867,35.26148739601154
Task_27843,2466,503,90,61,151,4.892857142857143,46.886917546794535
Task_27844,2436,312,186,195,381,7.782747603833866,47.453673923869495
Task_27845,1287,886,113,66,179,1.4509582863585118,29.67383696808892
Task_27846,1948,928,74,95,169,2.0968783638320776,40.639071138267035
Task_27847,512,675,146,76,222,0.757396449704142,17.08726659063056
Task_27848,1500,855,39,88,127,1.7523364485981308,32.94999170690861
Task_27849,2817,841,76,148,224,3.3456057007125892,54.48459186810306
Task_27850,1078,878,90,176,266,1.2263936291240045,27.131648198147392
Task_27851,1012,819,178,120,298,1.2341463414634146,25.97896459915765
Task_27852,2522,762,138,35,173,3.3053735255570116,48.57364943012911
Task_27853,2071,776,37,199,236,2.6653796653796653,42.547547643513234
Task_27854,2183,194,152,42,194,11.194871794871794,41.47646051861453
Task_27855,1250,710,187,72,259,1.7580872011251758,28.999835441376558
Task_27856,1971,686,50,86,136,2.868995633187773,39.97115122360702
Task_27857,1412,465,190,40,230,3.0300429184549356,30.336639414724115
Task_27858,807,448,162,74,236,1.7973273942093542,21.116441894051007
Task_27859,2984,484,117,92,209,6.152577319587629,55.723114709117574
Task_27860,2586,385,171,16,187,6.699481865284974,48.33856146475197
Task_27861,1374,615,110,54,164,2.2305194805194803,30.1606093152942
Task_27862,1339,890,115,95,210,1.5028058361391694,30.982148538599272
Task_27863,582,600,94,86,180,0.9683860232945092,17.85969581389692
Task_27864,2523,1023,107,143,250,2.4638671875,50.43745925407061
Task_27865,2052,133,47,132,179,15.313432835820896,39.36177754259831
Task_27866,2960,342,52,119,171,8.629737609329446,54.80062844321233
Task_27867,1434,738,163,91,254,1.9404600811907984,32.18150475381541
Task_27868,1738,495,178,92,270,3.504032258064516,36.30856143096866
Task_27869,2753,252,188,74,262,10.881422924901186,51.356770489853425
Task_27870,2112,306,124,15,139,6.879478827361564,40.22321680221493
Task_27871,2110,621,44,49,93,3.392282958199357,40.940045155132424
Task_27872,700,419,193,92,285,1.6666666666666667,19.692379149002672
Task_27873,1523,284,113,136,249,5.343859649122807,32.24182907937578
Task_27874,2169,934,139,125,264,2.3197860962566845,44.587305537640596
Task_27875,2625,267,160,65,225,9.794776119402986,49.12626629045226
Task_27876,2792,190,112,10,122,14.61780104712042,50.44049494621083
Task_27877,2515,89,174,173,347,27.944444444444443,47.137638364195254
Task_27878,2337,834,116,44,160,2.798802395209581,45.69539253348325
Task_27879,2287,668,93,63,156,3.4185351270553066,44.670315609162564
Task_27880,2972,183,155,164,319,16.152173913043477,55.03126323421984
Task_27881,2774,774,72,47,119,3.5793548387096776,52.08538742881054
Task_27882,1438,607,137,27,164,2.3651315789473686,30.869381034388837
Task_27883,1947,407,175,165,340,4.772058823529412,39.80757972456143
Task_27884,1596,251,64,153,217,6.333333333333333,33.23370446364152
Task_27885,1443,266,162,37,199,5.404494382022472,30.048363555483306
Task_27886,1120,509,36,194,230,2.196078431372549,26.60464260539653
Task_27887,1164,156,59,106,165,7.414012738853503,25.448519063581966
Task_27888,919,593,178,42,220,1.5471380471380471,22.887161450901356
Task_27889,2982,872,156,186,342,3.415807560137457,57.71677718269012
Task_27890,1667,212,74,68,142,7.826291079812207,33.39877744811009
Task_27891,2600,533,12,63,75,4.868913857677903,48.19276017536461
Task_27892,704,692,70,95,165,1.0158730158730158,20.113839730377798
Task_27893,2345,79,187,32,219,29.3125,42.98526102990508
Task_27894,2396,754,155,200,355,3.1735099337748345,48.141220784188796
Task_27895,2137,842,129,15,144,2.534994068801898,42.39444083443065
Task_27896,2985,575,172,179,351,5.182291666666667,56.85345156805935
Task_27897,1257,1015,106,23,129,1.2372047244094488,28.978898037659448
Task_27898,2378,248,192,115,307,9.550200803212851,45.858182802497105
Task_27899,2040,419,47,45,92,4.857142857142857,39.0488057375869
Task_27900,2338,528,162,142,304,4.4196597353497165,46.19162944215953
Task_27901,1019,557,120,52,172,1.8261648745519714,24.39123950246422
Task_27902,929,574,16,79,95,1.6156521739130434,22.475476249697863
Task_27903,691,495,108,91,199,1.3931451612903225,19.35498782829183
Task_27904,1789,335,174,120,294,5.324404761904762,36.79784354994684
Task_27905,975,338,29,18,47,2.8761061946902653,21.286302184394902
Task_27906,1123,934,185,194,379,1.2010695187165776,28.572240442370312
Task_27907,1158,519,15,32,47,2.226923076923077,24.89094081739094
Task_27908,666,748,180,35,215,0.8891855807743658,19.38530658191835
Task_27909,585,374,197,199,396,1.56,18.411082666641708
Task_27910,763,626,59,53,112,1.2169059011164274,19.899232718073677
Task_27911,2166,271,156,181,337,7.963235294117647,42.82295741903376
Task_27912,2017,607,96,74,170,3.317434210526316,40.443966561932946
Task_27913,1732,782,189,91,280,2.212005108556833,37.15683834762978
Task_27914,1585,398,44,22,66,3.9724310776942358,31.29173402337516
Task_27915,1228,578,133,63,196,2.1208981001727114,27.888867162606093
Task_27916,931,540,122,143,265,1.7208872458410351,23.76436909181473
Task_27917,1693,280,141,64,205,6.02491103202847,34.33471057427099
Task_27918,1103,219,137,58,195,5.013636363636364,24.714326542907415
Task_27919,1002,952,143,94,237,1.0514165792235046,25.917021952990044
Task_27920,1372,328,104,45,149,4.170212765957447,28.783377776685985
Task_27921,932,250,41,109,150,3.7131474103585655,22.113113896323767
Task_27922,2882,937,96,156,252,3.0724946695095947,55.893889177128415
Task_27923,1110,652,42,122,164,1.6998468606431854,26.431861318868723
Task_27924,2854,351,185,94,279,8.107954545454545,53.58472130850371
Task_27925,1110,416,140,114,254,2.661870503597122,26.128973635873688
Task_27926,2154,975,117,25,142,2.206967213114754,43.09740936941383
Task_27927,1514,677,138,106,244,2.2330383480825957,33.290175688838126
Task_27928,2081,169,191,184,375,12.241176470588234,41.072678802348356
Task_27929,2503,440,125,63,188,5.675736961451247,47.57625209948515
Task_27930,2548,1000,77,132,209,2.5454545454545454,50.6280376842399
Task_27931,2189,179,147,75,222,12.161111111111111,41.76981829556247
Task_27932,874,282,81,175,256,3.088339222614841,22.118273072322207
Task_27933,1193,132,180,193,373,8.969924812030076,26.872854565650155
Task_27934,875,693,102,61,163,1.260806916426513,22.446708206496755
Task_27935,2650,160,117,11,128,16.459627329192546,48.01993287238124
Task_27936,2993,963,114,31,145,3.104771784232365,56.49457173674767
Task_27937,2748,442,74,75,149,6.203160270880361,51.448630770444375
Task_27938,709,217,78,190,268,3.2522935779816513,19.388145225078908
Task_27939,1099,643,93,48,141,1.7065217391304348,25.51713033974904
Task_27940,1209,986,60,128,188,1.2249240121580547,29.181708720023593
Task_27941,2738,403,54,136,190,6.7772277227722775,51.6595266583854
Task_27942,1709,828,159,57,216,2.0615199034981906,36.34003772145209
Task_27943,1765,647,80,89,169,2.7237654320987654,36.78243188852231
Task_27944,2215,135,41,54,95,16.28676470588235,40.68702722611024
Task_27945,812,395,22,68,90,2.0505050505050506,19.90888347329314
Task_27946,2958,827,91,130,221,3.572463768115942,56.56710935071117
Task_27947,2669,414,179,89,268,6.4313253012048195,50.777416520200255
Task_27948,718,980,172,123,295,0.7319062181447502,21.882441603536407
Task_27949,1194,406,39,34,73,2.9336609336609336,25.212626878084805
Task_27950,2220,902,129,162,291,2.4584717607973423,45.471638555988285
Task_27951,2396,716,170,41,211,3.3417015341701535,46.627953035231734
Task_27952,2835,605,188,93,281,4.678217821782178,54.11625008968051
Task_27953,1290,855,66,197,263,1.5070093457943925,30.553818354352924
Task_27954,1911,840,182,157,339,2.272294887039239,40.591306022959294
Task_27955,638,174,180,65,245,3.645714285714286,17.328112889706023
Task_27956,2595,248,88,51,139,10.421686746987952,47.956796070858836
Task_27957,1291,777,70,161,231,1.6593830334190232,30.150402904005194
Task_27958,1194,717,18,72,90,1.6629526462395543,27.00555707719118
Task_27959,1035,1021,73,182,255,1.012720156555773,26.876441998351364
Task_27960,1707,73,24,184,208,23.06756756756757,33.73097275681891
Task_27961,1462,634,196,188,384,2.3023622047244094,33.08316943108962
Task_27962,2463,484,192,105,297,5.078350515463917,47.94299840126115
Task_27963,1127,518,82,168,250,2.1714836223506744,26.82322544233389
Task_27964,1370,779,130,90,220,1.7564102564102564,31.15442165479291
Task_27965,2501,630,177,73,250,3.9635499207606975,48.5237530082189
Task_27966,1672,133,173,125,298,12.477611940298507,33.984560398713725
Task_27967,2919,949,152,152,304,3.0726315789473686,56.73852497287245
Task_27968,1293,82,198,47,245,15.578313253012048,26.555539729655322
Task_27969,644,377,36,29,65,1.7037037037037037,16.401804864725882
Task_27970,728,376,32,182,214,1.9310344827586208,19.87475089432073
Task_27971,1363,697,39,79,118,1.9527220630372493,30.10780585750915
Task_27972,2222,496,44,42,86,4.470824949698189,42.17276060565671
Task_27973,2914,632,195,50,245,4.60347551342812,54.81544394465475
Task_27974,1430,863,155,31,186,1.6550925925925926,31.648595480569686
Task_27975,1806,920,168,85,253,1.9609120521172638,38.60647732340164
Task_27976,2084,65,42,18,60,31.575757575757574,36.72669932317708
Task_27977,1685,676,14,46,60,2.488921713441654,33.87916089474956
Task_27978,1678,698,170,83,253,2.400572246065808,35.88855301061362
Task_27979,1144,845,30,150,180,1.3522458628841607,27.6485223156263
Task_27980,2125,712,57,156,213,2.9803646563814867,43.078227600622085
Task_27981,1473,692,18,81,99,2.1255411255411256,31.453710025790965
Task_27982,898,404,64,51,115,2.217283950617284,21.347784929631427
Task_27983,1275,283,110,28,138,4.48943661971831,26.992649887503216
Task_27984,581,594,104,182,286,0.9764705882352941,18.521640270903525
Task_27985,2090,358,55,128,183,5.821727019498607,41.1786912124016
Task_27986,2965,329,118,151,269,8.984848484848484,55.30914528848266
Task_27987,2079,657,114,62,176,3.1595744680851063,41.46539234275422
Task_27988,2797,355,162,46,208,7.856741573033708,51.80549045475481
Task_27989,1106,435,115,37,152,2.536697247706422,24.906895663470266
Task_27990,1011,150,160,31,191,6.695364238410596,22.59584426940023
Task_27991,2514,595,181,193,374,4.218120805369128,49.58296004035727
Task_27992,2835,850,129,188,317,3.3313748531139837,55.208874604557344
Task_27993,2257,153,114,134,248,14.655844155844155,43.14421845871028
Task_27994,2440,651,139,25,164,3.7423312883435584,46.85404341494032
Task_27995,2065,107,37,137,174,19.12037037037037,39.27514713937349
Task_27996,2963,684,192,76,268,4.3255474452554745,56.15646488491584
Task_27997,2714,506,110,186,296,5.353057199211046,52.10211936139706
Task_27998,1022,249,74,125,199,4.088,24.025798267597736
Task_27999,1116,481,73,152,225,2.315352697095436,26.41445159834422
Task_28000,1076,864,141,104,245,1.2439306358381503,26.870093571029557
Task_28001,863,281,146,138,284,3.0602836879432624,21.959806088893746
Task_28002,1869,937,182,110,292,1.992537313432836,39.9470619242907
Task_28003,2523,835,189,125,314,3.0179425837320575,50.11262019156334
Task_28004,2451,296,92,103,195,8.252525252525253,46.66949490951718
Task_28005,2551,77,75,106,181,32.705128205128204,46.814716750315064
Task_28006,1232,798,96,89,185,1.541927409261577,28.804166390231696
Task_28007,2887,370,187,118,305,7.781671159029649,54.33076506691068
Task_28008,882,113,27,86,113,7.7368421052631575,19.92443034373104
Task_28009,2368,976,66,116,182,2.4237461617195497,47.528383344764485
Task_28010,1826,184,189,195,384,9.87027027027027,37.28724727094606
Task_28011,892,608,47,36,83,1.464696223316913,21.44451980301386
Task_28012,583,937,75,136,211,0.6215351812366737,19.43124168421374
Task_28013,2990,152,14,39,53,19.54248366013072,52.58642977305343
Task_28014,689,400,64,71,135,1.7182044887780548,18.57429628423347
Task_28015,1146,999,132,79,211,1.146,28.11048937956689
Task_28016,1429,840,181,73,254,1.699167657550535,32.209651271184846
Task_28017,1641,447,76,26,102,3.6629464285714284,32.91359040848891
Task_28018,2782,706,69,108,177,3.934936350777935,53.214172082900404
Task_28019,881,133,199,61,260,6.574626865671642,20.913113991824837
Task_28020,1402,892,146,46,192,1.5699888017917134,31.35181723807247
Task_28021,1650,669,187,12,199,2.462686567164179,34.50674430881471
Task_28022,2296,264,44,194,238,8.664150943396226,44.44206938802868
Task_28023,534,952,108,64,172,0.5603357817418678,18.10458956951773
Task_28024,1314,296,188,121,309,4.424242424242424,29.226329361022938
Task_28025,734,842,188,119,307,0.8706998813760379,21.71969808674405
Task_28026,2400,779,78,144,222,3.076923076923077,47.66849150748908
Task_28027,2955,71,159,185,344,41.041666666666664,53.914998853391005
Task_28028,698,187,81,139,220,3.7127659574468086,18.847011324086484
Task_28029,1423,474,98,19,117,2.9957894736842103,29.628843248160294
Task_28030,2893,1017,68,199,267,2.841846758349705,56.51415714014982
Task_28031,2333,574,188,138,326,4.057391304347826,46.35278114818639
Task_28032,2416,370,19,160,179,6.512129380053908,46.336020555293125
Task_28033,2779,339,98,144,242,8.173529411764706,52.274486190014706
Task_28034,1500,261,74,96,170,5.7251908396946565,31.44429051160081
Task_28035,2589,253,99,161,260,10.192913385826772,49.06777426093279
Task_28036,2366,898,48,156,204,2.631813125695217,47.4315106998379
Task_28037,1351,215,167,62,229,6.25462962962963,28.768372453103584
Task_28038,756,743,164,32,196,1.0161290322580645,20.650013480543546
Task_28039,1275,692,23,66,89,1.8398268398268398,28.138721867921998
Task_28040,1863,105,200,148,348,17.57547169811321,36.98974578969605
Task_28041,2986,70,22,159,181,42.056338028169016,53.54607765001531
Task_28042,1230,268,146,13,159,4.5724907063197024,26.28530762505396
Task_28043,1282,526,130,40,170,2.4326375711574952,28.158615231364212
Task_28044,1569,161,94,56,150,9.685185185185185,31.3228530189872
Task_28045,916,790,176,144,320,1.1580278128950696,24.498147652353637
Task_28046,546,243,86,37,123,2.237704918032787,15.193810379448358
Task_28047,1371,511,131,154,285,2.677734375,30.75942862008603
Task_28048,2033,579,53,86,139,3.5051724137931033,40.600134031595395
Task_28049,1816,165,155,187,342,10.939759036144578,36.74302096574696
Task_28050,1424,146,53,174,227,9.687074829931973,29.971268815535794
Task_28051,2821,1021,134,176,310,2.76027397260274,55.47254639091923
Task_28052,2224,69,72,90,162,31.771428571428572,41.29351134657938
Task_28053,2685,236,144,152,296,11.329113924050633,50.66780100498033
Task_28054,711,244,188,91,279,2.9020408163265308,19.29099326841038
Task_28055,734,514,84,116,200,1.4252427184466019,20.19955166109781
Task_28056,1134,583,26,129,155,1.9417808219178083,26.40912470449169
Task_28057,2756,958,126,60,186,2.8738269030239834,53.17014219817937
Task_28058,2647,769,147,179,326,3.4376623376623376,52.00326036800502
Task_28059,2278,747,87,30,117,3.0454545454545454,44.1058147684781
Task_28060,1301,826,137,28,165,1.573155985489722,29.410940621790854
Task_28061,835,800,17,196,213,1.042446941323346,22.757482636794307
Task_28062,801,697,19,40,59,1.1475644699140402,19.97067248949043
Task_28063,2902,102,61,180,241,28.174757281553397,52.90694907674125
Task_28064,1856,488,125,126,251,3.7955010224948875,38.17025404904684
Task_28065,2213,579,147,33,180,3.81551724137931,43.14294449090522
Task_28066,1939,858,198,17,215,2.2572759022118745,39.74596517235279
Task_28067,2797,776,66,176,242,3.5997425997425996,54.096077916639196
Task_28068,2440,207,187,184,371,11.73076923076923,47.070849088199246
Task_28069,576,514,152,139,291,1.1184466019417476,18.109050128541185
Task_28070,1256,195,105,167,272,6.408163265306122,27.867422356477277
Task_28071,2175,346,37,183,220,6.268011527377522,42.722550293584426
Task_28072,576,815,117,135,252,0.7058823529411765,19.00364849438816
Task_28073,1569,652,200,10,210,2.4027565084226645,33.21716689289452
Task_28074,2244,66,48,39,87,33.492537313432834,39.87961982850179
Task_28075,2603,263,52,52,104,9.859848484848484,47.74887455625406
Task_28076,1380,362,28,173,201,3.8016528925619837,30.06553804068363
Task_28077,931,562,36,195,231,1.6536412078152753,23.770663808185446
Task_28078,615,473,150,33,183,1.2974683544303798,17.51014702397183
Task_28079,2957,684,58,70,128,4.316788321167883,55.48073337001267
Task_28080,2145,75,125,93,218,28.223684210526315,40.476564821449365
Task_28081,1339,356,17,127,144,3.750700280112045,28.847521816337235
Task_28082,542,249,111,99,210,2.168,16.38682871137478
Task_28083,2284,740,64,36,100,3.0823211875843457,43.921940515526366
Task_28084,717,635,61,112,173,1.1273584905660377,20.171190602536456
Task_28085,906,507,36,46,82,1.7834645669291338,21.35825533314703
Task_28086,2674,551,154,94,248,4.844202898550725,51.2561762461562
Task_28087,587,611,93,177,270,0.9591503267973857,18.635867337090044
Task_28088,2720,392,22,130,152,6.921119592875318,50.84842954707947
Task_28089,2461,145,27,132,159,16.856164383561644,45.448492608954304
Task_28090,2150,589,81,178,259,3.6440677966101696,43.31249778651418
Task_28091,2327,144,181,150,331,16.048275862068966,44.59098785132783
Task_28092,1465,133,154,148,302,10.932835820895523,30.777032285144596
Task_28093,1537,936,25,149,174,1.64034151547492,34.15848672219253
Task_28094,1082,835,116,53,169,1.2942583732057416,26.23250553583841
Task_28095,1189,77,77,103,180,15.243589743589743,25.46701563732985
Task_28096,688,334,47,130,177,2.053731343283582,18.883038198497832
Task_28097,2227,140,173,171,344,15.794326241134751,43.057491324486
Task_28098,1239,253,113,171,284,4.877952755905512,27.857852589717485
Task_28099,885,412,176,124,300,2.142857142857143,22.777703823324703
Task_28100,1429,928,63,180,243,1.5382131324004307,32.85668476272178
Task_28101,1314,635,80,71,151,2.0660377358490565,29.185180606549896
Task_28102,1386,107,101,28,129,12.833333333333334,27.621483520719355
Task_28103,522,442,106,128,234,1.1783295711060948,16.77568510429492
Task_28104,642,483,129,73,202,1.3264462809917354,18.387071553912527
Task_28105,2331,322,129,38,167,7.21671826625387,44.123266542099884
Task_28106,2527,334,66,14,80,7.543283582089552,46.24456824426479
Task_28107,1836,1008,110,157,267,1.819623389494549,39.60088922780977
Task_28108,2924,682,157,82,239,4.281112737920937,55.510940654197306
Task_28109,2485,273,157,16,173,9.069343065693431,46.28635378418244
Task_28110,500,874,60,10,70,0.5714285714285714,15.63069330337997
Task_28111,1825,134,118,84,202,13.518518518518519,35.76272028585219
Task_28112,2917,441,184,94,278,6.599547511312217,54.880107110707286
Task_28113,1555,577,144,176,320,2.690311418685121,34.0709564108682
Task_28114,1667,688,43,199,242,2.4194484760522497,35.892047234320344
Task_28115,554,583,63,182,245,0.9486301369863014,17.894707850770367
Task_28116,2266,471,26,144,170,4.8008474576271185,44.208297518181745
Task_28117,745,782,35,187,222,0.9514687100893997,21.36559652628694
Task_28118,1142,235,128,161,289,4.838983050847458,26.272295783806516
Task_28119,2682,853,179,184,363,3.1405152224824358,52.99556321651198
Task_28120,1204,721,52,84,136,1.667590027700831,27.89519806793261
Task_28121,573,837,172,22,194,0.6837708830548926,18.267182111428586
Task_28122,1832,909,90,191,281,2.013186813186813,39.33720551287895
Task_28123,2476,151,156,31,187,16.289473684210527,45.650051119421754
Task_28124,1126,110,19,57,76,10.144144144144144,23.107275162504465
Task_28125,790,761,89,138,227,1.036745406824147,21.92306271369412
Task_28126,1187,161,118,183,301,7.327160493827161,26.619959308418
Task_28127,877,193,144,61,205,4.520618556701031,21.14211120808785
Task_28128,739,79,152,70,222,9.2375,18.08293627312742
Task_28129,1399,590,74,32,106,2.3671742808798646,29.60741176180745
Task_28130,1480,196,39,42,81,7.5126903553299496,29.47558227103896
Task_28131,1877,461,183,86,269,4.062770562770563,38.37229299132051
Task_28132,2161,465,48,135,183,4.6373390557939915,42.653181739143385
Task_28133,2769,66,200,26,226,41.32835820895522,49.37277871374233
Task_28134,2977,415,145,192,337,7.15625,56.159358682888204
Task_28135,1757,425,149,137,286,4.124413145539906,36.57478092592948
Task_28136,2028,458,63,78,141,4.4183006535947715,40.10168950345517
Task_28137,1443,782,140,22,162,1.842911877394636,31.37555284249419
Task_28138,824,194,94,192,286,4.225641025641026,21.143224670486706
Task_28139,949,147,41,165,206,6.412162162162162,22.33364029318717
Task_28140,1488,508,180,32,212,2.923379174852652,31.59275279463812
Task_28141,2089,175,32,189,221,11.869318181818182,40.44029760698007
Task_28142,2560,735,117,171,288,3.4782608695652173,50.33499951324463
Task_28143,2105,971,135,99,234,2.1656378600823047,43.50901154470531
Task_28144,2667,1010,185,153,338,2.6379821958456975,53.090257320048885
Task_28145,2218,340,177,60,237,6.504398826979473,42.93119695095157
Task_28146,1986,208,47,15,62,9.502392344497608,36.87829021165685
Task_28147,1590,500,46,13,59,3.1736526946107784,31.601305981218207
Task_28148,2957,526,112,161,273,5.611005692599621,55.87391041778019
Task_28149,2627,543,98,68,166,4.829044117647059,49.83091174425558
Task_28150,1392,821,32,181,213,1.6934306569343065,31.760541375783003
Task_28151,506,100,112,161,273,5.00990099009901,15.293030842623685
Task_28152,2216,275,194,129,323,8.028985507246377,43.4880369037888
Task_28153,2666,204,138,43,181,13.004878048780487,49.03287410324112
Task_28154,2833,571,35,78,113,4.9527972027972025,52.984104346316826
Task_28155,2473,779,35,142,177,3.1705128205128204,48.54434825230758
Task_28156,1751,914,21,144,165,1.9136612021857924,37.43884000904232
Task_28157,803,328,172,167,339,2.440729483282675,21.452739454233637
Task_28158,2950,930,12,160,172,3.1686358754027926,56.52276266731863
Task_28159,1732,173,156,158,314,9.954022988505747,35.25307290676642
Task_28160,2645,778,52,135,187,3.3953786906290118,51.36741735464608
Task_28161,2104,120,174,195,369,17.388429752066116,41.12258868584591
Task_28162,2031,733,31,117,148,2.7670299727520438,41.052088383548515
Task_28163,1360,513,107,45,152,2.6459143968871595,29.140262840753707
Task_28164,2307,505,174,52,226,4.559288537549407,44.88370241487423
Task_28165,540,221,186,71,257,2.4324324324324325,16.19944132061652
Task_28166,1816,502,85,67,152,3.610337972166998,36.62836734142281
Task_28167,2608,547,35,108,143,4.759124087591241,49.57986548676245
Task_28168,1838,377,83,50,133,4.862433862433862,36.364869505060035
Task_28169,2819,428,85,135,220,6.571095571095571,53.097373413389754
Task_28170,2755,1020,183,138,321,2.6983349657198823,54.41737677802765
Task_28171,2671,509,54,110,164,5.237254901960784,50.747367241728455
Task_28172,533,468,156,88,244,1.1364605543710022,16.950261132930788
Task_28173,1592,349,176,184,360,4.548571428571429,34.11943253413313
Task_28174,2680,590,186,121,307,4.534686971235194,51.788300720476194
Task_28175,1906,745,27,105,132,2.5549597855227884,39.048548154666456
Task_28176,2671,69,133,108,241,38.15714285714286,48.871813088134644
Task_28177,2269,990,102,32,134,2.289606458123108,44.982546846363526
Task_28178,2626,454,51,109,160,5.771428571428571,49.71713559022199
Task_28179,2804,923,40,193,233,3.034632034632035,54.58491986867799
Task_28180,2863,958,35,53,88,2.9854014598540144,54.00859149853002
Task_28181,1268,640,78,180,258,1.9781591263650546,29.516674315637644
Task_28182,1794,577,83,42,125,3.1038062283737022,36.02023210792934
Task_28183,1729,957,54,75,129,1.8048016701461378,36.933067855735
Task_28184,2651,900,37,70,107,2.942286348501665,50.848828036120175
Task_28185,2438,365,36,50,86,6.66120218579235,45.273174502525954
Task_28186,2316,311,56,109,165,7.423076923076923,44.493028181247496
Task_28187,720,177,98,68,166,4.044943820224719,18.251742944183544
Task_28188,2114,93,190,89,279,22.48936170212766,40.33908276400501
Task_28189,2017,139,83,121,204,14.407142857142857,39.05083478703832
Task_28190,876,898,48,90,138,0.9744160177975528,23.211982323950636
Task_28191,2904,205,94,137,231,14.097087378640778,53.69818056266254
Task_28192,1634,773,125,97,222,2.111111111111111,35.406909124957544
Task_28193,1295,176,103,37,140,7.31638418079096,26.74072396336746
Task_28194,2845,819,103,74,177,3.4695121951219514,54.26632680083529
Task_28195,1266,856,58,167,225,1.4772462077012836,29.942693160410016
Task_28196,2669,770,90,10,100,3.461738002594034,50.17999575909288
Task_28197,2407,69,177,94,271,34.385714285714286,44.87086017330744
Task_28198,934,683,58,173,231,1.3654970760233918,24.176689989107825
Task_28199,1874,166,28,143,171,11.221556886227544,36.63857401673487
Task_28200,2587,338,135,10,145,7.631268436578171,47.96544852429508
Task_28201,1397,872,164,109,273,1.600229095074456,32.16558057537608
Task_28202,1584,867,159,149,308,1.8248847926267282,35.34281420198874
Task_28203,1263,394,89,37,126,3.19746835443038,27.129280299980625
Task_28204,2471,177,189,142,331,13.882022471910112,46.95041509821772
Task_28205,1474,560,84,20,104,2.627450980392157,30.597084491518142
Task_28206,1051,122,152,71,223,8.544715447154472,23.430309496462808
Task_28207,1603,950,110,170,280,1.6855941114616193,35.792820718051566
Task_28208,2935,126,153,124,277,23.11023622047244,53.71820238879659
Task_28209,620,968,158,126,284,0.6398348813209495,20.329371414611213
Task_28210,1939,295,176,17,193,6.550675675675675,37.84774299657624
Task_28211,845,802,137,62,199,1.0523038605230386,22.485568684803365
Task_28212,1835,431,155,21,176,4.247685185185185,36.58262915906729
Task_28213,1452,687,94,101,195,2.11046511627907,32.12149143834399
Task_28214,2105,270,77,189,266,7.767527675276753,41.614002925096415
Task_28215,1471,926,133,10,143,1.586839266450917,32.05803170240811
Task_28216,1468,464,23,131,154,3.156989247311828,31.284729293585116
Task_28217,2514,121,115,146,261,20.60655737704918,47.01885799852867
Task_28218,1724,826,38,30,68,2.0846432889963724,34.91228931937211
Task_28219,2549,245,32,177,209,10.361788617886178,48.19537413799193
Task_28220,1577,738,143,130,273,2.1339648173207038,34.64457814984983
Task_28221,1383,570,39,107,146,2.4220665499124343,30.273589980074643
Task_28222,2922,619,82,39,121,4.712903225806452,53.92790504554153
Task_28223,1190,954,188,37,225,1.2460732984293195,28.33938133067433
Task_28224,816,488,49,23,72,1.6687116564417177,19.433121249404444
Task_28225,1288,240,13,90,103,5.344398340248962,27.24249444920692
Task_28226,2737,451,181,137,318,6.0553097345132745,52.31408406875806
Task_28227,660,892,14,184,198,0.7390817469204927,20.28815932680374
Task_28228,2956,648,135,124,259,4.554699537750385,56.132544420742384
Task_28229,1602,794,69,169,238,2.0150943396226415,35.1871097993753
Task_28230,1383,582,152,125,277,2.37221269296741,31.094380375109157
Task_28231,1203,484,122,162,284,2.4804123711340207,28.02177304018278
Task_28232,2990,514,53,105,158,5.805825242718447,55.636911738194186
Task_28233,1426,69,66,170,236,20.37142857142857,29.520092574027036
Task_28234,1511,118,189,74,263,12.697478991596638,30.802793840177685
Task_28235,824,688,163,152,315,1.1959361393323658,22.72277571955867
Task_28236,1937,302,116,188,304,6.3927392739273925,39.171975856090896
Task_28237,1610,853,33,55,88,1.8852459016393444,33.80665059120919
Task_28238,2969,500,199,167,366,5.926147704590818,56.407293236292766
Task_28239,2118,92,148,73,221,22.774193548387096,39.819470433218704
Task_28240,2984,208,132,101,233,14.277511961722489,54.91953053222759
Task_28241,1934,624,198,81,279,3.0944,39.792949331717026
Task_28242,1272,778,97,30,127,1.6328626444159178,28.4733518860636
Task_28243,2386,391,109,181,290,6.086734693877551,46.499531879789004
Task_28244,2770,309,36,82,118,8.935483870967742,51.15478309538776
Task_28245,1312,144,91,141,232,9.048275862068966,28.146391252955198
Task_28246,1745,369,137,67,204,4.716216216216216,35.456003125545955
Task_28247,602,480,122,23,145,1.2515592515592515,17.062522213658934
Task_28248,2954,961,26,187,213,3.0706860706860706,56.957470436935004
Task_28249,2709,1002,168,90,258,2.7008973080757728,53.246246888077565
Task_28250,2581,138,48,174,222,18.568345323741006,48.07356998396355
Task_28251,1003,510,136,62,198,1.9628180039138943,24.083234171207383
Task_28252,878,474,142,37,179,1.848421052631579,21.680578460892097
Task_28253,651,177,74,94,168,3.657303370786517,17.402274943890475
Task_28254,1277,230,92,51,143,5.528138528138528,27.183385136281995
Task_28255,1828,532,46,179,225,3.4296435272045027,37.86143301461082
Task_28256,1951,541,157,144,301,3.5996309963099633,40.09503878392711
Task_28257,539,561,164,50,214,0.9590747330960854,16.944965859628265
Task_28258,2665,107,49,21,70,24.675925925925927,46.968468892377764
Task_28259,1514,320,12,18,30,4.716510903426792,29.61384833632435
Task_28260,2574,567,45,122,167,4.53169014084507,49.38441240602038
Task_28261,2603,198,146,133,279,13.080402010050252,49.158437485700915
Task_28262,516,617,119,40,159,0.8349514563106796,16.212182799035613
Task_28263,878,337,184,186,370,2.5976331360946747,22.835227037536786
Task_28264,1234,604,16,56,72,2.0396694214876034,26.732707825205114
Task_28265,2239,391,51,105,156,5.711734693877551,43.36428801305908
Task_28266,946,506,142,118,260,1.8658777120315582,23.84970653668481
Task_28267,1047,122,36,195,231,8.512195121951219,23.842326488019378
Task_28268,1585,734,130,54,184,2.1564625850340136,33.92590910110289
Task_28269,2064,977,17,184,201,2.1104294478527605,42.8180045565962
Task_28270,2091,730,54,188,242,2.86046511627907,42.777326610700925
Task_28271,698,858,17,59,76,0.8125727590221188,19.05796678110052
Task_28272,2639,333,193,107,300,7.901197604790419,50.24246439050171
Task_28273,2407,310,172,130,302,7.739549839228296,46.53684111927172
Task_28274,761,948,36,162,198,0.8018967334035827,22.009637728949333
Task_28275,2393,998,183,53,236,2.3953953953953953,47.85255627688917
Task_28276,2394,535,150,164,314,4.4664179104477615,47.17805697221477
Task_28277,610,353,157,63,220,1.7231638418079096,17.499402294436585
Task_28278,570,609,151,158,309,0.9344262295081968,18.473911479263638
Task_28279,1514,80,27,122,149,18.691358024691358,29.988305925960645
Task_28280,2517,109,174,76,250,22.881818181818183,46.42304677937591
Task_28281,816,283,57,192,249,2.8732394366197185,21.211211102625615
Task_28282,2257,897,106,167,273,2.5133630289532296,45.968522017546796
Task_28283,2626,804,40,127,167,3.262111801242236,50.94725910428042
Task_28284,2902,573,154,18,172,5.055749128919861,53.892657891041715
Task_28285,2144,509,153,89,242,4.203921568627451,42.659512994589356
Task_28286,646,821,57,55,112,0.7858880778588808,18.675779639120048
Task_28287,1772,1024,134,60,194,1.728780487804878,37.83137893966824
Task_28288,1236,451,174,83,257,2.734513274336283,28.130346108938053
Task_28289,1926,88,174,10,184,21.640449438202246,36.114655665132425
Task_28290,1508,421,141,58,199,3.5734597156398102,31.800690092379895
Task_28291,1988,373,166,118,284,5.315508021390374,40.023539319979996
Task_28292,1397,810,85,119,204,1.7225647348951911,31.682671103833822
Task_28293,1902,618,191,57,248,3.0726978998384493,38.88401733824923
Task_28294,2772,916,165,66,231,3.0229007633587788,53.573227452906885
Task_28295,592,1015,124,86,210,0.5826771653543307,19.624079272140932
Task_28296,767,829,52,189,241,0.9240963855421687,22.01016442990603
Task_28297,1534,201,32,11,43,7.594059405940594,29.63884818274659
Task_28298,799,134,45,191,236,5.9185185185185185,20.032284523105684
Task_28299,513,247,132,53,185,2.068548387096774,15.48033399435394
Task_28300,2859,783,130,33,163,3.6466836734693877,53.936735674303414
Task_28301,1362,830,98,95,193,1.6389891696750902,31.115270422922805
Task_28302,1234,793,199,135,334,1.5541561712846348,29.62146486570684
Task_28303,1703,888,92,134,226,1.9156355455568055,36.90973127560994
Task_28304,2800,370,194,33,227,7.547169811320755,51.96952481330322
Task_28305,546,445,98,170,268,1.2242152466367713,17.379180334946543
Task_28306,2603,393,133,17,150,6.606598984771574,48.37783625703244
Task_28307,2417,79,46,29,75,30.2125,42.76628710048961
Task_28308,2053,525,81,63,144,3.903041825095057,40.518487456465955
Task_28309,1518,280,12,199,211,5.402135231316726,32.03443938946312
Task_28310,2170,451,23,96,119,4.800884955752212,42.121386981964214
Task_28311,1396,887,143,82,225,1.572072072072072,31.84399427096999
Task_28312,2463,737,126,156,282,3.33739837398374,48.75564840695091
Task_28313,889,875,25,107,132,1.014840182648402,23.26515591472882
Task_28314,2264,435,20,123,143,5.192660550458716,43.75738388378941
Task_28315,735,584,127,73,200,1.2564102564102564,20.161722715791402
Task_28316,970,598,167,161,328,1.6193656093489148,24.873322137679466
Task_28317,2039,944,154,180,334,2.157671957671958,42.95457097370586
Task_28318,1526,203,154,155,309,7.480392156862745,32.30494459633004
Task_28319,2979,436,200,187,387,6.816933638443936,56.47903455778626
Task_28320,2595,917,70,78,148,2.826797385620915,50.58720520929259
Task_28321,1034,484,172,18,190,2.131958762886598,24.13009544431533
Task_28322,1856,401,61,146,207,4.616915422885572,37.78788893680129
Task_28323,2218,689,83,27,110,3.214492753623188,42.89271500161713
Task_28324,553,640,146,187,333,0.8627145085803433,18.444289306871024
Task_28325,1295,924,86,102,188,1.4,30.22104253702699
Task_28326,2954,766,129,16,145,3.851368970013038,55.157750280643846
Task_28327,2735,508,72,155,227,5.373280943025541,52.14458275408475
Task_28328,1073,1013,26,174,200,1.0581854043392505,27.121777948986274
Task_28329,1163,805,101,147,248,1.4429280397022333,28.152730817493516
Task_28330,2749,829,46,58,104,3.3120481927710843,51.91446825056291
Task_28331,2472,697,141,128,269,3.541547277936963,48.67254476098776
Task_28332,1773,342,39,113,152,5.169096209912537,35.707132110631996
Task_28333,2280,248,24,61,85,9.156626506024097,42.440857583058126
Task_28334,648,666,57,32,89,0.9715142428785607,17.87523597849013
Task_28335,2378,531,24,12,36,4.469924812030075,43.999639258091996
Task_28336,1220,241,92,117,209,5.041322314049586,27.107453856204085
Task_28337,2957,133,190,48,238,22.067164179104477,53.27550753034112
Task_28338,1843,778,163,142,305,2.3658536585365852,39.14525884763755
Task_28339,1372,1024,47,166,213,1.3385365853658537,32.04967238014036
Task_28340,981,803,143,46,189,1.2201492537313432,24.392447294411152
Task_28341,1903,960,18,24,42,1.9802289281997918,37.994809818322786
Task_28342,2135,620,92,29,121,3.4380032206119164,41.531575135322406
Task_28343,529,230,59,61,120,2.29004329004329,15.045484451342212
Task_28344,2781,300,98,18,116,9.23920265780731,50.519565308565404
Task_28345,1521,388,186,68,254,3.910025706940874,32.19906256845281
Task_28346,1521,573,159,151,310,2.6498257839721253,33.438239717856966
Task_28347,1205,810,164,14,178,1.4858199753390875,27.741965157430545
Task_28348,2118,685,95,81,176,3.087463556851312,42.422411759535514
Task_28349,1155,462,92,161,253,2.4946004319654427,27.05895192757991
Task_28350,991,636,130,67,197,1.555729984301413,24.318150081668296
Task_28351,680,660,163,148,311,1.0287443267776097,20.330857681212404
Task_28352,943,811,89,104,193,1.1613300492610839,24.321092543800404
Task_28353,1931,1011,142,44,186,1.908102766798419,40.05216705291985
Task_28354,777,616,179,121,300,1.2593192868719612,21.640277173230853
Task_28355,2587,539,159,56,215,4.79074074074074,49.336453434703394
Task_28356,713,586,189,27,216,1.2146507666098807,19.562507028813574
Task_28357,1164,701,157,157,314,1.6581196581196582,28.19789691414249
Task_28358,2010,895,163,124,287,2.2433035714285716,42.048583656677856
Task_28359,665,82,87,79,166,8.012048192771084,16.793905453784955
Task_28360,960,940,149,144,293,1.0201912858661,25.53901174263409
Task_28361,2905,913,78,133,211,3.1783369803063457,56.02400026527252
Task_28362,2530,279,17,25,42,9.035714285714286,45.727248282656234
Task_28363,621,533,153,40,193,1.1629213483146068,17.8690062875059
Task_28364,2207,295,153,182,335,7.456081081081081,43.547578170951255
Task_28365,2624,624,91,136,227,4.1984,50.670613116729605
Task_28366,1300,790,159,151,310,1.6434892541087232,30.602354213580345
Task_28367,1138,879,165,151,316,1.2931818181818182,28.291133836471303
Task_28368,805,546,143,21,164,1.4716636197440585,20.619259108815033
Task_28369,2616,494,127,68,195,5.284848484848485,49.60526482280371
Task_28370,2151,119,103,175,278,17.925,41.40761528580686
Task_28371,1313,141,21,107,128,9.246478873239436,27.243876702699197
Task_28372,2095,108,172,101,273,19.220183486238533,40.25093840780965
Task_28373,1102,169,29,117,146,6.482352941176471,24.114193343514653
Task_28374,1343,843,156,71,227,1.5912322274881516,30.71152494653188
Task_28375,558,645,110,12,122,0.8637770897832817,16.616164246389626
Task_28376,1914,266,128,99,227,7.168539325842697,38.200723520819075
Task_28377,1629,918,154,44,198,1.7725788900979325,35.034874957611095
Task_28378,2156,719,200,33,233,2.9944444444444445,42.92594877345584
Task_28379,751,755,66,197,263,0.9933862433862434,21.661058091315805
Task_28380,2881,88,79,68,147,32.37078651685393,51.279237991869195
Task_28381,725,538,116,105,221,1.3450834879406308,20.208950725376226
Task_28382,974,218,24,180,204,4.447488584474886,23.193437146655807
Task_28383,1674,496,104,163,267,3.3682092555331993,35.44091178978221
Task_28384,2982,1015,30,185,215,2.9350393700787403,57.59347600863965
Task_28385,2956,627,77,160,237,4.707006369426751,56.0861224599187
Task_28386,611,676,48,94,142,0.9025110782865583,18.371733388511437
Task_28387,2020,768,89,101,190,2.626788036410923,41.31558128632073
Task_28388,2852,181,197,89,286,15.67032967032967,52.69828162323523
Task_28389,1252,522,101,84,185,2.3938814531548758,28.244855618772107
Task_28390,2820,307,173,36,209,9.155844155844155,51.98634298186781
Task_28391,2009,286,84,163,247,7.0,39.971655053161264
Task_28392,1836,979,158,136,294,1.873469387755102,39.601760808692106
Task_28393,1756,282,184,183,367,6.204946996466431,36.51887781574823
Task_28394,723,504,176,193,369,1.4316831683168316,20.860368988848037
Task_28395,2387,764,24,145,169,3.1202614379084967,47.054018824339046
Task_28396,1668,850,89,61,150,1.9600470035252644,35.32535504034374
Task_28397,1005,436,19,151,170,2.2997711670480547,24.146811141253895
Task_28398,656,78,51,196,247,8.30379746835443,17.55357000049055
Task_28399,855,204,179,194,373,4.170731707317073,22.061831271972284
Task_28400,2874,90,32,39,71,31.582417582417584,50.0465068789843
Task_28401,2164,451,26,127,153,4.787610619469026,42.24738916066723
Task_28402,1607,670,18,39,57,2.3949329359165423,32.57584348889837
Task_28403,723,120,16,142,158,5.975206611570248,17.930213086956382
Task_28404,2760,982,157,145,302,2.807731434384537,54.302728792839616
Task_28405,711,122,156,37,193,5.780487804878049,17.661567353624694
Task_28406,1741,426,92,70,162,4.07728337236534,35.31610713513269
Task_28407,2777,861,18,109,127,3.2215777262180976,53.16765610878405
Task_28408,2554,223,17,153,170,11.401785714285714,47.895890881232326
Task_28409,1225,458,105,35,140,2.6688453159041394,26.804150754659826
Task_28410,2765,1005,57,39,96,2.7485089463220675,52.35611136788824
Task_28411,2708,688,38,76,114,3.93033381712627,51.34312137538195
Task_28412,2565,418,113,139,252,6.121718377088306,49.18861775074837
Task_28413,691,936,101,28,129,0.7374599786552828,19.857904024834607
Task_28414,1545,182,156,186,342,8.442622950819672,32.641964950937286
Task_28415,2600,360,75,110,185,7.202216066481994,49.235398751066036
Task_28416,2972,70,106,173,279,41.859154929577464,53.85816943946224
Task_28417,2485,720,162,200,362,3.4466019417475726,49.475692536055554
Task_28418,2251,388,20,123,143,5.786632390745501,43.39727064745572
Task_28419,1254,710,21,178,199,1.7637130801687764,29.145742596899407
Task_28420,1553,673,66,142,208,2.3041543026706233,33.86333717955274
Task_28421,1449,203,48,93,141,7.102941176470588,30.15643122957154
Task_28422,969,648,179,123,302,1.4930662557781202,24.811037276916593
Task_28423,1923,541,100,88,188,3.547970479704797,38.9827475663708
Task_28424,991,789,69,147,216,1.2544303797468355,25.287942592364796
Task_28425,1701,526,20,113,133,3.227703984819734,35.121371668562965
Task_28426,1022,210,48,152,200,4.843601895734597,23.93733102589374
Task_28427,2204,143,84,69,153,15.305555555555555,41.09879230162921
Task_28428,2085,721,60,117,177,2.8878116343490303,42.23056367669536
Task_28429,2629,165,67,28,95,15.837349397590362,47.36753706787837
Task_28430,965,279,79,150,229,3.4464285714285716,23.39529588801604
Task_28431,2133,854,185,130,315,2.4947368421052634,44.004646431564744
Task_28432,2948,87,10,42,52,33.5,51.09080094819322
Task_28433,2174,426,60,58,118,5.091334894613583,41.67239645329699
Task_28434,979,310,196,136,332,3.147909967845659,24.10110301178635
Task_28435,2788,809,107,195,302,3.4419753086419753,54.278145469757725
Task_28436,588,411,64,185,249,1.4271844660194175,17.95496029632162
Task_28437,2860,758,92,115,207,3.7681159420289854,54.72049965863519
Task_28438,2126,797,21,81,102,2.664160401002506,42.246411039392285
Task_28439,1402,830,55,155,210,1.687123947051745,31.967439379841704
Task_28440,2411,377,57,116,173,6.378306878306878,46.26024513299774
Task_28441,2212,228,46,185,231,9.65938864628821,42.95555901165759
Task_28442,1709,721,110,116,226,2.3670360110803323,36.45015740926643
Task_28443,2811,544,149,96,245,5.157798165137614,53.42726604915406
Task_28444,1539,131,110,75,185,11.659090909090908,30.964120235347977
Task_28445,2965,898,152,46,198,3.2981090100111237,56.16709954914257
Task_28446,1695,720,90,151,241,2.350901525658807,36.33851301323087
Task_28447,714,907,28,147,175,0.7863436123348018,21.00313218210968
Task_28448,1019,96,56,124,180,10.505154639175258,22.81766494314988
Task_28449,2238,525,132,131,263,4.254752851711027,44.39780768039662
Task_28450,914,224,129,120,249,4.062222222222222,22.39359918258945
Task_28451,1118,171,96,107,203,6.5,25.02166836933303
Task_28452,770,632,145,115,260,1.216429699842022,21.386748565991216
Task_28453,2571,198,191,183,374,12.919597989949748,49.15482682058698
Task_28454,536,149,198,180,378,3.5733333333333333,16.665187810332597
Task_28455,1389,748,25,38,63,1.8544726301735648,29.36684206590667
Task_28456,2382,266,90,126,216,8.92134831460674,45.5872178863234
Task_28457,1501,536,68,126,194,2.7951582867783986,32.51860324742384
Task_28458,1023,163,30,57,87,6.237804878048781,22.13583350897714
Task_28459,2307,410,105,111,216,5.613138686131387,44.87612683385739
Task_28460,587,318,76,18,94,1.8401253918495297,15.72252371047611
Task_28461,2573,711,137,70,207,3.6137640449438204,49.674415926853136
Task_28462,2531,516,170,94,264,4.895551257253385,48.95146424642267
Task_28463,1589,85,137,116,253,18.476744186046513,32.07483691687713
Task_28464,1540,783,157,179,336,1.9642857142857142,34.55449582920881
Task_28465,1940,381,148,15,163,5.0785340314136125,38.00517107283792
Task_28466,2008,642,106,79,185,3.1228615863141522,40.566977025697014
Task_28467,1181,242,80,55,135,4.860082304526749,25.66643023731791
Task_28468,1708,758,107,76,183,2.2503293807641636,36.090527845201585
Task_28469,996,341,121,72,193,2.912280701754386,23.52698204173019
Task_28470,1427,317,192,46,238,4.487421383647798,30.144886393703455
Task_28471,1868,780,147,182,329,2.3918053777208708,39.714375964319835
Task_28472,2505,417,17,29,46,5.992822966507177,45.84686703252874
Task_28473,1656,839,69,170,239,1.9714285714285715,36.188754471304826
Task_28474,2893,118,136,93,229,24.310924369747898,52.68721627117994
Task_28475,2476,585,132,128,260,4.225255972696246,48.34021901395537
Task_28476,2014,119,167,158,325,16.783333333333335,39.439302379304344
Task_28477,2231,487,71,177,248,4.57172131147541,44.22467978241202
Task_28478,2616,805,173,139,312,3.2456575682382134,51.50351818661685
Task_28479,2195,799,87,120,207,2.74375,44.273916021803615
Task_28480,1357,315,63,165,228,4.294303797468355,29.735458132865435
Task_28481,533,984,55,86,141,0.5411167512690356,18.245089441760996
Task_28482,1929,929,54,37,91,2.074193548387097,38.86664399051404
Task_28483,827,993,140,173,313,0.8319919517102615,23.76541918583078
Task_28484,2126,204,78,26,104,10.370731707317074,39.76369579596511
Task_28485,2143,654,41,157,198,3.2717557251908396,43.06095484585114
Task_28486,2368,510,163,157,320,4.634050880626223,46.702880859846935
Task_28487,2981,130,179,128,307,22.755725190839694,54.61953940738192
Task_28488,2404,753,147,116,263,3.1883289124668437,47.727028601654716
Task_28489,2973,125,141,55,196,23.595238095238095,53.53154675243656
Task_28490,500,561,90,65,155,0.8896797153024911,16.065493794060213
Task_28491,994,323,132,126,258,3.067901234567901,24.03210301377031
Task_28492,2783,342,117,172,289,8.113702623906706,52.59674237453646
Task_28493,1563,731,48,32,80,2.1352459016393444,32.351316668828936
Task_28494,2001,849,192,158,350,2.3541176470588234,42.096389799736706
Task_28495,2635,640,180,110,290,4.110764430577223,51.14217709479914
Task_28496,2421,316,19,101,120,7.6372239747634065,45.62247950628202
Task_28497,2760,304,190,157,347,9.049180327868852,52.33972484605895
Task_28498,687,685,132,157,289,1.001457725947522,20.414751999193303
Task_28499,848,787,107,153,260,1.0761421319796953,23.155444811692476
Task_28500,1543,991,114,66,180,1.5554435483870968,34.063958027712125
Task_28501,666,703,39,47,86,0.9460227272727273,18.296613332477758
Task_28502,1981,881,45,39,84,2.246031746031746,39.55785826906861
Task_28503,1598,479,121,72,193,3.3291666666666666,33.4942170948383
Task_28504,2939,720,128,56,184,4.076282940360611,55.32360073177926
Task_28505,2569,174,90,90,180,14.68,47.65723855188876
Task_28506,1535,390,54,182,236,3.925831202046036,32.859366334217434
Task_28507,2089,766,38,41,79,2.723598435462842,40.68469632461731
Task_28508,1315,650,58,101,159,2.0199692780337943,29.53488560083416
Task_28509,1711,67,155,79,234,25.16176470588235,33.52948903766465
Task_28510,979,525,156,186,342,1.861216730038023,24.90094520916482
Task_28511,2889,511,98,159,257,5.642578125,54.6778088854212
Task_28512,623,556,64,80,144,1.118491921005386,18.171837623197874
Task_28513,588,537,27,194,221,1.0929368029739777,18.09559886925437
Task_28514,1521,1002,166,50,216,1.5164506480558324,33.77236170795721
Task_28515,1250,496,40,195,235,2.515090543259557,28.64108751950626
Task_28516,677,723,142,147,289,0.9350828729281768,20.415550970160563
Task_28517,2677,458,13,183,196,5.832244008714597,50.880980704626175
Task_28518,2368,791,99,195,294,2.98989898989899,47.53317387469309
Task_28519,1663,549,45,25,70,3.0236363636363635,33.053106092804704
Task_28520,689,595,56,139,195,1.1560402684563758,19.786342387689423
Task_28521,1765,305,50,104,154,5.76797385620915,35.538830478836466
Task_28522,2198,643,83,81,164,3.4130434782608696,43.56704221528664
Task_28523,927,100,168,120,288,9.178217821782178,21.913133827717814
Task_28524,1039,918,146,193,339,1.130576713819369,26.9935977144446
Task_28525,1768,764,190,104,294,2.311111111111111,37.80807487747184
Task_28526,646,340,116,28,144,1.8944281524926687,17.299653407142063
Task_28527,1266,781,177,141,318,1.618925831202046,30.057125343094963
Task_28528,912,97,69,37,106,9.306122448979592,19.621471519246022
Task_28529,1210,173,165,16,181,6.954022988505747,25.664367005919654
Task_28530,536,107,192,112,304,4.962962962962963,15.896194694233115
Task_28531,1281,512,185,114,299,2.497076023391813,29.34216192566036
Task_28532,610,723,60,112,172,0.8425414364640884,18.774609990686788
Task_28533,2798,527,66,104,170,5.299242424242424,52.8411724237859
Task_28534,2822,589,124,48,172,4.783050847457627,52.81385531721117
Task_28535,783,418,150,130,280,1.8687350835322196,21.101123637604445
Task_28536,1183,1013,25,200,225,1.1666666666666667,29.04301281856434
Task_28537,2193,227,140,73,213,9.618421052631579,42.14282454190479
Task_28538,2466,458,81,59,140,5.372549019607843,46.744842901619954
Task_28539,1778,639,128,178,306,2.778125,37.737481784131354
Task_28540,2676,232,28,80,108,11.484978540772532,49.201897636599455
Task_28541,1458,690,156,110,266,2.109985528219971,32.548797547837914
Task_28542,2226,697,94,164,258,3.189111747851003,44.78934552581371
Task_28543,1622,899,48,130,178,1.8022222222222222,35.46465503882633
Task_28544,1141,71,110,132,242,15.847222222222221,24.99919192496904
Task_28545,1288,525,44,116,160,2.4486692015209126,28.70106076391377
Task_28546,2586,91,68,15,83,28.108695652173914,45.64785338048014
Task_28547,698,408,63,190,253,1.706601466992665,19.744546654167788
Task_28548,707,373,131,37,168,1.8903743315508021,18.575596617849616
Task_28549,2462,562,67,116,183,4.373001776198934,47.717143656526524
Task_28550,2270,760,194,51,245,2.9829172141918527,45.135814807364376
Task_28551,560,916,102,19,121,0.6106870229007634,17.671150051149112
Task_28552,871,997,186,66,252,0.872745490981964,23.839201873175853
Task_28553,657,362,199,32,231,1.8099173553719008,18.064940964054674
Task_28554,2598,274,108,187,295,9.447272727272727,49.48103442814082
Task_28555,2398,529,148,187,335,4.524528301886792,47.350504604295566
Task_28556,2776,777,150,83,233,3.5681233933161955,53.440312327802474
Task_28557,2566,465,200,190,390,5.506437768240343,50.055449242380995
Task_28558,2643,341,163,38,201,7.728070175438597,49.28824417955408
Task_28559,1828,650,131,170,301,2.8079877112135176,38.52971747025845
Task_28560,2166,417,176,106,282,5.181818181818182,42.95793183300717
Task_28561,2437,603,109,135,244,4.03476821192053,47.71807606442463
Task_28562,900,870,69,63,132,1.0332950631458093,23.327516034939293
Task_28563,2305,937,199,78,277,2.4573560767590616,46.61844990486702
Task_28564,2783,628,162,83,245,4.424483306836248,53.133713943802626
Task_28565,1977,325,188,55,243,6.064417177914111,39.107560191263524
Task_28566,2962,518,65,93,158,5.707129094412331,55.209395450966674
Task_28567,676,653,89,180,269,1.033639143730887,20.03347330609425
Task_28568,2855,986,92,42,134,2.8926038500506586,54.31322887375642
Task_28569,2772,288,23,168,191,9.591695501730104,51.7728061635016
Task_28570,895,852,141,66,207,1.0492379835873389,23.513315553129548
Task_28571,2195,277,102,104,206,7.89568345323741,42.59919407022678
Task_28572,1013,458,95,156,251,2.206971677559913,24.784960841800757
Task_28573,1625,683,57,13,70,2.375730994152047,32.69377437652002
Task_28574,1338,235,117,12,129,5.669491525423729,27.755346147491803
Task_28575,966,275,38,44,82,3.5,21.533265340706887
Task_28576,1705,878,124,58,182,1.9397042093287826,36.251829452065316
Task_28577,2978,617,13,29,42,4.818770226537217,53.99068721029038
Task_28578,2978,640,171,87,258,4.645865834633385,56.335359450642926
Task_28579,705,681,103,138,241,1.033724340175953,20.461779029873522
Task_28580,1504,97,17,88,105,15.346938775510203,29.45103930017457
Task_28581,1328,521,14,140,154,2.5440613026819925,29.25623059959473
Task_28582,2925,990,164,168,332,2.951564076690212,57.111352774772946
Task_28583,1739,351,43,82,125,4.940340909090909,35.11700457411521
Task_28584,1371,618,23,50,73,2.2148626817447497,28.831603719393215
Task_28585,2815,216,199,166,365,12.972350230414747,52.974090882757444
Task_28586,2712,151,72,28,100,17.842105263157894,48.61665106291186
Task_28587,1614,409,119,198,317,3.9365853658536585,34.48929369357544
Task_28588,1225,820,193,199,392,1.4920828258221681,29.917941306857102
Task_28589,1336,647,20,61,81,2.0617283950617282,28.760219059944024
Task_28590,851,111,158,126,284,7.598214285714286,20.80336557056419
Task_28591,2812,950,160,22,182,2.956887486855941,53.71741248773313
Task_28592,1938,109,102,19,121,17.618181818181817,36.117546037149815
Task_28593,923,514,106,29,135,1.7922330097087378,22.157648420566215
Task_28594,2711,488,131,152,283,5.543967280163599,51.88773503146408
Task_28595,2355,478,43,49,92,4.916492693110647,44.36776062640263
Task_28596,1075,128,163,90,253,8.333333333333334,24.22514349414031
Task_28597,2236,1008,124,25,149,2.21605550049554,44.58519209181143
Task_28598,2157,905,110,27,137,2.380794701986755,42.903864361510635
Task_28599,1860,492,40,138,178,3.7728194726166326,37.91902253723173
Task_28600,2506,77,44,110,154,32.12820512820513,45.457779979244094
Task_28601,2350,525,54,181,235,4.467680608365019,46.18820512822344
Task_28602,703,599,25,79,104,1.1716666666666666,19.111987441116106
Task_28603,2801,334,30,27,57,8.361194029850747,50.39708087916719
Task_28604,1204,652,124,138,262,1.8437978560490047,28.429994811926477
Task_28605,758,636,156,113,269,1.1899529042386185,21.251509303851062
Task_28606,1127,777,37,139,176,1.448586118251928,27.165263191758616
Task_28607,522,772,136,16,152,0.6752910737386805,16.938268086581342
Task_28608,859,650,70,104,174,1.3195084485407067,22.50446267291545
Task_28609,730,360,94,155,249,2.0221606648199444,19.986833540645808
Task_28610,1281,287,48,44,92,4.447916666666667,26.60856480596867
Task_28611,1807,894,125,117,242,2.018994413407821,38.615817804431224
Task_28612,638,808,46,51,97,0.788627935723115,18.413176553647457
Task_28613,1450,644,111,152,263,2.248062015503876,32.32629801569533
Task_28614,2579,331,200,139,339,7.768072289156627,49.50932753776175
Task_28615,1994,650,194,73,267,3.0629800307219663,40.633635329032515
Task_28616,1186,199,108,119,227,5.93,26.51089550079713
Task_28617,2593,1023,139,115,254,2.5322265625,51.52376013555107
Task_28618,1353,70,57,49,106,19.056338028169016,26.279010346751928
Task_28619,1487,730,75,39,114,2.0341997264021887,31.54371441515291
Task_28620,1232,417,185,103,288,2.9473684210526314,28.199927634726237
Task_28621,1733,942,83,166,249,1.8377518557794275,37.73148336616724
Task_28622,2601,104,125,122,247,24.771428571428572,48.0897602223981
Task_28623,2626,122,126,187,313,21.349593495934958,49.08133445912339
Task_28624,2381,965,103,81,184,2.4648033126293996,47.47876013753433
Task_28625,1283,74,31,63,94,17.106666666666666,25.47306352363486
Task_28626,1781,286,156,93,249,6.205574912891986,36.2475511195801
Task_28627,1760,651,124,65,189,2.6993865030674846,36.530411131553386
Task_28628,938,152,35,164,199,6.130718954248366,22.135998502297202
Task_28629,2826,163,196,84,280,17.23170731707317,52.127109930998955
Task_28630,1715,236,116,193,309,7.236286919831223,35.46404533772855
Task_28631,2532,589,36,183,219,4.291525423728814,49.1502172638462
Task_28632,1896,646,102,134,236,2.930448222565688,39.24842448584432
Task_28633,533,987,164,105,269,0.5394736842105263,18.904547129247902
Task_28634,2715,783,115,31,146,3.4630102040816326,51.52972481158333
Task_28635,2649,726,132,92,224,3.6437414030261346,51.26044739424796
Task_28636,1378,736,128,46,174,1.869742198100407,30.398122404981752
Task_28637,1570,363,20,148,168,4.313186813186813,32.83965868011622
Task_28638,506,161,70,41,111,3.123456790123457,13.91043905681944
Task_28639,2706,935,67,97,164,2.891025641025641,52.678902160434085
Task_28640,2681,811,137,16,153,3.3017241379310347,50.93384719314785
Task_28641,2642,372,94,158,252,7.083109919571045,50.291595861513876
Task_28642,2608,929,175,198,373,2.804301075268817,52.126337795938184
Task_28643,1822,848,55,158,213,2.1460541813898706,38.70928099388427
Task_28644,2247,862,188,200,388,2.603707995365006,46.267519001922665
Task_28645,609,80,61,66,127,7.518518518518518,15.42384346411061
Task_28646,2659,1021,54,60,114,2.601761252446184,51.271126054928594
Task_28647,1127,744,141,200,341,1.512751677852349,27.900936756813966
Task_28648,662,892,153,102,255,0.7413213885778276,20.445775868662558
Task_28649,1301,965,47,172,219,1.3467908902691512,30.777672805373737
Task_28650,930,732,92,73,165,1.2687585266030013,23.565060850564738
Task_28651,2404,523,71,75,146,4.587786259541985,46.24557117064
Task_28652,2528,758,189,167,356,3.3306982872200264,50.20106601641938
Task_28653,1971,987,145,83,228,1.9949392712550607,41.31885540057659
Task_28654,2963,460,23,42,65,6.427331887201736,53.40191663485394
Task_28655,2884,236,168,195,363,12.168776371308017,54.17627968077238
Task_28656,2812,889,44,129,173,3.1595505617977526,54.21578312593371
Task_28657,1536,927,119,199,318,1.6551724137931034,34.873538571796026
Task_28658,2083,472,163,177,340,4.4038054968287526,42.1882086992267
Task_28659,1030,320,44,179,223,3.208722741433022,24.528322763784242
Task_28660,1019,246,140,79,219,4.125506072874494,23.82833354837055
Task_28661,1508,442,30,92,122,3.404063205417607,31.643704445102845
Task_28662,2754,187,88,111,199,14.648936170212766,51.063393703215645
Task_28663,1792,667,178,194,372,2.682634730538922,38.36809696153478
Task_28664,775,71,109,166,275,10.76388888888889,19.47202586032706
Task_28665,1785,117,121,72,193,15.127118644067796,34.758203425025336
Task_28666,2984,477,115,139,254,6.2426778242677825,56.023679598158594
Task_28667,1159,1013,119,71,190,1.1429980276134122,28.14222340359905
Task_28668,1184,733,19,140,159,1.6130790190735695,27.687413619945456
Task_28669,1723,302,156,84,240,5.686468646864687,35.27295668380372
Task_28670,2783,148,186,46,232,18.677852348993287,50.65690835212667
Task_28671,1022,486,124,152,276,2.0985626283367558,25.112058657794407
Task_28672,2556,599,79,75,154,4.26,48.8274674887959
Task_28673,604,218,169,113,282,2.7579908675799087,17.616693628035524
Task_28674,1856,803,94,31,125,2.308457711442786,37.8046849409654
Task_28675,1635,582,72,10,82,2.804459691252144,33.06739330761917
Task_28676,2816,904,141,64,205,3.1116022099447513,54.113543094093494
Task_28677,2986,517,105,112,217,5.764478764478764,55.9796107867712
Task_28678,1047,662,175,59,234,1.579185520361991,25.393518276550495
Task_28679,2727,610,33,93,126,4.463175122749591,51.660097752172476
Task_28680,2275,243,151,197,348,9.323770491803279,44.51749854531875
Task_28681,500,283,144,153,297,1.7605633802816902,16.29538827480134
Task_28682,715,845,95,178,273,0.8451536643026005,21.36287256442904
Task_28683,513,283,161,161,322,1.806338028169014,16.638713672022877
Task_28684,507,404,190,58,248,1.2518518518518518,16.119489035076196
Task_28685,609,64,165,72,237,9.36923076923077,16.225956660849064
Task_28686,547,833,172,198,370,0.6558752997601919,19.249105402174838
Task_28687,1682,215,184,56,240,7.787037037037037,34.04970536946327
Task_28688,509,767,40,12,52,0.6627604166666666,15.663418693409916
Task_28689,1392,388,109,128,237,3.5784061696658096,30.44563528421089
Task_28690,1524,925,136,198,334,1.6457883369330453,34.74782935383888
Task_28691,1622,889,98,105,203,1.8224719101123596,35.47979598247529
Task_28692,1461,736,165,106,271,1.98236092265943,32.756536934842224
Task_28693,2825,446,11,198,209,6.319910514541387,53.24892361989328
Task_28694,1991,168,148,75,223,11.781065088757396,38.615277098806025
Task_28695,2915,159,62,44,106,18.21875,51.61968024458974
Task_28696,2670,176,144,160,304,15.084745762711865,49.9897903765617
Task_28697,1205,903,69,94,163,1.3329646017699115,28.700988600482777
Task_28698,1073,995,120,196,316,1.0773092369477912,27.679669726272788
Task_28699,1404,467,141,82,223,3.0,30.686366056082885
Task_28700,2593,381,122,92,214,6.787958115183246,49.21653263774477
Task_28701,2113,142,98,71,169,14.776223776223777,39.94867727438058
Task_28702,1433,107,138,127,265,13.268518518518519,29.840547006665005
Task_28703,850,760,83,181,264,1.1169513797634691,23.170811698565547
Task_28704,2965,571,136,70,206,5.183566433566433,55.432839075770424
Task_28705,1090,768,93,137,230,1.4174252275682704,26.82808273367516
Task_28706,2019,346,55,49,104,5.818443804034582,38.603827408626444
Task_28707,982,221,175,146,321,4.423423423423423,23.81997660703554
Task_28708,1962,1024,108,171,279,1.9141463414634146,41.72192462983893
Task_28709,2434,211,174,141,315,11.481132075471699,46.67647524541718
Task_28710,2872,161,56,197,253,17.728395061728396,53.027328655796516
Task_28711,2454,266,17,42,59,9.191011235955056,44.65488077933576
Task_28712,1420,666,127,158,285,2.128935532233883,32.02790083397515
Task_28713,2771,328,114,161,275,8.422492401215806,52.279247462551744
Task_28714,2631,255,71,17,88,10.27734375,47.76961292620081
Task_28715,1006,916,71,132,203,1.0970556161395857,25.794714220014384
Task_28716,2020,934,126,177,303,2.160427807486631,42.47826381345711
Task_28717,2327,421,114,148,262,5.514218009478673,45.490332822237406
Task_28718,770,960,71,17,88,0.8012486992715921,20.83997430259289
Task_28719,1881,552,166,17,183,3.4014466546112114,37.703618280370726
Task_28720,1483,503,78,28,106,2.9424603174603177,30.63584703629951
Task_28721,529,201,48,100,148,2.618811881188119,15.627173612329683
Task_28722,2738,807,64,37,101,3.3886138613861387,51.36418691439775
Task_28723,1738,806,194,150,344,2.15365551425031,37.75662364659862
Task_28724,2172,425,179,72,251,5.098591549295775,42.6688924901814
Task_28725,1391,827,140,75,215,1.679951690821256,31.457981012315116
Task_28726,2525,565,179,117,296,4.46113074204947,49.1984019607527
Task_28727,1639,97,152,73,225,16.724489795918366,32.31650341678852
Task_28728,662,595,73,191,264,1.110738255033557,19.726798761477472
Task_28729,2801,165,132,118,250,16.873493975903614,51.758630505321804
Task_28730,840,219,93,114,207,3.8181818181818183,21.048593594589864
Task_28731,886,163,190,93,283,5.402439024390244,21.62932931539486
Task_28732,647,880,103,58,161,0.7343927355278093,19.37599958456087
Task_28733,2647,436,78,129,207,6.05720823798627,50.395204845220604
Task_28734,880,99,145,15,160,8.8,19.512208608553248
Task_28735,2729,499,27,28,55,5.458,49.76951742366143
Task_28736,1767,666,134,186,320,2.649175412293853,37.722884367339255
Task_28737,926,577,63,92,155,1.602076124567474,23.104708707184717
Task_28738,2438,629,85,124,209,3.86984126984127,47.64864672784966
Task_28739,1719,735,164,65,229,2.3355978260869565,36.32936717455106
Task_28740,708,949,118,163,281,0.7452631578947368,21.567784287480475
Task_28741,766,994,33,133,166,0.7698492462311558,22.03977397546768
Task_28742,1273,834,26,126,152,1.524550898203593,29.292335564913504
Task_28743,1313,1013,85,119,204,1.294871794871795,30.91996649388302
Task_28744,2186,777,124,69,193,2.809768637532134,43.67804302683172
Task_28745,2499,101,184,184,368,24.5,47.09358472850197
Task_28746,2037,310,54,143,197,6.54983922829582,40.302183861860804
Task_28747,1399,974,195,188,383,1.4348717948717948,33.08477601226308
Task_28748,1142,787,142,54,196,1.4492385786802031,27.138409791745
Task_28749,1200,128,117,80,197,9.30232558139535,25.83294521973082
Task_28750,1636,381,124,142,266,4.282722513089006,34.434762054082036
Task_28751,1888,165,27,87,114,11.373493975903614,36.17454203243049
Task_28752,1254,605,155,67,222,2.0693069306930694,28.515985835224317
Task_28753,1876,530,159,101,260,3.5329566854990584,38.62472748145583
Task_28754,1354,521,82,194,276,2.5938697318007664,30.581947866922093
Task_28755,2091,338,115,184,299,6.168141592920354,41.700695658471
Task_28756,1111,848,101,162,263,1.3085983510011778,27.55879265356514
Task_28757,2668,716,64,72,136,3.7210599721059974,50.92519055171996
Task_28758,2123,266,17,110,127,7.951310861423221,40.86438296745026
Task_28759,1940,505,183,179,362,3.83399209486166,40.132380288171866
Task_28760,666,1005,97,180,277,0.6620278330019881,21.24052322252869
Task_28761,2785,675,92,162,254,4.1198224852071,53.550722660708296
Task_28762,1207,222,82,109,191,5.4125560538116595,26.778484726856508
Task_28763,2329,699,70,58,128,3.327142857142857,45.435490993820345
Task_28764,1778,123,137,10,147,14.338709677419354,33.9829653332768
Task_28765,527,845,193,114,307,0.6229314420803782,18.57956327190188
Task_28766,2287,915,135,25,160,2.4967248908296944,45.12163756744337
Task_28767,626,297,163,36,199,2.1006711409395975,17.218676143365663
Task_28768,2975,676,73,141,214,4.394387001477105,56.40461873087488
Task_28769,589,870,13,176,189,0.6762342135476463,19.17255521376345
Task_28770,2102,355,161,104,265,5.904494382022472,41.661107383674995
Task_28771,1119,166,158,165,323,6.700598802395209,25.623686654120906
Task_28772,2270,678,56,92,148,3.3431516936671577,44.710700269632206
Task_28773,1041,542,96,119,215,1.9171270718232045,25.272920206366916
Task_28774,705,593,193,121,314,1.1868686868686869,20.493132482897582
Task_28775,1450,425,33,132,165,3.403755868544601,31.14381947145758
Task_28776,636,506,163,130,293,1.2544378698224852,19.043755722197066
Task_28777,1662,961,186,149,335,1.7276507276507276,36.978996687439604
Task_28778,997,851,173,117,290,1.17018779342723,25.80475325756534
Task_28779,2308,85,78,27,105,26.837209302325583,41.50148176967431
Task_28780,2467,857,96,66,162,2.875291375291375,48.16788480204223
Task_28781,1503,85,196,183,379,17.476744186046513,31.392488660894074
Task_28782,2029,291,120,184,304,6.948630136986301,40.582905289108574
Task_28783,1434,953,83,142,225,1.5031446540880504,32.84006773143442
Task_28784,647,782,136,180,316,0.8263090676883781,20.285075683158656
Task_28785,2393,603,134,172,306,3.9619205298013247,47.35493741673242
Task_28786,1791,414,19,51,70,4.31566265060241,34.899529635001144
Task_28787,1702,80,11,128,139,21.012345679012345,32.84617616519895
Task_28788,2576,915,69,147,216,2.8122270742358078,50.86562172910786
Task_28789,1244,568,10,197,207,2.186291739894552,28.59968546315308
Task_28790,1484,921,142,145,287,1.6095444685466378,33.81206261686865
Task_28791,1820,943,113,53,166,1.9279661016949152,38.30975018212477
Task_28792,2218,90,103,106,209,24.373626373626372,41.76550098237242
Task_28793,2839,236,46,63,109,11.978902953586498,51.62310622730566
Task_28794,1961,998,96,186,282,1.962962962962963,41.668535368305434
Task_28795,1945,547,80,48,128,3.5492700729927007,38.60396504501782
Task_28796,2057,583,49,179,228,3.5222602739726026,41.72522969793
Task_28797,1029,586,41,137,178,1.7529812606473594,25.045931005613017
Task_28798,1826,642,175,133,308,2.839813374805599,38.45019859915198
Task_28799,2738,316,171,80,251,8.637223974763407,51.38916038350187
Task_28800,2537,757,187,12,199,3.346965699208443,48.833738897569326
Task_28801,2474,1004,76,25,101,2.4616915422885572,47.85815860743608
Task_28802,2925,646,55,11,66,4.520865533230293,53.1446739421327
Task_28803,2640,143,25,133,158,18.333333333333332,48.240140694583005
Task_28804,2842,461,134,107,241,6.151515151515151,53.61789369331647
Task_28805,831,505,15,142,157,1.6422924901185771,21.37640310067829
Task_28806,2698,508,150,51,201,5.300589390962672,50.915270467651055
Task_28807,1917,265,192,84,276,7.206766917293233,38.37486144666861
Task_28808,594,654,168,52,220,0.9068702290076336,18.270243183635
Task_28809,597,234,167,193,360,2.5404255319148934,18.027109708924478
Task_28810,1579,410,72,171,243,3.8418491484184916,33.62550465849459
Task_28811,738,136,161,167,328,5.386861313868613,19.487949481582394
Task_28812,1872,896,151,69,220,2.0869565217391304,39.1981467069832
Task_28813,962,134,114,154,268,7.125925925925926,22.716626496453074
Task_28814,2482,751,188,46,234,3.300531914893617,48.21550806607518
Task_28815,2364,168,94,182,276,13.988165680473372,45.112856601273876
Task_28816,1561,621,133,16,149,2.509646302250804,32.634622070057645
Task_28817,1360,273,23,54,77,4.963503649635037,27.69015808247083
Task_28818,528,765,18,15,33,0.6892950391644909,15.809839007474038
Task_28819,1166,807,134,168,302,1.443069306930693,28.480633246450534
Task_28820,2967,210,84,160,244,14.061611374407583,54.80535711779802
Task_28821,1623,947,164,32,196,1.7120253164556962,35.0206372112549
Task_28822,2547,623,48,71,119,4.081730769230769,48.510979677885395
Task_28823,1579,949,54,119,173,1.6621052631578948,34.890366521520235
Task_28824,1747,123,75,41,116,14.088709677419354,33.23474922001437
Task_28825,908,705,79,97,176,1.2861189801699717,23.464641811397566
Task_28826,2014,671,10,151,161,2.9970238095238093,40.67736695309034
Task_28827,2722,235,108,81,189,11.533898305084746,50.55297517384556
Task_28828,2996,330,56,176,232,9.051359516616314,55.742400609299835
Task_28829,789,946,33,45,78,0.8331573389651531,20.714550737652587
Task_28830,1462,253,54,97,151,5.755905511811024,30.59590308312735
Task_28831,2250,296,42,160,202,7.575757575757576,43.61583705695739
Task_28832,1627,404,136,99,235,4.017283950617284,34.15818934592961
Task_28833,1678,731,11,68,79,2.2923497267759565,34.36542474675854
Task_28834,527,280,179,190,369,1.8754448398576513,17.1048213183376
Task_28835,1715,940,117,10,127,1.822529224229543,35.898631303802546
Task_28836,2360,464,112,200,312,5.075268817204301,46.45453906393584
Task_28837,509,375,37,69,106,1.3537234042553192,15.22435809323857
Task_28838,1650,407,113,34,147,4.044117647058823,33.44618730404117
Task_28839,1962,358,198,96,294,5.465181058495822,39.603748405134425
Task_28840,1921,261,36,151,187,7.3320610687022905,38.19678841181795
Task_28841,1301,674,107,120,227,1.9274074074074075,29.850893358139043
Task_28842,1618,634,159,21,180,2.548031496062992,33.81554583252366
Task_28843,863,323,110,183,293,2.6635802469135803,22.201749246907088
Task_28844,2316,839,86,195,281,2.757142857142857,46.759583265272994
Task_28845,1561,675,198,45,243,2.309171597633136,33.40811981461143
Task_28846,965,83,173,135,308,11.488095238095237,22.55062393382867
Task_28847,1908,254,25,169,194,7.482352941176471,38.00919898157771
Task_28848,2753,750,12,177,189,3.66577896138482,52.96326481685775
Task_28849,1143,194,17,168,185,5.861538461538461,25.581492798803964
Task_28850,1892,488,133,26,159,3.869120654396728,37.535949063239066
Task_28851,947,179,115,38,153,5.261111111111111,21.340565373442008
Task_28852,1589,574,61,137,198,2.763478260869565,34.06000358030463
Task_28853,1499,79,197,106,303,18.7375,30.839697487912208
Task_28854,1739,464,90,27,117,3.739784946236559,34.68589047746399
Task_28855,2111,1009,96,28,124,2.09009900990099,42.39021781677407
Task_28856,865,486,160,139,299,1.7761806981519508,22.697858816938368
Task_28857,1979,755,114,25,139,2.617724867724868,39.61128655753482
Task_28858,2697,331,139,132,271,8.123493975903614,51.058796887631765
Task_28859,2711,485,13,129,142,5.578189300411522,50.988151940609406
Task_28860,2317,331,18,193,211,6.978915662650603,44.852303034412444
Task_28861,1074,864,111,77,188,1.2416184971098265,26.38271419237441
Task_28862,2242,930,154,128,282,2.4081632653061225,45.81711961824838
Task_28863,634,954,72,176,248,0.6638743455497382,20.489201286125795
Task_28864,2411,680,97,65,162,3.5403817914831133,46.74465312312797
Task_28865,1792,100,104,106,210,17.742574257425744,35.127516063054145
Task_28866,2511,317,196,192,388,7.89622641509434,48.684124111030314
Task_28867,1526,729,181,191,372,2.0904109589041098,34.34420300820734
Task_28868,2808,223,114,172,286,12.535714285714286,52.54419127493736
Task_28869,1535,972,100,165,265,1.5775950668037,34.67928223101712
Task_28870,604,837,52,150,202,0.720763723150358,19.34360063255897
Task_28871,1810,892,24,156,180,2.0268756998880177,38.40015351812325
Task_28872,1300,277,20,138,158,4.676258992805756,28.08439344173374
Task_28873,694,541,129,164,293,1.2804428044280443,20.12416115392497
Task_28874,511,225,27,82,109,2.2610619469026547,15.048138269404978
Task_28875,2300,791,179,91,270,2.904040404040404,46.1386054589027
Task_28876,2112,303,167,84,251,6.947368421052632,41.476375964338885
Task_28877,2806,752,85,107,192,3.7264276228419653,53.76514282334811
Task_28878,1169,730,40,74,114,1.5991792065663475,27.10634003137353
Task_28879,970,206,123,151,274,4.685990338164252,23.374855195971623
Task_28880,628,311,117,127,244,2.0128205128205128,18.144401896546025
Task_28881,2990,172,121,131,252,17.283236994219653,54.778355827086784
Task_28882,1337,212,175,53,228,6.276995305164319,28.587007436099544
Task_28883,2145,119,41,150,191,17.875,40.85418567856677
Task_28884,1417,486,86,193,279,2.909650924024641,31.398975862962278
Task_28885,2543,804,113,79,192,3.1590062111801243,49.610850257548485
Task_28886,789,938,18,151,169,0.8402555910543131,22.200107901146804
Task_28887,667,485,199,167,366,1.3724279835390947,19.869891809410298
Task_28888,2150,330,191,103,294,6.495468277945619,42.465569029711666
Task_28889,1356,894,33,73,106,1.5150837988826815,30.27311614818932
Task_28890,1040,764,37,110,147,1.3594771241830066,25.423640231218325
Task_28891,798,519,197,139,336,1.5346153846153847,21.877812771946083
Task_28892,2242,855,92,190,282,2.619158878504673,45.681685629574524
Task_28893,1079,629,46,41,87,1.7126984126984126,24.447796981216342
Task_28894,2568,461,126,56,182,5.558441558441558,48.609624881300334
Task_28895,918,902,12,76,88,1.0166112956810631,23.160346532756552
Task_28896,1342,672,91,186,277,1.9940564635958395,30.815514506389892
Task_28897,663,588,22,45,67,1.1256366723259763,17.440450728524976
Task_28898,1752,297,89,192,281,5.879194630872483,36.11124629571933
Task_28899,1295,939,57,200,257,1.377659574468085,30.848737222806278
Task_28900,1479,974,56,33,89,1.5169230769230768,31.83113849043417
Task_28901,2235,234,119,38,157,9.51063829787234,42.13997692814629
Task_28902,2037,969,11,56,67,2.1,40.52849332055484
Task_28903,944,196,124,162,286,4.791878172588833,23.016214988360645
Task_28904,516,130,83,165,248,3.9389312977099236,15.632744797206259
Task_28905,1410,75,70,81,151,18.55263157894737,28.315835190821645
Task_28906,2493,647,173,68,241,3.8472222222222223,48.356611450887414
Task_28907,901,402,75,37,112,2.235732009925558,21.194598204338703
Task_28908,710,286,117,107,224,2.4738675958188154,19.24154510251483
Task_28909,2513,578,118,22,140,4.3402417962003454,47.512745336745645
Task_28910,778,537,139,141,280,1.446096654275093,21.356728177560967
Task_28911,2405,391,25,188,213,6.135204081632653,46.44902780083692
Task_28912,2504,897,63,98,161,2.7884187082405347,49.18295987104699
Task_28913,2803,303,91,34,125,9.220394736842104,51.134934947497136
Task_28914,1222,984,131,27,158,1.2406091370558376,28.46525209340392
Task_28915,2293,96,150,109,259,23.63917525773196,43.166338099875766
Task_28916,2384,921,129,86,215,2.585683297180043,47.60929241267535
Task_28917,1174,980,74,116,190,1.1967380224260957,28.60604996696632
Task_28918,2488,544,132,91,223,4.565137614678899,48.12318921748409
Task_28919,1651,891,39,33,72,1.850896860986547,33.974068933980746
Task_28920,2412,422,69,106,175,5.702127659574468,46.43121478381147
Task_28921,2949,762,12,129,141,3.865006553079948,55.62753947250557
Task_28922,553,197,178,36,214,2.792929292929293,15.842042989207307
Task_28923,2490,742,193,62,255,3.351278600269179,48.61971924048595
Task_28924,2771,498,196,59,255,5.55310621242485,52.284455918737876
Task_28925,1190,179,191,19,210,6.611111111111111,25.536833952103596
Task_28926,1477,173,187,170,357,8.488505747126437,31.442534543327366
Task_28927,981,929,82,28,110,1.0548387096774194,24.132376828497296
Task_28928,2432,151,138,175,313,16.0,46.25083326979913
Task_28929,1194,737,61,145,206,1.6178861788617886,28.347898529269504
Task_28930,2168,944,119,154,273,2.2941798941798943,44.68567491480592
Task_28931,2054,605,12,162,174,3.3894389438943895,41.32492679045044
Task_28932,1764,251,97,137,234,7.0,35.87874629653339
Task_28933,1074,546,196,84,280,1.963436928702011,25.967323378445755
Task_28934,1126,506,41,160,201,2.2209072978303745,26.507815308135196
Task_28935,1383,885,114,164,278,1.5609480812641083,32.057966200869146
Task_28936,2233,1019,112,166,278,2.18921568627451,45.98919135203705
Task_28937,2581,814,172,69,241,3.1668711656441717,50.270312348998374
Task_28938,2412,236,81,185,266,10.177215189873417,46.32186535450743
Task_28939,2027,167,123,21,144,12.06547619047619,38.22446510013267
Task_28940,1975,370,185,146,331,5.32345013477089,40.06084922686183
Task_28941,2594,370,191,53,244,6.991913746630728,49.07328769347751
Task_28942,2256,158,103,96,199,14.18867924528302,42.881116794784
Task_28943,1799,473,84,72,156,3.7953586497890295,36.38345196119977
Task_28944,2407,772,167,145,312,3.1138421733505823,48.09758023860558
Task_28945,1924,820,66,104,170,2.343483556638246,39.92474854665109
Task_28946,1600,1000,76,177,253,1.5984015984015985,35.85589063504571
Task_28947,1123,181,196,34,230,6.170329670329671,24.65415892412024
Task_28948,2162,744,27,10,37,2.902013422818792,41.27136803147115
Task_28949,1856,222,136,55,191,8.32286995515695,36.60146928633642
Task_28950,1475,516,51,95,146,2.852998065764023,31.68494302607874
Task_28951,2397,342,41,36,77,6.988338192419825,44.09117211553243
Task_28952,989,574,94,45,139,1.72,23.4468694367844
Task_28953,2549,529,91,194,285,4.809433962264151,49.52555053858077
Task_28954,2002,472,182,100,282,4.232558139534884,40.531736304388126
Task_28955,697,664,127,43,170,1.0481203007518798,19.341087106455884
Task_28956,2457,67,68,190,258,36.13235294117647,45.73912354413202
Task_28957,1280,825,60,28,88,1.549636803874092,28.19336705232229
Task_28958,1933,325,64,112,176,5.929447852760736,38.542715280753356
Task_28959,1818,167,51,131,182,10.821428571428571,35.98198398573465
Task_28960,537,780,155,24,179,0.6875800256081946,17.447379783976324
Task_28961,2114,542,12,160,172,3.8931860036832413,42.05680912996696
Task_28962,2009,151,131,54,185,13.217105263157896,38.49814428765509
Task_28963,2437,704,163,53,216,3.4567375886524823,47.539489132321485
Task_28964,1436,621,165,186,351,2.3086816720257235,32.47899222200247
Task_28965,2450,317,169,28,197,7.70440251572327,46.1093491792579
Task_28966,1545,145,131,11,142,10.582191780821917,30.414770181879348
Task_28967,962,424,83,106,189,2.263529411764706,23.540044806508252
Task_28968,781,347,10,144,154,2.2442528735632186,20.031459759635794
Task_28969,604,427,151,107,258,1.411214953271028,18.109823269257998
Task_28970,1522,588,22,179,201,2.5840407470288627,33.03275323421059
Task_28971,1326,214,28,177,205,6.167441860465116,28.74042774312979
Task_28972,2476,794,127,58,185,3.1144654088050316,48.223972613705
Task_28973,2326,252,87,161,248,9.193675889328063,44.81301743649357
Task_28974,1132,747,68,102,170,1.5133689839572193,27.104410417717176
Task_28975,760,764,14,17,31,0.9934640522875817,19.26419672819999
Task_28976,1849,86,34,38,72,21.25287356321839,33.98116495317871
Task_28977,2917,186,133,156,289,15.598930481283423,54.139273680928206
Task_28978,992,74,19,79,98,13.226666666666667,21.080317274856387
Task_28979,1360,579,33,179,212,2.3448275862068964,30.51326147873374
Task_28980,1943,750,17,171,188,2.5872170439414113,40.10180433400311
Task_28981,2861,712,17,54,71,4.012622720897616,52.80390290453732
Task_28982,2526,917,156,184,340,2.7516339869281046,50.620258706528396
Task_28983,1443,887,105,81,186,1.625,32.37773561545507
Task_28984,528,690,135,44,179,0.76410998552822,16.8803358081698
Task_28985,1112,530,193,23,216,2.0941619585687383,25.665093073262877
Task_28986,1692,682,198,106,304,2.4773060029282576,36.39570444004927
Task_28987,1510,97,37,24,61,15.408163265306122,28.634311964059105
Task_28988,1700,909,133,141,274,1.8681318681318682,37.14641563162166
Task_28989,1486,884,168,71,239,1.6790960451977401,33.18074983396135
Task_28990,1596,357,41,93,134,4.4581005586592175,32.93246424658974
Task_28991,833,321,104,139,243,2.5869565217391304,21.431068749452436
Task_28992,2143,338,154,77,231,6.321533923303835,41.89362742031354
Task_28993,1261,980,10,145,155,1.2854230377166156,29.577689480656236
Task_28994,2142,328,75,132,207,6.51063829787234,42.047477504577174
Task_28995,1952,805,69,53,122,2.4218362282878414,39.50563760895891
Task_28996,928,276,39,86,125,3.3501805054151625,22.042289989447426
Task_28997,2466,338,138,27,165,7.274336283185841,46.282153736704394
Task_28998,1236,441,198,191,389,2.7963800904977374,28.92377917435995
Task_28999,1626,1018,57,67,124,1.5956820412168793,35.18555495406392
Task_29000,2943,410,84,141,225,7.160583941605839,55.03490457194588
Task_29001,2439,199,57,28,85,12.195,44.47605095128168
Task_29002,757,570,114,169,283,1.3257443082311733,21.188533434174612
Task_29003,527,598,84,115,199,0.8797996661101837,17.16167645374497
Task_29004,2257,405,150,174,324,5.559113300492611,44.64757646493643
Task_29005,1644,965,68,63,131,1.7018633540372672,35.42025827489937
Task_29006,1771,306,166,132,298,5.768729641693811,36.45174942811935
Task_29007,2684,736,47,188,235,3.6417910447761193,52.128677581636545
Task_29008,600,913,87,100,187,0.6564551422319475,19.35538189321901
Task_29009,2843,125,180,193,373,22.563492063492063,52.786054460119054
Task_29010,2175,209,87,187,274,10.357142857142858,42.42247400028099
Task_29011,1993,998,38,23,61,1.994994994994995,39.65966598939687
Task_29012,2218,236,133,96,229,9.358649789029537,42.93515494953249
Task_29013,2069,323,45,53,98,6.385802469135802,39.48113651115272
Task_29014,1321,564,107,177,284,2.338053097345133,30.16384470764942
Task_29015,1823,671,22,126,148,2.712797619047619,37.555729770417194
Task_29016,2758,382,195,78,273,7.201044386422977,52.00470465545852
Task_29017,546,320,76,17,93,1.7009345794392523,15.061742412322182
Task_29018,2259,357,19,127,146,6.310055865921788,43.45396978307749
Task_29019,2484,864,57,169,226,2.871676300578035,49.31978853581199
Task_29020,1015,251,181,21,202,4.027777777777778,23.153080623031613
Task_29021,2984,494,30,27,57,6.028282828282828,53.82876821980696
Task_29022,1111,423,179,105,284,2.6202830188679247,26.289038132626768
Task_29023,2615,343,95,123,218,7.601744186046512,49.56140105659611
Task_29024,1134,494,37,10,47,2.290909090909091,24.305308060935957
Task_29025,1368,876,60,140,200,1.5598631698973775,31.478605650854746
Task_29026,1820,491,28,77,105,3.6991869918699187,36.436961769098794
Task_29027,1764,412,127,141,268,4.271186440677966,36.56826521034788
Task_29028,1613,708,80,173,253,2.2750352609308884,35.147348559229656
Task_29029,2213,709,141,166,307,3.1169014084507043,44.83465047495739
Task_29030,695,621,28,66,94,1.117363344051447,18.810815587375927
Task_29031,2693,971,166,95,261,2.7705761316872426,52.962072874652
Task_29032,1213,747,13,86,99,1.6216577540106951,27.526900438110335
Task_29033,1382,664,59,194,253,2.0781954887218044,31.398234656936992
Task_29034,1520,998,65,136,201,1.5215215215215214,34.26529226230597
Task_29035,711,726,39,35,74,0.9779917469050894,18.704454260124447
Task_29036,629,331,110,83,193,1.894578313253012,17.8553970018046
Task_29037,1919,887,192,178,370,2.161036036036036,41.035008229677175
Task_29038,661,86,173,189,362,7.597701149425287,18.12682626198627
Task_29039,1048,959,41,10,51,1.0916666666666666,24.549517243071318
Task_29040,2488,352,109,200,309,7.048158640226629,48.095941892495205
Task_29041,1547,448,163,152,315,3.44543429844098,33.477717345586036
Task_29042,2952,456,18,15,33,6.459518599562363,52.83163108532951
Task_29043,1564,342,65,183,248,4.559766763848397,33.217065821156545
Task_29044,1063,132,122,88,210,7.992481203007519,23.815285196630708
Task_29045,2734,856,175,46,221,3.190198366394399,52.47899248243113
Task_29046,2742,971,26,75,101,2.8209876543209877,52.49734237740384
Task_29047,1843,832,150,159,309,2.2124849939975992,39.35669551598642
Task_29048,1774,339,56,170,226,5.2176470588235295,36.41029408072575
Task_29049,1981,656,197,171,368,3.015220700152207,41.27535080708938
Task_29050,931,944,21,71,92,0.9851851851851852,23.596558132560244
Task_29051,919,734,114,129,243,1.2503401360544217,24.0073643889961
Task_29052,1825,900,146,115,261,2.025527192008879,39.00239992061593
Task_29053,1277,878,67,190,257,1.452787258248009,30.367842853071235
Task_29054,2383,101,70,23,93,23.362745098039216,42.898490286555585
Task_29055,2225,501,10,48,58,4.432270916334661,41.91537428728278
Task_29056,2090,979,66,138,204,2.13265306122449,43.301536884946366
Task_29057,839,650,181,176,357,1.2887864823348694,23.0653970631036
Task_29058,1973,405,10,11,21,4.859605911330049,37.10303523460414
Task_29059,2987,315,189,98,287,9.45253164556962,55.61866327564784
Task_29060,1585,226,198,110,308,6.9823788546255505,33.248951631988554
Task_29061,1057,730,88,125,213,1.4459644322845417,26.00682410636634
Task_29062,1256,810,47,25,72,1.5487053020961776,27.43772552197944
Task_29063,1648,841,189,17,206,1.9572446555819478,35.04177632362025
Task_29064,2108,1006,17,125,142,2.0933465739821253,43.05580496353483
Task_29065,2845,72,100,173,273,38.97260273972603,51.85457222102847
Task_29066,1446,409,120,168,288,3.526829268292683,31.656117487146734
Task_29067,592,545,32,25,57,1.0842490842490842,16.22860981686742
Task_29068,1943,919,30,90,120,2.1119565217391303,40.00277309830209
Task_29069,1734,634,135,14,149,2.730708661417323,35.41244998648536
Task_29070,2204,774,170,193,363,2.8438709677419354,45.18806243471994
Task_29071,2685,226,43,55,98,11.82819383259912,48.86005501276907
Task_29072,1160,919,79,50,129,1.2608695652173914,27.329861904960353
Task_29073,2439,623,84,14,98,3.9086538461538463,46.01721827018023
Task_29074,1947,798,80,126,206,2.436795994993742,40.43902730132523
Task_29075,1446,141,55,84,139,10.183098591549296,29.386171519023947
Task_29076,2417,477,132,37,169,5.056485355648536,45.97544037426568
Task_29077,1771,416,95,28,123,4.247002398081535,35.16228519202115
Task_29078,1640,348,109,157,266,4.699140401146132,34.41215600138384
Task_29079,858,177,72,58,130,4.820224719101123,20.08707632407631
Task_29080,2321,821,40,94,134,2.82360097323601,45.88430350183015
Task_29081,1555,365,180,29,209,4.248633879781421,32.1732378866173
Task_29082,2836,292,175,163,338,9.679180887372013,53.466703049150546
Task_29083,2142,689,75,121,196,3.1043478260869564,43.14563689907488
Task_29084,2231,660,150,113,263,3.3751891074130107,44.68941395762216
Task_29085,1979,515,97,187,284,3.8352713178294575,40.44963228680265
Task_29086,1868,665,29,35,64,2.804804804804805,36.64454355419109
Task_29087,968,1002,171,13,184,0.9651046859421735,24.776880265141696
Task_29088,1055,847,173,90,263,1.2441037735849056,26.517631728914626
Task_29089,2030,939,64,106,170,2.1595744680851063,41.97085681894687
Task_29090,984,735,98,153,251,1.3369565217391304,25.1332126642133
Task_29091,2447,515,62,45,107,4.742248062015504,45.82019739396576
Task_29092,1444,144,132,36,168,9.958620689655172,29.150145304976363
Task_29093,2414,208,52,174,226,11.55023923444976,46.06819687779915
Task_29094,858,623,117,30,147,1.375,21.5821496516882
Task_29095,2420,570,64,15,79,4.2381786339754814,45.091645595681264
Task_29096,1925,612,42,166,208,3.1402936378466557,39.53794524064235
Task_29097,2642,376,127,24,151,7.007957559681698,48.97488412593122
Task_29098,2707,488,111,177,288,5.5357873210633946,51.88359552820956
Task_29099,2307,180,134,171,305,12.74585635359116,44.3186845377798
Task_29100,1375,603,102,125,227,2.2764900662251657,30.808216075216723
Task_29101,2670,780,80,123,203,3.418693982074264,51.81907542793338
Task_29102,1978,345,169,39,208,5.716763005780347,38.80299393599686
Task_29103,1073,587,97,183,280,1.8248299319727892,26.307153440703953
Task_29104,877,765,29,81,110,1.1449086161879896,22.510125860524898
Task_29105,770,954,48,105,153,0.806282722513089,21.750899837273398
Task_29106,1875,375,80,177,257,4.986702127659575,38.260473431293526
Task_29107,1621,608,75,191,266,2.6617405582922826,35.05709864143362
Task_29108,1858,90,58,22,80,20.417582417582416,34.21215567174811
Task_29109,543,149,170,54,224,3.62,15.596914882723532
Task_29110,1125,635,196,32,228,1.7688679245283019,26.30477254799069
Task_29111,2569,796,80,186,266,3.223337515683814,50.64551496849801
Task_29112,575,732,31,13,44,0.7844474761255116,16.41026222147169
Task_29113,1201,887,193,27,220,1.3524774774774775,28.240411347473266
Task_29114,1752,168,48,63,111,10.366863905325443,33.89073313591869
Task_29115,2791,184,36,90,126,15.086486486486486,51.07199155473577
Task_29116,2802,807,150,60,210,3.467821782178218,53.557402155165086
Task_29117,1587,540,132,68,200,2.933456561922366,33.48546547188226
Task_29118,1342,377,143,68,211,3.5502645502645502,29.137656972389056
Task_29119,2183,560,68,63,131,3.89126559714795,42.698964233984405
Task_29120,1324,169,107,182,289,7.788235294117647,28.744130238094616
Task_29121,2037,743,61,140,201,2.7379032258064515,41.704595384161856
Task_29122,2977,197,112,187,299,15.035353535353535,55.225324350212354
Task_29123,983,453,62,186,248,2.1651982378854626,24.381638136762188
Task_29124,2576,542,53,166,219,4.7440147329650095,49.72904511233503
Task_29125,2031,96,93,35,128,20.938144329896907,37.61412033368794
Task_29126,2349,600,28,159,187,3.908485856905158,46.06968797878781
Task_29127,1165,715,200,59,259,1.6270949720670391,27.560885135473963
Task_29128,2536,137,77,174,251,18.3768115942029,47.55698763611924
Task_29129,2766,359,128,164,292,7.683333333333334,52.387927600826494
Task_29130,2771,501,27,19,46,5.5199203187251,50.22145372609392
Task_29131,2180,530,117,72,189,4.105461393596987,42.84993050151294
Task_29132,707,743,59,95,154,0.9502688172043011,20.122977237068998
Task_29133,2587,156,161,172,333,16.477707006369428,48.80455676715346
Task_29134,2528,882,120,98,218,2.8629671574178936,49.87418373374546
Task_29135,2107,630,31,92,123,3.3391442155309035,41.75157331455362
Task_29136,2289,654,134,169,303,3.4946564885496185,45.8514941729866
Task_29137,1923,459,87,38,125,4.180434782608696,37.71417798341058
Task_29138,2834,294,109,135,244,9.60677966101695,52.97755887072299
Task_29139,1469,599,61,142,203,2.4483333333333333,32.26818338364402
Task_29140,2399,229,144,95,239,10.430434782608696,45.79668964357458
Task_29141,629,997,86,164,250,0.6302605210420842,20.465597260862243
Task_29142,838,659,152,66,218,1.2696969696969698,22.066117316028052
Task_29143,781,172,19,13,32,4.514450867052023,17.575524694439224
Task_29144,2422,493,148,132,280,4.902834008097166,47.28602619400217
Task_29145,1919,260,134,78,212,7.352490421455939,38.043320295971164
Task_29146,915,525,67,138,205,1.7395437262357414,23.260875108367216
Task_29147,1584,419,131,68,199,3.7714285714285714,33.048049143277666
Task_29148,2355,193,156,28,184,12.139175257731958,44.12508868849489
Task_29149,766,754,81,71,152,1.014569536423841,20.769190541067157
Task_29150,1192,238,27,14,41,4.98744769874477,24.32662694200995
Task_29151,2015,363,29,190,219,5.535714285714286,40.232660327098976
Task_29152,1721,291,66,30,96,5.8938356164383565,33.63569297164924
Task_29153,971,691,79,190,269,1.403179190751445,24.979082655209734
Task_29154,1084,618,45,129,174,1.751211631663974,26.002411555843256
Task_29155,1709,140,70,95,165,12.120567375886525,33.974373044413056
Task_29156,2933,892,182,51,233,3.284434490481523,55.999957999634944
Task_29157,1269,756,66,134,200,1.676354029062087,29.562245333101014
Task_29158,1744,850,122,115,237,2.0493537015276146,37.45519895463696
Task_29159,2042,496,196,141,337,4.1086519114688125,41.549998954015045
Task_29160,2163,751,77,76,153,2.8763297872340425,43.086077166076706
Task_29161,2170,238,85,89,174,9.07949790794979,41.850291749283265
Task_29162,2705,218,183,144,327,12.351598173515981,51.0415919634033
Task_29163,1530,401,16,184,200,3.8059701492537314,32.55903046019102
Task_29164,1608,649,70,113,183,2.473846153846154,34.46135718405801
Task_29165,1404,671,162,139,301,2.0892857142857144,31.83435890839901
Task_29166,1651,283,147,129,276,5.813380281690141,34.373225615718226
Task_29167,2382,354,56,133,189,6.709859154929577,45.85341219873814
Task_29168,718,103,165,195,360,6.903846153846154,19.11973283920291
Task_29169,2180,994,200,200,400,2.190954773869347,45.67125388743214
Task_29170,575,680,156,41,197,0.8443465491923642,17.66253080137245
Task_29171,542,937,21,29,50,0.5778251599147122,16.69788083113514
Task_29172,2751,1005,94,16,110,2.734592445328032,52.35215508065244
Task_29173,2120,668,159,147,306,3.1689088191330343,43.200141908208856
Task_29174,2750,966,135,199,334,2.843846949327818,54.31771016533543
Task_29175,2706,223,92,97,189,12.080357142857142,50.42885493268596
Task_29176,1739,367,59,70,129,4.725543478260869,35.103647721209
Task_29177,2064,707,94,14,108,2.9152542372881354,40.51080591404394
Task_29178,1286,453,117,73,190,2.8325991189427313,28.448532325318265
Task_29179,2619,342,163,70,233,7.635568513119534,49.32313071025843
Task_29180,1229,1008,169,112,281,1.218037661050545,29.914349408382453
Task_29181,2636,971,62,56,118,2.711934156378601,50.6787620329155
Task_29182,1196,928,121,101,222,1.28740581270183,28.865002615131306
Task_29183,2710,345,177,167,344,7.832369942196531,51.6929749308678
Task_29184,2388,553,14,180,194,4.310469314079422,46.606902332172666
Task_29185,2738,170,172,153,325,16.01169590643275,51.167434280701485
Task_29186,750,565,48,109,157,1.325088339222615,20.2632712197561
Task_29187,807,64,189,30,219,12.415384615384616,18.717840396239286
Task_29188,2814,473,41,154,195,5.936708860759493,53.088344201331914
Task_29189,2891,302,59,56,115,9.541254125412541,52.57814133489557
Task_29190,1525,129,26,41,67,11.73076923076923,29.316009316036382
Task_29191,502,362,137,113,250,1.3829201101928374,16.26510166927761
Task_29192,1157,953,79,47,126,1.2127882599580713,27.22912081048266
Task_29193,2555,552,162,144,306,4.620253164556962,49.71644910931326
Task_29194,2938,486,44,63,107,6.032854209445585,54.00588918270676
Task_29195,2424,411,89,119,208,5.883495145631068,46.68553452583592
Task_29196,1413,498,178,196,374,2.8316633266533064,31.845957550556857
Task_29197,1884,645,103,99,202,2.91640866873065,38.84470087978799
Task_29198,672,578,26,55,81,1.160621761658031,18.085869866580676
Task_29199,2482,377,183,97,280,6.5661375661375665,47.83193583799572
Task_29200,1941,303,113,85,198,6.384868421052632,38.53286724727018
Task_29201,2020,482,114,104,218,4.182194616977226,40.566224818120084
Task_29202,2289,768,161,45,206,2.976592977893368,45.06496363691923
Task_29203,1853,789,98,17,115,2.3455696202531646,37.413986647742895
Task_29204,622,354,126,55,181,1.7521126760563381,17.456412564102372
Task_29205,1888,536,72,169,241,3.515828677839851,38.907793030302294
Task_29206,1921,349,127,129,256,5.488571428571428,38.77412538273953
Task_29207,2227,681,93,133,226,3.2653958944281527,44.59329873148361
Task_29208,1178,661,149,193,342,1.7794561933534743,28.474018212444538
Task_29209,625,325,184,81,265,1.9171779141104295,18.064461703076493
Task_29210,2335,187,125,51,176,12.420212765957446,44.000688154026896
Task_29211,1138,296,170,149,319,3.8316498316498318,26.52992737039961
Task_29212,2079,536,71,58,129,3.8715083798882683,40.87068253145264
Task_29213,1043,867,98,77,175,1.2016129032258065,25.852730329736534
Task_29214,1297,548,149,147,296,2.3624772313296902,29.74365453526119
Task_29215,882,479,127,105,232,1.8375,22.606644653778506
Task_29216,555,256,159,121,280,2.159533073929961,16.968419764776105
Task_29217,827,648,192,10,202,1.2742681047765794,21.397180062223867
Task_29218,2989,779,55,102,157,3.832051282051282,56.455759676986325
Task_29219,813,186,187,73,260,4.347593582887701,20.516912142903703
Task_29220,645,649,85,67,152,0.9923076923076923,18.551830634045704
Task_29221,1827,337,30,186,216,5.405325443786983,37.15390953393561
Task_29222,1412,846,35,134,169,1.667060212514758,31.860080811382492
Task_29223,1565,617,180,149,329,2.5323624595469254,34.356072648124076
Task_29224,2791,453,184,64,248,6.147577092511013,52.47595709037822
Task_29225,1646,839,166,16,182,1.9595238095238094,34.87037013573907
Task_29226,1551,220,91,122,213,7.018099547511312,32.27936688917785
Task_29227,976,867,42,53,95,1.1244239631336406,23.927351344416092
Task_29228,1408,363,22,122,144,3.868131868131868,29.977904217803964
Task_29229,2908,539,174,83,257,5.385185185185185,54.88180587864425
Task_29230,2730,275,82,190,272,9.891304347826088,51.51377917455639
Task_29231,2752,830,160,118,278,3.3116726835138386,53.55267754078009
Task_29232,2969,903,64,162,226,3.28429203539823,57.12023593020941
Task_29233,1885,669,66,45,111,2.8134328358208953,37.58679754762774
Task_29234,2391,811,99,79,178,2.9445812807881775,47.144641476078334
Task_29235,2642,725,30,68,98,3.6391184573002753,49.98966937617147
Task_29236,981,529,56,73,129,1.850943396226415,23.70161765657555
Task_29237,1877,524,134,167,301,3.5752380952380953,38.903010986430836
Task_29238,2295,519,74,115,189,4.413461538461538,44.98153552529924
Task_29239,690,929,54,143,197,0.7419354838709677,20.855712796034883
Task_29240,2946,804,21,59,80,3.6596273291925465,54.67642873976211
Task_29241,504,85,168,114,282,5.8604651162790695,15.190139872043801
Task_29242,2824,670,66,47,113,4.208643815201192,52.57206806526546
Task_29243,1821,157,67,150,217,11.525316455696203,36.25708940805261
Task_29244,642,804,102,44,146,0.7975155279503106,18.797690390231207
Task_29245,1351,953,10,73,83,1.4161425576519917,30.104780884116792
Task_29246,2392,587,78,143,221,4.068027210884353,46.929528647911695
Task_29247,802,467,125,136,261,1.7136752136752136,21.465388818768247
Task_29248,1333,621,152,88,240,2.143086816720257,30.144665260618726
Task_29249,1585,133,190,140,330,11.828358208955224,32.78093603425112
Task_29250,2677,952,128,143,271,2.809024134312697,52.751184471840304
Task_29251,1378,377,166,188,354,3.6455026455026456,30.80395101183758
Task_29252,1269,371,97,153,250,3.411290322580645,28.547796116040733
Task_29253,972,618,76,93,169,1.5702746365105007,24.12863237521418
Task_29254,1641,665,58,171,229,2.463963963963964,35.361700489917325
Task_29255,597,152,43,141,184,3.9019607843137254,16.598484075854664
Task_29256,1528,421,51,192,243,3.6208530805687205,32.92282824677303
Task_29257,1467,824,32,100,132,1.778181818181818,32.335917592133086
Task_29258,2559,611,55,28,83,4.181372549019608,47.77736235064676
Task_29259,625,818,46,53,99,0.7631257631257631,18.176973678382495
Task_29260,2611,87,167,109,276,29.670454545454547,48.20990227324287
Task_29261,2762,720,10,16,26,3.8307905686546464,50.614409586530066
Task_29262,1046,490,197,44,241,2.130346232179226,24.669428461195412
Task_29263,1583,404,160,158,318,3.908641975308642,33.928481667792774
Task_29264,2824,740,169,74,243,3.8110661268556005,54.009524226482604
Task_29265,2976,405,32,189,221,7.330049261083744,55.58025624527287
Task_29266,795,781,64,147,211,1.0166240409207161,22.094193498993473
Task_29267,2677,699,65,79,144,3.8242857142857143,51.185113294392806
Task_29268,1856,511,29,188,217,3.625,38.18378110337123
Task_29269,2374,825,120,105,225,2.87409200968523,47.29013074338477
Task_29270,2481,545,122,32,154,4.543956043956044,47.03416931263507
Task_29271,2688,116,56,123,179,22.974358974358974,49.24110968620133
Task_29272,2087,500,54,170,224,4.16566866267465,41.87846260492298
Task_29273,1801,965,74,10,84,1.8643892339544514,36.91310451098358
Task_29274,1588,760,180,116,296,2.0867279894875166,34.97061185809693
Task_29275,2060,98,102,135,237,20.80808080808081,39.46812379324445
Task_29276,1531,134,185,100,285,11.34074074074074,31.673645145027987
Task_29277,1216,668,46,14,60,1.8176382660687593,26.198695340029147
Task_29278,2109,194,124,102,226,10.815384615384616,41.01048040222759
Task_29279,2681,128,74,162,236,20.782945736434108,49.702152592612016
Task_29280,984,554,175,52,227,1.772972972972973,24.086323105980583
Task_29281,2504,818,200,126,326,3.057387057387057,49.81387481237878
Task_29282,1841,839,167,100,267,2.191666666666667,39.07104096820684
Task_29283,2575,1024,36,191,227,2.5121951219512195,51.24592850645533
Task_29284,1713,912,46,146,192,1.8762322015334063,37.03322882725255
Task_29285,1960,243,109,153,262,8.032786885245901,39.088943970082134
Task_29286,1258,338,154,137,291,3.7109144542772863,28.420740526941255
Task_29287,1603,671,147,41,188,2.3854166666666665,33.80831633263963
Task_29288,1309,377,139,151,290,3.462962962962963,29.36960321759058
Task_29289,1638,218,141,95,236,7.47945205479452,33.72423087831793
Task_29290,1684,568,75,13,88,2.959578207381371,33.824029204528316
Task_29291,2913,415,99,159,258,7.002403846153846,54.74381994182746
Task_29292,1547,442,26,150,176,3.492099322799097,32.79260145786544
Task_29293,2417,886,43,58,101,2.7249154453213076,46.811698772285276
Task_29294,2226,602,134,96,230,3.691542288557214,44.28139894372058
Task_29295,1194,423,87,146,233,2.8160377358490565,27.393076934873335
Task_29296,832,815,112,67,179,1.0196078431372548,22.24255596848945
Task_29297,516,465,151,73,224,1.1072961373390557,16.419652425960503
Task_29298,1197,729,20,108,128,1.6397260273972603,27.864227031562915
Task_29299,2523,381,142,197,339,6.604712041884817,48.87812266903353
Task_29300,2601,901,41,10,51,2.8835920177383594,48.87301779519774
Task_29301,2802,207,95,105,200,13.471153846153847,51.9095558834777
Task_29302,1526,522,47,131,178,2.9177820267686423,32.74659173974769
Task_29303,1825,584,53,190,243,3.1196581196581197,38.1141972609656
Task_29304,2255,364,44,116,160,6.178082191780822,43.48649883292084
Task_29305,2593,275,21,89,110,9.394927536231885,48.10813707504533
Task_29306,815,97,129,91,220,8.316326530612244,19.644926945323657
Task_29307,2740,649,133,51,184,4.2153846153846155,51.93450642188561
Task_29308,1513,495,146,137,283,3.0504032258064515,32.92293343729267
Task_29309,1368,361,179,77,256,3.7790055248618786,29.82342151229669
Task_29310,590,592,168,194,362,0.9949409780775716,19.025211213010625
Task_29311,941,958,199,137,336,0.9812304483837331,25.518128841830954
Task_29312,2710,532,96,13,109,5.084427767354597,50.15816538292224
Task_29313,2993,926,40,96,136,3.228694714131607,56.872900941326215
Task_29314,2923,931,125,92,217,3.1362660944206007,56.213751366016545
Task_29315,659,523,162,88,250,1.2576335877862594,19.15369985141051
Task_29316,1979,568,135,105,240,3.4780316344463973,40.292046530045134
Task_29317,944,923,113,146,259,1.0216450216450217,25.08259365905865
Task_29318,1391,751,179,173,352,1.8497340425531914,32.157650127926324
Task_29319,2997,940,126,26,152,3.1849096705632305,56.4086666599199
Task_29320,1332,740,99,185,284,1.7975708502024292,30.90153769355506
Task_29321,2640,702,57,98,155,3.755334281650071,50.675874784679515
Task_29322,2152,178,169,146,315,12.022346368715084,41.85629647657177
Task_29323,766,547,181,93,274,1.397810218978102,21.08402281536463
Task_29324,1039,826,134,167,301,1.256348246674728,26.510856356006503
Task_29325,1310,667,119,81,200,1.9610778443113772,29.68860844246963
Task_29326,2022,538,96,48,144,3.75139146567718,39.76768536113422
Task_29327,913,260,171,102,273,3.4980842911877397,22.57911754441028
Task_29328,2394,809,140,143,283,2.9555555555555557,47.87401065774557
Task_29329,2049,726,182,192,374,2.8184319119669876,42.6302242850327
Task_29330,1866,129,66,64,130,14.353846153846154,35.7567064798261
Task_29331,1827,769,42,83,125,2.3727272727272726,37.81810719755249
Task_29332,2183,488,86,53,139,4.4642126789366054,42.32625674056747
Task_29333,2488,456,35,175,210,5.444201312910285,47.972398189514955
Task_29334,2209,645,184,138,322,3.4195046439628483,44.59616813377917
Task_29335,1519,248,97,77,174,6.100401606425703,31.453700626369876
Task_29336,1515,935,152,40,192,1.6185897435897436,33.28406955627999
Task_29337,2220,800,127,120,247,2.7715355805243447,44.893136623461636
Task_29338,1829,476,147,21,168,3.8343815513626835,36.56470768163072
Task_29339,1527,152,66,192,258,9.980392156862745,31.849472046629213
Task_29340,2783,973,141,140,281,2.8572895277207393,54.537135491823506
Task_29341,1395,132,141,14,155,10.488721804511279,28.024234385011052
Task_29342,1277,154,52,88,140,8.238709677419354,26.83744074732046
Task_29343,2506,213,117,24,141,11.710280373831775,46.17543249160488
Task_29344,2433,502,116,75,191,4.836978131212724,46.82608147709727
Task_29345,2671,807,142,200,342,3.3056930693069306,52.605808107012386
Task_29346,2073,897,144,146,290,2.3084632516703785,43.098834235383265
Task_29347,1360,368,87,180,267,3.6856368563685638,30.046537659646862
Task_29348,827,624,16,133,149,1.3232,21.60954252366245
Task_29349,1877,315,171,111,282,5.939873417721519,38.055290674089925
Task_29350,1032,565,66,129,195,1.823321554770318,25.196607952292
Task_29351,887,696,47,151,198,1.272596843615495,23.244644882257784
Task_29352,1835,570,174,132,306,3.213660245183888,38.35516625699544
Task_29353,1608,921,75,111,186,1.7440347071583515,35.30333020257746
Task_29354,2955,954,160,175,335,3.094240837696335,57.498056447421106
Task_29355,1779,343,177,197,374,5.171511627906977,37.13966604899474
Task_29356,982,677,38,122,160,1.448377581120944,24.27426285887911
Task_29357,623,437,42,157,199,1.4223744292237444,18.270186972211373
Task_29358,1125,651,134,51,185,1.7254601226993864,26.361242703338416
Task_29359,2961,610,137,144,281,4.846153846153846,56.218876429375314
Task_29360,2268,80,46,78,124,28.0,41.52898217068164
Task_29361,711,130,102,99,201,5.427480916030534,18.371815990229944
Task_29362,1404,321,54,197,251,4.3602484472049685,30.651893025490015
Task_29363,2597,146,186,105,291,17.666666666666668,48.60321688608314
Task_29364,2471,81,127,52,179,30.134146341463413,44.94532272125294
Task_29365,1460,832,66,83,149,1.7527010804321728,32.403179872248245
Task_29366,1810,451,40,161,201,4.004424778761062,37.159315776603904
Task_29367,770,241,85,32,117,3.1818181818181817,18.64227484002556
Task_29368,599,1016,118,69,187,0.5889872173058014,19.440987367336742
Task_29369,2050,720,146,113,259,2.8432732316227463,41.99312469080595
Task_29370,867,335,10,53,63,2.580357142857143,20.015234141157904
Task_29371,1139,265,87,49,136,4.2819548872180455,24.90030408380495
Task_29372,1254,266,75,197,272,4.696629213483146,28.187462339159243
Task_29373,521,432,58,169,227,1.2032332563510393,16.819279597966176
Task_29374,1676,900,141,20,161,1.86015538290788,35.39829225396678
Task_29375,2586,692,189,11,200,3.7316017316017316,49.408096810963066
Task_29376,2071,510,28,19,47,4.052837573385519,39.17951686139892
Task_29377,2139,919,73,14,87,2.325,42.11468501034319
Task_29378,2428,792,114,123,237,3.0617906683480456,48.12274688532037
Task_29379,659,466,55,125,180,1.411134903640257,18.825174309993248
Task_29380,1546,954,120,87,207,1.618848167539267,34.3940008029399
Task_29381,2298,635,193,72,265,3.6132075471698113,45.3999284708572
Task_29382,2822,94,170,41,211,29.705263157894738,50.45596096260317
Task_29383,2359,600,141,29,170,3.925124792013311,45.436504157021425
Task_29384,2376,1022,132,190,322,2.3225806451612905,48.49818681727
Task_29385,608,394,111,136,247,1.539240506329114,18.073857405847832
Task_29386,2145,267,103,161,264,8.003731343283581,42.1185660366588
Task_29387,1494,287,137,143,280,5.1875,31.943477153403908
Task_29388,1629,806,189,149,338,2.0185873605947955,36.00119975555616
Task_29389,1570,949,61,136,197,1.6526315789473685,34.90998906336335
Task_29390,944,738,99,100,199,1.277401894451962,24.17997008428016
Task_29391,719,667,106,193,299,1.0763473053892216,20.974503484297845
Task_29392,2855,797,27,115,142,3.5776942355889725,54.25631465109122
Task_29393,1018,432,161,144,305,2.351039260969977,24.997536775846196
Task_29394,2051,329,133,46,179,6.215151515151515,39.7761855367468
Task_29395,2484,872,77,105,182,2.845360824742268,49.01538325269846
Task_29396,1502,251,96,121,217,5.9603174603174605,31.63899478772989
Task_29397,1215,594,85,150,235,2.042016806722689,28.324911417620203
Task_29398,2895,401,178,193,371,7.201492537313433,54.96954912779677
Task_29399,2443,224,109,179,288,10.857777777777779,46.80304861301397
Task_29400,1212,749,55,121,176,1.616,28.476648584448114
Task_29401,1287,670,162,193,355,1.9180327868852458,30.300575537604004
Task_29402,2367,877,17,176,193,2.6958997722095672,47.25987952818136
Task_29403,2639,908,104,55,159,2.903190319031903,50.95032817570125
Task_29404,2338,246,191,132,323,9.465587044534413,45.315886591439416
Task_29405,891,946,190,87,277,0.9408658922914467,24.31251190714053
Task_29406,1668,525,36,69,105,3.171102661596958,34.057477201152345
Task_29407,2942,445,152,134,286,6.596412556053812,55.390356535228854
Task_29408,2826,309,94,13,107,9.116129032258064,51.27804153043531
Task_29409,1265,455,173,97,270,2.7741228070175437,28.781458689441255
Task_29410,2396,460,84,49,133,5.197396963123644,45.45312927606475
Task_29411,576,211,57,136,193,2.7169811320754715,16.850688711016673
Task_29412,2743,443,85,66,151,6.177927927927928,51.12948051791795
Task_29413,1610,656,165,173,338,2.450532724505327,35.26687284279334
Task_29414,1328,224,173,17,190,5.902222222222222,27.93090526733438
Task_29415,1255,228,172,106,278,5.4803493449781655,27.902960838416984
Task_29416,2616,739,159,57,216,3.535135135135135,50.430657202772956
Task_29417,2414,435,62,109,171,5.536697247706422,46.45468697489263
Task_29418,2615,949,57,41,98,2.7526315789473683,49.790256714984345
Task_29419,1685,137,112,13,125,12.210144927536232,32.49010574740463
Task_29420,1862,540,122,190,312,3.4417744916820703,38.799671061557746
Task_29421,1171,629,165,122,287,1.8587301587301588,27.924775545512006
Task_29422,1885,89,164,26,190,20.944444444444443,35.69063919109211
Task_29423,2033,597,195,127,322,3.399665551839465,41.64088687817492
Task_29424,2480,402,181,42,223,6.153846153846154,47.006014532010035
Task_29425,2137,387,26,81,107,5.507731958762887,41.20597627934631
Task_29426,2948,743,66,144,210,3.9623655913978495,56.19302300602774
Task_29427,564,527,70,129,199,1.0681818181818181,17.57417423336606
Task_29428,1775,779,114,25,139,2.2756410256410255,36.4544773693218
Task_29429,503,718,11,37,48,0.6995827538247567,15.478559150804747
Task_29430,1602,535,53,42,95,2.9888059701492535,32.476435493416425
Task_29431,1549,1023,199,36,235,1.5126953125,34.26405297284245
Task_29432,1789,693,30,29,59,2.577809798270893,35.508509689574055
Task_29433,2732,387,13,114,127,7.041237113402062,50.94220718452947
Task_29434,2242,932,102,44,146,2.403001071811361,44.480861088521664
Task_29435,1205,323,124,19,143,3.7191358024691357,26.021126100491173
Task_29436,1717,714,48,29,77,2.4013986013986015,34.4964066832338
Task_29437,850,615,141,126,267,1.37987012987013,22.659155921657945
Task_29438,1755,984,40,64,104,1.781725888324873,36.80877443832195
Task_29439,2688,260,30,133,163,10.298850574712644,50.122824121496045
Task_29440,961,736,79,200,279,1.3039348710990502,25.00078517922942
Task_29441,2467,825,19,124,143,2.986682808716707,48.2131437445159
Task_29442,1426,368,137,198,335,3.86449864498645,31.4632619040518
Task_29443,2443,583,111,36,147,4.183219178082192,46.557393242243705
Task_29444,1627,810,42,17,59,2.0061652281134403,33.18561000839849
Task_29445,1857,529,139,165,304,3.5037735849056606,38.612847287782266
Task_29446,1323,851,88,189,277,1.5528169014084507,30.99015311155415
Task_29447,1452,533,33,161,194,2.7191011235955056,31.717760447597787
Task_29448,595,754,15,177,192,0.7880794701986755,18.776218055347005
Task_29449,1294,797,156,12,168,1.6215538847117794,29.07126078412533
Task_29450,2872,428,115,27,142,6.694638694638694,52.75743204512568
Task_29451,1135,866,76,12,88,1.309111880046136,26.06628991346121
Task_29452,2492,281,179,72,251,8.836879432624114,47.24325951520498
Task_29453,541,67,140,171,311,7.955882352941177,15.97758020947228
Task_29454,1629,770,164,130,294,2.11284046692607,35.662837173063785
Task_29455,2475,1011,190,118,308,2.4456521739130435,49.86419017452571
Task_29456,1167,345,24,120,144,3.3728323699421967,26.110230336624866
Task_29457,1175,255,37,170,207,4.58984375,26.52868701451136
Task_29458,928,289,53,77,130,3.2,22.107253078091826
Task_29459,620,582,121,131,252,1.0634648370497428,18.847823668119663
Task_29460,1022,485,98,130,228,2.102880658436214,24.864566714694472
Task_29461,1117,917,153,155,308,1.2167755991285403,28.042598775733452
Task_29462,915,132,121,24,145,6.879699248120301,20.50804983235265
Task_29463,1032,465,193,89,282,2.2145922746781115,25.096394904221654
Task_29464,797,104,71,118,189,7.59047619047619,19.53244566499492
Task_29465,1063,752,154,180,334,1.4116865869853918,26.83989185212665
Task_29466,1166,840,99,46,145,1.3864447086801426,27.145924636323358
Task_29467,1920,855,165,21,186,2.2429906542056073,39.308712798474446
Task_29468,1140,236,109,161,270,4.810126582278481,26.15846573811338
Task_29469,723,524,149,61,210,1.3771428571428572,19.723739415938375
Task_29470,1369,520,65,190,255,2.6276391554702494,30.743483627176744
Task_29471,1554,577,48,173,221,2.688581314878893,33.66437207836491
Task_29472,1089,864,140,60,200,1.2589595375722544,26.541797226096808
Task_29473,1492,164,75,142,217,9.042424242424243,31.087743183570762
Task_29474,804,261,63,37,100,3.068702290076336,19.01076055562793
Task_29475,2686,686,103,178,281,3.9097525473071326,52.15493076190027
Task_29476,2284,185,21,25,46,12.279569892473118,41.66297351224383
Task_29477,1020,82,171,114,285,12.289156626506024,23.27246712084701
Task_29478,1074,917,109,195,304,1.1699346405228759,27.40660833376774
Task_29479,2652,66,14,113,127,39.582089552238806,47.49723989889579
Task_29480,1024,196,19,116,135,5.197969543147208,23.328874372731246
Task_29481,1293,593,188,199,387,2.176767676767677,30.307891655639384
Task_29482,2828,118,176,154,330,23.764705882352942,52.24391129408025
Task_29483,1418,616,99,64,163,2.298217179902755,30.873207602488133
Task_29484,2022,519,163,157,320,3.8884615384615384,41.25377951984149
Task_29485,662,698,10,194,204,0.9470672389127325,19.686926391741796
Task_29486,924,945,124,172,296,0.9767441860465116,25.072455676381235
Task_29487,1133,311,50,29,79,3.6314102564102564,24.077445063153522
Task_29488,1428,681,147,36,183,2.093841642228739,31.030597554059597
Task_29489,1464,632,89,60,149,2.3127962085308056,31.460363224192893
Task_29490,1299,620,115,23,138,2.0917874396135265,28.40163826670799
Task_29491,1928,690,88,21,109,2.790159189580318,38.25425659367941
Task_29492,502,307,101,98,199,1.62987012987013,15.888186927595365
Task_29493,1159,938,177,180,357,1.2342917997870075,29.030637259514567
Task_29494,1457,796,84,84,168,1.8281053952321205,32.2843761684761
Task_29495,2543,498,134,139,273,5.096192384769539,49.19646629007273
Task_29496,2508,813,69,80,149,3.081081081081081,48.92680922879362
Task_29497,1135,489,170,181,351,2.316326530612245,27.290890689253374
Task_29498,2860,882,169,196,365,3.2389580973952437,55.93337923156719
Task_29499,548,903,144,74,218,0.6061946902654868,18.550067671717013
Task_29500,1691,773,36,134,170,2.1847545219638245,36.07145533014019
Task_29501,1100,710,61,83,144,1.5471167369901546,26.22586195267799
Task_29502,2145,374,99,51,150,5.72,41.37208701100982
Task_29503,682,430,177,171,348,1.5823665893271461,19.864259340794636
Task_29504,1940,122,56,11,67,15.772357723577235,35.575017589211505
Task_29505,692,984,183,84,267,0.7025380710659899,21.326485711261906
Task_29506,1925,370,37,50,87,5.188679245283019,37.17443033012618
Task_29507,1114,325,89,123,212,3.4171779141104293,25.70353847447772
Task_29508,1456,147,64,139,203,9.837837837837839,30.347537784933447
Task_29509,1278,919,186,149,335,1.3891304347826088,30.7234046286264
Task_29510,624,370,74,192,266,1.6819407008086253,18.509187144338995
Task_29511,1151,331,78,50,128,3.466867469879518,25.415583409753737
Task_29512,1052,231,117,173,290,4.5344827586206895,24.859236614772595
Task_29513,2013,446,173,51,224,4.503355704697986,39.974809194684404
Task_29514,2074,277,181,121,302,7.460431654676259,41.144250145587385
Task_29515,2685,739,61,175,236,3.6283783783783785,52.16640374534857
Task_29516,2438,921,187,187,374,2.644251626898048,49.39596512814476
Task_29517,674,166,98,195,293,4.0359281437125745,18.517745998406514
Task_29518,1857,247,143,71,214,7.487903225806452,36.8972736815092
Task_29519,1393,838,116,23,139,1.6603098927294397,30.5794990873918
Task_29520,1541,908,129,125,254,1.6952695269526952,34.49685912976079
Task_29521,830,380,14,170,184,2.1784776902887137,21.300330372500813
Task_29522,1112,799,119,197,316,1.39,27.705847586039766
Task_29523,2520,621,68,109,177,4.051446945337621,48.79706699609623
Task_29524,768,295,169,153,322,2.5945945945945947,20.696487869441757
Task_29525,834,626,91,74,165,1.3301435406698565,21.753553467989963
Task_29526,2251,137,81,112,193,16.31159420289855,42.67781935213217
Task_29527,2224,688,179,154,333,3.227866473149492,45.0424027238592
Task_29528,2774,328,113,177,290,8.43161094224924,52.41775258837348
Task_29529,1241,986,190,57,247,1.2573454913880446,29.546876628184894
Task_29530,2354,793,84,46,130,2.9647355163727958,45.71865043328619
Task_29531,1817,904,105,42,147,2.007734806629834,37.642255352360095
Task_29532,2078,194,87,109,196,10.656410256410256,40.35784324248495
Task_29533,1111,499,138,85,223,2.222,26.147770385950892
Task_29534,1192,396,153,182,335,3.0025188916876573,27.82760243687603
Task_29535,895,505,110,73,183,1.7687747035573123,22.352250398205314
Task_29536,2157,262,161,194,355,8.201520912547528,42.74894574601785
Task_29537,2322,786,22,10,32,2.9504447268106735,43.912756869851194
Task_29538,2077,441,160,34,194,4.699095022624435,40.61667059403877
Task_29539,1693,388,39,138,177,4.352185089974293,34.93646556287448
Task_29540,1830,418,133,45,178,4.3675417661097855,36.548595017027004
Task_29541,2302,927,183,149,332,2.480603448275862,47.01465632006947
Task_29542,2559,365,42,189,231,6.991803278688525,48.91204869927653
Task_29543,637,505,174,140,314,1.2588932806324111,19.169073653261865
Task_29544,1061,951,106,53,159,1.1144957983193278,26.107406772388632
Task_29545,1889,627,21,11,32,3.0079617834394905,36.55574286575917
Task_29546,664,577,17,51,68,1.1487889273356402,17.574027560424927
Task_29547,1937,204,160,122,282,9.448780487804878,38.62656258659504
Task_29548,2487,944,154,69,223,2.6317460317460317,49.10631620702146
Task_29549,1148,667,108,162,270,1.718562874251497,27.647594727679586
Task_29550,1140,565,99,169,268,2.0141342756183747,27.21870742335615
Task_29551,1715,452,175,129,304,3.7858719646799117,36.06631138580625
Task_29552,1326,325,43,29,72,4.067484662576687,27.07073328630732
Task_29553,2389,273,149,54,203,8.718978102189782,45.26884533119047
Task_29554,2461,968,134,120,254,2.539731682146543,49.26793668091557
Task_29555,2487,650,86,53,139,3.8202764976958523,47.65689822754447
Task_29556,2460,721,98,103,201,3.407202216066482,48.21922954609323
Task_29557,728,895,158,113,271,0.8125,21.632721424419874
Task_29558,1521,462,82,119,201,3.285097192224622,32.590724808196576
Task_29559,1492,363,67,41,108,4.0989010989010985,30.35459643801302
Task_29560,2317,678,129,18,147,3.4123711340206184,44.782349941969436
Task_29561,1403,803,164,50,214,1.7450248756218905,31.26550460025632
Task_29562,1798,915,63,140,203,1.962882096069869,38.463583852394336
Task_29563,2698,99,89,29,118,26.98,47.9965302628886
Task_29564,1904,589,116,11,127,3.227118644067797,37.79656939370573
Task_29565,1718,114,199,191,390,14.939130434782609,35.04237290426131
Task_29566,1890,1002,162,167,329,1.884346959122632,40.7321044067965
Task_29567,987,269,19,158,177,3.6555555555555554,23.390529725793275
Task_29568,1060,369,99,17,116,2.864864864864865,23.537969231552108
Task_29569,1794,773,104,192,296,2.317829457364341,38.38609328284121
Task_29570,2718,517,150,17,167,5.2471042471042475,50.77875971509377
Task_29571,830,353,134,152,286,2.3446327683615817,21.698570130870944
Task_29572,2819,827,38,31,69,3.404589371980676,52.26757493939334
Task_29573,2038,219,132,60,192,9.263636363636364,39.45750950931704
Task_29574,2805,793,144,105,249,3.5327455919395465,54.1263711261995
Task_29575,2950,446,167,196,363,6.599552572706935,55.95821455076532
Task_29576,2934,501,15,30,45,5.844621513944223,52.93379342396269
Task_29577,1474,270,169,62,231,5.439114391143911,30.910496347069664
Task_29578,2399,572,32,119,151,4.18673647469459,46.369386287297424
Task_29579,1311,629,56,198,254,2.080952380952381,30.174335100452407
Task_29580,958,794,180,70,250,1.2050314465408805,24.53006151559671
Task_29581,2375,470,181,11,192,5.042462845010616,45.321610169615134
Task_29582,887,158,62,185,247,5.578616352201258,21.688975161157614
Task_29583,1421,67,22,153,175,20.897058823529413,28.991665654990726
Task_29584,2936,792,169,22,191,3.7023959646910467,55.246286859417886
Task_29585,2812,974,103,132,235,2.884102564102564,54.78075690725107
Task_29586,747,840,43,138,181,0.8882282996432818,21.321228938531217
Task_29587,2250,447,165,133,298,5.022321428571429,44.49687124209472
Task_29588,2076,86,29,153,182,23.862068965517242,39.41399230832291
Task_29589,2588,483,150,123,273,5.347107438016529,49.83675461908183
Task_29590,2467,321,41,152,193,7.661490683229814,47.07739446956691
Task_29591,2816,338,152,112,264,8.306784660766962,52.90424155760193
Task_29592,2512,606,46,193,239,4.13838550247117,49.011614025703444
Task_29593,1655,436,109,134,243,3.7871853546910756,34.7977158591106
Task_29594,1211,849,78,94,172,1.4247058823529413,28.66807308954179
Task_29595,693,590,24,187,211,1.1725888324873097,19.897095103524368
Task_29596,2467,191,96,139,235,12.848958333333334,46.76035808663632
Task_29597,1482,903,169,190,359,1.6393805309734513,34.11498374880312
Task_29598,2162,490,156,38,194,4.403258655804481,42.13728851028456
Task_29599,1003,915,87,84,171,1.0949781659388647,25.301229069486507
Task_29600,1951,163,171,147,318,11.896341463414634,38.69647784947516
Task_29601,988,846,110,74,184,1.166469893742621,24.91437742887162
Task_29602,2770,71,150,69,219,38.47222222222222,49.8550756170684
Task_29603,653,483,116,42,158,1.3491735537190082,17.914595275659845
Task_29604,1331,705,28,138,166,1.885269121813031,30.133362422326808
Task_29605,2478,607,67,155,222,4.0756578947368425,48.38475928187888
Task_29606,1401,317,90,38,128,4.40566037735849,29.23735321250118
Task_29607,1381,218,69,164,233,6.30593607305936,29.812565226106347
Task_29608,848,618,13,87,100,1.369951534733441,21.36292716675186
Task_29609,1727,106,92,175,267,16.14018691588785,34.5459688979516
Task_29610,599,1016,102,166,268,0.5889872173058014,20.13491634530542
Task_29611,1367,366,35,67,102,3.7247956403269753,28.72747796523775
Task_29612,2468,118,122,30,152,20.73949579831933,44.875516417758206
Task_29613,2638,120,146,77,223,21.801652892561982,48.440685451638046
Task_29614,1897,364,124,140,264,5.197260273972603,38.4963183318801
Task_29615,1469,197,184,199,383,7.41919191919192,31.820361215629173
Task_29616,1630,953,43,95,138,1.7085953878406708,35.35602386874246
Task_29617,620,490,124,180,304,1.2627291242362526,18.866779902612546
Task_29618,2969,859,171,84,255,3.452325581395349,56.853768991670535
Task_29619,841,635,36,21,57,1.3223270440251573,20.337622830374297
Task_29620,2767,978,95,52,147,2.82635342185904,53.23930940889095
Task_29621,2599,823,189,15,204,3.154126213592233,50.036249157535785
Task_29622,1539,102,179,90,269,14.941747572815533,31.350902467344408
Task_29623,501,93,80,31,111,5.329787234042553,13.267816804824497
Task_29624,1156,730,14,138,152,1.5813953488372092,27.129193221269194
Task_29625,2818,466,193,126,319,6.034261241970022,53.63381370908661
Task_29626,1791,83,113,13,126,21.321428571428573,33.49853067196879
Task_29627,2113,797,120,172,292,2.6478696741854635,43.46758547499905
Task_29628,2521,941,199,49,248,2.6762208067940554,49.58235088274358
Task_29629,2358,707,53,192,245,3.330508474576271,46.95595939424583
Task_29630,2754,259,14,29,43,10.592307692307692,49.254351302497746
Task_29631,511,730,163,184,347,0.6990424076607387,18.209330864029038
Task_29632,2875,784,190,19,209,3.662420382165605,54.32971774207872
Task_29633,1513,203,187,173,360,7.416666666666667,32.35597846003437
Task_29634,1880,445,37,184,221,4.2152466367713,38.385793218706304
Task_29635,2295,990,77,139,216,2.315842583249243,46.629427852778406
Task_29636,2568,687,199,104,303,3.7325581395348837,50.27966788884758
Task_29637,2949,226,64,128,192,12.991189427312776,54.36500040826618
Task_29638,787,789,36,169,205,0.9962025316455696,21.94540535772713
Task_29639,1445,641,121,21,142,2.250778816199377,30.8076866044637
Task_29640,2049,905,153,148,301,2.26158940397351,42.79597870608103
Task_29641,2277,177,147,125,272,12.792134831460674,43.59935986428004
Task_29642,1399,804,175,10,185,1.737888198757764,30.861362421135993
Task_29643,1859,437,51,148,199,4.244292237442922,37.9499865704619
Task_29644,734,132,23,36,59,5.518796992481203,16.804259269267302
Task_29645,1503,535,198,55,253,2.8041044776119404,32.33084999485671
Task_29646,1938,837,11,160,171,2.3126491646778042,40.16266809808527
Task_29647,2744,964,190,132,322,2.8435233160621762,54.06408775992844
Task_29648,1562,701,119,135,254,2.225071225071225,34.213106323951955
Task_29649,1962,159,44,13,57,12.2625,36.3699082597763
Task_29650,1007,688,17,112,129,1.4615384615384615,24.57328889370763
Task_29651,1685,880,31,42,73,1.9125993189557322,34.50161860656616
Task_29652,2599,608,131,167,298,4.267651888341543,50.58984604668215
Task_29653,2176,398,45,108,153,5.453634085213032,42.28066574259818
Task_29654,1731,943,162,66,228,1.833686440677966,37.14832064331258
Task_29655,1468,668,45,88,133,2.194319880418535,31.917408094281893
Task_29656,764,541,14,19,33,1.4095940959409594,18.471797320276078
Task_29657,2285,973,31,130,161,2.345995893223819,45.929827161462015
Task_29658,1676,535,168,125,293,3.126865671641791,35.65785867686518
Task_29659,2849,533,17,32,49,5.335205992509363,51.731395892021844
Task_29660,1569,362,10,18,28,4.322314049586777,30.60450693012748
Task_29661,2965,436,124,175,299,6.784897025171625,55.843247497981885
Task_29662,524,629,169,21,190,0.8317460317460318,16.60235870918746
Task_29663,1900,553,54,178,232,3.4296028880866425,39.13449490897766
Task_29664,2408,609,84,74,158,3.9475409836065576,46.5181434287859
Task_29665,3000,444,85,121,206,6.741573033707865,55.93143652986214
Task_29666,1222,300,21,38,59,4.059800664451827,25.297824102060986
Task_29667,1667,439,195,155,350,3.7886363636363636,35.51031258496166
Task_29668,795,563,135,168,303,1.4095744680851063,21.85013536305766
Task_29669,893,269,196,111,307,3.3074074074074074,22.458976476540084
Task_29670,1575,190,85,58,143,8.24607329842932,31.82577832102571
Task_29671,1662,846,81,50,131,1.962219598583235,35.05453864538992
Task_29672,2639,1004,64,19,83,2.625870646766169,50.1870086069759
Task_29673,2224,435,35,140,175,5.10091743119266,43.49422954894484
Task_29674,2019,700,80,74,154,2.8801711840228243,40.618642368466304
Task_29675,2519,384,163,70,233,6.542857142857143,47.88322594378368
Task_29676,1866,401,33,154,187,4.641791044776119,37.793382277418026
Task_29677,592,925,149,108,257,0.6393088552915767,19.604901461494585
Task_29678,1525,703,140,196,336,2.1661931818181817,34.09226090120387
Task_29679,1822,618,37,143,180,2.9434571890145396,37.75077087754921
Task_29680,1555,632,76,134,210,2.456556082148499,33.7533838177822
Task_29681,1387,713,73,65,138,1.942577030812325,30.56827402603268
Task_29682,2394,421,62,57,119,5.672985781990521,45.10354410725673
Task_29683,885,919,15,112,127,0.9619565217391305,23.371524172184575
Task_29684,2852,938,146,123,269,3.03727369542066,55.44218776464572
Task_29685,1234,834,107,173,280,1.4778443113772455,29.54996497395085
Task_29686,849,452,167,55,222,1.8741721854304636,21.576258241966084
Task_29687,1032,620,52,119,171,1.6618357487922706,25.168454280061884
Task_29688,1839,307,130,89,219,5.970779220779221,37.068648959802495
Task_29689,2301,438,52,79,131,5.241457858769932,44.396370857656166
Task_29690,1733,937,15,134,149,1.847547974413646,36.98868453139807
Task_29691,1667,217,139,133,272,7.646788990825688,34.38302047978714
Task_29692,645,724,133,37,170,0.8896551724137931,18.755843529977348
Task_29693,1875,76,170,59,229,24.350649350649352,35.86447625079566
Task_29694,1717,237,131,165,296,7.214285714285714,35.39955569000351
Task_29695,1144,852,91,131,222,1.3411488862837047,27.85512630496872
Task_29696,2940,421,50,141,191,6.966824644549763,54.9592535975456
Task_29697,1367,995,116,138,254,1.3724899598393574,31.994999966858927
Task_29698,1767,668,162,49,211,2.6412556053811658,36.61601628572314
Task_29699,2757,673,159,137,296,4.0905044510385755,53.2458652631124
Task_29700,2626,540,25,81,106,4.853974121996303,49.42657258509706
Task_29701,2651,837,163,65,228,3.163484486873508,51.40962339289708
Task_29702,839,139,103,17,120,5.992857142857143,19.04317786971939
Task_29703,1843,581,182,89,271,3.1666666666666665,38.25328579361399
Task_29704,842,580,17,29,46,1.4492254733218588,20.06953737537919
Task_29705,909,382,10,161,171,2.373368146214099,22.44106309487833
Task_29706,1543,1017,195,147,342,1.5157170923379175,35.26621111616146
Task_29707,1342,574,25,12,37,2.333913043478261,27.755876203305647
Task_29708,2638,957,163,131,294,2.7536534446764094,52.23485705779738
Task_29709,1872,307,124,128,252,6.077922077922078,37.8389081039532
Task_29710,2207,950,107,139,246,2.3207150368033647,45.17867857306453
Task_29711,1776,350,10,43,53,5.05982905982906,34.2468406151631
Task_29712,885,109,183,52,235,8.045454545454545,20.624882813034738
Task_29713,2640,847,73,52,125,3.1132075471698113,50.61592607662416
Task_29714,1103,358,80,43,123,3.0724233983286906,24.349579379644634
Task_29715,2997,890,142,187,329,3.3636363636363638,57.953772013072864
Task_29716,1297,282,92,167,259,4.58303886925795,28.760843824738377
Task_29717,1479,507,186,123,309,2.911417322834646,32.51935380652974
Task_29718,2302,321,81,117,198,7.149068322981367,44.4798874505326
Task_29719,1196,518,27,108,135,2.304431599229287,27.054534398683263
Task_29720,1156,902,182,165,347,1.2801771871539314,28.807845105044095
Task_29721,749,174,62,98,160,4.28,18.694591321256905
Task_29722,1342,395,135,84,219,3.388888888888889,29.456781727239274
Task_29723,991,354,100,12,112,2.7915492957746477,22.39700143118105
Task_29724,585,701,146,32,178,0.8333333333333334,17.77255389355221
Task_29725,892,626,93,61,154,1.4226475279106858,22.364965683178156
Task_29726,2749,936,103,102,205,2.933831376734258,53.48456386811148
Task_29727,1097,664,45,94,139,1.649624060150376,26.030925556626148
Task_29728,1455,773,114,200,314,1.87984496124031,33.10836373337769
Task_29729,2122,78,188,164,352,26.860759493670887,40.89710043060891
Task_29730,2562,672,80,131,211,3.8068350668647843,49.81542182024011
Task_29731,888,744,51,48,99,1.1919463087248323,21.920638421228062
Task_29732,2797,802,90,167,257,3.4831880448318806,54.149213722581344
Task_29733,1734,521,97,143,240,3.32183908045977,36.32697896941415
Task_29734,2894,916,123,122,245,3.1559432933478737,55.9292607666564
Task_29735,1369,649,126,118,244,2.106153846153846,30.923550091715686
Task_29736,2807,320,143,78,221,8.744548286604362,52.33263436837462
Task_29737,1196,1004,46,77,123,1.190049751243781,28.396327358294286
Task_29738,1712,114,93,122,215,14.88695652173913,34.07993772188495
Task_29739,2865,663,87,174,261,4.3147590361445785,54.781519793698585
Task_29740,1273,206,78,60,138,6.14975845410628,27.02787194537608
Task_29741,928,877,150,119,269,1.0569476082004556,24.69994235964911
Task_29742,2331,888,82,25,107,2.622047244094488,45.26007547667464
Task_29743,2934,90,150,144,294,32.24175824175824,53.438170485433226
Task_29744,2562,607,98,151,249,4.213815789473684,49.76063546389207
Task_29745,1932,221,67,121,188,8.702702702702704,38.24711067134721
Task_29746,832,882,159,178,337,0.942242355605889,23.622119283216218
Task_29747,1812,277,76,163,239,6.517985611510792,36.84760800289753
Task_29748,2966,239,47,124,171,12.358333333333333,54.495761623470976
Task_29749,2177,162,113,71,184,13.355828220858896,41.23243572985354
Task_29750,879,119,148,164,312,7.325,21.53417663918321
Task_29751,1411,443,22,143,165,3.1779279279279278,30.57559706148803
Task_29752,2551,1009,108,185,293,2.5257425742574258,51.09295821449666
Task_29753,1921,293,60,145,205,6.534013605442177,38.44841164142555
Task_29754,1673,82,110,138,248,20.156626506024097,33.375407677382206
Task_29755,2666,743,32,184,216,3.5833333333333335,51.73141889704571
Task_29756,2822,640,173,57,230,4.402496099843994,53.44336310506045
Task_29757,832,1010,170,139,309,0.8229475766567754,23.829288999238916
Task_29758,984,999,162,83,245,0.984,25.76846595340473
Task_29759,2263,438,56,107,163,5.1548974943052395,44.03701389755599
Task_29760,2813,695,94,129,223,4.041666666666667,53.87216511752967
Task_29761,1129,702,103,115,218,1.6059743954480796,27.152350182534125
Task_29762,1518,121,42,115,157,12.442622950819672,30.397606434488996
Task_29763,1016,384,136,24,160,2.638961038961039,23.315211536896342
Task_29764,2466,1016,18,77,95,2.424778761061947,48.14818781244457
Task_29765,2114,314,111,56,167,6.711111111111111,40.89091405380915
Task_29766,2572,539,63,84,147,4.762962962962963,49.07461767617966
Task_29767,2467,414,77,163,240,5.944578313253012,47.67259335354567
Task_29768,872,799,145,168,313,1.09,23.837557078940026
Task_29769,2756,615,21,26,47,4.474025974025974,50.47779464009483
Task_29770,2697,947,74,28,102,2.8449367088607596,51.25720002275475
Task_29771,1448,249,174,189,363,5.792,31.528923436392216
Task_29772,725,728,78,188,266,0.9945130315500685,21.16289136742631
Task_29773,2751,653,92,75,167,4.206422018348624,52.23830741166958
Task_29774,2851,590,127,118,245,4.824027072758037,54.212443422099
Task_29775,1174,650,184,90,274,1.803379416282642,27.90058292811908
Task_29776,1614,307,185,72,257,5.240259740259741,33.47937629730094
Task_29777,1223,594,41,69,110,2.0554621848739494,27.31272294175771
Task_29778,776,360,158,102,260,2.149584487534626,20.67610075075905
Task_29779,1145,218,54,132,186,5.228310502283105,25.791406847258543
Task_29780,950,916,24,177,201,1.0359869138495092,24.883277620459026
Task_29781,952,842,129,87,216,1.129300118623962,24.607644090436015
Task_29782,1033,433,162,73,235,2.380184331797235,24.588666276487533
Task_29783,1876,378,37,58,95,4.949868073878628,36.60868977673325
Task_29784,2692,528,16,124,140,5.088846880907372,50.808067907305485
Task_29785,2309,720,41,139,180,3.20249653259362,45.76493778706114
Task_29786,1466,232,34,190,224,6.291845493562231,31.14131722461668
Task_29787,1260,758,159,194,353,1.6600790513833992,30.126005755932187
Task_29788,2652,466,171,194,365,5.6788008565310495,51.31319623993721
Task_29789,2304,279,80,21,101,8.228571428571428,42.797502412914135
Task_29790,520,814,92,179,271,0.6380368098159509,18.31214880156978
Task_29791,1085,179,181,182,363,6.027777777777778,25.30629039281888
Task_29792,526,346,181,26,207,1.515850144092219,15.801036047468635
Task_29793,2897,854,142,37,179,3.3883040935672515,54.85193566188257
Task_29794,1191,461,36,42,78,2.5779220779220777,25.490172910699055
Task_29795,1010,190,43,38,81,5.287958115183246,22.198998193752697
Task_29796,2474,101,118,188,306,24.254901960784313,46.427299841662965
Task_29797,1506,523,144,119,263,2.8740458015267176,32.78425533035798
Task_29798,1015,353,164,171,335,2.867231638418079,24.87365325662996
Task_29799,1001,692,128,148,276,1.4444444444444444,25.363077617954758
Task_29800,1856,596,29,138,167,3.1088777219430486,38.10798690211404
Task_29801,2844,583,13,122,135,4.86986301369863,53.36300338298302
Task_29802,1379,533,71,92,163,2.5823970037453186,30.30727715652991
Task_29803,2055,380,26,122,148,5.393700787401575,40.29680920834638
Task_29804,1965,83,108,183,291,23.392857142857142,38.21970398935342
Task_29805,2514,644,72,111,183,3.8976744186046512,48.77980175462969
Task_29806,585,453,108,90,198,1.2885462555066078,17.5600422714576
Task_29807,1201,857,139,157,296,1.3997668997668997,29.14707841012014
Task_29808,865,115,56,21,77,7.456896551724138,18.75986164708577
Task_29809,1510,68,67,29,96,21.884057971014492,28.420716433763985
Task_29810,1417,521,30,165,195,2.71455938697318,31.132985298720445
Task_29811,611,1006,63,65,128,0.6067527308838133,19.58144962434717
Task_29812,2168,386,148,73,221,5.602067183462532,42.33454140813567
Task_29813,2051,589,78,131,209,3.476271186440678,41.464115515245815
Task_29814,2660,760,29,108,137,3.495400788436268,51.015927651792715
Task_29815,1818,268,19,38,57,6.758364312267658,34.65134948909962
Task_29816,1862,449,81,162,243,4.137777777777778,38.21011799416649
Task_29817,1384,251,190,120,310,5.492063492063492,30.184557713147573
Task_29818,2815,503,132,180,312,5.5853174603174605,53.75469390397152
Task_29819,2331,852,131,107,238,2.7327080890973034,46.75481792823333
Task_29820,2532,468,85,20,105,5.398720682302772,47.06699403985518
Task_29821,1491,80,83,13,96,18.40740740740741,28.40263963208767
Task_29822,2973,150,115,78,193,19.688741721854306,53.89375565338086
Task_29823,725,421,137,181,318,1.7180094786729858,20.425285406461487
Task_29824,2550,95,28,90,118,26.5625,46.041054813204006
Task_29825,1349,503,190,46,236,2.6765873015873014,29.499117423763096
Task_29826,2057,752,50,21,71,2.731739707835325,39.8807028367911
Task_29827,2423,929,83,138,221,2.6053763440860216,48.45748668619768
Task_29828,1639,753,90,107,197,2.173740053050398,35.291665928353105
Task_29829,2137,624,152,106,258,3.4192,43.05410820271798
Task_29830,1444,424,78,76,154,3.3976470588235292,30.674732783082465
Task_29831,2247,936,165,195,360,2.398078975453575,46.36481125409498
Task_29832,2834,334,121,102,223,8.459701492537313,52.97561339812645
Task_29833,2089,378,102,36,138,5.511873350923483,40.1759744824039
Task_29834,2138,724,163,44,207,2.9489655172413793,42.54509817022602
Task_29835,1037,359,22,69,91,2.8805555555555555,23.36164667992077
Task_29836,2249,616,166,169,335,3.6450567260940034,45.2419749589129
Task_29837,1360,266,144,102,246,5.093632958801498,29.541417352126015
Task_29838,1508,694,66,184,250,2.1697841726618705,33.46707666425545
Task_29839,2327,444,140,194,334,5.229213483146068,45.957495194269484
Task_29840,1715,392,91,162,253,4.363867684478372,35.69054441720416
Task_29841,1104,627,127,169,296,1.7579617834394905,26.953440114146925
Task_29842,2800,569,21,152,173,4.912280701754386,53.01609055318604
Task_29843,1403,605,111,75,186,2.315181518151815,30.79327544279288
Task_29844,650,652,112,134,246,0.9954058192955589,19.5302380517692
Task_29845,2134,326,145,60,205,6.525993883792049,41.41110187104828
Task_29846,1876,518,133,188,321,3.6146435452793835,38.98900039437485
Task_29847,2754,997,178,105,283,2.7595190380761525,54.110172536087
Task_29848,2249,385,192,65,257,5.8264248704663215,43.73147112775161
Task_29849,2370,995,63,94,157,2.3795180722891565,47.34610484018459
Task_29850,1953,437,88,99,187,4.458904109589041,39.15415691642081
Task_29851,716,490,45,108,153,1.4582484725050917,19.411418481940625
Task_29852,2845,161,149,123,272,17.561728395061728,52.5406381715911
Task_29853,939,287,106,109,215,3.2604166666666665,22.827179721110095
Task_29854,744,917,170,14,184,0.8104575163398693,20.916340826701795
Task_29855,1846,528,100,30,130,3.489603024574669,36.811278755557
Task_29856,2055,608,80,170,250,3.374384236453202,41.81592291355668
Task_29857,623,596,184,181,365,1.0435510887772195,19.52137504639861
Task_29858,799,219,105,59,164,3.631818181818182,19.779562479523044
Task_29859,1282,87,140,109,249,14.568181818181818,27.244365726546196
Task_29860,2530,726,118,26,144,3.4800550206327374,48.32873468572822
Task_29861,1545,444,54,142,196,3.4719101123595504,32.952295642557004
Task_29862,2445,166,92,101,193,14.640718562874252,45.87123298931922
Task_29863,1671,953,143,187,330,1.751572327044025,37.129950345641895
Task_29864,1917,800,63,81,144,2.393258426966292,39.47642718074152
Task_29865,2764,893,177,97,274,3.0917225950783,53.91982200997191
Task_29866,2625,179,158,200,358,14.583333333333334,49.604107119428164
Task_29867,1912,213,67,162,229,8.934579439252337,38.16001856173818
Task_29868,910,850,118,186,304,1.0693301997649824,24.57995693022261
Task_29869,2176,454,15,116,131,4.782417582417582,42.40722789295389
Task_29870,1530,972,51,126,177,1.5724563206577595,34.22223848416143
Task_29871,1756,118,32,12,44,14.756302521008404,32.623529077132034
Task_29872,2429,611,116,61,177,3.968954248366013,46.85737899204315
Task_29873,1404,890,175,45,220,1.5757575757575757,31.483284804326445
Task_29874,2813,1013,142,183,325,2.774161735700197,55.39868937814138
Task_29875,2076,431,70,141,211,4.805555555555555,41.383010995555374
Task_29876,828,368,95,103,198,2.2439024390243905,21.25641034396774
Task_29877,1055,510,22,97,119,2.064579256360078,24.65464885270016
Task_29878,1812,569,91,74,165,3.1789473684210527,37.096274451896235
Task_29879,1796,340,169,165,334,5.266862170087976,37.17141420606619
Task_29880,1212,850,23,188,211,1.4242068155111633,28.95380869951063
Task_29881,537,108,31,171,202,4.926605504587156,15.526969050520103
Task_29882,2526,411,50,179,229,6.131067961165049,48.60144282813754
Task_29883,1309,292,156,160,316,4.467576791808874,29.222750993819005
Task_29884,2693,620,86,85,171,4.336553945249597,51.2471417909047
Task_29885,2825,187,11,42,53,15.02659574468085,50.35450414539906
Task_29886,2826,423,34,123,157,6.665094339622642,52.713613432913554
Task_29887,883,1002,44,163,207,0.8803589232303091,24.15501919762217
Task_29888,711,646,83,73,156,1.0989180834621328,19.654655086465116
Task_29889,835,82,140,197,337,10.060240963855422,20.7289845854994
Task_29890,1086,582,191,49,240,1.862778730703259,25.69194278217523
Task_29891,1367,903,44,71,115,1.5121681415929205,30.650101310803745
Task_29892,2250,79,176,93,269,28.125,42.382326223796134
Task_29893,846,925,158,76,234,0.9136069114470843,23.235614219499848
Task_29894,1253,675,185,25,210,1.8535502958579881,28.329778086004094
Task_29895,722,171,141,36,177,4.1976744186046515,17.999582752196595
Task_29896,1542,471,29,167,196,3.266949152542373,32.96005834722112
Task_29897,2075,984,31,138,169,2.1065989847715736,42.797142242625
Task_29898,2052,707,62,157,219,2.8983050847457625,41.93534338365097
Task_29899,1144,385,184,43,227,2.9637305699481864,25.83078949824436
Task_29900,2640,112,194,186,380,23.36283185840708,49.47166252526725
Task_29901,2878,362,164,53,217,7.928374655647383,53.417276594754746
Task_29902,2279,954,152,70,222,2.386387434554974,45.845021696357094
Task_29903,2861,394,45,81,126,7.243037974683545,53.03925691539008
Task_29904,1405,527,100,104,204,2.6609848484848486,30.90986620062812
Task_29905,2693,285,192,41,233,9.416083916083917,50.01720159107225
Task_29906,2978,820,91,176,267,3.6272838002436054,57.13673004418592
Task_29907,1830,181,121,28,149,10.054945054945055,35.322004462828154
Task_29908,801,1021,193,115,308,0.7837573385518591,23.362833546009952
Task_29909,2640,661,94,177,271,3.987915407854985,51.31088939152042
Task_29910,874,968,157,99,256,0.9019607843137255,24.072088125198345
Task_29911,2422,928,69,17,86,2.6071044133476855,46.641315535783264
Task_29912,2080,470,73,97,170,4.416135881104034,41.30746179568889
Task_29913,1476,1019,20,142,162,1.4470588235294117,33.23233555672223
Task_29914,1376,123,171,57,228,11.096774193548388,28.528698260317935
Task_29915,2344,340,198,18,216,6.873900293255132,44.51300519166583
Task_29916,676,890,70,123,193,0.7586980920314254,20.514890906796484
Task_29917,2246,578,62,151,213,3.8791018998272886,44.56471029337812
Task_29918,549,1021,147,182,329,0.5371819960861057,19.641327117937887
Task_29919,841,827,162,175,337,1.0157004830917875,23.54764235514358
Task_29920,1975,471,98,50,148,4.184322033898305,38.88254168511441
Task_29921,1373,461,116,137,253,2.9718614718614718,30.463605183344388
Task_29922,1854,67,146,103,249,27.264705882352942,36.12227207279576
Task_29923,2496,98,78,165,243,25.21212121212121,46.47114408377138
Task_29924,722,306,198,136,334,2.3517915309446256,20.033617464124244
Task_29925,519,340,29,138,167,1.5219941348973607,16.09873178561944
Task_29926,2032,869,35,48,83,2.335632183908046,40.38239946447265
Task_29927,2597,747,43,188,231,3.47192513368984,50.743602649744936
Task_29928,1743,892,21,195,216,1.9518477043673013,37.57437165161005
Task_29929,2939,739,110,61,171,3.9716216216216216,55.27799811386527
Task_29930,1962,201,72,185,257,9.712871287128714,39.049365715470756
Task_29931,1429,572,40,11,51,2.493891797556719,29.263291734914116
Task_29932,761,871,79,22,101,0.8727064220183486,20.386470173419678
Task_29933,2191,522,57,158,215,4.189292543021033,43.53375011472516
Task_29934,1879,993,182,164,346,1.8903420523138832,40.602063058581855
Task_29935,966,489,56,75,131,1.9714285714285715,23.34227673393436
Task_29936,2968,582,196,79,275,5.090909090909091,56.01541828703572
Task_29937,2403,878,101,123,224,2.733788395904437,47.93723723676205
Task_29938,1717,123,28,76,104,13.846774193548388,32.94511512260737
Task_29939,1291,731,23,157,180,1.7636612021857923,29.664413802456778
Task_29940,634,826,46,94,140,0.7666263603385731,19.220446556634695
Task_29941,2971,119,184,78,262,24.758333333333333,53.84028021571123
Task_29942,1048,200,62,150,212,5.213930348258707,24.371605987000905
Task_29943,2754,974,97,198,295,2.8246153846153845,54.236519713758014
Task_29944,2418,770,130,188,318,3.1361867704280155,48.35564409717648
Task_29945,1874,145,81,75,156,12.835616438356164,36.08158699148363
Task_29946,1824,929,16,148,164,1.961290322580645,38.61397171922096
Task_29947,1169,721,145,153,298,1.6191135734072022,28.26135691684725
Task_29948,667,1012,117,26,143,0.6584402764067128,19.99689909592149
Task_29949,502,946,128,156,284,0.5300950369588173,18.454169144513948
Task_29950,902,544,51,45,96,1.655045871559633,21.434891371159466
Task_29951,2065,203,95,140,235,10.122549019607844,40.46816705427391
Task_29952,1857,1022,119,127,246,1.81524926686217,39.83850702722096
Task_29953,1669,882,138,196,334,1.8901472253680633,36.92233478442168
Task_29954,589,645,177,188,365,0.9117647058823529,19.182558497147287
Task_29955,1295,810,41,193,234,1.596794081381011,30.317063623365886
Task_29956,1468,1011,49,114,163,1.4505928853754941,33.233863088711146
Task_29957,1195,823,139,95,234,1.450242718446602,28.589735769695665
Task_29958,1650,248,187,45,232,6.626506024096385,33.389144212176014
Task_29959,541,850,100,172,272,0.63572267920094,18.72672253482109
Task_29960,938,576,56,120,176,1.6256499133448874,23.59658115894489
Task_29961,2269,210,181,42,223,10.753554502369669,42.996065972619895
Task_29962,2028,899,191,32,223,2.2533333333333334,41.421271617632634
Task_29963,2475,534,155,70,225,4.626168224299065,47.640699866795025
Task_29964,521,871,151,57,208,0.5974770642201835,17.820911331421737
Task_29965,2934,354,114,135,249,8.264788732394367,54.792026497174355
Task_29966,735,730,67,125,192,1.0054719562243501,20.861282969273205
Task_29967,1631,413,107,39,146,3.9396135265700485,33.18595591246864
Task_29968,647,396,199,31,230,1.6297229219143576,18.004253895172223
Task_29969,913,441,142,182,324,2.065610859728507,23.505456939641892
Task_29970,2650,261,84,16,100,10.114503816793894,48.181332218555724
Task_29971,787,730,175,149,324,1.076607387140903,22.295097344337652
Task_29972,622,852,113,22,135,0.7291910902696366,18.600861591202307
Task_29973,1164,356,112,60,172,3.2605042016806722,25.991071650101144
Task_29974,1165,607,146,97,243,1.9161184210526316,27.554465440704746
Task_29975,1345,529,200,124,324,2.5377358490566038,30.53635720230318
Task_29976,2317,236,17,52,69,9.776371308016877,42.614604031670446
Task_29977,2810,948,129,105,234,2.9610115911485773,54.623772868450125
Task_29978,1955,702,138,151,289,2.7809388335704126,40.62270109171312
Task_29979,2545,473,94,113,207,5.3691983122362865,48.82172707506731
Task_29980,2602,568,151,80,231,4.572934973637961,49.980681682733206
Task_29981,874,441,69,123,192,1.9773755656108598,22.27922103081654
Task_29982,2281,769,93,168,261,2.9623376623376623,45.93435187727886
Task_29983,523,182,54,98,152,2.8579234972677594,15.390102339523404
Task_29984,2221,703,81,14,95,3.1548295454545454,42.803960462562095
Task_29985,1983,240,175,12,187,8.228215767634854,38.31136851232689
Task_29986,1608,817,118,48,166,1.9657701711491442,34.305576645989476
Task_29987,1994,483,111,29,140,4.119834710743802,39.050431014671354
Task_29988,2384,642,98,120,218,3.707620528771384,46.867510064552135
Task_29989,1925,528,189,143,332,3.6389413988657844,39.78026031309492
Task_29990,2969,1018,47,128,175,2.9136408243375858,57.14413345789942
Task_29991,1112,439,191,117,308,2.5272727272727273,26.4813326282576
Task_29992,1714,595,125,200,325,2.8758389261744965,36.70329085737605
Task_29993,1749,169,162,163,325,10.288235294117648,35.58084939508735
Task_29994,812,988,174,66,240,0.8210313447927199,22.82163129200293
Task_29995,1776,110,25,81,106,16.0,33.79927541430176
Task_29996,2364,487,128,34,162,4.844262295081967,45.100087307787966
Task_29997,2792,90,27,125,152,30.681318681318682,50.090387588365076
Task_29998,2312,515,148,55,203,4.48062015503876,44.85057478412916
Task_29999,1432,502,108,183,291,2.8469184890656063,31.76626855715142
Task_30000,2951,516,57,176,233,5.707930367504836,55.6546075537822
Task_30001,2317,156,62,147,209,14.757961783439491,43.993364732128335
Task_30002,2858,721,34,159,193,3.958448753462604,54.57775960067112
Task_30003,1138,80,100,139,239,14.049382716049383,24.939731795237478
Task_30004,2087,96,92,144,236,21.515463917525775,39.896979176761654
Task_30005,2658,819,43,19,62,3.2414634146341466,49.558265298195046
Task_30006,2685,316,172,111,283,8.470031545741325,50.84015696842346
Task_30007,2955,852,35,22,57,3.4642438452520516,54.46077338321578
Task_30008,2672,707,82,13,95,3.774011299435028,49.97308729301243
Task_30009,522,167,153,145,298,3.107142857142857,16.074078975765982
Task_30010,2891,330,181,99,280,8.734138972809667,54.10970465683513
Task_30011,1905,637,32,69,101,2.9858934169278997,38.0947947791482
Task_30012,749,802,122,147,269,0.9327521793275217,21.710525178540262
Task_30013,1903,773,63,200,263,2.458656330749354,40.04303556231337
Task_30014,2786,896,77,158,235,3.1059085841694536,54.23000540917704
Task_30015,1089,332,49,87,136,3.27027027027027,24.893336447774615
Task_30016,1546,386,184,52,236,3.994832041343669,32.50011390035431
Task_30017,1692,497,136,185,321,3.397590361445783,36.00468589998153
Task_30018,1838,183,157,73,230,9.98913043478261,36.44352406947508
Task_30019,2197,280,99,191,290,7.818505338078292,43.14917718675599
Task_30020,1530,745,124,24,148,2.0509383378016084,32.55043505650407
Task_30021,974,372,54,170,224,2.611260053619303,23.854015032595694
Task_30022,622,598,54,197,251,1.0383973288814692,19.04454535045834
Task_30023,2469,956,67,200,267,2.579937304075235,49.60765349210242
Task_30024,1594,398,48,141,189,3.9949874686716793,33.5335917025443
Task_30025,1121,201,158,66,224,5.5495049504950495,25.113525742784905
Task_30026,1566,943,152,117,269,1.6588983050847457,35.05752006816994
Task_30027,2909,775,117,132,249,3.7487113402061856,55.75692061818754
Task_30028,2713,785,159,23,182,3.4516539440203564,51.6520304834253
Task_30029,2611,419,136,70,206,6.216666666666667,49.333686090854826
Task_30030,1419,436,108,29,137,3.2471395881006866,29.76314281061642
Task_30031,1236,200,150,161,311,6.149253731343284,27.73428204165549
Task_30032,1659,159,31,82,113,10.36875,32.564783108162935
Task_30033,2713,457,19,191,210,5.923580786026201,51.5314187197473
Task_30034,1184,508,130,165,295,2.326129666011788,27.850595310909313
Task_30035,1932,109,119,84,203,17.563636363636363,37.19677976756152
Task_30036,644,648,88,111,199,0.9922958397534669,19.111624892929715
Task_30037,2482,64,91,170,261,38.184615384615384,46.08083756095547
Task_30038,2984,961,37,128,165,3.101871101871102,57.14218768480759
Task_30039,1837,634,127,169,296,2.8929133858267715,38.59793713692049
Task_30040,965,466,44,103,147,2.0663811563169165,23.3341312076828
Task_30041,2203,275,124,161,285,7.981884057971015,43.15820267386647
Task_30042,2074,175,111,147,258,11.784090909090908,40.37876058298056
Task_30043,1151,428,86,114,200,2.682983682983683,26.532807817779524
Task_30044,2011,225,153,39,192,8.898230088495575,38.83520954369899
Task_30045,677,877,162,98,260,0.7710706150341685,20.719449590005194
Task_30046,1003,468,111,101,212,2.138592750533049,24.39146483430741
Task_30047,826,190,141,185,326,4.324607329842932,21.33056616258942
Task_30048,728,776,132,39,171,0.9369369369369369,20.271872870156653
Task_30049,2557,712,138,135,273,3.5862552594670407,50.09459755693708
Task_30050,1598,715,127,123,250,2.2318435754189943,34.79149651831522
Task_30051,1167,764,169,63,232,1.5254901960784313,27.649637907575766
Task_30052,2906,823,147,27,174,3.5266990291262137,54.83012190408183
Task_30053,1589,999,142,163,305,1.589,35.79607994236248
Task_30054,1795,897,24,140,164,1.9988864142538976,38.05806648783601
Task_30055,2656,103,196,35,231,25.53846153846154,48.19566277881961
Task_30056,1335,467,182,81,263,2.8525641025641026,29.740000207255182
Task_30057,1465,690,77,69,146,2.1201157742402317,31.798999020897877
Task_30058,500,679,81,46,127,0.7352941176470589,16.070433123114814
Task_30059,1294,99,14,105,119,12.94,26.355499593806005
Task_30060,2251,307,40,72,112,7.308441558441558,42.727780650794024
Task_30061,2165,628,48,167,215,3.4419713831478536,43.46567347418136
Task_30062,2484,940,141,134,275,2.6397449521785337,49.660264622518696
Task_30063,1993,262,93,180,273,7.577946768060836,39.80563355440055
Task_30064,2594,74,38,111,149,34.586666666666666,46.846214034722266
Task_30065,973,406,158,150,308,2.3906633906633905,24.225443479768654
Task_30066,1496,270,22,68,90,5.520295202952029,30.3199602308445
Task_30067,2306,754,117,82,199,3.0543046357615893,45.76821146366666
Task_30068,1998,90,91,99,190,21.956043956043956,38.22806269161669
Task_30069,1052,627,41,76,117,1.6751592356687899,24.920470980607245
Task_30070,1123,785,114,128,242,1.4287531806615776,27.40203996207723
Task_30071,2522,650,143,67,210,3.8740399385560678,48.68587609290819
Task_30072,2045,216,161,14,175,9.423963133640553,39.13974218285444
Task_30073,1760,890,183,114,297,1.9753086419753085,38.102144557589774
Task_30074,1556,384,159,116,275,4.041558441558442,33.18121383122119
Task_30075,1930,983,51,107,158,1.9613821138211383,40.35434154009526
Task_30076,1677,580,151,108,259,2.8864027538726336,35.637741394341944
Task_30077,1108,940,90,114,204,1.177470775770457,27.433418269801262
Task_30078,1777,955,89,10,99,1.858786610878661,36.552088699005644
Task_30079,2261,183,185,28,213,12.28804347826087,42.70081841471463
Task_30080,1342,692,165,52,217,1.9365079365079365,30.15196411876423
Task_30081,2018,579,40,53,93,3.4793103448275864,39.49430480770419
Task_30082,2883,116,162,113,275,24.641025641025642,52.7546469377034
Task_30083,608,688,190,149,339,0.8824383164005806,19.435390301943585
Task_30084,2235,247,181,113,294,9.012096774193548,43.53367947712659
Task_30085,2793,287,57,84,141,9.697916666666666,51.67148344911746
Task_30086,2006,451,141,192,333,4.438053097345133,40.89209092738276
Task_30087,2876,346,84,142,226,8.288184438040346,53.763490479558016
Task_30088,701,861,95,41,136,0.8132250580046404,19.827426164583947
Task_30089,973,694,42,34,76,1.4,22.659027045431674
Task_30090,2573,715,176,137,313,3.5935754189944134,50.5407274255939
Task_30091,2496,997,197,138,335,2.501002004008016,50.30438963678525
Task_30092,1708,71,136,12,148,23.72222222222222,32.10091191338136
Task_30093,948,694,156,169,325,1.3640287769784172,24.788370717028513
Task_30094,2842,740,195,57,252,3.835357624831309,54.17624670630082
Task_30095,506,1001,58,66,124,0.5049900199600799,17.427737171045848
Task_30096,1409,294,108,107,215,4.776271186440678,30.27741247791951
Task_30097,2046,480,76,52,128,4.253638253638254,40.23722535874105
Task_30098,983,998,81,66,147,0.983983983983984,25.109432165619797
Task_30099,1724,574,128,79,207,2.9982608695652173,35.98399336534694
Task_30100,2713,296,47,99,146,9.134680134680135,50.43309220444906
Task_30101,2446,922,131,176,307,2.6500541711809316,49.207753030340974
Task_30102,1154,814,92,181,273,1.4159509202453988,28.212251912013812
Task_30103,584,466,18,150,168,1.2505353319057815,17.48847485190002
Task_30104,1409,810,70,125,195,1.7373612823674476,31.9074448588038
Task_30105,621,713,42,88,130,0.8697478991596639,18.567518587229614
Task_30106,1271,227,126,34,160,5.574561403508772,26.893237361125372
Task_30107,1413,670,81,47,128,2.105812220566319,30.54684850548884
Task_30108,1731,368,189,132,321,4.691056910569106,36.12854542521544
Task_30109,2215,749,158,88,246,2.953333333333333,44.543571335795896
Task_30110,2000,134,138,144,282,14.814814814814815,39.109565920744174
Task_30111,1670,142,181,104,285,11.678321678321678,33.94520833047845
Task_30112,1437,893,16,33,49,1.6073825503355705,30.54669901815574
Task_30113,1463,971,196,84,280,1.5051440329218106,33.413568754490285
Task_30114,2640,833,91,27,118,3.1654676258992804,50.11897113189823
Task_30115,2950,151,96,38,134,19.407894736842106,52.67994127780767
Task_30116,2741,638,157,52,209,4.289514866979656,52.1048055743413
Task_30117,2662,670,198,166,364,3.9672131147540983,52.08060835281515
Task_30118,893,386,21,183,204,2.3074935400516794,22.457570811901746
Task_30119,778,274,200,36,236,2.829090909090909,19.714375382993357
Task_30120,1743,454,154,185,339,3.830769230769231,36.7557506397021
Task_30121,743,679,55,42,97,1.0926470588235293,19.430819982563964
Task_30122,2264,499,110,57,167,4.528,43.864807142705
Task_30123,2995,796,102,67,169,3.7578419071518194,56.41058343779955
Task_30124,2639,569,28,41,69,4.629824561403509,48.60097194577667
Task_30125,1450,926,104,23,127,1.564185544768069,31.684121337404807
Task_30126,1012,106,24,180,204,9.457943925233645,22.98552125326906
Task_30127,2722,808,93,123,216,3.3646477132262054,52.77465873853094
Task_30128,1868,541,87,86,173,3.4464944649446494,37.97875767683589
Task_30129,2714,815,189,76,265,3.325980392156863,52.61173290327605
Task_30130,927,755,47,121,168,1.2261904761904763,23.83068039350088
Task_30131,769,812,122,144,266,0.9458794587945879,22.042606681957086
Task_30132,997,205,156,85,241,4.839805825242719,23.475147915391045
Task_30133,2676,321,27,72,99,8.31055900621118,49.20864282102656
Task_30134,2869,94,108,160,268,30.2,52.3060885273189
Task_30135,941,209,183,124,307,4.480952380952381,23.036443272650157
Task_30136,982,578,131,83,214,1.6960276338514682,24.304975156502106
Task_30137,1001,1006,82,83,165,0.9940417080436942,25.715833390618045
Task_30138,2319,756,158,47,205,3.0634081902245707,45.533739953114754
Task_30139,582,554,96,43,139,1.0486486486486486,16.94798744433464
Task_30140,1620,974,154,75,229,1.6615384615384616,35.60603342472783
Task_30141,1403,400,107,71,178,3.4987531172069826,30.039483283491535
Task_30142,1393,87,100,20,120,15.829545454545455,27.23345659950098
Task_30143,2365,488,186,103,289,4.83640081799591,46.36556951031361
Task_30144,1307,915,73,60,133,1.4268558951965065,29.83144890181995
Task_30145,2024,908,181,113,294,2.2266226622662266,42.32633032017598
Task_30146,1052,320,40,104,144,3.277258566978193,24.21328586885149
Task_30147,2120,401,51,20,71,5.27363184079602,39.67915721387976
Task_30148,939,839,71,43,114,1.1178571428571429,23.27504251403371
Task_30149,1598,556,106,159,265,2.8689407540394973,34.41285013568392
Task_30150,2985,238,39,183,222,12.489539748953975,55.136309677067324
Task_30151,1242,1019,82,84,166,1.2176470588235293,29.57278508508861
Task_30152,2083,389,74,73,147,5.341025641025641,40.67330439255559
Task_30153,553,985,34,62,96,0.5608519269776876,17.67331580708983
Task_30154,1862,320,102,49,151,5.8006230529595015,36.59809387606437
Task_30155,965,107,122,90,212,8.935185185185185,22.102968042747346
Task_30156,700,949,155,143,298,0.7368421052631579,21.50148253181584
Task_30157,2440,316,192,196,388,7.697160883280757,47.563789637338594
Task_30158,2484,107,165,24,189,23.0,45.28731424038148
Task_30159,2007,965,53,89,142,2.077639751552795,41.41849751415487
Task_30160,1619,800,92,53,145,2.0212234706616727,34.554807157913814
Task_30161,2392,106,104,116,220,22.35514018691589,44.685160705274406
Task_30162,2485,108,183,193,376,22.798165137614678,46.980176388825384
Task_30163,1915,612,129,56,185,3.1239804241435563,38.772732755039506
Task_30164,2485,985,56,41,97,2.520283975659229,47.86414267364225
Task_30165,2985,288,178,101,279,10.328719723183392,55.450925043706036
Task_30166,2603,691,49,72,121,3.7615606936416186,49.66187181973968
Task_30167,1125,257,196,164,360,4.3604651162790695,26.402221674272823
Task_30168,2404,537,10,100,110,4.4684014869888475,45.99799151203725
Task_30169,1680,642,98,168,266,2.6127527216174182,36.00405890375859
Task_30170,2745,839,130,200,330,3.267857142857143,53.82457803689906
Task_30171,2508,984,10,100,110,2.5461928934010154,49.05270290066832
Task_30172,1535,989,26,119,145,1.5505050505050506,33.931857834563594
Task_30173,2748,417,170,111,281,6.574162679425838,52.17096588783011
Task_30174,779,611,166,172,338,1.272875816993464,21.902441466874674
Task_30175,2963,485,162,68,230,6.096707818930041,55.22889932409344
Task_30176,1782,175,79,84,163,10.125,35.22937768967538
Task_30177,2840,293,80,110,190,9.65986394557823,52.83901260915251
Task_30178,2328,1012,72,128,200,2.2981243830207303,47.12559979916418
Task_30179,1828,961,63,133,196,1.9002079002079002,39.04011298027706
Task_30180,2410,1006,83,29,112,2.393247269116187,46.9594736941332
Task_30181,627,1015,28,50,78,0.6171259842519685,18.643146404286636
Task_30182,990,289,102,60,162,3.413793103448276,22.930569202032572
Task_30183,2146,824,96,142,238,2.601212121212121,43.795163408456624
Task_30184,693,323,133,100,233,2.138888888888889,19.121245413018595
Task_30185,2141,716,185,120,305,2.9860529986052997,43.6396735889713
Task_30186,2243,756,94,105,199,2.963011889035667,44.891618123674995
Task_30187,2066,701,83,30,113,2.943019943019943,40.61496978423289
Task_30188,1441,444,53,192,245,3.238202247191011,31.60241152225868
Task_30189,2243,134,69,60,129,16.614814814814814,41.65009523565716
Task_30190,2993,936,80,48,128,3.1942369263607255,56.43008386183849
Task_30191,2427,482,29,76,105,5.024844720496894,46.024748781572164
Task_30192,2989,611,114,195,309,4.883986928104576,56.86647251302304
Task_30193,1399,1004,199,34,233,1.3920398009950248,31.820514802009257
Task_30194,2473,244,129,80,209,10.093877551020409,46.75186334563409
Task_30195,2810,120,38,192,230,23.223140495867767,51.55808408690283
Task_30196,1020,738,164,129,293,1.3802435723951285,25.85568107378853
Task_30197,621,175,91,129,220,3.528409090909091,17.269449294685007
Task_30198,1512,206,177,200,377,7.304347826086956,32.46730979205038
Task_30199,2061,401,61,171,232,5.126865671641791,41.18105244635636
Task_30200,2805,960,192,41,233,2.9188345473465143,53.972045984412354
Task_30201,1300,118,12,120,132,10.92436974789916,26.807128064265697
Task_30202,825,983,142,47,189,0.8384146341463414,22.534171209241038
Task_30203,625,967,23,82,105,0.6456611570247934,19.186168162223336
Task_30204,695,575,143,43,186,1.2065972222222223,19.13904386638922
Task_30205,2775,160,106,69,175,17.236024844720497,50.55044249380049
Task_30206,2876,1024,145,34,179,2.805853658536585,55.035349230657054
Task_30207,677,813,124,163,287,0.8316953316953317,20.70058727564695
Task_30208,2502,148,186,31,217,16.79194630872483,46.19620399985678
Task_30209,1855,672,59,195,254,2.7563150074294205,38.92122569565931
Task_30210,2967,801,157,19,176,3.699501246882793,55.6812017675284
Task_30211,1360,866,83,151,234,1.5686274509803921,31.451385562055254
Task_30212,2574,140,72,78,150,18.25531914893617,47.16466807570432
Task_30213,2164,283,62,132,194,7.619718309859155,42.18432940518114
Task_30214,1578,592,16,35,51,2.661045531197302,31.84074129923154
Task_30215,2662,123,198,11,209,21.467741935483872,48.366382024429065
Task_30216,1181,877,50,83,133,1.3451025056947608,28.060202429245965
Task_30217,2488,846,110,110,220,2.937426210153483,49.14686787792249
Task_30218,1152,254,163,167,330,4.517647058823529,26.688001160748414
Task_30219,2711,775,12,80,92,3.493556701030928,51.29134767328833
Task_30220,1069,489,85,25,110,2.1816326530612247,24.064103012210214
Task_30221,2031,732,90,128,218,2.770804911323329,41.5613203149594
Task_30222,1799,725,176,111,287,2.4779614325068873,38.15596375327537
Task_30223,2037,162,37,194,231,12.496932515337424,39.688292732684594
Task_30224,1256,230,150,39,189,5.437229437229437,26.912147862105982
Task_30225,1742,306,133,130,263,5.6742671009771986,35.832537171661926
Task_30226,1650,232,188,137,325,7.081545064377682,34.41312249719073
Task_30227,2059,497,42,152,194,4.134538152610442,41.210606430393575
Task_30228,1935,990,87,44,131,1.9525731584258326,39.68154851277452
Task_30229,2116,169,109,87,196,12.447058823529412,40.58621025821294
Task_30230,1348,297,138,99,237,4.523489932885906,29.404448639566244
Task_30231,1359,548,196,161,357,2.4754098360655736,31.020821990497492
Task_30232,586,456,35,179,214,1.2822757111597374,17.81332744225062
Task_30233,1628,662,23,154,177,2.455505279034691,34.78257769033957
Task_30234,845,499,191,66,257,1.69,21.85264834038722
Task_30235,2028,957,144,137,281,2.116910229645094,42.51879471844583
Task_30236,625,222,99,63,162,2.802690582959641,16.985633039997506
Task_30237,1242,988,159,23,182,1.255813953488372,28.992231792727676
Task_30238,563,150,190,69,259,3.728476821192053,16.070875223750093
Task_30239,2094,108,82,167,249,19.211009174311926,40.27950178260091
Task_30240,2704,932,91,85,176,2.8981779206859595,52.48992419126619
Task_30241,1588,277,127,28,155,5.712230215827338,32.039245674377064
Task_30242,2550,662,88,93,181,3.8461538461538463,49.26503847332004
Task_30243,1335,926,175,24,199,1.4401294498381878,30.356221423172897
Task_30244,2491,131,173,173,346,18.87121212121212,47.152757395977964
Task_30245,800,299,132,73,205,2.6666666666666665,20.340809712220935
Task_30246,1158,259,67,130,197,4.453846153846154,26.220370471821116
Task_30247,1527,753,166,197,363,2.0251989389920424,34.4031347081545
Task_30248,2572,833,10,39,49,3.0839328537170263,48.30427672841657
Task_30249,2099,548,97,127,224,3.8233151183970855,42.096464600055434
Task_30250,1487,250,36,57,93,5.924302788844622,30.009968150604436
Task_30251,864,346,170,18,188,2.489913544668588,20.983923346659257
Task_30252,2252,706,66,136,202,3.185289957567185,45.003193438439666
Task_30253,1593,220,141,187,328,7.208144796380091,33.556862143093866
Task_30254,2481,67,94,59,153,36.48529411764706,44.67765300473462
Task_30255,1154,321,43,169,212,3.5838509316770186,26.428239015903248
Task_30256,2930,447,104,42,146,6.540178571428571,53.84220950756091
Task_30257,2904,767,119,172,291,3.78125,55.90042372327893
Task_30258,2996,209,55,31,86,14.266666666666667,53.317651741096995
Task_30259,2503,676,17,40,57,3.6971935007385524,46.79426522354159
Task_30260,2826,222,120,174,294,12.672645739910314,52.86347814788928
Task_30261,1566,128,114,161,275,12.13953488372093,32.24251915604117
Task_30262,2743,529,171,54,225,5.175471698113207,51.82652410067806
Task_30263,1585,839,74,118,192,1.8869047619047619,34.763889314534104
Task_30264,1208,170,25,16,41,7.064327485380117,24.32808469773696
Task_30265,854,984,130,72,202,0.867005076142132,23.34253322623408
Task_30266,1383,790,188,57,245,1.7484197218710493,31.17753787012983
Task_30267,740,515,68,153,221,1.434108527131783,20.515629536725253
Task_30268,949,895,133,41,174,1.0591517857142858,24.10231569641792
Task_30269,1920,79,151,80,231,24.0,36.84326502356999
Task_30270,2683,786,104,24,128,3.409148665819568,50.92605070824474
Task_30271,1456,740,110,28,138,1.9649122807017543,31.309032274451894
Task_30272,1995,859,161,52,213,2.3197674418604652,40.99988929572944
Task_30273,2424,608,128,64,192,3.980295566502463,46.91077254896285
Task_30274,2020,734,85,175,260,2.748299319727891,41.663207823593375
Task_30275,2014,149,142,187,329,13.426666666666666,39.74464389588079
Task_30276,2125,184,43,69,112,11.486486486486486,40.16300991655125
Task_30277,1589,565,198,173,371,2.8074204946996466,34.7970043423806
Task_30278,1661,756,66,115,181,2.1941875825627477,35.634449306576926
Task_30279,2836,255,15,139,154,11.078125,52.223394963862965
Task_30280,2574,758,185,121,306,3.391304347826087,50.637014661257844
Task_30281,789,943,158,70,228,0.8358050847457628,22.251154246211104
Task_30282,2074,870,53,126,179,2.381171067738232,42.547165956077905
Task_30283,1807,844,181,62,243,2.1384615384615384,38.06415043709312
Task_30284,2381,1021,119,100,219,2.3297455968688845,47.978153702585
Task_30285,2624,625,170,46,216,4.1916932907348246,49.98535897772633
Task_30286,1205,234,134,58,192,5.127659574468085,26.363144373894116
Task_30287,638,796,100,194,294,0.8005018820577164,20.12180724666212
Task_30288,1540,125,46,176,222,12.222222222222221,31.551390938349712
Task_30289,2608,111,109,57,166,23.285714285714285,47.416477307810474
Task_30290,2483,781,118,184,302,3.1751918158567776,49.34196328638586
Task_30291,2004,309,48,17,65,6.464516129032258,37.51085175918492
Task_30292,1846,634,56,128,184,2.9070866141732283,38.20739119335179
Task_30293,1425,180,93,57,150,7.87292817679558,29.158574283119773
Task_30294,997,704,41,135,176,1.4141843971631205,24.852899176074505
Task_30295,1048,808,40,144,184,1.2954264524103831,25.995637644083843
Task_30296,2967,620,189,174,363,4.777777777777778,56.75944037156635
Task_30297,1863,923,45,118,163,2.0162337662337664,39.20752671169174
Task_30298,1086,959,79,179,258,1.13125,27.52842104478546
Task_30299,997,299,58,139,197,3.3233333333333333,23.815801214555094
Task_30300,2650,652,71,139,210,4.058192955589586,51.15974049360741
Task_30301,870,476,147,43,190,1.8238993710691824,21.61242250938319
Task_30302,2300,504,47,197,244,4.554455445544554,45.36325964978126
Task_30303,1440,978,148,81,229,1.4708886618998978,32.79588680702113
Task_30304,1142,384,170,47,217,2.966233766233766,25.774810486810964
Task_30305,879,463,64,90,154,1.894396551724138,22.01088108098841
Task_30306,1962,845,116,113,229,2.3191489361702127,40.854670012019085
Task_30307,1554,726,146,156,302,2.137551581843191,34.411591008689086
Task_30308,1132,550,95,81,176,2.0544464609800364,26.382799155695086
Task_30309,819,892,182,89,271,0.9171332586786114,22.980688050301723
Task_30310,1317,713,149,12,161,1.8445378151260505,29.107016706703305
Task_30311,1805,692,81,96,177,2.6046176046176046,37.700047575501806
Task_30312,886,797,165,70,235,1.1102756892230576,23.314305849118142
Task_30313,957,1003,112,46,158,0.953187250996016,24.455121381557973
Task_30314,952,497,131,148,279,1.9116465863453815,24.046094881067603
Task_30315,1425,209,172,89,261,6.785714285714286,30.37653475665212
Task_30316,1859,797,147,90,237,2.3295739348370925,39.04362450098588
Task_30317,2002,257,158,28,186,7.75968992248062,38.754126803616145
Task_30318,2510,181,161,141,302,13.791208791208792,47.49708400972009
Task_30319,2680,587,95,25,120,4.557823129251701,49.95603623218804
Task_30320,910,662,135,34,169,1.3725490196078431,22.686406081978486
Task_30321,2619,709,174,86,260,3.6887323943661974,50.87050299614676
Task_30322,2381,339,107,145,252,7.002941176470588,46.02182933184048
Task_30323,1722,312,190,69,259,5.501597444089457,35.14469132304982
Task_30324,976,227,111,65,176,4.280701754385965,22.68432173372351
Task_30325,765,576,154,190,344,1.3258232235701906,21.639601906803676
Task_30326,1850,103,79,68,147,17.78846153846154,35.29463134128458
Task_30327,2079,674,18,82,100,3.08,41.11298782637847
Task_30328,2769,666,107,84,191,4.151424287856072,52.78623016395186
Task_30329,509,546,144,153,297,0.9305301645338209,17.251177112256226
Task_30330,1958,146,79,134,213,13.319727891156463,38.2917214429626
Task_30331,533,898,113,41,154,0.592880978865406,17.61277947699597
Task_30332,1374,609,142,165,307,2.2524590163934426,31.230385536485525
Task_30333,2233,154,121,134,255,14.406451612903226,42.802063399560446
Task_30334,2495,127,114,132,246,19.4921875,46.67450295176604
Task_30335,1445,394,99,140,239,3.6582278481012658,31.33185233991354
Task_30336,2849,778,48,170,218,3.657252888318357,54.7916541264718
Task_30337,2907,754,55,147,202,3.8503311258278146,55.53876249390427
Task_30338,889,759,101,135,236,1.1697368421052632,23.59164564634779
Task_30339,1811,193,84,169,253,9.335051546391753,36.540486318820335
Task_30340,2142,796,125,89,214,2.687578419071518,43.408113131408236
Task_30341,1805,65,34,140,174,27.348484848484848,34.9878966364305
Task_30342,2945,176,77,168,245,16.638418079096045,54.16490129748025
Task_30343,576,442,148,199,347,1.3002257336343115,18.242262688236433
Task_30344,2456,979,24,106,130,2.5061224489795917,48.47349697624245
Task_30345,867,335,173,61,234,2.580357142857143,21.529950349578098
Task_30346,1158,826,198,197,395,1.400241837968561,28.874468828911237
Task_30347,1995,376,127,145,272,5.291777188328912,40.12967311746901
Task_30348,2387,686,120,23,143,3.4745269286754,45.905565614760484
Task_30349,2572,616,198,183,381,4.168557536466775,50.585255769427285
Task_30350,2595,208,75,137,212,12.416267942583731,48.80114463073372
Task_30351,1578,213,138,104,242,7.373831775700935,32.7855065452612
Task_30352,946,799,199,155,354,1.1825,25.179791892658766
Task_30353,2011,725,49,102,151,2.7699724517906334,40.7784566918544
Task_30354,2013,913,199,55,254,2.202407002188184,41.59735823245636
Task_30355,1899,794,83,189,272,2.388679245283019,40.03824351197547
Task_30356,1819,798,186,49,235,2.276595744680851,37.954597799930895
Task_30357,1082,367,15,97,112,2.9402173913043477,24.581306358036965
Task_30358,2262,243,191,134,325,9.270491803278688,44.11610721524679
Task_30359,1815,230,199,11,210,7.857142857142857,35.73716495859106
Task_30360,1929,700,158,68,226,2.7517831669044224,39.52264704887235
Task_30361,1415,538,185,128,313,2.6252319109461966,31.629338437914484
Task_30362,2634,393,88,178,266,6.685279187817259,50.27645125557758
Task_30363,1358,391,151,145,296,3.4642857142857144,30.208161311299417
Task_30364,692,710,23,170,193,0.9732770745428974,20.129169326446483
Task_30365,1505,684,195,39,234,2.197080291970803,32.51507415705285
Task_30366,2150,671,47,165,212,3.199404761904762,43.327640976985755
Task_30367,865,247,191,131,322,3.4879032258064515,22.04124145977593
Task_30368,2538,864,117,162,279,2.9341040462427745,50.33756025728129
Task_30369,2149,360,160,12,172,5.9529085872576175,41.27665065860729
Task_30370,1014,431,86,121,207,2.3472222222222223,24.41593148529559
Task_30371,1610,676,133,108,241,2.3781388478581977,34.79705245001099
Task_30372,1541,379,84,179,263,4.0552631578947365,32.97582395325358
Task_30373,656,459,82,32,114,1.4260869565217391,17.5083677973108
Task_30374,2227,861,151,44,195,2.5835266821345706,44.32988815777353
Task_30375,1474,185,51,46,97,7.924731182795699,29.379535306494756
Task_30376,775,398,137,10,147,1.9423558897243107,19.47889965040933
Task_30377,2939,315,140,74,214,9.300632911392405,54.309548087326284
Task_30378,1503,546,46,136,182,2.7477148080438756,32.46519767504265
Task_30379,2954,934,104,173,277,3.1593582887700533,57.155318096576686
Task_30380,2735,1014,54,88,142,2.6945812807881775,53.10256815271165
Task_30381,1427,850,47,44,91,1.6768507638072856,30.72088345033903
Task_30382,2582,612,179,133,312,4.212071778140293,50.34661411984829
Task_30383,2020,554,172,38,210,3.6396396396396398,40.16573849472539
Task_30384,907,291,18,110,128,3.106164383561644,21.90474367151468
Task_30385,2957,698,69,22,91,4.23032904148784,54.483306351941515
Task_30386,1052,631,37,41,78,1.6645569620253164,23.819312780520804
Task_30387,2641,537,51,178,229,4.908921933085502,50.830942507804544
Task_30388,1358,557,38,48,86,2.4336917562724016,28.73200254010906
Task_30389,2054,84,80,30,110,24.16470588235294,37.53808157054602
Task_30390,1209,431,57,107,164,2.798611111111111,27.34653367187435
Task_30391,2973,836,193,114,307,3.5519713261648747,57.19786076373617
Task_30392,1934,867,182,160,342,2.228110599078341,41.05780104610505
Task_30393,1241,662,10,19,29,1.8717948717948718,26.371584955996024
Task_30394,1670,971,97,33,130,1.7181069958847737,35.407666385317874
Task_30395,536,495,163,85,248,1.0806451612903225,17.07863288554682
Task_30396,2897,191,125,161,286,15.088541666666666,53.80050539180854
Task_30397,1318,940,180,193,373,1.4006376195536663,31.658086515285998
Task_30398,1713,284,113,97,210,6.010526315789473,35.04070181509949
Task_30399,2376,290,184,146,330,8.164948453608247,46.12654103836828
Task_30400,1631,472,40,95,135,3.448202959830867,33.85639772190702
Task_30401,747,721,58,129,187,1.0346260387811634,21.01105025889765
Task_30402,1540,898,115,61,176,1.7130144605116797,33.65903135076122
Task_30403,2530,471,70,28,98,5.360169491525424,47.09793071304231
Task_30404,2745,448,38,199,237,6.11358574610245,52.16653231225024
Task_30405,2073,777,33,115,148,2.66452442159383,41.86117832161734
Task_30406,990,748,146,117,263,1.321762349799733,25.265681168324758
Task_30407,2807,783,83,133,216,3.580357142857143,54.0545625013737
Task_30408,1153,193,189,167,356,5.943298969072165,26.606315166146
Task_30409,2018,685,153,87,240,2.941690962099125,41.19119682659947
Task_30410,2351,722,124,31,155,3.251728907330567,45.56148442352289
Task_30411,1691,740,157,42,199,2.282051282051282,35.48257378865289
Task_30412,2034,376,191,177,368,5.395225464190982,41.22627964324262
Task_30413,684,112,32,48,80,6.053097345132743,16.21294649907334
Task_30414,1824,767,165,16,181,2.375,37.46146384284552
Task_30415,2365,402,132,126,258,5.86848635235732,45.97882910154328
Task_30416,2697,533,178,18,196,5.050561797752809,50.644688795072994
Task_30417,1499,80,12,94,106,18.506172839506174,29.324155849664795
Task_30418,2802,699,186,186,372,4.002857142857143,54.45539734869315
Task_30419,2191,796,96,18,114,2.749058971141782,42.80143504223221
Task_30420,2765,783,33,196,229,3.5267857142857144,53.51077598128327
Task_30421,2339,841,54,30,84,2.7779097387173395,45.02096506982132
Task_30422,2943,905,28,153,181,3.248344370860927,56.384103449263286
Task_30423,2142,777,62,53,115,2.7532133676092543,42.28321147751691
Task_30424,2737,946,50,141,191,2.8901795142555438,53.4178983519794
Task_30425,1968,627,107,65,172,3.1337579617834397,39.64258616911592
Task_30426,815,823,23,86,109,0.9890776699029126,21.668839342852262
Task_30427,975,67,196,120,316,14.338235294117647,22.70931055725377
Task_30428,2273,234,109,28,137,9.672340425531916,42.582595928202174
Task_30429,2227,906,65,53,118,2.4553472987872107,44.084830777468646
Task_30430,1497,267,107,101,208,5.585820895522388,31.537208876156637
Task_30431,2716,67,88,38,126,39.94117647058823,47.77223000106826
Task_30432,833,739,34,68,102,1.1256756756756756,21.45135818314746
Task_30433,2601,304,76,114,190,8.527868852459017,49.11896702214981
Task_30434,1935,368,97,153,250,5.2439024390243905,39.074322498153215
Task_30435,2181,192,113,39,152,11.300518134715025,41.12702328404833
Task_30436,1989,943,49,63,112,2.106991525423729,40.5409494106133
Task_30437,2612,717,96,49,145,3.637883008356546,49.79460325268746
Task_30438,2993,309,94,84,178,9.654838709677419,55.07832080279234
Task_30439,2137,623,11,95,106,3.4246794871794872,41.95447825882325
Task_30440,1502,968,68,150,218,1.5500515995872033,33.98688650242034
Task_30441,1165,309,164,160,324,3.7580645161290325,27.038021642537174
Task_30442,1408,237,147,147,294,5.915966386554622,30.483000208630113
Task_30443,1824,388,150,179,329,4.688946015424165,37.77027891638567
Task_30444,543,161,197,75,272,3.3518518518518516,15.962340612095426
Task_30445,777,620,95,75,170,1.251207729468599,20.81033359372107
Task_30446,1166,332,99,148,247,3.5015015015015014,26.765713303811182
Task_30447,2924,108,37,73,110,26.825688073394495,51.812079060252216
Task_30448,1638,534,40,57,97,3.061682242990654,33.32651489426272
Task_30449,842,773,160,140,300,1.0878552971576227,23.18210938318092
Task_30450,2465,421,50,60,110,5.841232227488152,46.25062552644399
Task_30451,2727,400,47,191,238,6.800498753117207,51.74561759205204
Task_30452,1161,581,176,21,197,1.9948453608247423,26.493410702616746
Task_30453,2845,505,24,29,53,5.622529644268774,51.62305560321749
Task_30454,2795,513,130,150,280,5.437743190661479,53.28231319511258
Task_30455,551,87,144,49,193,6.261363636363637,14.737827028311107
Task_30456,1027,171,95,23,118,5.97093023255814,22.25691222407893
Task_30457,1677,419,42,10,52,3.992857142857143,32.72739005758712
Task_30458,798,787,38,51,89,1.0126903553299493,20.75864719548984
Task_30459,2201,130,81,31,112,16.801526717557252,40.41291019664988
Task_30460,881,748,40,178,218,1.1762349799732976,23.405977769718465
Task_30461,980,457,94,66,160,2.1397379912663754,23.28556113544437
Task_30462,2452,252,83,122,205,9.691699604743082,46.62830016839985
Task_30463,962,364,178,147,325,2.6356164383561644,23.99015054067078
Task_30464,911,203,69,199,268,4.465686274509804,22.548958447569134
Task_30465,1660,754,160,81,241,2.198675496688742,35.68919031994416
Task_30466,2717,503,126,35,161,5.390873015873016,50.70923415481794
Task_30467,2495,704,50,70,120,3.5390070921985815,47.92328848218252
Task_30468,1609,263,120,66,186,6.09469696969697,32.83532726060455
Task_30469,1480,551,98,80,178,2.681159420289855,31.904305180587112
Task_30470,2199,733,142,136,278,2.9959128065395095,44.5136050882169
Task_30471,2065,105,25,186,211,19.4811320754717,39.56667427750508
Task_30472,616,106,172,42,214,5.757009345794392,16.046422057731473
Task_30473,2431,123,96,43,139,19.60483870967742,44.257478908469494
Task_30474,1998,800,92,150,242,2.49438202247191,41.40506629836006
Task_30475,1485,561,164,29,193,2.6423487544483986,31.618805962392983
Task_30476,2954,851,165,112,277,3.467136150234742,56.80579148642246
Task_30477,1225,990,100,24,124,1.2361251261352169,28.219309309935984
Task_30478,1228,950,127,126,253,1.2912723449001051,29.61657651708141
Task_30479,1742,468,16,157,173,3.7142857142857144,35.93974748963387
Task_30480,2263,596,186,26,212,3.7906197654941374,44.10873993526559
Task_30481,2128,363,168,85,253,5.846153846153846,41.94010216507705
Task_30482,2946,705,79,130,209,4.172804532577904,55.99868668648995
Task_30483,1122,730,126,152,278,1.5348837209302326,27.423910038867238
Task_30484,1911,229,52,99,151,8.308695652173913,37.54901603163439
Task_30485,2520,435,107,10,117,5.779816513761468,46.85257977064769
Task_30486,2936,607,185,183,368,4.828947368421052,56.26263657290898
Task_30487,2370,825,12,142,154,2.8692493946731235,46.698440835326444
Task_30488,1026,478,39,16,55,2.1419624217119,22.613848353731687
Task_30489,2838,738,123,101,224,3.8403247631935047,54.35731081414758
Task_30490,2111,273,169,17,186,7.704379562043796,40.44504010166023
Task_30491,1137,419,189,65,254,2.7071428571428573,26.232223585954685
Task_30492,1850,996,137,164,301,1.855566700100301,39.94899848405779
Task_30493,1317,600,87,134,221,2.1913477537437602,29.826709530901628
Task_30494,1945,162,169,101,270,11.932515337423313,38.31565350275988
Task_30495,1823,658,78,116,194,2.7663125948406675,37.98119184412767
Task_30496,973,442,111,68,179,2.1963882618510158,23.33410111784039
Task_30497,2702,816,100,134,234,3.307221542227662,52.541696381131636
Task_30498,1231,747,38,132,170,1.6457219251336899,28.678405027532197
Task_30499,2993,461,143,133,276,6.478354978354979,56.20388705685792
Task_30500,813,266,130,133,263,3.044943820224719,21.018799599006176
Task_30501,1313,603,171,198,369,2.173841059602649,30.573354415495718
Task_30502,1067,548,96,139,235,1.9435336976320583,25.822848429854474
Task_30503,1009,225,161,131,292,4.464601769911504,24.10723144663054
Task_30504,1455,404,164,47,211,3.5925925925925926,30.764462741993754
Task_30505,2646,425,159,42,201,6.211267605633803,49.60991016074195
Task_30506,1347,1002,169,146,315,1.3429710867397806,31.98639557195483
Task_30507,1590,73,127,51,178,21.486486486486488,30.936825202987777
Task_30508,1639,941,51,175,226,1.7399150743099787,36.19746928196209
Task_30509,1421,470,193,32,225,3.0169851380042463,30.47019866231554
Task_30510,700,729,79,96,175,0.958904109589041,20.24644529895484
Task_30511,2879,443,121,171,292,6.4842342342342345,54.467897856464994
Task_30512,1581,423,134,127,261,3.7287735849056602,33.65567565243529
Task_30513,2718,452,120,195,315,6.0,52.088138569285924
Task_30514,607,953,14,184,198,0.6362683438155137,19.77360483910695
Task_30515,2249,550,115,117,232,4.081669691470054,44.49166748337717
Task_30516,1394,200,104,48,152,6.935323383084577,28.694335010759072
Task_30517,1628,525,34,70,104,3.0950570342205324,33.40663820979674
Task_30518,675,852,40,98,138,0.7913247362250879,19.87674759311341
Task_30519,2965,518,39,54,93,5.7129094412331405,54.28558904729011
Task_30520,2755,664,58,57,115,4.142857142857143,51.61601258701601
Task_30521,579,347,148,117,265,1.6637931034482758,17.549900151260324
Task_30522,780,613,27,102,129,1.270358306188925,20.764389999831476
Task_30523,2900,189,48,13,61,15.263157894736842,51.36008407693024
Task_30524,2639,168,17,106,123,15.615384615384615,47.99835901648648
Task_30525,2231,546,171,152,323,4.078610603290676,44.65533352787653
Task_30526,2052,625,64,95,159,3.2779552715654954,41.16291483524673
Task_30527,1404,355,10,40,50,3.943820224719101,28.338246508669926
Task_30528,1753,137,122,68,190,12.702898550724637,34.37284430973786
Task_30529,2120,351,129,116,245,6.0227272727272725,41.859923475064754
Task_30530,2442,978,166,145,311,2.49438202247191,49.29156261527478
Task_30531,1577,862,24,87,111,1.8273464658169176,33.96194888805878
Task_30532,1478,918,165,109,274,1.6082698585418933,33.59631553782082
Task_30533,1447,142,184,50,234,10.118881118881118,29.60082616238991
Task_30534,1323,838,185,199,384,1.5768772348033373,31.49045921013005
Task_30535,1489,601,128,70,198,2.473421926910299,32.11826365792037
Task_30536,1920,929,119,80,199,2.064516129032258,40.16777025490541
Task_30537,1690,350,41,115,156,4.814814814814815,34.48178651588321
Task_30538,1358,198,12,96,108,6.824120603015075,28.33175607335201
Task_30539,1638,148,67,46,113,10.993288590604028,31.662768633374384
Task_30540,2465,604,119,86,205,4.074380165289257,47.85075502994723
Task_30541,1410,497,180,47,227,2.8313253012048194,30.420752182309798
Task_30542,2105,637,196,16,212,3.299373040752351,41.663244607257035
Task_30543,2188,637,147,171,318,3.4294670846394983,44.268635977811336
Task_30544,2374,656,189,86,275,3.6133942161339423,46.88991797694433
Task_30545,1972,701,184,171,355,2.809116809116809,41.21563350866742
Task_30546,1073,862,85,47,132,1.243337195828505,25.66566619441244
Task_30547,2237,876,117,48,165,2.5507411630558723,44.45099381943666
Task_30548,2796,456,73,156,229,6.1181619256017505,52.95104153491135
Task_30549,2533,555,172,166,338,4.555755395683454,49.55418580884481
Task_30550,1733,341,48,127,175,5.067251461988304,35.44000556937299
Task_30551,2200,239,117,115,232,9.166666666666666,42.67493900693938
Task_30552,2815,330,173,14,187,8.50453172205438,51.77063597060868
Task_30553,983,878,143,92,235,1.118316268486917,25.31156902465943
Task_30554,1660,825,174,43,217,2.009685230024213,35.33912107059984
Task_30555,1558,739,77,142,219,2.1054054054054054,34.1878630120786
Task_30556,827,461,76,18,94,1.79004329004329,19.970164563506213
Task_30557,1265,717,123,121,244,1.7618384401114207,29.47934383109731
Task_30558,2820,129,61,16,77,21.692307692307693,49.552981946107366
Task_30559,505,887,65,129,194,0.5686936936936937,17.93516080584212
Task_30560,1397,872,31,102,133,1.600229095074456,31.384642435386496
Task_30561,1191,355,38,79,117,3.345505617977528,26.30180542475149
Task_30562,2196,640,133,189,322,3.425897035881435,44.449235105225
Task_30563,2815,971,128,93,221,2.896090534979424,54.6822380860062
Task_30564,1412,545,33,196,229,2.586080586080586,31.331302887967894
Task_30565,1218,647,168,155,323,1.8796296296296295,28.9359836436703
Task_30566,2248,583,180,24,204,3.8493150684931505,43.76228397555841
Task_30567,909,930,194,165,359,0.9763694951664876,25.062072401117717
Task_30568,644,635,47,149,196,1.0125786163522013,19.134958024080323
Task_30569,784,391,133,18,151,2.0,19.59820991539767
Task_30570,1905,630,120,150,270,3.0190174326465926,39.517282661800145
Task_30571,2976,1014,167,157,324,2.9320197044334977,57.94229086493694
Task_30572,556,933,168,17,185,0.5952890792291221,18.26645488911645
Task_30573,2676,329,122,113,235,8.10909090909091,50.52964810022028
Task_30574,2593,214,161,15,176,12.06046511627907,47.79085293907095
Task_30575,602,643,77,13,90,0.9347826086956522,17.147579412590066
Task_30576,1462,243,51,60,111,5.991803278688525,29.80614664466516
Task_30577,2041,222,100,41,141,9.152466367713005,38.91123339617587
Task_30578,2495,462,56,164,220,5.388768898488121,48.187099193714886
Task_30579,1772,721,148,78,226,2.4542936288088644,37.26948646378529
Task_30580,1881,431,163,161,324,4.354166666666667,38.76305002202078
Task_30581,2976,626,19,41,60,4.746411483253588,54.130243152643764
Task_30582,1018,406,116,94,210,2.501228501228501,24.407108032326633
Task_30583,2716,76,146,127,273,35.27272727272727,49.77243859426954
Task_30584,2687,606,169,189,358,4.42668863261944,52.2797889469579
Task_30585,1855,342,102,66,168,5.408163265306122,36.895829367559024
Task_30586,1706,538,89,106,195,3.165120593692022,35.6517951209847
Task_30587,932,620,119,121,240,1.500805152979066,23.855510789134026
Task_30588,2406,816,123,148,271,2.944920440636475,48.0393040969397
Task_30589,2783,136,86,60,146,20.313868613138688,50.15152789392408
Task_30590,569,771,118,156,274,0.7370466321243523,18.786916070965315
Task_30591,2890,384,93,116,209,7.5064935064935066,54.02859841695766
Task_30592,1232,184,94,104,198,6.65945945945946,26.953901356781014
Task_30593,1872,717,157,180,337,2.6072423398328692,39.613807524108985
Task_30594,524,226,149,85,234,2.3083700440528636,16.044947594277044
Task_30595,1202,738,102,122,224,1.6265223274695535,28.458028335411303
Task_30596,2658,191,14,184,198,13.84375,49.62342899290544
Task_30597,722,431,147,21,168,1.6712962962962963,18.899093617409523
Task_30598,1453,432,77,99,176,3.355658198614319,31.270531363381224
Task_30599,2336,520,161,136,297,4.483685220729367,46.093947519242
Task_30600,2769,746,151,98,249,3.7068273092369477,53.40528577360383
Task_30601,765,117,119,142,261,6.483050847457627,19.44752171812645
Task_30602,1596,951,20,47,67,1.6764705882352942,33.338833895708255
Task_30603,2087,904,90,108,198,2.306077348066298,42.866467740012446
Task_30604,1081,131,153,144,297,8.18939393939394,24.691071655087597
Task_30605,1413,856,47,138,185,1.6487747957993,32.02210217880327
Task_30606,2221,175,164,65,229,12.619318181818182,42.22855836482222
Task_30607,2413,386,137,139,276,6.235142118863049,46.78544628436028
Task_30608,500,270,176,74,250,1.845018450184502,15.76149170635584
Task_30609,1128,635,195,57,252,1.7735849056603774,26.6869920041558
Task_30610,1343,848,107,68,175,1.5818610129564192,30.426925584505142
Task_30611,1868,412,46,179,225,4.523002421307506,38.10967744094653
Task_30612,2774,829,188,98,286,3.342168674698795,53.912363466218686
Task_30613,1863,372,154,45,199,4.994638069705094,37.02622830052599
Task_30614,917,118,198,137,335,7.705882352941177,22.18060759735808
Task_30615,699,852,193,174,367,0.8194607268464243,21.54639301625978
Task_30616,1992,780,95,14,109,2.5505761843790014,39.583190647336835
Task_30617,1008,817,108,191,299,1.2322738386308068,26.017977985584057
Task_30618,761,187,148,180,328,4.047872340425532,20.3251852538696
Task_30619,2870,284,51,122,173,10.070175438596491,53.23763755530416
Task_30620,2539,911,56,119,175,2.7839912280701755,50.01236547826636
Task_30621,1258,73,74,97,171,17.0,26.46832206998174
Task_30622,1163,824,165,69,234,1.4096969696969697,27.7797106405117
Task_30623,1067,198,124,48,172,5.36180904522613,23.79650357261234
Task_30624,1554,138,13,99,112,11.179856115107913,30.657570498496217
Task_30625,2570,238,110,115,225,10.753138075313808,48.48456156432629
Task_30626,2406,987,136,72,208,2.435222672064777,47.95730449753634
Task_30627,1968,686,175,155,330,2.8646288209606987,40.969045862766
Task_30628,2248,674,163,57,220,3.33037037037037,44.41450602031932
Task_30629,1613,93,77,58,135,17.159574468085108,31.23498849647832
Task_30630,672,718,60,176,236,0.9346314325452016,20.132879415984558
Task_30631,2777,168,192,46,238,16.431952662721894,50.70408619470424
Task_30632,717,902,67,42,109,0.7940199335548173,19.925709510134315
Task_30633,2871,855,146,197,343,3.3539719626168223,55.92533261331695
Task_30634,1071,800,74,37,111,1.3370786516853932,25.1414559412441
Task_30635,1375,177,104,98,202,7.724719101123595,28.99752438049909
Task_30636,2528,67,18,24,42,37.1764705882353,43.81144582685037
Task_30637,1814,275,75,86,161,6.572463768115942,36.23969342215927
Task_30638,2227,683,168,123,291,3.2558479532163744,44.83943366324675
Task_30639,1052,939,95,51,146,1.1191489361702127,25.900190991471153
Task_30640,1754,361,105,61,166,4.845303867403315,35.35459604700032
Task_30641,1787,956,120,41,161,1.8672936259143156,37.388270240325056
Task_30642,682,800,136,154,290,0.8514357053682896,20.740655343410054
Task_30643,2158,270,40,121,161,7.96309963099631,41.663176775680846
Task_30644,1251,147,142,74,216,8.452702702702704,26.784514987863247
Task_30645,2541,574,103,129,232,4.419130434782609,49.20968500937005
Task_30646,2077,225,112,98,210,9.190265486725664,40.5638366018256
Task_30647,1676,674,44,196,240,2.482962962962963,35.97734428058934
Task_30648,1783,945,198,103,301,1.8847780126849893,38.639465906887565
Task_30649,2050,997,13,185,198,2.0541082164328657,42.664112102010144
Task_30650,2330,680,168,26,194,3.42143906020558,45.35456747478211
Task_30651,519,559,98,111,209,0.9267857142857143,16.995895262951752
Task_30652,1365,877,24,104,128,1.5546697038724373,30.95052595848855
Task_30653,2053,1014,12,199,211,2.0226600985221674,42.83159905444046
Task_30654,787,486,131,61,192,1.6160164271047228,20.555311783889625
Task_30655,2086,162,23,98,121,12.797546012269938,39.25900268433531
Task_30656,2412,907,170,195,365,2.656387665198238,48.91144949168332
Task_30657,1429,1021,178,73,251,1.398238747553816,32.73836151402363
Task_30658,1055,285,41,104,145,3.6888111888111887,24.168068257537495
Task_30659,1836,748,118,39,157,2.451268357810414,37.49062538435148
Task_30660,515,804,41,157,198,0.639751552795031,17.81371706402995
Task_30661,2879,399,132,176,308,7.1975,54.400791289350956
Task_30662,1531,583,86,27,113,2.6215753424657535,31.77160070401368
Task_30663,1470,892,80,182,262,1.6461366181410975,33.495084084825045
Task_30664,2488,155,148,73,221,15.948717948717949,46.303876508237344
Task_30665,2022,573,31,86,117,3.5226480836236935,40.160024584348996
Task_30666,1281,896,29,200,229,1.4280936454849498,30.303474727411686
Task_30667,2440,528,123,150,273,4.612476370510397,47.678604525009085
Task_30668,2495,918,148,34,182,2.7149075081610445,48.67246364767495
Task_30669,1855,784,141,24,165,2.3630573248407645,38.00594948367367
Task_30670,819,590,144,104,248,1.385786802030457,21.97254695517857
Task_30671,2370,313,146,84,230,7.547770700636943,45.4956240827878
Task_30672,1376,435,108,41,149,3.1559633027522938,29.200677911958234
Task_30673,1699,275,21,90,111,6.155797101449275,34.00563771245162
Task_30674,949,454,149,143,292,2.085714285714286,23.914784681898244
Task_30675,1660,461,174,90,264,3.593073593073593,34.9553847362935
Task_30676,510,682,101,116,217,0.746705710102489,17.2484424378486
Task_30677,1077,450,17,12,29,2.388026607538803,23.10964297849594
Task_30678,1673,677,55,133,188,2.467551622418879,35.651916811373276
Task_30679,1288,379,29,62,91,3.389473684210526,27.295622027720952
Task_30680,2823,763,151,147,298,3.695026178010471,54.59949699318222
Task_30681,2657,624,49,143,192,4.2512,51.14248226842969
Task_30682,1868,127,153,145,298,14.59375,37.05909261033307
Task_30683,1629,940,40,175,215,1.7311370882040382,35.898028157024974
Task_30684,2263,856,133,152,285,2.6406067677946323,45.96769880687636
Task_30685,2196,531,71,106,177,4.12781954887218,43.361917382807725
Task_30686,1736,635,198,195,393,2.729559748427673,37.47674332800363
Task_30687,798,900,17,37,54,0.8856825749167592,20.61630133727542
Task_30688,1887,121,129,87,216,15.467213114754099,36.750701324052464
Task_30689,2108,97,120,125,245,21.510204081632654,40.234172851125756
Task_30690,1213,907,17,51,68,1.3359030837004404,27.265170797453777
Task_30691,2321,338,45,97,142,6.846607669616519,44.39828573300355
Task_30692,1849,679,85,115,200,2.7191176470588236,38.423606462684695
Task_30693,1615,955,160,67,227,1.6893305439330544,35.33863541369886
Task_30694,1329,476,100,35,135,2.7861635220125787,28.464683051867222
Task_30695,656,261,30,60,90,2.50381679389313,16.857470684746655
Task_30696,2433,638,109,106,215,3.807511737089202,47.59262720782548
Task_30697,2597,619,103,14,117,4.188709677419355,48.65687842890784
Task_30698,1751,137,131,75,206,12.68840579710145,34.49530791391248
Task_30699,1858,995,41,67,108,1.8654618473895583,38.561694941232275
Task_30700,966,624,104,126,230,1.5456,24.36870033172958
Task_30701,1566,370,157,128,285,4.2210242587601075,33.35662132484564
Task_30702,1450,520,20,20,40,2.783109404990403,29.32635407701602
Task_30703,2921,787,79,39,118,3.7068527918781724,54.40528384496913
Task_30704,2689,311,64,183,247,8.618589743589743,50.8994491954471
Task_30705,1951,494,62,87,149,3.9414141414141413,39.1157986787584
Task_30706,750,114,158,31,189,6.521739130434782,18.167678975108284
Task_30707,2072,367,150,74,224,5.630434782608695,40.819303360598276
Task_30708,1956,462,83,163,246,4.224622030237581,39.73717443019438
Task_30709,2049,600,159,144,303,3.409317803660566,41.84305157256319
Task_30710,1706,403,159,53,212,4.2227722772277225,34.98800797173172
Task_30711,1074,831,104,121,225,1.2908653846153846,26.67421205285279
Task_30712,1368,725,138,195,333,1.884297520661157,31.658916409446217
Task_30713,2859,133,116,178,294,21.33582089552239,52.73386687162769
Task_30714,2558,603,90,110,200,4.235099337748345,49.393702362378
Task_30715,1808,412,169,80,249,4.37772397094431,36.99007357100668
Task_30716,2641,717,197,85,282,3.6782729805013927,51.33124505358517
Task_30717,1165,883,194,190,384,1.3178733031674208,29.109276724224685
Task_30718,697,630,51,99,150,1.1045958795562598,19.58062169848737
Task_30719,651,582,93,148,241,1.1166380789022299,19.326182801355596
Task_30720,1869,692,62,89,151,2.696969696969697,38.39630557650374
Task_30721,2066,968,169,147,316,2.132094943240454,43.32757707588892
Task_30722,2409,653,69,77,146,3.68348623853211,46.76006554665211
Task_30723,2998,223,66,102,168,13.383928571428571,54.939559364174436
Task_30724,2987,230,140,73,213,12.930735930735931,54.69494110990104
Task_30725,1322,649,40,40,80,2.0338461538461536,28.277553896618247
Task_30726,1334,1017,39,143,182,1.3104125736738703,31.178724608884647
Task_30727,1366,727,108,162,270,1.8763736263736264,31.301146638306047
Task_30728,2035,130,137,65,202,15.534351145038167,38.82360047011567
Task_30729,1716,130,120,113,233,13.099236641221374,34.34965819833756
Task_30730,1389,234,177,73,250,5.910638297872341,29.635822520139374
Task_30731,1973,108,23,181,204,18.10091743119266,38.108212235383256
Task_30732,1094,475,177,102,279,2.2983193277310923,26.15742968926719
Task_30733,1320,506,157,109,266,2.603550295857988,29.784618361394365
Task_30734,1106,69,19,58,77,15.8,22.338308253076576
Task_30735,740,854,37,175,212,0.8654970760233918,21.464091081635733
Task_30736,1972,921,14,154,168,2.13882863340564,40.97409760499416
Task_30737,2816,356,103,198,301,7.8879551820728295,53.259022384100284
Task_30738,2617,179,59,125,184,14.53888888888889,48.52402615159779
Task_30739,1043,463,91,169,260,2.247844827586207,25.324243807806727
Task_30740,984,436,114,122,236,2.251716247139588,24.128830680285308
Task_30741,1817,670,126,88,214,2.7078986587183307,37.84686684568177
Task_30742,2273,654,122,157,279,3.4702290076335878,45.472314033650925
Task_30743,1754,475,98,81,179,3.6848739495798317,36.00243306717384
Task_30744,2449,379,94,165,259,6.4447368421052635,47.303470500573276
Task_30745,815,663,109,145,254,1.2274096385542168,22.212673436613994
Task_30746,1091,124,144,25,169,8.728,23.436468381900738
Task_30747,2819,125,26,56,82,22.373015873015873,50.01584461361984
Task_30748,2212,206,39,174,213,10.68599033816425,42.75061222241368
Task_30749,1674,855,115,29,144,1.955607476635514,35.19442306366904
Task_30750,2022,162,28,147,175,12.404907975460123,39.03979370191302
Task_30751,1971,700,60,129,189,2.81169757489301,40.45320543733168
Task_30752,1346,501,179,131,310,2.681274900398406,30.411010235559488
Task_30753,839,546,199,132,331,1.5338208409506398,22.57843902559539
Task_30754,2258,637,81,55,136,3.5391849529780566,43.98986921506245
Task_30755,2289,511,155,80,235,4.470703125,44.85997210869224
Task_30756,1301,325,43,129,172,3.9907975460122698,28.494995039172863
Task_30757,2669,703,149,84,233,3.7911931818181817,51.51067889819638
Task_30758,2549,150,162,61,223,16.880794701986755,47.18492364198181
Task_30759,1700,946,100,17,117,1.7951425554382259,35.4805972801371
Task_30760,690,852,47,128,175,0.8089097303634232,20.458779593833572
Task_30761,2534,740,89,162,251,3.4197031039136303,49.73788590094572
Task_30762,1749,941,176,158,334,1.856687898089172,38.3176297997473
Task_30763,1667,119,185,148,333,13.891666666666667,34.001845958745555
Task_30764,2482,348,163,51,214,7.111747851002866,47.026918275394955
Task_30765,2613,240,77,197,274,10.842323651452283,49.579400663366215
Task_30766,1080,258,13,190,203,4.1698841698841695,25.001030531638193
Task_30767,1133,416,110,32,142,2.7170263788968825,25.22796138868752
Task_30768,1741,293,194,11,205,5.921768707482993,34.765008395564024
Task_30769,2040,904,99,45,144,2.25414364640884,41.126383111859305
Task_30770,1313,703,25,121,146,1.8650568181818181,29.57360628030524
Task_30771,2969,92,49,69,118,31.9247311827957,52.50444784292832
Task_30772,2758,561,132,176,308,4.907473309608541,53.01567151855647
Task_30773,1812,592,152,151,303,3.0556492411467118,38.074800714697645
Task_30774,2354,401,145,148,293,5.855721393034826,45.991461252426745
Task_30775,1500,899,11,182,193,1.6666666666666667,33.58872914181294
Task_30776,647,130,35,193,228,4.938931297709924,17.57922887093528
Task_30777,1107,648,46,138,184,1.7057010785824345,26.512159826207682
Task_30778,953,698,69,135,204,1.363376251788269,24.349480071857176
Task_30779,859,950,140,84,224,0.9032597266035752,23.55353854041745
Task_30780,1286,367,35,157,192,3.494565217391304,28.55481509523003
Task_30781,2946,893,97,52,149,3.295302013422819,55.80916452975194
Task_30782,1020,198,60,133,193,5.125628140703518,23.857203914834656
Task_30783,2730,953,52,29,81,2.861635220125786,51.596250470774926
Task_30784,2174,871,129,45,174,2.493119266055046,43.41004372145576
Task_30785,828,900,187,56,243,0.9189789123196448,22.814674916289643
Task_30786,2238,158,114,32,146,14.075471698113208,41.60947605270451
Task_30787,749,236,87,104,191,3.160337552742616,19.502751822402043
Task_30788,567,354,162,156,318,1.5971830985915494,17.678168238666924
Task_30789,1790,310,37,45,82,5.755627009646302,34.672579864272926
Task_30790,1495,69,161,88,249,21.357142857142858,30.370944571103667
Task_30791,2609,266,129,195,324,9.771535580524345,49.768248201800304
Task_30792,1490,906,54,105,159,1.6427783902976847,33.09760309513592
Task_30793,2498,559,134,108,242,4.460714285714285,48.495086377634124
Task_30794,2813,305,41,92,133,9.19281045751634,52.00937895701924
Task_30795,2145,123,77,134,211,17.298387096774192,41.06479189495031
Task_30796,1956,238,197,18,215,8.184100418410042,38.01941973681353
Task_30797,1339,795,73,141,214,1.6821608040201006,30.848376423720868
Task_30798,2762,733,162,65,227,3.7629427792915533,52.836600768790355
Task_30799,2445,96,30,62,92,25.20618556701031,43.85978963055222
Task_30800,1523,265,43,79,122,5.725563909774436,31.2944843535023
Task_30801,618,850,34,87,121,0.7262044653349001,18.870031180156804
Task_30802,2101,474,59,180,239,4.423157894736842,42.098693678545295
Task_30803,2254,677,164,193,357,3.3244837758112094,45.64827457051917
Task_30804,2992,109,182,124,306,27.2,54.53908724543685
Task_30805,1809,383,73,53,126,4.7109375,36.06244430797923
Task_30806,587,587,22,98,120,0.9982993197278912,17.394227041057842
Task_30807,1735,175,173,156,329,9.857954545454545,35.36480176311865
Task_30808,888,684,143,73,216,1.2963503649635038,22.97104843904567
Task_30809,508,638,13,67,80,0.7949921752738655,15.751513690970162
Task_30810,700,297,152,34,186,2.348993288590604,18.317989335089916
Task_30811,2339,772,111,64,175,3.0258732212160413,45.9799951581062
Task_30812,1539,648,27,13,40,2.3713405238828966,31.120919663435387
Task_30813,1497,932,99,114,213,1.6045016077170418,33.674911398849964
Task_30814,2225,675,191,31,222,3.2914201183431953,43.8350234897419
Task_30815,1845,757,17,102,119,2.4340369393139842,37.89375786254481
Task_30816,2376,462,73,51,124,5.1317494600431965,45.11749743391503
Task_30817,569,91,147,65,212,6.184782608695652,15.409880119640016
Task_30818,965,892,16,155,171,1.0806270996640537,24.822395849083094
Task_30819,1837,302,191,125,316,6.0627062706270625,37.55262804438975
Task_30820,1758,507,38,114,152,3.4606299212598426,36.00500198995757
Task_30821,1050,699,182,136,318,1.5,26.34382951680735
Task_30822,1003,370,58,125,183,2.7035040431266846,24.01768147498788
Task_30823,1176,662,12,144,156,1.7737556561085972,27.309253227254242
Task_30824,2002,988,35,113,148,2.024266936299292,41.401675020839775
Task_30825,1653,642,28,21,49,2.5707620528771384,33.09260675875711
Task_30826,1277,960,140,85,225,1.3288241415192508,30.179050533486656
Task_30827,2717,879,60,166,226,3.0875,53.05707849161987
Task_30828,1862,295,120,174,294,6.29054054054054,37.896755727540985
Task_30829,1087,458,29,111,140,2.3681917211328978,25.18274611805879
Task_30830,906,713,136,180,316,1.26890756302521,24.1433419580647
Task_30831,1852,615,64,195,259,3.0064935064935066,38.717276107784855
Task_30832,1141,215,113,123,236,5.282407407407407,25.893364144125666
Task_30833,1079,263,103,77,180,4.087121212121212,24.569150239119008
Task_30834,1522,361,71,71,142,4.204419889502763,31.646210168562174
Task_30835,1607,874,157,16,173,1.8365714285714285,34.321051997899964
Task_30836,1230,320,58,93,151,3.8317757009345796,27.118055555822593
Task_30837,716,742,136,51,187,0.9636608344549125,20.261152763248244
Task_30838,1061,860,169,150,319,1.232288037166086,27.020987826069998
Task_30839,2901,930,97,189,286,3.1160042964554244,56.374683694891836
Task_30840,1705,536,139,86,225,3.175046554934823,35.69021955201675
Task_30841,1271,424,47,107,154,2.9905882352941178,28.05869644094574
Task_30842,2242,960,112,60,172,2.3329864724245577,44.963305339871795
Task_30843,2165,155,177,35,212,13.878205128205128,40.88740009990328
Task_30844,1802,487,102,149,251,3.692622950819672,37.345924346899444
Task_30845,1924,830,66,159,225,2.3152827918170877,40.3326339466961
Task_30846,2692,961,119,27,146,2.7983367983367984,51.69406926264424
Task_30847,2445,431,70,68,138,5.659722222222222,46.429278972745
Task_30848,1901,814,90,110,200,2.3325153374233127,39.65073275930539
Task_30849,526,406,141,75,216,1.2923832923832923,16.41802688862844
Task_30850,2481,267,146,176,322,9.257462686567164,47.712116427021726
Task_30851,2706,777,53,191,244,3.4781491002570695,52.683186993716845
Task_30852,1316,693,31,45,76,1.8962536023054755,28.04463613469898
Task_30853,2342,507,190,53,243,4.610236220472441,45.530194850721955
Task_30854,983,120,21,93,114,8.12396694214876,21.592563642399814
Task_30855,1395,237,167,128,295,5.861344537815126,30.254299160701162
Task_30856,2556,584,64,96,160,4.369230769230769,49.03240139108615
Task_30857,904,682,119,79,198,1.3235724743777453,23.25230150968807
Task_30858,1336,597,143,195,338,2.234113712374582,30.774679848932195
Task_30859,1581,227,69,157,226,6.934210526315789,32.96109592632592
Task_30860,839,495,85,169,254,1.6915322580645162,22.161619482278976
Task_30861,1401,303,77,165,242,4.608552631578948,30.454486034863223
Task_30862,1930,953,77,163,240,2.0230607966457024,40.873685810165554
Task_30863,1135,182,173,133,306,6.202185792349726,25.933555983075745
Task_30864,1503,153,151,83,234,9.75974025974026,31.000032332564796
Task_30865,763,217,73,61,134,3.5,19.028712866322845
Task_30866,689,363,175,122,297,1.8928571428571428,19.505387357075367
Task_30867,2821,641,108,107,215,4.394080996884735,53.74883978548193
Task_30868,1637,435,78,21,99,3.7545871559633026,32.70801733286057
Task_30869,2352,179,187,144,331,13.066666666666666,45.09366841358044
Task_30870,1584,407,38,14,52,3.8823529411764706,31.197936536374755
Task_30871,2742,747,110,157,267,3.665775401069519,53.1408059604125
Task_30872,1035,640,10,196,206,1.6146645865834632,25.495935959913833
Task_30873,1907,976,152,40,192,1.9518935516888434,39.60596463795457
Task_30874,1620,183,188,95,283,8.804347826086957,33.477096418557146
Task_30875,2019,384,46,174,220,5.244155844155844,40.37762485347219
Task_30876,1338,470,63,139,202,2.840764331210191,29.77834588458863
Task_30877,2673,596,80,39,119,4.477386934673367,49.871717934272546
Task_30878,2764,802,87,89,176,3.4420921544209215,53.0588758684008
Task_30879,2665,672,43,29,72,3.959881129271917,49.37985496944689
Task_30880,925,80,170,24,194,11.419753086419753,20.522002469917695
Task_30881,1365,731,71,35,106,1.8647540983606556,29.504975509425723
Task_30882,2033,247,20,186,206,8.19758064516129,40.03773164672366
Task_30883,2475,953,22,109,131,2.5943396226415096,48.706579988450834
Task_30884,1939,527,152,62,214,3.672348484848485,39.028268677042774
Task_30885,2860,270,12,36,48,10.55350553505535,51.00866453968501
Task_30886,1714,615,180,118,298,2.7824675324675323,36.524375139343945
Task_30887,2458,118,104,146,250,20.65546218487395,46.05134669441347
Task_30888,2016,891,19,96,115,2.2600896860986546,41.05745751124632
Task_30889,2813,457,116,61,177,6.141921397379913,52.44085439726285
Task_30890,2960,819,102,23,125,3.6097560975609757,55.20914802543172
Task_30891,1597,414,13,32,45,3.8481927710843373,31.49578215213931
Task_30892,2095,615,67,164,231,3.4009740259740258,42.39830024437343
Task_30893,1080,623,24,191,215,1.7307692307692308,26.215491512033793
Task_30894,2185,95,159,36,195,22.760416666666668,40.402472044683165
Task_30895,2474,1024,60,83,143,2.4136585365853658,49.01141487985392
Task_30896,2871,700,58,59,117,4.095577746077033,53.595093209618966
Task_30897,2611,874,21,43,64,2.984,49.14685408129969
Task_30898,1055,873,146,19,165,1.2070938215102975,25.60377451390012
Task_30899,2543,718,152,135,287,3.536856745479833,49.95484803661884
Task_30900,1262,941,48,200,248,1.3397027600849256,30.276776632372385
Task_30901,1228,99,86,65,151,12.28,25.224796496908144
Task_30902,1969,827,133,50,183,2.3780193236714977,40.16145113995762
Task_30903,2086,672,175,161,336,3.099554234769688,42.82993592051148
Task_30904,1996,988,53,49,102,2.018200202224469,40.248482251337556
Task_30905,2964,872,192,113,305,3.395189003436426,57.15779985307557
Task_30906,2298,882,45,93,138,2.6024915062287657,45.72761805555705
Task_30907,1139,803,113,17,130,1.4166666666666667,26.34655502408721
Task_30908,624,447,10,12,22,1.3928571428571428,15.884722067272756
Task_30909,1835,989,70,14,84,1.8535353535353536,37.51474701254656
Task_30910,1867,362,108,109,217,5.143250688705234,37.75785966537743
Task_30911,1412,1019,139,90,229,1.384313725490196,32.56473506579232
Task_30912,623,917,122,126,248,0.6786492374727668,20.05494732020858
Task_30913,2238,411,131,95,226,5.432038834951456,43.822617865725725
Task_30914,1854,868,146,125,271,2.1334867663981587,39.42203632377533
Task_30915,523,697,180,39,219,0.7492836676217765,16.954419272639242
Task_30916,857,909,56,175,231,0.9417582417582417,23.619888806983585
Task_30917,876,304,113,25,138,2.8721311475409834,20.712912957831396
Task_30918,2118,239,81,163,244,8.825,41.557321396990936
Task_30919,2030,305,199,64,263,6.633986928104576,40.009170911528024
Task_30920,1068,957,200,101,301,1.11482254697286,27.265374690769715
Task_30921,2367,967,80,47,127,2.4452479338842976,46.40193268488276
Task_30922,2667,612,62,148,210,4.350734094616639,51.32215763264971
Task_30923,1077,794,110,179,289,1.3547169811320754,26.994762881197335
Task_30924,1697,870,109,144,253,1.9483352468427095,36.88737193955507
Task_30925,1449,897,67,101,168,1.6135857461024499,32.60846622101733
Task_30926,1236,315,81,36,117,3.911392405063291,26.20364437215863
Task_30927,1707,371,173,133,306,4.588709677419355,35.69253650068641
Task_30928,647,670,148,167,315,0.9642324888226528,19.911225322642036
Task_30929,929,375,139,93,232,2.470744680851064,22.988365817721398
Task_30930,2706,905,170,76,246,2.986754966887417,52.681326421105815
Task_30931,570,500,160,130,290,1.1377245508982037,17.962337829160578
Task_30932,840,565,180,190,370,1.4840989399293287,22.91431559638087
Task_30933,828,331,71,63,134,2.4939759036144578,20.496439940074662
Task_30934,2318,987,96,44,140,2.3461538461538463,45.78162537258165
Task_30935,634,250,148,86,234,2.5258964143426295,17.87240063924768
Task_30936,1161,376,148,29,177,3.079575596816976,25.820459169073555
Task_30937,2820,854,137,104,241,3.2982456140350878,54.51808381662831
Task_30938,934,709,152,111,263,1.315492957746479,24.248727333607064
Task_30939,2104,431,149,96,245,4.87037037037037,41.86928747765668
Task_30940,2137,320,193,98,291,6.657320872274143,42.21272161586479
Task_30941,2914,1019,51,86,137,2.8568627450980393,55.947471170334246
Task_30942,1783,1009,118,127,245,1.7653465346534654,38.6075336682131
Task_30943,1662,828,163,110,273,2.004825090470446,36.24241808175544
Task_30944,1446,110,194,25,219,13.027027027027026,29.15680553194674
Task_30945,1563,807,87,187,274,1.9344059405940595,34.68617882695711
Task_30946,1949,638,118,42,160,3.0500782472613457,38.93837986652727
Task_30947,2264,672,173,82,255,3.364041604754829,45.097308547941736
Task_30948,620,228,79,155,234,2.7074235807860263,17.807292473223633
Task_30949,1531,926,112,170,282,1.651564185544768,34.5864406296056
Task_30950,547,167,108,83,191,3.255952380952381,15.788489231975994
Task_30951,2033,1019,104,18,122,1.9931372549019608,41.03553018343314
Task_30952,500,227,125,158,283,2.192982456140351,16.074012517825583
Task_30953,2769,815,130,178,308,3.3933823529411766,53.998092596679555
Task_30954,1821,224,17,169,186,8.093333333333334,36.43403756066127
Task_30955,2064,775,178,95,273,2.6597938144329896,42.43743316363377
Task_30956,1850,552,27,105,132,3.3453887884267632,37.55422929798403
Task_30957,2138,644,176,109,285,3.314728682170543,43.25921299432414
Task_30958,2648,739,140,122,262,3.5783783783783782,51.552636142961184
Task_30959,1633,295,34,37,71,5.516891891891892,31.81688186475253
Task_30960,1159,315,28,159,187,3.6677215189873418,26.320281140150566
Task_30961,2192,247,69,12,81,8.838709677419354,40.80661173361111
Task_30962,2628,106,168,164,332,24.560747663551403,48.96920324536557
Task_30963,625,187,176,16,192,3.324468085106383,16.78391030311048
Task_30964,556,314,79,126,205,1.765079365079365,16.8847569211412
Task_30965,1894,525,130,165,295,3.6007604562737643,39.145377513572605
Task_30966,1304,690,60,77,137,1.8871201157742403,29.28673475117588
Task_30967,2728,375,130,27,157,7.25531914893617,50.38884029116204
Task_30968,1852,926,155,160,315,1.9978425026968716,39.82043895864877
Task_30969,943,844,60,195,255,1.1159763313609468,24.92467163006164
Task_30970,662,145,120,51,171,4.534246575342466,16.97482596361284
Task_30971,1613,214,55,95,150,7.502325581395349,32.83163570287373
Task_30972,1125,829,50,58,108,1.355421686746988,26.202369489246276
Task_30973,617,520,172,170,342,1.1842610364683301,19.070769830572065
Task_30974,2429,920,112,135,247,2.6373507057546144,48.60160920517158
Task_30975,1228,297,29,102,131,4.120805369127517,26.89467736395362
Task_30976,1415,359,141,82,223,3.9305555555555554,30.5140585536638
Task_30977,2806,342,165,178,343,8.180758017492712,53.21270737160605
Task_30978,864,218,43,54,97,3.9452054794520546,20.08006800850597
Task_30979,2417,1018,52,103,155,2.3719332679097156,48.135173775214376
Task_30980,2376,268,169,14,183,8.83271375464684,44.58748134899869
Task_30981,2611,761,87,94,181,3.426509186351706,50.55647231963932
Task_30982,560,72,35,150,185,7.671232876712328,15.605179143681562
Task_30983,1930,411,198,126,324,4.684466019417476,39.422310330581205
Task_30984,1983,136,88,74,162,14.474452554744525,37.72758986759378
Task_30985,1210,648,88,112,200,1.8644067796610169,28.153785831552472
Task_30986,2407,833,197,118,315,2.886091127098321,48.26270945777827
Task_30987,1107,203,168,152,320,5.426470588235294,25.735961131113797
Task_30988,1670,428,119,82,201,3.8927738927738926,34.6727097860745
Task_30989,1875,564,107,164,271,3.3185840707964602,38.85873398757656
Task_30990,2262,794,129,28,157,2.8452830188679243,44.37490624339324
Task_30991,2780,456,116,53,169,6.083150984682713,51.9343020817058
Task_30992,2436,829,198,191,389,2.9349397590361446,49.150192546087
Task_30993,806,980,49,163,212,0.8216106014271152,22.96272717930972
Task_30994,500,823,164,26,190,0.6067961165048543,17.122838784203946
Task_30995,1135,635,98,60,158,1.7845911949685536,26.268580795635803
Task_30996,837,208,131,179,310,4.0047846889952154,21.48528218858324
Task_30997,701,964,85,182,267,0.7264248704663212,21.571944614659042
Task_30998,1946,507,131,48,179,3.8307086614173227,38.720233832317476
Task_30999,639,896,83,123,206,0.7123745819397993,20.05809003352238
Task_31000,2410,387,142,131,273,6.211340206185567,46.71605976341789
Task_31001,1196,708,177,130,307,1.68688293370945,28.65545207022249
Task_31002,1881,352,21,54,75,5.328611898016997,36.14852322606398
Task_31003,1266,1010,134,127,261,1.2522255192878338,30.43873172170379
Task_31004,1401,331,198,98,296,4.219879518072289,30.632462743730212
Task_31005,1634,861,44,116,160,1.8955916473317866,35.23163357392544
Task_31006,2642,671,146,132,278,3.931547619047619,51.32954159394834
Task_31007,1051,637,155,32,187,1.6473354231974922,24.94792057834672
Task_31008,1889,439,107,151,258,4.293181818181818,38.60339046150147
Task_31009,2764,442,86,127,213,6.239277652370204,52.184171874507065
Task_31010,1482,687,38,121,159,2.1540697674418605,32.2747647283232
Task_31011,808,986,56,17,73,0.8186423505572442,20.88486502670315
Task_31012,1647,372,120,170,290,4.415549597855228,34.728697103112154
Task_31013,2827,594,109,152,261,4.751260504201681,53.96713791427684
Task_31014,1708,571,22,131,153,2.986013986013986,35.41330531654248
Task_31015,1997,189,84,22,106,10.510526315789473,37.77202954363069
Task_31016,1353,402,164,172,336,3.357320099255583,30.384223270930416
Task_31017,2160,712,140,192,332,3.02945301542777,44.15531670781812
Task_31018,2802,99,10,30,40,28.02,48.88655534610399
Task_31019,2554,921,131,47,178,2.770065075921909,49.64100934490485
Task_31020,2982,366,65,111,176,8.125340599455042,55.27230251506532
Task_31021,1757,253,34,15,49,6.917322834645669,33.41079238863181
Task_31022,1486,403,109,70,179,3.6782178217821784,31.32995017474106
Task_31023,1696,949,165,45,210,1.7852631578947369,36.25177834093985
Task_31024,2492,270,86,83,169,9.195571955719558,46.91830453164878
Task_31025,2402,921,140,70,210,2.6052060737527114,47.63712338340653
Task_31026,1980,879,79,177,256,2.25,41.52137713202176
Task_31027,1009,270,138,133,271,3.7232472324723247,24.165581648686693
Task_31028,626,115,41,144,185,5.396551724137931,16.8059193746068
Task_31029,2341,69,143,112,255,33.44285714285714,43.780285111733
Task_31030,2396,843,31,173,204,2.838862559241706,47.69752539844171
Task_31031,2857,361,116,114,230,7.892265193370166,53.48156814749135
Task_31032,1984,979,69,41,110,2.024489795918367,40.14331307392478
Task_31033,2604,851,139,127,266,3.056338028169014,51.23269975993761
Task_31034,527,970,199,88,287,0.5427394438722966,18.769199865707233
Task_31035,847,75,197,102,299,11.144736842105264,20.584066633176516
Task_31036,1117,926,156,168,324,1.2049622437971952,28.166397023313177
Task_31037,2915,253,81,98,179,11.476377952755906,53.79598922270525
Task_31038,966,399,25,31,56,2.415,21.549796311565824
Task_31039,974,79,185,116,301,12.175,22.620710557910414
Task_31040,855,894,96,122,218,0.9553072625698324,23.405383678985668
Task_31041,2343,421,106,115,221,5.552132701421801,45.5103758442987
Task_31042,1792,922,112,166,278,1.9414951245937162,38.699291975293804
Task_31043,637,128,145,68,213,4.937984496124031,16.8619039226328
Task_31044,1623,849,178,142,320,1.9094117647058824,35.94859719084342
Task_31045,2598,129,107,153,260,19.984615384615385,48.41312507494526
Task_31046,2814,593,91,88,179,4.737373737373737,53.21451894622825
Task_31047,1621,979,89,189,278,1.6540816326530612,36.165846165138156
Task_31048,1889,297,112,135,247,6.3389261744966445,38.06143746028479
Task_31049,643,814,64,116,180,0.7889570552147239,19.659637032046167
Task_31050,1073,850,173,166,339,1.2608695652173914,27.29702582094197
Task_31051,1820,1022,134,146,280,1.7790811339198436,39.419820038180994
Task_31052,1085,611,143,167,310,1.772875816993464,26.66277282721734
Task_31053,1032,560,37,147,184,1.839572192513369,25.07008103938269
Task_31054,567,988,181,152,333,0.5733063700707786,19.80642769531781
Task_31055,1718,655,86,49,135,2.6189024390243905,35.31100124346471
Task_31056,2602,922,85,64,149,2.819068255687974,50.47733254115719
Task_31057,2105,339,94,44,138,6.1911764705882355,40.36234446290999
Task_31058,1963,288,55,56,111,6.7923875432525955,37.78342052044322
Task_31059,2933,331,72,54,126,8.83433734939759,53.63362037669676
Task_31060,673,537,137,117,254,1.2509293680297398,19.53123969222521
Task_31061,1507,764,57,103,160,1.969934640522876,32.93940818502154
Task_31062,1718,974,17,158,175,1.7620512820512821,37.1348570787137
Task_31063,2345,355,132,27,159,6.587078651685394,44.27142511645957
Task_31064,1304,999,45,42,87,1.304,29.23133722698041
Task_31065,2634,524,152,161,313,5.017142857142857,50.93371687317538
Task_31066,1361,473,91,111,202,2.871308016877637,30.043111599995726
Task_31067,1602,793,151,196,347,2.017632241813602,35.64240013678174
Task_31068,1041,861,20,146,166,1.2076566125290022,25.95754840385065
Task_31069,2454,65,108,40,148,37.18181818181818,43.8181110759082
Task_31070,1422,578,14,15,29,2.4559585492227978,28.984310538868005
Task_31071,532,454,71,79,150,1.1692307692307693,16.390009628520776
Task_31072,1204,295,193,150,343,4.0675675675675675,27.679715986831642
Task_31073,2340,908,138,23,161,2.5742574257425743,45.95878037757507
Task_31074,678,81,122,30,152,8.268292682926829,16.31111239607084
Task_31075,1765,976,97,104,201,1.8065506653019447,38.00895902552049
Task_31076,1426,925,21,74,95,1.5399568034557236,31.32901564886068
Task_31077,2335,719,96,153,249,3.2430555555555554,46.52590393898077
Task_31078,2754,672,30,181,211,4.092124814264487,52.87978059708427
Task_31079,2561,307,126,194,320,8.314935064935066,49.13636727114715
Task_31080,2595,128,143,41,184,20.11627906976744,47.25202260712506
Task_31081,523,812,161,34,195,0.6432964329643296,17.46438282273044
Task_31082,743,182,60,54,114,4.060109289617486,18.23848104385457
Task_31083,1175,295,124,44,168,3.9695945945945947,25.715595440154434
Task_31084,543,372,133,163,296,1.4557640750670242,17.22574079621821
Task_31085,2887,294,14,92,106,9.786440677966102,52.737508893219164
Task_31086,1873,1021,46,169,215,1.8326810176125246,40.04455853249263
Task_31087,1265,301,170,117,287,4.188741721854305,28.363119479277163
Task_31088,595,303,183,103,286,1.957236842105263,17.751317319961753
Task_31089,2828,854,10,155,165,3.3076023391812868,54.311297992071864
Task_31090,2891,919,81,71,152,3.142391304347826,55.041996064596766
Task_31091,1640,828,92,162,254,1.9782870928829916,35.8921072193216
Task_31092,1804,676,79,39,118,2.6646971935007384,36.36160235309863
Task_31093,769,502,140,158,298,1.52882703777336,21.2221846797399
Task_31094,665,87,81,31,112,7.556818181818182,15.81993011840865
Task_31095,2359,278,127,110,237,8.455197132616487,45.34346932272524
Task_31096,975,408,68,196,264,2.3838630806845966,24.205712762785605
Task_31097,2986,928,63,94,157,3.2142088266953714,56.89837670130413
Task_31098,1245,1015,165,26,191,1.2253937007874016,29.206551124375594
Task_31099,2022,300,100,130,230,6.717607973421927,40.090500672439426
Task_31100,2851,656,199,112,311,4.339421613394216,54.711722937728815
Task_31101,2574,618,129,27,156,4.158319870759289,48.737557503514694
Task_31102,1798,516,12,19,31,3.4777562862669247,34.750019236146734
Task_31103,2223,639,44,157,201,3.4734375,44.29810033269314
Task_31104,1520,551,79,30,109,2.753623188405797,31.418657428429185
Task_31105,1725,284,153,80,233,6.052631578947368,35.181324240775005
Task_31106,1203,162,191,182,373,7.380368098159509,27.200113657618786
Task_31107,1490,82,96,101,197,17.951807228915662,30.222639780939357
Task_31108,1911,281,67,194,261,6.776595744680851,38.57839665289048
Task_31109,718,364,69,36,105,1.9671232876712328,18.105520818149824
Task_31110,1234,637,157,65,222,1.9341692789968652,28.30930098090729
Task_31111,2242,411,130,124,254,5.441747572815534,44.04114575969339
Task_31112,1490,364,164,79,243,4.082191780821918,31.771452012272146
Task_31113,2779,947,102,124,226,2.931434599156118,54.12121270854764
Task_31114,1586,432,133,115,248,3.6628175519630486,33.68752421456451
Task_31115,526,192,160,155,315,2.7253886010362693,16.50950964539379
Task_31116,962,807,129,73,202,1.1905940594059405,24.46252839619476
Task_31117,2723,341,54,100,154,7.961988304093567,50.77696917894494
Task_31118,678,335,114,61,175,2.017857142857143,18.254550095812068
Task_31119,2118,385,36,141,177,5.487046632124352,41.66378989534174
Task_31120,1629,175,182,174,356,9.255681818181818,33.840907391739876
Task_31121,1046,266,34,73,107,3.9176029962546814,23.468415238011506
Task_31122,510,179,77,133,210,2.8333333333333335,15.531481159911285
Task_31123,2192,228,113,139,252,9.572052401746724,42.633147338443365
Task_31124,709,981,97,134,231,0.7219959266802444,21.532281347416134
Task_31125,1364,564,122,98,220,2.4141592920353983,30.44800935935479
Task_31126,2474,317,61,79,140,7.779874213836478,46.70238903737837
Task_31127,2195,453,175,141,316,4.834801762114537,43.738678168921886
Task_31128,2244,821,81,172,253,2.72992700729927,45.49565389078333
Task_31129,2866,212,179,192,371,13.455399061032864,53.82834090635905
Task_31130,2428,567,14,134,148,4.274647887323944,46.822445617872994
Task_31131,1127,335,66,180,246,3.3541666666666665,26.27674037534544
Task_31132,2403,631,144,145,289,3.8022151898734178,47.48599237268894
Task_31133,697,286,15,114,129,2.4285714285714284,18.482982921064238
Task_31134,1925,849,90,81,171,2.264705882352941,39.79806040200371
Task_31135,2294,837,120,147,267,2.7374701670644392,46.31102974886662
Task_31136,1846,923,60,82,142,1.9978354978354977,38.75544343719463
Task_31137,923,618,88,124,212,1.4911147011308563,23.541196939350062
Task_31138,1375,585,29,14,43,2.34641638225256,28.359822681566346
Task_31139,2836,317,140,134,274,8.918238993710691,53.22460625609259
Task_31140,1429,635,115,46,161,2.24685534591195,30.727612988351463
Task_31141,2977,124,56,105,161,23.816,53.513021849936884
Task_31142,2082,452,123,135,258,4.596026490066225,41.676663618334466
Task_31143,2035,291,59,17,76,6.969178082191781,37.94918331696628
Task_31144,1375,822,14,74,88,1.6707168894289186,30.20868128247319
Task_31145,1286,946,113,19,132,1.3579725448785638,29.21094875523133
Task_31146,2896,309,81,190,271,9.341935483870968,54.26696972734351
Task_31147,702,634,108,130,238,1.105511811023622,20.239460901652958
Task_31148,2770,940,78,128,206,2.9436769394261426,53.939392499846456
Task_31149,1438,210,136,131,267,6.815165876777251,30.716543998138764
Task_31150,944,324,197,146,343,2.9046153846153846,23.657029333879063
Task_31151,2685,70,97,35,132,37.816901408450704,47.39499622891204
Task_31152,1463,657,63,23,86,2.223404255319149,30.523727489367023
Task_31153,2582,97,154,47,201,26.346938775510203,46.67710271604173
Task_31154,2167,609,81,71,152,3.5524590163934424,42.597508219644176
Task_31155,762,436,199,130,329,1.7437070938215102,21.032751794960568
Task_31156,730,887,190,115,305,0.8220720720720721,21.779811866836386
Task_31157,1465,421,197,156,353,3.471563981042654,32.27065404175142
Task_31158,1130,109,49,10,59,10.272727272727273,22.733305064359353
Task_31159,2990,1018,38,104,142,2.9342492639842983,57.095008666088155
Task_31160,2789,788,141,53,194,3.534854245880862,53.28113601146777
Task_31161,2271,847,183,61,244,2.678066037735849,45.41943685996237
Task_31162,822,1015,61,90,151,0.8090551181102362,22.788291670675573
Task_31163,1741,152,109,189,298,11.379084967320262,35.31840389599507
Task_31164,518,944,75,84,159,0.5481481481481482,17.933256933385525
Task_31165,2643,848,147,182,329,3.1130742049469964,52.20579791215872
Task_31166,1961,746,69,150,219,2.6251673360107093,40.61113258260965
Task_31167,1525,880,56,130,186,1.7309875141884223,33.893475852514335
Task_31168,1986,357,90,104,194,5.5474860335195535,39.50713923975104
Task_31169,2595,204,100,57,157,12.658536585365853,47.923184167917704
Task_31170,2445,803,88,106,194,3.041044776119403,48.1666383685126
Task_31171,2828,888,137,196,333,3.1811023622047245,55.30090789772142
Task_31172,1620,178,58,50,108,9.050279329608939,31.462224683228488
Task_31173,1678,239,180,95,275,6.991666666666666,34.60678143940377
Task_31174,1514,576,36,119,155,2.6239168110918545,32.42630856990288
Task_31175,537,265,196,81,277,2.018796992481203,16.53649658742638
Task_31176,626,385,111,55,166,1.621761658031088,17.61039331182198
Task_31177,1108,997,167,70,237,1.1102204408817635,27.459942988257907
Task_31178,1775,749,154,86,240,2.3666666666666667,37.53601451839635
Task_31179,1722,182,108,175,283,9.40983606557377,35.15240548572
Task_31180,503,646,100,94,194,0.7774343122102009,16.93237641764757
Task_31181,1207,338,43,111,154,3.56047197640118,26.754261499949834
Task_31182,1094,291,148,72,220,3.7465753424657535,25.038283701478193
Task_31183,1308,610,88,132,220,2.1407528641571196,29.706579403467487
Task_31184,2252,425,34,23,57,5.286384976525822,41.98402419287341
Task_31185,876,638,122,17,139,1.3708920187793427,21.70280286604274
Task_31186,2589,527,74,130,204,4.903409090909091,49.75475952787669
Task_31187,2928,293,48,156,204,9.959183673469388,54.37038528601451
Task_31188,2624,727,67,200,267,3.6043956043956045,51.34597930001224
Task_31189,1971,136,94,51,145,14.386861313868613,37.339363768178565
Task_31190,2155,128,103,195,298,16.705426356589147,41.667307171823126
Task_31191,996,390,199,132,331,2.547314578005115,24.61589026442232
Task_31192,2500,376,176,105,281,6.63129973474801,48.101210597204066
Task_31193,2769,567,149,31,180,4.875,51.91317558345483
Task_31194,1793,136,120,168,288,13.087591240875913,35.92311288597297
Task_31195,1280,156,158,161,319,8.152866242038217,28.12376050709621
Task_31196,1266,296,114,177,291,4.262626262626263,28.468423982057345
Task_31197,893,80,105,68,173,11.024691358024691,20.173769836903585
Task_31198,672,726,106,155,261,0.9243466299862448,20.226799660384838
Task_31199,1005,405,22,134,156,2.4753694581280787,23.81489474367621
Task_31200,2268,402,146,191,337,5.6277915632754345,44.89527149243474
Task_31201,2417,889,173,115,288,2.715730337078652,48.470155212318296
Task_31202,2184,437,16,10,26,4.986301369863014,40.58689436637149
Task_31203,773,84,134,200,334,9.094117647058823,19.763672489748398
Task_31204,689,339,31,95,126,2.026470588235294,18.525227703448845
Task_31205,2501,776,125,43,168,3.2187902187902186,48.24668645844853
Task_31206,1434,664,196,110,306,2.156390977443609,32.26768177736727
Task_31207,1852,694,58,39,97,2.664748201438849,36.9191717313444
Task_31208,1466,245,31,34,65,5.959349593495935,28.940479249602983
Task_31209,1767,639,121,45,166,2.7609375,36.22292634769802
Task_31210,1415,680,98,35,133,2.077826725403818,30.4921488705473
Task_31211,1090,906,181,75,256,1.2017640573318633,27.08484726700029
Task_31212,1082,200,163,50,213,5.383084577114428,24.269757109187754
Task_31213,1268,605,163,189,352,2.092409240924092,29.777149416706635
Task_31214,2305,966,38,43,81,2.3836608066184075,44.96563525743818
Task_31215,2023,826,105,74,179,2.446191051995163,41.27378187564434
Task_31216,822,161,30,112,142,5.074074074074074,19.627356325678345
Task_31217,2785,315,101,79,180,8.813291139240507,51.78346223974807
Task_31218,2155,419,13,125,138,5.130952380952381,41.94019708407189
Task_31219,1925,978,25,117,142,1.9662921348314606,40.08452082922366
Task_31220,2861,218,175,145,320,13.06392694063927,53.47488557127614
Task_31221,2290,170,124,111,235,13.391812865497077,43.634957456782864
Task_31222,896,470,104,32,136,1.9023354564755839,21.60495497005466
Task_31223,859,292,15,69,84,2.931740614334471,20.251542745689076
Task_31224,1759,455,29,12,41,3.857456140350877,34.02233145575864
Task_31225,779,117,190,104,294,6.601694915254237,19.760761588821705
Task_31226,926,610,190,26,216,1.5155482815057284,22.998627745360526
Task_31227,2530,217,171,120,291,11.605504587155963,48.07684232763853
Task_31228,2745,296,146,143,289,9.242424242424242,51.79220480706922
Task_31229,2881,734,163,16,179,3.919727891156463,54.101716170044845
Task_31230,1210,454,15,178,193,2.659340659340659,27.634646080212153
Task_31231,2920,675,68,34,102,4.319526627218935,53.91622671665135
Task_31232,1834,447,15,198,213,4.09375,37.608363123298524
Task_31233,2365,236,122,74,196,9.978902953586498,44.86955128041925
Task_31234,652,287,192,177,369,2.263888888888889,19.0840233289043
Task_31235,1549,82,165,192,357,18.662650602409638,32.0023746931518
Task_31236,1688,590,164,64,228,2.856175972927242,35.362333947884906
Task_31237,2521,684,168,142,310,3.68029197080292,49.612967808201745
Task_31238,2698,353,189,154,343,7.621468926553672,51.50698192709831
Task_31239,1368,75,111,105,216,18.0,28.370949059523927
Task_31240,756,843,152,84,236,0.8957345971563981,21.649302813074286
Task_31241,524,481,58,10,68,1.0871369294605808,14.68732019186504
Task_31242,1875,108,21,197,218,17.201834862385322,36.648624108158245
Task_31243,2071,498,145,196,341,4.150300601202405,42.11416716203313
Task_31244,2101,374,146,186,332,5.602666666666667,42.130607136322574
Task_31245,1195,353,143,104,247,3.3757062146892656,27.226109494807314
Task_31246,1778,267,186,170,356,6.634328358208955,36.74633247021875
Task_31247,2857,158,191,93,284,17.968553459119498,52.689918678178316
Task_31248,1956,518,55,119,174,3.76878612716763,39.53571166057783
Task_31249,1848,407,86,54,140,4.529411764705882,36.74086717899966
Task_31250,2685,949,157,165,322,2.8263157894736843,53.1306982683577
Task_31251,1958,93,57,70,127,20.829787234042552,36.6582664217029
Task_31252,1898,638,198,25,223,2.9702660406885757,38.488484853930395
Task_31253,1107,271,15,178,193,4.069852941176471,25.41576832077186
Task_31254,795,431,14,182,196,1.8402777777777777,21.013141184368294
Task_31255,1412,803,43,58,101,1.756218905472637,30.611559437058663
Task_31256,2223,392,109,101,210,5.656488549618321,43.44591224899765
Task_31257,861,760,43,34,77,1.1314060446780552,21.19684288205603
Task_31258,2325,657,33,158,191,3.533434650455927,45.916574194524706
Task_31259,1928,683,172,43,215,2.818713450292398,39.13188057515385
Task_31260,2856,209,142,76,218,13.6,52.62694185999349
Task_31261,1771,460,59,148,207,3.841648590021692,36.63894347261654
Task_31262,1901,649,40,97,137,2.9246153846153846,38.70095495304675
Task_31263,1325,485,10,189,199,2.7263374485596708,29.573022541969305
Task_31264,1923,586,110,116,226,3.2759795570698467,39.415296253816
Task_31265,1489,556,46,76,122,2.673249551166966,31.651923033574235
Task_31266,999,275,36,18,54,3.619565217391304,21.573528455947798
Task_31267,1375,826,186,189,375,1.6626360338573156,32.251139759464515
Task_31268,801,245,108,141,249,3.2560975609756095,20.70916596120256
Task_31269,987,98,118,24,142,9.969696969696969,21.13290992072069
Task_31270,901,851,30,75,105,1.057511737089202,22.982248513934454
Task_31271,1548,819,70,18,88,1.8878048780487804,32.448386201024384
Task_31272,770,785,27,118,145,0.9796437659033079,21.187092545942154
Task_31273,671,718,108,181,289,0.933240611961057,20.354866724089298
Task_31274,866,577,70,127,197,1.4982698961937717,22.568117659097975
Task_31275,1966,985,52,109,161,1.9939148073022313,40.94612096918474
Task_31276,2598,339,186,75,261,7.641176470588236,49.215453503918845
Task_31277,1691,310,13,36,49,5.437299035369775,32.715077226651445
Task_31278,1032,653,97,66,163,1.5779816513761469,24.869247491891823
Task_31279,1594,442,24,21,45,3.598194130925508,31.46557201470678
Task_31280,1664,390,187,83,270,4.255754475703325,34.76665180920456
Task_31281,1581,246,53,135,188,6.40080971659919,32.81048491865721
Task_31282,721,218,69,79,148,3.2922374429223744,18.7255212772983
Task_31283,1465,327,48,22,70,4.466463414634147,29.149378710688342
Task_31284,2465,378,53,13,66,6.503957783641161,45.000355338271824
Task_31285,2183,606,29,158,187,3.5963756177924218,43.470809516180516
Task_31286,1675,897,75,45,120,1.8652561247216035,35.013618395754214
Task_31287,1440,527,42,191,233,2.727272727272727,31.738915794613032
Task_31288,2601,220,191,119,310,11.76923076923077,49.29391603314726
Task_31289,1479,654,130,185,315,2.2580152671755727,33.09965815529275
Task_31290,1879,219,54,64,118,8.540909090909091,36.50196683861781
Task_31291,2841,429,18,150,168,6.6069767441860465,53.17026164583856
Task_31292,2597,521,78,158,236,4.975095785440613,50.053731446253124
Task_31293,2244,1002,152,170,322,2.23728813559322,46.31481712758123
Task_31294,2020,236,95,92,187,8.523206751054852,39.52815589230459
Task_31295,2934,657,194,196,390,4.458966565349544,56.50872003208165
Task_31296,1646,325,30,20,50,5.049079754601227,31.93116112704615
Task_31297,1709,488,158,185,343,3.494887525562372,36.34429769423502
Task_31298,2735,190,29,12,41,14.319371727748692,48.6712506277081
Task_31299,1103,251,83,178,261,4.376984126984127,25.644508806216418
Task_31300,620,371,109,90,199,1.6666666666666667,17.909330163567002
Task_31301,2610,407,48,36,84,6.397058823529412,47.97333187776734
Task_31302,2166,488,140,40,180,4.429447852760736,42.11569869075051
Task_31303,2701,451,78,74,152,5.975663716814159,50.634181386271074
Task_31304,2475,87,82,31,113,28.125,44.282510839792145
Task_31305,2307,559,147,57,204,4.119642857142857,44.912194927490425
Task_31306,2031,141,193,34,227,14.30281690140845,38.73512201850602
Task_31307,2904,624,104,40,144,4.6464,53.940887360810116
Task_31308,1343,318,197,133,330,4.210031347962382,29.86962113474675
Task_31309,2855,152,181,168,349,18.66013071895425,53.07397190991589
Task_31310,1669,303,155,23,178,5.490131578947368,33.56694058688311
Task_31311,1567,739,188,47,235,2.1175675675675674,33.70275665740017
Task_31312,2978,582,165,109,274,5.108061749571184,56.31545188337302
Task_31313,1243,861,143,52,195,1.4419953596287702,28.996687683591222
Task_31314,811,588,137,68,205,1.3769100169779287,21.346556058748146
Task_31315,1400,815,199,186,385,1.7156862745098038,32.65371701798562
Task_31316,2837,585,183,142,325,4.841296928327645,54.370462435040565
Task_31317,2627,864,27,72,99,3.036994219653179,50.18435728580588
Task_31318,521,856,200,77,277,0.6079346557759626,18.25067055051373
Task_31319,2974,505,158,129,287,5.877470355731226,56.09098825735678
Task_31320,1940,254,62,147,209,7.607843137254902,38.631662286984856
Task_31321,801,847,188,153,341,0.9445754716981132,23.00909918373689
Task_31322,551,942,137,154,291,0.584305408271474,19.239377601258415
Task_31323,1352,384,134,63,197,3.5116883116883115,29.24182653060394
Task_31324,1833,574,116,191,307,3.187826086956522,38.427144272196735
Task_31325,1271,520,148,76,224,2.439539347408829,28.643666499506704
Task_31326,2573,980,152,26,178,2.6228338430173292,50.06145510227238
Task_31327,2894,1006,194,37,231,2.8738828202581925,55.52513640164981
Task_31328,1268,912,162,22,184,1.388828039430449,29.14578791625676
Task_31329,1078,774,43,121,164,1.3909677419354838,26.26114021314427
Task_31330,2504,893,108,180,288,2.80089485458613,49.95646066160714
Task_31331,1987,1019,123,79,202,1.9480392156862745,41.518470299020706
Task_31332,929,352,27,169,196,2.631728045325779,22.870694422297003
Task_31333,841,579,126,163,289,1.45,22.558002947282976
Task_31334,1416,949,28,108,136,1.4905263157894737,31.8484716870833
Task_31335,1271,1019,48,103,151,1.246078431372549,29.859744005756756
Task_31336,1312,800,15,77,92,1.637952559300874,29.183328992914284
Task_31337,606,957,71,79,150,0.6325678496868476,19.35510693415657
Task_31338,724,500,173,101,274,1.4451097804391217,20.300684634013468
Task_31339,2622,323,194,165,359,8.092592592592593,50.28996854474301
Task_31340,2617,558,23,124,147,4.6815742397137745,49.77908839699543
Task_31341,2478,223,155,92,247,11.0625,46.98782775939614
Task_31342,1172,838,110,182,292,1.396901072705602,28.647289095450187
Task_31343,2440,821,93,180,273,2.9683698296836982,48.68803582002818
Task_31344,1722,754,91,114,205,2.280794701986755,36.66098546153168
Task_31345,1628,614,146,176,322,2.6471544715447153,35.35242344621221
Task_31346,1278,549,127,55,182,2.3236363636363637,28.467613558952277
Task_31347,1023,462,64,73,137,2.2095032397408207,24.062638769754273
Task_31348,2627,932,70,99,169,2.8156484458735265,51.39121501946383
Task_31349,1170,483,94,11,105,2.4173553719008263,25.615004034018934
Task_31350,2263,910,145,199,344,2.4840834248079036,46.47105076689437
Task_31351,2063,380,28,79,107,5.414698162729659,40.00544985245377
Task_31352,2903,164,116,52,168,17.593939393939394,52.54653383389486
Task_31353,2472,855,107,170,277,2.8878504672897196,49.266379681377465
Task_31354,2659,290,183,43,226,9.137457044673539,49.469013687714984
Task_31355,2042,287,152,105,257,7.090277777777778,40.4469512994333
Task_31356,2581,422,28,118,146,6.101654846335697,48.75667534432474
Task_31357,1396,594,29,89,118,2.346218487394958,30.306528042315545
Task_31358,2085,581,39,132,171,3.582474226804124,41.69208511786483
Task_31359,575,513,120,126,246,1.1186770428015564,17.86823361341891
Task_31360,2999,735,198,153,351,4.074728260869565,57.54692446561173
Task_31361,2075,479,168,104,272,4.322916666666667,41.670616988491496
Task_31362,2386,886,72,11,83,2.689966178128523,45.928750330219
Task_31363,1482,177,73,45,118,8.325842696629213,29.42390313421504
Task_31364,1984,814,147,120,267,2.434355828220859,41.28802850815584
Task_31365,1146,485,140,51,191,2.3580246913580245,26.226771603738168
Task_31366,654,533,184,89,273,1.2247191011235956,19.224048469010388
Task_31367,614,138,61,141,202,4.41726618705036,16.973632857644937
Task_31368,2989,692,200,115,315,4.313131313131313,57.03434101037144
Task_31369,1626,193,149,21,170,8.381443298969073,32.46309511688481
Task_31370,2294,737,142,157,299,3.1084010840108403,46.156531381274554
Task_31371,2736,928,100,198,298,2.945102260495156,53.81345036368763
Task_31372,1996,86,125,23,148,22.942528735632184,36.91852865170564
Task_31373,1809,635,172,39,211,2.8443396226415096,37.072807352575204
Task_31374,1173,958,71,92,163,1.2231491136600625,28.300817491595023
Task_31375,978,805,44,94,138,1.2133995037220844,24.51153395741518
Task_31376,2306,634,160,28,188,3.631496062992126,44.81012737134995
Task_31377,847,600,177,14,191,1.4093178036605658,21.487753383482993
Task_31378,2514,630,28,129,157,3.9841521394611727,48.425525075058694
Task_31379,1170,412,141,109,250,2.8329297820823243,27.040387228029783
Task_31380,1054,404,25,56,81,2.602469135802469,23.54275971805852
Task_31381,1462,158,182,40,222,9.19496855345912,29.839639474375712
Task_31382,553,800,159,145,304,0.6903870162297129,18.857252879862394
Task_31383,2066,331,151,162,313,6.22289156626506,41.312585468988466
Task_31384,2550,139,91,188,279,18.214285714285715,47.856938230440356
Task_31385,1393,808,115,108,223,1.7218788627935724,31.676567192528278
Task_31386,1654,393,92,25,117,4.197969543147208,33.09240664616783
Task_31387,1264,198,175,109,284,6.351758793969849,28.01147866941748
Task_31388,2295,706,63,97,160,3.246110325318246,45.284321044057435
Task_31389,1528,634,153,154,307,2.4062992125984253,33.731591277030645
Task_31390,2368,987,118,76,194,2.396761133603239,47.344850201997936
Task_31391,2841,222,69,58,127,12.739910313901346,51.787310692557874
Task_31392,1760,162,115,85,200,10.797546012269938,34.955868288530645
Task_31393,2383,1010,153,38,191,2.3570722057368942,47.26088167512771
Task_31394,659,145,122,64,186,4.513698630136986,17.151987262938974
Task_31395,1504,323,193,190,383,4.6419753086419755,32.75453462404102
Task_31396,2795,189,12,163,175,14.710526315789474,51.59171783473056
Task_31397,1797,538,196,68,264,3.333951762523191,37.09264343555757
Task_31398,2253,116,139,35,174,19.256410256410255,41.682883486452106
Task_31399,1781,182,80,140,220,9.73224043715847,35.814038223386746
Task_31400,1745,765,119,137,256,2.2780678851174936,37.323932915890275
Task_31401,563,667,22,179,201,0.842814371257485,18.00643669458781
Task_31402,2866,350,74,70,144,8.165242165242166,52.84948643208312
Task_31403,2032,991,118,45,163,2.0483870967741935,41.483057253690916
Task_31404,2129,860,142,71,213,2.472706155632985,43.171643442678054
Task_31405,1347,858,45,128,173,1.568102444703143,30.877384841174727
Task_31406,740,159,79,159,238,4.625,19.326397519864262
Task_31407,1841,795,180,178,358,2.312814070351759,39.45829763653542
Task_31408,989,371,32,128,160,2.6586021505376345,23.480395725817942
Task_31409,2603,232,143,143,286,11.17167381974249,49.298967014210824
Task_31410,2759,180,111,27,138,15.243093922651934,49.83987190334843
Task_31411,2540,692,40,22,62,3.665223665223665,47.34753862150143
Task_31412,2740,1016,93,104,197,2.6941986234021633,53.596948379409405
Task_31413,2847,194,77,109,186,14.6,52.50329933081847
Task_31414,1054,196,89,97,186,5.350253807106599,24.193199027040027
Task_31415,1922,339,107,185,292,5.652941176470589,39.00099060832461
Task_31416,628,921,112,69,181,0.6811279826464208,19.540198360404688
Task_31417,2007,934,54,101,155,2.146524064171123,41.371694515839465
Task_31418,904,556,70,73,143,1.622980251346499,22.51644706995566
Task_31419,2932,397,140,152,292,7.366834170854271,55.125406631468536
Task_31420,2142,557,153,180,333,3.838709677419355,43.36726952009476
Task_31421,2707,771,82,43,125,3.506476683937824,51.09470333474443
Task_31422,1819,320,150,179,329,5.666666666666667,37.466441800271625
Task_31423,2341,260,30,103,133,8.969348659003831,44.36850879046809
Task_31424,978,404,127,56,183,2.414814814814815,23.266519300470787
Task_31425,669,362,46,142,188,1.8429752066115703,18.744111887151156
Task_31426,2586,367,16,119,135,7.0271739130434785,48.567676576371355
Task_31427,1731,973,130,148,278,1.7772073921971252,37.85128423032592
Task_31428,1909,310,179,199,378,6.138263665594855,39.10607612345785
Task_31429,2150,150,54,148,202,14.23841059602649,41.300932546912605
Task_31430,2232,945,15,200,215,2.3594080338266386,45.49256472680261
Task_31431,1796,290,188,121,309,6.171821305841925,36.82621814979081
Task_31432,1141,859,138,45,183,1.3267441860465117,27.04180720236042
Task_31433,2549,207,77,129,206,12.254807692307692,48.03429335980053
Task_31434,2619,303,116,21,137,8.615131578947368,48.244294050388504
Task_31435,2246,202,27,108,135,11.064039408866995,42.60069218209719
Task_31436,1020,276,45,91,136,3.6823104693140793,23.53626067074703
Task_31437,1627,367,54,42,96,4.421195652173913,32.331644442774646
Task_31438,2165,697,79,184,263,3.1017191977077365,43.92466193744841
Task_31439,857,142,147,51,198,5.993006993006993,20.24838299875879
Task_31440,1678,422,43,71,114,3.966903073286052,34.12426317575332
Task_31441,1973,932,158,97,255,2.114683815648446,41.42205979995867
Task_31442,1375,665,158,183,341,2.0645645645645647,31.601057336236636
Task_31443,1474,333,70,60,130,4.413173652694611,30.625822849913927
Task_31444,978,650,75,140,215,1.5023041474654377,24.661735471313524
Task_31445,1132,679,101,148,249,1.6647058823529413,27.31637254714505
Task_31446,2214,440,52,56,108,5.020408163265306,42.218843471214065
Task_31447,1939,999,53,85,138,1.939,40.41319851014209
Task_31448,2835,590,126,62,188,4.7969543147208125,53.28092722612329
Task_31449,1578,760,140,188,328,2.073587385019711,35.06196185443775
Task_31450,1976,767,60,83,143,2.5729166666666665,40.31886043365238
Task_31451,1795,974,112,18,130,1.841025641025641,37.31474663977276
Task_31452,2782,520,127,176,303,5.339731285988484,53.2409442383194
Task_31453,1392,963,85,70,155,1.4439834024896265,31.367158214531944
Task_31454,1187,228,21,179,200,5.183406113537118,26.56613554856122
Task_31455,778,756,198,186,384,1.0277410832232496,22.565386782106312
Task_31456,857,677,61,74,135,1.2640117994100295,22.154956368478746
Task_31457,2372,706,117,156,273,3.355021216407355,47.17595662715644
Task_31458,1204,207,156,164,320,5.788461538461538,27.298843172010606
Task_31459,2871,169,38,23,61,16.888235294117646,50.828610542013195
Task_31460,688,253,177,84,261,2.7086614173228347,18.84582377745588
Task_31461,921,477,80,147,227,1.9267782426778242,23.310071063014252
Task_31462,1036,356,195,150,345,2.9019607843137254,25.229737778278693
Task_31463,1945,966,45,48,93,2.0113753877973113,39.361886895767476
Task_31464,2344,225,20,172,192,10.371681415929203,44.78554252440623
Task_31465,924,621,171,100,271,1.4855305466237942,23.840859734496252
Task_31466,1577,287,140,111,251,5.475694444444445,33.07793607382461
Task_31467,1339,414,55,78,133,3.2265060240963854,29.07043494689964
Task_31468,2812,181,182,158,340,15.45054945054945,52.45770446475345
Task_31469,1481,367,28,33,61,4.024456521739131,29.57174713672561
Task_31470,1724,630,191,39,230,2.7321711568938194,35.79649484971396
Task_31471,812,717,138,200,338,1.1309192200557103,22.78033511384885
Task_31472,1700,196,115,21,136,8.629441624365482,33.35989301737851
Task_31473,1192,594,98,79,177,2.003361344537815,27.472159470051935
Task_31474,2135,101,13,96,109,20.931372549019606,39.536225266710915
Task_31475,745,371,88,182,270,2.002688172043011,20.341632035636728
Task_31476,1017,295,49,160,209,3.435810810810811,24.230096446218727
Task_31477,1892,376,146,66,212,5.018567639257294,37.83619861264034
Task_31478,1042,744,56,72,128,1.3986577181208053,25.401715809432517
Task_31479,2069,220,106,44,150,9.361990950226245,39.40519873597943
Task_31480,1619,473,181,83,264,3.4156118143459917,34.29427330637282
Task_31481,971,684,130,79,209,1.4175182481751825,24.362383800455444
Task_31482,2912,938,67,42,109,3.101171458998935,54.69413512141035
Task_31483,1725,341,61,101,162,5.043859649122807,35.11477677100914
Task_31484,2657,240,166,29,195,11.024896265560166,49.09979558184629
Task_31485,2745,795,135,63,198,3.448492462311558,52.60817354438825
Task_31486,1859,102,25,71,96,18.04854368932039,34.88488412902014
Task_31487,2210,357,166,81,247,6.173184357541899,43.15723352383956
Task_31488,1665,100,100,41,141,16.485148514851485,31.863233418782073
Task_31489,2972,78,86,16,102,37.620253164556964,51.64503318512619
Task_31490,592,226,199,199,398,2.607929515418502,18.102193484368133
Task_31491,2443,957,126,90,216,2.5501043841336117,48.70143231890459
Task_31492,1592,648,175,125,300,2.453004622496148,34.71506889276579
Task_31493,1978,788,155,130,285,2.5069708491761724,41.20753349909549
Task_31494,1822,674,52,91,143,2.6992592592592595,37.57754354491306
Task_31495,1047,250,138,129,267,4.171314741035856,24.675911841080758
Task_31496,2399,287,124,72,196,8.32986111111111,45.546568404654835
Task_31497,526,558,72,180,252,0.9409660107334525,17.403886683123748
Task_31498,2875,362,162,99,261,7.920110192837465,53.881496427888216
Task_31499,1787,261,140,106,246,6.820610687022901,36.278117047717934
Task_31500,1062,606,77,106,183,1.7495881383855025,25.650254966397295
Task_31501,1341,384,144,36,180,3.483116883116883,28.71590112063056
Task_31502,2989,799,50,87,137,3.73625,56.45757752606244
Task_31503,2220,244,162,113,275,9.061224489795919,43.200103831087866
Task_31504,2584,763,113,79,192,3.3821989528795813,50.131617080111766
Task_31505,2940,319,145,126,271,9.1875,54.85099765828289
Task_31506,1502,990,82,53,135,1.515640766902119,33.125862149757296
Task_31507,2827,924,72,108,180,3.056216216216216,54.61329696210817
Task_31508,850,885,161,99,260,0.9593679458239278,23.452808438471397
Task_31509,1229,792,162,74,236,1.549810844892812,28.8435643276044
Task_31510,1409,307,89,90,179,4.574675324675325,30.060231881408914
Task_31511,2697,446,147,44,191,6.033557046979865,50.436738792324036
Task_31512,1947,1019,117,139,256,1.9088235294117648,41.31811839760284
Task_31513,2941,692,38,113,151,4.243867243867244,55.33794930534455
Task_31514,1515,191,139,55,194,7.890625,31.175154142562107
Task_31515,1497,1014,13,23,36,1.4748768472906404,31.640160549518438
Task_31516,1266,212,84,122,206,5.943661971830986,27.729773163108586
Task_31517,1408,497,163,138,301,2.8273092369477912,31.34959882773218
Task_31518,1646,801,168,147,315,2.052369077306733,36.14836350868156
Task_31519,1305,834,125,55,180,1.562874251497006,29.77372537437974
Task_31520,2015,88,159,63,222,22.640449438202246,38.10889651652213
Task_31521,1281,715,112,95,207,1.7891061452513966,29.548598637844865
Task_31522,1667,902,97,16,113,1.8460686600221483,34.836866940103015
Task_31523,570,128,19,16,35,4.4186046511627906,13.959596804767912
Task_31524,1460,195,182,84,266,7.448979591836735,30.867793698245958
Task_31525,2610,198,164,110,274,13.115577889447236,49.21267206398513
Task_31526,1233,974,123,73,196,1.2646153846153847,29.245938896072996
Task_31527,1244,135,124,183,307,9.147058823529411,27.383293079730546
Task_31528,2517,997,152,14,166,2.5220440881763526,49.11979333417966
Task_31529,967,751,44,36,80,1.2859042553191489,23.024434389743977
Task_31530,1052,887,41,162,203,1.1846846846846846,26.457675815319803
Task_31531,1359,562,148,62,210,2.413854351687389,29.93728708057776
Task_31532,2033,343,177,112,289,5.909883720930233,40.64948282923088
Task_31533,1506,359,53,177,230,4.183333333333334,32.26760472982888
Task_31534,2578,1023,157,109,266,2.517578125,51.331338593308736
Task_31535,1608,165,85,49,134,9.686746987951807,31.62079089174011
Task_31536,845,302,94,29,123,2.788778877887789,20.183230581686534
Task_31537,1108,373,168,170,338,2.962566844919786,26.420954039973594
Task_31538,1908,113,41,195,236,16.736842105263158,37.3012746052973
Task_31539,677,80,67,152,219,8.358024691358025,17.709796659202496
Task_31540,1982,721,186,168,354,2.7451523545706373,41.42787223016485
Task_31541,1565,209,69,30,99,7.4523809523809526,30.926176281573607
Task_31542,2310,866,171,148,319,2.6643598615916955,46.89100613046289
Task_31543,2916,498,115,80,195,5.843687374749499,54.56208356118142
Task_31544,2092,238,166,55,221,8.753138075313808,40.52272810286324
Task_31545,2898,169,132,59,191,17.04705882352941,52.64121834653705
Task_31546,1129,478,106,153,259,2.356993736951983,26.705548707709994
Task_31547,564,811,40,169,209,0.6945812807881774,18.66694420754588
Task_31548,2449,910,187,89,276,2.6882546652030737,48.908011125874545
Task_31549,2286,327,194,194,388,6.969512195121951,45.163277181869375
Task_31550,557,630,47,176,223,0.8827258320126783,17.959898014943466
Task_31551,1648,1006,166,41,207,1.6365441906653426,35.662107076847114
Task_31552,2145,867,50,82,132,2.4711981566820276,43.35454351783661
Task_31553,2724,579,158,105,263,4.696551724137931,52.22811913478506
Task_31554,2949,638,84,80,164,4.615023474178404,55.418820783498944
Task_31555,754,353,152,109,261,2.1299435028248586,20.32066932101989
Task_31556,2289,131,109,110,219,17.34090909090909,43.307822264726205
Task_31557,1816,603,52,82,134,3.006622516556291,37.25441436374919
Task_31558,2688,163,12,70,82,16.390243902439025,48.4360634669333
Task_31559,1277,972,200,109,309,1.3124357656731758,30.70293862833007
Task_31560,1353,445,122,169,291,3.0336322869955157,30.314347534275043
Task_31561,2411,183,43,177,220,13.103260869565217,45.7369337813719
Task_31562,2830,905,23,97,120,3.123620309050773,54.01944423613087
Task_31563,1393,917,111,133,244,1.5174291938997821,32.11700985829328
Task_31564,2960,449,137,53,190,6.5777777777777775,54.88214389230334
Task_31565,2932,719,109,12,121,4.072222222222222,54.32607715227186
Task_31566,961,291,51,65,116,3.291095890410959,22.31747210862586
Task_31567,2302,309,133,104,237,7.425806451612903,44.542041650225
Task_31568,1264,441,157,112,269,2.8597285067873304,28.71028542216845
Task_31569,1594,91,76,127,203,17.32608695652174,32.079134229782795
Task_31570,2541,310,29,126,155,8.170418006430868,47.80279948670085
Task_31571,1030,262,57,158,215,3.9163498098859315,24.321756143147116
Task_31572,2725,423,83,58,141,6.42688679245283,50.74409022951238
Task_31573,2422,849,64,166,230,2.8494117647058825,48.30796493445953
Task_31574,1150,539,61,122,183,2.1296296296296298,26.871201985794176
Task_31575,1311,338,19,64,83,3.8672566371681416,27.523942068812584
Task_31576,1913,85,60,110,170,22.24418604651163,36.741670135064574
Task_31577,2207,570,56,129,185,3.865148861646235,43.732354009611164
Task_31578,1425,106,147,155,302,13.317757009345794,29.914899022461764
Task_31579,2351,717,150,158,308,3.2743732590529246,47.03861707386469
Task_31580,2665,210,84,57,141,12.630331753554502,49.006429060897176
Task_31581,1329,680,138,82,220,1.9515418502202644,30.154711764806038
Task_31582,1587,131,193,17,210,12.022727272727273,31.502098893463
Task_31583,1505,381,36,65,101,3.93979057591623,30.972679226323535
Task_31584,2195,761,80,144,224,2.8805774278215224,44.359730025961824
Task_31585,2612,150,24,129,153,17.29801324503311,47.81581743894395
Task_31586,1355,74,107,84,191,18.066666666666666,27.888635473059722
Task_31587,648,956,66,39,105,0.677115987460815,19.162680506129707
Task_31588,2022,798,169,98,267,2.530663329161452,41.81536278538435
Task_31589,1083,725,30,85,115,1.4917355371900827,25.696788443008405
Task_31590,2155,491,96,165,261,4.380081300813008,43.02317971569556
Task_31591,2268,147,167,190,357,15.324324324324325,43.87293769414513
Task_31592,791,502,105,117,222,1.5725646123260437,21.167838135034042
Task_31593,1361,530,111,103,214,2.5630885122410545,30.266276622582694
Task_31594,2892,422,190,169,359,6.836879432624113,54.90301922146019
Task_31595,2582,93,172,86,258,27.46808510638298,47.53397176147638
Task_31596,2849,979,100,53,153,2.907142857142857,54.50111091804163
Task_31597,507,83,25,193,218,6.035714285714286,15.031035817457445
Task_31598,727,442,64,167,231,1.6410835214446953,20.180435834381655
Task_31599,2710,825,125,130,255,3.280871670702179,52.78547713375608
Task_31600,2668,896,51,45,96,2.9743589743589745,50.49310633465208
Task_31601,574,339,159,112,271,1.688235294117647,17.465310898355167
Task_31602,2616,108,152,48,200,24.0,47.46480362956382
Task_31603,2666,394,130,164,294,6.749367088607595,50.933009561532025
Task_31604,1470,134,134,78,212,10.88888888888889,30.143517941205264
Task_31605,1201,452,26,132,158,2.65121412803532,27.075797850598985
Task_31606,2034,215,194,78,272,9.416666666666666,39.967069060087326
Task_31607,1737,974,67,118,185,1.7815384615384615,37.52747454024155
Task_31608,1139,317,110,66,176,3.5817610062893084,25.54326188404505
Task_31609,1456,151,83,95,178,9.578947368421053,30.13145094003319
Task_31610,1668,495,169,152,321,3.3629032258064515,35.56999998077317
Task_31611,2515,139,157,106,263,17.964285714285715,47.108062858117684
Task_31612,1777,1007,82,146,228,1.7628968253968254,38.49951596487438
Task_31613,1312,127,14,163,177,10.25,27.679018149475244
Task_31614,1490,414,85,33,118,3.5903614457831323,30.585410863182506
Task_31615,2110,716,152,102,254,2.9428172942817294,42.892361800873
Task_31616,500,987,119,116,235,0.5060728744939271,18.28472840019406
Task_31617,1936,516,130,24,154,3.74468085106383,38.24615757903435
Task_31618,2978,360,134,190,324,8.249307479224377,55.92733924356592
Task_31619,2852,1021,108,97,205,2.7906066536203524,55.403154787968965
Task_31620,2823,297,129,141,270,9.473154362416107,52.940377671963496
Task_31621,2675,756,107,100,207,3.533685601056803,51.75377859690369
Task_31622,1439,806,82,116,198,1.7831474597273853,32.34022901525851
Task_31623,1003,797,168,73,241,1.2568922305764412,25.252795157600545
Task_31624,1721,294,199,49,248,5.8338983050847455,34.85261137110145
Task_31625,1439,996,178,33,211,1.4433299899699097,32.32941064027499
Task_31626,2164,818,152,144,296,2.642246642246642,44.318242605036254
Task_31627,758,625,20,116,136,1.2108626198083068,20.408686965440324
Task_31628,739,220,150,174,324,3.3438914027149322,20.03381061911038
Task_31629,1338,247,164,43,207,5.395161290322581,28.355334371475266
Task_31630,2369,799,44,110,154,2.96125,46.612546313116866
Task_31631,2090,492,123,35,158,4.239350912778905,40.71147379735857
Task_31632,1211,480,173,177,350,2.5176715176715176,28.45524173454699
Task_31633,2791,866,122,23,145,3.2191464821222606,52.93264882057665
Task_31634,2165,114,95,59,154,18.82608695652174,40.18297691346458
Task_31635,2194,501,27,26,53,4.370517928286852,41.284150252668475
Task_31636,2471,845,158,91,249,2.92080378250591,48.92230059540702
Task_31637,1466,137,151,193,344,10.623188405797102,31.06783097620323
Task_31638,1538,664,122,111,233,2.312781954887218,33.587397820678014
Task_31639,1609,145,83,52,135,11.020547945205479,31.68804165847331
Task_31640,2643,654,35,173,208,4.035114503816794,51.05030323628723
Task_31641,1244,442,171,78,249,2.8081264108352144,28.133988354443833
Task_31642,1517,995,170,115,285,1.5230923694779117,34.482191827453
Task_31643,2253,766,144,67,211,2.9374185136897,44.79479437932584
Task_31644,1330,793,56,67,123,1.6750629722921915,29.787990141130454
Task_31645,2615,448,182,183,365,5.8240534521158125,50.652504041223814
Task_31646,1567,473,79,110,189,3.3059071729957807,33.30152773037026
Task_31647,946,104,31,15,46,9.00952380952381,19.770653394598856
Task_31648,1859,136,34,167,201,13.569343065693431,36.528020900573544
Task_31649,632,660,109,93,202,0.9561270801815431,19.02606504609376
Task_31650,1359,689,176,67,243,1.9695652173913043,30.536132124324524
Task_31651,685,959,39,95,134,0.7135416666666666,20.47471008072815
Task_31652,1858,875,107,107,214,2.1210045662100456,39.22392299979415
Task_31653,2899,459,105,31,136,6.302173913043478,53.27351870676956
Task_31654,1458,278,189,28,217,5.225806451612903,30.382702889155684
Task_31655,714,447,112,175,287,1.59375,20.184198132828126
Task_31656,2325,993,172,54,226,2.339034205231388,46.672051913509726
Task_31657,1663,673,86,122,208,2.4673590504451037,35.45920706248933
Task_31658,1103,674,46,174,220,1.634074074074074,26.782614061879002
Task_31659,2670,287,74,111,185,9.270833333333334,50.085942033425624
Task_31660,1502,177,171,50,221,8.438202247191011,30.617797397215742
Task_31661,525,694,195,111,306,0.7553956834532374,17.942335278643665
Task_31662,2565,514,30,191,221,4.980582524271845,49.44153942667353
Task_31663,1342,938,157,106,263,1.4291799787007455,31.408920323611678
Task_31664,1158,926,117,23,140,1.249190938511327,27.156081496592606
Task_31665,2331,148,168,151,319,15.644295302013424,44.63730868169483
Task_31666,2821,705,95,120,215,3.9957507082152977,53.981294936753436
Task_31667,2339,228,49,137,186,10.213973799126638,44.717181480659406
Task_31668,1631,212,10,160,170,7.657276995305164,33.29204069568983
Task_31669,1219,994,199,60,259,1.2251256281407035,29.272347927767267
Task_31670,1991,320,46,134,180,6.202492211838006,39.45683934824687
Task_31671,2670,184,183,128,311,14.432432432432432,50.17636679007768
Task_31672,730,989,179,144,323,0.7373737373737373,22.2145172330129
Task_31673,2962,755,194,123,317,3.917989417989418,56.82676112061582
Task_31674,1794,465,182,122,304,3.8497854077253217,37.348183453703115
Task_31675,1561,437,116,69,185,3.5639269406392695,32.64214309959467
Task_31676,2839,557,102,128,230,5.087813620071684,53.863500633164165
Task_31677,1504,926,39,154,193,1.622437971952535,33.74389763526268
Task_31678,947,317,195,116,311,2.9779874213836477,23.493731317366937
Task_31679,2529,87,171,51,222,28.738636363636363,46.023641797380215
Task_31680,821,355,34,18,52,2.306179775280899,18.992899178299993
Task_31681,884,463,16,178,194,1.9051724137931034,22.496445857525785
Task_31682,783,788,103,10,113,0.9923954372623575,20.621824607698155
Task_31683,1470,214,29,174,203,6.837209302325581,31.01315093142705
Task_31684,2078,692,68,46,114,2.9985569985569986,40.80970195533675
Task_31685,2898,347,141,158,299,8.327586206896552,54.457518941320494
Task_31686,529,307,127,136,263,1.7175324675324675,16.65173603479902
Task_31687,1856,101,89,117,206,18.19607843137255,36.160260182652245
Task_31688,1349,726,59,77,136,1.8555708390646493,30.113421732774196
Task_31689,2239,634,89,122,211,3.525984251968504,44.49178017098374
Task_31690,2967,179,59,197,256,16.483333333333334,54.54789261112948
Task_31691,1759,646,61,34,95,2.7187017001545595,35.26658799523209
Task_31692,1610,363,108,113,221,4.423076923076923,33.71943329674844
Task_31693,1951,99,109,97,206,19.51,37.58979605433104
Task_31694,2464,147,77,195,272,16.64864864864865,46.67049594244357
Task_31695,1291,363,23,163,186,3.5467032967032965,28.546289517258288
Task_31696,664,251,94,118,212,2.634920634920635,18.374020977225452
Task_31697,906,954,14,22,36,0.9486910994764398,22.245117386026852
Task_31698,1084,142,48,134,182,7.580419580419581,24.24859900965154
Task_31699,2719,774,121,184,305,3.5083870967741935,53.07232470303586
Task_31700,2272,442,181,163,344,5.128668171557562,45.08010270547811
Task_31701,1190,91,130,65,195,12.934782608695652,25.075799356852375
Task_31702,2266,406,75,116,191,5.5675675675675675,44.17362586833347
Task_31703,1781,555,50,174,224,3.2032374100719423,37.24277245338967
Task_31704,1916,832,122,84,206,2.300120048019208,39.86452775524299
Task_31705,2063,870,90,143,233,2.3685419058553387,42.58926677294365
Task_31706,2766,517,84,73,157,5.33976833976834,51.83562888348104
Task_31707,2529,470,37,150,187,5.369426751592357,48.522839376293234
Task_31708,1055,390,46,59,105,2.6982097186700766,23.705940471767292
Task_31709,921,232,102,200,302,3.9527896995708156,22.887111437750523
Task_31710,2363,747,70,17,87,3.159090909090909,45.13616615511153
Task_31711,1683,700,29,176,205,2.4008559201141226,35.96837643968269
Task_31712,2467,228,61,185,246,10.77292576419214,47.08401479805449
Task_31713,2880,822,104,70,174,3.4993924665856624,54.711541563869694
Task_31714,2049,1012,15,17,32,2.0227048371174727,40.27919454705467
Task_31715,2316,965,128,172,300,2.3975155279503104,47.244399317069565
Task_31716,503,156,126,46,172,3.2038216560509554,14.44813117656016
Task_31717,1933,948,139,53,192,2.0368809272918864,40.20924306462893
Task_31718,2644,554,192,52,244,4.763963963963964,50.458057594699426
Task_31719,2895,406,94,104,198,7.113022113022113,54.086430916342266
Task_31720,1398,487,84,76,160,2.8647540983606556,30.150797968360507
Task_31721,2827,314,167,176,343,8.974603174603175,53.44428291409556
Task_31722,2103,962,90,14,104,2.1838006230529596,41.83168072841914
Task_31723,1455,664,26,55,81,2.18796992481203,30.707204747789092
Task_31724,2426,937,57,98,155,2.5863539445629,48.022373447294434
Task_31725,1554,615,153,185,338,2.522727272727273,34.26891893412563
Task_31726,958,479,190,92,282,1.9958333333333333,23.964222828203187
Task_31727,962,1014,154,29,183,0.9477832512315271,24.77885942352164
Task_31728,2560,219,179,190,369,11.636363636363637,49.01255459805149
Task_31729,1136,429,182,37,219,2.641860465116279,25.813425896168297
Task_31730,1623,535,112,92,204,3.0279850746268657,34.31738870563124
Task_31731,623,471,83,84,167,1.319915254237288,18.061753639764877
Task_31732,929,650,17,13,30,1.4270353302611367,21.38898577892971
Task_31733,610,633,12,183,195,0.9621451104100947,18.60641611883978
Task_31734,1048,795,175,63,238,1.3165829145728642,25.895763922721013
Task_31735,1703,797,161,74,235,2.1340852130325816,36.39300297238663
Task_31736,709,845,142,74,216,0.8380614657210402,20.717419545201594
Task_31737,1366,669,16,152,168,2.038805970149254,30.573895233533204
Task_31738,2429,1017,12,49,61,2.3860510805500983,46.76261603407924
Task_31739,2612,122,170,48,218,21.235772357723576,47.683757292870126
Task_31740,2269,806,53,131,184,2.811648079306072,45.454669346873004
Task_31741,1252,546,190,96,286,2.2888482632541134,28.933314982705372
Task_31742,2943,347,94,111,205,8.456896551724139,54.68704545902361
Task_31743,1827,483,181,110,291,3.774793388429752,37.85201080878208
Task_31744,691,745,69,46,115,0.9262734584450402,19.113494196249054
Task_31745,612,83,42,59,101,7.285714285714286,15.14058817834487
Task_31746,756,939,31,85,116,0.8042553191489362,21.157723786468274
Task_31747,894,236,103,93,196,3.7721518987341773,21.822939056328114
Task_31748,1502,842,148,23,171,1.7817319098457889,32.55572344610791
Task_31749,656,472,135,72,207,1.386892177589852,18.60154180512446
Task_31750,756,1010,120,116,236,0.7477744807121661,22.245044026664022
Task_31751,1078,119,87,190,277,8.983333333333333,24.512530987172784
Task_31752,2204,338,76,61,137,6.501474926253687,42.19335748785347
Task_31753,834,86,155,133,288,9.586206896551724,20.424164470890208
Task_31754,2229,789,96,107,203,2.821518987341772,44.79161092358942
Task_31755,942,78,138,150,288,11.924050632911392,22.105226180668552
Task_31756,975,603,78,53,131,1.6142384105960266,23.628780105374307
Task_31757,614,406,57,79,136,1.5085995085995085,17.515512841648242
Task_31758,2972,309,56,196,252,9.587096774193549,55.4081343282576
Task_31759,861,238,125,146,271,3.602510460251046,21.74043510617003
Task_31760,2622,614,82,64,146,4.263414634146342,49.865229761600794
Task_31761,2331,995,104,151,255,2.3403614457831323,47.34190190092076
Task_31762,538,408,76,33,109,1.315403422982885,15.445688609928895
Task_31763,1804,240,64,176,240,7.485477178423237,36.61856953618816
Task_31764,622,518,150,167,317,1.1984585741811176,19.026634928733955
Task_31765,502,120,39,171,210,4.148760330578512,15.126198138126464
Task_31766,2628,216,23,87,110,12.110599078341014,48.46358476545569
Task_31767,1874,649,102,72,174,2.883076923076923,38.29133549961381
Task_31768,2891,800,62,86,148,3.6092384519350813,54.94826199437344
Task_31769,1816,204,80,165,245,8.858536585365854,36.66603483623601
Task_31770,2293,389,157,45,202,5.87948717948718,43.89909239926762
Task_31771,2923,812,71,13,84,3.5953259532595325,54.21544525102018
Task_31772,2571,164,136,174,310,15.581818181818182,48.47996862680591
Task_31773,1117,1001,192,42,234,1.1147704590818364,27.354120190226567
Task_31774,2476,114,57,165,222,21.530434782608694,46.179328963069565
Task_31775,755,552,158,175,333,1.3652802893309222,21.33497633637769
Task_31776,1481,210,120,182,302,7.018957345971564,31.62794275782706
Task_31777,2652,195,29,199,228,13.53061224489796,49.75997877115493
Task_31778,582,425,124,196,320,1.3661971830985915,18.17231424890317
Task_31779,1223,902,77,70,147,1.35437430786268,28.600587883535113
Task_31780,2568,835,56,84,140,3.0717703349282295,49.88674349522956
Task_31781,1899,315,178,190,368,6.0094936708860756,38.90658924111864
Task_31782,2560,166,137,75,212,15.32934131736527,47.515724350138576
Task_31783,730,602,23,20,43,1.2106135986733002,18.35265333653341
Task_31784,1418,824,21,190,211,1.7187878787878788,32.170219574697725
Task_31785,2193,417,115,180,295,5.246411483253588,43.55227804852043
Task_31786,2215,434,165,151,316,5.091954022988506,44.00811061575405
Task_31787,950,477,91,62,153,1.9874476987447698,22.78830198498107
Task_31788,741,122,120,122,242,6.024390243902439,19.00601211743076
Task_31789,1538,764,92,20,112,2.0104575163398692,32.38014795968884
Task_31790,2739,815,31,11,42,3.3566176470588234,50.70495842562884
Task_31791,1262,627,75,164,239,2.0095541401273884,29.269794947628426
Task_31792,2868,232,196,73,269,12.30901287553648,53.075606562849885
Task_31793,1264,861,71,51,122,1.4663573085846868,28.662036229453296
Task_31794,1155,451,65,28,93,2.5553097345132745,25.163679125575925
Task_31795,1243,297,41,78,119,4.171140939597316,26.90377459358262
Task_31796,1643,714,144,42,186,2.297902097902098,34.56863184949302
Task_31797,1953,340,17,133,150,5.7272727272727275,38.53103480102571
Task_31798,2671,83,134,130,264,31.797619047619047,49.08710853291749
Task_31799,1692,962,181,89,270,1.7570093457943925,37.038081213192534
Task_31800,1297,735,14,97,111,1.7622282608695652,29.13305953736777
Task_31801,771,240,197,52,249,3.199170124481328,19.828571298948926
Task_31802,656,139,128,109,237,4.685714285714286,17.715448377001763
Task_31803,1500,429,49,186,235,3.488372093023256,32.45839308831546
Task_31804,1141,742,148,183,331,1.5356662180349934,28.04651298142927
Task_31805,647,630,56,39,95,1.0253565768621236,17.753422464334843
Task_31806,1710,189,152,46,198,9.0,34.056565491126
Task_31807,1414,767,88,87,175,1.8411458333333333,31.534470119556474
Task_31808,1201,527,24,40,64,2.274621212121212,25.679471661725856
Task_31809,2930,956,176,116,292,3.0616509926854754,56.82785924022577
Task_31810,1568,334,113,15,128,4.6805970149253735,31.788643703585958
Task_31811,1951,173,33,48,81,11.21264367816092,36.725797431380016
Task_31812,2607,792,43,45,88,3.287515762925599,49.178300459357786
Task_31813,1449,753,144,131,275,1.9217506631299734,32.67409604668
Task_31814,1264,391,75,199,274,3.2244897959183674,28.765643358375453
Task_31815,1522,814,134,92,226,1.8674846625766872,33.69072166345857
Task_31816,2884,618,198,188,386,4.659127625201939,55.56273261072247
Task_31817,2139,278,79,195,274,7.666666666666667,42.21745277942747
Task_31818,1856,303,178,104,282,6.105263157894737,37.6724019763178
Task_31819,2026,455,56,200,256,4.442982456140351,40.95584868765361
Task_31820,2428,746,25,110,135,3.250334672021419,47.28233538777715
Task_31821,1129,352,110,151,261,3.198300283286119,26.310880431116203
Task_31822,2086,630,120,10,130,3.3058637083993663,40.84472226753841
Task_31823,2983,858,167,123,290,3.4726426076833525,57.361969970876224
Task_31824,2327,560,110,150,260,4.14795008912656,45.93324701940782
Task_31825,2971,493,43,77,120,6.01417004048583,54.876390568946306
Task_31826,2300,886,41,17,58,2.593010146561443,44.10367074412951
Task_31827,1450,426,57,30,87,3.395784543325527,29.615133664501485
Task_31828,2333,420,94,30,124,5.541567695961995,44.10924338185567
Task_31829,1897,658,82,152,234,2.8786039453717756,39.361420053995055
Task_31830,1509,738,116,121,237,2.0419485791610286,33.39191090133074
Task_31831,1299,354,81,31,112,3.659154929577465,27.312602787546084
Task_31832,1600,409,87,146,233,3.902439024390244,33.77320151173057
Task_31833,2792,401,115,92,207,6.945273631840796,52.40070666430856
Task_31834,886,998,87,152,239,0.8868868868868869,24.277370884574108
Task_31835,1603,225,57,62,119,7.092920353982301,32.04168449552133
Task_31836,1041,763,142,34,176,1.362565445026178,25.138883269991577
Task_31837,2270,838,21,200,221,2.705601907032181,45.785976548506234
Task_31838,623,695,154,57,211,0.8951149425287356,18.768804637223635
Task_31839,2690,542,126,107,233,4.953959484346225,51.4386608644031
Task_31840,2367,944,133,131,264,2.5047619047619047,47.764771816352855
Task_31841,1518,661,124,36,160,2.293051359516616,32.19068746978672
Task_31842,893,336,170,53,223,2.649851632047478,21.95986272677149
Task_31843,2135,547,192,107,299,3.895985401459854,42.964323140436115
Task_31844,2718,255,99,132,231,10.6171875,50.94032675513048
Task_31845,1336,254,15,54,69,5.23921568627451,27.202996524236088
Task_31846,1392,67,177,87,264,20.470588235294116,28.823364887370335
Task_31847,1754,793,173,20,193,2.209068010075567,36.52938812878035
Task_31848,2422,241,168,150,318,10.008264462809917,46.62828892021176
Task_31849,997,522,169,183,352,1.9063097514340344,25.217211811850515
Task_31850,2666,204,181,78,259,13.004878048780487,49.843424710856965
Task_31851,2831,853,119,193,312,3.3149882903981265,55.139701973973466
Task_31852,2257,255,22,77,99,8.81640625,42.39378278386932
Task_31853,1380,72,73,60,133,18.904109589041095,27.42469591887638
Task_31854,1212,307,117,121,238,3.935064935064935,27.329856503899816
Task_31855,667,872,78,188,266,0.7640320733104238,20.73006979102181
Task_31856,2826,415,48,21,69,6.793269230769231,50.96339545674895
Task_31857,1507,972,147,47,194,1.5488180883864338,33.28824859113438
Task_31858,1580,118,141,143,284,13.277310924369749,32.38884093146491
Task_31859,723,690,96,26,122,1.0463096960926195,19.43288014332968
Task_31860,2362,411,82,43,125,5.733009708737864,44.479835074077954
Task_31861,1398,960,32,10,42,1.4547346514047867,29.903839662911707
Task_31862,2416,641,170,163,333,3.763239875389408,47.94827350312479
Task_31863,2355,663,27,193,220,3.5466867469879517,46.576413064303146
Task_31864,591,619,55,186,241,0.9532258064516129,18.574552621920493
Task_31865,2913,887,128,192,320,3.2804054054054053,56.580149166522574
Task_31866,2210,70,50,168,218,31.12676056338028,41.67764613298192
Task_31867,2482,449,179,31,210,5.515555555555555,47.12760518357813
Task_31868,2471,360,155,31,186,6.8448753462603875,46.536575788932105
Task_31869,1485,283,187,69,256,5.22887323943662,31.286799440392546
Task_31870,1704,385,166,74,240,4.414507772020725,35.128418257433154
Task_31871,2681,192,43,177,220,13.89119170984456,50.11665661309519
Task_31872,1936,325,158,200,358,5.938650306748467,39.49496986650558
Task_31873,2915,284,47,101,148,10.228070175438596,53.59297043591709
Task_31874,1168,172,173,21,194,6.7514450867052025,25.089820903849613
Task_31875,2022,481,54,102,156,4.195020746887967,40.19018504561914
Task_31876,1970,191,27,117,144,10.260416666666666,38.24707922013624
Task_31877,607,299,146,83,229,2.0233333333333334,17.570195797967596
Task_31878,2042,941,178,184,362,2.1677282377919322,43.12483611971578
Task_31879,1644,336,91,161,252,4.878338278931751,34.37799023340959
Task_31880,1110,550,135,107,242,2.014519056261343,26.486927888686623
Task_31881,2457,528,90,131,221,4.644612476370511,47.67988951758732
Task_31882,1150,397,44,33,77,2.8894472361809047,24.536899008544477
Task_31883,901,186,50,83,133,4.818181818181818,21.557358256972034
Task_31884,2743,253,180,151,331,10.799212598425196,51.80474866555178
Task_31885,2747,201,88,28,116,13.599009900990099,49.69352229650284
Task_31886,1973,548,200,33,233,3.593806921675774,39.487725627876905
Task_31887,1075,402,75,97,172,2.667493796526055,25.2095387931376
Task_31888,2272,575,124,120,244,3.9444444444444446,44.99404012880473
Task_31889,752,324,148,53,201,2.313846153846154,19.592441422412776
Task_31890,1173,328,97,87,184,3.5653495440729484,26.39809305608407
Task_31891,1451,960,97,92,189,1.509885535900104,32.8182658881304
Task_31892,1021,427,52,17,69,2.385514018691589,22.34562407972471
Task_31893,1437,865,116,172,288,1.6593533487297922,32.93759015441662
Task_31894,2389,87,65,14,79,27.147727272727273,42.29249804833862
Task_31895,1328,819,81,27,108,1.6195121951219513,29.22637533277725
Task_31896,1956,624,23,191,214,3.1296,40.101250645610655
Task_31897,2428,620,93,103,196,3.9098228663446055,47.40477935084496
Task_31898,2986,277,177,143,320,10.741007194244604,55.672824234574875
Task_31899,2663,736,28,55,83,3.6132971506105833,50.08561001241165
Task_31900,1074,977,110,71,181,1.098159509202454,26.625349389049372
Task_31901,2652,70,130,46,176,37.352112676056336,47.32958584914952
Task_31902,741,689,140,56,196,1.0739130434782609,20.472784412973223
Task_31903,1994,199,113,46,159,9.97,38.19599735265485
Task_31904,2086,291,66,149,215,7.1438356164383565,41.108991351846306
Task_31905,1815,869,194,147,341,2.086206896551724,39.154952472879295
Task_31906,1202,174,158,160,318,6.868571428571428,26.9102210752942
Task_31907,1329,113,51,157,208,11.657894736842104,28.08258334036464
Task_31908,687,522,115,166,281,1.3135755258126196,19.917298331872896
Task_31909,1112,585,75,20,95,1.8976109215017065,24.898692465574182
Task_31910,2681,426,154,124,278,6.278688524590164,51.14602663550062
Task_31911,1605,394,143,41,184,4.063291139240507,32.93817579729175
Task_31912,1065,428,83,144,227,2.4825174825174825,25.412821902550277
Task_31913,1862,670,179,111,290,2.774962742175857,38.995014615205925
Task_31914,2093,1000,49,170,219,2.090909090909091,43.547524546344704
Task_31915,952,198,122,183,305,4.78391959798995,23.290103539375394
Task_31916,970,818,76,145,221,1.1843711843711844,25.06371376956872
Task_31917,2436,554,18,124,142,4.389189189189189,46.857221256717764
Task_31918,1153,368,197,106,303,3.124661246612466,26.865284683131364
Task_31919,1345,895,13,57,70,1.5011160714285714,29.351221000960617
Task_31920,2929,723,31,107,138,4.045580110497237,55.168991181179855
Task_31921,2672,91,77,147,224,29.043478260869566,49.118683968402486
Task_31922,1093,249,170,100,270,4.372,25.370374375768183
Task_31923,882,712,120,186,306,1.2370266479663394,23.72049330927716
Task_31924,2991,865,52,51,103,3.453810623556582,55.80863456045839
Task_31925,1178,539,46,88,134,2.1814814814814816,26.88476527476591
Task_31926,2935,661,140,38,178,4.433534743202417,54.841664493697515
Task_31927,2765,328,176,106,282,8.404255319148936,52.135283012383525
Task_31928,2063,797,28,74,102,2.5852130325814535,41.19006170458292
Task_31929,2169,883,131,38,169,2.4536199095022626,43.33254568297273
Task_31930,1488,780,112,69,181,1.9052496798975673,32.541864559492645
Task_31931,733,915,36,68,104,0.8002183406113537,20.467647939544435
Task_31932,1207,280,36,36,72,4.295373665480427,25.028088428477787
Task_31933,2267,132,103,57,160,17.045112781954888,42.08701019766912
Task_31934,2596,783,138,136,274,3.311224489795918,50.941904653524794
Task_31935,2008,476,173,81,254,4.209643605870021,40.381394648417945
Task_31936,989,826,43,117,160,1.1958887545344619,24.82414113108386
Task_31937,1406,72,151,149,300,19.26027397260274,29.424914063434283
Task_31938,1793,234,130,200,330,7.629787234042553,36.79390491096692
Task_31939,2531,156,179,139,318,16.121019108280255,47.805876761324335
Task_31940,1228,540,15,63,78,2.2698706099815156,26.61350110488733
Task_31941,787,215,151,65,216,3.6435185185185186,19.866853504346427
Task_31942,1419,497,20,52,72,2.8493975903614457,29.315894182002463
Task_31943,519,366,69,92,161,1.4141689373297002,16.014259746260517
Task_31944,1228,294,142,78,220,4.16271186440678,27.27298756484829
Task_31945,1986,835,171,37,208,2.375598086124402,40.50002277471594
Task_31946,1832,308,59,37,96,5.9288025889967635,35.36609734098747
Task_31947,635,915,131,103,234,0.6932314410480349,20.12962387962547
Task_31948,1885,162,33,18,51,11.56441717791411,35.128319188042724
Task_31949,2678,394,182,83,265,6.779746835443038,50.80153017571515
Task_31950,1261,341,100,110,210,3.6871345029239766,28.073277888201407
Task_31951,2293,357,198,45,243,6.405027932960894,43.97719385548202
Task_31952,2205,447,90,62,152,4.921875,42.55925139434223
Task_31953,614,387,58,41,99,1.5824742268041236,16.302563728309188
Task_31954,2492,116,51,83,134,21.299145299145298,45.56170595368885
Task_31955,1905,374,108,52,160,5.08,37.680463249569634
Task_31956,1627,360,113,85,198,4.5069252077562325,33.75682383923684
Task_31957,1269,333,37,132,169,3.7994011976047903,28.000598848370924
Task_31958,842,1002,159,47,206,0.839481555333998,22.9418914017274
Task_31959,2588,619,72,82,154,4.174193548387096,49.537610351198786
Task_31960,739,532,168,38,206,1.3864915572232646,19.794924701374246
Task_31961,797,157,43,102,145,5.044303797468355,19.241522520876945
Task_31962,1689,810,181,63,244,2.082614056720099,36.13204771482345
Task_31963,1115,277,158,193,351,4.010791366906475,26.31255553576936
Task_31964,1719,203,156,152,308,8.426470588235293,35.342659299787506
Task_31965,2243,575,19,82,101,3.8940972222222223,43.43071395406156
Task_31966,1987,832,187,154,341,2.385354141656663,41.775109620275124
Task_31967,666,964,66,104,170,0.6901554404145078,20.524250078559163
Task_31968,1106,847,142,195,337,1.304245283018868,27.844084998480017
Task_31969,1641,824,31,136,167,1.989090909090909,35.408394741742775
Task_31970,1510,272,30,171,201,5.531135531135531,31.833932238712553
Task_31971,1630,784,123,187,310,2.0764331210191083,35.87799851277333
Task_31972,1269,437,169,139,308,2.8972602739726026,28.99206148906373
Task_31973,1929,802,150,121,271,2.4022415940224158,40.39867062008877
Task_31974,802,205,154,30,184,3.8932038834951457,19.611903442678244
Task_31975,1535,668,178,165,343,2.294469357249626,34.12733541549205
Task_31976,638,380,195,193,388,1.6745406824146982,19.252901292483347
Task_31977,1310,435,24,149,173,3.0045871559633026,28.99983541200366
Task_31978,1544,552,62,24,86,2.7920433996383363,31.464765384754628
Task_31979,1342,869,90,87,177,1.542528735632184,30.711297300214866
Task_31980,1568,600,42,181,223,2.6089850249584026,33.935990025354926
Task_31981,1513,313,99,130,229,4.818471337579618,32.08341357378436
Task_31982,1303,343,117,65,182,3.7877906976744184,28.254875122628388
Task_31983,1690,454,32,28,60,3.7142857142857144,33.18238731319193
Task_31984,926,980,64,39,103,0.9439347604485219,23.281382161279833
Task_31985,2583,277,113,27,140,9.29136690647482,47.65661805276642
Task_31986,923,582,194,93,287,1.5831903945111492,23.748946107459403
Task_31987,1339,644,199,68,267,2.075968992248062,30.186817248741608
Task_31988,2248,1004,148,39,187,2.23681592039801,45.05933740756103
Task_31989,2106,1006,98,29,127,2.0913604766633567,42.3954531660532
Task_31990,1475,476,90,126,216,3.092243186582809,31.93730112305447
Task_31991,1358,300,31,180,211,4.511627906976744,29.577481199704568
Task_31992,2061,252,88,183,271,8.146245059288537,40.76030917319489
Task_31993,565,908,56,85,141,0.6215621562156216,18.544836917591155
Task_31994,1541,722,188,109,297,2.131396957123098,34.10173757362763
Task_31995,2355,627,75,87,162,3.75,46.00734332494608
Task_31996,1740,633,50,193,243,2.7444794952681386,36.952991876119036
Task_31997,694,568,138,81,219,1.2196836555360282,19.657438188426415
Task_31998,1775,534,136,152,288,3.317757009345794,37.23923612767632
Task_31999,754,96,126,34,160,7.77319587628866,17.590132203001485
Task_32000,2453,168,137,146,283,14.514792899408285,46.47045214039718
Task_32001,2519,237,47,13,60,10.584033613445378,45.41309423219452
Task_32002,2462,431,102,148,250,5.699074074074074,47.60556613988697
Task_32003,1452,687,186,83,269,2.11046511627907,32.34641737833292
Task_32004,2085,225,120,33,153,9.225663716814159,39.67833563043937
Task_32005,1980,132,182,137,319,14.887218045112782,38.93821927086977
Task_32006,1076,733,104,176,280,1.465940054495913,26.737613297085165
Task_32007,2829,400,66,116,182,7.054862842892768,52.9967568294623
Task_32008,1718,767,195,145,340,2.2369791666666665,37.292756643517244
Task_32009,2312,552,22,87,109,4.180831826401446,44.57732869069892
Task_32010,522,248,153,43,196,2.0963855421686746,15.416747645342054
Task_32011,1465,952,145,109,254,1.5372507869884575,33.37634665430145
Task_32012,516,844,148,48,196,0.6106508875739645,17.508066608396266
Task_32013,1079,958,198,13,211,1.1251303441084464,26.39521735058452
Task_32014,2560,918,55,111,166,2.7856365614798695,50.30596743597497
Task_32015,2533,448,141,65,206,5.641425389755011,48.203303102569585
Task_32016,1624,69,144,179,323,23.2,32.972642387423996
Task_32017,2016,86,52,135,187,23.17241379310345,38.52825114055926
Task_32018,2130,784,150,200,350,2.713375796178344,43.9986956302569
Task_32019,702,903,172,193,365,0.7765486725663717,21.800874325777013
Task_32020,2900,431,169,82,251,6.712962962962963,54.374096717271776
Task_32021,2123,854,72,74,146,2.4830409356725145,42.82821913050949
Task_32022,2042,597,143,53,196,3.4147157190635453,40.85514297826151
Task_32023,2571,727,110,76,186,3.5315934065934065,49.68336687211235
Task_32024,2618,760,118,186,304,3.440210249671485,51.426626777225714
Task_32025,618,902,151,34,185,0.6843853820598007,19.182400153475154
Task_32026,1255,590,14,26,40,2.1235194585448394,26.554605037796524
Task_32027,2897,586,61,49,110,4.93526405451448,53.363208467002046
Task_32028,1456,998,117,90,207,1.4574574574574575,33.09784389422185
Task_32029,2721,119,138,53,191,22.675,49.449597132448446
Task_32030,1237,228,110,76,186,5.401746724890829,26.9583425987186
Task_32031,685,629,23,13,36,1.0873015873015872,17.61531468246772
Task_32032,891,495,187,136,323,1.7963709677419355,23.25485001943424
Task_32033,2366,932,32,64,96,2.5359056806002145,46.242165439618525
Task_32034,1097,319,173,53,226,3.428125,25.14485353661537
Task_32035,2412,550,14,18,32,4.3774954627949185,44.58726864643342
Task_32036,1824,679,128,150,278,2.6823529411764704,38.42445151070577
Task_32037,1811,660,137,133,270,2.7397881996974283,38.097921134757286
Task_32038,982,523,168,81,249,1.8740458015267176,24.26497326250242
Task_32039,905,668,37,77,114,1.352765321375187,22.66571675294328
Task_32040,1050,836,136,132,268,1.2544802867383513,26.5160909475568
Task_32041,2246,480,23,146,169,4.669438669438669,43.921019621553285
Task_32042,1964,798,135,178,313,2.458072590738423,41.21353989806875
Task_32043,2196,958,116,42,158,2.289885297184567,43.841004793592525
Task_32044,1928,528,184,92,276,3.6446124763705106,39.448806498035104
Task_32045,877,912,136,45,181,0.9605695509309967,23.09410435080282
Task_32046,1877,818,99,199,298,2.2918192918192917,39.86247219445006
Task_32047,1336,241,192,64,256,5.520661157024794,28.789558551518823
Task_32048,1814,977,79,12,91,1.8548057259713702,37.19643081660343
Task_32049,1079,131,81,126,207,8.174242424242424,24.274141221877017
Task_32050,2830,729,157,126,283,3.8767123287671232,54.50472122551389
Task_32051,2009,820,98,162,260,2.4470158343483557,41.737109804267426
Task_32052,2661,340,103,29,132,7.803519061583578,49.1135566657309
Task_32053,1072,742,165,176,341,1.442799461641992,26.977136514609594
Task_32054,2381,747,61,195,256,3.1831550802139037,47.49519358112271
Task_32055,931,834,197,43,240,1.1149700598802395,23.918552316144012
Task_32056,2310,655,61,75,136,3.5213414634146343,45.114521139016624
Task_32057,2764,418,89,134,223,6.5966587112171835,52.178771174186615
Task_32058,1581,300,71,11,82,5.25249169435216,31.306454088852814
Task_32059,1872,404,133,175,308,4.622222222222222,38.48143746422377
Task_32060,2898,627,143,198,341,4.614649681528663,55.625031593931816
Task_32061,1179,618,37,24,61,1.9046849757673667,25.589633562918365
Task_32062,1857,608,51,146,197,3.0492610837438425,38.45102945086513
Task_32063,2774,581,34,93,127,4.766323024054983,52.29039692662334
Task_32064,1414,611,39,32,71,2.310457516339869,29.34192568175494
Task_32065,1124,323,38,89,127,3.4691358024691357,25.33095306200563
Task_32066,1472,217,152,191,343,6.752293577981652,31.708887165312962
Task_32067,806,768,113,85,198,1.048114434330299,21.991150946007156
Task_32068,1304,495,98,18,116,2.629032258064516,27.794034359927235
Task_32069,1497,129,123,10,133,11.515384615384615,29.543350234109027
Task_32070,1034,223,20,182,202,4.616071428571429,24.14950914027807
Task_32071,1366,371,120,147,267,3.672043010752688,30.14251063727667
Task_32072,2673,217,76,71,147,12.261467889908257,49.36531330277285
Task_32073,1417,87,51,152,203,16.102272727272727,29.262850775641933
Task_32074,1249,288,165,41,206,4.321799307958478,27.079101155621856
Task_32075,800,449,52,43,95,1.7777777777777777,19.5070223629137
Task_32076,2478,938,10,196,206,2.6389776357827475,49.299156547065316
Task_32077,1068,759,181,23,204,1.4052631578947368,25.631826750352573
Task_32078,2440,234,151,44,195,10.382978723404255,45.657562958861696
Task_32079,1415,612,76,119,195,2.3083197389885806,31.383826464992804
Task_32080,2278,616,78,176,254,3.6920583468395463,45.41338749017668
Task_32081,1431,516,97,141,238,2.7678916827853,31.501957522028558
Task_32082,1486,691,122,44,166,2.147398843930636,31.940859937507685
Task_32083,1032,374,60,99,159,2.752,24.17256841946271
Task_32084,2401,184,137,143,280,12.978378378378379,45.81444389273519
Task_32085,801,1020,107,56,163,0.7845249755142018,22.364735900164003
Task_32086,747,397,37,114,151,1.8768844221105527,19.68413451918609
Task_32087,630,79,99,25,124,7.875,15.30011455366684
Task_32088,2624,753,189,181,370,3.480106100795756,51.78978414279961
Task_32089,2252,77,98,138,236,28.871794871794872,42.36665023906941
Task_32090,2094,123,182,148,330,16.887096774193548,40.72971084087144
Task_32091,2370,641,147,166,313,3.691588785046729,47.133970453975884
Task_32092,709,173,50,189,239,4.074712643678161,18.886172025260265
Task_32093,2474,312,87,111,198,7.904153354632588,47.06688844894456
Task_32094,590,947,14,110,124,0.6223628691983122,18.88856690980236
Task_32095,1521,233,127,72,199,6.5,31.49531247566129
Task_32096,1412,680,27,45,72,2.0734214390602057,29.51758757970107
Task_32097,1124,75,112,174,286,14.789473684210526,24.967622607628503
Task_32098,1033,321,56,150,206,3.2080745341614905,24.51280253401825
Task_32099,2093,130,50,51,101,15.977099236641221,38.71231464922287
Task_32100,2274,547,154,150,304,4.149635036496351,45.2508238579627
Task_32101,1112,388,187,170,357,2.858611825192802,26.617807623532197
Task_32102,1793,701,135,103,238,2.5541310541310542,37.75320400472655
Task_32103,2190,280,40,134,174,7.7935943060498225,42.41454831899457
Task_32104,1341,427,119,39,158,3.133177570093458,28.645109671180915
Task_32105,1471,414,80,63,143,3.544578313253012,30.94374454750754
Task_32106,1718,301,34,164,198,5.688741721854305,35.20513926030812
Task_32107,1390,424,95,29,124,3.2705882352941176,29.16468255838832
Task_32108,608,462,88,181,269,1.3131749460043196,18.391689930928386
Task_32109,744,217,74,167,241,3.4128440366972477,19.77902826929513
Task_32110,2055,149,58,153,211,13.7,39.848753457165905
Task_32111,1155,547,154,113,267,2.1076642335766422,27.311531870286597
Task_32112,2844,745,138,113,251,3.812332439678284,54.61373779121377
Task_32113,2521,774,198,130,328,3.2529032258064516,49.96002228224764
Task_32114,1605,875,70,163,233,1.832191780821918,35.45535721940491
Task_32115,603,820,153,38,191,0.7344701583434835,18.55670096179667
Task_32116,576,249,27,194,221,2.304,17.108850220164623
Task_32117,1043,837,107,135,242,1.2446300715990453,26.29549602400009
Task_32118,2088,593,64,58,122,3.515151515151515,40.8830736183533
Task_32119,1139,920,164,19,183,1.236699239956569,27.117470606712544
Task_32120,2411,438,190,46,236,5.492027334851937,46.101150572654326
Task_32121,1067,528,135,66,201,2.0170132325141776,25.214557763088308
Task_32122,1971,538,53,187,240,3.6567717996289426,40.262316565611606
Task_32123,2230,840,53,40,93,2.6516052318668253,43.36345322647279
Task_32124,2947,264,176,187,363,11.120754716981132,55.26651992398907
Task_32125,2332,619,43,18,61,3.761290322580645,43.762219284390575
Task_32126,669,903,31,165,196,0.7400442477876106,20.42150540660528
Task_32127,1898,380,189,195,384,4.981627296587926,39.18625550493074
Task_32128,1468,476,192,200,392,3.0775681341719077,32.73386962317442
Task_32129,2869,298,21,51,72,9.595317725752508,51.56667591677395
Task_32130,1404,724,100,20,120,1.936551724137931,30.124142347670883
Task_32131,1666,464,48,142,190,3.5827956989247314,34.89115265772226
Task_32132,714,235,135,188,323,3.0254237288135593,19.70440245881071
Task_32133,1491,359,119,184,303,4.141666666666667,32.29755060148402
Task_32134,2159,1001,59,87,146,2.154690618762475,43.98107887236586
Task_32135,2030,908,198,97,295,2.233223322332233,42.4308437339489
Task_32136,821,744,24,99,123,1.1020134228187919,21.6437650827384
Task_32137,1172,963,27,160,187,1.2157676348547717,28.48181331667745
Task_32138,2956,889,49,62,111,3.3213483146067415,55.591924703162306
Task_32139,722,123,95,84,179,5.82258064516129,18.192205684275027
Task_32140,2301,338,90,76,166,6.787610619469026,44.10407736557042
Task_32141,1217,708,26,191,217,1.7165021156558533,28.65753697667954
Task_32142,1440,343,53,86,139,4.186046511627907,30.45698770420547
Task_32143,2305,359,197,143,340,6.402777777777778,45.280906684895704
Task_32144,664,643,24,187,211,1.031055900621118,19.566738705788424
Task_32145,2352,888,55,22,77,2.645669291338583,44.98124023371494
Task_32146,2495,70,115,151,266,35.140845070422536,46.306562252074734
Task_32147,1382,910,173,95,268,1.5170142700329308,31.98694257801505
Task_32148,1509,891,183,147,330,1.6917040358744395,34.311811019802
Task_32149,2689,236,19,189,208,11.345991561181435,50.37372199354933
Task_32150,1323,198,127,124,251,6.648241206030151,28.815969527287695
Task_32151,2977,594,10,78,88,5.003361344537815,54.84465664675579
Task_32152,1172,587,86,160,246,1.9931972789115646,27.64053673263977
Task_32153,1197,755,125,127,252,1.5833333333333333,28.53590978299975
Task_32154,777,935,85,107,192,0.8301282051282052,22.116723075337983
Task_32155,2315,343,182,124,306,6.729651162790698,45.20408865664135
Task_32156,1840,582,70,146,216,3.156089193825043,38.15962212724657
Task_32157,1590,1006,56,182,238,1.5789473684210527,35.63270180106613
Task_32158,2365,121,176,86,262,19.385245901639344,44.47233396662855
Task_32159,2622,636,83,75,158,4.116169544740973,50.02692459858637
Task_32160,1133,644,46,154,200,1.7565891472868218,27.044845978612177
Task_32161,817,1000,27,148,175,0.8161838161838162,22.902078683680728
Task_32162,1664,388,128,63,191,4.277634961439588,34.16224488273438
Task_32163,642,469,188,161,349,1.3659574468085107,19.338801918201746
Task_32164,2607,1003,142,67,209,2.596613545816733,51.13544518707901
Task_32165,2522,1011,194,88,282,2.492094861660079,50.38872238721756
Task_32166,2646,457,174,162,336,5.777292576419214,51.01117631049724
Task_32167,974,653,129,173,302,1.489296636085627,24.97908258195598
Task_32168,2171,862,17,163,180,2.5156431054461184,44.00767044712853
Task_32169,2181,935,195,120,315,2.3301282051282053,45.003102314896275
Task_32170,1569,873,56,29,85,1.7951945080091534,32.92040841309505
Task_32171,1466,887,113,12,125,1.6509009009009008,31.705452821928876
Task_32172,1864,104,94,63,157,17.752380952380953,35.384579364835254
Task_32173,1788,886,160,129,289,2.015783540022548,38.51929513312346
Task_32174,2493,819,72,31,103,3.040243902439024,47.636269866657294
Task_32175,748,140,160,167,327,5.304964539007092,19.679117748382996
Task_32176,1010,449,169,42,211,2.2444444444444445,23.839751626973072
Task_32177,778,294,39,132,171,2.6372881355932205,20.091673863668245
Task_32178,2573,705,12,20,32,3.644475920679887,47.63063077342241
Task_32179,2639,112,43,105,148,23.353982300884955,47.83218958592264
Task_32180,1155,124,79,161,240,9.24,25.63907141057113
Task_32181,1071,381,124,171,295,2.803664921465969,25.66879880429835
Task_32182,1630,474,108,25,133,3.431578947368421,33.198994437726626
Task_32183,998,959,89,191,280,1.0395833333333333,26.147977643573153
Task_32184,2340,508,27,62,89,4.597249508840864,44.337008614337954
Task_32185,2923,169,30,85,115,17.194117647058825,52.51822087935119
Task_32186,1738,565,131,196,327,3.070671378091873,36.99181737803197
Task_32187,2298,756,58,157,215,3.035667107001321,45.97078360787875
Task_32188,2090,810,160,37,197,2.5770653514180024,42.020115511794536
Task_32189,1970,881,67,83,150,2.233560090702948,40.581212594856275
Task_32190,1268,413,25,170,195,3.0628019323671496,28.421575474171235
Task_32191,1945,246,155,11,166,7.874493927125506,37.66189684130626
Task_32192,2210,124,160,18,178,17.68,41.06132300637707
Task_32193,1661,125,61,104,165,13.182539682539682,33.03402201869982
Task_32194,1627,705,134,142,276,2.3045325779036827,35.36465392986023
Task_32195,1646,625,79,163,242,2.6293929712460065,35.352456205036994
Task_32196,2213,978,40,172,212,2.26046986721144,45.26592684915561
Task_32197,1430,836,97,90,187,1.7084826762246117,32.125917625379195
Task_32198,1163,76,196,93,289,15.103896103896103,25.42716084951321
Task_32199,1338,992,200,12,212,1.3474320241691844,30.6078563368882
Task_32200,2014,609,131,46,177,3.301639344262295,40.087242154773485
Task_32201,2339,741,17,140,157,3.152291105121294,45.988321771451844
Task_32202,1979,73,175,134,309,26.743243243243242,38.41558762542084
Task_32203,2991,614,36,170,206,4.863414634146341,56.42146289535842
Task_32204,2707,302,15,135,150,8.933993399339935,50.35053544350183
Task_32205,545,178,146,194,340,3.0446927374301676,16.689210389382968
Task_32206,1580,670,151,145,296,2.354694485842027,34.605212713727006
Task_32207,2297,959,143,150,293,2.392708333333333,46.8608304959858
Task_32208,534,571,131,59,190,0.9335664335664335,16.894077921135427
Task_32209,2783,450,46,42,88,6.170731707317073,50.8876280501371
Task_32210,2621,984,17,154,171,2.660913705583756,51.432650146281844
Task_32211,539,435,150,38,188,1.2362385321100917,16.233296267412143
Task_32212,2911,110,74,25,99,26.225225225225227,51.29826633544484
Task_32213,1750,312,84,48,132,5.5910543130990416,34.66907792798913
Task_32214,2720,525,66,158,224,5.171102661596958,51.97045691344092
Task_32215,2679,230,90,198,288,11.597402597402597,50.57566585259829
Task_32216,1554,117,86,50,136,13.169491525423728,30.31258853952645
Task_32217,593,967,181,26,207,0.612603305785124,19.120484216108903
Task_32218,2533,335,73,46,119,7.538690476190476,46.83988752403068
Task_32219,1438,89,132,46,178,15.977777777777778,28.551946538493482
Task_32220,1645,507,93,27,120,3.2381889763779528,33.39850669701104
Task_32221,1865,76,127,197,324,24.22077922077922,36.77970072388782
Task_32222,1590,564,142,37,179,2.814159292035398,33.236456225401824
Task_32223,927,766,62,148,210,1.2086049543676662,24.176578368054766
Task_32224,2029,305,100,53,153,6.630718954248366,39.36216943322061
Task_32225,2612,715,94,150,244,3.64804469273743,50.87688622672496
Task_32226,2621,412,27,128,155,6.346246973365617,49.404727048858746
Task_32227,2078,64,20,124,144,31.96923076923077,38.6749907201304
Task_32228,2870,510,71,63,134,5.616438356164384,53.389561769041876
Task_32229,1053,397,139,147,286,2.6457286432160805,25.35921731053888
Task_32230,1301,434,181,179,360,2.9908045977011493,29.781974495958476
Task_32231,946,349,144,110,254,2.702857142857143,23.314916028056718
Task_32232,832,411,96,38,134,2.0194174757281553,20.437719228104083
Task_32233,1456,727,191,10,201,2.0,31.621108753227976
Task_32234,2191,735,183,85,268,2.9769021739130435,44.19629915980482
Task_32235,2144,285,80,136,216,7.496503496503497,41.96636288106913
Task_32236,631,759,121,129,250,0.8302631578947368,19.588246877381998
Task_32237,2635,334,68,17,85,7.865671641791045,48.07723270580063
Task_32238,2814,570,147,142,289,4.928196147110333,53.7958645802295
Task_32239,958,270,122,159,281,3.5350553505535056,23.44272728764192
Task_32240,568,169,84,52,136,3.3411764705882354,15.435784257371623
Task_32241,1748,420,193,132,325,4.1520190023752965,36.58465027398042
Task_32242,1590,638,64,147,211,2.488262910798122,34.35342171668557
Task_32243,1424,86,167,187,354,16.367816091954023,30.053051594733585
Task_32244,867,316,50,68,118,2.7350157728706623,20.920277941562595
Task_32245,1285,425,40,128,168,3.016431924882629,28.521672420181773
Task_32246,1630,804,196,138,334,2.0248447204968945,35.97665999132653
Task_32247,1388,141,16,69,85,9.774647887323944,27.84152821266193
Task_32248,2450,81,134,78,212,29.878048780487806,44.99747085557086
Task_32249,917,89,162,131,293,10.188888888888888,21.763532301857666
Task_32250,1062,501,80,139,219,2.1155378486055776,25.569776701508374
Task_32251,1869,244,164,49,213,7.628571428571429,36.86052632774111
Task_32252,2477,268,131,48,179,9.20817843866171,46.32367144003251
Task_32253,2113,143,26,196,222,14.67361111111111,40.716110066834
Task_32254,1922,747,70,98,168,2.56951871657754,39.65039878867356
Task_32255,1723,735,17,91,108,2.3410326086956523,35.75046842734276
Task_32256,1733,196,32,45,77,8.796954314720812,33.11143281533718
Task_32257,2175,942,53,160,213,2.306468716861082,44.600787086558995
Task_32258,780,378,27,49,76,2.058047493403694,18.6724018149874
Task_32259,2412,851,173,175,348,2.8309859154929575,48.63053814362973
Task_32260,2753,182,27,138,165,15.043715846994536,50.74675570755311
Task_32261,622,313,34,183,217,1.980891719745223,18.028310822997195
Task_32262,603,380,62,77,139,1.5826771653543308,17.21084836177481
Task_32263,1410,463,107,125,232,3.038793103448276,30.943385633948548
Task_32264,1232,745,185,20,205,1.6514745308310992,28.163076600120505
Task_32265,2075,389,91,156,247,5.32051282051282,41.34101639816486
Task_32266,2077,842,14,157,171,2.4638196915776986,42.3994860444457
Task_32267,1535,399,67,93,160,3.8375,32.24866448696454
Task_32268,2107,621,60,100,160,3.387459807073955,41.99317251510674
Task_32269,1036,1015,99,69,168,1.0196850393700787,26.045196677225068
Task_32270,1337,733,179,135,314,1.8215258855585832,31.01917406978782
Task_32271,2227,585,167,105,272,3.8003412969283277,44.417447939469206
Task_32272,2893,877,186,49,235,3.29498861047836,55.21814034699823
Task_32273,2748,944,69,30,99,2.907936507936508,52.02382976290323
Task_32274,2364,1017,89,100,189,2.3222003929273085,47.53698051441179
Task_32275,2586,209,71,150,221,12.314285714285715,48.71782012571763
Task_32276,610,169,144,194,338,3.588235294117647,17.72267501619527
Task_32277,526,988,145,94,239,0.531850353892821,18.67672493339919
Task_32278,987,758,83,123,206,1.300395256916996,25.00889365563801
Task_32279,2171,143,34,102,136,15.07638888888889,40.694573199408026
Task_32280,2434,950,127,76,203,2.559411146161935,48.3179713317086
Task_32281,1230,751,136,77,213,1.6356382978723405,28.675270849590646
Task_32282,1243,494,131,73,204,2.511111111111111,27.96566944744417
Task_32283,1869,80,193,69,262,23.074074074074073,35.93064128152604
Task_32284,1366,591,130,157,287,2.3074324324324325,30.945391502520376
Task_32285,1792,203,17,138,155,8.784313725490197,35.55618248902212
Task_32286,1028,904,78,111,189,1.1359116022099447,26.039553708671516
Task_32287,860,494,153,103,256,1.7373737373737375,22.397183207800357
Task_32288,2065,476,174,129,303,4.329140461215933,41.67903150405625
Task_32289,941,470,24,98,122,1.9978768577494692,22.757621332779024
Task_32290,2814,763,133,39,172,3.683246073298429,53.200899891800965
Task_32291,1964,518,170,36,206,3.7842003853564545,39.12777931149659
Task_32292,675,153,125,20,145,4.383116883116883,16.853047956686797
Task_32293,1547,93,130,70,200,16.45744680851064,30.70547286169466
Task_32294,1361,120,61,199,260,11.24793388429752,28.974930001945157
Task_32295,1411,100,123,81,204,13.970297029702971,28.877113961206476
Task_32296,1238,416,13,161,174,2.968824940047962,27.816797472941005
Task_32297,2773,146,71,133,204,18.86394557823129,51.09287649178378
Task_32298,1663,824,185,101,286,2.0157575757575756,36.291205773464405
Task_32299,2812,346,53,146,199,8.103746397694524,52.69751762337281
Task_32300,2547,317,122,102,224,8.00943396226415,48.38231170966241
Task_32301,2361,391,178,36,214,6.0229591836734695,45.0355281319018
Task_32302,1603,308,70,158,228,5.1877022653721685,33.597165060966866
Task_32303,1359,77,152,154,306,17.423076923076923,28.720675729264553
Task_32304,519,64,164,200,364,7.984615384615385,15.935356881439693
Task_32305,829,225,177,22,199,3.668141592920354,20.116250717592937
Task_32306,2548,1019,16,194,210,2.4980392156862745,50.68827297018738
Task_32307,562,95,95,180,275,5.854166666666667,16.176602923311595
Task_32308,2497,317,138,190,328,7.852201257861635,48.189382657702616
Task_32309,2890,181,109,193,302,15.87912087912088,53.56829094965956
Task_32310,2310,81,114,193,307,28.170731707317074,43.697280989970615
Task_32311,2542,400,42,93,135,6.339152119700748,48.04310871179348
Task_32312,970,261,128,103,231,3.7022900763358777,23.295324966792055
Task_32313,2786,402,40,196,236,6.913151364764268,52.653942467891
Task_32314,1281,873,60,196,256,1.465675057208238,30.414889663066827
Task_32315,1656,506,47,175,222,3.2662721893491122,35.04266179769626
Task_32316,683,950,62,198,260,0.7181913774973712,21.29879208119169
Task_32317,1488,585,144,197,341,2.539249146757679,33.160564811880434
Task_32318,1122,682,173,37,210,1.642752562225476,26.343412001005543
Task_32319,2520,863,46,168,214,2.9166666666666665,49.79881388992684
Task_32320,1634,487,143,142,285,3.348360655737705,34.82937783586512
Task_32321,2355,466,163,110,273,5.042826552462527,46.07418039220937
Task_32322,1796,91,51,198,249,19.52173913043478,35.50933127418124
Task_32323,2177,355,174,162,336,6.115168539325842,43.25252218223839
Task_32324,1854,465,148,29,177,3.9785407725321886,37.07292013891861
Task_32325,698,874,25,143,168,0.7977142857142857,20.5834931338906
Task_32326,1379,829,13,29,42,1.6614457831325302,29.3327908575682
Task_32327,2482,985,125,37,162,2.5172413793103448,48.55019763678223
Task_32328,2575,598,115,61,176,4.298831385642738,49.123662276770546
Task_32329,1424,602,106,13,119,2.361525704809287,30.043543028256604
Task_32330,1904,717,151,50,201,2.651810584958217,38.887872930740066
Task_32331,2453,604,156,123,279,4.054545454545455,48.11480102242664
Task_32332,2097,581,141,99,240,3.6030927835051547,42.18710063587837
Task_32333,2618,968,27,89,116,2.7017543859649122,50.81573618685605
Task_32334,662,517,23,79,102,1.277992277992278,18.152611228073777
Task_32335,1659,879,137,28,165,1.8852272727272728,35.249631805967674
Task_32336,985,270,102,170,272,3.6346863468634685,23.845014777080724
Task_32337,1791,304,39,97,136,5.872131147540983,35.85679048372149
Task_32338,2750,596,120,196,316,4.606365159128978,53.06652482896906
Task_32339,1905,338,86,13,99,5.619469026548672,36.621241424136656
Task_32340,2426,858,98,22,120,2.8242142025611177,46.73821870678132
Task_32341,2640,726,130,162,292,3.6313617606602477,51.578767070700884
Task_32342,1769,421,12,132,144,4.191943127962086,35.875205895389804
Task_32343,747,787,68,43,111,0.9479695431472082,20.081550168735962
Task_32344,2854,470,189,15,204,6.059447983014862,52.949885082956435
Task_32345,1530,869,37,71,108,1.7586206896551724,33.03780149771385
Task_32346,1953,116,30,23,53,16.692307692307693,35.906955359768354
Task_32347,1658,798,122,109,231,2.075093867334168,35.89483493980783
Task_32348,1675,584,15,105,120,2.8632478632478633,34.70234262345944
Task_32349,1579,758,99,159,258,2.080368906455863,34.71525062831848
Task_32350,1151,271,14,43,57,4.231617647058823,24.152941430959856
Task_32351,1825,855,28,128,156,2.1320093457943927,38.211235686339265
Task_32352,2713,887,109,127,236,3.05518018018018,52.937263773696884
Task_32353,1007,575,42,160,202,1.7482638888888888,24.834782130215885
Task_32354,2940,1006,190,146,336,2.919563058589871,57.38478363559344
Task_32355,2411,613,130,151,281,3.92671009771987,47.52831548953443
Task_32356,1201,599,144,76,220,2.0016666666666665,27.765097524709642
Task_32357,1182,785,191,50,241,1.5038167938931297,27.84038842574832
Task_32358,2275,308,93,147,240,7.3624595469255665,44.226690181985
Task_32359,2284,562,110,108,218,4.05683836589698,45.007868653302715
Task_32360,1436,493,106,120,226,2.9068825910931175,31.415785696931803
Task_32361,996,423,103,150,253,2.349056603773585,24.39533602410872
Task_32362,2973,571,46,67,113,5.1975524475524475,55.073641592612724
Task_32363,2536,990,126,16,142,2.5590312815338043,49.14919327297836
Task_32364,1419,780,114,101,215,1.8169014084507042,31.96849942932761
Task_32365,503,155,62,126,188,3.2243589743589745,15.224956120167953
Task_32366,1430,1006,63,121,184,1.420059582919563,32.71369960007142
Task_32367,2761,809,132,114,246,3.408641975308642,53.47924192298908
Task_32368,2116,801,107,53,160,2.638403990024938,42.39398372267808
Task_32369,2955,338,185,75,260,8.716814159292035,54.85394527381916
Task_32370,2365,579,149,21,170,4.077586206896552,45.38910826212841
Task_32371,1464,289,119,18,137,5.048275862068966,29.912856490140943
Task_32372,2641,788,175,14,189,3.347275031685678,50.5197159896544
Task_32373,671,821,167,176,343,0.816301703163017,20.917761880684417
Task_32374,988,815,22,34,56,1.2107843137254901,23.320458897745898
Task_32375,1561,909,79,80,159,1.7153846153846153,34.155521489222025
Task_32376,1502,674,62,159,221,2.225185185185185,33.13187322071171
Task_32377,1393,371,61,48,109,3.7446236559139785,28.812528701293562
Task_32378,2392,526,69,182,251,4.538899430740038,46.93239610829272
Task_32379,799,383,43,19,62,2.0807291666666665,18.74675786317017
Task_32380,2734,992,120,56,176,2.7532729103726084,52.9011504776547
Task_32381,521,304,100,32,132,1.7081967213114755,15.149959138892356
Task_32382,2578,226,47,53,100,11.3568281938326,47.2036441562016
Task_32383,613,410,122,193,315,1.491484184914842,18.593166853610562
Task_32384,2008,113,163,68,231,17.614035087719298,38.29263207546553
Task_32385,909,844,72,146,218,1.0757396449704142,24.11920290266707
Task_32386,1885,909,104,73,177,2.0714285714285716,39.28391984481411
Task_32387,703,146,101,54,155,4.782312925170068,17.54140705629332
Task_32388,1600,155,54,34,88,10.256410256410257,30.922220079200656
Task_32389,623,994,66,145,211,0.6261306532663317,20.267129262247057
Task_32390,2741,284,42,43,85,9.617543859649123,49.67783559656201
Task_32391,2898,648,118,111,229,4.465331278890601,55.059642010043696
Task_32392,1776,363,19,137,156,4.8791208791208796,35.885886329744515
Task_32393,2824,247,26,124,150,11.387096774193548,51.98663174628923
Task_32394,2529,866,37,155,192,2.916955017301038,49.822714955221834
Task_32395,1522,352,105,72,177,4.311614730878187,31.785265422375204
Task_32396,2465,455,80,160,240,5.405701754385965,47.757406391409084
Task_32397,679,95,25,120,145,7.072916666666667,16.89751717630345
Task_32398,981,847,37,198,235,1.1568396226415094,25.405734829700545
Task_32399,1400,173,87,126,213,8.045977011494253,29.48184548902881
Task_32400,2820,608,43,59,102,4.630541871921182,52.317075262878255
Task_32401,1464,296,133,104,237,4.929292929292929,31.24836433285249
Task_32402,2846,422,148,110,258,6.7281323877068555,53.63334212322834
Task_32403,671,629,144,78,222,1.065079365079365,19.489169452074798
Task_32404,2489,761,117,101,218,3.2664041994750654,48.8739319755937
Task_32405,2791,561,127,16,143,4.9661921708185055,51.863177816204626
Task_32406,2804,778,30,63,93,3.599486521181001,52.66230866792706
Task_32407,2059,581,184,92,276,3.5378006872852232,41.691509345924096
Task_32408,2230,107,151,135,286,20.64814814814815,42.473363096637165
Task_32409,2559,247,24,159,183,10.318548387096774,48.17308894640811
Task_32410,859,260,169,94,263,3.2911877394636013,21.662350929410746
Task_32411,2280,766,75,96,171,2.9726205997392436,45.40814639584215
Task_32412,2690,842,147,128,275,3.190984578884935,52.609128825178196
Task_32413,626,689,43,166,209,0.9072463768115943,19.117876334419027
Task_32414,2658,922,174,106,280,2.8797399783315276,52.342740760843505
Task_32415,719,570,15,53,68,1.2591943957968477,18.464623428032347
Task_32416,1448,238,90,185,275,6.058577405857741,31.08275443407538
Task_32417,1277,780,26,175,201,1.6350832266325224,29.73644898292049
Task_32418,2973,810,86,137,223,3.665844636251541,56.73149800893523
Task_32419,2078,689,26,67,93,3.0115942028985505,40.89624726605385
Task_32420,2187,548,127,155,282,3.9836065573770494,43.784626171920245
Task_32421,1955,698,192,125,317,2.7968526466380546,40.69823330786456
Task_32422,1837,845,141,141,282,2.1713947990543736,39.15406949019746
Task_32423,1591,558,49,120,169,2.8461538461538463,33.8663583670823
Task_32424,1087,72,85,81,166,14.89041095890411,23.518677608751137
Task_32425,2391,774,166,191,357,3.0851612903225805,48.12062764845029
Task_32426,1516,199,133,172,305,7.58,32.14887565841749
Task_32427,2550,373,158,12,170,6.818181818181818,47.63118432719438
Task_32428,1759,522,192,87,279,3.363288718929254,36.750580881179694
Task_32429,2051,419,42,113,155,4.883333333333334,40.415843960864905
Task_32430,1325,660,173,10,183,2.004538577912254,29.23685001205061
Task_32431,2210,804,21,111,132,2.7453416149068324,44.049767151662
Task_32432,1361,827,42,25,67,1.643719806763285,29.141549066370057
Task_32433,2559,813,82,46,128,3.1437346437346436,49.13357278273762
Task_32434,995,697,132,148,280,1.4255014326647564,25.30160466735275
Task_32435,828,283,81,41,122,2.915492957746479,19.728504418012935
Task_32436,1714,568,20,12,32,3.0123022847100174,33.600240874926214
Task_32437,2997,934,52,142,194,3.205347593582888,57.48920956040956
Task_32438,2072,501,56,22,78,4.127490039840637,39.38344491728188
Task_32439,2402,917,36,185,221,2.616557734204793,48.13511658709101
Task_32440,530,324,86,84,170,1.6307692307692307,16.076867577798613
Task_32441,2255,918,25,145,170,2.453754080522307,45.44694561449227
Task_32442,544,1006,134,154,288,0.5402184707050646,19.29492242709011
Task_32443,1858,203,170,195,365,9.107843137254902,37.85679317539597
Task_32444,1586,710,49,101,150,2.230661040787623,33.99512350091823
Task_32445,1345,470,152,190,342,2.8556263269639066,30.527778086338003
Task_32446,2722,828,183,169,352,3.2834740651387215,53.4793712378937
Task_32447,2262,286,138,152,290,7.881533101045296,44.138858235994974
Task_32448,1454,603,74,199,273,2.4072847682119205,32.43568088088171
Task_32449,2314,374,133,185,318,6.1706666666666665,45.43586989476279
Task_32450,2537,931,29,77,106,2.7221030042918457,49.206362234571266
Task_32451,1801,895,39,78,117,2.010044642857143,37.64080483929721
Task_32452,1636,821,84,114,198,1.9902676399026764,35.48639860417479
Task_32453,1687,609,82,184,266,2.765573770491803,36.072456128868424
Task_32454,2273,692,101,160,261,3.27994227994228,45.51544697985397
Task_32455,1611,538,114,80,194,2.9888682745825603,34.02462384622529
Task_32456,1187,618,139,88,227,1.9176090468497577,27.764432385469195
Task_32457,2607,267,10,48,58,9.727611940298507,47.171929069891995
Task_32458,2425,552,90,91,181,4.3851717902350815,46.927792991784706
Task_32459,1693,666,46,180,226,2.5382308845577213,36.15207469749743
Task_32460,1184,974,192,120,312,1.2143589743589744,29.247464092797646
Task_32461,1057,712,111,13,124,1.482468443197756,24.625478378678185
Task_32462,2684,722,154,59,213,3.7123098201936378,51.432977544292385
Task_32463,985,107,158,88,246,9.12037037037037,22.528750501407654
Task_32464,1149,974,131,20,151,1.1784615384615384,27.230427619429957
Task_32465,2847,637,166,50,216,4.462382445141066,53.63953188200117
Task_32466,2243,408,30,179,209,5.484107579462103,43.928127439049526
Task_32467,1368,702,97,15,112,1.945945945945946,29.45788082210224
Task_32468,1240,349,119,24,143,3.5428571428571427,26.669271556053072
Task_32469,1758,841,28,200,228,2.0878859857482186,37.72305114752347
Task_32470,1424,938,152,110,262,1.516506922257721,32.72076595690106
Task_32471,1618,762,122,46,168,2.1205766710353866,34.22256693227389
Task_32472,2857,910,79,23,102,3.1361141602634466,53.60826129692984
Task_32473,527,241,133,157,290,2.177685950413223,16.57568784295823
Task_32474,2822,116,164,171,335,24.11965811965812,52.150672643874714
Task_32475,1132,978,173,121,294,1.1562819203268642,28.351816042329414
Task_32476,1463,76,109,41,150,19.0,28.489371463116004
Task_32477,2547,863,87,180,267,2.9479166666666665,50.4096030087647
Task_32478,1460,389,51,162,213,3.7435897435897436,31.564624470128663
Task_32479,1920,646,173,84,257,2.9675425038639878,39.57530035546841
Task_32480,1739,791,155,181,336,2.1957070707070705,37.73507915461206
Task_32481,987,272,10,142,152,3.6153846153846154,23.035430265150165
Task_32482,2174,748,91,75,166,2.902536715620828,43.412239701441315
Task_32483,1176,774,186,110,296,1.5174193548387096,28.4356532455287
Task_32484,1438,576,135,180,315,2.4922010398613517,32.1983840393158
Task_32485,698,79,134,142,276,8.725,18.2223408297284
Task_32486,1182,588,59,63,122,2.00679117147708,26.70311428921779
Task_32487,2962,329,101,55,156,8.975757575757576,54.19097373915795
Task_32488,1490,326,50,27,77,4.556574923547401,29.66808394555679
Task_32489,2100,169,21,97,118,12.352941176470589,39.49043520703579
Task_32490,2592,345,72,128,200,7.491329479768786,49.180292863488695
Task_32491,1263,447,23,82,105,2.8191964285714284,27.56700396270651
Task_32492,1260,694,176,73,249,1.8129496402877698,29.06423350707672
Task_32493,2444,415,139,85,224,5.875,46.98150164742949
Task_32494,1785,215,184,175,359,8.26388888888889,36.69264331669381
Task_32495,2986,347,167,158,325,8.580459770114942,55.966645254672265
Task_32496,1508,642,45,40,85,2.3452566096423015,31.304003866435085
Task_32497,1099,967,171,52,223,1.1353305785123966,27.1707707895974
Task_32498,1427,551,149,54,203,2.585144927536232,30.960403373026548
Task_32499,659,112,165,55,220,5.831858407079646,17.06429954943625
Task_32500,1441,789,163,87,250,1.8240506329113924,32.42088970544267
Task_32501,1806,689,12,183,195,2.617391304347826,37.809047208746016
Task_32502,2068,274,156,62,218,7.52,40.25393033337513
Task_32503,884,332,147,155,302,2.6546546546546548,22.562205337514666
Task_32504,2408,745,106,112,218,3.227882037533512,47.55657188229452
Task_32505,1025,193,193,63,256,5.283505154639175,23.766629673466117
Task_32506,551,257,53,168,221,2.135658914728682,16.78344601721339
Task_32507,817,814,47,46,93,1.0024539877300613,21.059707523307637
Task_32508,2137,245,125,171,296,8.6869918699187,42.072131805113685
Task_32509,2802,837,101,181,282,3.343675417661098,54.47722019369265
Task_32510,701,144,161,152,313,4.834482758620689,18.89648092486257
Task_32511,1213,82,45,36,81,14.614457831325302,24.167493772972126
Task_32512,2071,721,104,88,192,2.8684210526315788,41.92920884691117
Task_32513,1812,290,128,61,189,6.22680412371134,36.11862947463276
Task_32514,2029,895,21,68,89,2.2645089285714284,40.731982540980646
Task_32515,822,213,142,71,213,3.8411214953271027,20.42764951900497
Task_32516,1676,540,130,52,182,3.0979667282809613,34.78552766263333
Task_32517,2509,1012,92,133,225,2.47680157946693,50.06167121942613
Task_32518,913,897,164,71,235,1.0167037861915367,24.085864684137942
Task_32519,686,465,74,55,129,1.4721030042918455,18.578212907428068
Task_32520,2294,820,50,193,243,2.7941534713763705,46.315291687652255
Task_32521,990,151,22,166,188,6.5131578947368425,22.838792573326476
Task_32522,2472,69,19,69,88,35.31428571428572,44.04696918664299
Task_32523,579,570,156,42,198,1.0140105078809107,17.305178910294813
Task_32524,1919,601,14,70,84,3.1877076411960132,38.00870041248054
Task_32525,2547,127,65,83,148,19.8984375,46.69050852192922
Task_32526,2632,727,99,18,117,3.6153846153846154,49.55536529838228
Task_32527,1192,185,62,84,146,6.408602150537634,26.030443940929487
Task_32528,976,927,167,25,192,1.0517241379310345,24.64881049278708
Task_32529,1523,443,108,69,177,3.43018018018018,32.02672939933986
Task_32530,1072,954,109,30,139,1.1225130890052355,25.9189932526433
Task_32531,1767,836,144,169,313,2.111111111111111,38.197709893578114
Task_32532,2938,651,135,156,291,4.506134969325154,56.04814033333395
Task_32533,1403,211,144,40,184,6.617924528301887,29.129916816724748
Task_32534,2058,203,183,166,349,10.088235294117647,40.89928766904748
Task_32535,1802,695,87,51,138,2.589080459770115,36.86642479812367
Task_32536,2404,663,105,33,138,3.6204819277108435,46.091586101823616
Task_32537,1783,212,28,171,199,8.370892018779342,35.91303367397131
Task_32538,1350,214,67,141,208,6.27906976744186,29.164593523789424
Task_32539,1533,790,171,119,290,1.9380530973451326,34.170118500289796
Task_32540,1984,487,27,29,56,4.065573770491803,37.95381335382921
Task_32541,2656,547,192,118,310,4.846715328467154,51.27956130321413
Task_32542,1193,338,184,18,202,3.5191740412979353,26.238523159385533
Task_32543,2289,363,71,91,162,6.288461538461538,44.0912048780522
Task_32544,564,470,70,173,243,1.197452229299363,17.698672586146447
Task_32545,2637,768,16,182,198,3.4291287386215865,51.24179073883794
Task_32546,1583,749,52,41,93,2.1106666666666665,32.8479252889069
Task_32547,1458,320,41,165,206,4.542056074766355,31.19554445537403
Task_32548,1816,469,52,73,125,3.8638297872340424,36.59993452148829
Task_32549,1571,932,189,94,283,1.6838156484458735,35.12535856629497
Task_32550,2297,654,114,80,194,3.5068702290076335,45.25508021080119
Task_32551,643,1003,156,165,321,0.6404382470119522,21.02577735662246
Task_32552,560,324,165,156,321,1.7230769230769232,17.48640488699036
Task_32553,1670,955,185,114,299,1.7468619246861925,36.87358294522597
Task_32554,1414,731,41,184,225,1.9316939890710383,31.91617095262239
Task_32555,1759,604,124,105,229,2.9074380165289258,36.87235823852706
Task_32556,802,367,71,152,223,2.1793478260869565,21.076068888265926
Task_32557,2578,324,22,101,123,7.932307692307693,48.19847148715572
Task_32558,2284,686,146,113,259,3.3245997088791848,45.592870399840514
Task_32559,2108,283,162,165,327,7.422535211267606,41.879809868664076
Task_32560,566,615,198,61,259,0.9188311688311688,17.827889644568202
Task_32561,2051,341,116,121,237,5.997076023391813,40.706314678597614
Task_32562,2176,793,48,27,75,2.7405541561712847,41.975708335572236
Task_32563,753,73,129,148,277,10.175675675675675,19.104974294982338
Task_32564,2362,816,54,80,134,2.8910648714810283,46.52749305126223
Task_32565,2630,507,108,95,203,5.177165354330708,50.236416554783155
Task_32566,2079,474,63,104,167,4.376842105263158,41.26141011698153
Task_32567,2185,897,20,95,115,2.433184855233853,43.74679604283629
Task_32568,1869,229,167,191,358,8.126086956521739,38.089289198463476
Task_32569,1001,675,16,25,41,1.4807692307692308,22.837674571207646
Task_32570,879,848,56,161,217,1.0353356890459364,23.68374457094063
Task_32571,2082,705,37,124,161,2.9490084985835696,41.89638948178197
Task_32572,1222,210,54,101,155,5.791469194312796,26.635416400588824
Task_32573,2926,598,158,126,284,4.884808013355593,55.613300631685775
Task_32574,887,370,149,152,301,2.3908355795148246,22.721909077632716
Task_32575,1197,893,145,40,185,1.3389261744966443,28.05771719673878
Task_32576,1959,471,29,181,210,4.15042372881356,39.64454599185499
Task_32577,2913,489,197,183,380,5.944897959183673,55.57140631474558
Task_32578,2921,121,195,17,212,23.942622950819672,52.44153953583491
Task_32579,2176,391,188,164,352,5.551020408163265,43.43130214137699
Task_32580,1488,576,135,191,326,2.5788561525129983,33.05586092493818
Task_32581,1540,899,189,111,300,1.711111111111111,34.63987052604847
Task_32582,2943,487,118,56,174,6.030737704918033,54.60275963523838
Task_32583,2798,728,143,44,187,3.8381344307270235,52.90923120482157
Task_32584,699,221,91,130,221,3.1486486486486487,18.876066844489408
Task_32585,2089,664,95,171,266,3.1413533834586467,42.56172617465962
Task_32586,957,473,33,128,161,2.018987341772152,23.337417962251553
Task_32587,2982,982,154,84,238,3.0335707019328586,57.36823632047112
Task_32588,1523,763,197,148,345,1.993455497382199,34.21798151255557
Task_32589,1899,791,60,158,218,2.397727272727273,39.77376905250545
Task_32590,1652,580,65,99,164,2.8433734939759034,34.816549343758986
Task_32591,1525,658,103,67,170,2.314112291350531,32.69513629320742
Task_32592,2063,931,53,140,193,2.213519313304721,42.67233096458216
Task_32593,2606,415,146,192,338,6.264423076923077,50.29281864759355
Task_32594,2488,285,42,192,234,8.6993006993007,47.530792291114686
Task_32595,2442,159,29,101,130,15.2625,45.09446059916249
Task_32596,652,689,122,77,199,0.9449275362318841,19.294005343317206
Task_32597,2163,690,166,127,293,3.130246020260492,43.86259954434595
Task_32598,1226,738,62,13,75,1.658998646820027,26.58924606476496
Task_32599,1842,269,94,92,186,6.822222222222222,36.809495515761945
Task_32600,1415,825,191,178,369,1.7130750605326877,32.83861379423957
Task_32601,2821,405,14,142,156,6.948275862068965,52.561155405226835
Task_32602,1119,552,57,129,186,2.023508137432188,26.448656024024945
Task_32603,2729,694,28,123,151,3.9266187050359713,51.97730327454235
Task_32604,2688,496,19,29,48,5.408450704225352,49.04085105956549
Task_32605,2969,346,167,183,350,8.556195965417867,55.84360884472026
Task_32606,713,383,102,22,124,1.8567708333333333,18.210167028102273
Task_32607,1178,752,52,151,203,1.5644090305444887,28.115568821692705
Task_32608,897,597,93,46,139,1.5,22.13427616241241
Task_32609,1991,916,32,127,159,2.1712104689203926,41.05013229463278
Task_32610,1523,98,129,93,222,15.383838383838384,30.84507930922914
Task_32611,1230,599,38,17,55,2.05,26.239651281284342
Task_32612,1257,339,12,115,127,3.697058823529412,27.43912243186013
Task_32613,1063,556,122,165,287,1.9084380610412925,26.049340503629193
Task_32614,506,844,96,100,196,0.5988165680473373,17.742832548803843
Task_32615,1993,697,133,114,247,2.855300859598854,40.96540342939172
Task_32616,2848,659,10,120,130,4.315151515151515,53.673013883333134
Task_32617,1533,589,40,49,89,2.5983050847457627,31.658525617742697
Task_32618,597,321,72,90,162,1.8540372670807452,17.213781502672735
Task_32619,1789,556,159,45,204,3.2118491921005385,36.46886746030203
Task_32620,1958,589,27,46,73,3.31864406779661,37.91168016363369
Task_32621,1306,846,36,84,120,1.5419126328217236,29.608547282780112
Task_32622,1263,482,103,124,227,2.6149068322981366,28.65266401135185
Task_32623,2825,95,157,152,309,29.427083333333332,51.796433758358354
Task_32624,1291,282,41,112,153,4.561837455830389,27.891793479694275
Task_32625,902,782,185,42,227,1.1519795657726692,23.24806006318183
Task_32626,2292,887,83,102,185,2.581081081081081,46.00230256584766
Task_32627,1207,676,195,142,337,1.7828655834564253,28.882820273935806
Task_32628,1327,701,77,116,193,1.8903133903133904,30.25478557410683
Task_32629,2064,518,196,82,278,3.976878612716763,41.54515102443847
Task_32630,2795,860,67,110,177,3.2462253193960513,53.90982542662658
Task_32631,846,207,61,82,143,4.0673076923076925,20.66668172702362
Task_32632,1522,879,156,148,304,1.7295454545454545,34.36480822701856
Task_32633,617,362,192,92,284,1.699724517906336,18.19544179468494
Task_32634,1153,783,148,47,195,1.4706632653061225,27.103119921175946
Task_32635,982,810,142,117,259,1.2108508014796548,25.295596011225303
Task_32636,2619,882,96,190,286,2.9660249150622877,51.757588358784254
Task_32637,1466,1006,180,119,299,1.4558093346573981,33.7659253756084
Task_32638,2871,873,164,41,205,3.2848970251716247,54.61946488893818
Task_32639,934,360,56,195,251,2.587257617728532,23.340887902287424
Task_32640,2718,350,106,183,289,7.743589743589744,51.61221779034361
Task_32641,2391,489,119,50,169,4.8795918367346935,45.69290283154367
Task_32642,2049,355,126,156,282,5.75561797752809,40.9755713010804
Task_32643,1811,874,168,77,245,2.069714285714286,38.40566129427811
Task_32644,915,465,67,142,209,1.963519313304721,23.110140770548256
Task_32645,2057,591,29,115,144,3.4746621621621623,40.99072924904429
Task_32646,983,961,149,26,175,1.021829521829522,24.803446710650643
Task_32647,1235,561,37,142,179,2.197508896797153,28.269795492694545
Task_32648,1142,587,150,169,319,1.9421768707482994,27.54739647680797
Task_32649,1404,957,71,51,122,1.465553235908142,31.178078620320097
Task_32650,1078,383,34,10,44,2.8072916666666665,23.048698558213633
Task_32651,860,238,189,64,253,3.598326359832636,21.24639775081869
Task_32652,2533,407,35,153,188,6.208333333333333,48.37856452016598
Task_32653,1314,897,200,172,372,1.4632516703786191,31.426153054642104
Task_32654,2050,466,184,31,215,4.389721627408994,40.36743101005387
Task_32655,2735,441,53,89,142,6.1877828054298645,51.29035624280297
Task_32656,1411,171,162,99,261,8.203488372093023,29.869967638322834
Task_32657,715,490,171,184,355,1.4562118126272912,20.613732529691568
Task_32658,2684,583,50,60,110,4.595890410958904,50.242400234943766
Task_32659,1761,386,58,31,89,4.550387596899225,34.43647847599737
Task_32660,1269,628,174,183,357,2.0174880763116056,29.87866670087119
Task_32661,553,297,11,91,102,1.8557046979865772,15.770846329434262
Task_32662,2547,257,138,156,294,9.872093023255815,48.563112143186316
Task_32663,2832,756,75,27,102,3.7410832232496696,52.79400300628703
Task_32664,812,712,48,67,115,1.1388499298737729,21.269362395868015
Task_32665,2773,402,170,133,303,6.880893300248139,52.64797958944274
Task_32666,2953,974,11,93,104,3.0287179487179485,55.95913182732814
Task_32667,2380,344,51,52,103,6.898550724637682,44.49937844489159
Task_32668,1440,892,173,45,218,1.612541993281075,32.07154158819772
Task_32669,2210,1023,73,111,184,2.158203125,45.15500251864364
Task_32670,1595,805,190,86,276,1.978908188585608,35.021299262534015
Task_32671,2923,104,94,108,202,27.83809523809524,52.94462179264817
Task_32672,1716,80,188,163,351,21.185185185185187,34.53603714605569
Task_32673,586,349,34,121,155,1.6742857142857144,17.006627351984783
Task_32674,1602,532,100,47,147,3.0056285178236397,33.09738446082871
Task_32675,2840,387,40,72,112,7.319587628865979,52.316812721779115
Task_32676,2753,628,121,58,179,4.376788553259141,52.063390949181525
Task_32677,2992,142,102,171,273,20.923076923076923,54.81436910871582
Task_32678,1983,716,37,102,139,2.7656903765690375,40.194022294756834
Task_32679,2476,339,61,91,152,7.2823529411764705,46.84557663908732
Task_32680,2018,624,128,196,324,3.2288,41.59883332942936
Task_32681,1013,867,19,159,178,1.1670506912442395,25.602694537622284
Task_32682,2665,631,28,177,205,4.216772151898734,51.29384803262772
Task_32683,1287,554,119,117,236,2.3189189189189188,29.289764263189152
Task_32684,1989,754,45,80,125,2.6344370860927153,40.32519165311951
Task_32685,2934,162,130,50,180,18.0,52.892626649766356
Task_32686,1132,802,27,181,208,1.4097135740971358,27.513714654347694
Task_32687,2127,1000,17,58,75,2.1248751248751248,42.06765601504141
Task_32688,1188,1019,15,130,145,1.1647058823529413,28.533500389419185
Task_32689,2663,520,195,47,242,5.111324376199616,50.39924926518086
Task_32690,1358,384,47,165,212,3.5272727272727273,29.876513782926597
Task_32691,2420,928,13,66,79,2.6049515608180838,46.731356790745444
Task_32692,1503,706,129,192,321,2.1258840169731257,33.67967126662575
Task_32693,2795,304,156,11,167,9.163934426229508,51.28371561223298
Task_32694,2008,184,70,68,138,10.854054054054053,38.668204976971275
Task_32695,763,577,178,149,327,1.320069204152249,21.4743204177322
Task_32696,1848,598,139,187,326,3.0851419031719534,38.82028364911337
Task_32697,956,833,80,127,207,1.146282973621103,24.772941073314612
Task_32698,2155,980,62,47,109,2.196738022426096,42.74929456535906
Task_32699,1269,664,113,54,167,1.9082706766917292,28.646111039693267
Task_32700,2037,288,88,159,247,7.048442906574395,40.36425148893151
Task_32701,2373,776,140,125,265,3.054054054054054,47.330338947484115
Task_32702,1457,323,75,97,172,4.496913580246914,30.99735516265145
Task_32703,1624,350,86,119,205,4.626780626780627,33.79527590823245
Task_32704,1947,383,119,167,286,5.0703125,39.48862364569004
Task_32705,2790,983,157,73,230,2.8353658536585367,54.12134363072164
Task_32706,533,803,57,42,99,0.6629353233830846,16.69785606318634
Task_32707,2232,392,164,185,349,5.679389312977099,44.33793438048449
Task_32708,2352,258,133,11,144,9.08108108108108,43.913884335317896
Task_32709,2170,428,108,130,238,5.058275058275059,42.8940284523153
Task_32710,1007,345,80,27,107,2.9104046242774566,22.60737494224776
Task_32711,2391,1020,41,82,123,2.3418217433888344,47.49819570746879
Task_32712,2479,803,65,42,107,3.0833333333333335,47.3424969215797
Task_32713,837,866,24,19,43,0.9653979238754326,20.955825439632708
Task_32714,933,356,106,196,302,2.6134453781512605,23.474042243324856
Task_32715,857,863,17,24,41,0.9918981481481481,21.250934638227854
Task_32716,678,109,153,120,273,6.163636363636364,18.00924363801418
Task_32717,950,734,130,169,299,1.2925170068027212,24.81277130384736
Task_32718,2595,663,145,145,290,3.908132530120482,50.632897969321256
Task_32719,1794,744,63,66,129,2.408053691275168,37.146112425235096
Task_32720,781,656,31,112,143,1.1887366818873668,20.927343056951603
Task_32721,2493,432,163,180,343,5.757505773672055,48.56553348681487
Task_32722,882,146,95,124,219,6.0,21.307718235083446
Task_32723,895,530,79,178,257,1.6854990583804144,23.238377498140967
Task_32724,2985,972,100,188,288,3.0678314491264134,57.836937769001395
Task_32725,1672,799,17,85,102,2.09,35.06405813446047
Task_32726,1733,511,168,54,222,3.384765625,35.764438951763914
Task_32727,2727,480,192,173,365,5.669438669438669,52.5153237655148
Task_32728,1895,645,83,138,221,2.93343653250774,39.203354654264594
Task_32729,912,883,92,38,130,1.0316742081447965,23.242935334326813
Task_32730,1339,577,162,82,244,2.3166089965397925,30.098991623961382
Task_32731,1580,691,138,156,294,2.2832369942196533,34.678032632611824
Task_32732,547,393,187,137,324,1.3883248730964468,17.442884261946617
Task_32733,803,245,10,117,127,3.2642276422764227,19.954328478806875
Task_32734,629,788,120,134,254,0.7972116603295311,19.70211936093291
Task_32735,1840,757,119,79,198,2.4274406332453826,38.35530298244388
Task_32736,2995,1014,25,135,160,2.9507389162561575,57.26795127323618
Task_32737,724,643,177,132,309,1.124223602484472,20.924246295342044
Task_32738,706,1009,40,120,160,0.699009900990099,21.091769216344524
Task_32739,2690,69,12,167,179,38.42857142857143,48.874441496131716
Task_32740,1858,823,115,10,125,2.254854368932039,37.73240827569804
Task_32741,1007,181,150,59,209,5.532967032967033,22.99111970840188
Task_32742,1243,217,112,23,135,5.701834862385321,26.207932801163267
Task_32743,665,727,122,81,203,0.9134615384615384,19.66921640114968
Task_32744,875,235,127,68,195,3.707627118644068,21.21647364196477
Task_32745,827,452,143,152,295,1.82560706401766,22.004185154424153
Task_32746,2547,499,136,86,222,5.094,48.889148517029504
Task_32747,2347,211,79,86,165,11.070754716981131,44.55987595143122
Task_32748,1341,473,182,86,268,2.829113924050633,29.92166855214808
Task_32749,2216,283,165,156,321,7.802816901408451,43.54676642281036
Task_32750,771,990,178,146,324,0.7780020181634713,22.909258476424842
Task_32751,735,183,122,167,289,3.994565217391304,19.606843489846515
Task_32752,2519,66,59,94,153,37.59701492537314,45.65017074356138
Task_32753,1855,463,169,29,198,3.997844827586207,37.187832883155366
Task_32754,1989,904,96,20,116,2.197790055248619,39.95662911510482
Task_32755,2577,102,124,165,289,25.019417475728154,47.94186806243093
Task_32756,2370,821,40,82,122,2.883211678832117,46.51641252577256
Task_32757,1080,330,43,199,242,3.2628398791540785,25.46631589975154
Task_32758,2101,300,161,80,241,6.980066445182724,41.21638804104696
Task_32759,2699,924,138,112,250,2.917837837837838,52.872248848757636
Task_32760,1212,190,111,11,122,6.345549738219895,25.509023564843744
Task_32761,737,682,50,104,154,1.0790629575402635,20.36397510281274
Task_32762,820,251,155,146,301,3.253968253968254,21.270741720419483
Task_32763,2617,912,125,92,217,2.8663745892661554,51.30555912901452
Task_32764,2129,337,17,22,39,6.298816568047338,39.50925726594239
Task_32765,1297,946,17,57,74,1.3695881731784583,28.74311950925438
Task_32766,1678,169,191,104,295,9.870588235294118,34.239468218475665
Task_32767,1955,237,68,96,164,8.214285714285714,38.53416390819209
Task_32768,753,877,73,96,169,0.857630979498861,21.506047547088837
Task_32769,2416,792,44,31,75,3.046658259773014,45.80804815825877
Task_32770,1283,588,47,24,71,2.1782682512733444,27.13779158659378
Task_32771,2481,758,73,111,184,3.268774703557312,48.62133849494682
Task_32772,765,151,163,171,334,5.032894736842105,20.06904889671499
Task_32773,2313,664,105,45,150,3.4781954887218047,44.72805521799497
Task_32774,2329,499,75,19,94,4.658,43.88590479983933
Task_32775,770,551,179,69,248,1.394927536231884,20.76937927252555
Task_32776,2696,350,34,114,148,7.680911680911681,50.355740342387634
Task_32777,1171,754,53,198,251,1.5509933774834437,28.296127936487864
Task_32778,1036,593,176,62,238,1.7441077441077442,25.036961979760978
Task_32779,1785,342,140,74,214,5.204081632653061,36.151443949872366
Task_32780,2380,474,156,147,303,5.010526315789473,46.68531196541963
Task_32781,1416,179,65,84,149,7.866666666666666,29.24899572493585
Task_32782,1025,529,149,52,201,1.9339622641509433,24.55009666415988
Task_32783,1925,106,134,101,235,17.990654205607477,37.39158047516919
Task_32784,1682,230,176,57,233,7.2813852813852815,34.067069330493155
Task_32785,1591,413,172,190,362,3.842995169082126,34.32931601331273
Task_32786,1842,268,174,142,316,6.847583643122676,37.539939894960206
Task_32787,1309,266,34,80,114,4.902621722846442,27.879838427627593
Task_32788,2810,1022,35,137,172,2.7468230694037143,54.60798433657222
Task_32789,1695,550,89,190,279,3.076225045372051,36.01733852383533
Task_32790,1589,723,87,159,246,2.1947513812154695,34.6689324496355
Task_32791,1343,911,123,149,272,1.4725877192982457,31.444660193697015
Task_32792,1335,937,73,45,118,1.4232409381663114,29.72673578109236
Task_32793,1659,691,105,114,219,2.397398843930636,35.529796478163355
Task_32794,1920,223,19,59,78,8.571428571428571,36.40856580036838
Task_32795,2337,725,27,104,131,3.21900826446281,45.80746623275764
Task_32796,1756,85,89,48,137,20.41860465116279,33.070793256323356
Task_32797,882,809,139,142,281,1.0888888888888888,23.844617135186635
Task_32798,2334,773,125,14,139,3.0155038759689923,45.24035035049939
Task_32799,2237,652,30,161,191,3.42572741194487,44.508251477767665
Task_32800,712,781,126,99,225,0.9104859335038363,20.784535030547637
Task_32801,2969,892,179,115,294,3.32474804031355,57.25308550857259
Task_32802,2006,804,43,164,207,2.4919254658385093,41.416082422472485
Task_32803,1224,627,127,19,146,1.9490445859872612,27.350466266586213
Task_32804,1697,317,27,37,64,5.336477987421383,32.84564039948305
Task_32805,1081,677,179,154,333,1.5943952802359882,26.88971629448007
Task_32806,1148,600,163,12,175,1.9101497504159735,26.22110118260167
Task_32807,749,76,126,23,149,9.727272727272727,17.291868868821677
Task_32808,1339,717,52,20,72,1.8649025069637883,28.311263475197546
Task_32809,584,591,84,61,145,0.9864864864864865,17.456801477398766
Task_32810,2582,138,70,39,109,18.575539568345324,46.450890352555014
Task_32811,1746,634,23,119,142,2.7496062992125982,36.17953929415108
Task_32812,1151,583,177,119,296,1.970890410958904,27.500450152744943
Task_32813,1868,485,10,37,47,3.843621399176955,36.03840723825792
Task_32814,530,244,68,89,157,2.163265306122449,15.840308700092685
Task_32815,608,194,118,65,183,3.117948717948718,16.819998723839774
Task_32816,2289,718,37,85,122,3.1835883171070933,44.92034096185166
Task_32817,2517,622,79,83,162,4.040128410914928,48.50738890131939
Task_32818,2331,149,157,83,240,15.54,44.06031876864324
Task_32819,2673,561,24,168,192,4.7562277580071175,51.12262441046898
Task_32820,2220,231,127,152,279,9.568965517241379,43.22732734583392
Task_32821,1762,887,151,95,246,1.9842342342342343,37.88027005928505
Task_32822,2556,881,39,24,63,2.8979591836734695,48.2267610888914
Task_32823,1774,291,190,145,335,6.075342465753424,36.634196907323975
Task_32824,849,1012,33,35,68,0.8381046396841066,21.752547691670113
Task_32825,1322,375,47,52,99,3.515957446808511,27.80189443342603
Task_32826,2751,911,195,41,236,3.0164473684210527,52.97674437138786
Task_32827,626,587,124,97,221,1.064625850340136,18.79718758694326
Task_32828,2486,901,42,151,193,2.7560975609756095,49.24221528279389
Task_32829,597,927,31,17,48,0.6433189655172413,17.514064278161587
Task_32830,1280,792,35,63,98,1.614123581336696,28.66039424518379
Task_32831,600,312,193,188,381,1.9169329073482428,18.41171735780594
Task_32832,1238,921,163,29,192,1.3427331887201734,28.830886607247677
Task_32833,2846,815,41,45,86,3.4877450980392157,53.01836810076506
Task_32834,1479,298,104,79,183,4.946488294314381,31.074638342017625
Task_32835,660,989,49,113,162,0.6666666666666666,20.460917583459636
Task_32836,1185,905,157,175,332,1.3079470198675496,29.237992045576007
Task_32837,2756,453,111,10,121,6.070484581497797,50.68177037696003
Task_32838,2605,928,151,118,269,2.804090419806243,51.48967054691273
Task_32839,1491,381,110,179,289,3.9031413612565444,32.29853718679637
Task_32840,1404,1006,164,130,294,1.394240317775571,32.776954388269694
Task_32841,2088,865,110,195,305,2.4110854503464205,43.3761812361324
Task_32842,1799,561,139,24,163,3.201067615658363,36.385850432515646
Task_32843,2127,514,50,17,67,4.1300970873786405,40.14343953962241
Task_32844,2240,640,25,144,169,3.4945397815912638,44.331673860068655
Task_32845,1280,989,165,150,315,1.292929292929293,30.875976190792713
Task_32846,1551,101,189,71,260,15.205882352941176,31.196610959984287
Task_32847,2574,857,73,161,234,3.0,50.74171380042841
Task_32848,2874,154,175,75,250,18.54193548387097,52.55073479653265
Task_32849,1191,1017,142,193,335,1.1699410609037328,29.706883204531394
Task_32850,846,442,107,179,286,1.909706546275395,22.27251504420145
Task_32851,2270,843,65,191,256,2.68957345971564,46.03420430537489
Task_32852,1571,1008,40,113,153,1.5569871159563924,34.566990522811516
Task_32853,2875,852,151,99,250,3.3704572098475967,55.41051335757927
Task_32854,2019,306,173,181,354,6.576547231270358,40.69722298767599
Task_32855,2854,361,183,156,339,7.883977900552487,53.986948315823234
Task_32856,1180,184,195,99,294,6.378378378378378,26.542543170737346
Task_32857,2067,728,72,166,238,2.8353909465020575,42.33050678719885
Task_32858,1497,994,19,166,185,1.5045226130653266,33.74592568032977
Task_32859,2585,310,193,152,345,8.311897106109324,49.57745686770327
Task_32860,1250,531,68,82,150,2.3496240601503757,28.101242537696976
Task_32861,1279,330,87,155,242,3.86404833836858,28.492653492902793
Task_32862,1437,694,125,94,219,2.0676258992805754,31.986724935812514
Task_32863,903,177,155,107,262,5.073033707865169,21.853987732603347
Task_32864,1849,538,169,181,350,3.430426716141002,38.74555826776494
Task_32865,1155,213,169,82,251,5.397196261682243,26.043830728732132
Task_32866,2952,683,137,111,248,4.315789473684211,56.11186062115314
Task_32867,2941,222,187,132,319,13.188340807174887,54.730686500376635
Task_32868,2953,216,176,56,232,13.608294930875577,54.08665472131102
Task_32869,1523,133,40,76,116,11.365671641791044,30.110088660357075
Task_32870,2904,999,85,76,161,2.904,55.62665932383813
Task_32871,2525,530,34,54,88,4.75517890772128,47.281440649618844
Task_32872,1962,974,37,197,234,2.0123076923076924,41.42577768066288
Task_32873,1286,568,183,178,361,2.260105448154657,29.97068669503277
Task_32874,2516,768,79,75,154,3.271781534460338,48.72826391029659
Task_32875,929,748,164,167,331,1.240320427236315,24.661531947005056
Task_32876,743,1018,82,99,181,0.7291462217860648,21.896514538400243
Task_32877,2556,780,41,22,63,3.272727272727273,47.895106894832914
Task_32878,2229,390,195,178,373,5.70076726342711,44.381766921058706
Task_32879,2438,886,85,21,106,2.7485907553551296,46.9128844929424
Task_32880,2264,1009,54,33,87,2.241584158415842,44.339315033501805
Task_32881,707,593,126,93,219,1.1902356902356903,20.039165405464896
Task_32882,1064,186,140,139,279,5.689839572192513,24.831579940598115
Task_32883,1496,499,168,26,194,2.992,31.575123252910917
Task_32884,660,782,95,163,258,0.842911877394636,20.20710860024543
Task_32885,756,266,121,64,185,2.831460674157303,19.358319099626975
Task_32886,2443,484,99,186,285,5.0371134020618555,47.69273455922473
Task_32887,2467,87,41,181,222,28.03409090909091,45.80320562279774
Task_32888,2369,808,198,175,373,2.9283065512978985,47.92733969377256
Task_32889,1716,650,114,139,253,2.6359447004608296,36.49401365937298
Task_32890,2197,336,191,148,339,6.519287833827893,43.497980333570275
Task_32891,1815,419,76,63,139,4.321428571428571,36.39224037807363
Task_32892,2132,555,134,107,241,3.8345323741007196,42.68089597436134
Task_32893,1838,907,92,145,237,2.0242290748898677,39.17363163138284
Task_32894,735,541,187,100,287,1.3560885608856088,20.666768386989506
Task_32895,1217,721,107,58,165,1.685595567867036,27.99408516757374
Task_32896,1507,257,21,62,83,5.841085271317829,30.27886751002968
Task_32897,1423,295,174,65,239,4.8074324324324325,30.286948584264426
Task_32898,2593,277,156,122,278,9.327338129496402,49.24093164782587
Task_32899,1408,886,80,81,161,1.5873731679819616,31.65354591907725
Task_32900,1198,702,188,181,369,1.7041251778093884,29.02265250081851
Task_32901,1090,358,184,17,201,3.0362116991643453,24.665391839829258
Task_32902,2838,972,47,52,99,2.9167523124357655,53.69532522101519
Task_32903,2783,517,190,172,362,5.372586872586872,53.507116753677714
Task_32904,2342,713,152,83,235,3.280112044817927,46.372590154199344
Task_32905,2156,636,166,100,266,3.3846153846153846,43.42021173952107
Task_32906,1051,708,115,113,228,1.4823695345557122,25.948297106949425
Task_32907,2539,94,117,193,310,26.726315789473684,47.36373674930899
Task_32908,552,361,146,87,233,1.5248618784530388,16.892042209454274
Task_32909,2057,80,183,115,298,25.395061728395063,39.56972218361888
Task_32910,2354,847,131,79,210,2.775943396226415,46.8341547321447
Task_32911,1929,573,66,165,231,3.3606271777003482,39.640940722044824
Task_32912,2867,991,155,165,320,2.8901209677419355,56.13687231360615
Task_32913,1475,517,88,90,178,2.8474903474903477,31.76193027344946
Task_32914,1219,487,47,18,65,2.497950819672131,25.686825238905964
Task_32915,834,646,28,178,206,1.2890262751159196,22.272970599715865
Task_32916,1405,538,100,171,271,2.6066790352504636,31.34473965703087
Task_32917,1045,981,140,175,315,1.0641547861507128,27.16503370500583
Task_32918,2517,739,160,36,196,3.401351351351351,48.54052030495142
Task_32919,798,495,175,165,340,1.6088709677419355,21.88826928660573
Task_32920,1358,231,75,166,241,5.853448275862069,29.5261749605385
Task_32921,1841,646,162,47,209,2.8454404945904175,37.63449718755111
Task_32922,525,555,87,33,120,0.9442446043165468,15.849239849089704
Task_32923,1184,443,165,144,309,2.6666666666666665,27.677645597944032
Task_32924,2152,818,136,104,240,2.6275946275946276,43.8170883525112
Task_32925,2536,803,93,198,291,3.154228855721393,50.26009126435827
Task_32926,2897,188,51,156,207,15.328042328042327,53.54261253245996
Task_32927,2116,502,170,32,202,4.20675944333996,41.47084427615929
Task_32928,1885,361,86,122,208,5.207182320441989,37.97806997329519
Task_32929,2384,418,54,79,133,5.689737470167064,45.642758719331624
Task_32930,2781,768,118,165,283,3.6163849154746424,53.90865606856962
Task_32931,1381,708,53,84,137,1.9478138222849084,30.661177536199602
Task_32932,1373,247,73,174,247,5.536290322580645,29.852225646783893
Task_32933,2966,199,113,84,197,14.83,54.34538505872187
Task_32934,1062,728,104,11,115,1.4567901234567902,24.63327242581417
Task_32935,1398,478,131,197,328,2.918580375782881,31.339279658047563
Task_32936,2916,479,199,129,328,6.075,55.272665911194984
Task_32937,2821,330,113,55,168,8.522658610271904,52.10052742075553
Task_32938,2002,555,31,116,147,3.6007194244604315,40.03407400849244
Task_32939,1014,971,142,31,173,1.0432098765432098,25.339261170431893
Task_32940,2634,592,160,167,327,4.441821247892074,51.22379885629105
Task_32941,2902,203,194,173,367,14.22549019607843,54.31371672370707
Task_32942,1656,811,118,26,144,2.039408866995074,34.74876587311906
Task_32943,656,376,111,54,165,1.740053050397878,18.044255221303384
Task_32944,1453,390,11,120,131,3.7161125319693094,30.74097463835233
Task_32945,1999,621,35,67,102,3.2138263665594855,39.54503057073447
Task_32946,2400,125,44,14,58,19.047619047619047,42.88359407613026
Task_32947,630,832,137,126,263,0.7563025210084033,19.84936918887064
Task_32948,1110,421,133,65,198,2.6303317535545023,25.558893223566034
Task_32949,2567,427,88,28,116,5.997663551401869,47.652951092252984
Task_32950,2931,291,33,76,109,10.037671232876713,53.44913933381895
Task_32951,1119,301,43,109,152,3.705298013245033,25.230751062353203
Task_32952,2763,384,126,167,293,7.176623376623376,52.43410780721346
Task_32953,1064,486,124,92,216,2.184804928131417,25.36676305082777
Task_32954,2069,686,118,66,184,3.011644832605531,41.467381322146906
Task_32955,1127,486,100,156,256,2.3141683778234086,26.689977392416434
Task_32956,2039,803,32,128,160,2.5360696517412937,41.46682310387987
Task_32957,778,84,138,25,163,9.152941176470588,18.05851262828011
Task_32958,728,118,37,107,144,6.117647058823529,17.854080693242665
Task_32959,2453,979,28,43,71,2.503061224489796,46.968379060016055
Task_32960,663,80,186,195,381,8.185185185185185,18.219337948299493
Task_32961,1254,182,127,131,258,6.852459016393443,27.591716623535145
Task_32962,2875,412,164,76,240,6.961259079903147,53.75632704316786
Task_32963,921,873,182,155,337,1.0537757437070938,24.935904039976446
Task_32964,962,587,163,144,307,1.6360544217687074,24.592758758670996
Task_32965,2241,1016,98,61,159,2.2035398230088497,44.972155677075456
Task_32966,2381,869,139,157,296,2.7367816091954023,47.93487956868007
Task_32967,979,810,173,41,214,1.2071516646115907,24.50378156412845
Task_32968,870,888,33,195,228,0.9786276715410573,23.71092187006512
Task_32969,1337,346,27,60,87,3.8530259365994235,27.86434764088754
Task_32970,1519,963,45,188,233,1.5757261410788381,34.319007502389866
Task_32971,855,819,186,17,203,1.0426829268292683,22.37608800595089
Task_32972,802,807,194,15,209,0.9925742574257426,21.653338527373858
Task_32973,723,146,155,44,199,4.918367346938775,18.012634067705026
Task_32974,581,642,15,129,144,0.9035769828926905,17.74690041331819
Task_32975,1908,995,193,109,302,1.9156626506024097,40.78890030869371
Task_32976,2426,152,53,63,116,15.856209150326798,44.413400646086785
Task_32977,2156,480,67,61,128,4.482328482328482,42.02587066549302
Task_32978,1813,555,163,23,186,3.2607913669064748,36.69447605783146
Task_32979,1869,435,128,195,323,4.286697247706422,38.63139424699738
Task_32980,763,900,106,187,293,0.8468368479467259,22.394333969271297
Task_32981,619,438,10,55,65,1.4100227790432802,16.394655523160885
Task_32982,2173,436,101,169,270,4.97254004576659,43.16896627226658
Task_32983,568,358,116,136,252,1.5821727019498608,17.35049029534075
Task_32984,2168,671,168,28,196,3.2261904761904763,42.79075123431888
Task_32985,819,234,102,113,215,3.4851063829787234,20.762975026448235
Task_32986,618,1007,81,86,167,0.6130952380952381,19.86546935980165
Task_32987,2914,697,17,129,146,4.174785100286533,54.899371565446735
Task_32988,2024,258,40,112,152,7.814671814671815,39.38723222799943
Task_32989,1891,913,141,15,156,2.0689277899343543,38.76915333934634
Task_32990,1885,97,50,100,150,19.23469387755102,35.927471649146845
Task_32991,2639,704,135,112,247,3.743262411347518,51.217370010550816
Task_32992,2301,467,157,137,294,4.916666666666667,45.35688011314857
Task_32993,2022,83,88,142,230,24.071428571428573,38.74495915413293
Task_32994,2508,911,139,101,240,2.75,49.74392568675378
Task_32995,1634,106,47,95,142,15.271028037383177,32.02519472043487
Task_32996,2768,466,134,93,227,5.927194860813705,52.362912904430935
Task_32997,873,113,13,113,126,7.657894736842105,19.940593620367668
Task_32998,1020,619,115,185,300,1.6451612903225807,25.63962241024629
Task_32999,888,527,136,147,283,1.6818181818181819,23.12989516776032
Task_33000,1003,658,196,34,230,1.5220030349013658,24.459340594216993
Task_33001,1472,531,90,120,210,2.7669172932330826,32.02814596641205
Task_33002,598,966,52,92,144,0.6184074457083765,19.270041353097117
Task_33003,2797,338,119,189,308,8.250737463126844,52.91491644135533
Task_33004,2519,896,179,118,297,2.8082497212931994,50.153190639913
Task_33005,1977,823,45,53,98,2.3992718446601944,39.62224434252931
Task_33006,1071,960,44,131,175,1.1144640998959416,26.770402851342407
Task_33007,923,437,57,102,159,2.1073059360730593,22.659173316937856
Task_33008,1115,949,159,38,197,1.1736842105263159,27.019621119742894
Task_33009,1482,539,160,156,316,2.7444444444444445,32.74790902504741
Task_33010,1078,183,149,25,174,5.858695652173913,23.806205605918493
Task_33011,1961,600,42,119,161,3.262895174708819,39.63095606100646
Task_33012,803,133,132,29,161,5.992537313432836,18.868634664941634
Task_33013,2765,373,105,83,188,7.393048128342246,51.73909294064459
Task_33014,2286,526,54,19,73,4.337760910815939,42.67354424093303
Task_33015,931,994,53,197,250,0.935678391959799,25.175576143966662
Task_33016,1892,351,130,139,269,5.375,38.39529483690408
Task_33017,1152,469,154,57,211,2.451063829787234,26.371724418227924
Task_33018,1435,358,186,91,277,3.997214484679666,31.09998266539897
Task_33019,1931,270,166,140,306,7.125461254612546,38.905499972213114
Task_33020,2611,144,29,87,116,18.00689655172414,47.395076391934445
Task_33021,2394,674,179,126,305,3.546666666666667,47.523755553491306
Task_33022,2167,918,32,146,178,2.3579978237214365,44.12425233527458
Task_33023,2932,243,55,16,71,12.01639344262295,51.92368486500471
Task_33024,1317,956,150,87,237,1.3761755485893417,30.866160442754246
Task_33025,1216,512,71,49,120,2.3703703703703702,26.676937224563414
Task_33026,2356,346,15,39,54,6.789625360230548,43.36992224466773
Task_33027,1937,75,77,130,207,25.486842105263158,37.369299177870026
Task_33028,692,789,163,198,361,0.8759493670886076,21.249568610620372
Task_33029,961,1003,103,67,170,0.9571713147410359,24.89896871006627
Task_33030,1423,693,123,15,138,2.0504322766570606,30.549280874429268
Task_33031,526,850,170,60,230,0.618096357226792,17.929522566699585
Task_33032,1484,67,155,90,245,21.823529411764707,30.232717224495573
Task_33033,987,1015,90,88,178,0.9714566929133859,25.52860693697298
Task_33034,844,685,95,149,244,1.2303206997084548,22.703360096924413
Task_33035,2078,131,25,143,168,15.742424242424242,39.6177526783579
Task_33036,2160,881,146,183,329,2.4489795918367347,44.65748996841165
Task_33037,2205,533,158,66,224,4.129213483146067,43.352176681550226
Task_33038,2353,925,180,42,222,2.541036717062635,46.652269158924724
Task_33039,672,445,84,132,216,1.506726457399103,19.109256090809634
Task_33040,2058,709,13,103,116,2.898591549295775,41.144332169136206
Task_33041,2453,213,78,64,142,11.462616822429906,45.7922037775437
Task_33042,2009,328,85,127,212,6.1063829787234045,39.90051747874613
Task_33043,525,616,112,144,256,0.8508914100486223,17.516429659507512
Task_33044,1911,93,84,162,246,20.329787234042552,37.21888482148929
Task_33045,2091,759,90,171,261,2.751315789473684,42.853267706351254
Task_33046,2174,674,102,172,274,3.220740740740741,43.966789471288145
Task_33047,1923,267,175,117,292,7.175373134328358,38.67177105369948
Task_33048,1788,288,61,187,248,6.186851211072664,36.58187006721762
Task_33049,1487,540,136,129,265,2.7486136783733826,32.560793016835696
Task_33050,2048,823,149,195,344,2.4854368932038833,42.78710710997736
Task_33051,973,607,27,104,131,1.600328947368421,23.828321619108113
Task_33052,2865,744,136,50,186,3.8456375838926173,54.11490536735414
Task_33053,795,470,188,189,377,1.6878980891719746,21.964493918209957
Task_33054,1292,221,177,72,249,5.81981981981982,28.061894888892652
Task_33055,1713,590,113,139,252,2.8984771573604062,36.2532588123286
Task_33056,576,368,110,121,231,1.5609756097560976,17.39184366899145
Task_33057,1202,107,109,193,302,11.12962962962963,26.473433238500693
Task_33058,2431,320,118,27,145,7.573208722741433,45.50313251030095
Task_33059,2841,766,104,176,280,3.7040417209908734,54.85549510565678
Task_33060,511,509,192,87,279,1.0019607843137255,16.86427046857758
Task_33061,537,123,99,98,197,4.330645161290323,15.549716960878213
Task_33062,1517,507,90,39,129,2.986220472440945,31.595603254316483
Task_33063,2620,197,90,56,146,13.232323232323232,48.3746889207612
Task_33064,2152,243,32,50,82,8.819672131147541,40.27905555846247
Task_33065,2417,192,87,150,237,12.523316062176166,45.95471461704645
Task_33066,2774,412,12,154,166,6.716707021791768,52.04366554911235
Task_33067,1736,290,110,52,162,5.965635738831615,34.78510294932905
Task_33068,1795,480,15,15,30,3.731808731808732,34.581281388406104
Task_33069,1815,851,170,88,258,2.130281690140845,38.57920000963416
Task_33070,1705,193,196,175,371,8.788659793814434,35.39709971083299
Task_33071,2641,145,71,169,240,18.089041095890412,49.22828379374899
Task_33072,2272,1009,12,135,147,2.2495049504950497,45.725028619121396
Task_33073,1260,614,172,21,193,2.048780487804878,28.14643701207308
Task_33074,2380,668,142,168,310,3.5575485799701045,47.36715588049761
Task_33075,2668,814,143,54,197,3.2736196319018407,51.41706066088758
Task_33076,785,94,153,17,170,8.263157894736842,18.134837567521707
Task_33077,507,474,104,117,221,1.0673684210526315,16.562880481768715
Task_33078,862,248,160,91,251,3.461847389558233,21.56356184456393
Task_33079,1966,592,149,112,261,3.315345699831366,40.26711200058467
Task_33080,2501,216,49,41,90,11.525345622119815,45.62242181236055
Task_33081,1412,175,88,122,210,8.022727272727273,29.648643930202052
Task_33082,520,239,24,84,108,2.1666666666666665,15.198400925551757
Task_33083,1014,308,161,42,203,3.2815533980582523,23.417181245644798
Task_33084,1189,750,164,106,270,1.5832223701731025,28.443975516093445
Task_33085,858,491,106,42,148,1.7439024390243902,21.149167206823137
Task_33086,1179,756,46,23,69,1.5574636723910171,26.031125852027614
Task_33087,1271,348,29,160,189,3.641833810888252,28.232170582602958
Task_33088,2071,418,33,59,92,4.94272076372315,39.77896426813685
Task_33089,950,361,28,74,102,2.6243093922651934,22.19329160300124
Task_33090,2854,600,111,119,230,4.748752079866889,54.22583114321475
Task_33091,1241,163,19,29,48,7.567073170731708,25.07565368933645
Task_33092,669,554,167,83,250,1.2054054054054053,19.387029717403667
Task_33093,1835,517,119,198,317,3.5424710424710426,38.333318339172465
Task_33094,1002,456,165,135,300,2.192560175054705,24.78430958467938
Task_33095,1488,712,75,139,214,2.0869565217391304,32.96565053307194
Task_33096,2794,265,96,44,140,10.503759398496241,50.98340414500851
Task_33097,1350,662,35,129,164,2.0361990950226243,30.289248557289664
Task_33098,1572,425,186,128,314,3.6901408450704225,33.76001025659807
Task_33099,881,249,45,147,192,3.524,21.76625459836281
Task_33100,1984,528,10,148,158,3.7504725897920603,39.707157908716674
Task_33101,1881,387,148,56,204,4.847938144329897,37.619392026306116
Task_33102,2755,880,140,137,277,3.127128263337117,53.7802881045399
Task_33103,2611,875,193,113,306,2.980593607305936,51.57850221889381
Task_33104,2034,870,159,119,278,2.3352468427095294,42.30306365737992
Task_33105,1104,346,146,192,338,3.1815561959654177,26.3032681244664
Task_33106,1726,189,117,122,239,9.08421052631579,35.051248965225
Task_33107,2262,870,77,51,128,2.5970149253731343,44.82678729722153
Task_33108,927,86,29,46,75,10.655172413793103,19.50815138296783
Task_33109,2026,603,111,82,193,3.3543046357615895,40.82851255647892
Task_33110,800,201,17,103,120,3.9603960396039604,19.589160934079754
Task_33111,1479,426,90,40,130,3.4637002341920375,30.710742942786993
Task_33112,1271,583,60,64,124,2.1763698630136985,28.160217850313938
Task_33113,1465,614,69,70,139,2.3821138211382116,31.509327437379806
Task_33114,1244,457,185,71,256,2.7161572052401746,28.083661121861923
Task_33115,1991,418,57,102,159,4.751789976133652,39.50054466403095
Task_33116,1112,551,111,184,295,2.0144927536231885,26.873478000003427
Task_33117,2396,242,83,162,245,9.860082304526749,45.94549808106877
Task_33118,1734,224,42,32,74,7.706666666666667,33.16446556247691
Task_33119,1075,918,191,75,266,1.1697497279651796,26.92938560184298
Task_33120,2698,680,187,65,252,3.9618208516886932,51.76793078912434
Task_33121,1824,78,200,147,347,23.088607594936708,36.181929549533336
Task_33122,2136,655,145,94,239,3.2560975609756095,43.026290242714566
Task_33123,685,407,192,92,284,1.678921568627451,19.412832348651477
Task_33124,546,931,17,91,108,0.5858369098712446,17.913193406005643
Task_33125,2082,738,51,98,149,2.817320703653586,41.98280402248382
Task_33126,2136,620,94,136,230,3.4396135265700485,42.9537005792794
Task_33127,1334,267,191,133,324,4.977611940298507,29.530881460369514
Task_33128,1417,671,32,23,55,2.1086309523809526,29.518414250786222
Task_33129,2219,590,110,90,200,3.754653130287648,43.92840909948635
Task_33130,2899,820,39,145,184,3.5310596833130328,55.43829859084999
Task_33131,2974,131,101,94,195,22.53030303030303,53.93901118419128
Task_33132,2540,458,151,120,271,5.533769063180828,48.98210497880316
Task_33133,2400,942,21,55,76,2.545068928950159,46.248391761419164
Task_33134,1253,443,86,11,97,2.8220720720720722,26.683168336111134
Task_33135,1442,97,52,75,127,14.714285714285714,28.6892094661704
Task_33136,679,736,52,56,108,0.921302578018996,18.867807656741018
Task_33137,2962,912,30,20,50,3.2442497261774372,54.64026515359907
Task_33138,2111,319,36,146,182,6.596875,41.35016632532687
Task_33139,2734,402,81,93,174,6.784119106699752,51.40710738287053
Task_33140,917,638,174,142,316,1.4350547730829422,24.036166452016925
Task_33141,1035,817,150,82,232,1.265281173594132,25.928032315926004
Task_33142,1115,604,174,79,253,1.8429752066115703,26.641342566950858
Task_33143,1145,687,125,28,153,1.6642441860465116,26.296222819277943
Task_33144,2702,787,92,65,157,3.4289340101522843,51.61780275730987
Task_33145,1412,623,102,173,275,2.2628205128205128,31.743564869050598
Task_33146,709,495,46,199,245,1.4294354838709677,20.098632394157487
Task_33147,1089,752,40,183,223,1.4462151394422311,26.77012645007809
Task_33148,2059,672,119,136,255,3.0594353640416045,42.00055285849799
Task_33149,2048,151,198,85,283,13.473684210526315,39.80777179778669
Task_33150,1615,762,33,96,129,2.1166448230668413,34.58068874496315
Task_33151,1068,423,98,200,298,2.518867924528302,25.81513539504138
Task_33152,2538,764,98,117,215,3.3176470588235296,49.673800942187235
Task_33153,863,564,144,79,223,1.527433628318584,22.35263744647337
Task_33154,2965,490,123,149,272,6.038696537678208,55.86126533988213
Task_33155,2170,919,187,104,291,2.358695652173913,44.64733112645266
Task_33156,1243,980,95,144,239,1.2670744138634047,29.912708964066297
Task_33157,1772,204,55,33,88,8.64390243902439,33.968507344492686
Task_33158,502,963,153,128,281,0.520746887966805,18.5137171684689
Task_33159,2029,534,137,151,288,3.7925233644859815,41.259439406870506
Task_33160,2542,402,89,92,181,6.3076923076923075,48.283559109467284
Task_33161,1565,126,115,141,256,12.32283464566929,32.08631910260363
Task_33162,1153,961,104,129,233,1.1985446985446986,28.37788492776386
Task_33163,1616,436,154,128,282,3.6979405034324944,34.34745306967296
Task_33164,824,96,96,59,155,8.494845360824742,18.88492528553136
Task_33165,589,577,100,168,268,1.019031141868512,18.46006404876718
Task_33166,850,745,157,12,169,1.1394101876675604,21.87591343884077
Task_33167,853,392,63,196,259,2.1704834605597965,22.19602980352685
Task_33168,2367,657,59,39,98,3.5972644376899696,44.941198237006795
Task_33169,1371,208,44,53,97,6.559808612440191,28.071514001559265
Task_33170,1415,481,25,91,116,2.9356846473029043,30.22584382035537
Task_33171,2835,156,67,113,180,18.05732484076433,51.93418376396079
Task_33172,2703,897,158,187,345,3.010022271714922,53.389325554899926
Task_33173,580,881,74,142,216,0.6575963718820862,19.21977122378934
Task_33174,924,841,45,164,209,1.0973871733966747,24.302400826592958
Task_33175,2712,922,158,92,250,2.9382448537378116,52.99087846685553
Task_33176,2046,376,50,15,65,5.427055702917772,38.390661796017305
Task_33177,1023,178,178,36,214,5.715083798882682,22.979964763430218
Task_33178,791,951,181,103,284,0.8308823529411765,22.8318908200183
Task_33179,1016,711,199,103,302,1.4269662921348314,25.710945924177228
Task_33180,2642,905,70,195,265,2.9161147902869757,52.171384096253625
Task_33181,1553,945,118,80,198,1.6416490486257929,34.388137079182584
Task_33182,1538,66,162,62,224,22.955223880597014,30.57524713096827
Task_33183,2441,558,77,133,210,4.366726296958855,47.54867731720622
Task_33184,647,350,167,163,330,1.8433048433048433,19.0087855042599
Task_33185,1557,140,131,141,272,11.042553191489361,32.135762702493004
Task_33186,2981,423,28,189,217,7.03066037735849,55.694166077995696
Task_33187,2406,492,168,119,287,4.880324543610548,47.041993591491725
Task_33188,1369,317,69,142,211,4.30503144654088,29.82677799694774
Task_33189,2956,806,34,150,184,3.6629491945477075,56.310458604550455
Task_33190,809,195,98,155,253,4.127551020408164,20.713685768453015
Task_33191,2379,857,46,87,133,2.772727272727273,46.95589086127154
Task_33192,2977,97,128,187,315,30.377551020408163,54.28568987864103
Task_33193,1335,404,48,66,114,3.2962962962962963,28.571317305723657
Task_33194,2761,850,71,107,178,3.244418331374853,53.32532872536017
Task_33195,1320,453,34,59,93,2.907488986784141,28.013189694294088
Task_33196,2519,825,10,11,21,3.049636803874092,47.084288117958344
Task_33197,1665,404,182,19,201,4.111111111111111,33.923977581855034
Task_33198,1383,240,131,75,206,5.738589211618257,29.419783978192555
Task_33199,1699,116,164,66,230,14.521367521367521,33.47960711819519
Task_33200,1860,585,172,80,252,3.174061433447099,38.379460050444685
Task_33201,2721,975,131,103,234,2.7879098360655736,53.29481644979239
Task_33202,1611,479,34,107,141,3.35625,33.56049386705542
Task_33203,2432,847,199,132,331,2.8679245283018866,48.79525650439755
Task_33204,2374,706,62,37,99,3.3578500707213577,45.19557625183611
Task_33205,656,559,163,148,311,1.1714285714285715,19.637593061154195
Task_33206,2591,612,84,75,159,4.226753670473083,49.426626286897154
Task_33207,2253,277,38,115,153,8.10431654676259,43.082154039443516
Task_33208,986,219,184,35,219,4.4818181818181815,22.74593857667469
Task_33209,864,650,135,110,245,1.327188940092166,22.874105453569005
Task_33210,2038,948,85,133,218,2.1475237091675448,42.36547488736995
Task_33211,789,303,73,124,197,2.5953947368421053,20.508245741664485
Task_33212,1439,82,108,37,145,17.337349397590362,28.213832547802326
Task_33213,1044,457,64,32,96,2.2794759825327513,23.382795271475057
Task_33214,2539,459,72,129,201,5.519565217391304,48.727182868283876
Task_33215,912,566,130,101,231,1.6084656084656084,23.32989971180848
Task_33216,827,139,68,120,188,5.9071428571428575,20.239241647406207
Task_33217,2132,616,35,198,233,3.4554294975688817,42.98601113410475
Task_33218,565,210,177,14,191,2.677725118483412,15.833572563546866
Task_33219,2108,242,187,90,277,8.674897119341564,41.36696759830463
Task_33220,2818,1011,127,97,224,2.7845849802371543,54.918795270926324
Task_33221,2513,571,65,197,262,4.393356643356643,49.06135255835206
Task_33222,2653,80,17,166,183,32.75308641975309,48.38792967713298
Task_33223,926,189,200,93,293,4.873684210526315,22.630237770144205
Task_33224,2598,954,169,163,332,2.7204188481675393,51.809820415574315
Task_33225,2157,934,95,36,131,2.306951871657754,43.05662715144549
Task_33226,1950,582,50,131,181,3.3447684391080617,39.709762254824206
Task_33227,802,674,36,39,75,1.1881481481481482,19.92333194942093
Task_33228,2415,975,150,112,262,2.4743852459016393,48.58513538516393
Task_33229,2120,169,81,65,146,12.470588235294118,40.14701774300615
Task_33230,2163,264,172,80,252,8.162264150943397,42.12012887095112
Task_33231,2260,146,144,54,198,15.374149659863946,42.499625232004306
Task_33232,2820,574,190,32,222,4.904347826086957,52.93882529587257
Task_33233,1023,288,163,179,342,3.5397923875432524,24.833339744090722
Task_33234,2053,112,37,22,59,18.168141592920353,37.34768658980618
Task_33235,788,923,25,84,109,0.8528138528138528,21.543205227778106
Task_33236,945,215,125,118,243,4.375,22.822767477496086
Task_33237,1478,587,100,170,270,2.5136054421768708,32.64891071053882
Task_33238,2519,928,72,44,116,2.7115177610333694,48.47286732973103
Task_33239,959,235,101,89,190,4.063559322033898,22.7823185909385
Task_33240,920,615,87,76,163,1.4935064935064934,23.04011239240552
Task_33241,568,639,132,108,240,0.8875,18.145883273214796
Task_33242,1935,682,21,176,197,2.833089311859444,39.84682181509844
Task_33243,1517,855,106,148,254,1.772196261682243,33.98565911115981
Task_33244,2772,381,66,67,133,7.2565445026178015,51.465995757711646
Task_33245,2321,950,29,184,213,2.440588853838065,46.90484166919911
Task_33246,1760,322,36,58,94,5.4489164086687305,34.57363665527321
Task_33247,2514,453,99,168,267,5.537444933920705,48.60826208331139
Task_33248,2411,178,86,180,266,13.46927374301676,45.71974753967826
Task_33249,1332,677,130,178,308,1.9646017699115044,30.801374505498103
Task_33250,613,370,192,71,263,1.6522911051212938,17.86036846581982
Task_33251,1779,946,97,75,172,1.8785638859556495,37.761076324673034
Task_33252,1548,678,126,151,277,2.279823269513991,34.04654740588524
Task_33253,2941,397,87,33,120,7.389447236180905,53.482335013208825
Task_33254,1310,567,146,93,239,2.306338028169014,29.656703259888232
Task_33255,1712,409,12,86,98,4.175609756097561,34.36827177639065
Task_33256,2635,554,172,185,357,4.747747747747748,51.27957665383766
Task_33257,1620,362,120,14,134,4.462809917355372,32.617063654531385
Task_33258,1544,754,47,68,115,2.0450331125827814,33.007034915472
Task_33259,1258,832,145,11,156,1.510204081632653,28.448610722542018
Task_33260,2688,883,195,63,258,3.0407239819004523,52.25147780046285
Task_33261,505,612,172,140,312,0.8238172920065253,17.43311335910705
Task_33262,2738,529,147,57,204,5.166037735849057,51.640311760543284
Task_33263,1514,421,176,94,270,3.5876777251184833,32.574492931882666
Task_33264,1074,555,61,143,204,1.9316546762589928,25.881177096437767
Task_33265,1198,517,189,112,301,2.312741312741313,28.04991359685566
Task_33266,2754,334,72,139,211,8.22089552238806,51.7704481295418
Task_33267,2340,211,10,17,27,11.037735849056604,42.25275570852024
Task_33268,2640,352,46,140,186,7.478753541076487,49.85838049374911
Task_33269,1767,122,69,20,89,14.365853658536585,33.34007833777513
Task_33270,1932,631,61,72,133,3.0569620253164556,39.03356365015309
Task_33271,927,567,148,115,263,1.6320422535211268,23.735294238754733
Task_33272,1227,906,90,165,255,1.3528114663726571,29.531198234623204
Task_33273,2123,751,35,134,169,2.8231382978723403,42.84157000724476
Task_33274,703,653,17,177,194,1.0749235474006116,20.097035216633884
Task_33275,2174,907,198,24,222,2.394273127753304,43.68891544977085
Task_33276,2489,585,135,199,334,4.247440273037543,48.98368750024796
Task_33277,2136,854,105,38,143,2.498245614035088,42.522494354514876
Task_33278,735,388,28,182,210,1.8894601542416452,19.997874494268956
Task_33279,1872,91,88,54,142,20.347826086956523,35.25071434052642
Task_33280,1046,650,22,82,104,1.6067588325652842,24.76200206278645
Task_33281,1698,439,161,159,320,3.859090909090909,35.87160084417501
Task_33282,2822,297,25,134,159,9.46979865771812,52.207419908111014
Task_33283,2483,336,99,100,199,7.367952522255193,47.32170826133406
Task_33284,866,745,109,116,225,1.160857908847185,23.09735348171137
Task_33285,627,277,37,55,92,2.2553956834532376,16.51788520953253
Task_33286,1020,680,176,34,210,1.497797356828194,24.706907032831747
Task_33287,2571,946,13,158,171,2.7148891235480463,50.545504755682636
Task_33288,1453,693,114,199,313,2.0936599423631126,32.82126412693532
Task_33289,2550,328,125,144,269,7.750759878419453,48.732188241908396
Task_33290,1228,528,174,198,372,2.321361058601134,29.005559825490412
Task_33291,2137,336,143,142,285,6.341246290801187,42.2968401893827
Task_33292,1183,953,95,187,282,1.240041928721174,29.131875685798878
Task_33293,715,167,155,112,267,4.255952380952381,18.929412811638453
Task_33294,1193,982,112,34,146,1.2136317395727365,28.03542750330089
Task_33295,2430,751,16,119,135,3.231382978723404,47.333813590755874
Task_33296,2913,266,141,170,311,10.910112359550562,54.477365261821
Task_33297,2352,525,200,194,394,4.47148288973384,46.88552874498843
Task_33298,2658,620,31,126,157,4.280193236714976,50.68191100479128
Task_33299,2479,890,78,10,88,2.782267115600449,47.412745033495696
Task_33300,670,664,17,27,44,1.0075187969924813,17.67901677057493
Task_33301,2031,541,156,104,260,3.7472324723247232,41.11831097370184
Task_33302,2648,111,96,130,226,23.642857142857142,48.81098704598742
Task_33303,921,948,84,193,277,0.9704952581664911,24.938760561998347
Task_33304,2571,692,76,74,150,3.70995670995671,49.36892516869428
Task_33305,648,607,50,25,75,1.0657894736842106,17.27366065069697
Task_33306,2074,378,95,199,294,5.472295514511873,41.5747539974009
Task_33307,2889,181,190,32,222,15.873626373626374,52.49167894840294
Task_33308,1251,127,122,130,252,9.7734375,27.118342255288297
Task_33309,2967,173,39,57,96,17.051724137931036,52.862770736088144
Task_33310,1169,148,26,185,211,7.845637583892618,25.822007963955745
Task_33311,2983,780,11,176,187,3.819462227912932,56.676873603518146
Task_33312,1972,896,90,61,151,2.198439241917503,40.30177578881813
Task_33313,2851,175,157,38,195,16.198863636363637,51.73784162899317
Task_33314,2464,224,22,148,170,10.95111111111111,46.494584150172265
Task_33315,1637,1008,99,139,238,1.622398414271556,36.27847481385848
Task_33316,2210,723,147,197,344,3.052486187845304,45.04333673619709
Task_33317,1644,803,60,99,159,2.044776119402985,35.211080936798986
Task_33318,760,372,124,34,158,2.037533512064343,19.27740007835051
Task_33319,904,174,196,116,312,5.1657142857142855,22.11838373142656
Task_33320,2826,210,146,160,306,13.393364928909953,52.848787761028255
Task_33321,1310,138,115,151,266,9.424460431654676,28.202068436841824
Task_33322,846,611,76,174,250,1.3823529411764706,22.64836850864928
Task_33323,1941,209,112,118,230,9.242857142857142,38.46840195408247
Task_33324,2193,950,102,86,188,2.305993690851735,44.53018923131424
Task_33325,2765,422,47,82,129,6.536643026004728,51.711517812419146
Task_33326,2421,774,91,172,263,3.1238709677419356,48.14373008632623
Task_33327,2734,833,97,118,215,3.278177458033573,53.00064980465621
Task_33328,844,727,162,139,301,1.1593406593406594,23.06929131121826
Task_33329,1061,275,14,13,27,3.8442028985507246,22.301791032706202
Task_33330,2942,126,109,156,265,23.165354330708663,53.821197936605415
Task_33331,831,239,108,155,263,3.4625,21.246968326752636
Task_33332,518,536,59,115,174,0.9646182495344506,16.73370565048061
Task_33333,2842,920,136,150,286,3.0857763300760044,55.34363798062424
Task_33334,2872,387,39,177,216,7.402061855670103,53.84631829869306
Task_33335,2175,914,92,124,216,2.377049180327869,44.40992666544398
Task_33336,2664,987,14,85,99,2.6963562753036436,51.26771860449103
Task_33337,2684,945,180,79,259,2.8372093023255816,52.59014373045469
Task_33338,1563,666,69,77,146,2.343328335832084,33.40124100884684
Task_33339,725,228,116,192,308,3.165938864628821,19.793410164985218
Task_33340,2808,354,119,199,318,7.909859154929578,53.203710502465945
Task_33341,1311,332,199,37,236,3.936936936936937,28.34732373124558
Task_33342,715,396,82,144,226,1.801007556675063,19.7750421938084
Task_33343,2503,242,77,42,119,10.300411522633745,46.01713689859992
Task_33344,807,839,73,142,215,0.9607142857142857,22.494083330467692
Task_33345,2268,914,70,162,232,2.4786885245901638,46.076165388332214
Task_33346,1177,831,150,153,303,1.4146634615384615,28.711861938759885
Task_33347,1276,132,152,136,288,9.593984962406015,27.712982231374014
Task_33348,924,747,39,106,145,1.2352941176470589,23.4908550368998
Task_33349,2515,938,102,143,245,2.6783812566560172,50.02323247164751
Task_33350,2526,615,178,143,321,4.10064935064935,49.52450205342179
Task_33351,1963,180,174,115,289,10.845303867403315,38.73761084530428
Task_33352,1726,689,81,114,195,2.5014492753623188,36.52994592604026
Task_33353,1055,244,142,85,227,4.3061224489795915,24.460434289154943
Task_33354,1164,509,128,178,306,2.2823529411764705,27.605738957621856
Task_33355,1489,1014,130,153,283,1.4669950738916255,34.13292397382786
Task_33356,2240,943,179,14,193,2.3728813559322033,44.671822635831404
Task_33357,1071,735,118,189,307,1.455163043478261,26.805367462674692
Task_33358,1407,483,11,62,73,2.90702479338843,29.091958017508944
Task_33359,697,98,167,70,237,7.040404040404041,17.536738308657643
Task_33360,1910,70,24,149,173,26.901408450704224,36.62013503047651
Task_33361,2161,682,107,155,262,3.16398243045388,43.70706545855779
Task_33362,2775,986,136,157,293,2.811550151975684,54.52993916903777
Task_33363,2047,472,85,90,175,4.3276955602537,40.70737320323099
Task_33364,713,776,102,176,278,0.9176319176319176,21.138454718377194
Task_33365,622,285,37,192,229,2.174825174825175,18.018265573011814
Task_33366,2969,367,121,170,291,8.067934782608695,55.63090678956585
Task_33367,1655,352,192,167,359,4.688385269121813,35.096384840784886
Task_33368,2059,791,32,108,140,2.599747474747475,41.616955473467065
Task_33369,1958,374,81,15,96,5.221333333333333,37.601990832850085
Task_33370,2265,987,128,150,278,2.29251012145749,46.37330549466541
Task_33371,2952,812,152,94,246,3.6309963099630997,56.478802340972095
Task_33372,2275,189,40,65,105,11.973684210526315,42.54855298844062
Task_33373,955,561,175,121,296,1.699288256227758,24.317469095477225
Task_33374,1258,493,115,129,244,2.5465587044534415,28.69220565480286
Task_33375,519,371,127,52,179,1.3951612903225807,15.920688407649388
Task_33376,1822,603,200,86,286,3.0165562913907285,38.02964437789904
Task_33377,1076,398,157,152,309,2.6967418546365916,25.837325352548486
Task_33378,2740,404,192,151,343,6.765432098765432,52.33914569645933
Task_33379,1356,140,117,181,298,9.617021276595745,29.145609516759862
Task_33380,2046,824,109,167,276,2.48,42.41101690781665
Task_33381,1005,694,160,185,345,1.4460431654676258,25.797880248576202
Task_33382,2120,506,99,192,291,4.181459566074951,42.68602832490774
Task_33383,2132,901,95,73,168,2.3636363636363638,43.126169251846704
Task_33384,2605,357,190,147,337,7.276536312849162,50.01217295924289
Task_33385,2539,121,146,42,188,20.811475409836067,46.35641572450745
Task_33386,2168,920,142,175,317,2.3539630836047776,44.840018055231724
Task_33387,2202,731,164,32,196,3.0081967213114753,43.53114539109303
Task_33388,864,225,94,14,108,3.8230088495575223,19.97882804220819
Task_33389,2742,759,76,197,273,3.607894736842105,53.331244073320185
Task_33390,1509,718,186,32,218,2.09874826147427,32.611737882969955
Task_33391,925,771,72,141,213,1.1981865284974094,24.156473742753438
Task_33392,937,510,12,148,160,1.8336594911937378,23.08367220166274
Task_33393,2007,200,27,106,133,9.985074626865671,38.86103750682626
Task_33394,2613,449,172,14,186,5.806666666666667,48.97003351911996
Task_33395,1576,1012,112,70,182,1.5557749259624876,34.65267581713635
Task_33396,1122,289,136,196,332,3.8689655172413793,26.381496557230093
Task_33397,929,988,155,165,320,0.9393326592517695,25.393997776836347
Task_33398,1247,412,13,38,51,3.0193704600484264,26.05582752214771
Task_33399,2857,210,86,194,280,13.540284360189574,53.2311466710051
Task_33400,2420,755,145,140,285,3.201058201058201,48.121120439467234
Task_33401,2682,988,91,147,238,2.711830131445905,52.79921968217439
Task_33402,624,474,177,151,328,1.3136842105263158,18.960164817601928
Task_33403,2842,671,85,176,261,4.229166666666667,54.49131171183948
Task_33404,1929,704,70,164,234,2.7361702127659573,40.060736552964215
Task_33405,1265,203,105,174,279,6.200980392156863,28.077544872050478
Task_33406,2201,220,91,11,102,9.959276018099548,40.96032769466384
Task_33407,1345,518,134,83,217,2.5915221579961463,29.8874109944433
Task_33408,1224,915,92,43,135,1.3362445414847162,28.250330799265626
Task_33409,2319,247,74,173,247,9.350806451612904,44.79750483405622
Task_33410,1355,261,197,101,298,5.17175572519084,29.67839788372993
Task_33411,514,358,118,24,142,1.4317548746518105,15.18537449795938
Task_33412,1088,651,173,26,199,1.6687116564417177,25.610459760474004
Task_33413,1901,400,20,75,95,4.740648379052369,37.24599445208274
Task_33414,2428,984,188,90,278,2.46497461928934,48.82730590162166
Task_33415,2211,882,168,52,220,2.5039637599093996,44.52563245884903
Task_33416,2665,847,67,76,143,3.142688679245283,51.39010005670456
Task_33417,2375,255,168,156,324,9.27734375,45.97314050629998
Task_33418,1338,836,106,26,132,1.5985663082437276,29.745370616475416
Task_33419,1893,802,82,157,239,2.3574097135740972,39.77890217755918
Task_33420,1392,178,41,90,131,7.776536312849162,28.680376035412024
Task_33421,843,876,167,67,234,0.9612314709236032,22.948997580218872
Task_33422,2742,872,77,123,200,3.140893470790378,53.24862842241857
Task_33423,2629,669,193,133,326,3.9238805970149255,51.33510050019036
Task_33424,1334,431,166,185,351,3.087962962962963,30.262921756906035
Task_33425,1774,932,160,125,285,1.9013933547695605,38.41659542070419
Task_33426,2478,312,177,138,315,7.916932907348243,47.736775056183056
Task_33427,1444,904,64,74,138,1.5955801104972376,32.17595571750881
Task_33428,1219,228,150,20,170,5.323144104803493,26.11004629909348
Task_33429,1724,761,80,125,205,2.2624671916010497,36.78460980606079
Task_33430,2237,558,132,162,294,4.001788908765653,44.672578937938454
Task_33431,1578,852,147,57,204,1.8499413833528722,34.28507136235902
Task_33432,2315,340,116,26,142,6.788856304985337,43.648280417152215
Task_33433,2826,320,19,90,109,8.80373831775701,51.93355808574387
Task_33434,2224,414,186,178,364,5.3590361445783135,44.34108026780344
Task_33435,2943,244,195,114,309,12.012244897959183,54.77713185347011
Task_33436,1974,464,187,88,275,4.245161290322581,39.95451035558609
Task_33437,2960,1020,18,164,182,2.899118511263467,57.027897529401265
Task_33438,1239,460,150,92,242,2.6876355748373104,28.172053821269685
Task_33439,1783,175,80,45,125,10.130681818181818,34.27088860656533
Task_33440,2946,428,187,142,329,6.8671328671328675,55.602793939274534
Task_33441,1747,415,88,198,286,4.199519230769231,36.43242825866388
Task_33442,2433,898,21,98,119,2.7063403781979978,47.672257220161875
Task_33443,1866,697,177,118,295,2.673352435530086,39.175898839386015
Task_33444,2316,776,69,116,185,2.9806949806949805,46.092652794151384
Task_33445,2792,710,21,194,215,3.926863572433193,53.61762219408226
Task_33446,1700,549,125,85,210,3.090909090909091,35.57244248570347
Task_33447,688,384,189,117,306,1.787012987012987,19.58900926392091
Task_33448,2654,509,26,127,153,5.203921568627451,50.19196809531895
Task_33449,1331,981,150,62,212,1.3553971486761711,30.800281469313756
Task_33450,1924,87,42,20,62,21.863636363636363,34.91865003146174
Task_33451,539,486,185,42,227,1.106776180698152,16.58802807104255
Task_33452,1726,97,113,130,243,17.612244897959183,34.234280844113
Task_33453,2693,826,44,22,66,3.2563482466747278,50.19524565048942
Task_33454,2553,761,32,140,172,3.3503937007874014,49.70672228273011
Task_33455,2908,640,150,107,257,4.536661466458658,55.31287747626923
Task_33456,871,405,50,164,214,2.145320197044335,22.30326143286524
Task_33457,734,464,173,54,227,1.578494623655914,19.808149820232007
Task_33458,2736,70,121,183,304,38.53521126760563,50.294224859687795
Task_33459,1042,903,124,22,146,1.1526548672566372,25.34569669460384
Task_33460,879,294,80,181,261,2.9796610169491524,22.267533949934165
Task_33461,1661,153,191,35,226,10.785714285714286,32.99701573498515
Task_33462,2480,979,73,158,231,2.5306122448979593,49.61528748961789
Task_33463,1699,306,42,160,202,5.534201954397394,34.93834724743518
Task_33464,2989,308,51,130,181,9.673139158576053,55.24741060746033
Task_33465,2396,373,199,103,302,6.406417112299465,46.53751325860416
Task_33466,2560,232,174,69,243,10.987124463519313,48.033179561587815
Task_33467,854,358,23,78,101,2.3788300835654597,20.70239687915527
Task_33468,1330,531,59,109,168,2.5,29.60182071255561
Task_33469,1397,369,14,81,95,3.7756756756756755,29.229705057718842
Task_33470,2641,828,169,139,308,3.185765983112183,51.95373716288924
Task_33471,1927,213,199,31,230,9.004672897196262,37.63317098181175
Task_33472,1911,776,30,123,153,2.4594594594594597,39.281971625054474
Task_33473,1092,328,33,34,67,3.3191489361702127,23.326539180492432
Task_33474,866,475,32,119,151,1.819327731092437,21.79071311302557
Task_33475,1272,69,129,31,160,18.17142857142857,25.51658479455688
Task_33476,2026,182,10,139,149,11.07103825136612,39.04001469791577
Task_33477,2346,375,112,85,197,6.23936170212766,45.17650510952743
Task_33478,1834,370,137,102,239,4.943396226415095,37.3510324447801
Task_33479,2035,599,93,101,194,3.3916666666666666,41.1023379446444
Task_33480,2639,538,157,75,232,4.896103896103896,50.39035344673861
Task_33481,2603,623,60,159,219,4.171474358974359,50.4025340367898
Task_33482,1238,131,123,32,155,9.378787878787879,25.66430538791455
Task_33483,1069,443,197,35,232,2.4076576576576576,24.842694377041436
Task_33484,2627,268,137,88,225,9.765799256505575,49.397842367354
Task_33485,635,729,187,198,385,0.8698630136986302,20.269130011245284
Task_33486,1608,452,178,139,317,3.5496688741721854,34.44596451500954
Task_33487,2534,566,69,104,173,4.469135802469136,48.810547915396974
Task_33488,2454,722,103,140,243,3.3941908713692945,48.36662780532575
Task_33489,2032,101,110,155,265,19.92156862745098,39.25101652718828
Task_33490,2381,535,36,166,202,4.442164179104478,46.48495309193169
Task_33491,2909,987,171,96,267,2.944331983805668,56.47824025993243
Task_33492,1148,748,66,22,88,1.5327102803738317,25.90612932927301
Task_33493,875,885,88,51,139,0.9875846501128668,22.836501797803283
Task_33494,1302,271,101,60,161,4.786764705882353,27.76956672216447
Task_33495,970,685,162,151,313,1.41399416909621,25.021404199684536
Task_33496,1650,681,69,163,232,2.4193548387096775,35.558796198313
Task_33497,1727,374,24,93,117,4.605333333333333,34.84879504305861
Task_33498,2823,999,176,119,295,2.823,55.28446259135575
Task_33499,2525,898,149,77,226,2.8086763070077865,49.70822222251067
Task_33500,913,708,136,21,157,1.2877291960507757,22.677476937844773
Task_33501,2355,188,77,47,124,12.46031746031746,43.72621005020653
Task_33502,538,196,172,122,294,2.730964467005076,16.585798206384258
Task_33503,919,544,20,24,44,1.6862385321100917,21.12561886869051
Task_33504,2331,417,80,90,170,5.576555023923445,45.022231394807136
Task_33505,1358,119,42,82,124,11.316666666666666,27.592694732688187
Task_33506,1819,836,140,48,188,2.173237753882915,37.7815379562631
Task_33507,635,131,103,62,165,4.8106060606060606,16.5866757111263
Task_33508,1834,487,11,142,153,3.7581967213114753,37.134244430953686
Task_33509,1099,1004,106,87,193,1.0935323383084576,27.347139420937225
Task_33510,1654,212,14,119,133,7.765258215962441,33.34652566771718
Task_33511,2472,879,72,59,131,2.809090909090909,48.17408263377701
Task_33512,2786,420,79,23,102,6.617577197149644,50.92022798134463
Task_33513,2604,846,181,59,240,3.074380165289256,50.67704422664192
Task_33514,1430,405,122,136,258,3.522167487684729,31.207964041618514
Task_33515,2632,558,162,199,361,4.708407871198569,51.2834603055102
Task_33516,986,88,69,49,118,11.07865168539326,20.957772538139935
Task_33517,2824,136,74,82,156,20.613138686131386,51.132593515034095
Task_33518,2069,245,178,55,233,8.410569105691057,40.23889077183228
Task_33519,1726,979,175,70,245,1.7612244897959184,37.25456908145151
Task_33520,2416,621,170,51,221,3.8842443729903535,46.901933717884
Task_33521,969,877,93,195,288,1.103644646924829,25.56920124002761
Task_33522,2314,991,164,96,260,2.3326612903225805,47.030273492032684
Task_33523,998,253,37,46,83,3.9291338582677167,22.01463394407204
Task_33524,2530,638,11,189,200,3.9593114241001564,49.14329891553743
Task_33525,1748,629,43,73,116,2.7746031746031745,35.894091661824525
Task_33526,1595,71,160,180,340,22.15277777777778,32.613668013458636
Task_33527,1784,456,116,46,162,3.903719912472648,35.815521090208634
Task_33528,2244,136,30,82,112,16.37956204379562,41.52131306627797
Task_33529,2249,1000,103,108,211,2.2467532467532467,45.79666098926062
Task_33530,689,76,10,198,208,8.948051948051948,17.791960377714716
Task_33531,510,446,191,25,216,1.1409395973154361,15.885154266858132
Task_33532,1921,273,163,68,231,7.010948905109489,38.03801144023207
Task_33533,2811,329,145,83,228,8.518181818181818,52.51724335791008
Task_33534,2199,785,41,77,118,2.7977099236641223,43.566752337987644
Task_33535,2759,933,101,91,192,2.9539614561027836,53.502025859328825
Task_33536,978,441,83,44,127,2.2126696832579187,22.70466605915192
Task_33537,1093,962,169,14,183,1.1349948078920042,26.474108113042785
Task_33538,1501,769,164,16,180,1.9493506493506494,32.36029706206412
Task_33539,1170,65,48,57,105,17.727272727272727,23.672181992002646
Task_33540,1956,220,198,43,241,8.850678733031675,38.17432561694836
Task_33541,2234,405,117,146,263,5.502463054187192,43.9676484094586
Task_33542,2695,609,189,12,201,4.418032786885246,50.87704342805147
Task_33543,764,409,42,54,96,1.8634146341463416,19.108656602561457
Task_33544,1646,264,110,140,250,6.211320754716981,34.12815427125263
Task_33545,1730,957,53,166,219,1.8058455114822547,37.631704795938894
Task_33546,2764,502,37,20,57,5.495029821073559,50.26224513841046
Task_33547,1398,225,151,36,187,6.185840707964601,29.11144364389843
Task_33548,621,182,35,20,55,3.3934426229508197,15.418935989903062
Task_33549,1506,178,82,185,267,8.41340782122905,31.549297981779684
Task_33550,878,715,18,35,53,1.2262569832402235,21.254854153145242
Task_33551,944,347,171,194,365,2.7126436781609193,23.90030540806862
Task_33552,1291,1008,133,161,294,1.2794846382556988,31.030588084641522
Task_33553,788,893,109,46,155,0.8814317673378076,21.37411066087275
Task_33554,1125,991,12,32,44,1.1340725806451613,25.908686738169152
Task_33555,1480,509,57,141,198,2.9019607843137254,32.134066436412915
Task_33556,770,185,40,128,168,4.139784946236559,19.473574392780414
Task_33557,2204,759,26,134,160,2.9,43.93559582141089
Task_33558,602,89,196,111,307,6.688888888888889,16.855645950981724
Task_33559,1970,695,85,107,192,2.8304597701149423,40.3426720919583
Task_33560,1248,104,137,196,333,11.885714285714286,27.326393426442234
Task_33561,2279,389,200,39,239,5.843589743589743,43.8507297059838
Task_33562,1092,336,155,24,179,3.2403560830860534,24.5513415709357
Task_33563,2282,353,73,129,202,6.446327683615819,44.31437004236773
Task_33564,1606,367,25,136,161,4.364130434782608,33.25598175317116
Task_33565,1720,708,180,141,321,2.4259520451339913,37.048558460373386
Task_33566,1310,889,108,146,254,1.4719101123595506,30.76801494523401
Task_33567,2057,477,180,131,311,4.303347280334728,41.594599191796114
Task_33568,2970,921,15,144,159,3.2212581344902387,56.58144246260158
Task_33569,2179,172,121,101,222,12.595375722543352,41.80826684790005
Task_33570,2954,468,159,11,170,6.298507462686567,54.33862665899818
Task_33571,1689,706,181,26,207,2.388967468175389,35.341339374956014
Task_33572,1985,408,45,129,174,4.853300733496333,39.613513557899125
Task_33573,2356,442,28,15,43,5.318284424379232,43.43667779461756
Task_33574,2481,556,33,51,84,4.454219030520647,46.644121228847915
Task_33575,1495,563,128,168,296,2.650709219858156,32.956860735534505
Task_33576,1934,414,147,17,164,4.660240963855422,38.048217947725725
Task_33577,2661,422,72,37,109,6.290780141843972,49.08404428927875
Task_33578,1909,741,179,194,373,2.57277628032345,40.45786013404323
Task_33579,1322,432,185,22,207,3.0531177829099305,28.618951994924117
Task_33580,545,523,192,164,356,1.0400763358778626,17.994143000569817
Task_33581,1299,321,84,84,168,4.03416149068323,28.282493885447863
Task_33582,539,663,124,158,282,0.8117469879518072,18.036711927230012
Task_33583,1661,856,190,194,384,1.9381563593932323,36.937136991291204
Task_33584,2095,482,62,116,178,4.337474120082816,41.63212646691563
Task_33585,949,512,104,11,115,1.8499025341130604,22.228720072336586
Task_33586,879,130,60,33,93,6.709923664122138,19.31897112017541
Task_33587,1007,413,38,80,118,2.4323671497584543,23.583042049871764
Task_33588,2631,392,157,193,350,6.694656488549619,50.66742984920476
Task_33589,1480,817,168,127,295,1.8092909535452322,33.44871809537609
Task_33590,704,1018,187,93,280,0.6908734052993131,21.734404331777665
Task_33591,558,784,198,186,384,0.710828025477707,19.286867465056478
Task_33592,934,534,74,31,105,1.7457943925233645,22.045114304710623
Task_33593,2798,288,98,117,215,9.681660899653979,52.23401683180966
Task_33594,2001,595,104,88,192,3.3573825503355703,40.42361169059543
Task_33595,983,690,44,103,147,1.422575976845152,24.26887185291582
Task_33596,1557,671,99,179,278,2.3169642857142856,34.21444114343199
Task_33597,809,731,47,119,166,1.105191256830601,21.865411303272356
Task_33598,1262,255,89,117,206,4.9296875,27.776296846230064
Task_33599,2338,448,20,157,177,5.2071269487750556,45.345742983260116
Task_33600,2546,794,39,89,128,3.2025157232704404,49.495187008975385
Task_33601,598,401,173,169,342,1.4875621890547264,18.41411735451772
Task_33602,1830,195,183,162,345,9.33673469387755,37.24823096431192
Task_33603,1881,1022,104,84,188,1.8387096774193548,39.798586547946734
Task_33604,1673,612,141,19,160,2.729200652528548,34.423391330720854
Task_33605,2280,802,17,21,38,2.839352428393524,43.37706519220583
Task_33606,2808,1017,19,51,70,2.7583497053045187,52.910974629645885
Task_33607,843,701,19,197,216,1.2008547008547008,22.65576335094234
Task_33608,1308,741,17,102,119,1.7628032345013478,29.328117081128642
Task_33609,1131,590,91,93,184,1.9137055837563453,26.615425762904398
Task_33610,2716,70,56,193,249,38.25352112676056,49.76115315052011
Task_33611,2440,575,135,79,214,4.236111111111111,47.35687382741944
Task_33612,747,466,119,174,293,1.5995717344753748,20.791587694805955
Task_33613,2472,84,61,123,184,29.08235294117647,45.63795816806692
Task_33614,2401,524,173,190,363,4.573333333333333,47.512542902895696
Task_33615,2141,569,130,15,145,3.756140350877193,41.6554894474088
Task_33616,1113,501,48,63,111,2.2171314741035855,25.26291923160608
Task_33617,2917,658,108,97,205,4.426403641881639,55.29209775103212
Task_33618,2887,220,102,25,127,13.063348416289593,52.130727765156415
Task_33619,2502,451,174,24,198,5.535398230088496,47.3318818908003
Task_33620,1675,577,43,71,114,2.897923875432526,34.5701976468389
Task_33621,914,598,113,106,219,1.5258764607679465,23.385289737753453
Task_33622,2682,735,166,51,217,3.6440217391304346,51.45778449397428
Task_33623,1077,652,22,73,95,1.6493108728943338,25.004038304602133
Task_33624,2669,148,149,165,314,17.91275167785235,49.961197117690936
Task_33625,736,142,146,64,210,5.146853146853147,18.504133323657534
Task_33626,2716,825,87,182,269,3.288135593220339,52.98013439107377
Task_33627,1226,903,120,195,315,1.3561946902654867,29.834153041444836
Task_33628,993,81,109,162,271,12.109756097560975,22.85118561255148
Task_33629,2842,1008,47,84,131,2.8166501486620414,54.75708876361299
Task_33630,924,334,102,103,205,2.7582089552238807,22.687824489200775
Task_33631,1810,137,186,84,270,13.115942028985508,35.858275980180885
Task_33632,1353,300,50,126,176,4.495016611295681,29.336436610524057
Task_33633,2240,676,11,14,25,3.308714918759232,42.210520313466546
Task_33634,2177,519,51,165,216,4.186538461538461,43.34898341982667
Task_33635,592,320,141,196,337,1.8442367601246106,18.123979469775204
Task_33636,1715,784,36,107,143,2.1847133757961785,36.18273989104295
Task_33637,2812,73,102,66,168,38.0,50.16233814200663
Task_33638,522,317,100,125,225,1.6415094339622642,16.38525449470627
Task_33639,2376,530,154,46,200,4.47457627118644,45.68265833612147
Task_33640,657,629,179,83,262,1.042857142857143,19.49082668661382
Task_33641,1705,539,49,171,220,3.1574074074074074,35.964175502776484
Task_33642,1997,163,33,42,75,12.176829268292684,37.111171121288
Task_33643,1634,926,43,89,132,1.7626752966558792,35.340094027291904
Task_33644,2988,660,30,158,188,4.5204236006051435,56.39711651132183
Task_33645,1731,655,139,192,331,2.638719512195122,37.17653254482506
Task_33646,2426,157,41,171,212,15.354430379746836,45.69168213432036
Task_33647,730,221,77,180,257,3.2882882882882885,19.668761737702365
Task_33648,1180,617,170,175,345,1.9093851132686084,28.368940243563227
Task_33649,934,748,150,132,282,1.2469959946595461,24.468587989547725
Task_33650,998,684,109,150,259,1.456934306569343,25.217000849733463
Task_33651,933,277,80,12,92,3.356115107913669,21.05668826557795
Task_33652,1549,704,62,67,129,2.197163120567376,33.162700455516564
Task_33653,2225,382,164,72,236,5.809399477806789,43.29857842656174
Task_33654,1520,800,19,104,123,1.8976279650436954,32.9729111479521
Task_33655,2325,529,190,128,318,4.386792452830188,46.03158267094998
Task_33656,2682,854,59,23,82,3.136842105263158,50.421385526184196
Task_33657,2251,946,176,12,188,2.3769799366420274,44.83047968868777
Task_33658,2134,648,58,155,213,3.288135593220339,43.02122120469627
Task_33659,2366,195,57,18,75,12.071428571428571,42.98508811524007
Task_33660,2528,538,73,149,222,4.690166975881262,48.93267649446426
Task_33661,2408,222,39,39,78,10.798206278026905,43.874485798905305
Task_33662,2935,1007,99,104,203,2.9117063492063493,56.64935066697768
Task_33663,1649,710,47,114,161,2.319268635724332,35.04273939351001
Task_33664,1728,702,101,50,151,2.458036984352774,35.69593055827904
Task_33665,1150,794,29,30,59,1.4465408805031446,25.69664832408978
Task_33666,2212,605,150,123,273,3.65016501650165,44.274272722694356
Task_33667,1620,553,188,62,250,2.9241877256317688,34.22203944373635
Task_33668,2027,602,133,170,303,3.361525704809287,41.539087275512664
Task_33669,528,830,121,122,243,0.6353790613718412,18.25191836862899
Task_33670,809,907,154,81,235,0.8909691629955947,22.642383375973555
Task_33671,2819,644,190,48,238,4.370542635658914,53.25804229057439
Task_33672,2377,771,160,193,353,3.0790155440414506,47.87432282829485
Task_33673,1076,130,52,170,222,8.213740458015268,24.34912824556262
Task_33674,2807,227,106,200,306,12.31140350877193,52.67534840273652
Task_33675,929,934,198,110,308,0.9935828877005347,25.08799356156892
Task_33676,1558,786,102,143,245,1.9796696315120712,34.38609440376343
Task_33677,500,842,117,189,306,0.5931198102016607,18.230953960456297
Task_33678,1990,170,159,93,252,11.637426900584796,38.916419035508554
Task_33679,1632,79,191,42,233,20.4,31.819593939068596
Task_33680,2449,811,119,137,256,3.0160098522167487,48.62117598358628
Task_33681,2809,788,56,125,181,3.5602027883396703,53.92865574667555
Task_33682,2372,514,188,64,252,4.6058252427184465,46.05935940555482
Task_33683,1605,486,89,47,136,3.295687885010267,32.92850674983004
Task_33684,1760,459,137,187,324,3.8260869565217392,36.97619445314972
Task_33685,788,249,111,156,267,3.152,20.62000630313852
Task_33686,2170,616,167,164,331,3.5170178282009723,43.96547410378404
Task_33687,1651,1009,18,39,57,1.6346534653465346,34.33719353070102
Task_33688,2851,848,99,151,250,3.3580683156654887,55.10158547021689
Task_33689,1002,669,65,139,204,1.4955223880597015,25.05488685339652
Task_33690,2039,492,63,76,139,4.1359026369168355,40.31990928414982
Task_33691,1786,425,115,45,160,4.192488262910798,35.66941957997617
Task_33692,2961,928,106,68,174,3.18729817007535,56.32581632739362
Task_33693,1703,796,10,136,146,2.136762860727729,36.03902664663476
Task_33694,1970,840,92,69,161,2.342449464922711,40.189708353886765
Task_33695,1781,630,108,190,298,2.822503961965135,37.73822672165434
Task_33696,2471,1012,95,149,244,2.43928923988154,49.571204482913565
Task_33697,2843,796,172,187,359,3.5671267252195733,55.35382247066057
Task_33698,2610,323,124,174,298,8.055555555555555,49.83846042805171
Task_33699,1967,563,172,65,237,3.4875886524822697,39.75227910167655
Task_33700,2532,427,102,171,273,5.91588785046729,48.83762302921385
Task_33701,1054,994,107,130,237,1.0592964824120603,26.93033914818004
Task_33702,2967,330,123,55,178,8.963746223564955,54.47186868315188
Task_33703,2847,89,79,72,151,31.633333333333333,50.776182797423
Task_33704,1148,1024,69,78,147,1.12,27.961928320232616
Task_33705,1327,819,30,197,227,1.6182926829268294,30.8167838705573
Task_33706,2728,294,78,28,106,9.247457627118644,49.64296355860816
Task_33707,760,250,179,124,303,3.0278884462151394,20.29622384212575
Task_33708,1587,347,143,174,317,4.560344827586207,33.82531958645362
Task_33709,695,772,55,114,169,0.8990944372574385,20.23343855468816
Task_33710,1152,993,91,17,108,1.158953722334004,26.915603402816583
Task_33711,687,810,130,200,330,0.8471023427866831,21.097788233846263
Task_33712,692,937,10,108,118,0.7377398720682303,20.21431446444156
Task_33713,693,95,106,122,228,7.21875,17.917614296213788
Task_33714,766,605,17,93,110,1.2640264026402641,20.208071043266575
Task_33715,932,707,74,99,173,1.3163841807909604,23.80309415417371
Task_33716,965,578,15,174,189,1.6666666666666667,24.10484675221872
Task_33717,1428,572,138,60,198,2.492146596858639,31.000502931743764
Task_33718,2846,411,152,196,348,6.907766990291262,54.12838736062336
Task_33719,747,176,69,159,228,4.220338983050848,19.39274167821309
Task_33720,1487,253,65,158,223,5.854330708661418,31.55221230918146
Task_33721,1448,989,158,86,244,1.4626262626262627,33.06948940552358
Task_33722,2885,884,160,189,349,3.2598870056497176,56.25339553311941
Task_33723,678,350,94,33,127,1.9316239316239316,17.793884797683113
Task_33724,1559,912,81,191,272,1.7075575027382257,35.025676196884184
Task_33725,1318,735,152,154,306,1.7907608695652173,30.716212182717868
Task_33726,539,698,150,53,203,0.771101573676681,17.44549952822345
Task_33727,1660,635,199,43,242,2.610062893081761,34.858012705033666
Task_33728,2141,698,42,175,217,3.0629470672389125,43.28376580709471
Task_33729,2556,818,146,125,271,3.120879120879121,50.38838475165907
Task_33730,2281,137,159,193,352,16.528985507246375,43.939062758095695
Task_33731,2653,954,69,69,138,2.7780104712041886,51.381539421252825
Task_33732,1435,747,159,57,216,1.9184491978609626,31.746780588286384
Task_33733,2353,575,50,126,176,4.085069444444445,46.051407543760014
Task_33734,1188,704,57,143,200,1.6851063829787234,28.11952500498374
Task_33735,2856,425,167,190,357,6.704225352112676,54.365044034272294
Task_33736,2228,496,157,129,286,4.482897384305835,44.24713108935752
Task_33737,727,866,134,111,245,0.8385236447520185,21.391092830450116
Task_33738,2151,302,184,135,319,7.099009900990099,42.54540258788871
Task_33739,768,76,121,84,205,9.974025974025974,18.730714605298477
Task_33740,2299,250,169,93,262,9.159362549800797,44.36583734881088
Task_33741,512,938,188,72,260,0.5452609158679447,18.18405760019208
Task_33742,1935,784,48,195,243,2.464968152866242,40.47962896970329
Task_33743,1163,767,170,107,277,1.5143229166666667,28.117925961233496
Task_33744,568,183,90,129,219,3.0869565217391304,16.60582396722398
Task_33745,1867,950,182,123,305,1.9631966351209253,40.033427517695124
Task_33746,2319,273,146,17,163,8.463503649635037,43.639527426227524
Task_33747,2226,946,123,25,148,2.350580781414995,44.21391679867943
Task_33748,2742,631,119,196,315,4.3386075949367084,53.0469714787778
Task_33749,1687,424,56,151,207,3.969411764705882,35.19781130859445
Task_33750,795,1002,85,30,115,0.7926221335992024,21.502759767381463
Task_33751,1414,186,91,127,218,7.561497326203209,30.075283886845494
Task_33752,1607,895,47,22,69,1.7935267857142858,33.19791381376545
Task_33753,2115,1008,162,19,181,2.0961347869177405,42.842387616639165
Task_33754,2065,675,63,132,195,3.054733727810651,41.89586559085638
Task_33755,2317,711,91,183,274,3.2542134831460676,46.36389989255997
Task_33756,831,214,64,64,128,3.8651162790697673,20.289784474431645
Task_33757,1001,529,14,71,85,1.8886792452830188,23.289403040830916
Task_33758,2258,952,92,88,180,2.3693599160545644,45.555040027288875
Task_33759,1052,756,169,38,207,1.3896961690885072,25.453326130581132
Task_33760,2319,477,23,21,44,4.851464435146443,43.058257344832555
Task_33761,1051,305,200,65,265,3.434640522875817,24.55554936019357
Task_33762,1656,118,113,140,253,13.915966386554622,33.44023951444695
Task_33763,1974,578,73,126,199,3.4093264248704664,40.15050604694036
Task_33764,1010,81,162,181,343,12.317073170731707,23.46994949814636
Task_33765,2996,558,188,163,351,5.359570661896243,56.94941413924698
Task_33766,2846,436,19,156,175,6.5125858123569795,53.336092204894236
Task_33767,1250,347,154,125,279,3.5919540229885056,28.251714646749374
Task_33768,2216,202,57,199,256,10.916256157635468,43.08515921470693
Task_33769,2008,578,117,132,249,3.4680483592400693,40.86312130320582
Task_33770,2554,664,158,82,240,3.8406015037593986,49.5977998224628
Task_33771,566,81,161,106,267,6.902439024390244,16.05965017394937
Task_33772,2811,874,156,150,306,3.2125714285714286,54.798567102292814
Task_33773,2710,293,177,61,238,9.217687074829932,50.549397926946206
Task_33774,1615,486,132,63,195,3.316221765913758,33.71952681007086
Task_33775,2023,275,34,195,229,7.329710144927536,40.12264913842369
Task_33776,1410,733,44,44,88,1.9209809264305178,30.040945031947917
Task_33777,2014,754,141,26,167,2.667549668874172,40.44752280493764
Task_33778,1318,67,197,190,387,19.38235294117647,28.493438672203215
Task_33779,1467,479,54,101,155,3.05625,31.392152029590758
Task_33780,1375,511,27,15,42,2.685546875,28.11772809124103
Task_33781,2617,210,100,35,135,12.402843601895734,47.92645808861292
Task_33782,583,637,59,62,121,0.9137931034482759,17.233732798644922
Task_33783,1354,710,75,134,209,1.9043600562587903,30.80689825260579
Task_33784,1726,789,10,145,155,2.1848101265822786,36.42398254906569
Task_33785,1379,304,112,52,164,4.521311475409836,29.278476901392583
Task_33786,2206,224,191,148,339,9.804444444444444,43.24457339418393
Task_33787,2858,932,164,198,362,3.0632368703108255,56.04760260851128
Task_33788,2319,742,122,134,256,3.1211305518169583,46.340757903188354
Task_33789,2959,117,41,71,112,25.076271186440678,52.51096279400003
Task_33790,2626,293,64,150,214,8.931972789115646,49.642694809169846
Task_33791,821,651,165,38,203,1.25920245398773,21.455727616532343
Task_33792,902,421,50,29,79,2.137440758293839,20.774964230359128
Task_33793,2887,745,102,29,131,3.8699731903485253,53.99861150925158
Task_33794,959,742,186,99,285,1.2907133243606999,24.808487054378485
Task_33795,1295,125,117,153,270,10.277777777777779,27.901052296108702
Task_33796,878,199,38,140,178,4.39,21.443429495330264
Task_33797,2956,783,92,15,107,3.770408163265306,54.851120629076966
Task_33798,1771,826,41,126,167,2.1414752116082223,37.47129818269753
Task_33799,2723,718,43,124,167,3.787204450625869,52.21557692096918
Task_33800,2358,647,193,171,364,3.638888888888889,47.20008941677872
Task_33801,638,184,112,69,181,3.4486486486486485,17.182224947211818
Task_33802,2279,975,49,111,160,2.3350409836065573,45.87052838995847
Task_33803,534,971,137,134,271,0.5493827160493827,18.891668815526646
Task_33804,2902,182,110,40,150,15.857923497267759,52.417537879424195
Task_33805,2886,529,165,166,331,5.445283018867925,55.02822847508045
Task_33806,991,336,42,124,166,2.940652818991098,23.591053498690012
Task_33807,1214,678,137,97,234,1.7879234167893963,28.51155183044067
Task_33808,3000,653,104,92,196,4.587155963302752,56.46272231862839
Task_33809,1013,477,65,134,199,2.1192468619246863,24.637611412385812
Task_33810,998,527,187,18,205,1.8901515151515151,23.765708920476474
Task_33811,596,799,140,29,169,0.745,18.153827536632114
Task_33812,2643,897,92,61,153,2.943207126948775,50.92445875881068
Task_33813,2053,557,102,33,135,3.6792114695340503,40.187680471898695
Task_33814,2379,847,47,74,121,2.8054245283018866,46.64387028798021
Task_33815,2446,919,32,42,74,2.658695652173913,46.68494643749538
Task_33816,1625,310,118,159,277,5.22508038585209,34.10157678339813
Task_33817,753,334,78,135,213,2.2477611940298505,20.13323575233161
Task_33818,1947,210,166,95,261,9.227488151658768,38.68637865995018
Task_33819,2096,684,24,127,151,3.0598540145985402,41.92235811436347
Task_33820,2367,276,170,25,195,8.545126353790614,44.60084657362595
Task_33821,2629,237,131,162,293,11.046218487394958,49.788153038709936
Task_33822,2315,627,185,150,335,3.6863057324840764,46.294246179506864
Task_33823,1198,845,109,166,275,1.4160756501182032,28.98087280433127
Task_33824,2886,589,155,179,334,4.8915254237288135,55.254051030973564
Task_33825,2199,499,150,16,166,4.398,42.51726159308042
Task_33826,999,246,50,79,129,4.044534412955466,23.23999398689071
Task_33827,827,318,86,115,201,2.592476489028213,21.0623698759669
Task_33828,1287,977,195,15,210,1.3159509202453987,29.734673235745344
Task_33829,1880,384,147,10,157,4.883116883116883,36.93455739826063
Task_33830,1537,872,160,190,350,1.7605956471935853,34.849625710614454
Task_33831,1537,572,89,161,250,2.682373472949389,33.411665064480516
Task_33832,1803,638,109,141,250,2.8215962441314555,37.82365724380469
Task_33833,620,1021,81,187,268,0.6066536203522505,20.592058130553937
Task_33834,2323,1008,118,186,304,2.3022794846382557,47.527732655814134
Task_33835,2591,448,67,114,181,5.770601336302895,49.378891352537096
Task_33836,1308,490,51,104,155,2.663951120162933,28.942527954102612
Task_33837,2759,323,28,80,108,8.515432098765432,50.84512638273845
Task_33838,2678,874,15,158,173,3.0605714285714285,52.058683144817564
Task_33839,1455,511,121,28,149,2.841796875,30.69856329347185
Task_33840,1355,710,123,196,319,1.9057665260196905,31.34459781309771
Task_33841,1206,507,50,60,110,2.374015748031496,26.598472269133584
Task_33842,1811,939,109,88,197,1.926595744680851,38.51466293974163
Task_33843,790,556,161,148,309,1.4183123877917414,21.74691835456817
Task_33844,2087,941,195,153,348,2.215498938428875,43.729366957453045
Task_33845,2897,667,145,93,238,4.336826347305389,55.10199003616966
Task_33846,2728,509,162,82,244,5.349019607843137,51.875508909700216
Task_33847,1528,464,122,99,221,3.286021505376344,32.72071536537877
Task_33848,649,481,102,126,228,1.3464730290456433,18.890391782921714
Task_33849,669,598,63,94,157,1.1168614357262103,19.089445203773163
Task_33850,1713,338,71,62,133,5.053097345132743,34.466707582343055
Task_33851,1770,319,135,38,173,5.53125,35.262109232963645
Task_33852,2912,190,154,99,253,15.24607329842932,53.78730313202476
Task_33853,1958,781,50,200,250,2.50383631713555,40.91183996226868
Task_33854,2953,866,191,87,278,3.405997693194925,56.74350060889074
Task_33855,2575,981,36,29,65,2.6221995926680246,48.87591865701859
Task_33856,1135,212,118,140,258,5.328638497652582,25.912309063436766
Task_33857,987,1009,25,148,173,0.9772277227722772,25.58222462767806
Task_33858,1446,605,90,173,263,2.386138613861386,32.16585830762653
Task_33859,2909,1020,173,61,234,2.8491674828599414,56.02417098822087
Task_33860,1396,387,144,191,335,3.597938144329897,31.039747558301205
Task_33861,2369,890,102,98,200,2.6588103254769924,47.298693564084296
Task_33862,1235,352,100,97,197,3.498583569405099,27.64838369394594
Task_33863,2305,760,141,161,302,3.028909329829172,46.42239320212631
Task_33864,897,1003,152,70,222,0.8934262948207171,24.140997296510605
Task_33865,2755,369,187,107,294,7.445945945945946,52.1733869181712
Task_33866,2118,112,148,69,217,18.743362831858406,39.94827684937837
Task_33867,980,372,42,166,208,2.6273458445040214,23.817597529405475
Task_33868,1489,387,83,113,196,3.8376288659793816,31.80604703532762
Task_33869,950,156,97,183,280,6.050955414012739,22.794999576535435
Task_33870,1880,91,69,84,153,20.434782608695652,35.74212745654493
Task_33871,1003,739,12,108,120,1.3554054054054054,24.442649656676892
Task_33872,2013,676,45,128,173,2.9734121122599704,40.89925790759511
Task_33873,689,819,90,42,132,0.8402439024390244,19.55375660769275
Task_33874,2215,284,109,86,195,7.771929824561403,42.79566985084737
Task_33875,745,265,138,125,263,2.800751879699248,19.929173155600722
Task_33876,806,232,109,40,149,3.459227467811159,19.52885655595616
Task_33877,1403,147,106,98,204,9.47972972972973,29.396735088920707
Task_33878,2839,633,139,170,309,4.477917981072555,54.52446211704864
Task_33879,1185,278,181,45,226,4.247311827956989,26.11563506013249
Task_33880,971,490,76,27,103,1.9775967413441955,22.4764640466893
Task_33881,1248,416,160,76,236,2.9928057553956835,28.004351524384976
Task_33882,2003,495,28,14,42,4.038306451612903,38.01370954851374
Task_33883,1322,511,76,176,252,2.58203125,29.934119413376223
Task_33884,2265,636,52,48,100,3.5557299843014127,43.39966242626429
Task_33885,2689,914,68,46,114,2.9387978142076503,51.18554293498951
Task_33886,2892,866,17,44,61,3.3356401384083045,53.51954550405924
Task_33887,1273,843,155,181,336,1.5082938388625593,30.471052203663092
Task_33888,2173,876,114,160,274,2.4777651083238315,44.56627129286613
Task_33889,2387,615,18,147,165,3.875,46.58416021529714
Task_33890,1611,618,133,109,242,2.602584814216478,34.63697924594857
Task_33891,2788,333,148,28,176,8.347305389221557,51.40454552126884
Task_33892,2558,884,170,82,252,2.8903954802259886,50.40689164083481
Task_33893,773,643,106,89,195,1.200310559006211,21.098832396070005
Task_33894,1262,664,84,27,111,1.8977443609022557,27.709172348238514
Task_33895,769,332,83,189,272,2.309309309309309,20.6937102120075
Task_33896,1970,572,11,180,191,3.43804537521815,40.01161823743212
Task_33897,2932,539,111,131,242,5.42962962962963,55.336481408723934
Task_33898,2802,940,17,14,31,2.977683315621679,51.96998469130404
Task_33899,547,794,200,121,321,0.6880503144654088,18.785099005214565
Task_33900,2421,756,168,109,277,3.1981505944517834,48.05860503699093
Task_33901,1272,616,108,20,128,2.0615883306320906,28.035250236024922
Task_33902,2177,782,92,62,154,2.7803320561941254,43.20257258021221
Task_33903,1946,342,136,178,314,5.673469387755102,39.47949441363306
Task_33904,804,159,129,74,203,5.025,19.74259724422859
Task_33905,1589,830,136,160,296,1.9121540312876053,35.26900309452565
Task_33906,1945,959,45,74,119,2.0260416666666665,40.084858312668146
Task_33907,2458,560,176,82,258,4.381461675579323,47.82774019994472
Task_33908,1223,166,189,54,243,7.323353293413174,26.479993730164974
Task_33909,2955,514,60,56,116,5.737864077669903,54.291610314060144
Task_33910,1867,399,137,132,269,4.6675,38.1472243205153
Task_33911,519,621,30,199,229,0.8344051446945338,17.33652640545041
Task_33912,888,623,177,22,199,1.4230769230769231,22.31522216986058
Task_33913,592,432,156,91,247,1.3672055427251733,17.81457962392483
Task_33914,1673,791,189,129,318,2.1123737373737375,36.53209430657487
Task_33915,1199,508,42,161,203,2.355599214145383,27.684217314724098
Task_33916,884,421,138,160,298,2.09478672985782,22.834035012271453
Task_33917,2139,151,125,95,220,14.072368421052632,41.085263571838
Task_33918,504,75,95,177,272,6.631578947368421,15.21024019735362
Task_33919,2841,903,144,172,316,3.142699115044248,55.44205838349736
Task_33920,1957,320,37,59,96,6.0965732087227416,37.702360495598285
Task_33921,1463,385,65,125,190,3.790155440414508,31.409769657880805
Task_33922,1229,763,138,90,228,1.6086387434554974,28.906946956101056
Task_33923,1902,489,81,84,165,3.8816326530612244,38.455791829269
Task_33924,1598,959,180,73,253,1.6645833333333333,35.26275500483043
Task_33925,2953,242,174,99,273,12.152263374485596,54.73719206551391
Task_33926,1599,220,165,161,326,7.235294117647059,33.604483828219436
Task_33927,2091,438,100,101,201,4.763097949886105,41.46699868443074
Task_33928,2600,596,84,163,247,4.355108877721943,50.34158049394606
Task_33929,2909,764,50,154,204,3.802614379084967,55.64984896708723
Task_33930,511,776,197,35,232,0.6576576576576577,17.331315206391075
Task_33931,2527,770,40,160,200,3.277561608300908,49.5194579562837
Task_33932,1870,539,64,15,79,3.462962962962963,36.28398782225588
Task_33933,993,698,177,112,289,1.4206008583690988,25.260822967383984
Task_33934,1300,873,18,13,31,1.4874141876430207,27.991804146945345
Task_33935,981,541,28,56,84,1.8099630996309963,22.838220866019938
Task_33936,2138,734,77,179,256,2.908843537414966,43.58124371316163
Task_33937,846,368,158,113,271,2.292682926829268,21.874547874472785
Task_33938,2805,647,46,77,123,4.328703703703703,52.81488953672644
Task_33939,2003,332,42,46,88,6.015015015015015,38.17901861400649
Task_33940,2883,675,101,105,206,4.264792899408284,54.79543659182093
Task_33941,2841,672,63,40,103,4.221396731054978,52.54987268902173
Task_33942,2686,609,52,163,215,4.4032786885245905,51.66294288207746
Task_33943,936,982,50,129,179,0.9521871820956256,24.82424289798746
Task_33944,586,529,110,49,159,1.1056603773584905,17.107982516150642
Task_33945,560,812,62,37,99,0.6888068880688807,17.184160750839926
Task_33946,1207,1011,123,109,232,1.1926877470355732,29.354513481572848
Task_33947,1119,698,36,89,125,1.6008583690987124,26.395620655620718
Task_33948,2167,674,50,106,156,3.2103703703703705,43.13391754498739
Task_33949,1481,616,188,155,343,2.40032414910859,33.094497550873875
Task_33950,2457,454,133,57,190,5.4,46.88241617692682
Task_33951,2820,678,96,66,162,4.153166421207659,53.19682126201795
Task_33952,1670,210,59,26,85,7.914691943127962,32.35295409376436
Task_33953,981,72,151,154,305,13.438356164383562,22.80476419698527
Task_33954,1238,501,156,150,306,2.4661354581673307,28.7110419075869
Task_33955,1163,275,167,100,267,4.213768115942029,26.549699797460637
Task_33956,1593,195,118,91,209,8.127551020408163,32.73211864754868
Task_33957,2577,219,77,134,211,11.713636363636363,48.55374151602652
Task_33958,2588,783,186,53,239,3.3010204081632653,50.283841222796475
Task_33959,1623,828,130,84,214,1.9577804583835947,35.245880256210846
Task_33960,1410,941,189,21,210,1.4968152866242037,31.620640968611937
Task_33961,1096,743,25,17,42,1.4731182795698925,24.437315518871554
Task_33962,2155,442,62,159,221,4.864559819413093,42.735207188026266
Task_33963,2819,669,12,160,172,4.2074626865671645,53.62569550081949
Task_33964,2179,618,36,55,91,3.520193861066236,42.14782596498417
Task_33965,1634,116,29,167,196,13.965811965811966,32.80536452702452
Task_33966,1919,286,26,103,129,6.686411149825784,37.78562114847753
Task_33967,2691,861,45,176,221,3.1218097447795823,52.53958602251438
Task_33968,2286,956,147,35,182,2.3887147335423196,45.48134765886519
Task_33969,1001,488,182,192,374,2.0470347648261757,25.286231064776235
Task_33970,1943,308,28,138,166,6.288025889967638,38.55111253393845
Task_33971,2822,375,131,121,252,7.50531914893617,53.08493623665627
Task_33972,719,480,188,99,287,1.4948024948024947,20.21988724857893
Task_33973,2052,496,16,111,127,4.128772635814889,40.532128348341594
Task_33974,2684,846,159,80,239,3.168831168831169,52.194563033645835
Task_33975,1930,462,198,70,268,4.168466522678186,38.975067933948125
Task_33976,2943,604,125,63,188,4.864462809917355,55.073016149477546
Task_33977,2556,401,87,17,104,6.358208955223881,47.20153411606632
Task_33978,1012,807,95,90,185,1.2524752475247525,25.329883376853374
Task_33979,859,336,73,32,105,2.548961424332344,20.253465545811974
Task_33980,718,775,119,179,298,0.9252577319587629,21.30911211050671
Task_33981,1533,588,137,154,291,2.602716468590832,33.59422963090401
Task_33982,1989,699,140,94,234,2.8414285714285716,40.81377523212475
Task_33983,2533,825,159,33,192,3.066585956416465,49.04628430460494
Task_33984,989,524,145,64,209,1.8838095238095238,24.00095271678325
Task_33985,2191,313,155,176,331,6.977707006369426,43.329839747449626
Task_33986,2069,248,82,127,209,8.309236947791165,40.59406212802408
Task_33987,1733,971,161,88,249,1.7829218106995885,37.60305665537063
Task_33988,2655,960,166,85,251,2.7627471383975024,52.175349672248096
Task_33989,1897,717,162,69,231,2.6420612813370474,39.085051285109586
Task_33990,723,991,189,179,368,0.7288306451612904,22.428318208126427
Task_33991,690,709,169,23,192,0.971830985915493,19.53119790436872
Task_33992,1344,923,55,17,72,1.4545454545454546,28.986924452189655
Task_33993,832,433,138,50,188,1.9170506912442395,20.949077020890304
Task_33994,1204,278,96,10,106,4.315412186379929,25.460321365168543
Task_33995,2771,526,67,123,190,5.258064516129032,52.57060509251568
Task_33996,1043,764,118,151,269,1.3633986928104576,26.231842438635564
Task_33997,2248,111,183,70,253,20.071428571428573,42.146821344154716
Task_33998,2416,664,77,186,263,3.6330827067669174,47.80622200314696
Task_33999,2834,796,166,22,188,3.5558343789209537,53.61591465318415
Task_34000,2654,456,79,131,210,5.807439824945296,50.581210602598134
Task_34001,962,223,49,75,124,4.294642857142857,22.324307911155604
Task_34002,2636,697,123,13,136,3.7765042979942693,49.782301930583195
Task_34003,1494,141,148,178,326,10.52112676056338,31.45520530844442
Task_34004,842,547,13,119,132,1.5364963503649636,21.54498950321865
Task_34005,543,418,176,57,233,1.295942720763723,16.664108746258957
Task_34006,2027,256,33,111,144,7.88715953307393,39.41761056608814
Task_34007,1861,673,151,126,277,2.7611275964391693,38.95199258223648
Task_34008,1787,100,113,160,273,17.693069306930692,35.412085355496465
Task_34009,798,469,186,70,256,1.6978723404255318,21.016020523168432
Task_34010,2188,707,97,140,237,3.0903954802259888,44.08643329421111
Task_34011,1033,962,70,81,151,1.0726895119418485,25.91074085763988
Task_34012,648,582,113,184,297,1.1114922813036021,19.553416532799883
Task_34013,1020,69,85,118,203,14.571428571428571,22.913430155708657
Task_34014,2201,923,68,103,171,2.382034632034632,44.62364340749974
Task_34015,2364,107,17,41,58,21.88888888888889,42.27991872309084
Task_34016,1376,225,193,170,363,6.088495575221239,30.280473164196483
Task_34017,611,451,119,146,265,1.3517699115044248,18.391339472940082
Task_34018,1915,227,63,163,226,8.399122807017545,38.239672436076056
Task_34019,810,816,130,166,296,0.9914320685434517,22.865461893575958
Task_34020,2712,809,62,44,106,3.348148148148148,50.94187769307564
Task_34021,2524,927,34,136,170,2.7198275862068964,49.750711537310536
Task_34022,1926,616,106,14,120,3.1215559157212316,38.029787985882756
Task_34023,2378,254,40,29,69,9.325490196078432,43.41897061852516
Task_34024,2943,207,119,182,301,14.149038461538462,54.69332250651737
Task_34025,1166,275,53,90,143,4.22463768115942,25.94218807132334
Task_34026,960,712,167,142,309,1.3464235624123422,24.922666646039904
Task_34027,2463,376,35,27,62,6.5331564986737405,45.18155112762559
Task_34028,2298,412,181,125,306,5.5641646489104115,45.166442404967995
Task_34029,2691,797,167,114,281,3.3721804511278197,52.49026406510061
Task_34030,2675,491,69,135,204,5.436991869918699,51.01905106608893
Task_34031,1618,303,13,170,183,5.322368421052632,33.501831526810996
Task_34032,576,303,54,93,147,1.894736842105263,16.746324813161277
Task_34033,1800,230,93,149,242,7.792207792207792,36.45716926369665
Task_34034,2568,267,58,144,202,9.582089552238806,48.56912609531398
Task_34035,1028,685,37,192,229,1.498542274052478,25.66096990003904
Task_34036,1323,278,97,123,220,4.741935483870968,28.918231133403182
Task_34037,529,480,190,46,236,1.0997920997920998,16.448487542544616
Task_34038,1959,260,85,177,262,7.505747126436781,39.17486527682184
Task_34039,1230,568,23,165,188,2.161687170474517,28.259069919821993
Task_34040,2697,582,59,167,226,4.626072041166381,51.804209439959834
Task_34041,613,460,57,66,123,1.3297180043383947,17.338244023240332
Task_34042,2315,598,194,192,386,3.8647746243739567,46.49367683403488
Task_34043,1377,923,76,74,150,1.4902597402597402,31.1471955880647
Task_34044,1333,204,42,116,158,6.5024390243902435,28.357582048818802
Task_34045,2377,796,154,178,332,2.982434127979925,47.83609241788404
Task_34046,1827,556,139,189,328,3.2800718132854576,38.366874071626775
Task_34047,2542,584,80,168,248,4.345299145299145,49.44005006475275
Task_34048,1855,882,116,11,127,2.10079275198188,37.93812904950482
Task_34049,1809,364,164,36,200,4.956164383561644,36.14993839926197
Task_34050,2520,144,167,123,290,17.379310344827587,47.40717735956492
Task_34051,2406,563,13,76,89,4.26595744680851,45.721467328126785
Task_34052,796,909,26,154,180,0.8747252747252747,22.30884378191578
Task_34053,1218,636,14,150,164,1.9120879120879122,28.11473232619006
Task_34054,2322,546,60,110,170,4.244972577696527,45.366280182607035
Task_34055,2310,295,146,27,173,7.804054054054054,43.672419704163566
Task_34056,2633,68,168,26,194,38.15942028985507,47.1288883470016
Task_34057,2644,86,164,71,235,30.39080459770115,48.084703571274794
Task_34058,2849,219,11,36,47,12.95,50.62597941880571
Task_34059,1482,107,173,27,200,13.722222222222221,29.635672212745487
Task_34060,1697,846,172,143,315,2.0035419126328216,37.090664568396825
Task_34061,1911,956,37,49,86,1.9968652037617556,38.77196829083723
Task_34062,2360,1009,13,84,97,2.3366336633663365,46.52550148471828
Task_34063,1984,506,144,17,161,3.913214990138067,39.01657628583451
Task_34064,2588,160,189,90,279,16.074534161490682,48.41306465379886
Task_34065,2523,933,10,129,139,2.701284796573876,49.397553038491395
Task_34066,2108,810,185,159,344,2.599260172626387,43.6443283699544
Task_34067,1638,407,103,101,204,4.014705882352941,34.21112869871315
Task_34068,2967,436,199,64,263,6.7894736842105265,55.273022268261855
Task_34069,2265,611,112,147,259,3.700980392156863,45.10473482027097
Task_34070,563,371,167,108,275,1.5134408602150538,17.374856596355777
Task_34071,979,722,105,167,272,1.3540802213001384,25.124579098851665
Task_34072,1265,416,171,16,187,3.0335731414868103,27.536895808428838
Task_34073,1710,341,70,32,102,5.0,33.71061107518569
Task_34074,1230,300,102,185,287,4.086378737541528,27.906139773950077
Task_34075,1529,344,162,65,227,4.431884057971015,32.070926730115225
Task_34076,721,250,185,16,201,2.8725099601593627,18.476118041987363
Task_34077,2515,537,31,187,218,4.674721189591078,48.698829400994875
Task_34078,1028,257,43,170,213,3.9844961240310077,24.23236694930033
Task_34079,1418,952,116,129,245,1.4879328436516264,32.62032721538248
Task_34080,2291,565,65,20,85,4.0477031802120145,43.35466545662272
Task_34081,2179,635,75,76,151,3.4261006289308176,43.00175777137016
Task_34082,2456,871,133,16,149,2.81651376146789,47.59583014457971
Task_34083,630,132,85,176,261,4.7368421052631575,17.492393861131994
Task_34084,2810,733,18,52,70,3.8283378746594003,52.08226182171439
Task_34085,668,837,181,122,303,0.7971360381861575,20.67472039433209
Task_34086,1531,904,72,65,137,1.6917127071823204,33.4218108810177
Task_34087,1927,944,92,196,288,2.039153439153439,41.00359565010915
Task_34088,1007,281,177,21,198,3.5709219858156027,23.107606174171064
Task_34089,581,780,57,156,213,0.7439180537772087,18.74538579420336
Task_34090,2198,483,33,109,142,4.541322314049586,42.865631968642425
Task_34091,2211,111,96,133,229,19.741071428571427,41.95830634566624
Task_34092,2686,155,17,109,126,17.21794871794872,48.793047806534695
Task_34093,1233,989,98,190,288,1.2454545454545454,30.06906558980676
Task_34094,1694,486,188,48,236,3.478439425051335,34.93153660719117
Task_34095,2893,720,44,80,124,4.0124826629681,54.49321576733018
Task_34096,2707,76,78,176,254,35.15584415584416,49.70106029170768
Task_34097,858,980,149,126,275,0.8746177370030581,23.977065135570268
Task_34098,2606,503,37,83,120,5.170634920634921,49.21660382452723
Task_34099,1525,297,32,169,201,5.117449664429531,32.14660392657513
Task_34100,2600,245,136,135,271,10.56910569105691,49.22151331385064
Task_34101,2315,959,146,117,263,2.4114583333333335,46.96247853578692
Task_34102,1065,101,105,113,218,10.441176470588236,23.787580445157374
Task_34103,746,629,13,26,39,1.1841269841269841,18.707954740572635
Task_34104,1402,143,189,34,223,9.73611111111111,28.82218586027814
Task_34105,1460,839,30,21,51,1.7380952380952381,30.67767674606294
Task_34106,1820,407,68,56,124,4.46078431372549,36.18181823047242
Task_34107,1809,819,73,118,191,2.2060975609756097,38.24548865949197
Task_34108,1091,267,105,99,204,4.07089552238806,25.09384585433182
Task_34109,1110,578,125,153,278,1.9170984455958548,26.80425960104542
Task_34110,2161,453,176,94,270,4.759911894273127,42.9176641704965
Task_34111,1251,186,30,183,213,6.689839572192513,27.516437411108445
Task_34112,1675,983,36,139,175,1.7022357723577235,36.509908999940365
Task_34113,2226,481,194,158,352,4.618257261410788,44.50712031926802
Task_34114,2910,704,54,134,188,4.127659574468085,55.33295829057581
Task_34115,2973,65,152,135,287,45.04545454545455,53.83668281994688
Task_34116,2323,346,47,173,220,6.694524495677234,45.06513932106359
Task_34117,2769,103,112,179,291,26.625,51.009335959137694
Task_34118,944,338,112,32,144,2.784660766961652,22.019694043013526
Task_34119,1774,912,185,108,293,1.9430449069003286,38.365567225689354
Task_34120,1101,709,163,193,356,1.5507042253521126,27.43761167160322
Task_34121,853,373,101,171,272,2.2807486631016043,22.090681527596974
Task_34122,1511,294,55,49,104,5.122033898305085,30.39658120798551
Task_34123,601,280,52,110,162,2.1387900355871885,17.161598386669727
Task_34124,2203,436,51,61,112,5.0411899313501145,42.181253892318566
Task_34125,2630,577,179,167,346,4.550173010380623,51.19814458179119
Task_34126,2240,610,83,143,226,3.6661211129296234,44.586699958739594
Task_34127,2593,755,106,129,235,3.42989417989418,50.62029890861205
Task_34128,720,643,135,65,200,1.1180124223602483,20.058573666907265
Task_34129,1532,948,168,13,181,1.6143308746048473,33.39462612637359
Task_34130,2156,514,109,48,157,4.186407766990291,41.8412435760327
Task_34131,2661,904,51,98,149,2.940331491712707,51.675934383895246
Task_34132,1347,897,30,191,221,1.5,31.314971628361295
Task_34133,1845,246,64,46,110,7.469635627530365,35.47849135730256
Task_34134,2591,393,72,163,235,6.5761421319796955,49.535513899546494
Task_34135,2174,678,167,181,348,3.2017673048600885,44.32610595427848
Task_34136,1091,973,50,21,71,1.120123203285421,25.37253180546108
Task_34137,686,932,150,78,228,0.7352625937834941,20.725473862308792
Task_34138,783,721,176,53,229,1.0844875346260388,21.43700077553903
Task_34139,1500,943,55,137,192,1.5889830508474576,33.73785148055178
Task_34140,2344,754,133,169,302,3.104635761589404,47.03312363014313
Task_34141,1383,772,124,48,172,1.7891332470892627,30.59726820423366
Task_34142,569,738,55,110,165,0.7699594046008119,18.164168447558875
Task_34143,1481,646,101,186,287,2.2890262751159196,32.98156000930439
Task_34144,1409,589,120,147,267,2.388135593220339,31.515268890284805
Task_34145,2348,489,94,100,194,4.791836734693877,45.677409622695
Task_34146,956,142,28,193,221,6.685314685314685,22.48027263084551
Task_34147,1080,891,91,59,150,1.210762331838565,26.158562113600556
Task_34148,1339,65,106,93,199,20.28787878787879,27.814724571194173
Task_34149,1901,953,65,141,206,1.9926624737945493,40.2314632992503
Task_34150,2007,810,62,172,234,2.474722564734895,41.63455187082711
Task_34151,2276,140,24,91,115,16.141843971631207,42.09494622672292
Task_34152,1676,967,108,110,218,1.7314049586776858,36.63497214813529
Task_34153,672,348,167,89,256,1.9255014326647564,18.91333903888675
Task_34154,1258,985,129,192,321,1.2758620689655173,30.60357231977008
Task_34155,1963,448,103,12,115,4.371937639198218,38.07850101418373
Task_34156,1436,80,43,40,83,17.728395061728396,27.623742411366436
Task_34157,2012,880,96,11,107,2.2837684449489215,40.18696400771106
Task_34158,2687,549,65,175,240,4.885454545454546,51.614662304704666
Task_34159,1914,719,150,105,255,2.658333333333333,39.80586856662847
Task_34160,2958,944,137,82,219,3.13015873015873,56.78401840042941
Task_34161,2060,252,29,192,221,8.142292490118576,40.57601847320817
Task_34162,1384,609,147,182,329,2.2688524590163937,31.512830893577515
Task_34163,1561,954,39,111,150,1.6345549738219896,34.27397947078777
Task_34164,2922,418,36,167,203,6.973747016706444,54.67300150432782
Task_34165,2404,961,73,12,85,2.498960498960499,46.4562470454273
Task_34166,970,874,166,177,343,1.1085714285714285,25.756365539223484
Task_34167,2166,411,50,103,153,5.257281553398058,42.227865776216234
Task_34168,693,601,143,31,174,1.1511627906976745,19.11543373827946
Task_34169,1934,382,71,180,251,5.049608355091384,39.20091067286148
Task_34170,1928,880,180,191,371,2.188422247446084,41.17937770988632
Task_34171,2133,642,22,20,42,3.317262830482115,40.566327788954005
Task_34172,2787,426,149,188,337,6.526932084309133,53.1833064526568
Task_34173,876,882,49,127,176,0.9920724801812004,23.54049617077358
Task_34174,2856,500,144,96,240,5.700598802395209,53.974690241433535
Task_34175,2024,614,36,79,115,3.2910569105691057,40.311643113182576
Task_34176,1077,535,159,78,237,2.0093283582089554,25.72941261193731
Task_34177,1117,654,67,130,197,1.7053435114503817,26.81464077109382
Task_34178,2851,389,94,180,274,7.31025641025641,53.78702655376059
Task_34179,1539,155,103,175,278,9.865384615384615,32.032821429469124
Task_34180,1092,875,183,45,228,1.2465753424657535,26.53126130097894
Task_34181,723,631,63,165,228,1.143987341772152,20.6209564915357
Task_34182,1992,320,191,80,271,6.205607476635514,39.696260044773354
Task_34183,2019,121,53,160,213,16.549180327868854,39.07559655509121
Task_34184,502,941,112,155,267,0.5329087048832272,18.347631911505726
Task_34185,1865,116,91,191,282,15.94017094017094,36.896125287646385
Task_34186,654,429,184,151,335,1.5209302325581395,19.33008373428498
Task_34187,1743,613,107,82,189,2.8387622149837135,36.357174557738674
Task_34188,1627,388,15,38,53,4.182519280205655,32.00526461811321
Task_34189,2503,868,69,54,123,2.8803222094361334,48.44888133538503
Task_34190,2128,987,145,104,249,2.1538461538461537,44.004152627109704
Task_34191,2547,330,45,185,230,7.694864048338369,48.60404762041818
Task_34192,578,301,29,93,122,1.913907284768212,16.50494541105748
Task_34193,1014,467,119,132,251,2.1666666666666665,24.78365633903388
Task_34194,1739,845,45,115,160,2.0555555555555554,36.847118771396474
Task_34195,2578,894,127,47,174,2.880446927374302,49.918912997363385
Task_34196,1892,532,136,46,182,3.549718574108818,37.92567849559529
Task_34197,1698,510,69,182,251,3.3228962818003915,35.893570629476194
Task_34198,2000,331,161,91,252,6.024096385542169,39.834823283288415
Task_34199,1187,347,108,82,190,3.410919540229885,26.714906567430393
Task_34200,1209,885,155,45,200,1.3645598194130926,28.295444920843874
Task_34201,2758,162,63,44,107,16.920245398773005,49.18257739047436
Task_34202,1944,609,125,84,209,3.1868852459016392,39.62242319845766
Task_34203,761,550,78,128,206,1.381125226860254,20.846708488582966
Task_34204,2406,146,30,117,147,16.367346938775512,44.5258642540009
Task_34205,2244,1022,185,110,295,2.193548387096774,46.167369748287946
Task_34206,2671,294,170,59,229,9.054237288135592,49.898482766671236
Task_34207,1537,74,197,85,282,20.493333333333332,31.16136072910525
Task_34208,1732,712,62,68,130,2.429172510518934,36.04665981173042
Task_34209,1053,492,114,48,162,2.135902636916836,24.383053878704644
Task_34210,2296,123,177,172,349,18.516129032258064,44.02915828056988
Task_34211,1656,218,52,199,251,7.561643835616438,34.28709261648998
Task_34212,2816,193,32,85,117,14.515463917525773,51.46492510551096
Task_34213,938,989,166,153,319,0.9474747474747475,25.51980942054185
Task_34214,2295,634,50,153,203,3.6141732283464565,45.507294385325956
Task_34215,1037,935,85,37,122,1.107905982905983,25.098104071782284
Task_34216,2642,343,169,71,240,7.680232558139535,49.75894714174054
Task_34217,1662,285,95,22,117,5.811188811188811,32.835353269294934
Task_34218,939,824,158,193,351,1.1381818181818182,25.179416712134856
Task_34219,1300,736,89,91,180,1.7639077340569878,29.670185006993112
Task_34220,2332,901,50,53,103,2.5853658536585367,45.54641819672617
Task_34221,2728,642,39,78,117,4.242612752721618,51.53235930604212
Task_34222,839,703,140,161,301,1.1917613636363635,22.95700868851117
Task_34223,2820,1015,160,172,332,2.7755905511811023,55.53128173821466
Task_34224,2858,398,70,30,100,7.162907268170426,52.072043790393366
Task_34225,1316,164,188,95,283,7.975757575757576,28.44945385171449
Task_34226,1259,325,21,158,179,3.861963190184049,27.879781742809417
Task_34227,1176,388,66,146,212,3.0231362467866325,27.019145301677607
Task_34228,1979,618,80,152,232,3.197092084006462,40.53638456627804
Task_34229,1878,139,140,144,284,13.414285714285715,37.22546719397761
Task_34230,2238,156,66,30,96,14.254777070063694,41.10004478376201
Task_34231,1535,765,94,179,273,2.003916449086162,34.14555419310727
Task_34232,2576,992,195,69,264,2.594159113796576,50.851105269733836
Task_34233,1507,340,177,110,287,4.419354838709677,32.30796008864561
Task_34234,1191,613,81,98,179,1.9397394136807817,27.705875984072076
Task_34235,750,947,115,124,239,0.7911392405063291,22.028339346124245
Task_34236,1158,989,18,36,54,1.1696969696969697,26.55125210759806
Task_34237,1524,496,144,52,196,3.0663983903420524,32.323765698614515
Task_34238,1491,117,185,101,286,12.635593220338983,30.91960016382376
Task_34239,710,724,32,54,86,0.9793103448275862,19.196506305864073
Task_34240,1682,109,176,178,354,15.290909090909091,34.241856648762095
Task_34241,1921,500,52,114,166,3.834331337325349,38.87446180738092
Task_34242,1239,672,73,96,169,1.8410104011887072,28.624137357880652
Task_34243,2749,372,95,187,282,7.369973190348525,52.16211901909534
Task_34244,1031,397,198,21,219,2.590452261306533,23.955148451545963
Task_34245,1587,550,101,91,192,2.88021778584392,33.734126779826966
Task_34246,1704,969,58,186,244,1.756701030927835,37.38329072324939
Task_34247,1589,771,192,95,287,2.0582901554404147,34.96288392966327
Task_34248,1221,195,168,185,353,6.229591836734694,27.706495428708752
Task_34249,973,961,126,95,221,1.0114345114345114,25.41628044001575
Task_34250,1159,190,153,103,256,6.0680628272251305,26.14972105416014
Task_34251,1194,433,91,197,288,2.751152073732719,27.786578096996053
Task_34252,2220,89,31,41,72,24.666666666666668,39.82351036171078
Task_34253,2587,269,67,192,259,9.58148148148148,49.20861790607314
Task_34254,1066,441,99,162,261,2.411764705882353,25.61543725586354
Task_34255,979,152,98,133,231,6.398692810457517,22.927595698108377
Task_34256,2949,141,169,114,283,20.767605633802816,54.086591333278626
Task_34257,1008,97,18,159,177,10.285714285714286,22.619291492375584
Task_34258,2859,817,177,109,286,3.4951100244498776,55.22998884941571
Task_34259,2211,839,174,100,274,2.632142857142857,44.96488108353566
Task_34260,1823,952,117,101,218,1.912906610703043,38.91804362914099
Task_34261,2820,519,181,66,247,5.423076923076923,53.14801680325528
Task_34262,2277,547,67,83,150,4.155109489051095,44.39363497868984
Task_34263,624,437,101,109,210,1.4246575342465753,18.244252030179187
Task_34264,1939,1019,170,108,278,1.9009803921568627,41.24505231912771
Task_34265,600,303,87,38,125,1.9736842105263157,16.282706928851827
Task_34266,1974,584,169,158,327,3.3743589743589744,40.7333793058283
Task_34267,2550,388,188,96,284,6.5552699228791775,48.961087885869716
Task_34268,2239,599,110,144,254,3.7316666666666665,44.62798136846899
Task_34269,1424,738,30,49,79,1.9269282814614344,30.142328137806132
Task_34270,1901,780,105,143,248,2.4340588988476313,39.81493974434587
Task_34271,550,859,37,101,138,0.6395348837209303,18.065410080489468
Task_34272,2262,692,106,149,255,3.264069264069264,45.29803911449611
Task_34273,1491,934,186,143,329,1.5946524064171124,34.14968213000015
Task_34274,637,705,154,192,346,0.9022662889518414,20.051701088239525
Task_34275,907,479,124,50,174,1.8895833333333334,22.220189231417447
Task_34276,1822,163,71,195,266,11.109756097560975,36.570166420360465
Task_34277,2323,547,199,140,339,4.239051094890511,46.169780233054745
Task_34278,2188,112,37,170,207,19.36283185840708,41.5289924394285
Task_34279,1438,158,128,54,182,9.044025157232705,29.51616176647761
Task_34280,724,945,11,63,74,0.7653276955602537,19.845882541367477
Task_34281,2668,264,38,134,172,10.067924528301887,49.89666959588886
Task_34282,1447,731,38,157,195,1.976775956284153,32.26126923363663
Task_34283,1968,857,102,115,217,2.2937062937062938,40.93599942698531
Task_34284,2345,292,62,59,121,8.003412969283277,43.9612440444669
Task_34285,1539,811,77,30,107,1.895320197044335,32.505078716337124
Task_34286,2803,824,186,73,259,3.3975757575757575,53.96041894249995
Task_34287,980,748,125,149,274,1.308411214953271,25.20375013877042
Task_34288,1190,655,132,153,285,1.8140243902439024,28.34326208132637
Task_34289,1546,175,38,177,215,8.784090909090908,31.85488356513576
Task_34290,2616,652,102,50,152,4.006125574272588,49.58013582775866
Task_34291,711,811,99,11,110,0.875615763546798,19.455073733680194
Task_34292,775,233,42,196,238,3.3119658119658117,20.306653876565104
Task_34293,2898,368,162,35,197,7.853658536585366,53.381555191011394
Task_34294,2526,332,148,42,190,7.585585585585585,47.34612991704645
Task_34295,1766,481,69,81,150,3.663900414937759,36.075265183374974
Task_34296,1937,531,101,199,300,3.6409774436090228,39.91767200707339
Task_34297,2306,527,85,68,153,4.367424242424242,44.46451050876771
Task_34298,1825,312,55,122,177,5.830670926517572,36.809604629495425
Task_34299,1982,729,190,56,246,2.7150684931506848,40.49620815504892
Task_34300,2879,380,44,17,61,7.556430446194225,51.63876436623664
Task_34301,2103,690,193,179,372,3.0434153400868307,43.34448530712518
Task_34302,872,322,37,163,200,2.6996904024767803,21.9162699229234
Task_34303,651,723,97,168,265,0.899171270718232,19.923407954591344
Task_34304,1120,558,178,33,211,2.0035778175313057,25.91341717786612
Task_34305,1344,594,160,82,242,2.2588235294117647,30.222483527075095
Task_34306,1253,1024,60,65,125,1.2224390243902439,29.309202125237068
Task_34307,2798,504,63,133,196,5.54059405940594,52.96421276165313
Task_34308,1125,641,98,46,144,1.7523364485981308,25.82459675910869
Task_34309,1696,721,172,46,218,2.3490304709141276,35.59797393739363
Task_34310,2170,89,91,129,220,24.11111111111111,41.08497577753662
Task_34311,2136,432,126,104,230,4.933025404157044,42.29479803375925
Task_34312,2767,207,143,121,264,13.302884615384615,51.65861562520147
Task_34313,2361,1017,54,73,127,2.319253438113949,47.00185589774207
Task_34314,1305,711,155,111,266,1.8328651685393258,30.19220652390891
Task_34315,2417,168,143,141,284,14.301775147928995,45.89992378245031
Task_34316,1927,503,141,102,243,3.8234126984126986,39.270964829275
Task_34317,1889,650,104,65,169,2.901689708141321,38.440853086977114
Task_34318,2070,250,85,174,259,8.247011952191235,40.875288883947114
Task_34319,752,502,127,42,169,1.4950298210735586,19.689971465568824
Task_34320,861,314,109,162,271,2.7333333333333334,22.01130723418537
Task_34321,1067,1018,171,149,320,1.0471050049067714,27.612496145810223
Task_34322,543,152,173,191,364,3.549019607843137,16.73848181083457
Task_34323,2669,846,197,10,207,3.1511216056670603,51.237546631873734
Task_34324,2175,856,74,102,176,2.5379229871645275,44.0430580801879
Task_34325,2281,998,43,26,69,2.2832832832832834,44.285711052133884
Task_34326,1499,1009,190,117,307,1.4841584158415841,34.34241825584572
Task_34327,2449,742,42,80,122,3.2960969044414536,47.495157975366475
Task_34328,1478,99,160,189,349,14.78,30.93832640029841
Task_34329,2027,84,61,24,85,23.847058823529412,36.79749637471945
Task_34330,1787,519,148,135,283,3.4365384615384613,37.33413212420685
Task_34331,1023,255,124,113,237,3.99609375,24.154674873844815
Task_34332,2612,462,173,13,186,5.6414686825053995,49.00921588304666
Task_34333,1951,116,109,141,250,16.675213675213676,38.02432984945769
Task_34334,547,500,197,30,227,1.091816367265469,16.747745814859353
Task_34335,2480,227,186,150,336,10.87719298245614,47.57271994858087
Task_34336,2999,592,29,40,69,5.057335581787521,54.365394191226784
Task_34337,2630,204,181,50,231,12.829268292682928,48.80152068042157
Task_34338,1922,761,106,127,233,2.522309711286089,39.997174881138776
Task_34339,1428,1006,114,69,183,1.4180734856007944,32.277807330898334
Task_34340,502,688,27,126,153,0.7285921625544267,16.759308101307973
Task_34341,2934,77,28,120,148,37.61538461538461,52.17278758398651
Task_34342,2321,653,143,23,166,3.5489296636085625,44.9851534373376
Task_34343,2309,326,138,191,329,7.061162079510703,45.253287894654115
Task_34344,1876,274,13,188,201,6.821818181818182,37.623304754825114
Task_34345,1694,453,134,165,299,3.7312775330396475,35.7673651790586
Task_34346,2889,893,114,114,228,3.2315436241610738,55.689674320828125
Task_34347,2889,432,190,55,245,6.672055427251732,53.902927045103745
Task_34348,1635,197,12,65,77,8.257575757575758,31.882393200335414
Task_34349,2060,148,52,175,227,13.825503355704697,40.0251102572183
Task_34350,1704,110,117,11,128,15.35135135135135,32.644339310622726
Task_34351,2999,631,101,14,115,4.745253164556962,55.05826211516008
Task_34352,1486,164,10,50,60,9.006060606060606,29.029730382107036
Task_34353,2685,342,42,49,91,7.82798833819242,49.129021239812836
Task_34354,1377,816,160,127,287,1.6854345165238678,31.764244442423045
Task_34355,807,430,59,113,172,1.8723897911832947,21.044871865230466
Task_34356,1628,942,77,28,105,1.7264050901378578,34.28300902896226
Task_34357,1201,672,149,41,190,1.7845468053491829,27.463472884614475
Task_34358,1584,487,178,80,258,3.2459016393442623,33.72585372673888
Task_34359,2624,393,107,161,268,6.659898477157361,50.14352490608811
Task_34360,1534,373,200,182,382,4.101604278074866,33.37646311387895
Task_34361,1585,707,62,149,211,2.2387005649717513,34.490030179292276
Task_34362,2197,340,117,48,165,6.442815249266862,42.10677161738699
Task_34363,1078,415,186,43,229,2.5913461538461537,24.890986691131747
Task_34364,1564,165,180,199,379,9.421686746987952,32.953855975267786
Task_34365,872,576,88,92,180,1.511265164644714,22.35417864108939
Task_34366,1518,907,135,103,238,1.671806167400881,34.02494651956574
Task_34367,2662,774,191,89,280,3.4348387096774196,51.87479631040602
Task_34368,513,930,32,126,158,0.5510204081632653,17.79084263018009
Task_34369,1864,601,166,94,260,3.096345514950166,38.642706397200236
Task_34370,2849,669,182,61,243,4.2522388059701495,54.011400377738
Task_34371,1934,962,180,100,280,2.0083073727933543,40.986035881720625
Task_34372,2928,753,83,178,261,3.883289124668435,56.14570885009659
Task_34373,2217,583,149,93,242,3.796232876712329,44.08350813513095
Task_34374,1323,814,199,61,260,1.6233128834355828,30.372865556091046
Task_34375,927,204,96,60,156,4.521951219512195,21.589531358506758
Task_34376,1274,631,115,118,233,2.0158227848101267,29.31307341059293
Task_34377,1610,791,127,12,139,2.032828282828283,33.83753043267759
Task_34378,1784,846,182,18,200,2.106257378984652,37.188973387966435
Task_34379,1045,752,178,138,316,1.3877822045152723,26.412043377065313
Task_34380,1873,540,28,63,91,3.4621072088724585,37.142283860905074
Task_34381,2377,746,78,154,232,3.182061579651941,47.26023273393776
Task_34382,2124,985,116,44,160,2.154158215010142,42.79116211864328
Task_34383,966,751,138,36,174,1.2845744680851063,23.90278814666713
Task_34384,2100,279,124,108,232,7.5,41.227658757930165
Task_34385,2764,816,59,170,229,3.383108935128519,53.62415540839661
Task_34386,2855,820,184,113,297,3.4774665042630937,55.231483177447046
Task_34387,2868,675,124,14,138,4.242603550295858,53.379648380844856
Task_34388,2795,246,52,104,156,11.31578947368421,51.62222298496811
Task_34389,738,647,103,46,149,1.1388888888888888,19.77569450539146
Task_34390,2343,704,109,83,192,3.323404255319149,46.16432209456661
Task_34391,2981,617,41,184,225,4.823624595469256,56.37700356704729
Task_34392,900,737,107,161,268,1.2195121951219512,23.875268807119312
Task_34393,2495,666,193,109,302,3.7406296851574212,49.05979675169906
Task_34394,960,879,129,135,264,1.0909090909090908,25.210280484139727
Task_34395,1266,285,185,177,362,4.426573426573427,28.75201467266376
Task_34396,1230,657,33,109,142,1.8693009118541033,28.087663596026648
Task_34397,1060,475,191,30,221,2.226890756302521,24.746845427917147
Task_34398,1115,505,30,164,194,2.2035573122529644,26.295293665953125
Task_34399,1261,573,116,98,214,2.196864111498258,28.818201529838902
Task_34400,2444,354,11,26,37,6.884507042253521,44.56998625348248
Task_34401,1700,562,146,60,206,3.019538188277087,35.31217564893031
Task_34402,1377,442,139,188,327,3.108352144469526,30.87475781013275
Task_34403,2363,981,56,188,244,2.4063136456211813,47.8796718070551
Task_34404,1063,937,58,87,145,1.1332622601279319,26.34852880636932
Task_34405,1969,77,50,30,80,25.243589743589745,35.894724456861866
Task_34406,1671,215,180,112,292,7.736111111111111,34.49827182956826
Task_34407,599,947,107,45,152,0.6318565400843882,18.79856051417076
Task_34408,1163,876,67,61,128,1.3261117445838084,27.548814260448562
Task_34409,640,396,72,70,142,1.6120906801007557,17.773614997225494
Task_34410,2787,954,137,24,161,2.918324607329843,53.18129501509313
Task_34411,2656,953,12,12,24,2.7840670859538785,49.678466188157195
Task_34412,1049,909,88,92,180,1.1527472527472526,26.1503130113497
Task_34413,851,284,12,156,168,2.9859649122807017,21.202930651836034
Task_34414,2133,919,179,177,356,2.3184782608695653,44.46101168163447
Task_34415,1724,976,177,171,348,1.7645854657113613,38.09888018443372
Task_34416,2033,762,168,167,335,2.6644823066841417,42.277136336996385
Task_34417,1694,732,128,66,194,2.311050477489768,35.74975901491023
Task_34418,1495,343,30,196,226,4.34593023255814,31.982331093283694
Task_34419,2398,755,16,61,77,3.171957671957672,45.67267069590574
Task_34420,665,306,188,79,267,2.1661237785016287,18.644626971608933
Task_34421,1105,166,75,34,109,6.616766467065868,23.39992039956465
Task_34422,1265,459,61,80,141,2.75,28.052390561452597
Task_34423,738,824,67,130,197,0.8945454545454545,21.289009648964527
Task_34424,2001,517,143,112,255,3.862934362934363,40.555987581701594
Task_34425,1748,542,113,15,128,3.2191528545119708,35.30664266604317
Task_34426,1835,715,157,145,302,2.5628491620111733,38.812379251496004
Task_34427,1705,1007,92,11,103,1.691468253968254,35.672739068933886
Task_34428,2764,613,169,98,267,4.501628664495114,52.98555266922489
Task_34429,2789,998,94,200,294,2.7917917917917916,54.86707416793838
Task_34430,1676,170,106,34,140,9.801169590643275,32.73600620730255
Task_34431,2554,895,38,63,101,2.8504464285714284,49.18292164684329
Task_34432,1996,178,196,183,379,11.150837988826815,39.73811602580435
Task_34433,1717,768,80,170,250,2.2327698309492847,36.964349439238546
Task_34434,2772,297,38,44,82,9.302013422818792,50.15774150637716
Task_34435,1950,858,74,125,199,2.270081490104773,40.6480122477614
Task_34436,550,661,166,125,291,0.8308157099697885,18.180887285553677
Task_34437,1638,558,166,85,251,2.9302325581395348,34.80394901890103
Task_34438,2940,505,164,100,264,5.810276679841897,55.406538343529405
Task_34439,838,124,60,51,111,6.704,18.90864161387695
Task_34440,2004,916,140,71,211,2.1853871319520173,41.35653075464733
Task_34441,685,937,43,47,90,0.7302771855010661,19.60159987386664
Task_34442,692,267,172,90,262,2.582089552238806,19.010490427913542
Task_34443,2382,214,181,61,242,11.07906976744186,45.09217098519497
Task_34444,1374,313,111,42,153,4.375796178343949,28.734800463455766
Task_34445,1462,1015,31,113,144,1.438976377952756,32.83517869271261
Task_34446,2180,1014,122,152,274,2.147783251231527,45.09518874244677
Task_34447,1952,430,178,22,200,4.529002320185615,38.55156105968251
Task_34448,1699,984,145,108,253,1.7248730964467005,37.20701665738962
Task_34449,2186,532,38,190,228,4.101313320825516,43.53550465976679
Task_34450,884,106,184,15,199,8.261682242990654,20.11764109891533
Task_34451,2019,158,64,116,180,12.69811320754717,39.048817610462066
Task_34452,2346,1011,169,53,222,2.3181818181818183,47.08510337338686
Task_34453,2423,901,14,185,199,2.686252771618625,48.28778759512045
Task_34454,2078,521,194,121,315,3.9808429118773945,42.07148345191458
Task_34455,2909,802,124,170,294,3.62266500622665,56.100464008611596
Task_34456,1653,732,186,169,355,2.2551159618008185,36.25653828250129
Task_34457,2601,999,185,22,207,2.601,50.65832691804701
Task_34458,2719,636,153,45,198,4.268445839874412,51.42360232714063
Task_34459,1785,786,136,152,288,2.2681067344345616,38.18939935524116
Task_34460,2745,1004,47,37,84,2.7313432835820897,52.043800905874974
Task_34461,2688,411,106,193,299,6.524271844660194,51.402863336209386
Task_34462,1333,969,190,150,340,1.3742268041237113,31.77386465947617
Task_34463,819,644,124,114,238,1.2697674418604652,22.102761820496124
Task_34464,2603,813,195,128,323,3.197788697788698,51.35611213825257
Task_34465,1698,235,53,95,148,7.194915254237288,34.26997979071947
Task_34466,1009,216,143,153,296,4.649769585253456,24.126915193867614
Task_34467,1902,767,23,130,153,2.4765625,39.10576885533427
Task_34468,776,783,121,117,238,0.9897959183673469,21.891425198437915
Task_34469,967,719,104,181,285,1.3430555555555554,25.00428755540455
Task_34470,2566,570,180,97,277,4.493870402802101,49.77707309757495
Task_34471,1360,866,136,199,335,1.5686274509803921,31.942777543098902
Task_34472,2791,261,120,10,130,10.65267175572519,50.77746954589612
Task_34473,2795,673,59,107,166,4.146884272997033,53.253271388078595
Task_34474,1065,972,28,168,196,1.094552929085303,26.849139323492107
Task_34475,2041,601,138,165,303,3.3903654485049834,41.75030709272199
Task_34476,2128,266,130,68,198,7.9700374531835205,41.136243645190774
Task_34477,2436,702,57,113,170,3.465149359886202,47.668151256035266
Task_34478,2653,285,164,70,234,9.276223776223777,49.66584093425373
Task_34479,1226,146,45,98,143,8.34013605442177,25.905179666122123
Task_34480,865,363,55,78,133,2.3763736263736264,21.408018731095137
Task_34481,2541,304,130,134,264,8.331147540983606,48.469280621920994
Task_34482,2454,240,125,105,230,10.182572614107883,46.66749049459427
Task_34483,1718,675,163,175,338,2.5414201183431953,37.039986301618754
Task_34484,2831,475,170,109,279,5.947478991596639,53.66387205638845
Task_34485,504,879,151,182,333,0.5727272727272728,18.51583687004211
Task_34486,504,466,104,183,287,1.0792291220556745,16.877056162909266
Task_34487,2098,299,187,75,262,6.993333333333333,41.17575708703173
Task_34488,1854,606,16,155,171,3.054365733113674,38.11305969954625
Task_34489,2842,979,132,100,232,2.9,55.21133699304945
Task_34490,1422,527,182,12,194,2.6931818181818183,30.42715629772201
Task_34491,954,347,42,169,211,2.7413793103448274,23.344403102714963
Task_34492,1468,330,95,95,190,4.435045317220544,31.218657864468998
Task_34493,2020,426,78,166,244,4.730679156908665,40.66037760550207
Task_34494,2301,730,18,139,157,3.1477428180574556,45.37644818395062
Task_34495,1117,100,51,11,62,11.05940594059406,22.444386546499327
Task_34496,1192,256,184,81,265,4.638132295719845,26.80360846272042
Task_34497,2414,382,33,34,67,6.302872062663186,44.41622016235913
Task_34498,2046,354,24,193,217,5.763380281690141,40.67351841326728
Task_34499,1182,301,181,176,357,3.9139072847682117,27.452819205011874
Task_34500,671,595,27,134,161,1.1258389261744965,19.08977939079691
Task_34501,786,768,139,142,281,1.0221066319895968,22.192868059672865
Task_34502,1641,363,87,65,152,4.508241758241758,33.344590636259454
Task_34503,2855,344,38,102,140,8.27536231884058,52.78243070861392
Task_34504,1844,516,14,123,137,3.5667311411992264,37.32405897873456
Task_34505,2951,659,99,32,131,4.471212121212122,54.74802233996292
Task_34506,1033,956,16,17,33,1.0794148380355277,24.09141474314596
Task_34507,1406,350,37,85,122,4.005698005698005,29.76880976224042
Task_34508,2942,764,193,13,206,3.845751633986928,55.304851914714135
Task_34509,2021,164,141,66,207,12.248484848484848,38.90769401413967
Task_34510,2157,668,60,113,173,3.2242152466367715,43.17424243673229
Task_34511,2785,404,100,28,128,6.8765432098765435,51.36473195713498
Task_34512,1944,173,61,177,238,11.172413793103448,38.32116345851467
Task_34513,2438,443,86,140,226,5.490990990990991,47.105413528762995
Task_34514,1260,1017,10,137,147,1.237721021611002,29.66039204052093
Task_34515,2128,859,51,112,163,2.474418604651163,43.26840945379501
Task_34516,800,580,151,160,311,1.3769363166953528,22.006574811474007
Task_34517,2643,582,41,114,155,4.5334476843910805,50.31096611233311
Task_34518,2567,955,14,157,171,2.685146443514644,50.51628375778123
Task_34519,2276,1013,191,174,365,2.244575936883629,47.05580832700369
Task_34520,559,757,83,173,256,0.737467018469657,18.563113405183337
Task_34521,586,544,89,165,254,1.075229357798165,18.17987716374402
Task_34522,1455,156,110,122,232,9.26751592356688,30.432911148063983
Task_34523,2005,805,45,44,89,2.4875930521091814,39.69734276041308
Task_34524,1235,213,116,132,248,5.771028037383178,27.43789864356576
Task_34525,2472,606,39,95,134,4.072487644151565,47.60535834356654
Task_34526,1646,220,128,131,259,7.447963800904978,34.000735313030226
Task_34527,2567,508,194,126,320,5.043222003929273,49.8015366083138
Task_34528,1478,810,26,166,192,1.8224414303329224,32.97384886338806
Task_34529,1394,567,118,89,207,2.454225352112676,30.810609768919345
Task_34530,2110,494,89,76,165,4.262626262626263,41.57875228655296
Task_34531,2285,792,143,115,258,2.8814627994955866,45.94013084105915
Task_34532,1977,267,110,41,151,7.376865671641791,38.1291496314763
Task_34533,1289,353,160,185,345,3.6412429378531073,29.273459646213052
Task_34534,674,783,171,188,359,0.8596938775510204,20.922168925709414
Task_34535,2762,565,189,103,292,4.879858657243816,52.91273546405504
Task_34536,2580,988,142,108,250,2.608695652173913,51.180410397348396
Task_34537,2844,862,16,177,193,3.295480880648899,54.7867147483162
Task_34538,2560,90,135,160,295,28.13186813186813,47.59816349976476
Task_34539,1481,393,73,36,109,3.7588832487309647,30.304830665785776
Task_34540,2093,379,108,80,188,5.507894736842105,41.09553523533264
Task_34541,1784,447,30,48,78,3.982142857142857,34.8818487721442
Task_34542,796,327,152,132,284,2.426829268292683,21.039648352273243
Task_34543,1822,747,44,59,103,2.435828877005348,36.96963543330068
Task_34544,767,427,106,181,287,1.7920560747663552,20.98251574949416
Task_34545,1215,482,173,67,240,2.515527950310559,27.59316105088838
Task_34546,1770,483,36,46,82,3.65702479338843,34.960381819652746
Task_34547,2802,253,58,130,188,11.031496062992126,52.11799093709726
Task_34548,1881,497,111,155,266,3.7771084337349397,38.70490889761056
Task_34549,878,713,21,130,151,1.2296918767507004,22.65567623865859
Task_34550,2843,893,36,171,207,3.180089485458613,54.964294698788564
Task_34551,2055,87,97,61,158,23.352272727272727,38.200814337396444
Task_34552,2477,462,131,65,196,5.3498920086393085,47.31756331958115
Task_34553,2551,193,11,188,199,13.149484536082474,47.93803174802273
Task_34554,2802,602,161,158,319,4.646766169154229,53.86702254991068
Task_34555,1842,644,29,90,119,2.855813953488372,37.53792658149797
Task_34556,2110,256,23,142,165,8.210116731517509,41.013618922779514
Task_34557,1931,777,126,196,322,2.482005141388175,40.692057275943725
Task_34558,2076,671,23,87,110,3.0892857142857144,41.24869327413129
Task_34559,1629,672,150,175,325,2.4205052005943535,35.56228515166564
Task_34560,2236,889,35,58,93,2.512359550561798,43.89504778671314
Task_34561,1224,115,136,176,312,10.551724137931034,26.91113151845342
Task_34562,975,829,124,36,160,1.1746987951807228,24.116046970844582
Task_34563,2020,772,198,26,224,2.6131953428201813,40.867985377743715
Task_34564,2534,556,133,124,257,4.549371633752244,49.14658438567551
Task_34565,2814,74,34,53,87,37.52,49.35386823190316
Task_34566,2893,404,91,144,235,7.14320987654321,54.262522498131084
Task_34567,1070,325,126,69,195,3.2822085889570554,24.586669002567408
Task_34568,1803,648,100,29,129,2.778120184899846,36.53302389240855
Task_34569,656,436,81,113,194,1.5011441647597255,18.744277741645735
Task_34570,723,910,58,147,205,0.7936333699231614,21.395857870097498
Task_34571,2774,206,86,121,207,13.400966183574878,51.46840188078682
Task_34572,2267,781,49,185,234,2.898976982097187,45.71099881195531
Task_34573,2377,495,10,28,38,4.792338709677419,43.984429459683014
Task_34574,952,209,120,19,139,4.533333333333333,21.591112774301337
Task_34575,1264,202,158,137,295,6.226600985221675,28.076078103429563
Task_34576,2372,716,35,42,77,3.308228730822873,44.929225102324686
Task_34577,1144,866,97,23,120,1.3194925028835063,26.467224189363634
Task_34578,1139,321,176,51,227,3.5372670807453415,25.75504886380848
Task_34579,501,576,187,46,233,0.8682842287694974,16.332415179858277
Task_34580,1949,355,159,20,179,5.474719101123595,38.15021734241936
Task_34581,2793,873,38,49,87,3.1956521739130435,52.48959446672021
Task_34582,2771,933,74,10,84,2.9668094218415417,52.184222655328064
Task_34583,2986,853,159,86,245,3.496487119437939,57.0704236617154
Task_34584,2325,571,79,172,251,4.064685314685315,45.988363834471606
Task_34585,2333,608,44,51,95,3.8308702791461413,44.55888231912005
Task_34586,2712,180,54,89,143,14.98342541436464,49.60526133681555
Task_34587,2280,148,18,61,79,15.302013422818792,41.697916385667575
Task_34588,2725,910,177,77,254,2.991218441273326,53.041005705798675
Task_34589,2763,565,155,36,191,4.881625441696113,51.861795278086966
Task_34590,2720,513,129,52,181,5.291828793774319,51.22417678529235
Task_34591,2896,435,121,86,207,6.6422018348623855,54.13644655462806
Task_34592,578,777,183,104,287,0.7429305912596401,18.906760746178776
Task_34593,2818,794,141,54,195,3.5446540880503146,53.72168638634977
Task_34594,2750,456,39,65,104,6.017505470459518,50.958838608830405
Task_34595,2298,745,198,173,371,3.0804289544235925,46.59298952384298
Task_34596,2062,506,14,109,123,4.067061143984221,40.6477762221404
Task_34597,1624,1008,102,98,200,1.6095143706640238,35.846923840868904
Task_34598,2509,103,142,27,169,24.125,45.56410046085481
Task_34599,1078,983,102,132,234,1.0955284552845528,27.262250266129783
Task_34600,2982,413,130,96,226,7.202898550724638,55.61908486133339
Task_34601,1853,243,25,143,168,7.594262295081967,36.901312615667806
Task_34602,2008,911,87,151,238,2.2017543859649122,41.84572154769742
Task_34603,1089,117,145,162,307,9.228813559322035,24.780472155126862
Task_34604,1357,157,48,142,190,8.58860759493671,28.742917461087973
Task_34605,1826,683,98,146,244,2.6695906432748537,38.313816308246196
Task_34606,568,774,48,147,195,0.7329032258064516,18.50722280697781
Task_34607,2556,766,73,90,163,3.332464146023468,49.70977694028931
Task_34608,1777,410,48,152,200,4.32360097323601,36.53699798595368
Task_34609,720,458,15,188,203,1.5686274509803921,19.91197025916276
Task_34610,2494,601,98,184,282,4.142857142857143,48.86173941057948
Task_34611,2477,559,170,140,310,4.423214285714286,48.515947866761735
Task_34612,2889,694,14,174,188,4.1568345323741,54.94084246163799
Task_34613,2280,697,53,182,235,3.2664756446991405,45.62918733717451
Task_34614,1411,583,107,132,239,2.416095890410959,31.379915267110828
Task_34615,2818,992,138,105,243,2.837865055387714,54.928496605643794
Task_34616,633,299,65,73,138,2.11,17.381357813592075
Task_34617,1202,688,103,99,202,1.74455732946299,28.163557885763193
Task_34618,1469,87,92,106,198,16.693181818181817,29.949402618813593
Task_34619,805,624,191,92,283,1.288,21.93765922425202
Task_34620,1050,842,190,170,360,1.2455516014234875,27.00503840418281
Task_34621,2596,95,80,90,170,27.041666666666668,47.38722929258061
Task_34622,2404,266,37,143,180,9.00374531835206,45.80493522128501
Task_34623,2355,104,11,112,123,22.428571428571427,43.0643536227679
Task_34624,2754,956,34,103,137,2.877742946708464,53.12629122327525
Task_34625,1192,473,160,132,292,2.5147679324894514,27.80499144218055
Task_34626,1650,667,29,104,133,2.470059880239521,34.76208532646813
Task_34627,900,367,63,35,98,2.4456521739130435,20.79985964092622
Task_34628,2942,149,25,150,175,19.613333333333333,53.463636310315074
Task_34629,696,829,126,37,163,0.8385542168674699,19.887202055210338
Task_34630,507,1015,65,115,180,0.49901574803149606,18.169500503286176
Task_34631,2693,176,81,64,145,15.214689265536723,49.17432369065756
Task_34632,2026,190,100,11,111,10.607329842931938,38.28554889591219
Task_34633,2448,306,116,45,161,7.973941368078176,45.76957608462923
Task_34634,2578,651,168,39,207,3.9539877300613497,49.28498700087355
Task_34635,805,141,15,85,100,5.669014084507042,18.814566822411887
Task_34636,733,829,28,191,219,0.8831325301204819,21.31052210764295
Task_34637,1310,852,118,165,283,1.5357561547479484,30.822892387454484
Task_34638,1428,904,93,28,121,1.5779005524861878,31.25233361781989
Task_34639,1435,313,96,24,120,4.570063694267516,29.328856243605667
Task_34640,2270,406,96,31,127,5.577395577395578,43.110237076733796
Task_34641,2940,604,80,21,101,4.859504132231405,53.93878594427542
Task_34642,712,886,84,169,253,0.8027057497181511,21.329854753972942
Task_34643,2246,971,60,159,219,2.3106995884773665,45.83907223584587
Task_34644,891,955,151,45,196,0.9320083682008368,23.552858055064103
Task_34645,2839,718,91,112,203,3.9485396383866482,54.23078268085799
Task_34646,1242,537,146,128,274,2.308550185873606,28.711213809899508
Task_34647,1303,395,78,163,241,3.29040404040404,29.196189030348084
Task_34648,2020,83,116,168,284,24.047619047619047,39.02830958331053
Task_34649,1365,500,177,63,240,2.7245508982035926,30.010989847332553
Task_34650,690,545,122,61,183,1.2637362637362637,19.122140697490618
Task_34651,1381,454,152,191,343,3.035164835164835,31.052777164832975
Task_34652,2678,394,93,92,185,6.779746835443038,50.48368142118428
Task_34653,2606,328,166,65,231,7.920972644376899,49.06901966758746
Task_34654,2942,926,125,163,288,3.173678532901834,56.975054644000636
Task_34655,686,890,107,197,304,0.7699214365881033,21.23812620389283
Task_34656,2408,541,118,108,226,4.442804428044281,46.94024798461276
Task_34657,1266,337,79,160,239,3.7455621301775146,28.40338541554908
Task_34658,2786,560,67,146,213,4.966131907308378,53.05817097214571
Task_34659,2277,751,200,194,394,3.0279255319148937,46.41359695160452
Task_34660,993,705,116,100,216,1.406515580736544,24.93592808633223
Task_34661,2995,969,134,35,169,3.0876288659793816,56.6749736599767
Task_34662,2926,839,76,88,164,3.4833333333333334,55.801681317432525
Task_34663,696,263,101,77,178,2.6363636363636362,18.501499141729607
Task_34664,574,519,195,123,318,1.103846153846154,18.205681473078823
Task_34665,2293,138,32,42,74,16.496402877697843,41.60460106545897
Task_34666,1559,903,43,50,93,1.7245575221238938,33.10021252154941
Task_34667,652,474,21,13,34,1.3726315789473684,16.501386686758305
Task_34668,1027,112,186,69,255,9.08849557522124,22.965272440516088
Task_34669,944,216,171,199,370,4.350230414746544,23.501505372363393
Task_34670,2438,995,192,189,381,2.4477911646586343,49.66112164876389
Task_34671,1215,885,127,124,251,1.3713318284424378,29.211535355322507
Task_34672,1181,1024,76,173,249,1.1521951219512194,29.199748222075243
Task_34673,1079,557,106,180,286,1.9336917562724014,26.323304096529053
Task_34674,705,270,16,119,135,2.6014760147601477,18.50116549825324
Task_34675,2874,790,161,153,314,3.6333754740834387,55.57341420425437
Task_34676,2234,424,199,171,370,5.2564705882352944,44.54885828519131
Task_34677,842,403,94,199,293,2.0841584158415842,22.15754201680092
Task_34678,1433,629,14,99,113,2.2746031746031745,31.008129325139333
Task_34679,957,637,134,178,312,1.5,24.712440157614058
Task_34680,967,723,23,146,169,1.3356353591160222,24.372296033778998
Task_34681,1764,113,142,189,331,15.473684210526315,35.48981590247989
Task_34682,1583,84,126,54,180,18.623529411764707,31.091857860673226
Task_34683,2706,74,54,158,212,36.08,49.42757107955496
Task_34684,1600,656,50,17,67,2.43531202435312,32.247153727065616
Task_34685,791,242,148,112,260,3.2551440329218106,20.54839362752057
Task_34686,2405,1013,56,81,137,2.371794871794872,47.8183097572059
Task_34687,1539,863,176,170,346,1.78125,34.80600092383826
Task_34688,1379,792,37,36,73,1.7389659520807061,29.36219352936799
Task_34689,1123,1002,191,100,291,1.119641076769691,28.229609240545983
Task_34690,2940,704,36,62,98,4.170212765957447,54.559083011435284
Task_34691,807,852,162,71,233,0.9460726846424384,22.344986214981642
Task_34692,1261,244,180,83,263,5.146938775510204,27.879360519142548
Task_34693,2250,281,187,177,364,7.9787234042553195,44.30176797965313
Task_34694,1640,64,87,173,260,25.23076923076923,32.91316029400466
Task_34695,539,704,138,72,210,0.7645390070921986,17.537804302628132
Task_34696,1774,743,29,69,98,2.3844086021505375,36.289241673068894
Task_34697,860,783,81,133,214,1.096938775510204,23.10726106493858
Task_34698,1823,344,187,101,288,5.284057971014493,37.3105974798438
Task_34699,1999,650,155,93,248,3.0706605222734256,40.869944029946474
Task_34700,2914,867,46,137,183,3.357142857142857,55.831161313208725
Task_34701,555,414,156,136,292,1.3373493975903614,17.496492047225466
Task_34702,2913,853,69,154,223,3.411007025761124,56.05308235266046
Task_34703,1070,1012,184,14,198,1.0562685093780848,26.354454048526748
Task_34704,673,933,24,37,61,0.7205567451820128,18.902714966914978
Task_34705,1981,955,64,191,255,2.0721757322175733,41.8000396603994
Task_34706,702,301,148,42,190,2.3245033112582782,18.399928225930296
Task_34707,2761,685,92,30,122,4.024781341107872,51.67740348773455
Task_34708,1547,248,135,174,309,6.21285140562249,32.82426626235026
Task_34709,1329,513,64,59,123,2.585603112840467,28.664509467291225
Task_34710,1129,200,133,196,329,5.616915422885572,26.177780485804146
Task_34711,2855,188,165,179,344,15.105820105820106,53.445351188512255
Task_34712,2602,795,10,13,23,3.2688442211055277,48.31712982249967
Task_34713,1345,414,110,51,161,3.2409638554216866,28.91018491961618
Task_34714,752,343,193,45,238,2.186046511627907,19.533496341360713
Task_34715,1508,280,150,54,204,5.366548042704626,31.372560569519653
Task_34716,992,998,145,152,297,0.992992992992993,26.29617524722823
Task_34717,2758,686,124,69,193,4.014556040756914,52.452715495375365
Task_34718,917,401,58,131,189,2.281094527363184,22.826014500845165
Task_34719,2308,193,188,25,213,11.896907216494846,43.48949246199687
Task_34720,2974,930,135,106,241,3.1944146079484423,57.19925026211615
Task_34721,2808,612,24,63,87,4.580750407830343,52.13274657819897
Task_34722,1352,459,122,15,137,2.9391304347826086,28.680578519267105
Task_34723,1603,197,172,93,265,8.095959595959595,33.23167506747391
Task_34724,1295,182,120,93,213,7.076502732240437,27.982400048228655
Task_34725,1248,491,137,133,270,2.5365853658536586,28.65063141846196
Task_34726,2634,836,198,183,381,3.1469534050179213,52.26142771311362
Task_34727,1612,316,37,17,54,5.085173501577287,31.390860276548512
Task_34728,1060,381,30,155,185,2.774869109947644,24.94901641550732
Task_34729,517,662,35,66,101,0.779788838612368,16.20176903423979
Task_34730,768,244,16,68,84,3.1346938775510202,18.660878981831935
Task_34731,2129,405,44,122,166,5.24384236453202,41.81589878299272
Task_34732,2894,224,120,157,277,12.862222222222222,53.843772324838234
Task_34733,2972,347,20,180,200,8.540229885057471,55.19918552981813
Task_34734,846,107,154,111,265,7.833333333333333,20.591219889688826
Task_34735,1814,211,143,57,200,8.556603773584905,35.93371108455059
Task_34736,1020,387,82,62,144,2.6288659793814433,23.677778205314734
Task_34737,1829,953,19,82,101,1.9171907756813418,38.05716557662444
Task_34738,521,588,49,21,70,0.8845500848896435,15.228295485663928
Task_34739,1415,943,11,67,78,1.4989406779661016,30.815829545237026
Task_34740,2615,695,161,133,294,3.757183908045977,51.05138138923585
Task_34741,1278,608,184,69,253,2.0985221674876846,29.038486237184035
Task_34742,2731,1008,21,175,196,2.7066402378592667,53.47219778472581
Task_34743,2403,400,109,54,163,5.992518703241895,45.74061175961955
Task_34744,988,809,117,174,291,1.219753086419753,25.615339397786556
Task_34745,2346,233,154,190,344,10.025641025641026,45.573660845371684
Task_34746,957,174,170,125,295,5.468571428571429,22.890915263968676
Task_34747,824,688,167,17,184,1.1959361393323658,21.384394931755406
Task_34748,1499,817,162,93,255,1.832518337408313,33.50319873050755
Task_34749,2497,548,37,95,132,4.548269581056466,47.87327838990124
Task_34750,1420,675,98,80,178,2.100591715976331,31.343033369962203
Task_34751,2418,414,158,71,229,5.8265060240963855,46.40365029454671
Task_34752,2747,1010,143,192,335,2.7171117705242334,54.40168208579271
Task_34753,590,498,79,43,122,1.182364729458918,16.67616567006172
Task_34754,2998,145,199,51,250,20.534246575342465,54.248247241586874
Task_34755,1272,984,120,39,159,1.2913705583756345,29.2929682367086
Task_34756,1928,731,22,20,42,2.633879781420765,37.59893260685638
Task_34757,2609,183,131,30,161,14.179347826086957,47.89082590073033
Task_34758,1793,217,26,163,189,8.224770642201834,36.02508435636184
Task_34759,537,483,147,146,293,1.109504132231405,17.414479790768727
Task_34760,1939,72,131,28,159,26.561643835616437,35.95971512468022
Task_34761,2320,766,144,141,285,3.0247718383311604,46.57291442648468
Task_34762,1095,385,156,18,174,2.8367875647668392,24.702206480132574
Task_34763,2525,439,143,35,178,5.738636363636363,47.619906349667936
Task_34764,1568,135,46,195,241,11.529411764705882,32.180137576333024
Task_34765,2298,831,98,64,162,2.762019230769231,45.4087062407557
Task_34766,1208,920,121,57,178,1.3116178067318132,28.488308454342345
Task_34767,1683,277,160,149,309,6.053956834532374,35.03664512744459
Task_34768,1378,303,100,128,228,4.532894736842105,29.90655302801888
Task_34769,1939,371,167,177,344,5.212365591397849,39.598648555229786
Task_34770,2362,546,53,41,94,4.318098720292505,44.53379593721754
Task_34771,2747,520,78,173,251,5.272552783109405,52.514983006609526
Task_34772,1641,287,113,45,158,5.697916666666667,32.90961804417293
Task_34773,2893,72,51,125,176,39.63013698630137,52.0810859693616
Task_34774,2677,338,132,105,237,7.896755162241888,50.57381985162086
Task_34775,2628,505,22,170,192,5.1936758893280635,50.226874183752436
Task_34776,2399,892,193,88,281,2.686450167973124,48.06405771104062
Task_34777,1077,255,172,163,335,4.20703125,25.522930920099594
Task_34778,1912,434,10,36,46,4.395402298850574,36.547937629882334
Task_34779,779,389,70,26,96,1.9974358974358974,19.10561609790906
Task_34780,2008,908,136,25,161,2.209020902090209,40.70344096691063
Task_34781,674,79,98,151,249,8.425,17.737582866532687
Task_34782,2969,846,108,120,228,3.5053128689492326,56.81863574896462
Task_34783,1608,542,61,195,256,2.9613259668508287,34.60629934032749
Task_34784,1785,620,53,162,215,2.8743961352657004,37.427020488856485
Task_34785,1771,127,123,192,315,13.8359375,35.67785248498226
Task_34786,1869,658,90,48,138,2.836115326251897,37.678644546938855
Task_34787,1207,828,48,193,241,1.4559710494571774,29.021271012679872
Task_34788,557,720,124,56,180,0.7725381414701803,17.625557457286828
Task_34789,2064,90,79,36,115,22.681318681318682,37.82826745079336
Task_34790,677,257,193,195,388,2.624031007751938,19.494679794556625
Task_34791,1935,633,61,88,149,3.05205047318612,39.29566791366706
Task_34792,1768,282,53,13,66,6.247349823321555,33.652801613241806
Task_34793,1776,290,25,27,52,6.103092783505154,33.97935008168965
Task_34794,1596,493,166,130,296,3.230769230769231,34.27888346551731
Task_34795,2151,506,64,167,231,4.242603550295858,42.93831774919361
Task_34796,1931,902,100,93,193,2.1384274640088594,40.3311072208365
Task_34797,2201,390,195,158,353,5.629156010230179,43.81927748048272
Task_34798,1708,922,174,84,258,1.8504875406283856,37.083306857479776
Task_34799,2109,172,132,20,152,12.190751445086706,39.55746284927537
Task_34800,583,379,111,102,213,1.5342105263157895,17.42815497534234
Task_34801,2027,286,172,185,357,7.062717770034843,40.77434675030391
Task_34802,1584,343,14,169,183,4.604651162790698,33.10289765320088
Task_34803,829,312,14,84,98,2.648562300319489,20.103779802779503
Task_34804,542,962,48,30,78,0.5628245067497404,16.81854059260287
Task_34805,1881,418,134,126,260,4.4892601431980905,38.381183684823476
Task_34806,2221,478,153,26,179,4.6367432150313155,42.90669062220966
Task_34807,2448,185,12,36,48,13.161290322580646,44.29665316252528
Task_34808,1093,614,43,189,232,1.7772357723577237,26.496189359399498
Task_34809,1201,467,140,76,216,2.5662393162393164,27.332223098089703
Task_34810,1057,182,156,37,193,5.775956284153006,23.628568720906667
Task_34811,1868,414,57,187,244,4.501204819277109,38.246232919648094
Task_34812,2934,780,111,145,256,3.7567221510883484,56.219347113572475
Task_34813,2900,314,99,59,158,9.206349206349206,53.15739097325039
Task_34814,1506,913,48,85,133,1.6477024070021882,33.30484217824615
Task_34815,709,822,163,12,175,0.8614823815309842,20.047796448198216
Task_34816,2487,1006,193,142,335,2.4697120158887786,50.1956598279855
Task_34817,2435,848,77,185,262,2.868080094228504,48.67956609124612
Task_34818,1760,834,88,90,178,2.1077844311377247,37.26937911941699
Task_34819,871,678,185,50,235,1.2827687776141385,22.562558696630038
Task_34820,1934,306,78,192,270,6.299674267100977,39.05772113322863
Task_34821,1742,975,135,185,320,1.7848360655737705,38.28876673167915
Task_34822,2310,666,151,115,266,3.4632683658170915,45.97609179803779
Task_34823,1722,866,145,41,186,1.986159169550173,36.292699098527436
Task_34824,2537,165,114,158,272,15.283132530120483,47.75368956621414
Task_34825,2146,1017,35,62,97,2.1080550098231825,42.950571536487836
Task_34826,2931,810,151,192,343,3.6140567200986435,56.727280034860655
Task_34827,727,650,156,191,347,1.1167434715821813,21.251236963398302
Task_34828,2642,411,17,152,169,6.412621359223301,49.94257556196299
Task_34829,1682,80,150,11,161,20.765432098765434,31.950163896291382
Task_34830,1088,888,26,58,84,1.2238470191226096,25.66855117840697
Task_34831,1017,90,185,63,248,11.175824175824175,22.59025016440265
Task_34832,2920,255,12,105,117,11.40625,53.28217997887099
Task_34833,1001,384,48,118,166,2.6,23.93706106361672
Task_34834,2482,618,159,60,219,4.009693053311794,47.932090176198024
Task_34835,701,336,164,20,184,2.080118694362018,18.36289959687353
Task_34836,2718,424,178,178,356,6.395294117647059,52.15567216058304
Task_34837,736,499,117,113,230,1.472,20.30681894173095
Task_34838,719,598,58,106,164,1.2003338898163607,20.046995262681882
Task_34839,2467,919,38,51,89,2.6815217391304347,47.62537629417279
Task_34840,2612,738,162,163,325,3.534506089309878,51.32323869616588
Task_34841,2015,65,106,15,121,30.53030303030303,36.60036163153982
Task_34842,1843,931,61,112,173,1.9774678111587982,39.018081300487914
Task_34843,739,545,23,71,94,1.3534798534798536,19.28490768487818
Task_34844,2001,244,96,121,217,8.16734693877551,39.49824142454778
Task_34845,518,791,196,188,384,0.6540404040404041,18.7083856396994
Task_34846,644,618,128,93,221,1.0403877221324718,19.127762818027712
Task_34847,2426,816,86,122,208,2.9694002447980417,47.99438489203617
Task_34848,1851,676,184,189,373,2.7341211225997046,39.32804637181052
Task_34849,755,883,82,78,160,0.8540723981900452,21.267156853585522
Task_34850,2040,483,192,146,338,4.214876033057851,41.488456882038115
Task_34851,1067,394,117,145,262,2.7012658227848103,25.460094016714862
Task_34852,1433,426,97,66,163,3.3559718969555035,30.519815742609424
Task_34853,950,169,99,174,273,5.588235294117647,22.763940539194607
Task_34854,1951,402,74,53,127,4.841191066997519,38.35685512973314
Task_34855,2881,201,121,95,216,14.262376237623762,53.19243899086279
Task_34856,1652,484,10,74,84,3.406185567010309,33.460548112679426
Task_34857,2708,878,22,84,106,3.080773606370876,51.818266936489685
Task_34858,912,368,172,22,194,2.4715447154471546,21.868952356656205
Task_34859,2022,365,15,58,73,5.524590163934426,38.42636123448501
Task_34860,1310,314,183,70,253,4.158730158730159,28.61753225343544
Task_34861,873,234,174,66,240,3.7148936170212767,21.382045730187812
Task_34862,2402,767,60,77,137,3.1276041666666665,46.92133623861063
Task_34863,1088,673,113,129,242,1.6142433234421365,26.541350937622138
Task_34864,1411,292,26,108,134,4.815699658703072,29.728146554442443
Task_34865,2741,887,58,184,242,3.0867117117117115,53.56133990214775
Task_34866,1572,706,137,183,320,2.2234794908062234,34.75496580452948
Task_34867,1634,701,20,15,35,2.3276353276353277,32.74850762474975
Task_34868,1340,245,10,49,59,5.4471544715447155,27.051720668748107
Task_34869,2021,574,16,158,174,3.514782608695652,40.70682544588576
Task_34870,1412,309,67,152,219,4.554838709677419,30.533101458935814
Task_34871,743,979,17,20,37,0.7581632653061224,19.73535347551378
Task_34872,2046,958,190,126,316,2.133472367049009,42.94876173998301
Task_34873,1726,507,183,108,291,3.3976377952755907,36.32668756019818
Task_34874,2014,710,170,175,345,2.832630098452883,41.869971567069996
Task_34875,967,445,43,168,211,2.1681614349775784,23.859570782999537
Task_34876,2522,412,14,64,78,6.106537530266344,46.69648660825552
Task_34877,1386,738,119,60,179,1.8755074424898512,30.74858721912346
Task_34878,2446,395,173,168,341,6.1767676767676765,47.672986142066634
Task_34879,2118,911,94,137,231,2.3223684210526314,43.58668530186218
Task_34880,2241,829,60,140,200,2.7,45.203431125981275
Task_34881,2763,148,55,28,83,18.543624161073826,49.21014466516414
Task_34882,941,314,114,99,213,2.9873015873015873,22.91659968986355
Task_34883,2235,898,98,84,182,2.486095661846496,44.98430583587734
Task_34884,839,693,140,98,238,1.2089337175792507,22.557209127142272
Task_34885,1949,875,112,66,178,2.2248858447488584,40.13857683627717
Task_34886,2881,753,77,28,105,3.820954907161804,53.56252249527409
Task_34887,1243,1023,76,129,205,1.2138671875,29.92418684372903
Task_34888,2712,342,109,125,234,7.906705539358601,51.156958721765044
Task_34889,2048,471,13,55,68,4.338983050847458,39.167882630169146
Task_34890,2282,714,25,199,224,3.1916083916083915,45.60332004005077
Task_34891,2122,261,184,85,269,8.099236641221374,41.56787059081397
Task_34892,2776,671,89,55,144,4.130952380952381,52.32377617349169
Task_34893,1803,320,59,101,160,5.616822429906542,36.21209820126739
Task_34894,1292,1007,95,165,260,1.2817460317460319,30.898222780140912
Task_34895,557,936,13,18,31,0.5944503735325507,16.769263707516902
Task_34896,1091,872,82,57,139,1.2497136311569301,26.244995904846647
Task_34897,1873,644,172,94,266,2.903875968992248,38.947787733561576
Task_34898,876,435,72,47,119,2.0091743119266057,20.959995467530693
Task_34899,2919,72,35,192,227,39.986301369863014,52.79518046897448
Task_34900,2634,511,158,198,356,5.14453125,51.13977267647781
Task_34901,1645,237,155,33,188,6.911764705882353,33.0597612177467
Task_34902,2193,394,125,149,274,5.5518987341772155,43.336642063295045
Task_34903,1078,512,93,170,263,2.101364522417154,26.086551979855244
Task_34904,2325,476,99,69,168,4.8742138364779874,44.780765712041834
Task_34905,742,184,105,112,217,4.010810810810811,19.309906995104228
Task_34906,1879,242,124,104,228,7.732510288065844,37.58064240903689
Task_34907,1351,100,27,145,172,13.376237623762377,27.97933337987648
Task_34908,1686,585,150,95,245,2.8771331058020477,35.727353103812796
Task_34909,654,626,36,106,142,1.0430622009569377,18.79783771550429
Task_34910,707,821,165,194,359,0.8600973236009732,21.571295920748483
Task_34911,1083,302,30,45,75,3.5742574257425743,23.116583483952308
Task_34912,2180,917,183,196,379,2.374727668845316,45.33104009618082
Task_34913,627,101,149,28,177,6.147058823529412,16.04524640841944
Task_34914,1344,325,10,18,28,4.122699386503068,26.924734970189288
Task_34915,2712,339,25,177,202,7.976470588235294,51.06428381140655
Task_34916,1635,992,169,68,237,1.646525679758308,35.8293778821676
Task_34917,742,805,164,124,288,0.9205955334987593,21.65645996798611
Task_34918,2188,407,120,192,312,5.362745098039215,43.5345891468063
Task_34919,1278,816,147,89,236,1.5642594859241126,29.842380283962687
Task_34920,1294,690,59,25,84,1.8726483357452968,27.943678945919412
Task_34921,1342,191,126,38,164,6.989583333333333,28.112249566889982
Task_34922,2995,126,27,67,94,23.58267716535433,52.965478079778784
Task_34923,2723,476,122,22,144,5.7085953878406706,50.550632491604084
Task_34924,2387,153,188,101,289,15.5,45.32950307865419
Task_34925,1689,874,89,143,232,1.9302857142857144,36.65591526593112
Task_34926,1778,506,143,14,157,3.5069033530571994,35.705359541247866
Task_34927,1478,1005,69,184,253,1.4691848906560636,33.917712992205715
Task_34928,2295,81,62,81,143,27.98780487804878,42.22297180696231
Task_34929,2060,81,82,42,124,25.121951219512194,37.67660955702472
Task_34930,1197,699,116,66,182,1.71,27.67777338409894
Task_34931,2148,916,70,172,242,2.342420937840785,44.240658703802524
Task_34932,1648,979,48,169,217,1.6816326530612244,36.370332809972915
Task_34933,2149,514,35,39,74,4.172815533980582,40.67444760496729
Task_34934,1408,393,182,64,246,3.5736040609137056,30.384728928917017
Task_34935,1297,375,35,21,56,3.449468085106383,26.689917202309815
Task_34936,2493,171,148,37,185,14.494186046511627,45.993934933894415
Task_34937,2452,953,126,173,299,2.570230607966457,49.359070658196764
Task_34938,2610,97,55,93,148,26.632653061224488,47.31541722187119
Task_34939,1674,949,16,123,139,1.7621052631578948,35.992234892583205
Task_34940,1326,1013,13,80,93,1.3076923076923077,30.063465977563293
Task_34941,1549,856,145,108,253,1.807467911318553,34.44607111860722
Task_34942,1737,355,34,186,220,4.879213483146067,35.81675623930611
Task_34943,2334,422,183,66,249,5.5177304964539005,45.14791627591035
Task_34944,2137,1021,17,106,123,2.0909980430528377,43.41288805584272
Task_34945,944,123,30,31,61,7.612903225806452,20.06969274039251
Task_34946,1546,102,144,87,231,15.009708737864077,31.247764802093553
Task_34947,2036,883,198,155,353,2.3031674208144794,42.766077260162625
Task_34948,767,124,91,158,249,6.136,19.506495276306122
Task_34949,2854,97,89,195,284,29.122448979591837,52.21338131776391
Task_34950,1542,404,74,168,242,3.8074074074074074,33.01238735633356
Task_34951,1860,931,96,38,134,1.9957081545064377,38.34424782910074
Task_34952,732,680,131,60,191,1.0748898678414096,20.266972475060772
Task_34953,2629,296,18,79,97,8.851851851851851,48.472067701053845
Task_34954,1502,969,91,141,232,1.5484536082474227,33.9665169481287
Task_34955,1900,524,162,120,282,3.619047619047619,39.112633490932865
Task_34956,1794,507,33,186,219,3.531496062992126,37.19940063515241
Task_34957,1211,252,76,61,137,4.786561264822135,26.20413787725799
Task_34958,2031,72,174,54,228,27.82191780821918,38.27078972159746
Task_34959,518,951,12,59,71,0.5441176470588235,16.389447118803734
Task_34960,1433,475,35,76,111,3.0105042016806722,30.427165868690228
Task_34961,1776,996,116,88,204,1.7813440320962888,38.1592485408301
Task_34962,2900,989,119,66,185,2.9292929292929295,55.592261798300314
Task_34963,992,648,111,34,145,1.5285053929121726,23.79741194872801
Task_34964,554,745,165,61,226,0.7426273458445041,17.801506204916652
Task_34965,984,670,71,183,254,1.466467958271237,25.041816599878377
Task_34966,1124,294,69,118,187,3.8101694915254236,25.72057800471706
Task_34967,1531,603,150,179,329,2.5347682119205297,33.81762139960134
Task_34968,992,80,138,147,285,12.246913580246913,22.8711983784459
Task_34969,1495,502,113,176,289,2.9721669980119283,32.74437580668238
Task_34970,2007,678,127,183,310,2.955817378497791,41.5125586161259
Task_34971,1002,612,175,27,202,1.6345840130505709,24.141843862147226
Task_34972,1218,1013,121,95,216,1.2011834319526626,29.45586469615924
Task_34973,1153,1016,186,131,317,1.1337266470009832,28.920477372335395
Task_34974,2644,720,130,65,195,3.667128987517337,50.78012896760526
Task_34975,1385,199,133,14,147,6.925,28.456664127047713
Task_34976,2788,883,134,13,147,3.1538461538461537,52.88756882232209
Task_34977,516,202,199,170,369,2.541871921182266,16.650636444450438
Task_34978,1050,518,128,130,258,2.023121387283237,25.54244097357621
Task_34979,1713,618,131,162,293,2.767366720516963,36.559940623907025
Task_34980,1443,437,148,135,283,3.2945205479452055,31.62738892057222
Task_34981,1608,201,28,14,42,7.96039603960396,30.781985485652793
Task_34982,2978,385,111,142,253,7.715025906735751,55.62227224496379
Task_34983,2065,515,180,50,230,4.001937984496124,40.929989491763585
Task_34984,2900,586,18,84,102,4.940374787052811,53.86826674716743
Task_34985,2103,706,22,140,162,2.9745403111739743,42.24330961072216
Task_34986,2029,655,196,111,307,3.0929878048780486,41.669579057424535
Task_34987,2400,111,97,196,293,21.428571428571427,45.31060523892723
Task_34988,2209,993,189,38,227,2.222334004024145,44.61285272025689
Task_34989,2801,999,58,152,210,2.801,54.670918302951605
Task_34990,2661,322,87,174,261,8.238390092879257,50.435015600378875
Task_34991,2236,271,57,117,174,8.220588235294118,43.14148557875933
Task_34992,1779,419,77,149,226,4.235714285714286,36.71766697568193
Task_34993,2590,809,85,62,147,3.197530864197531,49.88076829415795
Task_34994,1700,979,121,16,137,1.7346938775510203,35.80981359938603
Task_34995,989,347,74,171,245,2.8419540229885056,24.098094101772073
Task_34996,1916,949,140,138,278,2.0168421052631578,40.70708098009495
Task_34997,1294,515,38,199,237,2.507751937984496,29.41247600641623
Task_34998,2912,1001,82,110,192,2.906187624750499,56.26570877571916
Task_34999,2488,95,152,98,250,25.916666666666668,46.16184141087533
Task_35000,1451,232,12,92,104,6.227467811158799,29.78481847516224
Task_35001,2056,597,127,169,296,3.4381270903010033,41.94950908481385
Task_35002,2790,553,57,100,157,5.036101083032491,52.57898387794855
Task_35003,961,321,108,133,241,2.984472049689441,23.43743537272714
Task_35004,2343,664,165,183,348,3.523308270676692,46.96172768163404
Task_35005,1189,855,150,104,254,1.389018691588785,28.683754079949754
Task_35006,2102,211,169,147,316,9.915094339622641,41.44799387394227
Task_35007,2031,660,22,196,218,3.0726172465960664,41.42218352941948
Task_35008,815,317,135,64,199,2.5628930817610063,20.548453078580494
Task_35009,2124,410,140,59,199,5.1678832116788325,41.504273529494945
Task_35010,1351,884,119,91,210,1.5265536723163842,31.07939315842525
Task_35011,1000,709,66,148,214,1.408450704225352,25.20232284169713
Task_35012,1403,605,112,104,216,2.315181518151815,31.17755378452611
Task_35013,1413,637,147,98,245,2.2147335423197494,31.565608379833705
Task_35014,2173,283,94,179,273,7.651408450704225,42.6947267346323
Task_35015,1939,308,141,103,244,6.275080906148867,38.82898110652801
Task_35016,1492,296,174,43,217,5.023569023569023,30.999818767714743
Task_35017,883,265,16,194,210,3.319548872180451,21.944945975041765
Task_35018,2855,169,35,36,71,16.794117647058822,50.65442096550634
Task_35019,2418,692,117,25,142,3.4891774891774894,46.39464576214356
Task_35020,2709,714,55,82,137,3.788811188811189,51.73417065291475
Task_35021,1411,247,81,185,266,5.689516129032258,30.54771689476182
Task_35022,2488,601,70,164,234,4.132890365448505,48.58926588371195
Task_35023,2358,779,19,73,92,3.023076923076923,45.64341721425421
Task_35024,1741,318,104,11,115,5.4576802507836994,34.13859877909396
Task_35025,2447,523,144,71,215,4.669847328244275,47.15400508360086
Task_35026,1937,723,191,90,281,2.675414364640884,40.24620449586662
Task_35027,1815,711,162,167,329,2.5491573033707864,38.6369782115576
Task_35028,1968,169,114,143,257,11.576470588235294,38.69871532684454
Task_35029,2698,790,170,47,217,3.4108723135271806,51.69890952304027
Task_35030,1133,846,92,124,216,1.3376623376623376,27.633249182102826
Task_35031,1250,848,26,139,165,1.4723203769140165,29.242653253080544
Task_35032,950,851,163,146,309,1.1150234741784038,25.169590418942178
Task_35033,1142,994,20,116,136,1.1477386934673366,27.639359244701243
Task_35034,873,707,74,38,112,1.2330508474576272,21.728735883336032
Task_35035,1509,556,107,61,168,2.7091561938958706,32.05650011276703
Task_35036,2687,308,74,46,120,8.6957928802589,49.18209910641974
Task_35037,1290,885,26,33,59,1.4559819413092552,28.182374300707377
Task_35038,1155,247,172,169,341,4.657258064516129,26.76437286028465
Task_35039,2128,940,167,139,306,2.261424017003188,44.16612273865602
Task_35040,2183,792,39,18,57,2.7528373266078185,41.958282788700316
Task_35041,2823,538,73,114,187,5.23747680890538,53.380997361447584
Task_35042,1707,165,40,159,199,10.283132530120483,34.30035910441988
Task_35043,2691,825,131,40,171,3.2578692493946733,51.41595410350584
Task_35044,1201,576,23,41,64,2.081455805892548,25.868001571101985
Task_35045,1042,130,61,96,157,7.9541984732824424,23.06125054255783
Task_35046,1739,416,113,195,308,4.170263788968825,36.445027805857045
Task_35047,787,94,99,136,235,8.284210526315789,19.44262566242245
Task_35048,2803,98,142,180,322,28.31313131313131,51.585065994550156
Task_35049,803,597,189,158,347,1.342809364548495,22.27331636468308
Task_35050,2102,374,124,199,323,5.605333333333333,42.12492100361698
Task_35051,1377,839,181,164,345,1.6392857142857142,32.1513541159728
Task_35052,1004,580,81,26,107,1.7280550774526677,23.27882001965274
Task_35053,2813,567,133,186,319,4.952464788732394,53.97010494332034
Task_35054,1837,91,123,192,315,19.967391304347824,36.398050742093865
Task_35055,1060,269,120,161,281,3.925925925925926,25.05443234086593
Task_35056,655,300,133,141,274,2.176079734219269,18.692031115952794
Task_35057,1449,257,199,142,341,5.616279069767442,31.40410362804153
Task_35058,2360,267,133,39,172,8.805970149253731,44.39313124948743
Task_35059,2074,571,156,71,227,3.625874125874126,41.45533351771996
Task_35060,1406,601,135,179,314,2.335548172757475,31.76415462647466
Task_35061,2065,724,113,96,209,2.8482758620689657,42.02132393915401
Task_35062,1214,1023,151,132,283,1.185546875,29.76614658502346
Task_35063,2043,439,194,196,390,4.6431818181818185,41.70164503482504
Task_35064,817,842,75,193,268,0.9691577698695136,22.980300706566222
Task_35065,1860,1011,107,89,196,1.8379446640316206,39.52827943708627
Task_35066,1151,101,31,181,212,11.284313725490197,25.211524457044494
Task_35067,1726,523,192,66,258,3.2938931297709924,35.88954643251338
Task_35068,508,749,170,127,297,0.6773333333333333,17.936388574507777
Task_35069,2302,306,47,70,117,7.498371335504886,43.54623900105841
Task_35070,1477,980,197,184,381,1.5056065239551477,34.33565013924582
Task_35071,1872,590,61,187,248,3.16751269035533,38.89066199206526
Task_35072,2914,617,33,46,79,4.715210355987055,53.30133101322156
Task_35073,2208,112,40,132,172,19.539823008849556,41.52072373084679
Task_35074,2424,593,72,136,208,4.08080808080808,47.37953548686193
Task_35075,1396,485,157,87,244,2.8724279835390947,30.7285845508452
Task_35076,2494,492,139,119,258,5.0588235294117645,48.30440223247293
Task_35077,1911,724,102,17,119,2.6358620689655172,38.136406397282705
Task_35078,1996,86,196,140,336,22.942528735632184,38.87301696193024
Task_35079,2960,690,56,126,182,4.283646888567294,56.01712454509169
Task_35080,1512,664,12,70,82,2.2736842105263158,31.70534376128187
Task_35081,2695,406,13,179,192,6.621621621621622,50.97026780386199
Task_35082,1007,392,172,90,262,2.5623409669211195,24.392003814286443
Task_35083,714,738,146,177,323,0.9661705006765899,21.233845545090343
Task_35084,1724,620,112,113,225,2.7761674718196456,36.36213386099946
Task_35085,1860,477,32,154,186,3.8912133891213387,37.914203448225685
Task_35086,808,777,103,118,221,1.038560411311054,22.271350740135023
Task_35087,1257,850,34,156,190,1.4770857814336076,29.54673704233818
Task_35088,2059,638,75,99,174,3.2222222222222223,41.50785826615224
Task_35089,2641,854,157,58,215,3.088888888888889,51.18461620634216
Task_35090,1902,489,111,78,189,3.8816326530612244,38.42392907672875
Task_35091,2577,321,95,65,160,8.003105590062113,48.13440128997198
Task_35092,1166,996,158,196,354,1.1695085255767301,29.33576856758901
Task_35093,1805,181,155,58,213,9.917582417582418,35.60502169990851
Task_35094,2938,69,45,112,157,41.97142857142857,52.19882559825345
Task_35095,2025,416,175,78,253,4.856115107913669,40.42863583996966
Task_35096,2403,290,35,25,60,8.257731958762887,43.912140036738315
Task_35097,1700,64,38,36,74,26.153846153846153,31.082831850931935
Task_35098,778,563,74,124,198,1.3794326241134751,21.10808305007067
Task_35099,599,829,45,178,223,0.7216867469879518,19.35013651775439
Task_35100,2627,571,132,195,327,4.5926573426573425,51.086845658514655
Task_35101,2042,652,33,92,125,3.127105666156202,40.865697449911316
Task_35102,1166,159,25,104,129,7.2875,24.995998445421417
Task_35103,2086,813,39,62,101,2.5626535626535625,41.40458566840233
Task_35104,2380,206,54,152,206,11.497584541062801,45.39912629782765
Task_35105,708,911,173,36,209,0.7763157894736842,20.52916203542259
Task_35106,642,821,26,181,207,0.781021897810219,19.79845953512738
Task_35107,1818,241,120,162,282,7.512396694214876,36.94180717103051
Task_35108,1315,297,80,197,277,4.412751677852349,29.265933035316532
Task_35109,1365,278,187,49,236,4.89247311827957,29.116995021642918
Task_35110,1750,176,34,75,109,9.887005649717514,33.95018682623908
Task_35111,1110,858,106,33,139,1.2922002328288709,26.209845321380158
Task_35112,1463,844,11,184,195,1.7313609467455622,32.843585075725066
Task_35113,2152,454,62,141,203,4.72967032967033,42.61913447451662
Task_35114,2213,418,65,193,258,5.281622911694511,43.79410233080785
Task_35115,2152,279,35,36,71,7.685714285714286,39.95162220323532
Task_35116,2196,398,58,177,235,5.503759398496241,43.332375943276986
Task_35117,786,697,161,11,172,1.1260744985673352,20.747349388783785
Task_35118,2567,129,175,81,256,19.746153846153845,47.62538595021365
Task_35119,1876,474,184,64,248,3.9494736842105262,38.06071270583752
Task_35120,1971,981,84,72,156,2.0071283095723014,40.702323876543765
Task_35121,2779,1013,108,191,299,2.7406311637080867,54.754426498297995
Task_35122,2978,415,76,55,131,7.158653846153846,54.68439317141236
Task_35123,2116,489,119,147,266,4.318367346938776,42.387807849991646
Task_35124,697,113,74,28,102,6.114035087719298,16.567208686433695
Task_35125,647,418,118,60,178,1.5441527446300716,18.026761253542748
Task_35126,1207,903,176,131,307,1.3351769911504425,29.40321724414129
Task_35127,2058,816,40,89,129,2.518971848225214,41.73455293110005
Task_35128,2863,333,134,193,327,8.571856287425149,54.03292423253674
Task_35129,819,834,66,190,256,0.9808383233532935,22.94107265350155
Task_35130,2451,424,92,121,213,5.767058823529411,47.20979633736332
Task_35131,2793,622,190,29,219,4.48314606741573,52.64311476420619
Task_35132,2700,607,25,171,196,4.440789473684211,51.717976654759305
Task_35133,1096,463,78,86,164,2.3620689655172415,25.62443945572188
Task_35134,520,105,163,71,234,4.90566037735849,14.894042716614457
Task_35135,2499,741,88,94,182,3.3679245283018866,48.72228536797837
Task_35136,1573,94,46,40,86,16.557894736842105,29.87824334616045
Task_35137,2866,252,37,160,197,11.328063241106719,53.17758872471754
Task_35138,1110,923,175,16,191,1.2012987012987013,26.687981470349317
Task_35139,2042,359,122,165,287,5.6722222222222225,40.913875078122224
Task_35140,1355,365,43,124,167,3.702185792349727,29.431014992215935
Task_35141,960,954,97,175,272,1.0052356020942408,25.517897750230375
Task_35142,1582,253,119,124,243,6.228346456692913,33.02383517105533
Task_35143,2010,1004,130,144,274,2.0,42.358362710771345
Task_35144,1440,324,95,62,157,4.430769230769231,30.104299305730546
Task_35145,2839,901,187,39,226,3.147450110864745,54.29236177498109
Task_35146,538,479,21,124,145,1.1208333333333333,16.537112054169334
Task_35147,994,401,56,87,143,2.472636815920398,23.622406664082135
Task_35148,730,756,192,163,355,0.964332892998679,21.666740190525037
Task_35149,2473,485,67,163,230,5.088477366255144,47.96207986699172
Task_35150,1614,208,125,112,237,7.722488038277512,33.32489159616421
Task_35151,1143,471,57,55,112,2.4216101694915255,25.398531969745235
Task_35152,2181,606,177,98,275,3.5930807248764416,43.76638960328751
Task_35153,627,933,24,77,101,0.671306209850107,19.0790275955883
Task_35154,2244,138,141,197,338,16.14388489208633,43.30404351669006
Task_35155,760,145,146,71,217,5.205479452054795,18.97826776565852
Task_35156,1260,818,37,54,91,1.5384615384615385,28.172106086035658
Task_35157,1914,92,130,173,303,20.580645161290324,37.52118079244985
Task_35158,1849,393,123,17,140,4.692893401015229,36.376981640481375
Task_35159,2501,494,10,157,167,5.052525252525252,47.98087744514572
Task_35160,935,482,128,147,275,1.9358178053830228,23.71042152011948
Task_35161,2824,416,88,139,227,6.772182254196642,53.12679906917338
Task_35162,2684,909,169,32,201,2.9494505494505496,51.74788905689689
Task_35163,1933,152,58,91,149,12.633986928104575,37.239999265651655
Task_35164,2005,879,153,160,313,2.278409090909091,42.08946621940418
Task_35165,1092,687,25,193,218,1.5872093023255813,26.59388548533327
Task_35166,2823,174,131,181,312,16.13142857142857,52.481676834788836
Task_35167,2526,810,99,124,223,3.1146732429099875,49.671880089657975
Task_35168,1394,114,122,184,306,12.121739130434783,29.55833837472989
Task_35169,607,879,125,165,290,0.6897727272727273,19.923030532970095
Task_35170,1970,888,134,58,192,2.2159730033745784,40.555341869813724
Task_35171,1810,666,79,140,219,2.7136431784107944,37.94133895142689
Task_35172,2250,365,105,36,141,6.147540983606557,42.721625516030464
Task_35173,2234,218,77,183,260,10.200913242009133,43.426227637104084
Task_35174,2126,691,132,125,257,3.0722543352601157,43.11447925860332
Task_35175,2300,516,196,95,291,4.448742746615087,45.43747115679992
Task_35176,960,838,99,57,156,1.1442193087008343,24.10718587023967
Task_35177,2246,408,145,15,160,5.491442542787286,42.814059203182204
Task_35178,1269,416,105,51,156,3.0431654676258995,27.668762642237187
Task_35179,1893,646,62,198,260,2.9258114374034,39.47001964581821
Task_35180,2398,599,54,148,202,3.9966666666666666,46.98750832832102
Task_35181,1237,361,92,81,173,3.4171270718232045,27.414019789595198
Task_35182,2081,874,139,166,305,2.378285714285714,43.25082609149255
Task_35183,2355,173,95,110,205,13.53448275862069,44.54225069282981
Task_35184,1019,328,157,106,263,3.0972644376899696,24.436804540998214
Task_35185,2729,661,78,164,242,4.122356495468278,52.62744186591278
Task_35186,1396,591,90,51,141,2.358108108108108,30.17437487988469
Task_35187,625,812,146,114,260,0.7687576875768758,19.71065109905331
Task_35188,1685,244,84,39,123,6.877551020408164,33.1915486716916
Task_35189,1811,453,84,22,106,3.988986784140969,35.625404858379504
Task_35190,2375,452,151,31,182,5.242825607064018,45.29862812151037
Task_35191,1483,924,23,96,119,1.6032432432432433,32.72157834561818
Task_35192,2733,738,165,17,182,3.698240866035183,51.78155093898945
Task_35193,539,151,149,39,188,3.5460526315789473,15.08131198618185
Task_35194,2601,942,83,189,272,2.758218451749735,51.62325558363031
Task_35195,1398,955,151,88,239,1.4623430962343096,32.15938659114
Task_35196,2728,210,156,189,345,12.928909952606634,51.519835371920124
Task_35197,2983,848,131,164,295,3.513545347467609,57.41320881322927
Task_35198,2613,688,148,68,216,3.792452830188679,50.274422550699654
Task_35199,2046,637,52,124,176,3.206896551724138,41.3569786624044
Task_35200,930,670,160,189,349,1.3859910581222057,24.55916124664733
Task_35201,1539,726,77,167,244,2.1169188445667126,33.99563255947682
Task_35202,537,67,57,84,141,7.897058823529412,14.549948156873825
Task_35203,806,727,106,142,248,1.1071428571428572,22.22332687815482
Task_35204,2860,414,128,109,237,6.891566265060241,53.73212997476147
Task_35205,2503,450,160,108,268,5.549889135254989,48.33921315058391
Task_35206,2345,626,94,195,289,3.740031897926635,46.63514758229008
Task_35207,1789,662,133,68,201,2.6983408748114632,37.07315721464216
Task_35208,1048,759,84,22,106,1.3789473684210527,24.50605817232841
Task_35209,2485,317,40,93,133,7.814465408805032,46.89730275638874
Task_35210,931,87,112,44,156,10.579545454545455,20.28178973260645
Task_35211,2138,513,106,170,276,4.159533073929961,42.891886351110564
Task_35212,2310,347,137,73,210,6.637931034482759,44.401226217378884
Task_35213,1115,578,152,85,237,1.9257340241796201,26.521944226583255
Task_35214,996,679,143,73,216,1.464705882352941,24.65922707814816
Task_35215,2173,444,194,42,236,4.883146067415731,42.34391011949412
Task_35216,1654,456,149,51,200,3.6192560175054704,34.21657843232631
Task_35217,1694,862,16,12,28,1.962920046349942,34.183119646023
Task_35218,2943,969,196,194,390,3.034020618556701,57.63052356103358
Task_35219,1653,125,134,63,197,13.119047619047619,32.75331450078695
Task_35220,1674,451,183,177,360,3.7035398230088497,35.7369174337605
Task_35221,2702,816,21,196,217,3.307221542227662,52.53767055119849
Task_35222,2774,597,186,179,365,4.638795986622074,53.645722181253255
Task_35223,689,75,91,138,229,9.06578947368421,17.84429511292887
Task_35224,2512,673,197,176,373,3.7270029673590503,49.769423395829584
Task_35225,1811,89,56,125,181,20.122222222222224,35.28601492221703
Task_35226,1206,493,140,31,171,2.4412955465587043,26.84783058737123
Task_35227,2591,679,162,163,325,3.8102941176470586,50.80432774460053
Task_35228,1231,160,200,97,297,7.645962732919255,27.173915634311314
Task_35229,2825,609,94,79,173,4.631147540983607,53.35493441044836
Task_35230,1485,625,135,171,306,2.3722044728434506,33.04276318179891
Task_35231,2192,578,112,198,310,3.785837651122625,44.148548323486665
Task_35232,737,102,24,188,212,7.155339805825243,18.708735113709135
Task_35233,2216,666,72,192,264,3.3223388305847075,44.65101330286928
Task_35234,1585,259,174,152,326,6.096153846153846,33.50708909571647
Task_35235,1935,866,172,16,188,2.2318339100346023,39.566028390607805
Task_35236,2044,751,53,114,167,2.7180851063829787,41.60380620344138
Task_35237,629,745,12,132,144,0.8431635388739946,18.823814006149792
Task_35238,2825,823,123,70,193,3.4283980582524274,53.95413621616809
Task_35239,1734,172,95,92,187,10.023121387283236,34.51061436059497
Task_35240,2513,372,83,125,208,6.737265415549598,48.029416452864716
Task_35241,1071,711,127,135,262,1.5042134831460674,26.459924964229632
Task_35242,581,789,140,77,217,0.7354430379746836,18.53267776906201
Task_35243,2439,634,173,141,314,3.840944881889764,48.172481766899104
Task_35244,1404,642,148,183,331,2.1835147744945567,31.943399278785694
Task_35245,1635,598,97,160,257,2.7295492487479134,35.10423863603679
Task_35246,1580,106,199,191,390,14.766355140186915,32.80021540290321
Task_35247,1396,761,178,76,254,1.832020997375328,31.512469602000646
Task_35248,2850,185,12,42,54,15.32258064516129,50.737996398247674
Task_35249,1974,315,71,96,167,6.246835443037975,39.10482420185362
Task_35250,987,424,167,143,310,2.3223529411764705,24.502708455427364
Task_35251,2408,329,145,188,333,7.296969696969697,46.84284653694848
Task_35252,2571,144,159,173,332,17.73103448275862,48.473232731092516
Task_35253,1398,228,72,190,262,6.104803493449782,30.272471105713848
Task_35254,1292,448,191,186,377,2.8775055679287305,29.770930879667233
Task_35255,1136,534,128,66,194,2.1233644859813086,26.29235128504028
Task_35256,954,212,73,133,206,4.47887323943662,22.8698408760141
Task_35257,2763,706,95,19,114,3.908062234794908,51.61729740995176
Task_35258,1174,354,177,28,205,3.307042253521127,26.087533793568543
Task_35259,716,837,167,121,288,0.8544152744630071,21.336344942231648
Task_35260,1346,742,140,115,255,1.8115746971736204,30.894539694127143
Task_35261,2571,367,144,16,160,6.986413043478261,47.821295676848514
Task_35262,1351,329,42,10,52,4.093939393939394,27.277745782813934
Task_35263,1127,405,147,12,159,2.7758620689655173,25.099597686204987
Task_35264,1126,702,100,107,207,1.6017069701280227,27.043524132812408
Task_35265,1433,96,105,175,280,14.77319587628866,29.855342568425428
Task_35266,616,940,34,148,182,0.6546227417640808,19.72216614822986
Task_35267,2101,847,91,51,142,2.4775943396226414,42.15019511518092
Task_35268,1950,381,150,184,334,5.104712041884817,39.77077896537062
Task_35269,2814,918,200,163,363,3.0620239390642,55.259804275184194
Task_35270,1542,83,30,89,119,18.357142857142858,30.192810144183895
Task_35271,610,313,69,108,177,1.9426751592356688,17.58295258001524
Task_35272,1735,148,141,163,304,11.644295302013424,35.19605941208595
Task_35273,1694,206,195,100,295,8.183574879227054,34.82432198936218
Task_35274,1579,812,179,179,358,1.9421894218942188,35.36183488168122
Task_35275,2703,123,140,60,200,21.798387096774192,49.26756460847778
Task_35276,2225,995,77,173,250,2.2339357429718874,45.73878136218277
Task_35277,1105,436,110,48,158,2.528604118993135,24.960194533784833
Task_35278,1513,437,80,103,183,3.454337899543379,32.25316413317345
Task_35279,743,235,100,84,184,3.1483050847457625,19.266413285384605
Task_35280,2274,740,88,29,117,3.068825910931174,44.01752453340706
Task_35281,648,783,67,136,203,0.826530612244898,19.761753519538463
Task_35282,2011,397,80,195,275,5.052763819095477,40.591943261046204
Task_35283,838,816,18,109,127,1.025703794369645,22.24854196032563
Task_35284,643,93,142,23,165,6.840425531914893,16.028246799618614
Task_35285,2430,254,131,153,284,9.529411764705882,46.65386848679022
Task_35286,2712,563,162,167,329,4.808510638297872,52.375148296873284
Task_35287,1459,120,153,132,285,12.057851239669422,30.50408295813608
Task_35288,963,261,109,94,203,3.6755725190839694,23.038678712272656
Task_35289,1099,302,153,154,307,3.627062706270627,25.886197677809065
Task_35290,2121,251,190,165,355,8.416666666666666,42.098157743356076
Task_35291,573,256,192,67,259,2.2295719844357977,16.80434979612101
Task_35292,2649,297,93,104,197,8.889261744966444,49.84466092353645
Task_35293,833,146,114,51,165,5.666666666666667,19.71203823555688
Task_35294,2739,800,111,129,240,3.4194756554307117,53.09735753750764
Task_35295,2323,707,96,92,188,3.281073446327684,45.86661456417146
Task_35296,2931,219,136,44,180,13.322727272727272,53.28134163156719
Task_35297,1000,842,190,11,201,1.1862396204033214,24.7458741131843
Task_35298,2161,640,103,123,226,3.371294851794072,43.365470059148834
Task_35299,502,256,29,93,122,1.953307392996109,15.160359874563293
Task_35300,1291,210,189,53,242,6.118483412322274,27.91676367686018
Task_35301,864,992,44,117,161,0.8700906344410876,23.416817710802178
Task_35302,2154,411,10,44,54,5.228155339805825,40.39759475709999
Task_35303,2405,802,150,104,254,2.995018679950187,47.838476814056065
Task_35304,1451,730,199,171,370,1.984952120383037,33.12089881834641
Task_35305,2511,191,197,10,207,13.078125,46.621357229045934
Task_35306,1373,663,67,98,165,2.0677710843373496,30.69883486499297
Task_35307,2810,218,147,30,177,12.831050228310502,51.34018543476221
Task_35308,2204,1002,34,154,188,2.19740777666999,45.05203926697154
Task_35309,2399,889,24,155,179,2.695505617977528,47.71759985571532
Task_35310,1231,904,173,27,200,1.3602209944751382,28.678313632900856
Task_35311,1637,723,190,62,252,2.2610497237569063,35.03398520434785
Task_35312,2258,550,104,144,248,4.098003629764065,44.74586759003495
Task_35313,699,301,196,99,295,2.314569536423841,19.417999495956227
Task_35314,651,651,179,63,242,0.9984662576687117,19.17864752495982
Task_35315,2574,596,193,147,340,4.311557788944723,50.315659089306145
Task_35316,2874,82,149,50,199,34.626506024096386,51.14902211447022
Task_35317,1336,934,20,57,77,1.4288770053475937,29.37582039742055
Task_35318,1634,875,65,153,218,1.865296803652968,35.82990018585634
Task_35319,1188,500,32,79,111,2.37125748502994,26.653493457907985
Task_35320,925,398,132,149,281,2.318295739348371,23.31740963978147
Task_35321,1873,136,59,98,157,13.671532846715328,36.13458306186279
Task_35322,1397,433,39,147,186,3.21889400921659,30.44352375448877
Task_35323,2330,903,123,156,279,2.577433628318584,47.154865749355736
Task_35324,1243,337,152,113,265,3.6775147928994083,28.027884074068822
Task_35325,1181,570,105,91,196,2.0683012259194395,27.38812787588935
Task_35326,553,956,28,115,143,0.5778474399164054,18.441847064990004
Task_35327,2846,928,117,196,313,3.063509149623251,55.621165255917084
Task_35328,802,588,72,25,97,1.3616298811544991,20.102217625430317
Task_35329,1524,605,168,39,207,2.514851485148515,32.44681362238352
Task_35330,541,821,179,151,330,0.6581508515815085,18.867807842643327
Task_35331,1892,65,37,106,143,28.666666666666668,35.72424331645285
Task_35332,1128,738,105,146,251,1.5263870094722598,27.413337725645817
Task_35333,2990,455,75,190,265,6.557017543859649,56.23539022324275
Task_35334,2277,162,91,65,156,13.969325153374234,42.46846483799641
Task_35335,2391,502,104,72,176,4.753479125248509,46.01986554071353
Task_35336,1524,729,46,160,206,2.0876712328767124,33.552653043566885
Task_35337,1917,880,29,133,162,2.1759364358683313,39.85102565832128
Task_35338,1779,424,180,91,271,4.185882352941176,36.72974205117209
Task_35339,908,712,197,120,317,1.273492286115007,24.088473040997215
Task_35340,1936,326,62,32,94,5.920489296636085,37.05738373221858
Task_35341,1222,874,143,183,326,1.3965714285714286,29.705854669581438
Task_35342,2195,653,55,31,86,3.356269113149847,42.14884297860389
Task_35343,1981,857,44,144,188,2.308857808857809,41.05691514049836
Task_35344,591,731,70,197,267,0.8073770491803278,19.089834284775076
Task_35345,1806,659,100,199,299,2.7363636363636363,38.24303999331203
Task_35346,2992,755,11,121,132,3.9576719576719577,56.2784841318093
Task_35347,1694,123,18,169,187,13.661290322580646,33.70301873454394
Task_35348,2722,655,25,86,111,4.149390243902439,51.452491889360196
Task_35349,2940,208,14,130,144,14.066985645933014,53.656577062854616
Task_35350,761,950,94,145,239,0.8002103049421662,22.22128127634475
Task_35351,1536,568,117,191,308,2.6994727592267136,33.709644272471074
Task_35352,505,239,131,180,311,2.1041666666666665,16.350077580194675
Task_35353,771,863,85,48,133,0.8923611111111112,20.99588149206082
Task_35354,2361,324,135,32,167,7.264615384615385,44.59173390474223
Task_35355,2307,161,125,107,232,14.24074074074074,43.85501711947353
Task_35356,544,729,26,34,60,0.7452054794520548,15.997565347256648
Task_35357,2911,577,64,31,95,5.036332179930795,53.316507892869545
Task_35358,2384,818,166,78,244,2.9108669108669107,47.34975881051636
Task_35359,1637,442,200,101,301,3.695259593679458,34.74512110554204
Task_35360,1486,235,180,194,374,6.296610169491525,32.13761507674686
Task_35361,690,502,23,79,102,1.371769383697813,18.524508365729506
Task_35362,661,849,50,137,187,0.7776470588235294,20.15289353482302
Task_35363,2376,184,165,84,249,12.843243243243244,45.16667894588213
Task_35364,650,171,48,47,95,3.7790697674418605,16.124396449477437
Task_35365,2076,943,117,20,137,2.1991525423728815,41.69886583936872
Task_35366,1765,970,60,36,96,1.8177136972193615,36.38320522054904
Task_35367,2914,801,11,55,66,3.6334164588528677,53.90063756345663
Task_35368,2238,128,174,193,367,17.348837209302324,43.28184285591204
Task_35369,1835,473,66,153,219,3.871308016877637,37.762580755652515
Task_35370,2267,706,166,118,284,3.2065063649222063,45.50657742643981
Task_35371,1688,287,57,94,151,5.861111111111111,34.2588104573368
Task_35372,971,874,168,33,201,1.1097142857142857,24.483870713799693
Task_35373,1908,701,155,22,177,2.717948717948718,38.60103655466394
Task_35374,2675,274,101,129,230,9.727272727272727,50.32007797097108
Task_35375,1946,491,24,87,111,3.9552845528455283,38.640822618961494
Task_35376,1293,965,70,186,256,1.3385093167701863,30.873483189179154
Task_35377,1110,582,167,96,263,1.9039451114922814,26.693914515988975
Task_35378,2328,974,43,100,143,2.3876923076923076,46.475933499869576
Task_35379,1523,126,89,54,143,11.992125984251969,30.23421872711876
Task_35380,924,855,111,147,258,1.0794392523364487,24.552283543383822
Task_35381,2129,543,122,135,257,3.9136029411764706,42.70831575016879
Task_35382,1672,549,47,131,178,3.04,35.14366893029264
Task_35383,1173,791,83,125,208,1.481060606060606,28.10047124111099
Task_35384,1422,822,122,151,273,1.7278250303766707,32.46793700731149
Task_35385,2397,407,197,192,389,5.875,47.1888874644863
Task_35386,2658,689,23,113,136,3.8521739130434782,50.756707325314494
Task_35387,1255,925,27,77,104,1.355291576673866,28.802621461733526
Task_35388,2051,690,91,23,114,2.968162083936324,40.30741885884185
Task_35389,1833,901,30,48,78,2.032150776053215,37.086073156792004
Task_35390,1760,703,76,155,231,2.5,37.34835617666838
Task_35391,2789,970,35,47,82,2.8722966014418128,52.63431527736207
Task_35392,2103,841,191,53,244,2.497624703087886,42.8039562393438
Task_35393,1548,860,187,41,228,1.7979094076655053,33.72011099598939
Task_35394,1285,963,146,40,186,1.3329875518672198,29.673522066727458
Task_35395,2686,220,39,54,93,12.153846153846153,48.841986697193526
Task_35396,2961,390,137,59,196,7.572890025575448,54.66851830450531
Task_35397,1465,702,117,46,163,2.0839260312944523,31.619719387199577
Task_35398,998,846,187,57,244,1.17827626918536,25.253469687321445
Task_35399,1663,713,144,109,253,2.3291316526610646,35.8078927141621
Task_35400,2568,531,39,20,59,4.827067669172933,47.21038139998992
Task_35401,995,666,21,153,174,1.4917541229385307,24.709783351087484
Task_35402,736,977,110,125,235,0.7525562372188139,21.860293443893283
Task_35403,2157,850,48,68,116,2.534665099882491,43.00183867399709
Task_35404,1086,1013,173,115,288,1.0710059171597632,27.696407164626596
Task_35405,691,960,82,48,130,0.7190426638917794,20.203714896400623
Task_35406,1038,295,16,141,157,3.5067567567567566,23.991693802091845
Task_35407,2252,974,145,27,172,2.3097435897435896,44.922596640565935
Task_35408,2903,604,187,28,215,4.798347107438016,54.304716190482054
Task_35409,1509,278,14,108,122,5.408602150537634,31.129524265339416
Task_35410,2465,653,120,35,155,3.7691131498470947,47.14904067922807
Task_35411,2900,831,197,186,383,3.485576923076923,56.47362832937184
Task_35412,1267,136,36,170,206,9.248175182481752,27.237102785175313
Task_35413,2146,622,176,119,295,3.4446227929373996,43.376140163678166
Task_35414,609,852,113,123,236,0.7139507620164126,19.545551684493677
Task_35415,2011,654,37,16,53,3.070229007633588,38.77335341571613
Task_35416,725,789,23,78,101,0.9177215189873418,19.99150126135864
Task_35417,1049,917,140,161,301,1.1427015250544663,26.93800372677934
Task_35418,2510,160,43,129,172,15.590062111801242,46.68192978278057
Task_35419,2641,247,13,197,210,10.649193548387096,49.668785209033445
Task_35420,1140,163,141,62,203,6.951219512195122,24.96418268257445
Task_35421,1053,830,175,119,294,1.2671480144404332,26.646447624515535
Task_35422,1445,504,72,31,103,2.8613861386138613,30.04613900077253
Task_35423,1337,558,112,198,310,2.3917710196779964,30.546318301260897
Task_35424,926,224,135,55,190,4.115555555555556,21.913960666523195
Task_35425,784,264,61,19,80,2.9584905660377356,18.375504837342845
Task_35426,825,930,97,15,112,0.8861439312567132,21.633852890033424
Task_35427,1463,509,66,151,217,2.868627450980392,31.97618589606564
Task_35428,848,845,13,98,111,1.0023640661938533,22.28838018368189
Task_35429,736,414,69,20,89,1.7734939759036144,18.332516030823665
Task_35430,1653,567,66,181,247,2.910211267605634,35.34702200907277
Task_35431,2468,356,165,155,320,6.913165266106443,47.77672589205478
Task_35432,965,609,129,25,154,1.5819672131147542,23.16248482203342
Task_35433,713,1006,10,20,30,0.7080436941410129,19.481292416144182
Task_35434,1800,880,20,193,213,2.0431328036322363,38.42716488831756
Task_35435,2436,340,57,155,212,7.1436950146627565,46.79596578259187
Task_35436,2073,630,129,182,311,3.2852614896988905,42.40973499940389
Task_35437,1491,984,67,49,116,1.5137055837563451,32.48024196763759
Task_35438,1520,842,17,77,94,1.8030842230130486,32.5795195740385
Task_35439,2437,683,94,89,183,3.5628654970760234,47.55844096593692
Task_35440,1755,306,147,194,341,5.716612377850163,36.48345520940418
Task_35441,2428,758,33,90,123,3.1989459815546772,47.25769937963861
Task_35442,984,655,148,156,304,1.5,25.127786510804956
Task_35443,2463,148,163,179,342,16.530201342281877,46.8619541165123
Task_35444,1371,159,63,71,134,8.56875,28.232530969437594
Task_35445,2858,210,135,199,334,13.545023696682465,53.537376582981985
Task_35446,1763,963,90,76,166,1.8288381742738589,37.57012544710115
Task_35447,2487,113,106,166,272,21.81578947368421,46.559114018900516
Task_35448,1592,67,43,23,66,23.41176470588235,29.298555295368175
Task_35449,1504,339,21,33,54,4.423529411764706,29.86560512899389
Task_35450,2995,872,192,102,294,3.4306987399770903,57.58328409224506
Task_35451,923,289,172,109,281,3.182758620689655,22.87821532376726
Task_35452,2837,816,94,65,159,3.4724602203182373,53.84585214138544
Task_35453,1754,349,51,155,206,5.011428571428572,36.04348986931527
Task_35454,1722,483,193,47,240,3.5578512396694215,35.37403410861319
Task_35455,1529,1012,98,66,164,1.5093780848963474,33.877094486502976
Task_35456,670,121,51,45,96,5.491803278688525,15.981301383893813
Task_35457,2011,430,186,104,290,4.665893271461717,40.580430507697116
Task_35458,608,827,177,130,307,0.7342995169082126,19.71802457997003
Task_35459,1041,730,132,16,148,1.424076607387141,24.67063071546031
Task_35460,2578,679,103,166,269,3.791176470588235,50.350414665037725
Task_35461,1495,865,183,40,223,1.7263279445727482,32.86173555335366
Task_35462,2497,779,103,178,281,3.2012820512820515,49.45403666118392
Task_35463,1067,915,69,199,268,1.1648471615720524,27.18628847474568
Task_35464,1141,467,185,48,233,2.4380341880341883,26.10384981103051
Task_35465,667,127,184,135,319,5.2109375,18.235620746795238
Task_35466,2565,114,120,160,280,22.304347826086957,47.8209587469066
Task_35467,1521,368,173,174,347,4.121951219512195,32.98507503129901
Task_35468,2512,954,132,32,164,2.630366492146597,49.002176877427594
Task_35469,1696,468,174,135,309,3.6162046908315566,35.848127707874504
Task_35470,2513,506,129,144,273,4.956607495069034,48.754713783594944
Task_35471,1653,636,115,85,200,2.594976452119309,35.05719246971913
Task_35472,2761,800,151,191,342,3.446941323345818,53.996512602195686
Task_35473,607,587,10,115,125,1.032312925170068,17.8425312786893
Task_35474,2539,575,168,72,240,4.407986111111111,48.91314048472265
Task_35475,931,733,116,14,130,1.268392370572207,22.844170794314596
Task_35476,961,347,116,161,277,2.7614942528735633,23.724206887805508
Task_35477,1548,166,159,62,221,9.269461077844312,31.480830674367848
Task_35478,542,303,162,23,185,1.7828947368421053,15.765980719125473
Task_35479,836,676,178,136,314,1.2348596750369276,22.842885906166867
Task_35480,1590,803,117,130,247,1.9776119402985075,34.93597533587047
Task_35481,2296,494,78,79,157,4.638383838383838,44.51035177618949
Task_35482,1818,762,106,81,187,2.382699868938401,37.952618797782655
Task_35483,2342,703,28,30,58,3.3267045454545454,44.300345714733645
Task_35484,2600,260,190,160,350,9.96168582375479,49.66991410442779
Task_35485,1468,742,122,82,204,1.9757738896366084,32.477819397564666
Task_35486,1165,134,16,138,154,8.62962962962963,24.894521516246403
Task_35487,2614,859,198,189,387,3.0395348837209304,52.052436284262456
Task_35488,1767,939,134,36,170,1.8797872340425532,37.12285327933002
Task_35489,1545,983,17,167,184,1.5701219512195121,34.437362902706745
Task_35490,676,122,91,82,173,5.495934959349594,17.40519517130291
Task_35491,723,568,109,125,234,1.2706502636203867,20.344285456453335
Task_35492,2669,101,11,163,174,26.166666666666668,48.74234873308149
Task_35493,643,870,54,98,152,0.7382319173363949,19.524866883324016
Task_35494,2659,328,83,113,196,8.082066869300911,50.1172132486742
Task_35495,892,915,187,74,261,0.9737991266375546,24.035826898022375
Task_35496,2846,773,145,60,205,3.6770025839793283,54.12497060702892
Task_35497,2194,567,191,112,303,3.862676056338028,43.98761757508388
Task_35498,912,178,101,27,128,5.094972067039106,20.756546094281955
Task_35499,586,202,22,10,32,2.8866995073891624,14.579934671733609
Task_35500,559,910,177,88,265,0.6136114160263447,19.03379014448869
Task_35501,2937,754,109,46,155,3.890066225165563,54.939154802904085
Task_35502,2345,174,96,19,115,13.4,42.96248539819222
Task_35503,1945,342,139,138,277,5.670553935860059,39.23828013635358
Task_35504,2694,408,181,63,244,6.58679706601467,50.76689326331914
Task_35505,887,278,71,36,107,3.1792114695340503,20.511790542513292
Task_35506,2121,804,165,97,262,2.634782608695652,43.39945536286175
Task_35507,1389,231,126,97,223,5.987068965517241,29.79712680966691
Task_35508,2670,1021,191,139,330,2.6125244618395302,53.11549711288109
Task_35509,1188,748,118,88,206,1.5861148197596795,28.05202445842367
Task_35510,1869,517,73,180,253,3.608108108108108,38.61672390618594
Task_35511,883,929,129,186,315,0.9494623655913978,24.49314602836843
Task_35512,967,738,163,85,248,1.3085250338294994,24.682827033679967
Task_35513,1501,785,100,88,188,1.9096692111959288,33.064857742273695
Task_35514,1610,550,21,90,111,2.9219600725952812,33.49051051100009
Task_35515,692,774,19,76,95,0.8929032258064517,19.302122952277045
Task_35516,2103,575,22,31,53,3.6510416666666665,40.102044340275924
Task_35517,2372,974,116,105,221,2.4328205128205127,47.7055641376738
Task_35518,2422,141,88,72,160,17.056338028169016,44.5638522506
Task_35519,2123,751,171,168,339,2.8231382978723403,43.687952273123095
Task_35520,650,675,156,54,210,0.9615384615384616,19.141796288486592
Task_35521,1688,856,60,129,189,1.9696616102683782,36.45706597518612
Task_35522,549,378,52,125,177,1.4485488126649078,16.798009568527466
Task_35523,2564,463,123,172,295,5.525862068965517,49.56270949610382
Task_35524,2673,422,32,125,157,6.319148936170213,50.27734841203472
Task_35525,1170,972,11,154,165,1.2024665981500513,28.340164855140838
Task_35526,2413,677,44,153,197,3.5589970501474926,47.40365458227267
Task_35527,1354,392,137,173,310,3.44529262086514,30.25222878515825
Task_35528,2649,658,79,114,193,4.019726858877086,51.049740638973056
Task_35529,1557,507,87,27,114,3.0649606299212597,31.916069946692577
Task_35530,1284,725,183,197,380,1.7685950413223142,30.529602947634043
Task_35531,1244,246,123,128,251,5.036437246963563,27.70137631234645
Task_35532,2230,634,15,145,160,3.5118110236220472,43.96431320061313
Task_35533,1876,897,148,44,192,2.089086859688196,38.86703421979886
Task_35534,2558,603,95,11,106,4.235099337748345,47.965118759179724
Task_35535,1526,1014,111,152,263,1.5034482758620689,34.638782078664356
Task_35536,965,372,51,90,141,2.5871313672922254,23.097090833166934
Task_35537,1976,647,190,162,352,3.049382716049383,41.08251402539356
Task_35538,853,539,17,41,58,1.5796296296296297,20.265761164985427
Task_35539,2564,363,69,38,107,7.043956043956044,47.34304722209031
Task_35540,2794,342,106,107,213,8.145772594752186,52.33290747158187
Task_35541,1223,451,117,64,181,2.7057522123893807,27.31388320324049
Task_35542,941,491,193,82,275,1.9126016260162602,23.667200958134003
Task_35543,2820,69,102,11,113,40.285714285714285,49.19572826251496
Task_35544,936,287,112,192,304,3.25,23.3025539207277
Task_35545,2517,509,53,90,143,4.935294117647059,48.081255901878315
Task_35546,688,464,20,118,138,1.4795698924731182,18.824938675302967
Task_35547,608,345,138,33,171,1.7572254335260116,16.902719037506525
Task_35548,2519,236,108,199,307,10.628691983122362,48.1640836014274
Task_35549,2061,366,23,200,223,5.615803814713897,40.98799241513707
Task_35550,503,655,20,92,112,0.7667682926829268,16.26931543781625
Task_35551,1645,970,195,66,261,1.694129763130793,36.00935857091231
Task_35552,531,716,164,88,252,0.7405857740585774,17.767423445491886
Task_35553,1506,439,165,148,313,3.422727272727273,32.785144565061074
Task_35554,2520,277,29,107,136,9.06474820143885,47.22470942892081
Task_35555,2158,507,87,75,162,4.248031496062992,42.24023900442224
Task_35556,1963,197,95,95,190,9.914141414141413,38.61449275186648
Task_35557,2925,354,100,132,232,8.23943661971831,54.568642875222075
Task_35558,1464,763,72,140,212,1.9162303664921465,32.73206994192132
Task_35559,1116,967,132,131,263,1.1528925619834711,27.93917519977796
Task_35560,2220,215,182,17,199,10.277777777777779,42.02750815602065
Task_35561,728,562,162,21,183,1.2930728241563054,19.504739352807263
Task_35562,2955,355,187,118,305,8.30056179775281,55.355132377239784
Task_35563,1345,395,77,177,254,3.3964646464646466,29.939870035456305
Task_35564,2172,113,33,35,68,19.05263157894737,39.343577345335525
Task_35565,983,720,182,69,251,1.3633841886269071,24.688926808610713
Task_35566,1195,868,16,76,92,1.375143843498274,27.4654085464817
Task_35567,555,458,185,179,364,1.2091503267973855,18.008557758149177
Task_35568,2911,354,46,156,202,8.2,54.28090290581927
Task_35569,2245,688,81,16,97,3.258345428156749,43.155027149521175
Task_35570,1767,169,194,21,215,10.394117647058824,34.61969133576041
Task_35571,2102,744,178,138,316,2.821476510067114,43.18569269601622
Task_35572,2095,860,125,158,283,2.4332171893147505,43.318101308891535
Task_35573,857,713,154,72,226,1.2002801120448179,22.627512178335802
Task_35574,1539,77,64,52,116,19.73076923076923,29.70488312377357
Task_35575,1481,219,130,78,208,6.7318181818181815,30.961077201286685
Task_35576,1949,282,187,200,387,6.886925795053004,39.68471702228363
Task_35577,2343,413,171,46,217,5.659420289855072,44.85732642499632
Task_35578,1358,281,160,177,337,4.815602836879433,30.08028622689739
Task_35579,846,303,137,17,154,2.7828947368421053,20.282357063993306
Task_35580,2796,665,121,195,316,4.198198198198198,54.01337777195956
Task_35581,1825,965,51,180,231,1.8892339544513457,39.262695402397476
Task_35582,1054,373,189,85,274,2.8181818181818183,25.076561533453674
Task_35583,2615,105,96,155,251,24.669811320754718,48.39031089257111
Task_35584,2188,437,131,45,176,4.995433789954338,42.26700071967982
Task_35585,2617,417,147,131,278,6.260765550239235,50.1136737861403
Task_35586,2429,672,91,99,190,3.609212481426449,47.502317931493515
Task_35587,1908,455,138,144,282,4.184210526315789,39.05361408588962
Task_35588,1003,123,170,133,303,8.088709677419354,23.418273716526386
Task_35589,905,751,74,57,131,1.2034574468085106,22.953125571523916
Task_35590,2226,79,176,146,322,27.825,42.37312446717888
Task_35591,1385,833,175,165,340,1.660671462829736,32.238397549772884
Task_35592,1616,908,11,192,203,1.7777777777777777,35.514469886179526
Task_35593,681,856,191,175,366,0.79463243873979,21.30104690914512
Task_35594,823,700,137,197,334,1.174037089871612,22.89576263900861
Task_35595,743,584,135,51,186,1.27008547008547,20.121656435039593
Task_35596,1953,196,112,177,289,9.913705583756345,38.97662099969065
Task_35597,1821,75,46,36,82,23.960526315789473,33.4834263372457
Task_35598,1078,741,127,20,147,1.4528301886792452,25.37235836322847
Task_35599,1935,769,96,37,133,2.512987012987013,39.035453119979046
Task_35600,568,345,187,178,365,1.6416184971098267,17.90973439549479
Task_35601,3000,681,168,157,325,4.39882697947214,57.28029090161747
Task_35602,583,889,93,38,131,0.6550561797752809,18.40758807647182
Task_35603,2366,121,124,53,177,19.39344262295082,43.798594065491244
Task_35604,1568,694,199,72,271,2.256115107913669,34.04996448466757
Task_35605,2326,483,197,180,377,4.805785123966942,46.24152230694724
Task_35606,1781,823,142,92,234,2.1614077669902914,37.85828743441397
Task_35607,2131,77,33,122,155,27.32051282051282,39.64823407146734
Task_35608,1981,252,44,100,144,7.830039525691699,38.669908281570386
Task_35609,2361,253,93,141,234,9.295275590551181,45.355470631764526
Task_35610,681,326,13,127,140,2.0825688073394497,18.338599482300232
Task_35611,2557,407,159,118,277,6.267156862745098,49.1074887379743
Task_35612,2941,127,182,36,218,22.9765625,52.87833107098962
Task_35613,2441,822,101,40,141,2.965978128797084,47.19805267110767
Task_35614,1145,207,135,190,325,5.5048076923076925,26.428054305799083
Task_35615,2090,880,114,54,168,2.3723041997729855,42.300986925890605
Task_35616,2237,332,150,159,309,6.717717717717718,43.997978183937754
Task_35617,2464,283,194,151,345,8.67605633802817,47.567825290944086
Task_35618,2945,520,96,27,123,5.652591170825336,54.04154309497806
Task_35619,1820,695,64,52,116,2.6149425287356323,36.90353318282644
Task_35620,2143,86,51,18,69,24.632183908045977,38.30858043323338
Task_35621,1037,266,24,14,38,3.8838951310861423,21.94058977605606
Task_35622,599,263,45,134,179,2.268939393939394,17.25232775731102
Task_35623,1683,586,96,125,221,2.8671209540034073,35.613019651285185
Task_35624,2555,805,61,127,188,3.1699751861042182,50.0142109509454
Task_35625,2157,764,129,193,322,2.819607843137255,44.22735008055184
Task_35626,1183,864,32,83,115,1.3676300578034681,27.720450627328727
Task_35627,2090,639,90,129,219,3.265625,42.20939081306425
Task_35628,840,698,77,146,223,1.201716738197425,22.64297612457716
Task_35629,822,407,195,142,337,2.014705882352941,21.958137326621593
Task_35630,591,252,41,152,193,2.33596837944664,17.190476728538055
Task_35631,2077,285,53,98,151,7.2622377622377625,40.38562327164623
Task_35632,960,483,132,108,240,1.9834710743801653,23.894398605757573
Task_35633,1770,124,136,192,328,14.16,35.68952048894581
Task_35634,1491,307,18,113,131,4.840909090909091,31.084008731373288
Task_35635,1198,180,93,156,249,6.6187845303867405,26.569090404106007
Task_35636,730,881,73,197,270,0.8276643990929705,21.740722819318265
Task_35637,1687,879,141,103,244,1.9170454545454545,36.65625032238443
Task_35638,2421,888,147,135,282,2.7232845894263216,48.532687499812
Task_35639,1251,218,93,111,204,5.712328767123288,27.51737617150152
Task_35640,2317,379,87,32,119,6.097368421052631,43.5482013118719
Task_35641,1618,885,116,136,252,1.8261851015801354,35.66603337444801
Task_35642,1258,869,53,197,250,1.445977011494253,30.015146943789063
Task_35643,2585,366,35,102,137,7.043596730245231,48.56889819748921
Task_35644,2300,656,22,90,112,3.5007610350076104,44.752665409922294
Task_35645,2446,197,73,62,135,12.353535353535353,45.57217334813601
Task_35646,2538,597,93,89,182,4.2441471571906355,48.91317753912472
Task_35647,1032,504,191,194,385,2.0435643564356436,25.879748111509475
Task_35648,1428,877,38,182,220,1.6264236902050113,32.55030390767194
Task_35649,2604,276,107,101,208,9.40072202166065,49.064912776352685
Task_35650,1851,973,11,174,185,1.9004106776180698,39.31584943715193
Task_35651,2776,607,37,17,54,4.565789473684211,50.75825583771009
Task_35652,2889,1016,48,59,107,2.84070796460177,54.73868808287279
Task_35653,950,752,129,193,322,1.2616201859229748,25.00745966013939
Task_35654,1762,649,155,118,273,2.710769230769231,37.27880513753733
Task_35655,634,144,178,136,314,4.372413793103449,17.82200294379158
Task_35656,1700,384,96,187,283,4.415584415584416,35.607393194314454
Task_35657,1451,157,130,26,156,9.183544303797468,29.186102722982884
Task_35658,2516,878,192,52,244,2.862343572241183,49.45400334566242
Task_35659,1609,126,159,154,313,12.669291338582678,33.0547857570096
Task_35660,1580,611,193,193,386,2.581699346405229,34.89618717967564
Task_35661,2576,383,46,160,206,6.708333333333333,49.10343924989392
Task_35662,1956,956,164,67,231,2.043887147335423,40.77209294732989
Task_35663,1690,696,199,174,373,2.42467718794835,36.81853228037675
Task_35664,1872,727,30,172,202,2.5714285714285716,39.02815027016173
Task_35665,582,572,158,96,254,1.0157068062827226,18.19336449258168
Task_35666,2935,168,13,66,79,17.366863905325445,52.246019364453616
Task_35667,2711,1014,63,103,166,2.670935960591133,52.98409429752956
Task_35668,901,769,108,47,155,1.1701298701298701,22.7409801820361
Task_35669,2093,73,117,54,171,28.283783783783782,38.87652192438599
Task_35670,2627,738,117,114,231,3.554803788903924,51.06536740755356
Task_35671,2303,118,89,26,115,19.352941176470587,42.00440209280901
Task_35672,818,740,57,134,191,1.1039136302294197,22.22648091895037
Task_35673,2615,489,170,69,239,5.336734693877551,49.76695306437097
Task_35674,2013,667,176,152,328,3.0134730538922154,41.608682065534275
Task_35675,1726,540,85,123,208,3.190388170055453,36.08536399788408
Task_35676,2840,781,52,47,99,3.631713554987212,52.84887741243973
Task_35677,1425,935,148,127,275,1.5224358974358974,32.810821221309176
Task_35678,2488,1018,106,83,189,2.4416094210009813,49.42745595224671
Task_35679,2593,560,79,166,245,4.622103386809269,50.161142950709525
Task_35680,2910,66,86,120,206,43.43283582089552,52.4356972741838
Task_35681,1983,642,97,105,202,3.08398133748056,40.42570900568966
Task_35682,2822,241,29,132,161,11.661157024793388,52.05366851817832
Task_35683,2312,602,121,199,320,3.8341625207296848,46.171667113600904
Task_35684,1687,973,153,121,274,1.7320328542094456,37.096425975744474
Task_35685,768,506,66,106,172,1.514792899408284,20.62441513050051
Task_35686,942,282,135,50,185,3.3286219081272086,22.19357710322818
Task_35687,1744,142,36,125,161,12.195804195804195,34.20939147155238
Task_35688,1442,597,27,144,171,2.411371237458194,31.561332246806955
Task_35689,1203,693,96,187,283,1.7334293948126802,28.702707434419484
Task_35690,1258,613,178,54,232,2.04885993485342,28.609420230971242
Task_35691,2377,233,10,167,177,10.158119658119658,45.215070682662734
Task_35692,1182,213,172,198,370,5.5233644859813085,27.24768250169409
Task_35693,601,661,138,150,288,0.9078549848942599,19.022256618382546
Task_35694,2021,897,131,37,168,2.250556792873051,41.02513562417521
Task_35695,1560,972,145,104,249,1.6032887975334018,34.94320853662635
Task_35696,2643,462,99,42,141,5.708423326133909,49.254417186996534
Task_35697,1750,365,171,149,320,4.781420765027322,36.43970226751833
Task_35698,890,413,42,46,88,2.1497584541062804,20.83371991213869
Task_35699,567,712,197,184,381,0.7952314165497896,19.1306181098421
Task_35700,976,732,154,73,227,1.3315143246930423,24.563617298460844
Task_35701,2078,724,25,138,163,2.866206896551724,41.98033049766623
Task_35702,757,731,189,178,367,1.034153005464481,22.066934453647878
Task_35703,1530,402,124,128,252,3.796526054590571,32.74192572859105
Task_35704,2726,967,36,83,119,2.8161157024793386,52.57041651013292
Task_35705,2066,130,153,175,328,15.770992366412214,40.37861992738553
Task_35706,1475,1010,193,130,323,1.4589515331355094,34.045237071409765
Task_35707,533,892,94,185,279,0.5968645016797313,18.81497639043098
Task_35708,2435,956,126,45,171,2.5444096133751306,47.76134391927661
Task_35709,780,438,154,46,200,1.7767653758542141,20.114545426609006
Task_35710,2007,711,139,44,183,2.818820224719101,40.30199065419813
Task_35711,2891,664,134,61,195,4.347368421052631,54.44442267279073
Task_35712,521,327,126,56,182,1.5884146341463414,15.773119719739599
Task_35713,2722,98,84,32,116,27.494949494949495,48.2401544725847
Task_35714,1204,675,44,179,223,1.7810650887573964,28.389275647802183
Task_35715,2913,694,40,61,101,4.19136690647482,54.057351947654546
Task_35716,1213,1006,131,98,229,1.2045680238331677,29.412001765788727
Task_35717,1378,264,53,142,195,5.2,29.71994294842133
Task_35718,1698,361,59,194,253,4.69060773480663,35.43788309571044
Task_35719,1681,399,90,135,225,4.2025,35.00450002541967
Task_35720,681,610,148,105,253,1.1145662847790507,19.84883483976031
Task_35721,1168,378,30,127,157,3.0817941952506596,26.323684310818596
Task_35722,2603,944,122,99,221,2.7544973544973543,51.25777224909037
Task_35723,2604,418,43,172,215,6.214797136038186,49.704071703000274
Task_35724,1698,583,139,195,334,2.9075342465753424,36.44531637813697
Task_35725,640,533,88,59,147,1.198501872659176,18.081000278015285
Task_35726,536,416,84,117,201,1.2853717026378897,16.746110943599266
Task_35727,830,789,83,41,124,1.0506329113924051,21.405719455354113
Task_35728,2434,86,66,95,161,27.977011494252874,44.69716050922124
Task_35729,1143,937,122,114,236,1.2185501066098081,28.131900945448425
Task_35730,2146,715,146,178,324,2.9972067039106145,43.88639278727195
Task_35731,1263,441,17,21,38,2.8574660633484164,26.13410910225132
Task_35732,724,276,47,127,174,2.6137184115523464,19.24898721716662
Task_35733,1337,271,78,25,103,4.915441176470588,27.521985686356004
Task_35734,2648,564,191,122,313,4.686725663716814,51.226845253973465
Task_35735,1226,86,196,152,348,14.091954022988507,26.869706278569037
Task_35736,1415,824,128,129,257,1.715151515151515,32.258885172894
Task_35737,1708,356,30,184,214,4.784313725490196,35.32250449091142
Task_35738,1060,898,198,173,371,1.1790878754171301,27.3956758732167
Task_35739,2578,354,51,112,163,7.261971830985916,48.778185191453765
Task_35740,633,822,158,166,324,0.7691373025516404,20.2329806247765
Task_35741,2030,438,105,187,292,4.624145785876993,41.037767654194
Task_35742,1654,1017,41,131,172,1.62475442043222,36.24560209796387
Task_35743,1790,397,173,71,244,4.49748743718593,36.47807773298682
Task_35744,2070,505,53,96,149,4.090909090909091,41.074663335550866
Task_35745,893,703,112,54,166,1.2684659090909092,22.82353770450632
Task_35746,2303,160,97,180,277,14.304347826086957,44.12238518693838
Task_35747,2781,295,12,134,146,9.39527027027027,51.48484035949378
Task_35748,1638,174,72,188,260,9.36,33.640285904306005
Task_35749,2730,113,165,42,207,23.94736842105263,49.32114065125
Task_35750,1706,322,164,143,307,5.281733746130031,35.53423218312189
Task_35751,1060,892,19,60,79,1.187010078387458,25.03679241261627
Task_35752,601,137,167,184,351,4.355072463768116,17.46357804361629
Task_35753,1496,741,141,34,175,2.0161725067385445,32.26878070829538
Task_35754,1254,475,44,90,134,2.634453781512605,27.892857103737057
Task_35755,1425,878,36,97,133,1.621160409556314,31.92202946971305
Task_35756,1004,853,97,45,142,1.1756440281030445,24.536475087601076
Task_35757,1423,767,178,99,277,1.8528645833333333,32.261940760140824
Task_35758,939,850,173,196,369,1.1034077555816686,25.35043972092981
Task_35759,2788,597,151,90,241,4.662207357859532,53.14635526604459
Task_35760,1016,624,16,142,158,1.6256,24.67669515475519
Task_35761,1486,157,30,106,136,9.405063291139241,30.027447570260506
Task_35762,2591,943,187,177,364,2.7447033898305087,51.82931760524341
Task_35763,2404,934,157,158,315,2.5711229946524066,48.5893348915997
Task_35764,1547,380,20,74,94,4.060367454068241,31.569385247743117
Task_35765,1507,931,76,73,149,1.6169527896995708,33.272560454658375
Task_35766,2385,224,196,88,284,10.6,45.67651520923807
Task_35767,517,321,147,137,284,1.6055900621118013,16.602315617812504
Task_35768,1705,454,113,161,274,3.7472527472527473,35.82613932406847
Task_35769,1561,246,153,200,353,6.319838056680162,33.27493404510137
Task_35770,844,979,84,50,134,0.8612244897959184,22.555104900217472
Task_35771,2744,575,124,14,138,4.763888888888889,51.09691386439933
Task_35772,1958,684,26,72,98,2.858394160583942,39.037904115488296
Task_35773,2576,173,37,184,221,14.804597701149426,48.14870282600629
Task_35774,2318,77,107,58,165,29.71794871794872,42.530922011029965
Task_35775,1187,491,80,154,234,2.41260162601626,27.606786244541414
Task_35776,2613,278,60,132,192,9.365591397849462,49.25708807945864
Task_35777,2309,343,52,197,249,6.712209302325581,45.031340151901816
Task_35778,2155,1011,29,162,191,2.1294466403162056,44.332716468677155
Task_35779,1621,153,54,51,105,10.525974025974026,31.36968467069587
Task_35780,1425,491,171,118,289,2.8963414634146343,31.516323703988636
Task_35781,2096,733,177,90,267,2.8555858310626703,42.73320397239784
Task_35782,1043,68,98,170,268,15.115942028985508,23.622357321178374
Task_35783,2721,852,43,63,106,3.189917936694021,51.725033521122555
Task_35784,2964,228,147,93,240,12.943231441048034,54.68819057637885
Task_35785,1022,912,161,83,244,1.1193866374589265,26.04327903151071
Task_35786,2234,812,36,187,223,2.747847478474785,45.15712916173849
Task_35787,2165,849,66,98,164,2.5470588235294116,43.805797712094574
Task_35788,1082,232,52,125,177,4.643776824034335,24.803065542102075
Task_35789,2968,956,79,187,266,3.1013584117032393,57.47692993002034
Task_35790,1136,678,130,163,293,1.6730486008836525,27.596916262046193
Task_35791,636,667,106,125,231,0.9520958083832335,19.301222840174116
Task_35792,2054,723,188,170,358,2.8370165745856353,42.59565640488628
Task_35793,621,934,45,117,162,0.6641711229946524,19.608527675672065
Task_35794,2989,559,10,145,155,5.3375,55.701676566011734
Task_35795,991,845,85,174,259,1.1713947990543736,25.62421133298881
Task_35796,2282,811,196,100,296,2.810344827586207,46.101375536589956
Task_35797,1951,475,19,19,38,4.098739495798319,37.09223887765395
Task_35798,599,448,82,193,275,1.334075723830735,18.334489795218754
Task_35799,1152,721,25,176,201,1.5955678670360112,27.574239923473503
Task_35800,615,956,83,49,132,0.6426332288401254,19.127155819388065
Task_35801,715,91,82,109,191,7.771739130434782,18.15801798203423
Task_35802,2853,435,17,136,153,6.543577981651376,53.085736390885806
Task_35803,3000,331,36,100,136,9.036144578313253,55.01454729939844
Task_35804,1676,647,124,58,182,2.5864197530864197,35.07120168281438
Task_35805,1483,776,99,186,285,1.9086229086229087,33.41175641402696
Task_35806,987,293,103,89,192,3.357142857142857,23.428004196970466
Task_35807,792,547,184,13,197,1.4452554744525548,20.49396191100858
Task_35808,2742,992,73,113,186,2.7613293051359515,53.5055499794146
Task_35809,793,267,40,97,137,2.958955223880597,19.949647007089734
Task_35810,822,140,184,27,211,5.829787234042553,19.59295308716301
Task_35811,1423,864,101,31,132,1.6450867052023121,31.18712629922752
Task_35812,597,351,111,46,157,1.6960227272727273,16.61376204193
Task_35813,2368,96,31,73,104,24.412371134020617,42.88302349400342
Task_35814,2959,648,198,12,210,4.559322033898305,55.22309628285995
Task_35815,2507,495,96,105,201,5.054435483870968,48.25018197899428
Task_35816,877,959,84,177,261,0.9135416666666667,24.184258130855927
Task_35817,544,92,144,24,168,5.849462365591398,14.45436856293964
Task_35818,1647,193,196,67,263,8.489690721649485,33.62732807499403
Task_35819,633,596,110,23,133,1.0603015075376885,17.82740363548453
Task_35820,1300,1024,51,144,195,1.2682926829268293,30.842026640802562
Task_35821,2343,159,56,110,166,14.64375,44.05808996698079
Task_35822,1776,360,48,90,138,4.919667590027701,35.82864802188539
Task_35823,782,520,129,125,254,1.5009596928982725,21.23751169569751
Task_35824,1385,849,68,58,126,1.6294117647058823,30.814877228161794
Task_35825,2303,178,167,90,257,12.865921787709498,43.851687530494665
Task_35826,2259,578,16,162,178,3.901554404145078,44.512269296824684
Task_35827,1697,982,145,133,278,1.7263479145473042,37.318441155277064
Task_35828,2468,746,22,154,176,3.3038821954484603,48.34203287516569
Task_35829,533,352,15,125,140,1.5099150141643058,16.045797568110284
Task_35830,2733,578,47,55,102,4.72020725388601,50.83279530774464
Task_35831,770,769,11,100,111,1.0,20.805280980570938
Task_35832,665,736,197,91,288,0.9023066485753053,20.138709225456704
Task_35833,618,717,197,175,372,0.8607242339832869,19.870394034554195
Task_35834,1846,119,60,199,259,15.383333333333333,36.58968989655968
Task_35835,686,764,147,23,170,0.8967320261437909,19.4989571595784
Task_35836,1573,545,17,49,66,2.880952380952381,31.72962453148951
Task_35837,2779,160,176,19,195,17.26086956521739,50.446370244642786
Task_35838,1545,301,78,49,127,5.1158940397351,31.40799303641496
Task_35839,1407,808,91,120,211,1.739184177997528,31.86122459732324
Task_35840,1857,1007,52,137,189,1.8422619047619047,39.61866712364665
Task_35841,1471,885,131,84,215,1.6602708803611739,33.009876330787186
Task_35842,655,87,179,159,338,7.443181818181818,17.88501134497275
Task_35843,2242,753,58,162,220,2.973474801061008,45.10408607503546
Task_35844,1534,382,136,97,233,4.005221932114883,32.63789321772679
Task_35845,2835,422,61,57,118,6.702127659574468,52.0864582858577
Task_35846,2165,774,138,49,187,2.793548387096774,43.131370709716386
Task_35847,2554,866,99,142,241,2.9457900807381776,50.39843435034461
Task_35848,2084,559,23,192,215,3.7214285714285715,41.92843721260032
Task_35849,1102,128,121,173,294,8.542635658914728,25.042049453190547
Task_35850,2468,840,92,118,210,2.934601664684899,48.78552066745055
Task_35851,899,196,92,21,113,4.563451776649746,20.57325072215919
Task_35852,1697,294,149,139,288,5.752542372881356,35.206444560729686
Task_35853,1965,499,70,21,91,3.93,38.128645007120774
Task_35854,2042,83,80,160,240,24.30952380952381,39.22009645166051
Task_35855,1117,909,116,79,195,1.2274725274725276,27.30547034239189
Task_35856,2793,78,115,13,128,35.35443037974684,49.20884094846411
Task_35857,1970,667,48,83,131,2.9491017964071857,39.894213040457586
Task_35858,761,351,90,194,284,2.1619318181818183,20.64766149644964
Task_35859,2655,97,78,98,176,27.091836734693878,48.527504683940855
Task_35860,633,471,21,89,110,1.3411016949152543,17.701258910630965
Task_35861,1907,896,107,104,211,2.1259754738015606,40.04778578424298
Task_35862,2336,730,22,125,147,3.19562243502052,45.869739914726495
Task_35863,1192,567,12,76,88,2.0985915492957745,26.474508663270807
Task_35864,641,993,27,196,223,0.6448692152917505,20.55212504275598
Task_35865,848,977,105,66,171,0.8670756646216768,22.993559440376817
Task_35866,1084,458,74,70,144,2.3616557734204795,25.00554791226165
Task_35867,1796,754,176,135,311,2.3788079470198675,38.3424752981577
Task_35868,755,299,117,161,278,2.5166666666666666,20.31721675828986
Task_35869,1209,295,149,74,223,4.08445945945946,26.928133290903006
Task_35870,543,566,120,84,204,0.9576719576719577,17.271716879919985
Task_35871,706,408,181,83,264,1.726161369193154,19.628905210391377
Task_35872,1450,962,43,24,67,1.505711318795431,30.965142854908663
Task_35873,1546,655,27,54,81,2.356707317073171,32.114241097436945
Task_35874,2096,948,86,145,231,2.208640674394099,43.314983267688795
Task_35875,2982,153,192,153,345,19.363636363636363,55.03564379987378
Task_35876,2235,867,163,175,338,2.574884792626728,45.83099591333573
Task_35877,2455,177,52,148,200,13.792134831460674,46.13577222795153
Task_35878,609,535,39,88,127,1.1361940298507462,17.798369737772234
Task_35879,2066,382,137,150,287,5.394255874673629,41.347704562471186
Task_35880,2238,362,106,149,255,6.1652892561983474,43.856761116407846
Task_35881,2258,133,14,133,147,16.850746268656717,42.107876601144994
Task_35882,2822,511,33,82,115,5.51171875,52.64801863078433
Task_35883,1074,241,41,131,172,4.43801652892562,24.62779045468299
Task_35884,1256,362,99,33,132,3.4600550964187327,26.96497256027344
Task_35885,2871,551,50,166,216,5.201086956521739,54.44165354688011
Task_35886,2928,704,116,131,247,4.153191489361702,55.82310912498576
Task_35887,1795,152,145,109,254,11.732026143790849,35.853853882167016
Task_35888,1304,719,108,140,248,1.8111111111111111,30.162673583545512
Task_35889,2533,159,31,183,214,15.83125,47.391832894383704
Task_35890,1083,808,115,148,263,1.338689740420272,26.970621337358384
Task_35891,1232,293,124,196,320,4.190476190476191,28.07955639999382
Task_35892,2579,933,68,58,126,2.7612419700214135,49.98971445280691
Task_35893,792,966,142,156,298,0.8190279214064116,23.03486329091255
Task_35894,1828,75,101,169,270,24.05263157894737,35.909727400888734
Task_35895,1701,907,128,186,314,1.8733480176211454,37.4022935111655
Task_35896,1388,631,71,130,201,2.1962025316455698,31.051897277869713
Task_35897,2400,232,110,71,181,10.300429184549357,45.23629975640563
Task_35898,624,315,168,149,317,1.9746835443037976,18.455118625642402
Task_35899,1756,449,169,135,304,3.902222222222222,36.71442225739987
Task_35900,1413,916,81,42,123,1.5408942202835332,30.975192048628486
Task_35901,544,541,32,21,53,1.003690036900369,15.401496145710896
Task_35902,2986,534,125,17,142,5.581308411214954,54.843800164473244
Task_35903,1522,532,183,162,345,2.855534709193246,33.49864314064466
Task_35904,898,347,200,115,315,2.5804597701149423,22.831539743465186
Task_35905,1082,687,58,12,70,1.572674418604651,24.089503854473335
Task_35906,1940,570,10,19,29,3.3975481611208407,37.15270060696104
Task_35907,2171,81,31,32,63,26.475609756097562,38.9511931877908
Task_35908,2115,772,21,114,135,2.736093143596378,42.407268401224336
Task_35909,655,551,11,162,173,1.1865942028985508,18.92150091168888
Task_35910,764,432,197,163,360,1.7644341801385681,21.239942984865205
Task_35911,595,452,168,170,338,1.3134657836644592,18.505411062985846
Task_35912,696,255,44,52,96,2.71875,17.566964210343176
Task_35913,2882,927,55,182,237,3.105603448275862,55.89502235980688
Task_35914,1765,226,19,183,202,7.775330396475771,35.706146749645164
Task_35915,1590,1000,33,123,156,1.5884115884115884,34.9064157001791
Task_35916,1194,251,120,199,319,4.738095238095238,27.338871456353427
Task_35917,2997,478,101,185,286,6.25678496868476,56.44440642587995
Task_35918,512,534,11,195,206,0.9570093457943926,16.813462962682447
Task_35919,1019,919,149,37,186,1.107608695652174,25.321609036160265
Task_35920,1456,665,71,180,251,2.186186186186186,32.53393649326479
Task_35921,2657,437,103,147,250,6.066210045662101,50.71001304674136
Task_35922,1303,114,39,77,116,11.330434782608696,26.478459270661034
Task_35923,2318,148,132,29,161,15.557046979865772,42.84984125432416
Task_35924,2151,578,106,41,147,3.715025906735751,41.90948356000657
Task_35925,2758,93,102,129,231,29.340425531914892,50.38109442423166
Task_35926,804,931,99,32,131,0.8626609442060086,21.61190437300414
Task_35927,2318,934,172,70,242,2.479144385026738,46.490842063972394
Task_35928,1585,623,42,151,193,2.5400641025641026,34.098288297216826
Task_35929,961,964,12,61,73,0.9958549222797928,23.526755021462588
Task_35930,597,658,152,183,335,0.9059180576631259,19.209816509695397
Task_35931,1202,855,29,45,74,1.4042056074766356,26.73819539934127
Task_35932,2108,98,105,69,174,21.292929292929294,39.329828248708246
Task_35933,1840,546,122,168,290,3.363802559414991,38.33896507105848
Task_35934,608,753,122,189,311,0.8063660477453581,19.58426473220087
Task_35935,2621,908,191,183,374,2.8833883388338832,52.24924312889095
Task_35936,724,368,161,182,343,1.962059620596206,20.370150970004925
Task_35937,1283,165,85,26,111,7.728915662650603,26.205109239852018
Task_35938,1624,198,175,191,366,8.160804020100503,34.18337722244147
Task_35939,1247,122,172,197,369,10.138211382113822,27.650144454228037
Task_35940,2780,663,30,40,70,4.186746987951807,51.146773144098745
Task_35941,594,552,84,25,109,1.074141048824593,16.767276635232133
Task_35942,1407,609,135,59,194,2.3065573770491805,30.765192022479663
Task_35943,1332,893,97,98,195,1.4899328859060403,30.817099749905633
Task_35944,1282,638,168,40,208,2.0062597809076683,28.72349254569575
Task_35945,1928,457,100,192,292,4.209606986899563,39.492054337897365
Task_35946,2571,832,167,49,216,3.086434573829532,49.88958248575784
Task_35947,987,987,126,113,239,0.9989878542510121,25.843872781633767
Task_35948,742,264,54,91,145,2.8,19.20416112985345
Task_35949,2969,177,12,198,210,16.679775280898877,54.24576167159427
Task_35950,1758,930,92,128,220,1.8882921589688506,37.87594467453745
Task_35951,817,1012,126,140,266,0.8065153010858835,23.42147202262849
Task_35952,583,695,189,160,349,0.8376436781609196,19.12153231980365
Task_35953,2535,426,60,43,103,5.936768149882904,46.908155059326
Task_35954,792,760,184,152,336,1.040735873850197,22.533382980871142
Task_35955,1597,652,182,80,262,2.445635528330781,34.470144386189226
Task_35956,2032,622,146,131,277,3.261637239165329,41.50712872996218
Task_35957,2502,412,41,70,111,6.058111380145278,47.00244872902348
Task_35958,1793,260,180,64,244,6.869731800766283,36.021953405110736
Task_35959,2089,555,96,94,190,3.7571942446043165,41.74883038075847
Task_35960,1033,310,102,123,225,3.3215434083601285,24.453646118647253
Task_35961,2705,634,131,190,321,4.25984251968504,52.48876233430642
Task_35962,1983,757,13,44,57,2.6160949868073877,38.83260350776157
Task_35963,1770,852,172,151,323,2.075029308323564,38.31375773102102
Task_35964,1054,129,71,30,101,8.107692307692307,22.346020498118794
Task_35965,1733,471,159,82,241,3.6716101694915255,35.98807287119718
Task_35966,2657,404,130,199,329,6.560493827160494,51.03302645307972
Task_35967,1985,671,106,180,286,2.9538690476190474,41.02951297124742
Task_35968,891,519,128,118,246,1.7134615384615384,22.94310928266144
Task_35969,2778,1003,143,109,252,2.766932270916335,54.37535948077948
Task_35970,518,613,26,84,110,0.8436482084690554,16.335310928814305
Task_35971,2846,779,191,100,291,3.6487179487179486,54.91383009700646
Task_35972,1305,774,182,125,307,1.6838709677419355,30.580190786770345
Task_35973,2456,653,137,167,304,3.7553516819571864,48.49497245280787
Task_35974,893,196,98,156,254,4.532994923857868,22.062508522621993
Task_35975,1870,694,49,73,122,2.6906474820143886,38.089860032743594
Task_35976,587,485,49,103,152,1.2078189300411524,17.397840383279735
Task_35977,1725,538,199,165,364,3.2003710575139146,36.821841184652804
Task_35978,999,910,64,53,117,1.0965971459934138,24.56228994806221
Task_35979,1691,763,62,103,165,2.2133507853403143,36.03964876749342
Task_35980,2917,736,112,189,301,3.9579375848032563,56.07851040023303
Task_35981,1875,248,99,176,275,7.530120481927711,37.857896650262944
Task_35982,2774,347,174,105,279,7.971264367816092,52.32831135180104
Task_35983,2828,313,70,85,155,9.006369426751592,52.356395987210085
Task_35984,2099,508,200,175,375,4.1237721021611,42.711953198779725
Task_35985,2173,424,58,172,230,5.1129411764705885,43.02378188443203
Task_35986,979,575,96,169,265,1.6996527777777777,24.679563719087188
Task_35987,1338,679,185,142,327,1.9676470588235293,30.935515980061947
Task_35988,2017,658,171,43,214,3.0606980273141122,40.458464467204436
Task_35989,2133,159,12,62,74,13.33125,39.39770437214123
Task_35990,1050,175,153,108,261,5.965909090909091,24.183237617035925
Task_35991,2363,938,133,42,175,2.516506922257721,46.62857522097013
Task_35992,1424,700,128,26,154,2.0313837375178316,30.74882561749291
Task_35993,2555,810,18,56,74,3.1504315659679407,48.281599435765095
Task_35994,2398,727,132,193,325,3.293956043956044,47.94253996538612
Task_35995,1869,415,139,10,149,4.492788461538462,36.86072699280094
Task_35996,1900,223,26,86,112,8.482142857142858,37.0069724408001
Task_35997,710,413,137,46,183,1.714975845410628,18.832635055410858
Task_35998,1676,222,17,41,58,7.515695067264574,32.22639327273924
Task_35999,2604,456,141,40,181,5.698030634573304,48.93554966749676
Task_36000,1586,751,118,188,306,2.109042553191489,35.06147143907579
Task_36001,1401,540,125,46,171,2.589648798521257,30.099358933823726
Task_36002,1690,252,11,32,43,6.679841897233201,32.40297129161553
Task_36003,1563,235,108,142,250,6.622881355932203,32.71880855701153
Task_36004,1024,719,17,141,158,1.4222222222222223,25.038883633796647
Task_36005,1719,504,130,159,289,3.403960396039604,36.27206899778435
Task_36006,2952,502,56,125,181,5.868787276341949,55.281110579487915
Task_36007,2508,746,152,138,290,3.357429718875502,49.506507037014025
Task_36008,1231,269,81,97,178,4.559259259259259,27.267647661636556
Task_36009,1247,564,167,189,356,2.207079646017699,29.33416125961509
Task_36010,1092,440,43,147,190,2.4761904761904763,25.693673094324556
Task_36011,792,116,189,107,296,6.769230769230769,19.95282661359428
Task_36012,2818,850,79,132,211,3.3113983548766157,54.43969806973342
Task_36013,555,888,118,23,141,0.6242969628796401,17.801899200888005
Task_36014,2105,739,23,142,165,2.8445945945945947,42.50421719169833
Task_36015,1577,213,198,191,389,7.369158878504673,33.559789317835445
Task_36016,1278,198,141,39,180,6.422110552763819,27.138262106134576
Task_36017,2174,195,178,47,225,11.091836734693878,41.50351025374383
Task_36018,1143,239,157,67,224,4.7625,25.596220469301457
Task_36019,1173,419,129,107,236,2.7928571428571427,27.04410377445014
Task_36020,2295,400,33,61,94,5.723192019950124,43.28430706935746
Task_36021,1955,417,171,180,351,4.677033492822966,40.03829858038007
Task_36022,1839,549,82,36,118,3.3436363636363637,36.49756674966806
Task_36023,2575,407,114,70,184,6.311274509803922,48.58976346142049
Task_36024,2134,123,160,157,317,17.20967741935484,41.3137440623036
Task_36025,2477,620,182,100,282,3.9887278582930756,48.52555629595679
Task_36026,1877,717,58,78,136,2.614206128133705,38.498225222625344
Task_36027,2470,300,144,44,188,8.205980066445182,46.325693641454826
Task_36028,2010,193,56,156,212,10.360824742268042,39.51891668927903
Task_36029,1406,630,162,134,296,2.2282091917591127,31.707939567680715
Task_36030,1789,770,77,169,246,2.3203631647211416,38.1053874950837
Task_36031,737,914,72,35,107,0.805464480874317,20.268127031253343
Task_36032,1489,714,89,110,199,2.0825174825174826,32.79178678409418
Task_36033,1466,631,31,125,156,2.319620253164557,31.832211580426748
Task_36034,2694,1008,106,173,279,2.6699702675916748,53.27529870333084
Task_36035,2257,130,60,122,182,17.229007633587788,42.621372089275035
Task_36036,2307,977,115,15,130,2.3588957055214723,45.42588000107539
Task_36037,2452,335,48,58,106,7.2976190476190474,45.62726572227069
Task_36038,2450,87,178,48,226,27.84090909090909,44.6638616999233
Task_36039,2010,813,129,34,163,2.4692874692874693,40.581508474861934
Task_36040,2666,662,18,30,48,4.0211161387631975,49.22284579690416
Task_36041,1897,562,172,21,193,3.369449378330373,38.07030708076363
Task_36042,946,256,85,79,164,3.6809338521400776,22.48114291147051
Task_36043,830,963,84,95,179,0.8609958506224067,22.982568222590785
Task_36044,892,380,126,15,141,2.341207349081365,21.193725727339928
Task_36045,2373,513,24,49,73,4.616731517509727,44.32257414800898
Task_36046,1520,437,120,134,254,3.470319634703196,32.71388367642207
Task_36047,2762,789,186,195,381,3.4962025316455696,54.15940920534049
Task_36048,1034,780,148,169,317,1.323943661971831,26.381630998551774
Task_36049,2017,577,44,159,203,3.48961937716263,40.851383519691005
Task_36050,1690,66,176,181,357,25.223880597014926,34.17253970014634
Task_36051,1373,269,98,15,113,5.0851851851851855,28.17054506638433
Task_36052,1731,1008,119,73,192,1.7155599603567888,37.23521865110852
Task_36053,1241,739,200,12,212,1.677027027027027,28.294448223033186
Task_36054,2710,665,199,124,323,4.069069069069069,52.57868310785992
Task_36055,1021,916,163,118,281,1.113413304252999,26.328532751116892
Task_36056,1000,147,114,105,219,6.756756756756757,23.14725842286286
Task_36057,2262,820,93,38,131,2.7551766138855056,44.45012559907855
Task_36058,1146,414,22,144,166,2.76144578313253,26.29048652669016
Task_36059,2875,299,46,77,123,9.583333333333334,52.772300933320984
Task_36060,741,117,192,74,266,6.279661016949152,18.68802241517277
Task_36061,1863,434,139,37,176,4.2827586206896555,37.130543068665546
Task_36062,1972,933,84,32,116,2.1113490364025695,39.84930695332013
Task_36063,1716,378,63,147,210,4.527704485488127,35.51275753104624
Task_36064,1068,540,97,169,266,1.9741219963031422,25.9973221577891
Task_36065,1564,503,46,159,205,3.1031746031746033,33.47015436299995
Task_36066,1354,532,91,81,172,2.5403377110694185,29.796846092279726
Task_36067,814,978,191,118,309,0.8314606741573034,23.414427324614945
Task_36068,833,848,127,89,216,0.9811542991755006,22.80911657150003
Task_36069,585,164,89,197,286,3.5454545454545454,17.07956788704339
Task_36070,1186,190,16,194,210,6.209424083769633,26.448299788070333
Task_36071,906,292,37,154,191,3.092150170648464,22.303405385372027
Task_36072,1935,599,87,167,254,3.225,39.80766083244148
Task_36073,793,669,54,111,165,1.1835820895522389,21.468916759680855
Task_36074,994,533,84,12,96,1.8614232209737829,22.875701927141375
Task_36075,575,625,114,35,149,0.9185303514376997,17.243512600375574
Task_36076,1232,159,173,28,201,7.7,26.159879415729524
Task_36077,1504,465,118,146,264,3.227467811158798,32.61267649948136
Task_36078,1777,328,119,163,282,5.401215805471125,36.59370172790994
Task_36079,1531,607,91,154,245,2.518092105263158,33.41428970261437
Task_36080,2701,273,181,75,256,9.857664233576642,50.588907486422706
Task_36081,839,776,45,76,121,1.0797940797940797,21.951145344264575
Task_36082,2428,364,61,62,123,6.652054794520548,45.64359825643379
Task_36083,1139,677,159,139,298,1.6799410029498525,27.62867439690252
Task_36084,1146,796,143,11,154,1.4378920953575909,26.53421995255732
Task_36085,1526,289,126,142,268,5.2620689655172415,32.400511979729906
Task_36086,778,526,150,114,264,1.476280834914611,21.210730846665214
Task_36087,652,266,77,167,244,2.4419475655430714,18.505536717186413
Task_36088,2604,64,147,143,290,40.06153846153846,48.08712093180127
Task_36089,2800,546,176,78,254,5.118829981718465,53.122461457087326
Task_36090,2421,783,115,40,155,3.0880102040816326,46.84342125082741
Task_36091,1516,474,49,106,155,3.191578947368421,32.18583995480872
Task_36092,2733,324,108,136,244,8.409230769230769,51.488002650085946
Task_36093,1330,495,78,79,157,2.681451612903226,29.220800201424648
Task_36094,1840,836,141,12,153,2.198327359617682,37.69557985466175
Task_36095,706,906,27,174,201,0.7783902976846747,21.04219850816669
Task_36096,845,667,94,107,201,1.2649700598802396,22.411241279415066
Task_36097,2821,502,199,87,286,5.608349900596422,53.53153836512868
Task_36098,1545,168,93,71,164,9.142011834319527,31.263665260074873
Task_36099,2441,848,77,17,94,2.8751472320376914,46.75295180141358
Task_36100,884,780,17,142,159,1.1318822023047375,22.985568995702746
Task_36101,2195,826,22,125,147,2.6541717049576783,43.936855532077544
Task_36102,1168,871,114,19,133,1.3394495412844036,27.113282819918297
Task_36103,2262,945,175,87,262,2.3911205073995774,45.96914991529567
Task_36104,1970,414,56,126,182,4.746987951807229,39.4568652380467
Task_36105,1546,772,82,176,258,2.0,34.30137078273931
Task_36106,2292,237,184,58,242,9.630252100840336,43.769666162645876
Task_36107,806,921,96,197,293,0.8741865509761388,23.148268990056962
Task_36108,2342,513,69,153,222,4.556420233463035,45.92578501080239
Task_36109,1213,761,105,88,193,1.5918635170603674,28.457219986260622
Task_36110,917,1013,169,25,194,0.9043392504930966,24.081056715802774
Task_36111,771,787,165,100,265,0.9784263959390863,21.914242787857603
Task_36112,1818,305,11,23,34,5.9411764705882355,34.44588961399106
Task_36113,712,135,64,31,95,5.235294117647059,16.73379022715369
Task_36114,863,723,57,89,146,1.191988950276243,22.520374042047383
Task_36115,1875,616,38,55,93,3.038897893030794,37.339954244109755
Task_36116,1605,132,71,14,85,12.06766917293233,30.872394344956614
Task_36117,2373,788,67,104,171,3.0076045627376424,46.92979700674783
Task_36118,2514,152,86,76,162,16.431372549019606,46.289985416206406
Task_36119,2344,927,43,198,241,2.5258620689655173,47.3585242717
Task_36120,1543,391,44,140,184,3.936224489795918,32.60209131778406
Task_36121,1865,426,125,115,240,4.3676814988290396,38.047630780457574
Task_36122,2665,645,101,38,139,4.125386996904025,50.18721055857188
Task_36123,1719,746,41,197,238,2.3012048192771086,36.87227876859171
Task_36124,1177,469,55,52,107,2.5042553191489363,25.883018561354305
Task_36125,1037,186,200,137,337,5.545454545454546,24.664036437591147
Task_36126,2432,121,98,93,191,19.934426229508198,45.289197548947634
Task_36127,1002,977,146,58,204,1.0245398773006136,25.53650428137675
Task_36128,2194,549,200,50,250,3.9890909090909092,43.171195460513694
Task_36129,2200,507,183,40,223,4.330708661417323,42.91364431701991
Task_36130,1464,564,35,155,190,2.591150442477876,31.983441878876647
Task_36131,2437,764,181,156,337,3.1856209150326795,48.67653136621021
Task_36132,1122,443,19,189,208,2.527027027027027,26.29222323138245
Task_36133,1786,298,156,101,257,5.973244147157191,36.431634966681045
Task_36134,2897,838,135,129,264,3.4529201430274137,55.828185063176704
Task_36135,2456,932,23,62,85,2.632368703108253,47.47850905964459
Task_36136,2365,117,94,83,177,20.04237288135593,43.962574523264436
Task_36137,2539,895,165,60,225,2.833705357142857,49.73372106485751
Task_36138,2290,1014,119,30,149,2.2561576354679804,45.50656246670267
Task_36139,2598,278,57,198,255,9.311827956989248,49.39775922662103
Task_36140,2925,929,46,87,133,3.1451612903225805,55.832531935870286
Task_36141,2140,521,130,191,321,4.099616858237548,43.18276058684512
Task_36142,2545,119,114,155,269,21.208333333333332,47.53597136323066
Task_36143,1880,427,138,31,169,4.392523364485982,37.30100121123821
Task_36144,1410,922,157,120,277,1.5276273022751896,32.5315701096772
Task_36145,2433,446,167,182,349,5.442953020134228,47.691749908406756
Task_36146,2969,1014,115,33,148,2.9251231527093595,56.24809909506077
Task_36147,2976,472,163,176,339,6.291754756871036,56.31796647048346
Task_36148,2683,782,81,82,163,3.426564495530013,51.729099172364506
Task_36149,2168,545,13,193,206,3.970695970695971,43.163431216967744
Task_36150,2015,526,172,81,253,3.823529411764706,40.64777785723408
Task_36151,682,437,124,197,321,1.5570776255707763,19.802608099215615
Task_36152,727,145,187,62,249,4.97945205479452,18.554928423728047
Task_36153,2401,292,68,180,248,8.194539249146757,46.28222180648462
Task_36154,1887,874,84,48,132,2.1565714285714286,38.62474574018039
Task_36155,2497,747,91,147,238,3.338235294117647,49.11356487726136
Task_36156,1113,532,23,22,45,2.0881801125703565,24.145590274816062
Task_36157,2478,478,16,30,46,5.1732776617954075,45.63642020849402
Task_36158,1984,657,129,26,155,3.0151975683890577,39.510488740461064
Task_36159,2302,895,85,160,245,2.5691964285714284,46.54487981279336
Task_36160,612,554,43,37,80,1.1027027027027028,16.860973856214724
Task_36161,775,794,79,193,272,0.9748427672955975,22.178523994325257
Task_36162,1931,693,135,118,253,2.782420749279539,40.003663272255125
Task_36163,1980,503,71,164,235,3.9285714285714284,40.22480843356033
Task_36164,2867,521,199,132,331,5.492337164750958,54.65165093780522
Task_36165,566,707,91,73,164,0.7994350282485876,17.775478889857528
Task_36166,1138,582,176,112,288,1.9519725557461407,27.245138709686007
Task_36167,1977,483,119,143,262,4.0847107438016526,40.144216858929276
Task_36168,2662,552,30,149,179,4.81374321880651,50.826693361219725
Task_36169,2713,295,187,93,280,9.16554054054054,51.152449517254865
Task_36170,627,600,94,144,238,1.043261231281198,18.968712980755623
Task_36171,594,94,187,133,320,6.252631578947368,16.790110532712188
Task_36172,2668,624,128,68,196,4.2688,50.85240607802046
Task_36173,573,283,31,134,165,2.017605633802817,16.811360415005222
Task_36174,1603,616,154,138,292,2.59805510534846,34.77186190968121
Task_36175,547,81,119,183,302,6.670731707317073,16.0325271489534
Task_36176,2764,466,71,177,248,5.918629550321199,52.593746840529526
Task_36177,1294,831,67,181,248,1.5552884615384615,30.447991586350508
Task_36178,1467,577,25,158,183,2.538062283737024,31.985064109996543
Task_36179,2598,187,119,117,236,13.819148936170214,48.804251781111695
Task_36180,763,504,164,44,208,1.510891089108911,20.08410132241161
Task_36181,1395,661,179,156,335,2.107250755287009,31.838717313525933
Task_36182,1793,211,157,108,265,8.45754716981132,36.2823152289647
Task_36183,2247,332,19,77,96,6.747747747747748,42.50462238125639
Task_36184,2150,178,68,30,98,12.011173184357542,39.907100143378145
Task_36185,787,744,137,17,154,1.0563758389261746,20.733763245123914
Task_36186,1421,644,196,12,208,2.2031007751937985,30.8419342799065
Task_36187,1826,412,71,188,259,4.421307506053269,37.637670308865296
Task_36188,2694,1020,79,195,274,2.6385896180215473,53.382427870404165
Task_36189,686,532,174,91,265,1.2870544090056286,19.681328224950658
Task_36190,1716,64,58,148,206,26.4,33.8593015378929
Task_36191,1491,881,90,159,249,1.6904761904761905,33.64240786828943
Task_36192,1499,139,45,113,158,10.707142857142857,30.22196977766062
Task_36193,2010,445,176,118,294,4.506726457399103,40.65175609408101
Task_36194,2150,991,102,42,144,2.1673387096774195,43.15049197608915
Task_36195,1412,364,128,144,272,3.8684931506849316,30.865714746090564
Task_36196,880,190,106,72,178,4.607329842931938,21.151674500400375
Task_36197,2238,598,60,67,127,3.7362270450751254,43.65915645482463
Task_36198,715,273,55,12,67,2.6094890510948905,16.979661125758167
Task_36199,1191,306,174,66,240,3.8794788273615635,26.64524720752479
Task_36200,623,765,18,172,190,0.8133159268929504,19.208199184374212
Task_36201,2346,528,173,183,356,4.434782608695652,46.61276282379229
Task_36202,2403,71,21,110,131,33.375,43.697981172193316
Task_36203,1296,210,130,68,198,6.14218009478673,27.794971627104236
Task_36204,517,935,199,100,299,0.5523504273504274,18.579528945248907
Task_36205,1741,892,15,116,131,1.9496080627099663,36.898563120121786
Task_36206,2659,441,30,12,42,6.015837104072398,48.249500356573435
Task_36207,2552,814,151,169,320,3.1312883435582823,50.59781384179519
Task_36208,1219,520,92,43,135,2.3397312859884836,26.93177606713662
Task_36209,2878,962,104,137,241,2.988577362409138,55.82352166111283
Task_36210,1621,659,77,128,205,2.456060606060606,34.85204056885885
Task_36211,957,395,183,124,307,2.4166666666666665,23.89477951721882
Task_36212,2310,236,175,20,195,9.746835443037975,43.52640841226074
Task_36213,914,612,178,124,302,1.4910277324632952,23.82936719115659
Task_36214,1049,306,97,128,225,3.416938110749186,24.70866998503564
Task_36215,1384,710,62,141,203,1.9465541490857947,31.267655241802398
Task_36216,2671,344,101,162,263,7.742028985507246,50.70027186261149
Task_36217,2643,649,83,65,148,4.0661538461538465,50.297644833413166
Task_36218,2203,675,26,131,157,3.2588757396449703,43.6405770223817
Task_36219,2422,589,28,38,66,4.105084745762712,45.2066677850782
Task_36220,1979,705,195,157,352,2.803116147308782,41.30502534711429
Task_36221,2524,968,135,72,207,2.604747162022704,49.76350223916367
Task_36222,1613,933,127,40,167,1.7269807280513918,34.6780959586377
Task_36223,920,337,198,54,252,2.7218934911242605,22.47852828377802
Task_36224,945,879,103,49,152,1.0738636363636365,23.82125008872926
Task_36225,2539,725,79,135,214,3.497245179063361,49.64454823811439
Task_36226,2998,669,56,45,101,4.474626865671642,55.01572457707193
Task_36227,1009,758,21,49,70,1.3293807641633728,23.52174509883064
Task_36228,1645,468,169,25,194,3.5074626865671643,33.813216920443764
Task_36229,1272,767,128,62,190,1.65625,29.111839867321887
Task_36230,2286,343,190,196,386,6.645348837209302,45.21150558986276
Task_36231,1123,107,80,153,233,10.398148148148149,24.91388312028536
Task_36232,528,127,161,23,184,4.125,14.698541869048048
Task_36233,1334,488,69,141,210,2.7280163599182004,29.816336525624852
Task_36234,1457,893,89,25,114,1.6297539149888143,31.515426952074336
Task_36235,1338,581,112,168,280,2.2989690721649483,30.455188212498268
Task_36236,2967,70,139,158,297,41.7887323943662,53.83910307242366
Task_36237,586,1000,142,112,254,0.5854145854145855,19.744603102368774
Task_36238,680,602,82,138,220,1.1276948590381426,19.73282183332164
Task_36239,2017,953,10,15,25,2.1142557651991614,39.541473309270636
Task_36240,1935,829,13,41,54,2.3313253012048194,38.29421835891714
Task_36241,1318,965,169,16,185,1.3643892339544514,30.058938877621983
Task_36242,1997,663,121,130,251,3.0075301204819276,40.96337564231331
Task_36243,1093,564,60,161,221,1.9345132743362832,26.315463184869326
Task_36244,2147,190,178,12,190,11.24083769633508,40.79645512841674
Task_36245,2753,983,138,193,331,2.7977642276422765,54.395989811528956
Task_36246,1466,475,40,107,147,3.0798319327731094,31.292184746094268
Task_36247,1001,138,191,178,369,7.201438848920863,23.839279420296066
Task_36248,2298,595,145,165,310,3.8557046979865772,45.83280987920114
Task_36249,1089,92,95,21,116,11.709677419354838,22.54854667899998
Task_36250,554,810,71,117,188,0.6831072749691739,18.415299098839352
Task_36251,2538,956,30,29,59,2.652037617554859,48.19739645103275
Task_36252,1713,831,106,195,301,2.058894230769231,37.31059371491729
Task_36253,2457,623,20,77,97,3.9375,46.781295143611466
Task_36254,1203,666,179,88,267,1.8035982008995501,28.34793526444467
Task_36255,1695,204,42,191,233,8.268292682926829,34.703316813240995
Task_36256,1512,362,99,34,133,4.1652892561983474,31.01374373211706
Task_36257,2956,234,123,157,280,12.578723404255319,54.87600330624165
Task_36258,2817,638,84,122,206,4.408450704225352,53.66723887136656
Task_36259,1773,185,96,144,240,9.53225806451613,35.748036491278484
Task_36260,1651,727,55,65,120,2.267857142857143,34.5667600781088
Task_36261,1191,804,184,140,324,1.479503105590062,28.93662962970995
Task_36262,621,182,68,136,204,3.3934426229508197,17.446390382406427
Task_36263,1754,359,138,170,308,4.872222222222222,36.45997019568082
Task_36264,1437,81,96,105,201,17.524390243902438,29.409458768705747
Task_36265,2471,690,16,166,182,3.5759768451519536,48.236646880747685
Task_36266,1159,952,49,147,196,1.2161594963273872,28.3882618287911
Task_36267,775,966,122,173,295,0.8014477766287487,22.791539039378502
Task_36268,2330,890,168,35,203,2.6150392817059482,46.08639892605809
Task_36269,2547,604,171,119,290,4.209917355371901,49.64716949618988
Task_36270,1829,942,96,46,142,1.9395546129374337,37.91835876330061
Task_36271,2214,747,120,196,316,2.9598930481283423,45.0543923002763
Task_36272,687,614,18,31,49,1.1170731707317074,17.89201289206796
Task_36273,2607,625,111,194,305,4.164536741214057,50.841782822434254
Task_36274,2769,586,133,11,144,4.7172061328790456,51.60610984153012
Task_36275,2161,715,48,67,115,3.0181564245810057,42.65827824833709
Task_36276,1746,738,27,105,132,2.3626522327469552,36.49200434992151
Task_36277,876,969,167,195,362,0.9030927835051547,24.731315841940688
Task_36278,2976,911,19,53,72,3.263157894736842,55.28697660474148
Task_36279,836,1001,11,102,113,0.8343313373253493,22.62514833210859
Task_36280,2472,495,121,131,252,4.983870967741935,47.95637601920006
Task_36281,2540,384,165,193,358,6.597402597402597,49.2369018553505
Task_36282,1458,539,45,96,141,2.7,31.38786864054228
Task_36283,1722,205,168,126,294,8.359223300970873,35.29624496779392
Task_36284,2101,773,191,99,290,2.714470284237726,43.080379246758376
Task_36285,842,403,49,161,210,2.0841584158415842,21.813512240572965
Task_36286,2843,544,22,75,97,5.21651376146789,52.64102949818516
Task_36287,1946,1000,100,32,132,1.944055944055944,39.90186211813191
Task_36288,503,880,11,182,193,0.5709421112372304,17.858607530069264
Task_36289,1082,523,33,157,190,2.064885496183206,25.801103828758972
Task_36290,672,821,107,184,291,0.8175182481751825,20.71096521972542
Task_36291,1206,216,147,83,230,5.557603686635945,26.7655969676327
Task_36292,674,870,53,187,240,0.7738231917336394,20.703372868884262
Task_36293,2852,485,166,131,297,5.868312757201646,54.14236801397859
Task_36294,2890,473,66,105,171,6.09704641350211,54.11784049667207
Task_36295,2776,769,84,200,284,3.605194805194805,53.89828518089295
Task_36296,2985,333,53,89,142,8.937125748502995,54.880615313117886
Task_36297,2232,136,49,154,203,16.291970802919707,42.485830502480546
Task_36298,2684,523,95,172,267,5.122137404580153,51.54122597462959
Task_36299,1357,937,166,18,184,1.4466950959488274,30.597108229998664
Task_36300,2524,159,27,98,125,15.775,46.27821445380702
Task_36301,1839,1002,25,57,82,1.8334995014955136,37.83525244222029
Task_36302,1727,820,68,144,212,2.1035322777101095,37.095415600896786
Task_36303,1335,79,157,30,187,16.6875,26.992824032440392
Task_36304,2140,907,74,96,170,2.356828193832599,43.636228166181475
Task_36305,2851,208,68,55,123,13.641148325358852,51.77468985992829
Task_36306,1480,794,149,60,209,1.8616352201257862,32.56761816918915
Task_36307,2709,312,58,86,144,8.654952076677317,50.44556007097933
Task_36308,2507,1015,75,102,177,2.46751968503937,49.80888737695275
Task_36309,1975,148,180,124,304,13.25503355704698,38.920594357454505
Task_36310,2050,770,112,19,131,2.6588845654993514,40.75217185717893
Task_36311,744,491,106,79,185,1.5121951219512195,20.039376395943112
Task_36312,1838,960,108,129,237,1.9125910509885535,39.307273074575406
Task_36313,2477,982,55,195,250,2.5198372329603256,49.726619593816174
Task_36314,1852,638,117,157,274,2.8982785602503913,38.73134973380146
Task_36315,1623,156,57,51,108,10.337579617834395,31.489886752526463
Task_36316,1598,530,114,134,248,3.0094161958568737,34.21740954636666
Task_36317,2208,680,118,41,159,3.2422907488986783,43.164433532923795
Task_36318,2494,737,136,110,246,3.3794037940379402,49.01704725965542
Task_36319,2617,803,158,176,334,3.2549751243781095,51.66647710301066
Task_36320,762,975,156,183,339,0.7807377049180327,22.842163197172166
Task_36321,2767,186,45,105,150,14.796791443850267,50.8615202035807
Task_36322,2159,195,108,175,283,11.01530612244898,42.18027322951691
Task_36323,1597,323,19,160,179,4.929012345679013,33.22479014913016
Task_36324,2551,352,142,112,254,7.2266288951841355,48.71559887583309
Task_36325,2721,543,43,20,63,5.001838235294118,49.68933372185641
Task_36326,1933,884,155,35,190,2.184180790960452,39.71560103850448
Task_36327,1901,290,118,157,275,6.5326460481099655,38.38566029393895
Task_36328,1155,977,106,31,137,1.1809815950920246,27.287270834505893
Task_36329,1558,114,154,101,255,13.547826086956523,31.78584994347072
Task_36330,792,756,100,88,188,1.046235138705416,21.696484912497766
Task_36331,2317,695,28,150,178,3.329022988505747,45.80097444740673
Task_36332,2360,814,148,153,301,2.895705521472393,47.44678206431092
Task_36333,2241,430,188,135,323,5.199535962877031,44.41464222225176
Task_36334,1245,963,43,35,78,1.29149377593361,27.90714748765491
Task_36335,769,778,40,82,122,0.9871630295250321,20.940692292993262
Task_36336,629,747,148,97,245,0.8409090909090909,19.478392444404697
Task_36337,1573,466,186,13,199,3.3683083511777303,32.648205138325345
Task_36338,1334,886,133,173,306,1.503945885005637,31.42405421952037
Task_36339,1458,199,95,62,157,7.29,29.969919490368955
Task_36340,1528,928,30,111,141,1.6447793326157158,33.63553070329246
Task_36341,1243,791,167,98,265,1.5694444444444444,29.400134347604723
Task_36342,2481,348,93,105,198,7.108882521489972,47.37056653444744
Task_36343,1479,496,100,199,299,2.975855130784708,32.550847113739394
Task_36344,2042,988,152,90,242,2.0647118301314458,42.56062508706275
Task_36345,1238,884,20,158,178,1.3988700564971752,29.251531468031605
Task_36346,1396,1013,171,43,214,1.3767258382642997,31.725585637165803
Task_36347,1751,326,127,141,268,5.3547400611620795,36.08050182062341
Task_36348,2684,176,132,121,253,15.163841807909604,49.9235934138596
Task_36349,1023,79,39,10,49,12.7875,20.5856430305758
Task_36350,506,349,127,87,214,1.4457142857142857,16.029944658204787
Task_36351,743,977,199,26,225,0.7597137014314929,21.356818987276753
Task_36352,1441,286,110,166,276,5.020905923344948,31.117985137333378
Task_36353,2645,415,90,18,108,6.358173076923077,48.73870376879906
Task_36354,2664,456,168,47,215,5.829321663019694,50.08528894643326
Task_36355,800,612,184,38,222,1.3050570962479608,21.087579800423445
Task_36356,973,569,175,39,214,1.707017543859649,23.629314652798456
Task_36357,1168,585,143,139,282,1.993174061433447,27.74213633912019
Task_36358,2061,693,140,71,211,2.9697406340057637,41.56253782178264
Task_36359,621,814,200,153,353,0.7619631901840491,20.128909520799766
Task_36360,1570,821,174,198,372,1.9099756690997567,35.33820702829169
Task_36361,1628,634,114,66,180,2.563779527559055,34.31516258507845
Task_36362,2122,248,94,76,170,8.522088353413654,40.933945794904844
Task_36363,1144,866,75,91,166,1.3194925028835063,27.61251305732435
Task_36364,1311,732,174,58,232,1.7885402455661665,29.809019715588203
Task_36365,2872,424,131,108,239,6.75764705882353,53.96289431052262
Task_36366,2285,463,122,83,205,4.924568965517241,44.53845052557981
Task_36367,898,700,178,188,366,1.2810271041369472,24.213348850364536
Task_36368,946,850,191,190,381,1.1116333725029377,25.492125607281068
Task_36369,2479,941,83,97,180,2.6316348195329087,49.15279792072678
Task_36370,1975,530,139,55,194,3.71939736346516,39.522373537062464
Task_36371,588,899,86,106,192,0.6533333333333333,19.159692061116697
Task_36372,2408,555,127,197,324,4.330935251798561,47.55722288538868
Task_36373,663,238,86,87,173,2.774058577405858,17.964589727587096
Task_36374,1157,315,136,106,242,3.661392405063291,26.482356137333582
Task_36375,2970,833,33,87,120,3.5611510791366907,56.02147492554513
Task_36376,999,1009,193,141,334,0.9891089108910891,26.59174215773616
Task_36377,2295,406,38,31,69,5.638820638820639,42.62554779209186
Task_36378,762,587,110,63,173,1.2959183673469388,20.391691893601248
Task_36379,2774,344,176,47,223,8.040579710144927,51.486986604079796
Task_36380,2648,435,118,18,136,6.073394495412844,49.131409203745655
Task_36381,2501,553,101,173,274,4.514440433212997,48.76288573622376
Task_36382,2404,125,33,41,74,19.07936507936508,43.11827743419489
Task_36383,2737,681,60,108,168,4.013196480938417,52.35621748322266
Task_36384,1287,331,119,34,153,3.8765060240963853,27.431525309558733
Task_36385,2440,640,139,110,249,3.8065522620904835,47.86893644846439
Task_36386,653,669,66,171,237,0.9746268656716418,19.678779016167496
Task_36387,513,881,33,115,148,0.5816326530612245,17.62388294309697
Task_36388,2756,788,107,156,263,3.4930291508238276,53.47220319152134
Task_36389,734,77,87,46,133,9.41025641025641,16.919356505446306
Task_36390,2320,746,159,156,315,3.105756358768407,46.66733117039113
Task_36391,2501,296,68,181,249,8.42087542087542,47.88321017224726
Task_36392,2761,630,47,101,148,4.375594294770206,52.30634812536536
Task_36393,2147,544,187,23,210,3.9394495412844037,42.07002283409823
Task_36394,949,844,73,123,196,1.123076923076923,24.638841435149118
Task_36395,1874,804,78,96,174,2.327950310559006,39.142964205584384
Task_36396,2801,943,199,197,396,2.9671610169491527,55.33054139550293
Task_36397,1467,491,193,25,218,2.981707317073171,31.176825806508745
Task_36398,1059,660,147,24,171,1.6021180030257187,24.99523676544251
Task_36399,1859,471,152,79,231,3.9385593220338984,37.90206299845806
Task_36400,1611,757,105,146,251,2.12532981530343,35.166780506690195
Task_36401,1749,941,123,76,199,1.856687898089172,37.41732920443113
Task_36402,2768,784,165,24,189,3.5261146496815288,52.563553846963536
Task_36403,1516,920,170,22,192,1.6460369163952226,33.15050175540446
Task_36404,1003,185,18,117,135,5.39247311827957,22.79271310102797
Task_36405,2284,679,92,103,195,3.3588235294117648,45.275352117927014
Task_36406,1351,796,187,77,264,1.6951066499372647,30.951703711288157
Task_36407,2610,644,126,103,229,4.046511627906977,50.473728795978026
Task_36408,1177,519,109,87,196,2.2634615384615384,27.152450860923995
Task_36409,532,390,97,138,235,1.360613810741688,16.799111353305072
Task_36410,2416,749,14,19,33,3.2213333333333334,45.279137213095915
Task_36411,2288,281,195,155,350,8.113475177304965,44.807083019079634
Task_36412,1869,475,164,69,233,3.926470588235294,37.88543044587369
Task_36413,851,91,32,138,170,9.25,20.052490884908448
Task_36414,2156,726,50,11,61,2.9656121045392023,41.26378066524375
Task_36415,2665,886,64,17,81,3.004509582863585,50.256748333549865
Task_36416,1919,866,122,29,151,2.2133794694348325,39.143592052362074
Task_36417,1731,462,17,179,196,3.73866090712743,35.89635255242541
Task_36418,959,559,111,127,238,1.7125,24.121946828358933
Task_36419,2066,461,39,17,56,4.471861471861472,39.04873785016411
Task_36420,1125,313,120,180,300,3.582802547770701,26.339720276551702
Task_36421,1919,692,45,36,81,2.769119769119769,37.97932730208226
Task_36422,2272,347,110,192,302,6.528735632183908,44.61910733979287
Task_36423,1453,618,189,33,222,2.347334410339257,31.424411797521234
Task_36424,1952,496,31,128,159,3.9275653923541247,39.113614999814814
Task_36425,2127,588,122,59,181,3.6112054329371817,42.014268833724415
Task_36426,2494,896,161,77,238,2.7803790412486067,49.264855742406446
Task_36427,862,953,105,120,225,0.9035639412997903,23.732612153489907
Task_36428,2485,537,74,164,238,4.618959107806692,48.343344898803046
Task_36429,2676,746,136,107,243,3.5823293172690764,51.910636851095965
Task_36430,1370,903,68,190,258,1.5154867256637168,31.93327940541758
Task_36431,1837,825,195,188,383,2.223970944309927,39.615843998024694
Task_36432,666,752,193,15,208,0.8844621513944223,19.306310785321266
Task_36433,1308,348,46,123,169,3.7478510028653296,28.659240971778107
Task_36434,1078,131,156,107,263,8.166666666666666,24.436362657174783
Task_36435,678,398,19,11,30,1.699248120300752,16.661966661052244
Task_36436,1230,356,146,19,165,3.4453781512605044,26.736226764905002
Task_36437,1504,943,60,104,164,1.5932203389830508,33.60475611446976
Task_36438,993,231,31,182,213,4.280172413793103,23.59095449791975
Task_36439,1032,708,51,132,183,1.4555712270803949,25.52594742665242
Task_36440,2886,96,150,188,338,29.75257731958763,52.948573497788225
Task_36441,533,137,199,101,300,3.86231884057971,16.041137739286757
Task_36442,1388,588,97,92,189,2.3565365025466893,30.704240466983425
Task_36443,605,344,148,143,291,1.7536231884057971,18.106988690592644
Task_36444,2101,723,15,175,190,2.9019337016574585,42.5708443686241
Task_36445,2596,998,111,73,184,2.5985985985985987,50.85118743455018
Task_36446,2972,96,154,14,168,30.63917525773196,52.463256761747324
Task_36447,531,545,122,27,149,0.9725274725274725,16.273915497523998
Task_36448,1117,720,148,131,279,1.5492371705963939,27.287339052381785
Task_36449,1240,624,42,186,228,1.984,28.846516052130628
Task_36450,556,127,66,198,264,4.34375,16.41300202211616
Task_36451,2195,692,119,89,208,3.167388167388167,43.894398193990156
Task_36452,1499,242,66,183,249,6.1687242798353905,31.865281287357472
Task_36453,1466,142,21,20,41,10.251748251748252,28.259679842675755
Task_36454,2788,820,85,100,185,3.3958587088915957,53.61878778425413
Task_36455,2528,709,140,111,251,3.5605633802816903,49.491418336038485
Task_36456,853,998,151,89,240,0.8538538538538538,23.70048165231603
Task_36457,666,374,89,13,102,1.776,17.17739826533837
Task_36458,1178,695,37,68,105,1.6925287356321839,26.8305504568507
Task_36459,2572,885,69,68,137,2.9029345372460496,49.87662144913592
Task_36460,1531,446,129,109,238,3.4250559284116333,32.808005200143874
Task_36461,1324,896,34,109,143,1.47603121516165,30.28374944492553
Task_36462,2897,894,17,142,159,3.2368715083798882,55.315581365240654
Task_36463,2849,911,87,19,106,3.12390350877193,53.491268458868994
Task_36464,1447,771,164,187,351,1.8743523316062176,33.12310195369519
Task_36465,2119,221,29,119,148,9.545045045045045,40.770086577980585
Task_36466,553,605,191,100,291,0.9125412541254125,18.025947127876382
Task_36467,2806,198,143,42,185,14.100502512562814,51.27319898196989
Task_36468,833,342,19,52,71,2.4285714285714284,19.54573608757919
Task_36469,2850,143,139,140,279,19.791666666666668,52.56511783977575
Task_36470,964,596,42,42,84,1.6147403685092128,22.637102173031064
Task_36471,2891,244,30,54,84,11.8,52.07331299372159
Task_36472,2543,634,196,159,355,4.004724409448819,50.03080735689603
Task_36473,2357,511,113,134,247,4.603515625,46.169215028772605
Task_36474,1075,939,167,26,193,1.1436170212765957,26.2821095256423
Task_36475,1531,297,139,74,213,5.1375838926174495,31.980445191612194
Task_36476,2244,446,135,103,238,5.02013422818792,44.084252655312184
Task_36477,2319,511,196,81,277,4.529296875,45.52098673823002
Task_36478,566,182,137,100,237,3.092896174863388,16.59723068862748
Task_36479,552,340,130,146,276,1.6187683284457477,17.192874950598615
Task_36480,1094,824,37,138,175,1.3260606060606062,26.76859940510244
Task_36481,1111,352,150,85,235,3.1473087818696883,25.73519789303843
Task_36482,1837,110,132,95,227,16.54954954954955,35.99849471565988
Task_36483,1328,607,73,57,130,2.1842105263157894,29.15533063269829
Task_36484,2274,402,94,198,292,5.642679900744417,44.80795620124122
Task_36485,629,879,22,165,187,0.7147727272727272,19.74997574744762
Task_36486,1823,478,98,172,270,3.805845511482255,37.77317140127355
Task_36487,2682,244,66,10,76,10.946938775510205,48.103444692296186
Task_36488,1423,942,42,124,166,1.5090137857900319,32.29162194082583
Task_36489,2730,680,81,12,93,4.008810572687224,50.790304297449275
Task_36490,1427,587,111,196,307,2.42687074829932,32.0461497510235
Task_36491,2849,749,19,103,122,3.7986666666666666,53.84393933817276
Task_36492,2399,860,38,76,114,2.786295005807201,46.988511670153876
Task_36493,706,529,51,175,226,1.3320754716981131,20.09564251947717
Task_36494,1966,132,51,171,222,14.781954887218046,38.38344445191934
Task_36495,1518,597,77,19,96,2.5384615384615383,31.356201265038862
Task_36496,866,976,183,158,341,0.8863868986693961,24.437936668429476
Task_36497,2456,669,194,14,208,3.665671641791045,47.3027642813492
Task_36498,1909,565,198,133,331,3.372791519434629,39.62527135394252
Task_36499,1718,378,127,125,252,4.532981530343008,35.63432365638137
Task_36500,2168,439,17,55,72,4.927272727272728,40.9657659411603
Task_36501,760,249,128,191,319,3.04,20.463285984534313
Task_36502,859,285,148,119,267,3.0034965034965033,21.80507861740914
Task_36503,2647,345,112,67,179,7.6502890173410405,49.50435488825241
Task_36504,975,76,109,195,304,12.662337662337663,22.750742824412157
Task_36505,2322,698,187,69,256,3.3218884120171674,45.870269367049424
Task_36506,1495,199,77,77,154,7.475,30.74137396670596
Task_36507,650,64,23,116,139,10.0,16.319900015974035
Task_36508,1636,835,142,113,255,1.9569377990430623,35.775538495436216
Task_36509,965,637,72,90,162,1.5125391849529781,23.99068478533617
Task_36510,1457,74,155,130,285,19.426666666666666,30.14510040881591
Task_36511,1952,879,184,158,342,2.2181818181818183,41.37746067591916
Task_36512,1787,303,153,16,169,5.878289473684211,35.314834008095616
Task_36513,1696,96,98,190,288,17.484536082474225,34.042330753462515
Task_36514,905,796,81,25,106,1.1355081555834379,22.42231591425207
Task_36515,1863,733,172,100,272,2.5381471389645776,39.11110616684029
Task_36516,590,349,191,112,303,1.6857142857142857,17.89413541537211
Task_36517,978,347,57,23,80,2.810344827586207,21.771906124500834
Task_36518,2697,794,136,149,285,3.392452830188679,52.64522993346552
Task_36519,1568,774,191,86,277,2.023225806451613,34.501475279507325
Task_36520,1665,230,88,12,100,7.207792207792208,32.50726127591389
Task_36521,2437,422,58,198,256,5.761229314420804,47.35049298902323
Task_36522,938,208,128,151,279,4.488038277511961,22.89904935066591
Task_36523,2210,483,136,117,253,4.566115702479339,43.753986335016926
Task_36524,2120,1004,118,58,176,2.109452736318408,43.20079605300662
Task_36525,860,564,184,36,220,1.5221238938053097,21.855224465499848
Task_36526,2350,835,167,103,270,2.811004784688995,47.14105802651398
Task_36527,2354,325,101,160,261,7.220858895705521,45.60959947075465
Task_36528,2703,247,92,80,172,10.899193548387096,50.197034704514344
Task_36529,1187,918,92,108,200,1.2916213275299238,28.60214306299274
Task_36530,1207,234,97,130,227,5.136170212765958,26.978434179338123
Task_36531,1090,204,176,189,365,5.317073170731708,25.728148095016934
Task_36532,2990,878,165,173,338,3.401592718998862,57.82527082075611
Task_36533,2867,493,87,166,253,5.803643724696356,54.21919610009027
Task_36534,2291,926,91,41,132,2.471413160733549,45.161665039772025
Task_36535,2844,730,121,11,132,3.8905608755129957,53.19019384979064
Task_36536,1682,601,76,15,91,2.7940199335548175,33.92842613957151
Task_36537,1284,884,188,44,232,1.4508474576271186,29.628953217725527
Task_36538,2589,882,87,138,225,2.9320498301245754,50.883657959026465
Task_36539,1105,750,62,189,251,1.4713715046604527,27.209623901090893
Task_36540,828,612,131,145,276,1.3507340946166395,22.376833987339197
Task_36541,1618,634,198,156,354,2.548031496062992,35.37177320288637
Task_36542,1230,803,79,10,89,1.5298507462686568,27.35071751880254
Task_36543,2227,516,15,74,89,4.307543520309478,42.7438091260421
Task_36544,1630,992,113,126,239,1.6414904330312186,36.10168889878003
Task_36545,1826,571,188,94,282,3.1923076923076925,38.04530263163959
Task_36546,848,728,137,32,169,1.1632373113854595,21.91135567820271
Task_36547,1456,437,140,189,329,3.324200913242009,32.11962124293895
Task_36548,629,531,117,117,234,1.1823308270676691,18.730527433791693
Task_36549,2656,545,105,196,301,4.864468864468864,51.34690739825885
Task_36550,2373,735,164,47,211,3.224184782608696,46.35025659898736
Task_36551,2319,614,114,22,136,3.770731707317073,44.52381806654045
Task_36552,1401,487,130,40,170,2.8709016393442623,29.919442957001312
Task_36553,1332,139,109,74,183,9.514285714285714,27.738473865847496
Task_36554,1460,983,109,194,303,1.483739837398374,33.73866137574599
Task_36555,1615,950,10,153,163,1.698212407991588,35.33306425889064
Task_36556,586,933,84,74,158,0.6274089935760171,18.90888757291668
Task_36557,1860,590,45,199,244,3.1472081218274113,38.66115809338516
Task_36558,1027,828,89,161,250,1.238841978287093,26.052622218612328
Task_36559,1039,532,175,173,348,1.949343339587242,25.880837786117155
Task_36560,864,652,49,176,225,1.3231240428790199,22.97522369083795
Task_36561,1057,285,180,187,367,3.695804195804196,25.485395219887977
Task_36562,631,243,38,62,100,2.5860655737704916,16.561788775752145
Task_36563,2749,132,197,110,307,20.669172932330827,50.95199277467672
Task_36564,2226,902,166,58,224,2.4651162790697674,44.799571130006846
Task_36565,775,477,142,145,287,1.6213389121338913,21.19967891550702
Task_36566,2151,221,11,108,119,9.68918918918919,41.005765535227084
Task_36567,2391,982,126,113,239,2.4323499491353,48.12442207595322
Task_36568,1626,713,121,190,311,2.277310924369748,35.60193368008904
Task_36569,2928,988,23,58,81,2.9605662285136503,55.058022679322356
Task_36570,2497,582,111,111,222,4.283018867924528,48.467012672205044
Task_36571,1874,548,51,52,103,3.413479052823315,37.155074998632664
Task_36572,2367,871,20,91,111,2.7144495412844036,46.4803614166456
Task_36573,2781,174,35,25,60,15.891428571428571,49.455548326100704
Task_36574,2837,360,184,76,260,7.858725761772853,53.06963027283592
Task_36575,2941,66,52,155,207,43.8955223880597,53.00948446109792
Task_36576,834,432,110,28,138,1.926096997690531,20.495765536834117
Task_36577,2104,1015,88,160,248,2.0708661417322833,43.74724005451182
Task_36578,2523,205,150,136,286,12.24757281553398,47.91970768113409
Task_36579,1289,282,76,111,187,4.554770318021202,28.273544998538814
Task_36580,1889,400,33,96,129,4.71072319201995,37.77293883390487
Task_36581,2669,991,178,172,350,2.690524193548387,53.144659250796394
Task_36582,2247,533,41,80,121,4.207865168539326,43.61531010424287
Task_36583,2322,782,132,39,171,2.9655172413793105,45.4334845414474
Task_36584,554,881,21,36,57,0.6281179138321995,16.919357424833926
Task_36585,1674,666,175,75,250,2.5097451274362816,35.59513302126613
Task_36586,2090,446,79,57,136,4.675615212527965,40.72597807689372
Task_36587,760,423,157,57,214,1.7924528301886793,20.035938478290905
Task_36588,1324,561,72,121,193,2.3558718861209966,29.7696359670486
Task_36589,2081,913,198,168,366,2.2768052516411377,43.65022862472214
Task_36590,1483,517,106,171,277,2.862934362934363,32.54045956748542
Task_36591,2714,170,98,150,248,15.871345029239766,50.439769674937516
Task_36592,2694,699,135,103,238,3.8485714285714288,52.01903058929497
Task_36593,1971,105,170,177,347,18.59433962264151,38.724887560972775
Task_36594,1777,443,108,38,146,4.002252252252252,35.605222461344695
Task_36595,2437,1023,156,70,226,2.3798828125,48.581675305675255
Task_36596,764,676,123,58,181,1.1285081240768096,20.691640896045495
Task_36597,842,400,77,99,176,2.0997506234413965,21.49973732872118
Task_36598,902,674,21,119,140,1.3362962962962963,22.873887173592
Task_36599,2346,136,64,184,248,17.124087591240876,44.512482476728714
Task_36600,2012,667,16,53,69,3.0119760479041915,39.25079912006978
Task_36601,2034,457,139,16,155,4.441048034934497,39.59474297970457
Task_36602,832,871,39,68,107,0.9541284403669725,21.929077819254076
Task_36603,1055,617,95,199,294,1.7071197411003236,26.19147244086564
Task_36604,1581,633,175,96,271,2.493690851735016,34.34889862179262
Task_36605,1652,477,93,125,218,3.4560669456066946,34.79403048507096
Task_36606,2360,298,132,143,275,7.892976588628763,45.64933586342075
Task_36607,2997,251,181,173,354,11.892857142857142,55.94643531215966
Task_36608,2182,717,134,111,245,3.0389972144846795,44.008672016086194
Task_36609,679,639,85,36,121,1.0609375,18.479623932773105
Task_36610,2832,318,112,176,288,8.877742946708464,53.28953486361718
Task_36611,1870,495,53,74,127,3.7701612903225805,37.63772988289286
Task_36612,2464,163,19,96,115,15.024390243902438,45.2005233858663
Task_36613,673,72,39,45,84,9.219178082191782,15.430711037211838
Task_36614,1418,228,195,145,340,6.192139737991266,30.81399407311201
Task_36615,1497,256,82,51,133,5.824902723735408,30.686104357191805
Task_36616,2430,564,21,150,171,4.300884955752212,47.10299554035976
Task_36617,2214,640,108,91,199,3.453978159126365,43.981356331519464
Task_36618,2535,666,119,174,293,3.800599700149925,49.748083245247564
Task_36619,1344,256,46,69,115,5.229571984435798,28.251270796950703
Task_36620,2277,69,114,55,169,32.52857142857143,41.783262216274
Task_36621,1496,585,196,85,281,2.5529010238907848,32.775624973639616
Task_36622,1978,583,183,132,315,3.386986301369863,40.70135798853978
Task_36623,2741,558,14,139,153,4.903398926654741,51.740999203085636
Task_36624,2227,563,18,102,120,3.948581560283688,43.36349936485488
Task_36625,1768,122,36,176,212,14.373983739837398,35.07360769552634
Task_36626,1430,367,148,198,346,3.885869565217391,31.572878817581657
Task_36627,608,737,178,159,337,0.8238482384823849,19.591936335593946
Task_36628,2226,525,14,76,90,4.231939163498099,42.76806401527674
Task_36629,2467,322,72,29,101,7.637770897832818,45.627876742861616
Task_36630,855,727,130,102,232,1.1744505494505495,22.887420385766493
Task_36631,1697,161,129,92,221,10.475308641975309,34.07780360209638
Task_36632,1570,215,42,97,139,7.268518518518518,32.075115616437195
Task_36633,2769,417,28,92,120,6.624401913875598,51.4678621606227
Task_36634,1974,771,20,98,118,2.55699481865285,39.99992562295085
Task_36635,1653,241,117,117,234,6.830578512396694,34.05288003490758
Task_36636,2350,782,95,97,192,3.001277139208174,46.65340491871859
Task_36637,2417,103,24,48,72,23.240384615384617,43.26883221395108
Task_36638,2306,913,105,81,186,2.5229759299781183,46.142484611127635
Task_36639,1924,697,41,114,155,2.7564469914040113,39.28728576392266
Task_36640,1795,628,105,33,138,2.853736089030207,36.33558967497149
Task_36641,1529,132,163,189,352,11.496240601503759,32.06245833388379
Task_36642,512,467,14,15,29,1.0940170940170941,14.3233162256317
Task_36643,1293,227,111,24,135,5.671052631578948,27.02811306993533
Task_36644,2327,977,53,74,127,2.3793456032719837,46.39127351695188
Task_36645,2256,283,193,11,204,7.943661971830986,42.86724091062115
Task_36646,2481,456,48,29,77,5.428884026258205,45.7744364735461
Task_36647,592,952,194,68,262,0.621196222455404,19.503605035294253
Task_36648,2000,523,118,60,178,3.816793893129771,39.79203945967596
Task_36649,1477,782,109,142,251,1.8863346104725416,33.11595413388383
Task_36650,1408,220,28,96,124,6.3710407239819,29.39172297272226
Task_36651,2865,734,47,170,217,3.8979591836734695,54.88214187372957
Task_36652,1587,908,188,148,336,1.7458745874587458,35.62904503477039
Task_36653,2446,412,65,136,201,5.9225181598062955,47.1211260474681
Task_36654,1332,255,35,32,67,5.203125,26.880822984921853
Task_36655,2509,593,159,151,310,4.223905723905724,49.14738422613186
Task_36656,991,621,125,89,214,1.5932475884244373,24.619737653854497
Task_36657,2009,1003,34,199,233,2.000996015936255,42.24727597980376
Task_36658,2345,390,32,129,161,5.997442455242966,45.02965949510758
Task_36659,703,870,139,128,267,0.8071182548794489,21.16331122537918
Task_36660,1256,273,44,142,186,4.583941605839416,27.692763488968158
Task_36661,1361,547,109,134,243,2.4835766423357666,30.495958657668197
Task_36662,1958,605,62,141,203,3.231023102310231,40.02974263606712
Task_36663,641,629,103,100,203,1.0174603174603174,19.052235045714923
Task_36664,2328,884,149,68,217,2.630508474576271,46.37911876450331
Task_36665,1963,425,97,162,259,4.607981220657277,39.757548814481844
Task_36666,835,639,192,152,344,1.3046875,22.874092420678064
Task_36667,2351,733,132,122,254,3.2029972752043596,46.792793845095446
Task_36668,2903,955,80,124,204,3.036610878661088,56.0652909193636
Task_36669,2022,782,30,102,132,2.582375478927203,41.010776300319776
Task_36670,2385,697,23,49,72,3.4169054441260744,45.1284839093282
Task_36671,657,533,39,78,117,1.2303370786516854,18.35926363036774
Task_36672,2418,267,27,50,77,9.022388059701493,44.25120103665768
Task_36673,2744,716,66,168,234,3.8270571827057185,53.01946228950188
Task_36674,1908,920,110,174,284,2.0716612377850163,40.56994287565145
Task_36675,1037,239,145,52,197,4.320833333333334,23.792965736894413
Task_36676,1614,611,107,157,264,2.6372549019607843,34.8320122589638
Task_36677,2203,716,43,182,225,3.0725244072524407,44.368782523540766
Task_36678,2298,139,63,165,228,16.414285714285715,43.655315139638
Task_36679,1952,477,12,121,133,4.083682008368201,38.929976148382764
Task_36680,1679,846,15,174,189,1.9822904368358913,36.26353918090553
Task_36681,1049,863,27,135,162,1.2141203703703705,25.95360968493937
Task_36682,2001,745,138,192,330,2.6823056300268098,41.73107676399789
Task_36683,889,173,146,85,231,5.109195402298851,21.378264793605467
Task_36684,881,654,97,196,293,1.3450381679389314,23.493810523424575
Task_36685,2927,719,42,106,148,4.065277777777778,55.20387592786509
Task_36686,2209,874,104,187,291,2.5245714285714285,45.24664267731557
Task_36687,2693,228,174,34,208,11.759825327510917,49.685001852957605
Task_36688,1274,1013,164,18,182,1.2564102564102564,29.52216359430201
Task_36689,1256,133,78,54,132,9.373134328358208,26.073415413047787
Task_36690,1529,382,79,46,125,3.9921671018276763,31.225695691024836
Task_36691,2430,626,111,44,155,3.875598086124402,46.488877900189834
Task_36692,1798,890,197,62,259,2.0179573512906845,38.13686577610088
Task_36693,2840,891,17,157,174,3.1838565022421523,54.662694170565885
Task_36694,2561,548,168,92,260,4.664845173041894,49.46327385282006
Task_36695,1366,653,139,153,292,2.08868501529052,31.15618419597774
Task_36696,2912,465,154,180,334,6.24892703862661,55.26522357328846
Task_36697,2396,241,63,60,123,9.900826446280991,44.64426957335684
Task_36698,1157,66,91,33,124,17.26865671641791,23.445925718690265
Task_36699,798,645,93,190,283,1.2352941176470589,22.114621785110604
Task_36700,1578,378,19,65,84,4.163588390501319,31.88747256867971
Task_36701,957,489,190,165,355,1.953061224489796,24.467610562259143
Task_36702,2785,433,189,126,315,6.417050691244239,52.98479780177674
Task_36703,2315,753,131,89,220,3.070291777188329,46.041145849382126
Task_36704,1706,130,143,121,264,13.022900763358779,34.34367860528451
Task_36705,2300,950,14,194,208,2.4185068349106205,46.545335068147004
Task_36706,1760,704,175,160,335,2.49645390070922,37.760608603302956
Task_36707,1737,879,111,43,154,1.9738636363636364,36.28370955910748
Task_36708,1400,908,23,175,198,1.54015401540154,32.045308444056154
Task_36709,2793,377,62,163,225,7.388888888888889,52.639900154828275
Task_36710,2791,578,32,138,170,4.820379965457685,52.868041021166185
Task_36711,2801,412,168,90,258,6.782082324455206,52.82685975693818
Task_36712,2111,973,66,116,182,2.1673511293634498,43.44646138938949
Task_36713,1348,999,157,11,168,1.348,30.545241995557618
Task_36714,570,464,92,57,149,1.2258064516129032,16.82229225788779
Task_36715,2844,807,184,30,214,3.51980198019802,54.015169329099855
Task_36716,1044,99,110,135,245,10.44,23.574321158483162
Task_36717,2368,400,24,90,114,5.905236907730673,45.061943366717365
Task_36718,1898,431,127,22,149,4.393518518518518,37.40110002504094
Task_36719,1553,914,13,178,191,1.6972677595628416,34.47597248149658
Task_36720,1914,560,46,101,147,3.411764705882353,38.668100070249466
Task_36721,852,705,81,152,233,1.206798866855524,22.889211731246984
Task_36722,1022,920,61,49,110,1.1096634093376765,24.73595087546002
Task_36723,2550,888,138,102,240,2.8683914510686166,50.339029031979386
Task_36724,2881,574,37,181,218,5.010434782608695,54.63072042329845
Task_36725,2592,904,143,89,232,2.8640883977900553,50.95685560609962
Task_36726,2716,900,60,42,102,3.014428412874584,51.27733845722707
Task_36727,1330,817,53,47,100,1.625916870415648,29.132915276584765
Task_36728,1804,148,64,141,205,12.10738255033557,35.84317961757276
Task_36729,1070,382,125,157,282,2.793733681462141,25.577053382471274
Task_36730,1281,749,104,152,256,1.708,29.9319373739509
Task_36731,1884,373,116,67,183,5.037433155080214,37.53821179018046
Task_36732,2628,361,191,58,249,7.259668508287293,49.54978466465045
Task_36733,1537,766,39,52,91,2.0039113428943938,32.474480146992704
Task_36734,2460,82,66,65,131,29.63855421686747,44.566928076175515
Task_36735,2987,758,141,76,217,3.935441370223979,56.54103514143835
Task_36736,2999,562,135,47,182,5.326820603907637,55.565509197047824
Task_36737,1354,747,17,174,191,1.8101604278074865,30.79308448539616
Task_36738,1479,699,173,18,191,2.112857142857143,31.85807161164952
Task_36739,1472,124,154,73,227,11.776,30.077154850327627
Task_36740,1981,128,30,53,83,15.356589147286822,36.902441675333726
Task_36741,2078,711,96,52,148,2.918539325842697,41.480169269126115
Task_36742,1705,847,185,35,220,2.01061320754717,36.12605915517682
Task_36743,1029,562,130,111,241,1.8277087033747779,25.243246307350642
Task_36744,2946,853,82,36,118,3.449648711943794,54.9909183329134
Task_36745,2410,595,28,41,69,4.043624161073826,45.05758782471119
Task_36746,2116,473,156,176,332,4.4641350210970465,42.67628332489888
Task_36747,1281,257,183,186,369,4.965116279069767,28.940107554247238
Task_36748,506,776,55,120,175,0.6512226512226512,17.440698761778304
Task_36749,2414,781,154,22,176,3.0869565217391304,46.86331708201697
Task_36750,585,974,113,32,145,0.6,18.692493195048783
Task_36751,702,216,152,96,248,3.2350230414746544,19.00773154630165
Task_36752,1573,647,12,59,71,2.427469135802469,32.18656349828294
Task_36753,705,518,135,48,183,1.3583815028901733,19.123266872985983
Task_36754,1179,602,34,61,95,1.955223880597015,26.275482193093833
Task_36755,649,387,27,190,217,1.672680412371134,18.663864195344875
Task_36756,1891,663,152,73,225,2.8478915662650603,38.85384008894836
Task_36757,2471,256,148,132,280,9.614785992217898,47.26023670303268
Task_36758,2447,544,52,25,77,4.489908256880734,45.45556419677473
Task_36759,1551,735,173,48,221,2.1073369565217392,33.38292449523386
Task_36760,640,668,62,67,129,0.9566517189835575,18.689207978645545
Task_36761,2505,466,145,130,275,5.364025695931478,48.48687120203764
Task_36762,2437,442,158,38,196,5.501128668171558,46.34365874228348
Task_36763,1033,879,14,186,200,1.1738636363636363,26.135195961534873
Task_36764,1981,120,200,82,282,16.371900826446282,38.50803448465832
Task_36765,1185,223,106,153,259,5.290178571428571,26.763446728209463
Task_36766,2408,212,189,163,352,11.305164319248826,46.468900368243396
Task_36767,2510,127,136,26,162,19.609375,45.7223825668946
Task_36768,1108,404,82,99,181,2.7358024691358023,25.70769574559704
Task_36769,2513,266,128,123,251,9.411985018726591,47.81652246592579
Task_36770,2434,407,92,23,115,5.965686274509804,45.47440519391082
Task_36771,1539,529,46,19,65,2.9037735849056605,30.886581986243325
Task_36772,1160,310,50,145,195,3.729903536977492,26.457001546950348
Task_36773,2161,592,39,105,144,3.6441821247892072,42.63730709340141
Task_36774,908,130,177,18,195,6.931297709923665,20.74117695086291
Task_36775,972,512,43,75,118,1.894736842105263,23.2797758717019
Task_36776,1120,399,67,91,158,2.8,25.66236343655096
Task_36777,2170,66,73,101,174,32.38805970149254,40.7208611043227
Task_36778,1163,610,51,97,148,1.9034369885433715,27.04894449238893
Task_36779,2183,353,138,82,220,6.166666666666667,42.62948729618926
Task_36780,1018,996,155,66,221,1.0210631895687061,25.96610856411208
Task_36781,2711,69,197,108,305,38.72857142857143,49.78577935613561
Task_36782,2153,533,57,109,166,4.031835205992509,42.64007746855874
Task_36783,896,691,183,40,223,1.2947976878612717,22.847474668023295
Task_36784,2031,397,174,72,246,5.103015075376884,40.32352447959313
Task_36785,2571,746,44,160,204,3.4417670682730925,50.16583400330961
Task_36786,1452,303,52,106,158,4.776315789473684,30.60872655455113
Task_36787,2433,138,80,160,240,17.503597122302157,45.83258746878503
Task_36788,2865,127,106,46,152,22.3828125,51.12365009752696
Task_36789,1274,725,22,103,125,1.7548209366391185,28.909256994820357
Task_36790,2531,201,47,18,65,12.529702970297029,45.46126301520399
Task_36791,2377,182,76,94,170,12.989071038251366,44.91077172509436
Task_36792,2482,630,191,67,258,3.9334389857369256,48.205260521051876
Task_36793,2001,197,71,50,121,10.106060606060606,38.12528373772384
Task_36794,2018,410,169,93,262,4.909975669099757,40.46737240746889
Task_36795,2470,831,95,58,153,2.96875,47.978479369824974
Task_36796,534,394,114,144,258,1.3518987341772153,16.960123008432852
Task_36797,709,529,134,103,237,1.3377358490566038,19.99676442292012
Task_36798,1456,433,90,59,149,3.3548387096774195,30.734012263558487
Task_36799,2750,551,141,159,300,4.981884057971015,52.79586663329985
Task_36800,589,718,155,125,280,0.8191933240611962,18.925440366343196
Task_36801,618,137,161,146,307,4.478260869565218,17.477290548257958
Task_36802,1727,246,100,136,236,6.991902834008097,35.27642857701112
Task_36803,2237,1015,56,146,202,2.201771653543307,45.73788311892051
Task_36804,2525,524,125,186,311,4.809523809523809,49.23557689199936
Task_36805,2474,74,36,124,160,32.986666666666665,45.10174085760357
Task_36806,2166,425,197,56,253,5.084507042253521,42.4742701970591
Task_36807,1690,442,86,28,114,3.81489841986456,33.838384656103386
Task_36808,1650,858,192,58,250,1.9208381839348079,35.65304836524101
Task_36809,2250,686,79,61,140,3.2751091703056767,44.06882182192381
Task_36810,2545,245,25,73,98,10.345528455284553,46.898630985440576
Task_36811,722,791,42,49,91,0.9116161616161617,19.565795532202884
Task_36812,940,635,99,70,169,1.4779874213836477,23.346256623437185
Task_36813,1680,898,137,83,220,1.8687430478309233,36.39500545611779
Task_36814,2442,626,197,56,253,3.8947368421052633,47.48928987968065
Task_36815,2812,73,59,133,192,38.0,50.95356226853554
Task_36816,1448,189,184,47,231,7.621052631578947,30.086421398488977
Task_36817,824,502,103,75,178,1.6381709741550696,21.270983505539125
Task_36818,1168,706,60,131,191,1.652050919377652,27.753714739663184
Task_36819,2995,631,94,69,163,4.738924050632911,55.90372816620438
Task_36820,2264,775,30,50,80,2.917525773195876,43.702319775321826
Task_36821,519,230,168,124,292,2.2467532467532467,16.374507945254297
Task_36822,2786,381,197,142,339,7.293193717277487,52.95856752574927
Task_36823,1772,493,140,45,185,3.5870445344129553,35.900180304262996
Task_36824,2611,768,112,44,156,3.3953185955786735,49.808820089322886
Task_36825,1436,487,168,172,340,2.942622950819672,31.986802704088806
Task_36826,1864,298,138,32,170,6.234113712374582,36.62744387756364
Task_36827,2512,608,119,12,131,4.124794745484401,47.538914213653044
Task_36828,2430,489,61,10,71,4.959183673469388,44.8218266241941
Task_36829,2589,656,192,53,245,3.9406392694063928,49.92609583277335
Task_36830,2034,448,199,111,310,4.5300668151447665,41.10317322329933
Task_36831,889,455,38,16,54,1.9495614035087718,20.3747602323024
Task_36832,1538,713,81,24,105,2.15406162464986,32.109710593439154
Task_36833,1029,670,26,128,154,1.533532041728763,24.928821853248873
Task_36834,2985,293,35,28,63,10.153061224489797,53.15282113616999
Task_36835,1156,732,180,188,368,1.5770804911323328,28.42713914194947
Task_36836,1228,219,171,133,304,5.581818181818182,27.602152496567115
Task_36837,569,508,61,180,241,1.117878192534381,17.8712785888936
Task_36838,2916,445,189,49,238,6.538116591928251,54.21685644721227
Task_36839,2750,179,131,72,203,15.277777777777779,50.507825904638004
Task_36840,892,418,137,112,249,2.1288782816229115,22.6599647382334
Task_36841,1223,543,177,57,234,2.2481617647058822,27.832420462520094
Task_36842,2181,345,90,43,133,6.303468208092486,41.58429081642496
Task_36843,2051,957,67,111,178,2.140918580375783,42.42961540813503
Task_36844,1017,589,109,128,237,1.723728813559322,25.13103266375636
Task_36845,2300,891,148,150,298,2.57847533632287,46.718899853802746
Task_36846,2542,542,67,197,264,4.681399631675875,49.44140093743153
Task_36847,2826,790,32,185,217,3.572692793931732,54.420148332360405
Task_36848,2663,889,86,18,104,2.992134831460674,50.44773809002291
Task_36849,749,376,75,42,117,1.986737400530504,18.74547229563171
Task_36850,2814,205,184,120,304,13.660194174757281,52.57120614339095
Task_36851,2608,823,59,57,116,3.1650485436893203,49.777084534713275
Task_36852,2252,521,19,32,51,4.314176245210728,42.275283232985814
Task_36853,2734,903,98,107,205,3.024336283185841,53.15527795682177
Task_36854,2846,573,194,62,256,4.958188153310105,53.72632491458209
Task_36855,1101,572,112,53,165,1.9214659685863875,25.759026370904433
Task_36856,1789,301,37,159,196,5.923841059602649,36.323193328376
Task_36857,2537,649,53,88,141,3.903076923076923,48.81937517336579
Task_36858,1544,245,130,21,151,6.276422764227642,31.16061124668361
Task_36859,2845,292,13,121,134,9.709897610921502,52.40831975010573
Task_36860,834,134,156,74,230,6.177777777777778,20.136327134395486
Task_36861,1753,948,85,18,103,1.8472075869336144,36.21128459173779
Task_36862,963,576,107,69,176,1.6689774696707105,23.58121165469173
Task_36863,2700,454,22,78,100,5.934065934065934,50.18949734032114
Task_36864,2855,130,55,186,241,21.793893129770993,52.460338871579246
Task_36865,2908,801,147,49,196,3.625935162094763,55.04136278298953
Task_36866,2121,443,58,108,166,4.777027027027027,41.84584913963177
Task_36867,1444,769,90,126,216,1.8753246753246753,32.365817021300295
Task_36868,2272,334,135,138,273,6.782089552238806,44.36527430604
Task_36869,2890,444,32,48,80,6.49438202247191,52.511487931608976
Task_36870,2061,783,135,10,145,2.628826530612245,41.06895941400918
Task_36871,2504,750,33,92,125,3.33422103861518,48.492429789322834
Task_36872,2342,762,55,30,85,3.0694626474442988,44.818385017230334
Task_36873,2920,371,93,123,216,7.849462365591398,54.50091181398039
Task_36874,2860,898,139,62,201,3.181312569521691,54.72800704660161
Task_36875,2085,642,141,186,327,3.2426127527216173,42.71564161464797
Task_36876,2664,512,10,186,196,5.192982456140351,50.83955622276027
Task_36877,2897,409,122,72,194,7.065853658536585,53.830352550974304
Task_36878,2076,411,113,78,191,5.038834951456311,40.93797863551921
Task_36879,1298,471,194,52,246,2.75,28.89222820989016
Task_36880,1467,419,154,134,288,3.492857142857143,31.970684366663416
Task_36881,1825,682,161,165,326,2.67203513909224,38.68803071079666
Task_36882,2816,494,71,53,124,5.688888888888889,52.236246397967996
Task_36883,2498,499,192,47,239,4.996,47.70560226469052
Task_36884,1490,574,29,34,63,2.591304347826087,30.386876854336027
Task_36885,2225,930,89,62,151,2.3899033297529537,44.40759669409911
Task_36886,2946,292,116,192,308,10.054607508532424,55.11299613181859
Task_36887,905,696,60,35,95,1.2984218077474892,21.93854164243316
Task_36888,2062,382,38,162,200,5.383812010443864,40.91977047733353
Task_36889,2666,907,182,52,234,2.936123348017621,51.87637446359631
Task_36890,1640,923,72,186,258,1.774891774891775,36.279542723710925
Task_36891,1306,582,40,140,180,2.240137221269297,29.44391302738023
Task_36892,1230,321,141,14,155,3.8198757763975157,26.42966338886212
Task_36893,1363,627,187,34,221,2.1703821656050954,30.024186058077195
Task_36894,2738,294,74,26,100,9.28135593220339,49.78653338742774
Task_36895,824,267,85,195,280,3.074626865671642,21.369426159663472
Task_36896,537,783,72,24,96,0.6849489795918368,16.929623100523315
Task_36897,2484,345,147,57,204,7.179190751445087,47.01359163626744
Task_36898,642,861,183,47,230,0.7447795823665894,19.429819548304298
Task_36899,2603,225,48,114,162,11.517699115044248,48.5962716484209
Task_36900,1289,875,121,52,173,1.471461187214612,29.649026931550065
Task_36901,556,553,192,158,350,1.0036101083032491,18.20713469332469
Task_36902,735,530,189,187,376,1.384180790960452,21.154147473460256
Task_36903,1376,186,155,12,167,7.358288770053476,28.51348543656557
Task_36904,2409,166,193,79,272,14.425149700598803,45.49005381101373
Task_36905,2181,466,142,54,196,4.670235546038544,42.595143547522426
Task_36906,2523,683,159,134,293,3.68859649122807,49.5531398467395
Task_36907,780,309,84,150,234,2.5161290322580645,20.53999089001515
Task_36908,1242,728,71,53,124,1.7037037037037037,28.040672448980555
Task_36909,2910,271,66,84,150,10.698529411764707,53.48754197570691
Task_36910,2475,292,92,178,270,8.447098976109215,47.48280862248472
Task_36911,857,341,99,47,146,2.5058479532163744,20.721603125107368
Task_36912,2383,363,198,38,236,6.5467032967032965,45.40793035177284
Task_36913,994,777,85,193,278,1.2776349614395888,25.57621065154841
Task_36914,2317,678,24,189,213,3.4123711340206184,45.98189388132091
Task_36915,628,338,85,71,156,1.8525073746312684,17.400207567566788
Task_36916,898,990,54,38,92,0.9061553985872856,22.885575656079524
Task_36917,873,66,178,118,296,13.029850746268657,21.037361694305186
Task_36918,2204,991,141,196,337,2.221774193548387,45.752440089378716
Task_36919,1687,493,113,158,271,3.41497975708502,35.6478639226625
Task_36920,2523,568,118,86,204,4.434094903339192,48.64990960328669
Task_36921,599,119,142,107,249,4.991666666666666,16.7618362859258
Task_36922,2021,108,75,10,85,18.541284403669724,37.140263385405156
Task_36923,2669,937,92,119,211,2.845415778251599,52.27963210029822
Task_36924,2182,835,32,70,102,2.610047846889952,43.106272228011484
Task_36925,1090,736,197,151,348,1.4789687924016282,27.249663050728216
Task_36926,2798,729,151,90,241,3.8328767123287673,53.723997647261854
Task_36927,568,651,16,59,75,0.8711656441717791,16.398340235070506
Task_36928,958,234,136,23,159,4.076595744680851,21.90833777251432
Task_36929,1356,647,131,41,172,2.0925925925925926,29.743690712700015
Task_36930,1408,806,181,95,276,1.744733581164808,32.14129518540385
Task_36931,1251,750,113,74,187,1.6657789613848202,28.84985493855375
Task_36932,2816,531,23,75,98,5.293233082706767,52.1824136970273
Task_36933,2651,64,132,13,145,40.784615384615385,46.77643192320562
Task_36934,607,144,189,12,201,4.186206896551724,16.132087661487372
Task_36935,2647,841,75,14,89,3.143705463182898,49.941226430337004
Task_36936,1194,475,139,137,276,2.508403361344538,27.77818448666794
Task_36937,660,161,60,62,122,4.074074074074074,16.66778310167889
Task_36938,2541,403,162,194,356,6.28960396039604,49.308495782067915
Task_36939,2917,525,123,97,220,5.5456273764258555,54.93304942036911
Task_36940,1845,556,66,179,245,3.312387791741472,38.340566500876605
Task_36941,1190,375,16,29,45,3.1648936170212765,24.91651993135829
Task_36942,2763,204,152,11,163,13.478048780487805,50.39170013235582
Task_36943,2175,746,89,50,139,2.9116465863453813,42.83788689679553
Task_36944,1954,723,14,30,44,2.6988950276243093,38.11891391055804
Task_36945,948,357,170,142,312,2.64804469273743,23.680426657674776
Task_36946,2969,679,35,146,181,4.366176470588235,56.09781001102065
Task_36947,2483,325,188,19,207,7.616564417177914,46.62861666498589
Task_36948,1958,927,192,169,361,2.1099137931034484,41.723721896969714
Task_36949,1403,660,155,60,215,2.122541603630862,30.95701116698263
Task_36950,1895,703,172,48,220,2.6917613636363638,38.72759572631211
Task_36951,2190,454,120,23,143,4.813186813186813,42.04602230546171
Task_36952,2604,451,105,177,282,5.761061946902655,50.10534969421409
Task_36953,2317,967,180,66,246,2.393595041322314,46.59002730116623
Task_36954,2631,563,144,64,208,4.664893617021277,50.11927273052055
Task_36955,1913,926,43,57,100,2.063646170442287,38.937678543482804
Task_36956,1129,233,163,10,173,4.8247863247863245,24.725379922505905
Task_36957,2904,471,185,105,290,6.1525423728813555,54.85003820755611
Task_36958,815,482,10,145,155,1.6873706004140787,21.023782534952364
Task_36959,667,210,116,142,258,3.161137440758294,18.519438906647597
Task_36960,1649,861,197,77,274,1.9129930394431554,35.92908398735994
Task_36961,2267,752,135,108,243,3.01062416998672,45.45168272394446
Task_36962,1925,418,98,48,146,4.594272076372315,37.8802214790494
Task_36963,1932,102,135,107,242,18.75728155339806,37.51212025638537
Task_36964,1087,552,32,196,228,1.9656419529837252,26.193839067026563
Task_36965,1991,616,30,80,110,3.226904376012966,39.71695835194044
Task_36966,2139,529,53,71,124,4.035849056603774,41.8286841935371
Task_36967,715,595,17,72,89,1.1996644295302012,19.01881685494529
Task_36968,782,149,116,173,289,5.213333333333333,20.130218493949986
Task_36969,2602,882,118,19,137,2.9467723669309174,49.83992177557155
Task_36970,997,382,87,110,197,2.6031331592689293,23.930343362842397
Task_36971,1379,850,151,149,300,1.6204465334900118,31.99239956462053
Task_36972,2578,809,159,138,297,3.1827160493827162,50.8449536605825
Task_36973,1768,192,52,84,136,9.160621761658032,35.13743337632673
Task_36974,2838,113,39,72,111,24.894736842105264,50.52911340087093
Task_36975,2252,421,20,147,167,5.3364928909952605,43.812220904540546
Task_36976,2016,750,152,101,253,2.684420772303595,41.50392131508922
Task_36977,920,475,188,129,317,1.9327731092436975,23.613910466420666
Task_36978,2703,952,58,68,126,2.8363064008394545,52.15428171888204
Task_36979,1843,987,102,42,144,1.8653846153846154,38.27307327948383
Task_36980,2473,550,189,136,325,4.488203266787659,48.48553705997432
Task_36981,672,938,95,180,275,0.7156549520766773,21.07893114093148
Task_36982,1242,223,73,193,266,5.544642857142857,27.81374690438818
Task_36983,2677,446,106,127,233,5.988814317673378,50.9502278516203
Task_36984,2855,560,26,15,41,5.089126559714795,51.700370158750026
Task_36985,1761,195,109,53,162,8.98469387755102,34.890973476953285
Task_36986,1764,469,99,133,232,3.753191489361702,36.57942829450737
Task_36987,2524,449,45,62,107,5.608888888888889,47.22545013051038
Task_36988,2667,162,180,48,228,16.36196319018405,48.91305969232985
Task_36989,1846,503,149,62,211,3.6626984126984126,37.4658511867253
Task_36990,1482,629,145,118,263,2.3523809523809525,32.73629222302102
Task_36991,1579,160,155,83,238,9.807453416149068,32.26072125762176
Task_36992,2072,446,159,32,191,4.635346756152125,40.54433237080823
Task_36993,2375,674,140,134,274,3.5185185185185186,47.09481418091426
Task_36994,2619,555,169,73,242,4.710431654676259,50.11708677542767
Task_36995,2866,220,52,111,163,12.968325791855204,52.817116297816796
Task_36996,807,520,181,192,373,1.5489443378119,22.26788164112524
Task_36997,916,508,122,50,172,1.799607072691552,22.436735336351322
Task_36998,2878,938,161,17,178,3.0649627263045796,54.696808526259595
Task_36999,1910,931,168,124,292,2.0493562231759657,40.59861097858805
Task_37000,1009,495,38,198,236,2.034274193548387,24.83155896504725
Task_37001,609,288,105,199,304,2.1072664359861593,18.146755937897492
Task_37002,972,806,108,113,221,1.204460966542751,24.95239863497484
Task_37003,2940,382,61,99,160,7.676240208877284,54.39428452906257
Task_37004,2841,571,187,86,273,4.966783216783217,54.006098153875236
Task_37005,2144,645,39,164,203,3.318885448916409,43.07832115438112
Task_37006,1745,186,118,47,165,9.331550802139038,34.492486419472
Task_37007,2693,981,82,41,123,2.7423625254582484,51.48308749393063
Task_37008,2983,540,188,31,219,5.513863216266174,55.39530879466577
Task_37009,2446,145,58,115,173,16.753424657534246,45.64178777956372
Task_37010,1514,921,24,122,146,1.6420824295010845,33.430556077472524
Task_37011,1575,96,67,29,96,16.237113402061855,29.962007135000118
Task_37012,2367,321,16,78,94,7.350931677018633,44.3720739532389
Task_37013,2950,246,72,116,188,11.94331983805668,54.39940119759597
Task_37014,688,259,37,71,108,2.646153846153846,17.804421806822152
Task_37015,722,897,61,191,252,0.8040089086859689,21.591559370622104
Task_37016,725,200,67,185,252,3.6069651741293534,19.512186346314994
Task_37017,1648,744,97,37,134,2.212080536912752,34.379146084132906
Task_37018,1852,191,174,121,295,9.645833333333334,37.29152904406282
Task_37019,2254,553,102,27,129,4.068592057761733,43.35262721018872
Task_37020,1815,694,77,95,172,2.6115107913669067,37.83335523149886
Task_37021,1814,687,194,89,283,2.636627906976744,38.18169136696489
Task_37022,2782,702,67,78,145,3.957325746799431,52.866504700421395
Task_37023,1255,547,149,180,329,2.29014598540146,29.272589339941806
Task_37024,1915,698,160,106,266,2.739628040057225,39.80691091963709
Task_37025,1544,870,194,152,346,1.772675086107922,34.88059165441751
Task_37026,2628,471,87,84,171,5.567796610169491,49.73939307094755
Task_37027,1751,132,92,165,257,13.165413533834586,35.11132158901045
Task_37028,2935,735,199,160,359,3.9877717391304346,56.579393953348905
Task_37029,2068,686,18,30,48,3.01018922852984,39.8266349609326
Task_37030,734,557,92,109,201,1.3154121863799284,20.32595861481354
Task_37031,2737,429,108,100,208,6.365116279069768,51.691531186004035
Task_37032,2754,474,152,154,306,5.797894736842105,52.62937452710444
Task_37033,1441,76,16,138,154,18.714285714285715,28.799757443180194
Task_37034,1320,755,61,57,118,1.746031746031746,29.14654237424983
Task_37035,1532,543,14,136,150,2.8161764705882355,32.55074567767543
Task_37036,1604,283,22,162,184,5.647887323943662,33.211553696852
Task_37037,1562,702,193,185,378,2.2219061166429586,34.84840278434164
Task_37038,977,773,169,79,248,1.2622739018087856,24.910009996391892
Task_37039,2999,532,137,95,232,5.626641651031895,56.29029349759798
Task_37040,2132,426,146,193,339,4.992974238875878,42.83368571129953
Task_37041,2665,513,28,44,72,5.184824902723736,48.82349952557572
Task_37042,2246,191,10,27,37,11.697916666666666,41.025287449353264
Task_37043,1902,637,77,117,194,2.981191222570533,39.16784948326848
Task_37044,1956,452,150,42,192,4.317880794701987,38.73688091618295
Task_37045,692,560,28,41,69,1.2335115864527628,17.77702124070086
Task_37046,2689,674,105,154,259,3.9837037037037035,52.030112518143575
Task_37047,1976,93,168,120,288,21.02127659574468,38.35109753988299
Task_37048,1341,758,174,39,213,1.766798418972332,30.04262348721817
Task_37049,1727,441,124,166,290,3.9072398190045248,36.21206331357512
Task_37050,2744,122,112,197,309,22.308943089430894,50.93466777171083
Task_37051,1418,131,142,155,297,10.742424242424242,30.012754465253266
Task_37052,2317,1004,86,158,244,2.3054726368159204,47.069004189315194
Task_37053,1345,458,177,95,272,2.9302832244008714,30.048421678585573
Task_37054,1773,277,12,19,31,6.377697841726619,33.57276303556611
Task_37055,935,472,147,12,159,1.9767441860465116,22.272581202871198
Task_37056,1861,677,197,139,336,2.7448377581120944,39.24952440699479
Task_37057,629,921,93,106,199,0.6822125813449024,20.00511182776048
Task_37058,569,588,68,175,243,0.966044142614601,18.12598571880363
Task_37059,1540,615,71,10,81,2.5,31.69124207896328
Task_37060,2964,812,197,36,233,3.6457564575645756,56.01859958094588
Task_37061,1672,541,73,171,244,3.084870848708487,35.52004961834145
Task_37062,2276,413,196,18,214,5.497584541062802,43.671498667983265
Task_37063,691,173,173,94,267,3.971264367816092,18.509418519489024
Task_37064,1211,367,129,73,202,3.2907608695652173,27.046191313012404
Task_37065,1787,334,140,81,221,5.334328358208955,36.27256955574791
Task_37066,2452,162,69,120,189,15.042944785276074,46.02987104384632
Task_37067,1545,823,120,172,292,1.875,34.549660568453405
Task_37068,697,817,177,157,334,0.8520782396088019,21.233577809171788
Task_37069,1794,865,40,111,151,2.071593533487298,37.70666915207727
Task_37070,2735,579,137,168,305,4.7155172413793105,52.683959432968834
Task_37071,1333,884,123,82,205,1.5062146892655368,30.7463088774801
Task_37072,1879,430,169,13,182,4.359628770301624,37.28028695051251
Task_37073,2586,330,36,137,173,7.812688821752266,48.851655933976076
Task_37074,1363,458,122,88,210,2.969498910675381,29.971029286405926
Task_37075,1197,406,141,60,201,2.941031941031941,26.832134279028395
Task_37076,2732,304,94,105,199,8.957377049180328,51.16403922910243
Task_37077,2839,997,48,53,101,2.844689378757515,53.84284235309155
Task_37078,2481,307,106,149,255,8.055194805194805,47.51251021596386
Task_37079,960,372,73,153,226,2.5737265415549597,23.60654185846849
Task_37080,790,181,148,175,323,4.34065934065934,20.506399343133204
Task_37081,2067,77,130,148,278,26.5,39.67361309842237
Task_37082,2483,996,168,14,182,2.490471414242728,48.61906226796617
Task_37083,1170,634,39,96,135,1.8425196850393701,27.07837340809392
Task_37084,2409,693,141,115,256,3.4711815561959654,47.58434770204618
Task_37085,1896,597,92,175,267,3.17056856187291,39.30142840853879
Task_37086,2874,508,139,145,284,5.6463654223968565,54.52750914887969
Task_37087,914,775,160,141,301,1.1778350515463918,24.33904911120619
Task_37088,1877,724,134,200,334,2.5889655172413795,39.730733950242985
Task_37089,2244,876,134,97,231,2.5587229190421894,45.43348602196215
Task_37090,2832,548,50,93,143,5.158469945355192,53.23343636565488
Task_37091,1214,733,91,166,257,1.6539509536784742,28.84515039426576
Task_37092,1704,571,62,192,254,2.979020979020979,36.20462262169814
Task_37093,2817,800,135,110,245,3.5168539325842696,54.327803860815514
Task_37094,986,158,139,116,255,6.20125786163522,23.144292353258674
Task_37095,2519,133,41,23,64,18.79850746268657,44.95428399874098
Task_37096,1684,482,67,47,114,3.4865424430641823,33.91280494713889
Task_37097,1545,836,115,92,207,1.8458781362007168,34.037930880077944
Task_37098,2112,222,101,135,236,9.47085201793722,41.269289648219235
Task_37099,1090,766,177,11,188,1.4211212516297262,25.835334215567247
Task_37100,582,204,130,169,299,2.8390243902439023,17.382091182251187
Task_37101,2924,76,150,14,164,37.97402597402598,51.50355439923817
Task_37102,718,438,10,119,129,1.6355353075170842,19.271933733172844
Task_37103,2821,575,124,59,183,4.897569444444445,52.97181307581257
Task_37104,557,142,200,67,267,3.895104895104895,15.936831957197006
Task_37105,2880,772,109,131,240,3.725743855109961,55.24600603542749
Task_37106,2249,955,10,17,27,2.352510460251046,43.23411095093437
Task_37107,1753,887,16,55,71,1.9740990990990992,35.83879438570131
Task_37108,644,770,169,28,197,0.8352788586251622,19.007748226426077
Task_37109,575,656,11,27,38,0.8751902587519026,16.13388031841782
Task_37110,1371,111,28,37,65,12.241071428571429,26.734385522017174
Task_37111,1846,294,94,18,112,6.257627118644068,35.76367328370554
Task_37112,1904,864,49,156,205,2.2011560693641616,40.04584433261412
Task_37113,1345,745,11,136,147,1.8029490616621984,30.213069875412575
Task_37114,593,932,74,133,207,0.6355841371918542,19.52942425452638
Task_37115,1781,635,12,33,45,2.800314465408805,35.095921151191384
Task_37116,602,574,150,12,162,1.0469565217391303,17.375086318472967
Task_37117,1120,948,38,37,75,1.1801896733403583,25.835127345419235
Task_37118,1139,531,93,105,198,2.1409774436090228,26.723747900171972
Task_37119,1332,416,73,36,109,3.194244604316547,28.02090254842693
Task_37120,1994,155,62,131,193,12.782051282051283,38.79706457659478
Task_37121,1558,516,142,58,200,3.013539651837524,32.899317644646935
Task_37122,1850,598,82,134,216,3.0884808013355594,38.32052595814944
Task_37123,1575,736,149,10,159,2.1370420624151967,33.23121428435229
Task_37124,1065,348,134,15,149,3.0515759312320916,23.91709534065608
Task_37125,1236,711,152,126,278,1.7359550561797752,29.161848115906764
Task_37126,561,773,120,168,288,0.7248062015503876,18.841341359662838
Task_37127,2504,718,139,191,330,3.4826147426981917,49.61294811693764
Task_37128,2853,976,78,164,242,2.9201637666325486,55.58211515562994
Task_37129,2111,569,118,17,135,3.7035087719298247,41.0541428934877
Task_37130,1174,551,127,134,261,2.1268115942028984,27.62866627956751
Task_37131,2797,514,197,98,295,5.4310679611650485,53.3161205003427
Task_37132,1144,619,120,88,208,1.8451612903225807,27.000915000969684
Task_37133,1627,432,137,62,199,3.7575057736720554,33.717970778750875
Task_37134,910,363,146,68,214,2.5,22.271940422788344
Task_37135,2817,536,15,116,131,5.245810055865922,52.82015456976951
Task_37136,715,1003,17,181,198,0.7121513944223108,21.57314035093437
Task_37137,2153,1017,18,136,154,2.1149312377210214,43.87206800793854
Task_37138,965,945,88,141,229,1.0200845665961944,25.257082558983697
Task_37139,570,376,95,72,167,1.5119363395225465,16.768922640940882
Task_37140,1881,634,30,95,125,2.9622047244094487,38.273328905322465
Task_37141,628,817,181,195,376,0.7677261613691931,20.41519033803898
Task_37142,2519,627,188,61,249,4.011146496815287,48.678355606128385
Task_37143,1725,579,175,188,363,2.9741379310344827,36.980704495092326
Task_37144,2538,616,167,73,240,4.113452188006483,49.02018870346103
Task_37145,2618,812,78,12,90,3.220172201722017,49.41022559956713
Task_37146,1358,169,24,78,102,7.988235294117647,27.648512395545808
Task_37147,925,167,89,152,241,5.505952380952381,22.17037823776579
Task_37148,1472,999,54,198,252,1.472,33.81763349408839
Task_37149,1160,1020,178,199,377,1.1361410381978452,29.413885597974996
Task_37150,546,124,175,62,237,4.368,15.500438145226056
Task_37151,2952,168,150,28,178,17.467455621301774,53.1715752434232
Task_37152,580,339,167,55,222,1.7058823529411764,16.954293996330478
Task_37153,2065,168,135,29,164,12.218934911242604,39.1413668326833
Task_37154,1895,868,12,56,68,2.180667433831991,37.97619660615445
Task_37155,1020,785,27,158,185,1.297709923664122,25.497109113708557
Task_37156,2332,333,181,77,258,6.982035928143713,44.987605705323176
Task_37157,1091,882,83,187,270,1.2355605889014722,27.419972929674753
Task_37158,692,178,104,119,223,3.8659217877094973,18.370838838008748
Task_37159,750,76,31,179,210,9.74025974025974,18.77518777768943
Task_37160,2564,506,13,26,39,5.057199211045365,47.00561601533266
Task_37161,2150,150,113,34,147,14.23841059602649,40.125009367855334
Task_37162,1905,716,37,152,189,2.6569037656903767,39.44612051238051
Task_37163,2082,340,145,182,327,6.105571847507331,41.68833277774046
Task_37164,2468,507,62,48,110,4.858267716535433,46.26686957409917
Task_37165,1950,791,55,11,66,2.462121212121212,38.15682281607125
Task_37166,2353,437,105,151,256,5.372146118721461,45.93156399181593
Task_37167,2687,1011,170,104,274,2.6551383399209487,53.050036789191346
Task_37168,2371,783,127,44,171,3.024234693877551,46.212312047741314
Task_37169,2734,983,18,43,61,2.7784552845528454,51.4413534540715
Task_37170,2053,933,176,32,208,2.1980728051391862,41.85566971410923
Task_37171,2636,879,114,44,158,2.9954545454545456,50.56207232382835
Task_37172,1148,985,32,135,167,1.1643002028397567,28.010728512167663
Task_37173,1037,311,40,190,230,3.323717948717949,24.65076552663804
Task_37174,1710,525,182,149,331,3.2509505703422055,36.37093503683686
Task_37175,1409,698,92,80,172,2.015736766809728,31.19749393843446
Task_37176,1349,221,192,140,332,6.076576576576577,29.656368215365532
Task_37177,1610,145,165,134,299,11.027397260273972,33.13182655940594
Task_37178,2099,790,102,10,112,2.6536030341340076,41.313082222483075
Task_37179,1962,466,142,76,218,4.2012847965738755,39.383988449159
Task_37180,1428,136,180,196,376,10.423357664233576,30.61281520760952
Task_37181,1913,582,90,53,143,3.281303602058319,38.441708270513715
Task_37182,2270,968,31,200,231,2.3426212590299276,46.25232842706752
Task_37183,2944,333,50,101,151,8.81437125748503,54.27833598116691
Task_37184,2640,148,194,89,283,17.71812080536913,49.177477876992334
Task_37185,1368,504,12,51,63,2.708910891089109,28.45396825828458
Task_37186,2342,195,172,51,223,11.948979591836734,44.32078529092225
Task_37187,1324,755,140,107,247,1.7513227513227514,30.525278052904753
Task_37188,1956,134,56,77,133,14.488888888888889,37.243031344858146
Task_37189,750,679,89,98,187,1.1029411764705883,20.800968384216144
Task_37190,2835,371,12,79,91,7.620967741935484,51.93369744083254
Task_37191,1466,343,67,196,263,4.261627906976744,31.761682843196542
Task_37192,1109,326,168,191,359,3.3914373088685017,26.410951333451624
Task_37193,889,235,39,72,111,3.766949152542373,20.984494294194985
Task_37194,1254,277,119,112,231,4.510791366906475,27.85002282507617
Task_37195,2938,179,46,24,70,16.322222222222223,51.960203428089876
Task_37196,610,347,153,195,348,1.7528735632183907,18.528670178079874
Task_37197,1090,677,55,100,155,1.607669616519174,26.032096597178732
Task_37198,2928,319,171,79,250,9.15,54.39548313568516
Task_37199,595,604,130,60,190,0.9834710743801653,17.923781365427583
Task_37200,1320,517,176,195,371,2.548262548262548,30.41862788341639
Task_37201,1449,588,180,75,255,2.460101867572156,31.809442390606844
Task_37202,1799,519,164,92,256,3.4596153846153848,37.28760133428285
Task_37203,1710,114,134,86,220,14.869565217391305,33.86304057708295
Task_37204,2455,75,52,166,218,32.30263157894737,45.53544763651269
Task_37205,1947,763,162,52,214,2.548429319371728,39.944141502551176
Task_37206,647,228,76,137,213,2.8253275109170306,18.119624214582515
Task_37207,1196,224,109,31,140,5.315555555555555,25.583256382174483
Task_37208,1084,545,74,147,221,1.9853479853479854,26.084129009240527
Task_37209,2488,340,44,193,237,7.296187683284457,47.73701962557798
Task_37210,1465,881,102,166,268,1.6609977324263039,33.33199209893839
Task_37211,2211,408,11,10,21,5.405867970660147,40.8819380792685
Task_37212,2007,523,183,99,282,3.8301526717557253,40.76679783244886
Task_37213,1823,265,195,169,364,6.853383458646617,37.485148065726484
Task_37214,2972,815,149,83,232,3.642156862745098,56.660609478354765
Task_37215,663,330,79,198,277,2.003021148036254,19.071013901115247
Task_37216,574,371,57,83,140,1.543010752688172,16.80900920835662
Task_37217,1967,93,174,91,265,20.925531914893618,37.93977055377608
Task_37218,964,1006,170,138,308,0.9572989076464746,25.912802980439256
Task_37219,918,991,19,49,68,0.9254032258064516,22.874963777151237
Task_37220,2322,411,175,103,278,5.635922330097087,45.38449607948045
Task_37221,1075,904,31,62,93,1.1878453038674033,25.6376947836964
Task_37222,1001,898,181,151,332,1.1134593993325919,26.234153829139043
Task_37223,1234,877,20,72,92,1.4054669703872438,28.10147105181717
Task_37224,2010,855,21,167,188,2.3481308411214954,41.50893246273243
Task_37225,1386,92,167,185,352,14.903225806451612,29.473462537502712
Task_37226,1633,157,104,137,241,10.335443037974683,33.30791996439637
Task_37227,1208,331,77,181,258,3.63855421686747,27.589922757646818
Task_37228,898,434,48,81,129,2.064367816091954,22.18885884365766
Task_37229,2684,296,84,184,268,9.037037037037036,50.803140708924424
Task_37230,2640,618,73,20,93,4.264943457189014,49.188787432591255
Task_37231,2287,565,179,23,202,4.040636042402827,44.31774538813047
Task_37232,2399,266,131,43,174,8.985018726591761,45.02805872107623
Task_37233,2914,514,12,30,42,5.658252427184466,52.63199667895066
Task_37234,1528,997,155,24,179,1.531062124248497,33.531094668431926
Task_37235,1096,923,122,116,238,1.1861471861471862,27.360514282568644
Task_37236,2389,91,15,115,130,25.967391304347824,43.654574858051916
Task_37237,1378,996,181,183,364,1.382146439317954,32.7271456754703
Task_37238,2722,230,94,125,219,11.783549783549784,50.85279188911711
Task_37239,1655,815,60,137,197,2.028186274509804,35.85744900402627
Task_37240,1852,861,155,32,187,2.148491879350348,38.33849599158675
Task_37241,1152,299,127,66,193,3.84,25.791894049454736
Task_37242,2707,660,188,43,231,4.095310136157337,51.47025884465614
Task_37243,1237,361,143,50,193,3.4171270718232045,27.164443400472063
Task_37244,641,457,156,107,263,1.3995633187772927,18.811727630435513
Task_37245,1158,239,21,109,130,4.825,25.569940210983486
Task_37246,576,681,56,128,184,0.844574780058651,18.16504848332568
Task_37247,934,733,143,180,323,1.2724795640326976,24.680501478195723
Task_37248,2474,494,177,101,278,4.997979797979798,48.05801077149456
Task_37249,2029,222,191,188,379,9.09865470852018,40.6807427861774
Task_37250,2206,79,72,33,105,27.575,39.757642869630864
Task_37251,680,880,136,40,176,0.771850170261067,19.861475809345738
Task_37252,2544,356,34,158,192,7.126050420168068,48.41847043700995
Task_37253,1192,180,197,105,302,6.585635359116022,26.618412888839178
Task_37254,2539,813,39,121,160,3.119164619164619,49.421105035116476
Task_37255,2309,621,145,123,268,3.712218649517685,45.8386562303815
Task_37256,2788,113,187,62,249,24.45614035087719,50.630835651981215
Task_37257,1320,598,94,118,212,2.2036727879799667,29.853964814010407
Task_37258,1702,545,173,75,248,3.1172161172161172,35.64858470465521
Task_37259,2877,462,86,84,170,6.213822894168467,53.66839928708456
Task_37260,1200,238,120,118,238,5.02092050209205,26.905804315990352
Task_37261,2579,757,67,12,79,3.4023746701846966,48.29818221947691
Task_37262,1904,737,132,33,165,2.5799457994579944,38.69588155062614
Task_37263,1861,954,117,55,172,1.9486910994764397,38.92231061096111
Task_37264,2772,756,152,22,174,3.6618229854689566,52.447238578245475
Task_37265,2798,345,167,133,300,8.086705202312139,52.83674301356816
Task_37266,874,321,33,85,118,2.7142857142857144,21.198543092584043
Task_37267,1934,548,46,172,218,3.522768670309654,39.54881684285068
Task_37268,905,617,18,150,168,1.464401294498382,23.06956446256685
Task_37269,1011,782,33,61,94,1.2911877394636015,24.18283148081645
Task_37270,1302,559,95,149,244,2.325,29.636251752967222
Task_37271,1912,994,44,102,146,1.921608040201005,39.97631185045834
Task_37272,1919,761,200,129,329,2.5183727034120733,40.3852587489831
Task_37273,1006,729,74,69,143,1.378082191780822,24.59156407820528
Task_37274,1956,593,141,133,274,3.292929292929293,40.20128838294741
Task_37275,1635,652,25,116,141,2.5038284839203677,34.46896906508764
Task_37276,1451,544,20,44,64,2.6623853211009174,29.701349966336213
Task_37277,2798,1023,182,124,306,2.732421875,55.02003702465947
Task_37278,2548,827,68,73,141,3.077294685990338,49.394056180710464
Task_37279,2329,720,60,165,225,3.230235783633842,46.40510864612428
Task_37280,2900,989,50,116,166,2.9292929292929295,55.95131337078623
Task_37281,1180,687,150,78,228,1.7151162790697674,27.786081863535838
Task_37282,2964,693,123,75,198,4.270893371757925,55.879050023794356
Task_37283,2208,143,200,29,229,15.333333333333334,41.55639323676544
Task_37284,1735,615,127,156,283,2.8165584415584415,36.84505475446069
Task_37285,1783,351,82,42,124,5.065340909090909,35.08307502295382
Task_37286,1409,1014,44,96,140,1.3881773399014778,32.02194924527098
Task_37287,880,194,85,193,278,4.512820512820513,21.989437887079628
Task_37288,762,912,130,128,258,0.8346111719605696,22.171333540146804
Task_37289,1271,729,60,70,130,1.7410958904109588,28.78866141920263
Task_37290,2142,349,134,171,305,6.12,42.552270501324884
Task_37291,2343,1003,22,199,221,2.3336653386454183,47.45579552060394
Task_37292,2708,617,191,29,220,4.381877022653722,51.2855034545118
Task_37293,2125,244,120,188,308,8.673469387755102,41.9579210843761
Task_37294,2311,147,122,158,280,15.614864864864865,44.156509583501844
Task_37295,2559,657,16,79,95,3.8890577507598785,48.53535434085924
Task_37296,2716,1018,46,125,171,2.665358194308145,53.0735086063124
Task_37297,1120,665,22,187,209,1.6816816816816818,26.94129190582957
Task_37298,1075,831,157,137,294,1.2920673076923077,27.024497878457453
Task_37299,1473,256,107,165,272,5.7315175097276265,31.502648416100783
Task_37300,2103,762,136,165,301,2.7562254259501966,43.22991387907036
Task_37301,1971,586,38,149,187,3.3577512776831346,40.044371475523185
Task_37302,512,591,47,30,77,0.8648648648648649,15.186597068849187
Task_37303,2925,651,187,183,370,4.486196319018405,56.23787574610365
Task_37304,972,777,183,180,363,1.249357326478149,25.595959257681756
Task_37305,1246,467,112,183,295,2.6623931623931623,28.729086275674238
Task_37306,1517,417,59,137,196,3.6291866028708135,32.415198173724775
Task_37307,2303,832,79,172,251,2.764705882352941,46.46253857165036
Task_37308,1021,1015,39,173,212,1.0049212598425197,26.355449556367805
Task_37309,504,775,76,147,223,0.6494845360824743,17.728606066403177
Task_37310,1686,956,38,199,237,1.761755485893417,36.98526807105883
Task_37311,2951,433,155,46,201,6.799539170506913,54.47333691690241
Task_37312,1164,724,76,193,269,1.6055172413793104,28.186357696290248
Task_37313,1279,392,167,23,190,3.2544529262086512,27.751297737945432
Task_37314,879,122,100,131,231,7.146341463414634,21.14102541970364
Task_37315,1095,233,44,92,136,4.67948717948718,24.571538941432923
Task_37316,2299,223,164,79,243,10.263392857142858,44.073478399884316
Task_37317,861,732,38,198,236,1.17462482946794,23.149985910397273
Task_37318,1466,224,112,104,216,6.515555555555555,30.939035262982063
Task_37319,2873,88,86,98,184,32.28089887640449,51.86085065610385
Task_37320,1319,273,86,80,166,4.813868613138686,28.403555241742595
Task_37321,2999,348,133,62,195,8.593123209169054,55.129195034981386
Task_37322,1442,865,194,19,213,1.6651270207852193,31.895762464044026
Task_37323,698,64,108,61,169,10.738461538461538,17.142403224352805
Task_37324,715,345,131,67,198,2.066473988439306,19.05821387664987
Task_37325,1446,965,200,73,273,1.4968944099378882,32.94079348245309
Task_37326,2429,449,145,166,311,5.397777777777778,47.44351347381968
Task_37327,2539,703,173,47,220,3.606534090909091,48.91960661031615
Task_37328,1396,562,147,17,164,2.479573712255773,30.00354424184762
Task_37329,528,240,117,70,187,2.190871369294606,15.69756487904806
Task_37330,739,270,49,101,150,2.726937269372694,19.19835100249855
Task_37331,1356,546,97,53,150,2.4789762340036563,29.524249653992516
Task_37332,2504,745,199,174,373,3.35656836461126,49.86685295675212
Task_37333,608,134,88,14,102,4.503703703703704,15.239688234111144
Task_37334,1014,804,50,60,110,1.2596273291925466,24.46732821883251
Task_37335,770,832,44,62,106,0.9243697478991597,20.655184385453886
Task_37336,912,501,132,139,271,1.8167330677290836,23.376130474203595
Task_37337,2642,553,91,138,229,4.768953068592058,50.74075006834699
Task_37338,636,404,133,138,271,1.5703703703703704,18.659380635896234
Task_37339,1733,107,104,78,182,16.046296296296298,33.77791933535659
Task_37340,1683,644,63,102,165,2.609302325581395,35.539070030386156
Task_37341,2210,751,26,86,112,2.9388297872340425,43.63553772964184
Task_37342,1888,624,155,180,335,3.0208,39.56607115580078
Task_37343,1214,618,83,113,196,1.9612277867528272,28.183752882339974
Task_37344,2108,161,164,145,309,13.012345679012345,41.120414248910514
Task_37345,2201,833,39,179,218,2.6390887290167866,44.660978237411406
Task_37346,2604,512,168,171,339,5.076023391812866,50.55184417360832
Task_37347,2729,723,22,57,79,3.7693370165745854,50.89076182489908
Task_37348,702,496,66,186,252,1.4124748490945673,20.047058694925
Task_37349,2056,91,22,96,118,22.347826086956523,38.28281150571767
Task_37350,2247,580,36,181,217,3.8674698795180724,44.596378894109954
Task_37351,2211,577,116,109,225,3.8252595155709344,43.932679248897124
Task_37352,1192,248,149,186,335,4.78714859437751,27.35020367422104
Task_37353,2722,539,185,46,231,5.04074074074074,51.32966151055593
Task_37354,1682,1007,26,130,156,1.6686507936507937,36.40275477161792
Task_37355,1526,812,110,101,211,1.8769987699876998,33.74525546212172
Task_37356,2913,782,121,137,258,3.7203065134099615,55.890240055531045
Task_37357,2729,140,193,78,271,19.354609929078013,50.299288163158565
Task_37358,1067,982,153,147,300,1.0854526958290946,27.40044214900642
Task_37359,667,971,152,138,290,0.6862139917695473,21.12575118530313
Task_37360,2654,369,49,95,144,7.172972972972973,49.840599962116755
Task_37361,2073,241,126,54,180,8.566115702479339,40.045971082256735
Task_37362,1634,419,180,137,317,3.8904761904761904,34.748609633586526
Task_37363,901,624,93,117,210,1.4416,23.267316430492855
Task_37364,1841,382,137,46,183,4.806788511749347,36.64007714784366
Task_37365,1776,297,47,45,92,5.959731543624161,34.46847119755586
Task_37366,788,93,175,130,305,8.382978723404255,19.79638760601449
Task_37367,2423,127,98,168,266,18.9296875,45.683876258765224
Task_37368,1636,489,149,160,309,3.3387755102040817,35.001960934686664
Task_37369,812,607,120,200,320,1.3355263157894737,22.386827255019895
Task_37370,1291,337,102,174,276,3.8195266272189348,28.92605877323508
Task_37371,1280,404,163,170,333,3.1604938271604937,29.219037705647168
Task_37372,2292,365,109,79,188,6.262295081967213,44.19304336804978
Task_37373,796,882,43,22,65,0.9014722536806342,20.496551887240763
Task_37374,1448,833,97,173,270,1.73621103117506,32.94048908643029
Task_37375,1625,715,34,138,172,2.2695530726256985,34.8732491908017
Task_37376,1886,697,78,32,110,2.702005730659026,37.6806232403251
Task_37377,2620,183,22,110,132,14.23913043478261,48.302059614229755
Task_37378,2090,323,118,62,180,6.450617283950617,40.58493703118871
Task_37379,556,269,50,77,127,2.0592592592592593,16.17457548445921
Task_37380,756,1005,18,156,174,0.7514910536779325,21.974980642355302
Task_37381,2892,670,181,159,340,4.309985096870343,55.60521829872423
Task_37382,2247,357,184,61,245,6.276536312849162,43.47961868182147
Task_37383,1611,865,50,74,124,1.8602771362586605,34.63102764959419
Task_37384,1754,964,154,182,336,1.8176165803108808,38.51248948825006
Task_37385,1904,999,54,37,91,1.904,38.68803464504937
Task_37386,1805,393,98,69,167,4.581218274111675,36.31096302884909
Task_37387,1663,114,142,18,160,14.460869565217392,32.090395560816226
Task_37388,2645,267,150,130,280,9.869402985074627,50.047248221962114
Task_37389,998,591,30,95,125,1.6858108108108107,24.145660185733348
Task_37390,565,838,52,188,240,0.6734207389749702,18.999073573312156
Task_37391,2291,89,176,37,213,25.455555555555556,42.15523028192
Task_37392,774,965,70,78,148,0.8012422360248447,21.89907694106724
Task_37393,997,261,47,19,66,3.8053435114503817,21.451333378717937
Task_37394,1966,619,200,177,377,3.170967741935484,40.970525008369584
Task_37395,2887,711,138,200,338,4.054775280898877,55.70710307934731
Task_37396,1331,250,90,36,126,5.302788844621514,27.7376820800434
Task_37397,2115,272,41,100,141,7.747252747252747,40.83921185171871
Task_37398,915,75,45,83,128,12.039473684210526,20.497288172095786
Task_37399,1536,447,190,68,258,3.4285714285714284,32.64406327762091
Task_37400,1809,594,120,20,140,3.0403361344537814,36.41232410442519
Task_37401,2009,393,27,116,143,5.098984771573604,39.579323947860765
Task_37402,1466,718,65,19,84,2.0389429763560503,30.772451388686402
Task_37403,959,75,25,113,138,12.618421052631579,21.167984091708604
Task_37404,1516,477,126,194,320,3.1715481171548117,33.16357426166693
Task_37405,2382,376,35,62,97,6.318302387267905,44.65654448250234
Task_37406,1326,163,115,160,275,8.085365853658537,28.667500108569044
Task_37407,568,255,52,125,177,2.21875,16.758516527857324
Task_37408,1245,377,35,114,149,3.2936507936507935,27.513243462345326
Task_37409,790,776,74,65,139,1.0167310167310166,21.30510917217362
Task_37410,1372,241,10,178,188,5.669421487603306,29.442600875239624
Task_37411,1876,473,50,37,87,3.957805907172996,36.585944444333855
Task_37412,1909,150,83,98,181,12.642384105960264,37.25949938585558
Task_37413,565,718,146,16,162,0.7858136300417247,17.331284015951432
Task_37414,2203,949,44,84,128,2.3189473684210524,44.532713986769544
Task_37415,857,230,180,83,263,3.70995670995671,21.450369091321903
Task_37416,2290,925,192,51,243,2.473002159827214,45.95953102309835
Task_37417,534,798,200,157,357,0.6683354192740926,18.814875162408825
Task_37418,911,714,40,155,195,1.274125874125874,23.63717465550181
Task_37419,1984,881,170,50,220,2.249433106575964,40.753235319722286
Task_37420,2218,337,61,44,105,6.562130177514793,41.590821581960974
Task_37421,2403,225,172,83,255,10.632743362831858,45.81378514016816
Task_37422,2578,714,186,152,338,3.6055944055944056,50.751441764653954
Task_37423,2520,416,110,88,198,6.043165467625899,48.09261030963072
Task_37424,1288,956,139,35,174,1.3458725182863114,29.643996559889757
Task_37425,2509,990,198,165,363,2.5317860746720484,50.65437008788473
Task_37426,2166,265,143,105,248,8.142857142857142,42.28913953030939
Task_37427,1821,561,61,161,222,3.2402135231316724,37.83603129776595
Task_37428,1964,761,77,134,211,2.57742782152231,40.64059259592012
Task_37429,828,262,55,149,204,3.1482889733840302,21.06994490526128
Task_37430,1350,648,158,125,283,2.0801232665639446,30.80552871462434
Task_37431,1718,945,85,17,102,1.8160676532769555,35.629923614305035
Task_37432,2151,322,170,150,320,6.659442724458204,42.64032759261412
Task_37433,1403,414,38,156,194,3.3807228915662653,30.560317364927982
Task_37434,942,514,122,174,296,1.829126213592233,24.055782267964684
Task_37435,2713,1011,34,32,66,2.680830039525692,51.1441439191996
Task_37436,1114,791,54,184,238,1.4065656565656566,27.416441547985396
Task_37437,2091,987,98,25,123,2.116396761133603,41.93648615379688
Task_37438,933,796,158,127,285,1.1706398996235885,24.612503525357297
Task_37439,2078,368,138,56,194,5.631436314363143,40.628518434123784
Task_37440,1312,341,40,160,200,3.8362573099415203,28.91803225036459
Task_37441,2825,152,154,71,225,18.464052287581698,51.619649158876655
Task_37442,1344,812,99,58,157,1.6531365313653137,30.131807376282822
Task_37443,1108,554,152,181,333,1.9963963963963964,26.98640896855913
Task_37444,2513,645,80,164,244,3.890092879256966,49.150906268486985
Task_37445,2743,485,141,119,260,5.6440329218107,52.23250477098338
Task_37446,865,659,79,189,268,1.3106060606060606,23.18962749489329
Task_37447,2584,538,102,70,172,4.794063079777366,49.105530798539604
Task_37448,778,797,82,177,259,0.974937343358396,22.12419810126589
Task_37449,2912,903,111,108,219,3.2212389380530975,56.03607566962969
Task_37450,1529,223,176,68,244,6.825892857142857,31.727538518840664
Task_37451,695,919,97,136,233,0.7554347826086957,21.048868708216656
Task_37452,1163,167,25,56,81,6.9226190476190474,24.3479849531024
Task_37453,2495,650,99,185,284,3.8325652841781874,49.04111278255554
Task_37454,1344,710,16,116,132,1.890295358649789,30.039132058284764
Task_37455,2010,149,192,169,361,13.4,39.799452622224834
Task_37456,1737,1020,140,175,315,1.7012732615083253,38.298542511369114
Task_37457,2569,810,60,160,220,3.1676942046855734,50.46008287084692
Task_37458,665,773,170,108,278,0.8591731266149871,20.266313558019178
Task_37459,2238,970,179,106,285,2.304840370751802,45.85958407232808
Task_37460,2782,439,66,82,148,6.322727272727272,52.10534175566778
Task_37461,2974,579,154,35,189,5.127586206896551,55.23989012237729
Task_37462,1720,399,22,129,151,4.3,35.0591178764337
Task_37463,2326,650,123,71,194,3.5729646697388633,45.545844767339624
Task_37464,1223,474,72,59,131,2.574736842105263,27.119619291667224
Task_37465,1358,967,73,76,149,1.4028925619834711,31.060963736237213
Task_37466,2068,609,132,50,182,3.3901639344262295,41.04097827341836
Task_37467,1196,434,169,26,195,2.749425287356322,26.62471468811812
Task_37468,1709,509,118,60,178,3.350980392156863,35.14025068005596
Task_37469,2346,937,196,128,324,2.5010660980810235,47.67621005813924
Task_37470,1416,439,61,163,224,3.2181818181818183,31.04869844695641
Task_37471,1128,805,28,109,137,1.3995037220843674,26.825578465529702
Task_37472,1863,375,48,147,195,4.954787234042553,37.75375365817086
Task_37473,978,998,185,142,327,0.978978978978979,26.19206883542068
Task_37474,2542,562,71,157,228,4.515097690941386,49.27009168593472
Task_37475,590,240,18,171,189,2.4481327800829877,17.114275765646976
Task_37476,614,212,136,178,314,2.8826291079812205,17.994415913020994
Task_37477,815,152,92,86,178,5.326797385620915,19.87459075918524
Task_37478,797,397,179,121,300,2.0025125628140703,21.333460327422472
Task_37479,559,542,94,194,288,1.0294659300184161,18.010534785957386
Task_37480,2177,231,102,54,156,9.383620689655173,41.43590912471555
Task_37481,911,181,159,196,355,5.0054945054945055,22.590337256931672
Task_37482,2898,606,33,13,46,4.774299835255354,52.590841471509584
Task_37483,1604,898,156,144,300,1.7842046718576197,35.69923634488003
Task_37484,2021,451,165,80,245,4.471238938053097,40.469285356495305
Task_37485,2010,724,154,21,175,2.7724137931034485,40.27843673786548
Task_37486,1983,472,66,84,150,4.192389006342495,39.50335048841461
Task_37487,2750,757,16,15,31,3.627968337730871,50.59101251810295
Task_37488,2458,529,152,63,215,4.637735849056604,47.295388622005284
Task_37489,1175,989,21,98,119,1.1868686868686869,27.95747644856476
Task_37490,2176,216,180,146,326,10.027649769585253,42.679048824087715
Task_37491,1964,576,119,54,173,3.4038128249566726,39.383082190209116
Task_37492,1651,178,145,174,319,9.223463687150838,34.01218815467842
Task_37493,2740,484,104,105,209,5.649484536082475,51.931372207583856
Task_37494,2090,490,54,105,159,4.256619144602851,41.30815860433155
Task_37495,1734,502,114,31,145,3.4473161033797215,35.10017338845156
Task_37496,1200,406,38,108,146,2.9484029484029484,26.859510530468658
Task_37497,2220,69,136,57,193,31.714285714285715,41.06475709697454
Task_37498,548,536,96,68,164,1.0204841713221602,16.856392619173405
Task_37499,2064,889,101,108,209,2.3191011235955057,42.51052178426347
Task_37500,1084,558,182,37,219,1.9391771019677997,25.396356088460507
Task_37501,1145,107,151,24,175,10.601851851851851,24.133125607498826
Task_37502,1430,635,42,73,115,2.248427672955975,30.888669941908926
Task_37503,1910,859,60,66,126,2.2209302325581395,39.27476552452919
Task_37504,2118,875,112,186,298,2.4178082191780823,43.837970339105944
Task_37505,1928,480,24,79,103,4.008316008316008,38.14354270828045
Task_37506,929,88,71,122,193,10.438202247191011,21.54136047328498
Task_37507,1341,158,38,79,117,8.433962264150944,27.518903959956727
Task_37508,2232,911,187,35,222,2.4473684210526314,44.684705513021726
Task_37509,705,958,104,153,257,0.735140771637122,21.445953111287224
Task_37510,1641,731,135,165,300,2.2418032786885247,35.809566922338604
Task_37511,2965,1024,69,169,238,2.892682926829268,57.501600890554386
Task_37512,1699,900,18,56,74,1.8856825749167592,34.99976826823097
Task_37513,2286,806,54,15,69,2.83271375464684,43.52960027198304
Task_37514,1756,344,52,179,231,5.089855072463768,36.180332381935145
Task_37515,2401,252,40,72,112,9.4901185770751,44.90369811250838
Task_37516,1132,502,75,43,118,2.250497017892644,25.204657251818336
Task_37517,2651,569,72,109,181,4.650877192982456,50.69853927667993
Task_37518,1263,460,161,136,297,2.7396963123644253,28.916125170256084
Task_37519,1329,158,93,113,206,8.358490566037736,28.349246177930443
Task_37520,2365,1006,27,93,120,2.348560079443893,46.962590704944745
Task_37521,634,936,135,41,176,0.6766275346851655,19.51892895954464
Task_37522,974,470,82,147,229,2.067940552016985,24.124798446712337
Task_37523,2913,99,111,89,200,29.13,52.568487312091456
Task_37524,1063,610,173,122,295,1.739770867430442,26.17766619291778
Task_37525,1719,708,129,55,184,2.4245416078984485,35.959515483851966
Task_37526,1250,474,117,90,207,2.6315789473684212,28.249864235845823
Task_37527,624,802,55,31,86,0.7770859277708593,17.95000238923696
Task_37528,1155,580,153,121,274,1.9879518072289157,27.45818264756694
Task_37529,586,782,193,91,284,0.7484035759897829,18.98269532567939
Task_37530,1218,115,102,162,264,10.5,26.579907478690444
Task_37531,2746,650,82,40,122,4.218125960061444,51.257299141016055
Task_37532,2452,317,153,103,256,7.710691823899371,47.025743936684925
Task_37533,2837,800,175,90,265,3.5418227215980025,54.67375365755485
Task_37534,2932,609,157,197,354,4.80655737704918,56.1631125167011
Task_37535,1116,762,111,122,233,1.4626474442988204,27.170372945792977
Task_37536,1510,746,60,196,256,2.0214190093708164,33.69765360751188
Task_37537,2560,615,10,127,137,4.1558441558441555,48.95956688793036
Task_37538,1168,713,178,188,366,1.6358543417366946,28.578414083153348
Task_37539,1358,346,37,56,93,3.913544668587896,28.302045230890204
Task_37540,2137,686,132,138,270,3.1106259097525473,43.35063699071177
Task_37541,1134,844,152,200,352,1.3420118343195266,28.367641680096757
Task_37542,906,640,72,121,193,1.4134165366614664,23.3472378220513
Task_37543,674,476,188,69,257,1.4129979035639413,19.05617471480573
Task_37544,600,822,131,174,305,0.7290400972053463,19.6661709752956
Task_37545,1435,583,171,174,345,2.4571917808219177,32.2992915711039
Task_37546,611,472,142,118,260,1.291754756871036,18.379003513031236
Task_37547,2950,339,103,134,237,8.676470588235293,54.937666904176886
Task_37548,1907,642,34,163,197,2.9657853810264387,39.28882480821789
Task_37549,2866,91,97,169,266,31.152173913043477,52.28968619447224
Task_37550,893,917,96,12,108,0.9727668845315904,22.717115012184326
Task_37551,2233,901,195,71,266,2.475609756097561,45.18629335074664
Task_37552,2238,390,102,21,123,5.723785166240409,42.35889046749248
Task_37553,1344,87,98,103,201,15.272727272727273,27.99135317697211
Task_37554,1688,846,112,197,309,1.9929161747343564,37.00018303458688
Task_37555,1859,637,72,69,141,2.913793103448276,37.816703831709575
Task_37556,1392,914,37,172,209,1.521311475409836,32.01947547756896
Task_37557,2205,257,53,91,144,8.546511627906977,42.28297424877264
Task_37558,2497,742,104,187,291,3.360699865410498,49.39599941453533
Task_37559,2758,322,56,63,119,8.538699690402476,50.75028730368329
Task_37560,2844,302,125,84,209,9.386138613861386,52.857155692334125
Task_37561,2602,661,143,92,235,3.930513595166163,50.36005655488959
Task_37562,1336,185,52,116,168,7.182795698924731,28.469758858232932
Task_37563,726,507,154,137,291,1.4291338582677164,20.483582226298548
Task_37564,2742,538,121,117,238,5.087198515769944,52.286319819032805
Task_37565,1417,700,74,151,225,2.021398002853067,31.866448636022536
Task_37566,1946,404,135,194,329,4.8049382716049385,39.77490630278729
Task_37567,1213,575,38,168,206,2.1059027777777777,28.13328247264899
Task_37568,2977,327,13,43,56,9.076219512195122,53.20702993772824
Task_37569,737,808,197,39,236,0.9110012360939431,20.820060999711888
Task_37570,2417,463,135,120,255,5.209051724137931,46.97936061738352
Task_37571,1388,643,160,33,193,2.1552795031055902,30.342536319667676
Task_37572,2135,81,135,159,294,26.036585365853657,40.8464646167124
Task_37573,1902,219,34,134,168,8.645454545454545,37.6014179790807
Task_37574,2246,170,155,189,344,13.134502923976608,43.54665705907862
Task_37575,536,81,178,140,318,6.536585365853658,15.869228159823413
Task_37576,1951,484,132,186,318,4.022680412371134,40.05126622267216
Task_37577,2687,272,81,150,231,9.842490842490843,50.591059647510555
Task_37578,1037,389,186,158,344,2.658974358974359,25.358135689353407
Task_37579,1057,611,64,190,254,1.727124183006536,26.070922470012828
Task_37580,611,423,99,51,150,1.4410377358490567,17.23932627307242
Task_37581,1131,910,198,169,367,1.2414928649835346,28.529199904788186
Task_37582,793,202,102,187,289,3.9064039408866993,20.687495356084888
Task_37583,1114,351,174,20,194,3.164772727272727,25.007332197565304
Task_37584,2991,933,182,158,340,3.202355460385439,58.000444990065375
Task_37585,2591,100,152,134,286,25.653465346534652,48.06089985702874
Task_37586,2570,900,138,193,331,2.8523862375138735,51.23698150629648
Task_37587,1222,209,25,112,137,5.819047619047619,26.463162780629364
Task_37588,1696,832,63,62,125,2.036014405762305,35.584621370087284
Task_37589,2958,964,89,200,289,3.0652849740932644,57.38515127927303
Task_37590,1915,152,196,105,301,12.516339869281046,37.95100642373785
Task_37591,769,151,112,38,150,5.059210526315789,18.368964837671722
Task_37592,1477,594,123,27,150,2.4823529411764707,31.264963963415454
Task_37593,2231,404,106,24,130,5.508641975308642,42.44879616796354
Task_37594,1353,133,55,61,116,10.097014925373134,27.257972350876543
Task_37595,1831,99,105,113,218,18.31,35.78047270358495
Task_37596,876,290,102,183,285,3.0103092783505154,22.26496035430253
Task_37597,1290,575,37,185,222,2.2395833333333335,29.46364281954435
Task_37598,1864,867,151,135,286,2.1474654377880182,39.65963351064046
Task_37599,1237,150,29,112,141,8.19205298013245,26.101366308806462
Task_37600,1237,626,35,70,105,1.9728867623604465,27.534631175874676
Task_37601,1098,531,196,110,306,2.06390977443609,26.530213713917572
Task_37602,1590,88,117,133,250,17.865168539325843,32.120954053789944
Task_37603,716,749,60,32,92,0.9546666666666667,19.23915127741701
Task_37604,1853,196,60,93,153,9.406091370558375,36.53974973191871
Task_37605,2178,275,154,149,303,7.891304347826087,42.8265959221261
Task_37606,1243,687,46,47,93,1.806686046511628,27.337005526519942
Task_37607,1159,469,104,130,234,2.4659574468085106,27.005645057637395
Task_37608,1429,584,28,135,163,2.442735042735043,31.261471918881835
Task_37609,1085,556,162,147,309,1.947935368043088,26.47046892040036
Task_37610,1936,360,56,84,140,5.362880886426593,38.364567994950384
Task_37611,759,335,83,48,131,2.2589285714285716,19.08783119614816
Task_37612,2146,269,133,140,273,7.948148148148148,42.15123454023388
Task_37613,1739,984,40,199,239,1.765482233502538,37.92106259635413
Task_37614,2387,429,144,129,273,5.551162790697674,46.487846610353905
Task_37615,580,902,25,114,139,0.6423034330011074,18.664015230347733
Task_37616,1465,582,162,150,312,2.5128644939965694,32.58730799977708
Task_37617,801,813,132,131,263,0.984029484029484,22.51354754478801
Task_37618,1275,154,185,45,230,8.225806451612904,26.902637202136503
Task_37619,2339,548,155,92,247,4.260473588342441,45.8895131872949
Task_37620,2990,226,193,50,243,13.17180616740088,54.62846993712237
Task_37621,2496,293,167,77,244,8.489795918367347,47.37924507450378
Task_37622,1655,772,18,51,69,2.1410090556274257,33.874169861174565
Task_37623,1935,83,174,109,283,23.035714285714285,37.60491085449494
Task_37624,1513,176,160,123,283,8.548022598870057,31.590594008504272
Task_37625,2036,84,191,75,266,23.95294117647059,38.7200090937481
Task_37626,698,818,25,151,176,0.8522588522588522,20.450932992889474
Task_37627,1007,483,11,49,60,2.080578512396694,22.564878839309017
Task_37628,1060,841,75,30,105,1.2589073634204275,25.038605402422146
Task_37629,572,607,68,29,97,0.9407894736842105,16.68153360443771
Task_37630,1709,427,147,120,267,3.9929906542056073,35.71103336997103
Task_37631,2561,581,52,95,147,4.400343642611684,49.07167669831042
Task_37632,1070,100,68,24,92,10.594059405940595,22.145107725533638
Task_37633,822,191,68,23,91,4.28125,19.188071657215293
Task_37634,1659,909,40,47,87,1.823076923076923,34.53174098096708
Task_37635,2938,776,84,195,279,3.7812097812097814,56.45694622376582
Task_37636,2013,583,150,40,190,3.4469178082191783,40.04320404131996
Task_37637,1278,317,116,26,142,4.018867924528302,27.171462818449204
Task_37638,1192,858,94,158,252,1.3876600698486612,28.82507704387753
Task_37639,1189,387,56,27,83,3.064432989690722,25.367907351342
Task_37640,591,310,121,42,163,1.9003215434083602,16.54303776854842
Task_37641,663,294,152,30,182,2.247457627118644,17.697589085004907
Task_37642,2832,592,14,59,73,4.775716694772344,51.978922708275356
Task_37643,609,416,163,143,306,1.460431654676259,18.42368204651114
Task_37644,835,871,154,28,182,0.9575688073394495,22.3148844685455
Task_37645,564,649,84,198,282,0.8676923076923077,18.401392869166255
Task_37646,1872,890,32,45,77,2.101010101010101,37.49445403892482
Task_37647,969,588,154,184,338,1.6451612903225807,24.905085221983892
Task_37648,1199,332,77,154,231,3.6006006006006004,27.289560743257567
Task_37649,2857,470,11,47,58,6.065817409766455,51.79598645812795
Task_37650,652,323,193,76,269,2.0123456790123457,18.428294036198604
Task_37651,1262,173,130,196,326,7.252873563218391,27.949887277664022
Task_37652,1521,341,100,103,203,4.447368421052632,32.14381838210768
Task_37653,2374,161,128,34,162,14.654320987654321,43.87099834310826
Task_37654,720,439,175,57,232,1.6363636363636365,19.539050173654086
Task_37655,1464,176,105,105,210,8.271186440677965,30.46227478843797
Task_37656,2433,354,42,67,109,6.853521126760564,45.66769872908395
Task_37657,1467,484,169,28,197,3.024742268041237,31.103520579310295
Task_37658,1062,761,133,175,308,1.3937007874015748,26.72747793290698
Task_37659,602,841,192,47,239,0.7149643705463183,18.981379880815783
Task_37660,1053,676,19,40,59,1.5553914327917282,23.83528576758871
Task_37661,1852,662,143,83,226,2.793363499245852,38.41008466237576
Task_37662,1927,903,139,134,273,2.131637168141593,40.709895212796326
Task_37663,2184,905,145,176,321,2.410596026490066,45.06629341520719
Task_37664,598,1001,50,66,116,0.5968063872255489,18.94253752340078
Task_37665,2923,874,166,90,256,3.3405714285714287,56.22813916196984
Task_37666,2423,107,200,66,266,22.435185185185187,44.89481382795949
Task_37667,1748,134,121,86,207,12.948148148148148,34.587001845772775
Task_37668,2714,790,68,113,181,3.43109987357775,52.415855400003466
Task_37669,1939,831,200,120,320,2.3305288461538463,40.86699536687298
Task_37670,1371,692,71,155,226,1.9783549783549783,31.122585631106386
Task_37671,2591,991,76,70,146,2.6118951612903225,50.579909143701855
Task_37672,2663,635,123,180,303,4.187106918238993,51.73096033570223
Task_37673,2732,268,95,136,231,10.156133828996282,51.224118714829835
Task_37674,2153,895,85,25,110,2.4029017857142856,42.50449037407656
Task_37675,1945,634,124,36,160,3.062992125984252,38.8689321623727
Task_37676,1200,507,58,39,97,2.3622047244094486,26.006301553138282
Task_37677,858,69,52,152,204,12.257142857142858,20.44128598202447
Task_37678,1012,603,178,94,272,1.6754966887417218,25.196804497301077
Task_37679,1135,787,82,134,216,1.4403553299492386,27.530539424926612
Task_37680,719,905,172,32,204,0.7935982339955849,20.66053983988014
Task_37681,1848,370,165,132,297,4.981132075471698,37.87790394536659
Task_37682,2027,283,165,34,199,7.137323943661972,39.321759988909385
Task_37683,2029,752,89,56,145,2.694555112881806,40.80802944011599
Task_37684,2061,115,184,183,367,17.767241379310345,40.3328167466284
Task_37685,2965,808,78,119,197,3.665018541409147,56.5615619943374
Task_37686,742,489,154,86,240,1.5142857142857142,20.324930527030528
Task_37687,773,548,61,16,77,1.4080145719489983,18.83208629938157
Task_37688,2020,373,29,107,136,5.401069518716578,39.646247895809424
Task_37689,2642,825,87,151,238,3.198547215496368,51.622537849356156
Task_37690,2177,565,181,122,303,3.8462897526501765,43.726716559297394
Task_37691,1146,249,61,160,221,4.584,26.141994472145257
Task_37692,2956,501,16,163,179,5.888446215139442,55.30650344636206
Task_37693,2982,99,149,39,188,29.82,52.896106393754074
Task_37694,2667,173,118,95,213,15.327586206896552,49.451927004014856
Task_37695,1012,249,177,100,277,4.048,24.122140523471415
Task_37696,2072,755,150,25,175,2.740740740740741,41.38485114719388
Task_37697,2019,991,199,105,304,2.035282258064516,42.53863348196642
Task_37698,1293,315,200,75,275,4.091772151898734,28.559707989132477
Task_37699,1721,482,168,159,327,3.5631469979296067,36.404897217875224
Task_37700,1716,979,59,66,125,1.7510204081632652,36.47678517650484
Task_37701,1110,492,76,39,115,2.2515212981744424,24.810039609118494
Task_37702,2838,243,73,104,177,11.631147540983607,52.53902397841617
Task_37703,1429,459,174,109,283,3.106521739130435,31.437816240995105
Task_37704,810,348,14,89,103,2.320916905444126,20.03972493219196
Task_37705,1655,258,83,181,264,6.38996138996139,34.40851260547009
Task_37706,507,459,42,58,100,1.1021739130434782,15.19977473480786
Task_37707,2180,728,84,33,117,2.99039780521262,42.49975109904232
Task_37708,1238,894,12,69,81,1.3832402234636871,28.051277937055406
Task_37709,1524,107,112,93,205,14.11111111111111,30.898600947839498
Task_37710,2911,265,83,80,163,10.943609022556391,53.5809333325997
Task_37711,1729,889,28,21,49,1.942696629213483,35.06769812311507
Task_37712,1821,758,162,59,221,2.399209486166008,37.9108513699314
Task_37713,2870,993,127,93,220,2.887323943661972,55.617981057468945
Task_37714,963,377,182,104,286,2.5476190476190474,23.808570191329817
Task_37715,2440,439,176,173,349,5.545454545454546,47.76645435254837
Task_37716,1181,264,124,160,284,4.456603773584906,26.96215063464827
Task_37717,1738,648,146,70,216,2.6779661016949152,36.29054607462508
Task_37718,1765,186,98,123,221,9.438502673796792,35.611738473100864
Task_37719,772,110,56,84,140,6.954954954954955,18.45873460962877
Task_37720,2146,913,12,41,53,2.3479212253829322,41.88348603399758
Task_37721,1118,102,154,179,333,10.854368932038835,25.23993924675037
Task_37722,2596,445,69,68,137,5.820627802690583,48.85819948080135
Task_37723,2131,415,115,168,283,5.122596153846154,42.492909134494404
Task_37724,1489,240,119,140,259,6.178423236514523,31.60497017444194
Task_37725,2863,284,85,12,97,10.04561403508772,51.63090732500095
Task_37726,2055,113,118,151,269,18.026315789473685,39.730550303327306
Task_37727,2135,728,145,111,256,2.9286694101508917,43.348266281691814
Task_37728,2646,69,78,195,273,37.8,48.825682383984656
Task_37729,2626,458,95,181,276,5.721132897603486,50.46560777449894
Task_37730,1571,424,122,179,301,3.696470588235294,33.757141348919326
Task_37731,1586,293,76,83,159,5.394557823129252,32.643209982016536
Task_37732,2724,1004,28,120,148,2.71044776119403,52.87176082069191
Task_37733,729,727,161,50,211,1.0013736263736264,20.315325301261904
Task_37734,1693,773,69,199,268,2.1873385012919897,36.74251502423084
Task_37735,1153,357,30,59,89,3.2206703910614527,25.015542887896533
Task_37736,1426,419,90,134,224,3.395238095238095,31.02773877494587
Task_37737,636,815,131,186,317,0.7794117647058824,20.256647644247032
Task_37738,1463,824,155,19,174,1.7733333333333334,31.904975440581477
Task_37739,586,346,122,142,264,1.6887608069164266,17.68961141447335
Task_37740,716,825,34,153,187,0.8668280871670703,20.83145284756001
Task_37741,2898,727,70,83,153,3.980769230769231,54.77402569494938
Task_37742,2791,752,159,171,330,3.7065073041168657,54.23728544447558
Task_37743,977,395,164,106,270,2.467171717171717,24.01809214317679
Task_37744,2840,654,110,52,162,4.33587786259542,53.44272116021822
Task_37745,1299,561,123,155,278,2.311387900355872,29.74676508123831
Task_37746,573,853,54,121,175,0.6709601873536299,18.7425155930237
Task_37747,2354,777,147,98,245,3.025706940874036,46.91026937750835
Task_37748,537,231,87,120,207,2.314655172413793,16.233349267163828
Task_37749,1543,714,83,109,192,2.158041958041958,33.67085596557177
Task_37750,531,395,168,134,302,1.3409090909090908,17.099435100885177
Task_37751,2642,793,130,88,218,3.327455919395466,51.32020591756529
Task_37752,2052,668,98,57,155,3.0672645739910314,40.8855597946413
Task_37753,1688,625,18,47,65,2.696485623003195,33.76756279632907
Task_37754,2974,259,61,101,162,11.438461538461539,54.57451364238773
Task_37755,2797,882,81,25,106,3.1676104190260475,52.598786198398265
Task_37756,2280,726,132,50,182,3.1361760660247593,44.76771063963105
Task_37757,2219,598,23,175,198,3.704507512520868,44.08857938356672
Task_37758,1987,871,198,25,223,2.278669724770642,40.62773645631218
Task_37759,1613,991,101,103,204,1.626008064516129,35.63772709978613
Task_37760,2663,246,40,115,155,10.781376518218623,49.49509878475909
Task_37761,2430,386,108,66,174,6.27906976744186,46.18282376073882
Task_37762,736,796,66,169,235,0.9234629861982434,21.379129300764827
Task_37763,2518,522,72,107,179,4.81453154875717,48.44171921725402
Task_37764,1161,774,160,143,303,1.4980645161290322,28.277940511919436
Task_37765,1008,806,142,173,315,1.2490706319702602,26.029610653550538
Task_37766,2384,355,25,119,144,6.696629213483146,45.39037600156082
Task_37767,869,475,129,135,264,1.8256302521008403,22.576516853101992
Task_37768,2414,995,200,170,370,2.423694779116466,49.20336469532672
Task_37769,2494,231,160,87,247,10.75,47.254240742932915
Task_37770,2336,99,112,78,190,23.36,43.25030181291064
Task_37771,1566,825,198,102,300,1.8958837772397095,34.822044485668606
Task_37772,1937,208,85,141,226,9.267942583732058,38.42319000849977
Task_37773,2539,317,125,70,195,7.984276729559748,47.79849785185905
Task_37774,1284,802,91,15,106,1.5990037359900373,28.37534023774691
Task_37775,2969,899,60,45,105,3.298888888888889,55.275720239089736
Task_37776,1944,240,51,56,107,8.066390041493776,37.26455879764449
Task_37777,1078,978,199,150,349,1.101123595505618,27.791483847345308
Task_37778,2271,356,50,22,72,6.361344537815126,42.008375220548245
Task_37779,1953,566,72,174,246,3.4444444444444446,40.06212497205467
Task_37780,2643,145,138,61,199,18.102739726027398,48.50574865304884
Task_37781,1392,239,100,198,298,5.8,30.32996164902171
Task_37782,1249,147,62,179,241,8.43918918918919,27.314560966581997
Task_37783,1116,459,114,170,284,2.4260869565217393,26.577408532004227
Task_37784,1620,221,159,134,293,7.297297297297297,33.75138880706148
Task_37785,1644,503,158,14,172,3.261904761904762,33.73710866311221
Task_37786,1858,891,61,26,87,2.0829596412556053,37.51271068916293
Task_37787,2908,965,169,93,262,3.010351966873706,56.322014047630795
Task_37788,2633,698,14,151,165,3.7668097281831185,50.74848940437965
Task_37789,1878,748,155,12,167,2.507343124165554,38.20931685123989
Task_37790,1400,853,29,108,137,1.639344262295082,31.335379251914315
Task_37791,1752,402,84,10,94,4.347394540942928,34.43923818295706
Task_37792,1434,550,158,32,190,2.602540834845735,30.768210792663552
Task_37793,573,794,21,23,44,0.720754716981132,16.804460641423663
Task_37794,1218,797,132,110,242,1.5263157894736843,28.929102979836355
Task_37795,1408,355,11,127,138,3.955056179775281,29.89957976525326
Task_37796,2455,500,120,160,280,4.900199600798403,47.87211234980714
Task_37797,1201,151,114,15,129,7.901315789473684,25.045112923416994
Task_37798,961,267,158,82,240,3.5858208955223883,23.11146788197172
Task_37799,1137,383,193,175,368,2.9609375,27.05429591727676
Task_37800,1466,103,121,184,305,14.096153846153847,30.60783324849807
Task_37801,2953,691,107,28,135,4.267341040462428,54.85950350987702
Task_37802,2465,856,25,27,52,2.8763127187864646,46.70029974992263
Task_37803,2941,823,76,66,142,3.5691747572815533,55.53489929317309
Task_37804,533,747,137,47,184,0.7125668449197861,17.336421094963367
Task_37805,995,505,39,80,119,1.966403162055336,23.68931096951572
Task_37806,2710,898,145,157,302,3.014460511679644,53.265589693830954
Task_37807,924,338,99,174,273,2.725663716814159,23.11288732650723
Task_37808,2910,587,151,171,322,4.948979591836735,55.56189012058405
Task_37809,2994,744,157,141,298,4.018791946308725,57.23970488143531
Task_37810,1575,610,91,14,105,2.5777414075286416,32.37613993736161
Task_37811,2536,735,156,92,248,3.4456521739130435,49.60692145282672
Task_37812,1662,217,85,54,139,7.623853211009174,33.166505205472035
Task_37813,2238,348,39,46,85,6.412607449856734,41.93809591380691
Task_37814,1388,359,46,47,93,3.8555555555555556,28.59610679841177
Task_37815,2764,229,127,56,183,12.017391304347827,50.908041440963785
Task_37816,2170,857,169,178,347,2.5291375291375293,44.81484294553983
Task_37817,1579,1019,37,96,133,1.5480392156862746,34.77588100422158
Task_37818,1453,973,35,89,124,1.4917864476386038,32.43166435132654
Task_37819,1039,351,85,91,176,2.9517045454545454,24.34953832464647
Task_37820,2323,844,165,134,299,2.749112426035503,46.91756433054912
Task_37821,1061,988,166,89,255,1.0728008088978767,26.994764696054062
Task_37822,2058,602,169,133,302,3.4129353233830844,41.97127848361854
Task_37823,1893,439,76,15,91,4.302272727272728,36.75350410413301
Task_37824,522,866,191,85,276,0.6020761245674741,18.356623469548378
Task_37825,928,786,164,48,212,1.1791613722998728,23.639616617960765
Task_37826,1187,540,198,135,333,2.1940850277264325,28.12596806071115
Task_37827,1656,732,54,134,188,2.2592087312414733,35.55657189409788
Task_37828,2824,150,141,40,181,18.70198675496689,51.04245939175319
Task_37829,2907,647,63,189,252,4.486111111111111,55.48413034321089
Task_37830,879,921,74,73,147,0.9533622559652929,23.333273673413718
Task_37831,2234,460,147,153,300,4.845986984815618,44.32415593154286
Task_37832,1844,521,44,18,62,3.532567049808429,35.727737382721024
Task_37833,1406,221,27,52,79,6.333333333333333,28.308231606562916
Task_37834,1497,974,12,17,29,1.5353846153846153,31.388041231351764
Task_37835,1732,121,10,90,100,14.19672131147541,33.27681520937701
Task_37836,1240,106,52,67,119,11.588785046728972,25.439453827920804
Task_37837,2597,776,65,29,94,3.3423423423423424,49.031089298111056
Task_37838,846,213,44,146,190,3.953271028037383,21.068585838151787
Task_37839,2994,475,92,83,175,6.2899159663865545,55.63502699080377
Task_37840,904,920,43,77,120,0.9815418023887079,23.426426687890025
Task_37841,2955,355,55,18,73,8.30056179775281,52.70922285120159
Task_37842,1377,423,37,139,176,3.2476415094339623,30.06344657571047
Task_37843,2294,884,55,50,105,2.592090395480226,44.69342277159718
Task_37844,1680,247,67,90,157,6.774193548387097,34.032708555659134
Task_37845,2761,443,111,67,178,6.218468468468468,51.63213972480096
Task_37846,2458,892,103,57,160,2.7525195968645018,48.03116577469757
Task_37847,1774,651,69,99,168,2.7208588957055215,36.99305880550248
Task_37848,2227,651,76,189,265,3.415644171779141,44.78501270620012
Task_37849,1149,615,133,91,224,1.8652597402597402,27.14830833212358
Task_37850,914,981,174,65,239,0.9307535641547862,24.470134400497443
Task_37851,2852,117,89,152,241,24.16949152542373,52.18570861922574
Task_37852,1868,154,72,88,160,12.051612903225806,36.294476230431655
Task_37853,651,1012,45,176,221,0.6426456071076012,20.75759243137794
Task_37854,1833,544,162,45,207,3.363302752293578,37.1410608709325
Task_37855,1684,112,100,92,192,14.902654867256636,33.338445079128896
Task_37856,2019,77,79,148,227,25.884615384615383,38.76659257033168
Task_37857,2891,534,52,35,87,5.40373831775701,52.80190323073136
Task_37858,2829,340,94,65,159,8.296187683284458,52.17909618546522
Task_37859,1444,475,67,91,158,3.033613445378151,31.03195646218096
Task_37860,2547,231,32,175,207,10.97844827586207,48.09893755983283
Task_37861,826,349,142,10,152,2.36,20.103008333330013
Task_37862,1268,616,46,176,222,2.055105348460292,29.240339535549538
Task_37863,2447,889,13,101,114,2.749438202247191,47.872033011243815
Task_37864,660,475,12,59,71,1.3865546218487395,17.182225886096
Task_37865,1723,227,84,56,140,7.557017543859649,34.19153448406586
Task_37866,2669,359,50,18,68,7.413888888888889,48.229365158802175
Task_37867,2437,113,88,35,123,21.37719298245614,44.11355686202694
Task_37868,1178,652,161,83,244,1.8039816232771821,27.78452637808238
Task_37869,1233,623,73,155,228,1.9759615384615385,28.730369964028153
Task_37870,2227,701,166,51,217,3.1723646723646723,44.14308439239144
Task_37871,523,827,105,151,256,0.6316425120772947,18.274968777260746
Task_37872,766,206,141,110,251,3.7004830917874396,19.990601651853073
Task_37873,2782,449,183,30,213,6.182222222222222,51.88424657806079
Task_37874,2725,369,179,35,214,7.364864864864865,50.724686990871525
Task_37875,2096,255,66,25,91,8.1875,39.37118872969349
Task_37876,2493,407,105,72,177,6.110294117647059,47.32884675167221
Task_37877,2642,508,18,84,102,5.19056974459725,49.53184847612473
Task_37878,779,843,198,88,286,0.9229857819905213,22.24580079651541
Task_37879,730,800,39,198,237,0.9113607990012484,21.257449045426082
Task_37880,813,538,167,128,295,1.5083487940630798,21.973686529978533
Task_37881,2367,396,173,175,348,5.962216624685139,46.468091331778965
Task_37882,2127,928,38,35,73,2.2895586652314317,41.63068846515407
Task_37883,1879,405,189,88,277,4.62807881773399,38.26908167998935
Task_37884,815,228,10,69,79,3.558951965065502,19.102219725042676
Task_37885,1488,714,46,123,169,2.081118881118881,32.66639058360685
Task_37886,2987,971,26,48,74,3.0730452674897117,55.47678008190322
Task_37887,1869,780,176,156,332,2.3930857874519846,39.70562641596589
Task_37888,1830,594,156,182,338,3.0756302521008405,38.56935707833438
Task_37889,2149,168,30,46,76,12.715976331360947,39.50792440978773
Task_37890,628,748,194,77,271,0.8384512683578104,19.395394152939204
Task_37891,2015,985,187,112,299,2.0436105476673427,42.44432462311541
Task_37892,1749,69,141,87,228,24.985714285714284,34.24291124058555
Task_37893,1068,973,88,42,130,1.0965092402464065,25.894381211908883
Task_37894,2718,490,88,81,169,5.535641547861507,51.20163957989868
Task_37895,1355,389,134,22,156,3.4743589743589745,28.66696715006078
Task_37896,2162,297,29,149,178,7.25503355704698,42.067384028424236
Task_37897,506,918,37,77,114,0.5505984766050055,17.29806543154054
Task_37898,1080,394,115,196,311,2.7341772151898733,25.961398972495804
Task_37899,2818,672,51,165,216,4.187221396731055,53.987551027894376
Task_37900,640,201,63,118,181,3.1683168316831685,17.71046021318483
Task_37901,1134,729,77,18,95,1.5534246575342465,25.679838224845387
Task_37902,1911,734,82,96,178,2.6,39.50398630298624
Task_37903,1348,382,110,83,193,3.519582245430809,29.391992420432743
Task_37904,2789,236,153,192,345,11.767932489451477,52.59010252683481
Task_37905,981,801,101,158,259,1.2231920199501247,25.31196186989496
Task_37906,613,480,79,12,91,1.2744282744282744,16.643900042084628
Task_37907,1261,840,96,58,154,1.4994054696789536,28.838013192974504
Task_37908,2881,1014,143,40,183,2.838423645320197,55.09966683366854
Task_37909,849,373,80,40,120,2.270053475935829,20.28625003786656
Task_37910,777,252,29,199,228,3.0711462450592886,20.345735331801276
Task_37911,1394,964,178,165,343,1.444559585492228,32.76055695363135
Task_37912,719,563,17,200,217,1.274822695035461,20.246192365415077
Task_37913,2877,411,40,141,181,6.983009708737864,53.75773110066509
Task_37914,2987,398,87,185,272,7.486215538847118,55.91755758644425
Task_37915,2802,474,193,72,265,5.8989473684210525,52.86363296248035
Task_37916,1020,246,36,34,70,4.129554655870446,21.946586937148414
Task_37917,2640,411,125,132,257,6.407766990291262,50.36456797377434
Task_37918,2948,744,134,182,316,3.9570469798657717,56.65221854186748
Task_37919,2563,612,18,130,148,4.181076672104404,49.09811122503071
Task_37920,2958,806,78,104,182,3.6654275092936803,56.31698123107708
Task_37921,1474,486,134,72,206,3.026694045174538,31.614081975451978
Task_37922,2152,619,122,14,136,3.470967741935484,41.85718333509309
Task_37923,966,69,39,198,237,13.8,22.28866710983101
Task_37924,1192,731,41,40,81,1.6284153005464481,26.606799252718393
Task_37925,1912,481,154,66,220,3.966804979253112,38.52899064225073
Task_37926,554,555,66,198,264,0.9964028776978417,17.915964187166296
Task_37927,599,819,68,194,262,0.7304878048780488,19.5388999055036
Task_37928,1010,593,49,194,243,1.7003367003367003,25.25251508934359
Task_37929,2886,675,131,181,312,4.269230769230769,55.432112391120235
Task_37930,1990,878,182,182,364,2.2639362912400456,42.110787237146575
Task_37931,2176,1014,84,127,211,2.1438423645320195,44.7210848798076
Task_37932,1367,548,177,124,301,2.4899817850637525,30.84086076111953
Task_37933,2654,687,15,78,93,3.8575581395348837,50.101527525726276
Task_37934,1770,902,136,123,259,1.9601328903654485,38.13984096996514
Task_37935,563,337,26,63,89,1.665680473372781,15.767928751948586
Task_37936,996,482,63,143,206,2.062111801242236,24.426334360177606
Task_37937,1030,978,104,199,303,1.052093973442288,26.899152476404492
Task_37938,2248,871,142,63,205,2.5779816513761467,45.003363926079714
Task_37939,851,508,191,44,235,1.6719056974459725,21.61053455479738
Task_37940,1399,913,35,163,198,1.5306345733041575,32.054132452260056
Task_37941,1420,315,120,122,242,4.493670886075949,30.664615770622365
Task_37942,757,929,177,80,257,0.8139784946236559,21.987468819540897
Task_37943,2989,943,34,195,229,3.1663135593220337,57.56602755941031
Task_37944,1797,663,149,111,260,2.7063253012048194,37.808275047413666
Task_37945,1739,513,173,168,341,3.3832684824902723,36.86488968368438
Task_37946,675,670,96,56,152,1.0059612518628913,18.97693145179772
Task_37947,2240,1019,177,109,286,2.196078431372549,46.05262302574193
Task_37948,2427,263,135,186,321,9.193181818181818,46.85438898132302
Task_37949,2188,694,70,110,180,3.148201438848921,43.78361992554347
Task_37950,2597,590,182,76,258,4.39424703891709,50.01544716819169
Task_37951,1541,952,195,117,312,1.6169989506820566,34.88309321551955
Task_37952,1270,197,13,161,174,6.414141414141414,27.639458740551948
Task_37953,1497,187,177,103,280,7.962765957446808,31.609334004802708
Task_37954,1323,829,123,129,252,1.5939759036144578,30.79425981135219
Task_37955,515,65,81,188,269,7.803030303030303,15.44373906978583
Task_37956,541,251,69,198,267,2.1468253968253967,16.85788997933672
Task_37957,2092,520,132,101,233,4.015355086372361,41.89104601381103
Task_37958,633,857,190,17,207,0.7377622377622378,19.10259494192751
Task_37959,2179,887,73,133,206,2.453828828828829,44.40953794265564
Task_37960,558,896,168,137,305,0.6220735785953178,19.252871356857877
Task_37961,800,814,113,51,164,0.9815950920245399,21.7448092669851
Task_37962,1579,655,64,22,86,2.4070121951219514,32.33753058131074
Task_37963,2138,242,55,41,96,8.798353909465021,39.97707892526916
Task_37964,2325,935,195,11,206,2.483974358974359,46.061929305738225
Task_37965,547,556,192,148,340,0.9820466786355476,18.066012617485512
Task_37966,1268,424,49,133,182,2.9835294117647058,28.416444544318082
Task_37967,1311,262,76,136,212,4.984790874524715,28.717096994284358
Task_37968,1435,753,56,139,195,1.903183023872679,32.17306656478457
Task_37969,2159,721,87,45,132,2.990304709141274,42.38985747634306
Task_37970,2847,976,81,36,117,2.9140225179119756,53.80713519667548
Task_37971,1946,488,131,159,290,3.9795501022494886,39.819156035854924
Task_37972,2150,507,144,14,158,4.232283464566929,41.60247254751685
Task_37973,1740,909,140,70,210,1.9120879120879122,37.10997575771822
Task_37974,1187,94,77,113,190,12.494736842105263,25.571865997309036
Task_37975,2978,65,146,120,266,45.121212121212125,53.79816703383478
Task_37976,1725,444,66,117,183,3.8764044943820224,35.67559167093341
Task_37977,2714,536,143,82,225,5.054003724394786,51.65547742832359
Task_37978,2450,164,114,88,202,14.848484848484848,45.871515928592
Task_37979,2020,919,199,189,388,2.1956521739130435,42.832269169861526
Task_37980,1350,710,23,124,147,1.8987341772151898,30.192236361218644
Task_37981,506,521,18,175,193,0.9693486590038314,16.601716552713857
Task_37982,2052,205,146,134,280,9.96116504854369,40.4543662140496
Task_37983,2511,563,47,171,218,4.452127659574468,48.73806918899447
Task_37984,1303,768,120,178,298,1.694408322496749,30.566975756419254
Task_37985,1488,472,13,46,59,3.145877378435518,30.107630791475913
Task_37986,1716,1008,164,155,319,1.7006937561942517,37.917238512532286
Task_37987,798,911,121,55,176,0.875,22.01299098461136
Task_37988,1658,192,76,11,87,8.590673575129534,32.27404732635886
Task_37989,1588,181,19,110,129,8.725274725274724,31.792832752803964
Task_37990,2607,712,198,142,340,3.656381486676017,51.19886682264479
Task_37991,1719,167,116,142,258,10.232142857142858,34.764957067975566
Task_37992,1142,665,125,137,262,1.7147147147147148,27.473623818448726
Task_37993,1271,102,140,191,331,12.339805825242719,27.652132507065904
Task_37994,2751,318,183,19,202,8.623824451410659,50.819917408669674
Task_37995,2433,297,180,182,362,8.164429530201343,47.249253743937174
Task_37996,2998,924,77,47,124,3.2410810810810813,56.19500080265388
Task_37997,2252,503,46,12,58,4.468253968253968,42.10567706140562
Task_37998,738,387,154,131,285,1.902061855670103,20.315436964364103
Task_37999,564,625,140,90,230,0.9009584664536742,17.945229924592493
Task_38000,2941,540,118,157,275,5.436229205175601,55.669064447118785
Task_38001,2627,760,180,50,230,3.45203679369251,50.60700666766431
Task_38002,1403,121,189,20,209,11.5,28.565344113774128
Task_38003,1421,418,184,33,217,3.3914081145584727,30.262742584452976
Task_38004,570,83,34,64,98,6.785714285714286,14.508611004627525
Task_38005,821,316,23,65,88,2.589905362776025,19.75186414548031
Task_38006,2976,450,167,152,319,6.598669623059867,56.120151797741585
Task_38007,2848,878,105,38,143,3.2400455062571103,53.87891932402897
Task_38008,1810,67,102,65,167,26.61764705882353,34.57205062425617
Task_38009,2532,355,145,143,288,7.112359550561798,48.623914743793726
Task_38010,1425,778,154,128,282,1.829268292682927,32.39888321243273
Task_38011,2471,185,44,37,81,13.28494623655914,45.17085220275201
Task_38012,1260,245,35,194,229,5.121951219512195,27.962557372510034
Task_38013,1048,321,144,90,234,3.2546583850931676,24.68692360532131
Task_38014,1439,1011,161,164,325,1.4219367588932805,33.536690165863284
Task_38015,898,283,168,24,192,3.1619718309859155,21.381648455234323
Task_38016,2023,721,108,145,253,2.801939058171745,41.58842241258356
Task_38017,2641,629,117,47,164,4.192063492063492,50.05444109258972
Task_38018,2322,322,65,196,261,7.188854489164087,45.215793276156866
Task_38019,631,800,114,163,277,0.787765293383271,19.91707242587388
Task_38020,1872,233,114,151,265,8.0,37.67337129120861
Task_38021,2396,981,61,88,149,2.439918533604888,47.68829452507356
Task_38022,712,718,37,25,62,0.9902642559109874,18.679306630997576
Task_38023,1761,927,177,69,246,1.8976293103448276,37.652882024693575
Task_38024,849,443,89,123,212,1.912162162162162,21.886500769124183
Task_38025,2190,263,34,133,167,8.295454545454545,42.302613948288204
Task_38026,895,277,109,111,220,3.2194244604316546,22.12457594018932
Task_38027,1678,201,142,116,258,8.306930693069306,34.409891191283585
Task_38028,1662,109,148,105,253,15.10909090909091,33.36523952426118
Task_38029,1178,812,115,23,138,1.4489544895448954,27.08064374761678
Task_38030,2173,531,132,142,274,4.084586466165414,43.45356189316461
Task_38031,2399,504,78,197,275,4.75049504950495,47.09710204403785
Task_38032,2933,494,170,110,280,5.925252525252525,55.346630977570726
Task_38033,506,692,43,75,118,0.7301587301587301,16.51605794135551
Task_38034,1477,712,115,153,268,2.0715287517531555,32.99050301114918
Task_38035,2739,866,45,34,79,3.1591695501730106,51.26633349078327
Task_38036,1704,602,130,193,323,2.825870646766169,36.54770247396596
Task_38037,2593,113,55,38,93,22.74561403508772,46.14345513584234
Task_38038,760,930,67,45,112,0.8163265306122449,20.717715647851712
Task_38039,1388,139,187,162,349,9.914285714285715,29.827160233841997
Task_38040,2747,773,137,168,305,3.549095607235142,53.489311580400305
Task_38041,1687,1024,31,27,58,1.6458536585365853,34.95251553110575
Task_38042,2341,986,94,184,278,2.3718338399189465,47.634691584916446
Task_38043,692,297,194,67,261,2.3221476510067114,18.825669040805955
Task_38044,1058,224,142,182,324,4.702222222222222,25.096677584212546
Task_38045,1121,248,25,137,162,4.502008032128514,25.233012322461715
Task_38046,1681,806,42,35,77,2.0830235439900866,34.24441833127752
Task_38047,2127,904,61,194,255,2.350276243093923,43.95603280908716
Task_38048,2617,805,89,64,153,3.2468982630272953,50.223862363815634
Task_38049,1357,177,142,50,192,7.623595505617978,28.199816104469505
Task_38050,836,611,165,21,186,1.3660130718954249,21.38624480841142
Task_38051,811,567,180,106,286,1.4278169014084507,21.94848642522936
Task_38052,2269,395,18,174,192,5.72979797979798,44.1938981731117
Task_38053,1818,518,91,65,156,3.5028901734104045,36.748524973796606
Task_38054,2050,557,14,154,168,3.673835125448029,41.06776807665255
Task_38055,2538,558,66,26,92,4.540250447227192,47.400704581806615
Task_38056,1312,721,31,14,45,1.817174515235457,27.81308693919749
Task_38057,595,920,80,111,191,0.6460369163952225,19.407667239135723
Task_38058,2185,259,73,183,256,8.403846153846153,42.778310239449816
Task_38059,653,287,128,59,187,2.267361111111111,17.764192221479075
Task_38060,1166,563,95,166,261,2.0673758865248226,27.596813039901843
Task_38061,2479,987,142,132,274,2.5091093117408905,49.720114068867325
Task_38062,2499,618,34,57,91,4.037156704361874,47.18922668935804
Task_38063,1283,912,138,118,256,1.4052573932092005,30.379435422850534
Task_38064,687,971,94,144,238,0.7067901234567902,21.2044962378075
Task_38065,1970,373,113,64,177,5.267379679144385,38.87325684192183
Task_38066,1976,268,43,102,145,7.345724907063197,38.6688005980265
Task_38067,1717,670,37,11,48,2.5588673621460507,34.101692259922466
Task_38068,998,638,176,130,306,1.5618153364632237,25.267510471741158
Task_38069,1670,128,199,73,272,12.945736434108527,33.426638224279756
Task_38070,1182,583,115,121,236,2.0239726027397262,27.723868134614126
Task_38071,2977,360,163,122,285,8.246537396121884,55.63606338593263
Task_38072,2919,699,23,23,46,4.17,53.2988586011551
Task_38073,2715,779,60,109,169,3.480769230769231,52.32298476608921
Task_38074,2366,523,61,35,96,4.515267175572519,44.498074943506424
Task_38075,1345,259,63,118,181,5.173076923076923,29.040525759697164
Task_38076,861,308,97,183,280,2.7864077669902914,22.071060167140818
Task_38077,2665,84,33,55,88,31.352941176470587,47.22566698894652
Task_38078,2776,261,52,195,247,10.595419847328245,52.11398390382328
Task_38079,2409,940,151,78,229,2.5600425079702442,48.059448571411046
Task_38080,774,287,101,88,189,2.6875,20.00954798580131
Task_38081,2519,477,40,178,218,5.2698744769874475,48.567599068215905
Task_38082,1949,231,48,24,72,8.400862068965518,36.498242477220344
Task_38083,2383,126,93,44,137,18.763779527559056,43.55111236880177
Task_38084,970,230,90,25,115,4.199134199134199,21.720110616235868
Task_38085,736,440,48,89,137,1.6689342403628118,19.597250463119945
Task_38086,2376,681,68,24,92,3.4838709677419355,45.22464172174616
Task_38087,2765,930,188,160,348,2.969924812030075,54.448879997886365
Task_38088,976,482,90,98,188,2.020703933747412,23.881956224236177
Task_38089,960,674,174,135,309,1.4222222222222223,24.787372550843504
Task_38090,1842,842,63,99,162,2.185053380782918,38.5472874737593
Task_38091,594,130,17,54,71,4.534351145038168,14.852043366270998
Task_38092,2216,197,94,164,258,11.191919191919192,43.00606160784442
Task_38093,1333,88,135,12,147,14.97752808988764,26.46915636425061
Task_38094,1856,634,97,125,222,2.9228346456692913,38.508529943266375
Task_38095,2858,535,94,195,289,5.332089552238806,54.46781908499892
Task_38096,623,683,165,200,365,0.9108187134502924,19.85636490185483
Task_38097,2061,901,69,115,184,2.2849223946784925,42.43261564544494
Task_38098,2934,371,54,186,240,7.887096774193548,54.95447502833226
Task_38099,2325,207,28,152,180,11.177884615384615,44.31543416992461
Task_38100,2572,260,131,119,250,9.854406130268199,48.71663704469487
Task_38101,1649,748,157,10,167,2.2016021361815756,34.57862395401579
Task_38102,1168,156,141,91,232,7.439490445859873,25.763588378143805
Task_38103,852,797,178,118,296,1.0676691729323309,23.368393086304735
Task_38104,1663,312,40,91,131,5.313099041533547,33.8438244679979
Task_38105,968,72,25,20,45,13.26027397260274,19.415547519666017
Task_38106,1852,902,185,55,240,2.05094130675526,38.94890795110712
Task_38107,2426,246,91,173,264,9.821862348178138,46.499731136046215
Task_38108,2786,956,46,185,231,2.911180773249739,54.405953412273824
Task_38109,550,158,82,88,170,3.459119496855346,15.740646847370309
Task_38110,2084,127,81,178,259,16.28125,40.378060582215255
Task_38111,2006,268,83,76,159,7.4572490706319705,39.06520315044746
Task_38112,958,680,126,25,151,1.406754772393539,23.290169307046913
Task_38113,2779,642,73,20,93,4.321928460342146,51.46662598118214
Task_38114,607,236,151,143,294,2.561181434599156,17.82080017996087
Task_38115,2426,722,163,34,197,3.355463347164592,47.051651009961
Task_38116,1412,990,85,41,126,1.4248234106962665,31.31417977824341
Task_38117,1896,261,25,104,129,7.236641221374046,37.33669431781248
Task_38118,1863,114,68,191,259,16.2,36.80218670420485
Task_38119,2908,821,48,194,242,3.537712895377129,56.005034598724144
Task_38120,897,231,114,150,264,3.8663793103448274,22.260126503379098
Task_38121,968,482,97,56,153,2.0041407867494825,23.108734742577866
Task_38122,2428,986,20,168,188,2.459979736575481,48.54556860823909
Task_38123,1459,907,162,103,265,1.6068281938325992,33.21175680360778
Task_38124,1652,812,77,105,182,2.031980319803198,35.64583700876967
Task_38125,1234,317,22,48,70,3.880503144654088,25.66691785354801
Task_38126,1887,828,135,154,289,2.2762364294330517,39.94388119921649
Task_38127,2212,818,101,165,266,2.700854700854701,44.974304785787865
Task_38128,578,365,166,179,345,1.5792349726775956,18.012883142682096
Task_38129,2980,777,83,35,118,3.8303341902313623,55.304568020397255
Task_38130,1291,886,71,43,114,1.455467869222097,28.92622409454684
Task_38131,2453,659,60,157,217,3.716666666666667,48.129048611168706
Task_38132,2497,646,132,66,198,3.8593508500772797,48.21869530592875
Task_38133,873,259,167,164,331,3.3576923076923078,22.296037203831776
Task_38134,1217,162,131,153,284,7.466257668711656,26.97720018508573
Task_38135,2904,768,94,200,294,3.776332899869961,55.96844212890209
Task_38136,2566,256,176,157,333,9.98443579766537,49.03690209497076
Task_38137,2907,618,79,68,147,4.696284329563813,54.389497885461964
Task_38138,2643,542,179,37,216,4.867403314917127,50.01758634138082
Task_38139,1055,864,42,27,69,1.2196531791907514,24.541787460605946
Task_38140,1717,1006,160,109,269,1.70506454816286,37.634096936421834
Task_38141,835,75,147,11,158,10.986842105263158,18.575090449730215
Task_38142,2597,1010,179,175,354,2.568743818001978,52.08531622063392
Task_38143,1031,140,37,66,103,7.3120567375886525,22.23207821128483
Task_38144,2706,336,130,54,184,8.029673590504451,50.391583226524006
Task_38145,1334,687,178,180,358,1.938953488372093,31.092543336262008
Task_38146,2816,355,64,61,125,7.910112359550562,51.7438404725807
Task_38147,2336,781,110,88,198,2.9872122762148337,46.34450804440638
Task_38148,632,64,196,169,365,9.723076923076922,17.659543051952088
Task_38149,690,525,127,98,225,1.311787072243346,19.629586225700958
Task_38150,897,386,134,119,253,2.317829457364341,22.66617933332161
Task_38151,969,254,32,121,153,3.8,22.708601086806997
Task_38152,507,696,87,88,175,0.727403156384505,17.036682682260494
Task_38153,2299,514,37,14,51,4.464077669902912,42.8631717658493
Task_38154,2128,154,180,89,269,13.729032258064516,41.071720619325355
Task_38155,2721,924,197,60,257,2.9416216216216218,52.85246023307894
Task_38156,734,71,133,103,236,10.194444444444445,18.562490641806658
Task_38157,2265,783,90,122,212,2.889030612244898,45.392356935848944
Task_38158,1513,569,200,128,328,2.6543859649122807,33.346375542245674
Task_38159,2174,743,39,115,154,2.922043010752688,43.34824668767834
Task_38160,2597,143,73,128,201,18.03472222222222,48.275857760769306
Task_38161,2368,775,116,192,308,3.051546391752577,47.54000820186358
Task_38162,1678,962,38,14,52,1.742471443406023,34.429594175723544
Task_38163,2194,981,25,91,116,2.2342158859470467,44.13170447363381
Task_38164,2093,490,79,106,185,4.262729124236253,41.62840822132434
Task_38165,728,250,176,149,325,2.900398406374502,19.926425332691753
Task_38166,1174,540,150,172,322,2.1700554528650646,27.924790867168216
Task_38167,2453,578,16,182,198,4.236614853195164,47.725994770748194
Task_38168,1731,698,200,156,356,2.476394849785408,37.37123623313624
Task_38169,1868,606,195,105,300,3.077429983525535,38.924876572016196
Task_38170,1333,90,48,13,61,14.648351648351648,25.61502217679295
Task_38171,1753,657,150,55,205,2.664133738601824,36.45761052551257
Task_38172,1107,333,166,54,220,3.31437125748503,25.27901053521494
Task_38173,1571,227,142,107,249,6.890350877192983,32.761082563559576
Task_38174,1231,204,187,38,225,6.004878048780488,26.60397581007078
Task_38175,2719,740,36,48,84,3.669365721997301,50.87663899469169
Task_38176,1388,460,78,60,138,3.0108459869848154,29.682671646635942
Task_38177,712,213,191,138,329,3.3271028037383177,19.55401504916322
Task_38178,1406,582,173,68,241,2.411663807890223,30.93647701997133
Task_38179,1105,562,12,143,155,1.9626998223801067,25.879393594535653
Task_38180,2544,996,19,56,75,2.5516549648946842,48.68971912024211
Task_38181,940,1001,154,128,282,0.93812375249501,25.382981161733284
Task_38182,858,338,78,84,162,2.5309734513274336,21.349305834702815
Task_38183,776,457,67,114,181,1.6943231441048034,20.666391525616785
Task_38184,904,943,115,152,267,0.9576271186440678,24.60301201430029
Task_38185,1399,861,183,41,224,1.622969837587007,31.361516145930484
Task_38186,527,108,46,159,205,4.834862385321101,15.374001929678991
Task_38187,1641,324,69,40,109,5.049230769230769,32.63176303925808
Task_38188,922,190,183,75,258,4.827225130890052,22.25668446733305
Task_38189,1878,505,111,86,197,3.7114624505928853,38.204497225036754
Task_38190,2713,316,105,163,268,8.558359621451103,51.29154462843409
Task_38191,1579,736,162,146,308,2.1424694708276797,34.85122063551341
Task_38192,1205,271,162,16,178,4.430147058823529,26.07924072164097
Task_38193,1589,274,161,119,280,5.778181818181818,33.36597829803286
Task_38194,2200,940,68,191,259,2.3379383634431457,45.24459765449151
Task_38195,2135,207,135,152,287,10.264423076923077,41.83028815769053
Task_38196,1192,629,19,44,63,1.892063492063492,25.886745672610544
Task_38197,1414,661,47,82,129,2.13595166163142,31.085227968422668
Task_38198,1015,697,152,102,254,1.4541547277936964,25.433793914848664
Task_38199,1522,670,197,188,385,2.2682563338301045,34.15069542115902
Task_38200,1071,297,93,184,277,3.5939597315436242,25.374415645147774
Task_38201,1360,151,60,30,90,8.947368421052632,27.12228018316026
Task_38202,2562,379,178,180,358,6.742105263157895,49.54917071846055
Task_38203,2220,598,89,18,107,3.706176961602671,42.56449757107982
Task_38204,1245,474,191,182,373,2.6210526315789475,29.085487728343747
Task_38205,1061,731,160,28,188,1.4494535519125684,25.397726104020524
Task_38206,2104,271,182,114,296,7.735294117647059,41.56004943588129
Task_38207,1710,235,34,37,71,7.245762711864407,32.82656901571733
Task_38208,1507,134,97,133,230,11.162962962962963,31.11005864834338
Task_38209,2556,501,145,39,184,5.091633466135458,48.334133859288414
Task_38210,1820,784,72,168,240,2.3184713375796178,38.60471090207915
Task_38211,1106,573,110,16,126,1.9268292682926829,25.098814145182477
Task_38212,1221,72,62,133,195,16.726027397260275,26.060265234877917
Task_38213,672,429,86,134,220,1.5627906976744186,19.029448427223567
Task_38214,2394,591,124,86,210,4.043918918918919,46.7075324941951
Task_38215,2756,455,14,199,213,6.043859649122807,52.229204934446045
Task_38216,635,343,74,113,187,1.8459302325581395,18.12609491981359
Task_38217,2776,853,19,144,163,3.250585480093677,53.451490028763224
Task_38218,1886,468,128,181,309,4.021321961620469,38.923107383694195
Task_38219,1560,888,123,150,273,1.7547806524184477,34.85808788821428
Task_38220,2154,980,131,200,331,2.1957186544342506,44.90470313348775
Task_38221,682,290,167,106,273,2.343642611683849,19.03111991563195
Task_38222,1309,475,41,31,72,2.75,27.263093276907743
Task_38223,1066,551,163,126,289,1.931159420289855,26.033038007163565
Task_38224,1695,469,134,111,245,3.606382978723404,35.5118611758168
Task_38225,1500,362,77,86,163,4.132231404958677,31.67805201269176
Task_38226,2710,145,54,16,70,18.561643835616437,47.93587481210136
Task_38227,1628,932,141,170,311,1.744908896034298,36.27281740593396
Task_38228,1431,189,25,87,112,7.531578947368421,29.470849735050603
Task_38229,2731,543,118,61,179,5.020220588235294,51.431269162159715
Task_38230,1634,825,182,143,325,1.9782082324455206,36.07219534582841
Task_38231,1632,415,107,109,216,3.923076923076923,34.20781017817645
Task_38232,1581,142,111,20,131,11.055944055944057,30.958631165327954
Task_38233,836,884,107,116,223,0.9446327683615819,23.092014235842438
Task_38234,2290,492,88,93,181,4.645030425963489,44.60531603188323
Task_38235,1626,796,75,164,239,2.040150564617315,35.56311058742137
Task_38236,2541,820,161,79,240,3.095006090133983,49.84764494917962
Task_38237,1162,218,94,87,181,5.30593607305936,25.84515998101828
Task_38238,2314,112,126,58,184,20.47787610619469,42.84107562439356
Task_38239,2328,177,162,174,336,13.07865168539326,44.764131464285505
Task_38240,2466,143,94,11,105,17.125,44.71035981278978
Task_38241,889,943,24,50,74,0.9417372881355932,22.265629168901455
Task_38242,2891,956,169,126,295,3.0208986415882966,56.238032933335695
Task_38243,1367,884,84,87,171,1.544632768361582,31.116642960647997
Task_38244,1678,934,22,111,133,1.7946524064171123,36.02752505463597
Task_38245,2905,320,198,177,375,9.049844236760125,54.844539149176626
Task_38246,1204,277,27,198,225,4.330935251798561,27.148762019191093
Task_38247,2216,391,156,75,231,5.653061224489796,43.21188702191639
Task_38248,1465,1005,99,183,282,1.4562624254473162,33.76586677195345
Task_38249,2274,780,190,168,358,2.911651728553137,46.25665912216158
Task_38250,932,668,173,136,309,1.3931240657698056,24.326648330213143
Task_38251,2668,494,55,189,244,5.38989898989899,51.17457194208321
Task_38252,1134,528,42,129,171,2.1436672967863895,26.468627598262685
Task_38253,720,666,92,114,206,1.0794602698650675,20.429769439337367
Task_38254,2751,425,34,48,82,6.457746478873239,50.33803747623137
Task_38255,1347,71,59,108,167,18.708333333333332,27.794701367342824
Task_38256,906,447,85,190,275,2.0223214285714284,23.210454765183755
Task_38257,749,434,89,170,259,1.72183908045977,20.542844351095724
Task_38258,591,77,154,48,202,7.576923076923077,15.380295811622576
Task_38259,2075,517,82,69,151,4.005791505791506,40.824108784535724
Task_38260,2024,890,100,160,260,2.271604938271605,42.18592125517694
Task_38261,2358,416,88,61,149,5.654676258992806,44.91130439351934
Task_38262,610,821,85,105,190,0.7420924574209246,19.12739254121608
Task_38263,2077,682,79,171,250,3.04099560761347,42.40591399213498
Task_38264,1628,851,123,104,227,1.9107981220657277,35.55917874707207
Task_38265,1476,781,197,141,338,1.8874680306905371,33.48764698560875
Task_38266,1083,520,32,31,63,2.0786948176583495,23.787375256991947
Task_38267,1379,717,119,132,251,1.9206128133704736,31.34630059532604
Task_38268,1307,150,138,55,193,8.655629139072847,27.503620212840094
Task_38269,551,541,178,82,260,1.0166051660516606,17.516940874594326
Task_38270,2724,503,39,169,208,5.404761904761905,51.83904116292513
Task_38271,1870,336,129,178,307,5.548961424332345,38.22588197437495
Task_38272,1860,186,127,115,242,9.946524064171124,37.18938403710015
Task_38273,2920,336,105,58,163,8.664688427299703,53.691697590166335
Task_38274,2631,616,192,190,382,4.2641815235008105,51.53442213397059
Task_38275,859,177,63,138,201,4.825842696629214,20.94938153639595
Task_38276,655,575,175,175,350,1.1371527777777777,19.877729417643895
Task_38277,1420,380,171,80,251,3.727034120734908,30.756163006497186
Task_38278,1326,708,138,55,193,1.8702397743300423,29.799468567461762
Task_38279,2627,902,156,90,246,2.9091915836101885,51.580591914967044
Task_38280,1677,237,83,65,148,7.046218487394958,33.660208409763214
Task_38281,2859,193,31,192,223,14.737113402061855,52.94579402571468
Task_38282,1140,585,14,134,148,1.9453924914675769,26.48322579397055
Task_38283,2792,227,158,121,279,12.24561403508772,52.20094586202009
Task_38284,2105,358,161,12,173,5.8635097493036215,40.57845242246486
Task_38285,1251,181,124,18,142,6.873626373626373,26.016366151116866
Task_38286,2884,533,180,190,370,5.400749063670412,55.22046299642418
Task_38287,1492,506,184,51,235,2.942800788954635,31.96897881417222
Task_38288,509,904,182,78,260,0.5624309392265193,18.116785239004752
Task_38289,1541,870,62,69,131,1.7692307692307692,33.50906482969571
Task_38290,1550,124,189,30,219,12.4,31.004734944745405
Task_38291,2709,707,42,71,113,3.8262711864406778,51.37068966789055
Task_38292,551,91,177,47,224,5.989130434782608,14.906119851361817
Task_38293,1635,733,105,22,127,2.2275204359673024,34.00517278900977
Task_38294,501,269,58,197,255,1.8555555555555556,16.225144645854456
Task_38295,699,380,116,19,135,1.8346456692913387,18.126358450178575
Task_38296,2722,104,115,185,300,25.923809523809524,50.32223807968697
Task_38297,1971,210,78,52,130,9.341232227488153,38.040908954614586
Task_38298,2387,800,173,61,234,2.9800249687890137,47.06514819898425
Task_38299,921,213,108,31,139,4.303738317757009,21.187217746832612
Task_38300,540,728,189,66,255,0.7407407407407407,17.75286619077774
Task_38301,509,219,13,97,110,2.3136363636363635,15.022661956158577
Task_38302,1242,128,71,176,247,9.627906976744185,27.11038946250819
Task_38303,1378,849,26,196,222,1.6211764705882352,31.6764451164712
Task_38304,1252,567,70,11,81,2.204225352112676,26.97995170901645
Task_38305,2303,262,102,109,211,8.756653992395437,44.282551200992636
Task_38306,1502,608,121,150,271,2.4663382594417076,33.07013464523519
Task_38307,1773,783,52,31,83,2.2614795918367347,35.895874366597205
Task_38308,2396,322,123,54,177,7.41795665634675,45.41727599132897
Task_38309,1563,492,105,85,190,3.1703853955375254,33.12756738187186
Task_38310,906,72,140,158,298,12.41095890410959,21.605546319718048
Task_38311,1401,883,167,57,224,1.584841628959276,31.651205808166836
Task_38312,1837,89,26,98,124,20.41111111111111,34.89272337549081
Task_38313,2885,425,175,184,359,6.772300469483568,54.82421136060653
Task_38314,505,522,23,109,132,0.9655831739961759,16.141934508445097
Task_38315,675,229,47,36,83,2.9347826086956523,16.792646000252926
Task_38316,2634,668,125,12,137,3.937219730941704,49.65323545632481
Task_38317,2029,811,75,53,128,2.498768472906404,41.037087168447144
Task_38318,1247,801,21,48,69,1.554862842892768,27.400824777862255
Task_38319,2214,923,130,17,147,2.396103896103896,43.91409486018521
Task_38320,2782,146,72,47,119,18.92517006802721,49.72863680809937
Task_38321,2930,755,113,38,151,3.875661375661376,54.82890642951771
Task_38322,2883,379,69,154,223,7.586842105263158,54.05369705369315
Task_38323,1376,919,81,97,178,1.4956521739130435,31.570822954742695
Task_38324,1238,123,192,191,383,9.983870967741936,27.56177417438323
Task_38325,1346,772,62,149,211,1.7412677878395861,30.893136427513948
Task_38326,2124,456,26,52,78,4.647702407002188,40.436957191496695
Task_38327,2182,529,123,186,309,4.1169811320754715,43.81191280543942
Task_38328,2806,204,33,59,92,13.68780487804878,50.64227165393265
Task_38329,1797,713,43,157,200,2.5168067226890756,37.778696068721494
Task_38330,822,569,82,67,149,1.4421052631578948,21.182266103149065
Task_38331,995,278,52,10,62,3.5663082437275984,21.433638117038228
Task_38332,703,388,143,15,158,1.80719794344473,18.322712250150616
Task_38333,711,267,19,41,60,2.6529850746268657,17.12994336368106
Task_38334,1103,585,21,72,93,1.8822525597269624,25.14136086259335
Task_38335,1427,310,194,152,346,4.588424437299035,31.271498046591812
Task_38336,1956,154,84,55,139,12.619354838709677,37.24864582051116
Task_38337,2430,607,52,99,151,3.9967105263157894,47.01219900152984
Task_38338,708,788,82,26,108,0.8973384030418251,19.3915381466014
Task_38339,2804,570,136,78,214,4.910683012259194,53.082717463773115
Task_38340,1925,859,24,78,102,2.238372093023256,39.239887826974226
Task_38341,1003,93,193,57,250,10.670212765957446,22.400555497712087
Task_38342,2997,894,110,191,301,3.3486033519553073,57.845976161913164
Task_38343,682,812,137,106,243,0.8388683886838868,20.494845618235768
Task_38344,583,75,15,18,33,7.671052631578948,13.355745554075083
Task_38345,1901,601,25,118,143,3.1578073089700998,38.53495783061831
Task_38346,2331,497,60,130,190,4.680722891566265,45.51603646532192
Task_38347,1762,617,118,175,293,2.8511326860841426,37.35187885569009
Task_38348,1899,525,84,96,180,3.6102661596958177,38.629460317589235
Task_38349,1588,281,68,163,231,5.631205673758865,33.290776307730454
Task_38350,1842,269,73,50,123,6.822222222222222,35.89940767961436
Task_38351,1643,992,199,46,245,1.6545820745216515,35.72212739441863
Task_38352,1389,373,96,133,229,3.713903743315508,30.328748773656326
Task_38353,1591,822,97,147,244,1.9331713244228432,35.030063814077046
Task_38354,1763,554,183,54,237,3.1765765765765765,36.44344960329217
Task_38355,2815,976,85,179,264,2.881269191402252,55.040165002146715
Task_38356,738,151,30,53,83,4.855263157894737,17.535702723117968
Task_38357,2497,570,107,89,196,4.373029772329247,48.236685455111875
Task_38358,2827,459,69,182,251,6.145652173913043,53.601350405677685
Task_38359,1320,428,176,146,322,3.076923076923077,29.843915486998323
Task_38360,2033,539,150,94,244,3.7648148148148146,41.05020022227955
Task_38361,2006,321,177,129,306,6.229813664596273,40.25003169359134
Task_38362,2947,133,123,45,168,21.992537313432837,52.69394626337831
Task_38363,1937,767,147,115,262,2.5221354166666665,40.366685962050035
Task_38364,500,523,17,193,210,0.9541984732824428,16.594832164428414
Task_38365,2497,902,79,18,97,2.7652270210409746,47.81961785655938
Task_38366,1646,445,81,176,257,3.690582959641256,34.862119841241224
Task_38367,2901,798,113,174,287,3.6307884856070087,55.93544632314985
Task_38368,812,206,118,13,131,3.922705314009662,19.340524768585343
Task_38369,2213,432,77,27,104,5.1108545034642034,41.94786948019365
Task_38370,2969,440,139,82,221,6.732426303854876,55.36078846491504
Task_38371,2431,167,179,20,199,14.470238095238095,45.01565794780786
Task_38372,837,552,174,155,329,1.5135623869801085,22.590186574296933
Task_38373,527,582,167,185,352,0.9039451114922813,17.945272502082442
Task_38374,1320,467,168,183,351,2.8205128205128207,30.15283763575465
Task_38375,619,571,184,73,257,1.082167832167832,18.539300147592673
Task_38376,2905,733,102,136,238,3.957765667574932,55.517295717307945
Task_38377,1408,103,15,116,131,13.538461538461538,28.380982535495757
Task_38378,1012,75,46,140,186,13.31578947368421,22.68544515691239
Task_38379,1473,799,119,63,182,1.84125,32.360908566731084
Task_38380,1457,1003,34,78,112,1.451195219123506,32.40335572628462
Task_38381,521,939,67,154,221,0.5542553191489362,18.484715554680157
Task_38382,1419,410,181,53,234,3.4525547445255476,30.568202557830176
Task_38383,1114,773,173,118,291,1.4392764857881137,27.4283914077033
Task_38384,2174,84,169,99,268,25.576470588235296,41.30353007654731
Task_38385,2614,745,112,185,297,3.5040214477211795,51.28302414214685
Task_38386,1024,979,195,117,312,1.0448979591836736,26.727524496540596
Task_38387,1941,956,12,162,174,2.0282131661442007,40.63334255269543
Task_38388,1407,863,29,51,80,1.6284722222222223,30.483432878276375
Task_38389,2099,185,59,142,201,11.28494623655914,40.7515616274058
Task_38390,2280,117,66,119,185,19.322033898305083,42.92166721569625
Task_38391,1306,973,111,55,166,1.3408624229979467,30.196266788108858
Task_38392,1052,343,133,94,227,3.058139534883721,24.820541799215306
Task_38393,1001,986,38,10,48,1.0141843971631206,23.865671020091252
Task_38394,554,321,81,117,198,1.720496894409938,16.823805729822052
Task_38395,1954,996,23,82,105,1.9598796389167503,40.230122138704765
Task_38396,2669,253,94,194,288,10.507874015748031,50.515019477925904
Task_38397,2159,268,58,129,187,8.026022304832713,42.00570674488673
Task_38398,1604,467,17,63,80,3.427350427350427,32.45185737182793
Task_38399,2779,201,33,61,94,13.757425742574258,50.223382135078964
Task_38400,981,566,122,111,233,1.7301587301587302,24.446188114531974
Task_38401,1858,815,82,131,213,2.2769607843137254,39.10965531953386
Task_38402,795,819,197,20,217,0.9695121951219512,21.641317275238183
Task_38403,2199,1001,11,73,84,2.194610778443114,43.71763204476104
Task_38404,576,779,82,120,202,0.7384615384615385,18.580103214637074
Task_38405,2318,479,15,72,87,4.829166666666667,43.991132795232055
Task_38406,1059,496,121,96,217,2.130784708249497,25.409529297164706
Task_38407,2646,687,120,94,214,3.8459302325581395,51.09275466423308
Task_38408,922,304,168,40,208,3.0229508196721313,21.969692399729862
Task_38409,653,985,104,149,253,0.6622718052738337,20.797284462653483
Task_38410,2807,266,37,32,69,10.513108614232209,50.245777281642454
Task_38411,994,610,124,103,227,1.6268412438625204,24.750580325313848
Task_38412,1039,947,71,139,210,1.0959915611814346,26.455351651527092
Task_38413,2263,373,81,20,101,6.050802139037433,42.448915654610495
Task_38414,2760,424,158,36,194,6.4941176470588236,51.36870406771405
Task_38415,943,631,133,197,330,1.4920886075949367,24.581012578113015
Task_38416,1425,412,87,158,245,3.450363196125908,31.085235976216307
Task_38417,2769,325,88,101,189,8.493865030674847,51.717317326547594
Task_38418,2438,455,24,76,100,5.3464912280701755,46.027045647667
Task_38419,2126,778,168,92,260,2.729139922978177,43.30079441583022
Task_38420,2089,824,193,55,248,2.532121212121212,42.496981747643225
Task_38421,1451,455,109,78,187,3.182017543859649,31.15102394016633
Task_38422,749,237,149,114,263,3.1470588235294117,19.884934774802222
Task_38423,2018,616,99,181,280,3.2706645056726096,41.354960677101964
Task_38424,1779,810,94,125,219,2.193588162762022,37.82893872141228
Task_38425,2821,208,137,67,204,13.497607655502392,51.89094219558391
Task_38426,1445,924,55,73,128,1.5621621621621622,32.3455679543361
Task_38427,2901,760,37,100,137,3.812089356110381,54.8508717487465
Task_38428,2252,735,171,196,367,3.0597826086956523,45.848560130232066
Task_38429,1717,965,63,122,185,1.7774327122153208,37.18110269234122
Task_38430,2377,165,175,147,322,14.319277108433734,45.44004992790473
Task_38431,2412,344,14,37,51,6.991304347826087,44.26517542021685
Task_38432,2713,293,99,136,235,9.227891156462585,51.023645084669965
Task_38433,1150,482,115,79,194,2.380952380952381,26.54498312479178
Task_38434,2289,336,94,173,267,6.792284866468843,44.67549502537235
Task_38435,2499,927,188,188,376,2.6928879310344827,50.3917611138736
Task_38436,712,89,64,91,155,7.911111111111111,17.521532543677434
Task_38437,734,503,142,31,173,1.4563492063492063,19.443944665183935
Task_38438,2137,999,168,94,262,2.137,44.22138434498613
Task_38439,2768,636,196,42,238,4.345368916797488,52.39022405575404
Task_38440,2174,536,196,137,333,4.048417132216015,43.74395874442448
Task_38441,2412,619,43,125,168,3.890322580645161,46.984275397090045
Task_38442,1625,526,99,130,229,3.0834914611005693,34.54242788627993
Task_38443,550,163,125,158,283,3.3536585365853657,16.465612188811566
Task_38444,1823,859,169,162,331,2.119767441860465,39.22748973188109
Task_38445,1371,72,98,194,292,18.78082191780822,28.906897611829095
Task_38446,2953,1007,197,11,208,2.929563492063492,56.2471800475085
Task_38447,1213,758,162,24,186,1.598155467720685,27.84026155628747
Task_38448,1675,521,126,152,278,3.2088122605363987,35.56962288314918
Task_38449,1300,887,106,117,223,1.4639639639639639,30.42113134014652
Task_38450,2499,562,46,122,168,4.438721136767318,48.19309512666167
Task_38451,973,643,117,112,229,1.5108695652173914,24.513690142511877
Task_38452,1404,568,189,55,244,2.467486818980668,30.826661136612902
Task_38453,1920,986,197,179,376,1.9452887537993921,41.387244055462304
Task_38454,2390,486,53,20,73,4.907597535934292,44.21012342329016
Task_38455,784,979,191,145,336,0.8,23.12198492963584
Task_38456,687,338,105,33,138,2.0265486725663715,17.88078597179084
Task_38457,2915,238,171,176,347,12.196652719665272,54.573772449662634
Task_38458,2714,191,192,134,326,14.135416666666666,51.053328001798434
Task_38459,1065,304,122,142,264,3.4918032786885247,25.143749237204904
Task_38460,2382,183,73,193,266,12.945652173913043,45.601864007775525
Task_38461,2210,665,44,180,224,3.3183183183183185,44.31166604436654
Task_38462,1314,149,166,170,336,8.76,28.720807090494223
Task_38463,810,1022,117,115,232,0.7917888563049853,23.166010409771435
Task_38464,1629,521,68,23,91,3.1206896551724137,32.88334745674022
Task_38465,2738,836,144,18,162,3.271206690561529,52.039192454365065
Task_38466,1910,945,132,17,149,2.019027484143763,39.181236030505886
Task_38467,851,971,181,139,320,0.8755144032921811,24.060207392233195
Task_38468,2227,706,127,16,143,3.14992927864215,43.39110834368093
Task_38469,591,66,187,157,344,8.82089552238806,16.903837296953423
Task_38470,2504,241,18,108,126,10.347107438016529,46.839174503915565
Task_38471,2340,344,92,138,230,6.782608695652174,45.2885449596765
Task_38472,2892,206,157,93,250,13.971014492753623,53.507300109593075
Task_38473,1257,780,117,21,138,1.6094750320102433,28.246224711172612
Task_38474,2315,877,191,38,229,2.6366742596810933,45.940046835728744
Task_38475,2689,820,198,83,281,3.275274056029233,52.41344475920829
Task_38476,2218,584,103,44,147,3.7914529914529913,42.986520168000574
Task_38477,1803,1004,124,133,257,1.7940298507462686,38.985266736105594
Task_38478,1682,284,173,138,311,5.901754385964912,35.03759599951822
Task_38479,2556,553,165,94,259,4.613718411552346,49.443726591516715
Task_38480,2465,740,177,63,240,3.326585695006748,48.188664630019495
Task_38481,705,648,27,160,187,1.086286594761171,20.07974489413115
Task_38482,699,90,140,33,173,7.681318681318682,16.96294726562171
Task_38483,1112,294,10,42,52,3.769491525423729,23.54868401074687
Task_38484,1016,453,57,173,230,2.237885462555066,24.80310627567943
Task_38485,717,850,49,159,208,0.8425381903642774,21.134536483603
Task_38486,1010,189,28,49,77,5.315789473684211,21.87254902022235
Task_38487,680,138,124,136,260,4.892086330935252,18.230851245506233
Task_38488,2090,108,15,145,160,19.174311926605505,39.34123191195473
Task_38489,1433,282,82,38,120,5.063604240282685,29.2380958234191
Task_38490,1522,804,162,153,315,1.8906832298136647,34.20194710686716
Task_38491,2952,588,37,45,82,5.01188455008489,53.971801671234054
Task_38492,2564,792,189,115,304,3.2332912988650695,50.56762999615247
Task_38493,1967,231,76,113,189,8.47844827586207,38.832267881513836
Task_38494,2502,392,85,168,253,6.366412213740458,48.158489490450954
Task_38495,2913,223,50,120,170,13.004464285714286,53.6533570225428
Task_38496,2013,660,175,84,259,3.0453857791225416,41.101382772878004
Task_38497,2909,584,182,192,374,4.972649572649573,55.8015797106011
Task_38498,1257,871,177,32,209,1.44151376146789,29.054553246819307
Task_38499,2686,159,51,59,110,16.7875,48.45090755938714
Task_38500,792,75,80,132,212,10.421052631578947,19.431837975328566
Task_38501,2949,803,152,58,210,3.667910447761194,55.88185119820213
Task_38502,1405,1014,59,114,173,1.3842364532019704,32.29096443911048
Task_38503,1352,848,67,131,198,1.5924617196702002,31.146776585820774
Task_38504,1284,124,182,37,219,10.272,26.788559381402766
Task_38505,1857,770,180,161,341,2.4085603112840466,39.532168267180616
Task_38506,1429,981,40,10,50,1.455193482688391,30.529109055080223
Task_38507,563,237,132,200,332,2.365546218487395,17.38381857128405
Task_38508,1142,365,105,133,238,3.120218579234973,26.4282577608802
Task_38509,2705,640,29,190,219,4.21996879875195,52.0505841092699
Task_38510,2005,570,165,166,331,3.51138353765324,41.20966724261818
Task_38511,1921,653,123,31,154,2.937308868501529,38.506993686886545
Task_38512,1134,838,154,140,294,1.3516090584028606,27.99967419756499
Task_38513,2510,337,149,12,161,7.42603550295858,46.7870628712794
Task_38514,2822,256,140,118,258,10.980544747081712,52.6868884644687
Task_38515,970,953,188,190,378,1.0167714884696017,26.188205942541284
Task_38516,1424,535,129,126,255,2.656716417910448,31.498039714206275
Task_38517,1688,417,47,147,194,4.038277511961723,35.09715902714391
Task_38518,863,865,46,113,159,0.9965357967667436,22.942318259412257
Task_38519,1302,543,38,37,75,2.3933823529411766,27.383032432091948
Task_38520,1411,824,89,134,223,1.7103030303030302,32.028573534314035
Task_38521,1500,691,153,162,315,2.167630057803468,33.51427481999901
Task_38522,888,247,11,18,29,3.5806451612903225,19.468871755248397
Task_38523,1058,962,41,200,241,1.09865005192108,26.97619460790342
Task_38524,1954,501,121,95,216,3.8924302788844622,39.57354933247483
Task_38525,2391,804,92,48,140,2.9701863354037266,46.46455293002544
Task_38526,2537,862,30,40,70,2.939745075318656,47.923764222116496
Task_38527,2888,119,86,74,160,24.066666666666666,51.738288716745046
Task_38528,2585,355,105,126,231,7.26123595505618,49.1804746069698
Task_38529,2374,970,139,52,191,2.4449021627188467,47.25212745073552
Task_38530,2357,945,63,15,78,2.4915433403805496,45.23670174603055
Task_38531,2118,390,168,35,203,5.41687979539642,41.14166073925857
Task_38532,2552,191,111,86,197,13.291666666666666,47.81931386286658
Task_38533,880,661,64,39,103,1.3293051359516617,21.471903380852083
Task_38534,2676,213,94,49,143,12.504672897196262,49.106926728805945
Task_38535,1704,244,162,193,355,6.955102040816326,35.52591050936572
Task_38536,815,77,145,130,275,10.448717948717949,20.026235181009284
Task_38537,2243,476,19,55,74,4.70230607966457,42.284567487986266
Task_38538,518,717,104,71,175,0.7214484679665738,17.14226751514546
Task_38539,1209,71,28,67,95,16.791666666666668,24.29521107029393
Task_38540,1314,186,133,96,229,7.026737967914438,28.528828068037033
Task_38541,1689,759,199,151,350,2.2223684210526318,36.862228876934914
Task_38542,1127,349,30,110,140,3.22,25.46790106986796
Task_38543,873,339,23,87,110,2.5676470588235296,21.1529472673858
Task_38544,1103,810,45,167,212,1.3600493218249075,27.10900669688063
Task_38545,556,746,120,140,260,0.7443105756358769,18.388033129081155
Task_38546,1703,474,58,107,165,3.5852631578947367,35.32815818405638
Task_38547,553,154,188,119,307,3.567741935483871,16.535635637950275
Task_38548,2741,393,81,176,257,6.956852791878172,52.020506993630306
Task_38549,1086,940,157,92,249,1.1540913921360254,27.20817119251393
Task_38550,2436,667,162,40,202,3.6467065868263475,47.06544884006235
Task_38551,2052,371,25,159,184,5.516129032258065,40.59033123630588
Task_38552,979,874,192,24,216,1.1188571428571428,24.62414062965948
Task_38553,2502,717,57,145,202,3.4846796657381613,49.00022709121725
Task_38554,2966,133,22,171,193,22.134328358208954,53.88998432441597
Task_38555,2161,184,166,192,358,11.68108108108108,42.45118414337956
Task_38556,2646,935,131,168,299,2.826923076923077,52.36971968099482
Task_38557,1244,229,33,105,138,5.408695652173913,26.90541429101401
Task_38558,1310,385,126,51,177,3.393782383419689,28.428340402203258
Task_38559,2392,353,52,10,62,6.757062146892656,43.77435151500381
Task_38560,2281,643,192,87,279,3.5419254658385095,45.40026291099196
Task_38561,2048,189,40,92,132,10.778947368421052,39.504100332584635
Task_38562,942,641,25,137,162,1.4672897196261683,23.59198326157802
Task_38563,2742,413,183,12,195,6.6231884057971016,50.958047169622915
Task_38564,2406,806,139,121,260,2.9814126394052045,47.91881821589311
Task_38565,2767,956,143,69,212,2.891327063740857,53.53113293054716
Task_38566,509,995,24,111,135,0.5110441767068273,17.797258887651967
Task_38567,2994,479,72,176,248,6.2375,56.27567873141428
Task_38568,994,950,70,90,160,1.0452155625657202,25.30537178642244
Task_38569,2096,434,42,139,181,4.818390804597701,41.47757161975892
Task_38570,1909,802,154,101,255,2.37733499377335,39.98037628043494
Task_38571,1337,216,31,51,82,6.161290322580645,27.397206116338015
Task_38572,2520,292,193,81,274,8.600682593856655,47.95826067335553
Task_38573,609,628,67,108,175,0.9682034976152624,18.46097430054789
Task_38574,1196,614,50,178,228,1.9447154471544716,28.18820796316751
Task_38575,1371,793,68,141,209,1.7267002518891688,31.33981991332333
Task_38576,2650,331,44,14,58,7.981927710843373,47.84574363792282
Task_38577,1775,398,185,153,338,4.448621553884712,37.02999144961998
Task_38578,538,528,63,56,119,1.0170132325141776,16.03253031660171
Task_38579,2230,241,168,119,287,9.214876033057852,43.40996626906108
Task_38580,2974,78,64,16,80,37.64556962025316,51.40725714219724
Task_38581,861,186,77,107,184,4.60427807486631,21.192867546052852
Task_38582,708,559,76,150,226,1.2642857142857142,20.138534677808174
Task_38583,2916,324,144,198,342,8.972307692307693,54.9146028252517
Task_38584,798,322,110,49,159,2.4705882352941178,19.81441769466196
Task_38585,863,833,72,15,87,1.0347721822541966,21.726156385210952
Task_38586,2324,962,121,197,318,2.4132917964693665,47.47960146776692
Task_38587,590,864,65,100,165,0.6820809248554913,19.00930621989792
Task_38588,2942,447,47,109,156,6.566964285714286,54.62296478558727
Task_38589,926,169,176,154,330,5.447058823529412,22.61135223113852
Task_38590,2792,99,22,166,188,27.92,50.769790989403084
Task_38591,1370,986,78,188,266,1.3880445795339413,32.206294762931726
Task_38592,1042,525,67,145,212,1.9809885931558935,25.326882707933468
Task_38593,1333,764,117,144,261,1.742483660130719,30.813198250364582
Task_38594,2226,354,67,191,258,6.270422535211267,43.78972714766715
Task_38595,901,378,155,86,241,2.3773087071240107,22.535305237385653
Task_38596,2291,104,200,43,243,21.81904761904762,42.49147955836815
Task_38597,569,514,197,21,218,1.104854368932039,17.02431174417319
Task_38598,2754,698,176,111,287,3.939914163090129,53.19885679830909
Task_38599,788,213,31,67,98,3.682242990654206,19.00582855212247
Task_38600,644,756,98,76,174,0.8507265521796565,19.225138908604634
Task_38601,1032,291,88,166,254,3.5342465753424657,24.528531856326083
Task_38602,1985,859,68,73,141,2.308139534883721,40.5738392526841
Task_38603,600,209,33,38,71,2.857142857142857,15.212318008488786
Task_38604,2400,159,115,114,229,15.0,45.31757132606682
Task_38605,1353,854,40,44,84,1.5824561403508772,29.51090915801267
Task_38606,2576,841,109,36,145,3.0593824228028503,49.4955989886926
Task_38607,1534,530,115,155,270,2.888888888888889,33.334029103994965
Task_38608,1192,712,110,188,298,1.6718092566619915,28.648998556460384
Task_38609,1984,786,180,183,363,2.5209656925031765,41.725582745390376
Task_38610,1138,395,151,192,343,2.8737373737373737,27.02068042593992
Task_38611,1514,853,76,44,120,1.7728337236533958,32.29410852208606
Task_38612,1302,203,54,102,156,6.382352941176471,27.879579911288275
Task_38613,1933,349,166,94,260,5.522857142857143,38.92402410485526
Task_38614,958,294,77,178,255,3.247457627118644,23.49867739330894
Task_38615,2745,118,144,45,189,23.067226890756302,49.55668768175
Task_38616,1835,788,83,77,160,2.3257287705956906,38.044040014976865
Task_38617,833,438,196,87,283,1.89749430523918,21.844423875476405
Task_38618,1730,72,35,162,197,23.698630136986303,34.0115974680348
Task_38619,1520,991,70,11,81,1.532258064516129,32.52805797875279
Task_38620,643,138,71,133,204,4.625899280575539,17.45905819204644
Task_38621,1754,354,79,153,232,4.940845070422535,36.13607070736912
Task_38622,809,448,87,171,258,1.8017817371937639,21.528088577870108
Task_38623,1320,694,177,16,193,1.8992805755395683,29.322677626996523
Task_38624,586,257,106,173,279,2.2713178294573644,17.533200793528195
Task_38625,1397,480,181,155,336,2.9043659043659042,31.3042803492928
Task_38626,1694,107,142,113,255,15.685185185185185,33.87708797772119
Task_38627,1472,618,11,48,59,2.378029079159935,30.342133687053476
Task_38628,1955,827,198,113,311,2.361111111111111,41.057191596057564
Task_38629,616,484,67,116,183,1.270103092783505,18.17452237749657
Task_38630,1681,1022,176,124,300,1.643206256109482,37.27492554453874
Task_38631,2420,1019,44,68,112,2.372549019607843,47.618905784449304
Task_38632,1192,392,172,48,220,3.0330788804071247,26.614233107933572
Task_38633,1874,952,17,167,184,1.9664218258132213,39.59375856497714
Task_38634,1964,678,132,34,166,2.8924889543446244,39.46724942758279
Task_38635,2380,576,176,158,334,4.124783362218371,47.168795758602876
Task_38636,2236,505,106,154,260,4.4189723320158105,44.3221823694602
Task_38637,1617,891,140,35,175,1.812780269058296,34.65489468266463
Task_38638,2126,798,61,169,230,2.6608260325406756,43.45996049442829
Task_38639,1441,577,17,106,123,2.4930795847750864,31.000575495623167
Task_38640,570,510,147,21,168,1.1154598825831703,16.74000106520889
Task_38641,1649,836,63,36,99,1.9701314217443249,34.10392260222495
Task_38642,2230,70,64,57,121,31.408450704225352,40.514493941988995
Task_38643,2846,539,125,36,161,5.270370370370371,52.858884766686025
Task_38644,1369,965,45,183,228,1.4171842650103519,31.907938340015175
Task_38645,2479,163,59,59,118,15.115853658536585,45.254013033027945
Task_38646,2023,965,170,122,292,2.0942028985507246,42.492031097105794
Task_38647,2536,892,96,156,252,2.83986562150056,50.270638097977915
Task_38648,1797,251,33,123,156,7.130952380952381,35.844292729137074
Task_38649,2756,224,52,156,208,12.248888888888889,51.42395863549941
Task_38650,2926,329,128,69,197,8.866666666666667,53.96333187557611
Task_38651,1738,933,81,174,255,1.860813704496788,37.83916938538771
Task_38652,1332,425,67,35,102,3.1267605633802815,27.968927655195426
Task_38653,2746,350,195,172,367,7.823361823361823,52.390545755983474
Task_38654,2328,209,165,88,253,11.085714285714285,44.57883926154809
Task_38655,1093,193,142,66,208,5.634020618556701,24.63196860285176
Task_38656,2695,431,78,103,181,6.238425925925926,50.94530088753597
Task_38657,956,353,192,37,229,2.7005649717514126,22.768540331484733
Task_38658,883,920,66,87,153,0.9587404994571118,23.4370193756655
Task_38659,1149,756,159,104,263,1.5178335535006604,27.794465478854846
Task_38660,2248,706,38,183,221,3.1796322489391797,45.02682266507861
Task_38661,1873,457,109,101,210,4.0895196506550215,38.118516351491685
Task_38662,2270,805,153,99,252,2.8163771712158807,45.68672862269538
Task_38663,2750,884,159,14,173,3.1073446327683616,52.46001551334129
Task_38664,2452,417,85,176,261,5.866028708133971,47.49789875064574
Task_38665,1442,376,195,113,308,3.8249336870026527,31.49600048762123
Task_38666,1187,311,49,174,223,3.8044871794871793,27.053791537951184
Task_38667,2074,546,85,90,175,3.7915904936014626,41.371690867298355
Task_38668,2729,400,100,133,233,6.805486284289277,51.62955932393112
Task_38669,685,597,120,57,177,1.145484949832776,19.19180385849548
Task_38670,1484,898,200,191,391,1.6507230255839822,34.27684557597914
Task_38671,1402,705,38,82,120,1.9858356940509916,30.792105161902168
Task_38672,1327,106,197,38,235,12.401869158878505,27.33048165621565
Task_38673,1677,546,165,115,280,3.0658135283363803,35.63526160405027
Task_38674,2726,354,84,91,175,7.67887323943662,51.04142191232841
Task_38675,2867,397,121,161,282,7.203517587939698,54.06502019927708
Task_38676,2050,800,141,158,299,2.5593008739076155,42.48987848457346
Task_38677,1210,519,125,16,141,2.326923076923077,26.66726336383073
Task_38678,2095,556,197,84,281,3.761220825852783,42.17016998474353
Task_38679,1221,367,23,61,84,3.317934782608696,26.092456051652892
Task_38680,918,779,53,149,202,1.176923076923077,24.04435707698225
Task_38681,1368,426,28,139,167,3.2037470725995316,29.831660923063158
Task_38682,2419,290,193,149,342,8.312714776632303,46.86479622732969
Task_38683,2942,144,176,88,264,20.28965517241379,53.77065890668387
Task_38684,1645,864,31,94,125,1.9017341040462428,35.25661226230206
Task_38685,2403,535,60,190,250,4.483208955223881,47.139595231445135
Task_38686,731,961,150,85,235,0.7598752598752598,21.630880361395068
Task_38687,2655,601,93,169,262,4.410299003322259,51.33353135451659
Task_38688,2496,409,130,197,327,6.087804878048781,48.48999362856307
Task_38689,2053,743,108,177,285,2.7594086021505375,42.323769626347854
Task_38690,651,421,80,107,187,1.542654028436019,18.569379922613226
Task_38691,1722,888,42,69,111,1.937007874015748,36.15854997942196
Task_38692,898,183,37,162,199,4.880434782608695,21.752400066415486
Task_38693,1745,131,106,38,144,13.219696969696969,33.54438210564558
Task_38694,2997,391,82,44,126,7.645408163265306,54.5071781404123
Task_38695,2467,949,164,178,342,2.596842105263158,49.78542488252682
Task_38696,893,290,19,75,94,3.06872852233677,20.933332744428704
Task_38697,1325,315,148,149,297,4.193037974683544,29.449853661885598
Task_38698,2896,216,48,21,69,13.345622119815669,51.35861435088075
Task_38699,2868,198,91,164,255,14.412060301507537,53.280245821183
Task_38700,2272,924,190,26,216,2.456216216216216,45.2992849124515
Task_38701,2718,885,184,85,269,3.0677200902934536,53.020372355938996
Task_38702,2857,316,188,153,341,9.012618296529968,53.88298861963616
Task_38703,2744,338,86,170,256,8.094395280235988,51.774700843984355
Task_38704,1493,297,84,43,127,5.010067114093959,30.421671933194478
Task_38705,1695,92,52,167,219,18.225806451612904,33.74426273386566
Task_38706,2509,757,78,11,89,3.3100263852242744,47.48986882573388
Task_38707,1210,84,84,128,212,14.235294117647058,25.975060943936086
Task_38708,744,314,12,200,212,2.361904761904762,19.91505841992596
Task_38709,657,844,131,155,286,0.7775147928994083,20.493821378026713
Task_38710,1997,176,178,178,356,11.282485875706215,39.63476316696953
Task_38711,1435,221,154,115,269,6.463963963963964,30.69387472584728
Task_38712,2736,288,96,31,127,9.46712802768166,50.078145699008495
Task_38713,1566,670,46,36,82,2.3338301043219074,32.29009198313937
Task_38714,2255,1018,34,111,145,2.212953876349362,45.49129457570027
Task_38715,2501,107,165,37,202,23.15740740740741,45.63881313711337
Task_38716,2559,562,143,10,153,4.5452930728241565,48.21836064326056
Task_38717,1986,776,54,132,186,2.555984555984556,40.89016480197623
Task_38718,1608,554,144,108,252,2.8972972972972975,34.431527839821165
Task_38719,1885,458,106,167,273,4.106753812636166,38.69236821063391
Task_38720,1737,339,24,46,70,5.108823529411764,33.616095098556336
Task_38721,841,83,176,69,245,10.011904761904763,19.762777281725334
Task_38722,1978,516,93,61,154,3.8259187620889747,39.239870281007796
Task_38723,861,420,78,104,182,2.045130641330166,21.89114127018368
Task_38724,791,479,36,26,62,1.6479166666666667,19.05184284909903
Task_38725,1835,599,10,177,187,3.058333333333333,37.923207087264764
Task_38726,1599,381,149,40,189,4.18586387434555,32.83863730844196
Task_38727,1355,335,175,40,215,4.032738095238095,28.94926205350535
Task_38728,2941,119,84,27,111,24.508333333333333,51.953741897387054
Task_38729,1176,610,45,72,117,1.9247135842880523,26.75282668646886
Task_38730,2508,978,172,16,188,2.561797752808989,48.9946503285312
Task_38731,1517,688,169,31,200,2.201741654571843,32.56216237429541
Task_38732,2747,838,37,19,56,3.2741358760429082,51.040308344031295
Task_38733,2528,215,49,163,212,11.703703703703704,47.84045528025958
Task_38734,2280,500,10,199,209,4.550898203592815,44.79910433863743
Task_38735,1082,603,194,89,283,1.7913907284768211,26.325113520661887
Task_38736,2360,469,147,62,209,5.0212765957446805,45.484347065075475
Task_38737,834,589,188,135,323,1.4135593220338982,22.59044869495266
Task_38738,715,547,108,188,296,1.3047445255474452,20.52405211716216
Task_38739,1276,124,17,130,147,10.208,26.52840458044246
Task_38740,1651,133,150,155,305,12.32089552238806,33.72943603344325
Task_38741,2949,448,183,41,224,6.567928730512249,54.583646300127214
Task_38742,966,410,18,99,117,2.3503649635036497,22.902590414792215
Task_38743,2811,869,135,97,232,3.231034482758621,54.40007170114879
Task_38744,2371,1020,195,47,242,2.3222331047992166,47.34894947941086
Task_38745,1693,789,168,168,336,2.143037974683544,36.98101333293361
Task_38746,799,89,190,47,237,8.877777777777778,18.845577315311562
Task_38747,1760,880,134,90,224,1.9977298524404086,37.675103889254906
Task_38748,2672,87,25,119,144,30.363636363636363,48.158412222271004
Task_38749,1304,278,74,114,188,4.673835125448028,28.499835264577726
Task_38750,1024,465,184,61,245,2.1974248927038627,24.47581877963464
Task_38751,1840,754,172,76,248,2.437086092715232,38.49744358708864
Task_38752,2076,177,58,88,146,11.662921348314606,39.581471777552615
Task_38753,871,72,98,29,127,11.931506849315069,19.013308492731667
Task_38754,1730,169,108,160,268,10.176470588235293,35.019915911189564
Task_38755,2894,435,10,150,160,6.637614678899083,53.820004927513985
Task_38756,759,584,194,152,346,1.2974358974358975,21.508501194006556
Task_38757,1240,741,145,180,325,1.6711590296495957,29.609573046133807
Task_38758,875,287,170,105,275,3.0381944444444446,22.080021491619306
Task_38759,1586,596,22,144,166,2.6566164154103853,33.83148571566527
Task_38760,734,538,65,124,189,1.3617810760667903,20.293981591431873
Task_38761,1978,486,103,116,219,4.061601642710472,39.93628664717935
Task_38762,912,565,43,135,178,1.6113074204946995,23.128610734165107
Task_38763,1642,417,167,132,299,3.9282296650717705,34.780309840532816
Task_38764,2793,563,47,55,102,4.952127659574468,51.73477865982388
Task_38765,1358,637,47,175,222,2.128526645768025,30.736350732784885
Task_38766,2923,722,136,198,334,4.0428769017980635,56.29121992095438
Task_38767,2121,221,98,137,235,9.554054054054054,41.4103343600106
Task_38768,1769,77,32,67,99,22.67948717948718,33.223086168673426
Task_38769,1002,91,180,121,301,10.891304347826088,23.12835714026255
Task_38770,1517,767,87,64,151,1.9752604166666667,32.66804072686987
Task_38771,1016,422,174,194,368,2.4018912529550827,25.291496381002037
Task_38772,1547,787,10,129,139,1.9631979695431472,33.47809484260401
Task_38773,592,299,31,82,113,1.9733333333333334,16.682985462714985
Task_38774,2424,348,51,177,228,6.945558739255015,46.7694250845289
Task_38775,2748,199,57,106,163,13.74,50.86518498070379
Task_38776,2314,341,103,160,263,6.766081871345029,45.04046991104941
Task_38777,1825,618,86,10,96,2.9483037156704364,36.28905929210702
Task_38778,1028,121,97,152,249,8.426229508196721,23.607097558215752
Task_38779,1802,943,186,27,213,1.9088983050847457,37.898777142869285
Task_38780,1485,597,27,81,108,2.483277591973244,31.57506274452842
Task_38781,1986,479,90,122,212,4.1375,40.01205510095563
Task_38782,1314,389,62,187,249,3.3692307692307693,29.42240403268013
Task_38783,1056,458,21,96,117,2.3006535947712417,24.4969894509058
Task_38784,859,259,56,197,253,3.3038461538461537,21.84122476270409
Task_38785,1360,134,93,75,168,10.074074074074074,28.03389797277622
Task_38786,949,189,148,29,177,4.994736842105263,21.9197929481408
Task_38787,2085,224,170,141,311,9.266666666666667,41.19718586350613
Task_38788,1352,342,36,35,71,3.941690962099125,27.518462898271185
Task_38789,2328,907,186,157,343,2.563876651982379,47.42557355309791
Task_38790,1956,440,76,168,244,4.4353741496598635,39.695797490491536
Task_38791,987,171,105,103,208,5.738372093023256,22.955922650283583
Task_38792,2935,556,133,50,183,5.269299820466786,54.60592478797386
Task_38793,1834,593,151,173,324,3.0875420875420874,38.55325316742331
Task_38794,2735,780,22,193,215,3.501920614596671,52.933949153852105
Task_38795,1992,432,196,166,362,4.600461893764434,40.701613397504126
Task_38796,1090,147,97,83,180,7.364864864864865,24.177743646253628
Task_38797,2674,860,51,57,108,3.105691056910569,50.841529038098834
Task_38798,854,468,140,94,234,1.8208955223880596,22.11517139061981
Task_38799,2412,388,71,180,251,6.200514138817481,46.783647929138986
Task_38800,2391,497,185,192,377,4.801204819277109,47.33332147161186
Task_38801,2672,553,72,173,245,4.823104693140794,51.399798259514796
Task_38802,2396,748,193,98,291,3.198931909212283,47.691915961348066
Task_38803,1208,650,102,142,244,1.8556067588325653,28.411845502107838
Task_38804,578,551,94,118,212,1.0471014492753623,17.885383342740592
Task_38805,2259,152,142,111,253,14.764705882352942,43.164856752185166
Task_38806,2278,928,167,72,239,2.4520990312163615,45.88487242692398
Task_38807,2202,88,125,32,157,24.741573033707866,40.32640303941469
Task_38808,705,928,28,43,71,0.7588805166846071,19.23778518696873
Task_38809,2038,810,154,170,324,2.5129469790382246,42.461276821938554
Task_38810,1293,907,156,75,231,1.4240088105726871,30.184126085597057
Task_38811,1738,258,95,36,131,6.710424710424711,34.26180181843828
Task_38812,2686,941,37,29,66,2.851380042462845,50.51028820743225
Task_38813,773,634,45,19,64,1.2173228346456693,19.189965814505207
Task_38814,1854,838,69,16,85,2.209773539928486,37.350985127145854
Task_38815,1805,693,134,124,258,2.6008645533141213,38.039143208869625
Task_38816,1898,1024,88,191,279,1.8517073170731708,40.69580034082458
Task_38817,2985,310,57,124,181,9.59807073954984,55.150770213712576
Task_38818,628,389,69,51,120,1.6102564102564103,17.136320591432092
Task_38819,926,619,92,55,147,1.4935483870967743,22.91907746567809
Task_38820,625,651,161,69,230,0.9585889570552147,18.786626787771684
Task_38821,1513,484,47,144,191,3.1195876288659794,32.523773386004606
Task_38822,2587,156,75,36,111,16.477707006369428,46.66877598596278
Task_38823,1335,750,127,43,170,1.77762982689747,29.69177296914674
Task_38824,2984,691,107,28,135,4.312138728323699,55.35054413140446
Task_38825,1750,453,181,130,311,3.854625550660793,36.65651672015456
Task_38826,2133,620,24,75,99,3.4347826086956523,41.63023493384625
Task_38827,2232,598,46,35,81,3.7262103505843074,42.63536626299422
Task_38828,2149,787,143,25,168,2.7271573604060912,42.641772465618224
Task_38829,2935,699,136,38,174,4.192857142857143,54.94429206003784
Task_38830,831,968,177,199,376,0.8575851393188855,24.0743575788286
Task_38831,2655,557,163,43,206,4.758064516129032,50.205513598976815
Task_38832,2501,314,137,163,300,7.93968253968254,48.076452965564705
Task_38833,664,683,105,60,165,0.9707602339181286,19.185316891984296
Task_38834,2434,500,116,41,157,4.858283433133733,46.161384829875765
Task_38835,1247,474,122,167,289,2.6252631578947367,28.71656490132288
Task_38836,535,560,23,147,170,0.9536541889483066,17.00501163283807
Task_38837,1061,320,144,149,293,3.305295950155763,25.273407781925073
Task_38838,2184,121,183,25,208,17.901639344262296,40.88072110457464
Task_38839,1464,707,171,92,263,2.0677966101694913,32.6052171372638
Task_38840,2112,284,38,59,97,7.410526315789474,40.02832722330998
Task_38841,702,548,114,81,195,1.278688524590164,19.61506000060712
Task_38842,1120,366,118,167,285,3.0517711171662127,26.345102562048613
Task_38843,1987,542,180,146,326,3.6593001841620625,40.78384301918382
Task_38844,2424,954,25,101,126,2.538219895287958,47.88640437509514
Task_38845,2788,171,117,184,301,16.209302325581394,51.897810356552945
Task_38846,2347,194,88,183,271,12.035897435897436,45.04823882211584
Task_38847,901,213,83,14,97,4.210280373831775,20.35188366629278
Task_38848,1258,855,170,162,332,1.469626168224299,30.213627585936575
Task_38849,1150,900,135,35,170,1.2763596004439512,27.233647307101506
Task_38850,2506,368,32,130,162,6.791327913279133,47.54203041312717
Task_38851,912,898,21,181,202,1.0144605116796441,24.208461096415817
Task_38852,2424,237,120,132,252,10.184873949579831,46.321079518363575
Task_38853,2550,888,84,169,253,2.8683914510686166,50.505713941452996
Task_38854,2908,605,57,113,170,4.798679867986799,54.836066890021975
Task_38855,1633,562,97,124,221,2.9005328596802844,34.74407867967001
Task_38856,2394,875,116,134,250,2.732876712328767,47.91856895708469
Task_38857,1406,823,112,177,289,1.7063106796116505,32.327773245951654
Task_38858,1065,910,176,172,348,1.1690450054884742,27.39766208343916
Task_38859,1229,620,122,16,138,1.9790660225442833,27.249985936415964
Task_38860,2079,287,180,154,334,7.21875,41.450724297278676
Task_38861,2376,761,82,70,152,3.1181102362204722,46.34702510741755
Task_38862,2073,968,197,145,342,2.1393188854489162,43.552754680888505
Task_38863,966,758,65,54,119,1.2727272727272727,23.570973004991373
Task_38864,1771,326,149,131,280,5.415902140672783,36.43622011172972
Task_38865,2426,651,19,78,97,3.7208588957055215,46.40420242939354
Task_38866,584,852,197,184,381,0.6846424384525205,19.920763649518047
Task_38867,2424,901,132,114,246,2.6873614190687363,48.42778377658606
Task_38868,630,898,57,58,115,0.7007786429365962,18.82643404307633
Task_38869,2834,512,34,96,130,5.524366471734893,53.066604906955725
Task_38870,2838,653,62,168,230,4.339449541284404,54.28042144107045
Task_38871,942,854,43,25,68,1.1017543859649124,22.689541810965284
Task_38872,813,873,135,199,334,0.9302059496567505,23.313324524853613
Task_38873,2767,70,106,35,141,38.971830985915496,48.77255770559265
Task_38874,1979,769,10,50,60,2.57012987012987,38.8675417929547
Task_38875,2556,639,120,106,226,3.99375,49.59346912856275
Task_38876,2591,323,21,117,138,7.996913580246914,48.50937506134735
Task_38877,2331,841,193,27,220,2.7684085510688834,45.994506338526755
Task_38878,1108,191,92,132,224,5.770833333333333,25.255997578761548
Task_38879,2963,909,186,151,337,3.256043956043956,57.45784917205881
Task_38880,534,716,191,84,275,0.7447698744769874,17.883606325169172
Task_38881,1784,389,148,145,293,4.574358974358974,36.92855263047725
Task_38882,2329,301,147,87,234,7.711920529801325,44.84140501131893
Task_38883,818,939,116,166,282,0.8702127659574468,23.30671623451946
Task_38884,2149,294,146,199,345,7.284745762711864,42.697150484598126
Task_38885,2303,887,100,167,267,2.5934684684684686,46.639151584309026
Task_38886,1239,207,159,116,275,5.956730769230769,27.578209748594073
Task_38887,1387,949,187,69,256,1.46,31.815802314030112
Task_38888,1528,279,56,10,66,5.457142857142857,29.83649827641726
Task_38889,2452,663,119,21,140,3.6927710843373496,46.81525631030352
Task_38890,2583,68,134,187,321,37.43478260869565,47.96369822576913
Task_38891,2830,803,112,167,279,3.5199004975124377,54.7799947162919
Task_38892,1882,720,97,25,122,2.6102635228848823,37.75406446000371
Task_38893,799,274,50,167,217,2.9054545454545453,20.76421096305285
Task_38894,1552,447,85,128,213,3.4642857142857144,33.064778738203856
Task_38895,1162,689,39,103,142,1.6840579710144927,27.09556771305893
Task_38896,2042,645,44,58,102,3.1609907120743035,40.106921772492875
Task_38897,1305,930,183,164,347,1.40171858216971,31.261404331415907
Task_38898,1463,502,48,69,117,2.908548707753479,30.912516894500396
Task_38899,1195,497,160,78,238,2.3995983935742973,27.482715710323514
Task_38900,783,98,181,90,271,7.909090909090909,19.40902256625103
Task_38901,1920,273,196,134,330,7.007299270072993,38.84147039491355
Task_38902,2257,811,152,24,176,2.7795566502463056,44.486036065283294
Task_38903,1941,363,170,30,200,5.332417582417582,38.233955729578675
Task_38904,1583,596,152,115,267,2.6515912897822447,34.245862558779784
Task_38905,518,677,70,175,245,0.7640117994100295,17.660742127732792
Task_38906,568,453,180,78,258,1.251101321585903,17.473411249430182
Task_38907,1323,959,41,123,164,1.378125,30.715699216391556
Task_38908,1613,547,42,49,91,2.9434306569343067,32.83149839484641
Task_38909,1140,751,65,163,228,1.5159574468085106,27.639164395474364
Task_38910,833,719,192,36,228,1.1569444444444446,21.951225927870368
Task_38911,1202,294,75,117,192,4.074576271186441,26.98066705026056
Task_38912,2633,771,144,62,206,3.410621761658031,50.75550264991699
Task_38913,2111,851,89,19,108,2.477699530516432,41.658809638170325
Task_38914,649,225,17,59,76,2.8716814159292037,16.22409199420962
Task_38915,2486,483,174,139,313,5.136363636363637,48.42580695590294
Task_38916,2563,832,11,14,25,3.076830732292917,47.817614296149095
Task_38917,1533,445,33,51,84,3.437219730941704,31.280852181532122
Task_38918,2360,488,109,132,241,4.826175869120655,46.11258849221087
Task_38919,1394,989,104,45,149,1.408080808080808,31.19884812070786
Task_38920,2892,606,105,137,242,4.764415156507414,54.927293456356665
Task_38921,1775,564,82,181,263,3.1415929203539825,37.30614643585758
Task_38922,1601,496,52,78,130,3.221327967806841,33.470810796390985
Task_38923,1636,731,165,95,260,2.2349726775956285,35.460944302076975
Task_38924,725,416,195,17,212,1.7386091127098322,19.11319871925845
Task_38925,840,830,176,114,290,1.0108303249097472,23.229019871297407
Task_38926,2269,659,87,95,182,3.437878787878788,44.84462237129181
Task_38927,1050,114,84,104,188,9.130434782608695,23.484202662419904
Task_38928,605,200,88,124,212,3.009950248756219,17.232653918326058
Task_38929,2345,756,177,175,352,3.09775429326288,47.28939434003496
Task_38930,1127,119,161,189,350,9.391666666666667,25.64352140890102
Task_38931,2483,204,144,153,297,12.112195121951219,47.358750825940426
Task_38932,2407,737,51,134,185,3.261517615176152,47.463919145346324
Task_38933,1941,331,75,73,148,5.846385542168675,38.23043377402069
Task_38934,1549,991,107,37,144,1.561491935483871,33.63788782236353
Task_38935,2442,281,68,49,117,8.659574468085106,45.317972126594306
Task_38936,2964,95,143,67,210,30.875,52.93980476981124
Task_38937,1892,957,190,72,262,1.9749478079331941,39.96220495663267
Task_38938,2093,799,155,93,248,2.61625,42.82643870034573
Task_38939,2321,288,192,134,326,8.03114186851211,45.21442537184163
Task_38940,2725,916,92,111,203,2.97164667393675,53.053592076004776
Task_38941,1700,353,160,54,214,4.80225988700565,34.696674627519876
Task_38942,1895,401,44,29,73,4.713930348258707,36.315322060797676
Task_38943,711,753,75,33,108,0.9429708222811671,19.342258741014962
Task_38944,2556,741,19,10,29,3.444743935309973,47.473671682590854
Task_38945,1432,1023,84,66,150,1.3984375,32.16348046621508
Task_38946,1095,990,97,61,158,1.1049445005045408,26.705694737366574
Task_38947,1608,904,115,86,201,1.7767955801104973,35.187781919996375
Task_38948,2045,342,11,188,199,5.962099125364431,40.50202007785726
Task_38949,680,106,124,119,243,6.355140186915888,17.8880677168891
Task_38950,789,246,163,34,197,3.194331983805668,19.622923381557595
Task_38951,2019,231,107,23,130,8.702586206896552,38.50774854277045
Task_38952,1889,949,66,60,126,1.9884210526315789,39.107463982553874
Task_38953,2286,729,88,132,220,3.1315068493150684,45.57074830822597
Task_38954,692,345,112,17,129,2.0,17.902343029875244
Task_38955,1299,666,44,48,92,1.9475262368815591,28.205865240435454
Task_38956,1725,502,91,93,184,3.429423459244533,35.74341005878809
Task_38957,1259,422,116,149,265,2.976359338061466,28.606912002535932
Task_38958,1533,219,10,15,25,6.968181818181818,29.530100450152556
Task_38959,694,572,190,46,236,1.2111692844677138,19.344396535210635
Task_38960,991,196,83,135,218,5.030456852791878,23.44889418249619
Task_38961,555,705,37,145,182,0.7861189801699717,17.90021167046302
Task_38962,2850,75,90,147,237,37.5,51.7203099907502
Task_38963,2941,846,54,115,169,3.4722550177095632,56.123600870501406
Task_38964,1678,396,103,122,225,4.226700251889169,34.93390433402535
Task_38965,1596,150,154,33,187,10.56953642384106,31.76060666194702
Task_38966,711,857,129,117,246,0.8286713286713286,21.123067150899754
Task_38967,2890,581,166,193,359,4.965635738831615,55.424931064592634
Task_38968,557,439,111,131,242,1.2659090909090909,17.35926091469425
Task_38969,1227,585,163,41,204,2.0938566552901023,27.669587735654744
Task_38970,1057,663,116,100,216,1.591867469879518,25.859508169535662
Task_38971,1505,928,194,135,329,1.620021528525296,34.341181727987426
Task_38972,2244,845,111,193,304,2.652482269503546,45.778025496651615
Task_38973,2993,373,186,157,343,8.002673796791443,56.246404217692806
Task_38974,612,685,197,47,244,0.892128279883382,18.501199609402004
Task_38975,1727,906,198,11,209,1.9040793825799338,36.50945529010596
Task_38976,678,320,24,62,86,2.1121495327102804,17.40848745070464
Task_38977,1912,800,124,98,222,2.387016229712859,39.87605235859909
Task_38978,1158,75,26,70,96,15.236842105263158,23.583569594817316
Task_38979,996,955,120,33,153,1.0418410041841004,24.790442634822597
Task_38980,2892,429,34,152,186,6.725581395348837,54.10396996676935
Task_38981,639,729,197,78,275,0.8753424657534247,19.567453504655646
Task_38982,1567,72,142,94,236,21.465753424657535,31.5877694814282
Task_38983,1479,835,200,41,241,1.7691387559808613,32.59707443571873
Task_38984,2634,667,122,168,290,3.94311377245509,51.297012724276044
Task_38985,1208,348,130,82,212,3.4613180515759314,27.154445123810337
Task_38986,855,815,183,55,238,1.0477941176470589,22.86493572239536
Task_38987,2789,384,150,110,260,7.244155844155844,52.61318720270549
Task_38988,2730,895,15,115,130,3.046875,52.56294124070081
Task_38989,2723,980,62,139,201,2.7757390417940875,53.31327329907132
Task_38990,1746,801,16,185,201,2.1770573566084788,37.247182127791014
Task_38991,712,487,181,36,217,1.459016393442623,19.26076605437727
Task_38992,1245,678,199,18,217,1.8335787923416789,28.203179639146427
Task_38993,1699,353,185,13,198,4.799435028248587,34.272350944820964
Task_38994,2909,812,33,99,132,3.5781057810578107,55.15456589527461
Task_38995,1743,467,146,67,213,3.7243589743589745,35.78185001271151
Task_38996,2827,560,10,28,38,5.03921568627451,51.318693199541805
Task_38997,2928,611,30,194,224,4.784313725490196,55.51905187657732
Task_38998,1903,659,139,74,213,2.8833333333333333,39.03019557173525
Task_38999,1967,973,143,88,231,2.0195071868583163,41.24559757285319
Task_39000,2799,709,81,88,169,3.9422535211267604,53.34267918918538
Task_39001,2566,978,177,64,241,2.6210418794688457,50.54541014850586
Task_39002,2029,1006,116,48,164,2.014895729890765,41.549353177312234
Task_39003,2559,905,98,70,168,2.8245033112582782,49.85637797015008
Task_39004,2866,288,144,67,211,9.916955017301039,52.93872689173401
Task_39005,1309,865,31,19,50,1.5115473441108545,28.32855960317883
Task_39006,2542,490,101,15,116,5.177189409368635,47.37451137849302
Task_39007,2935,688,57,199,256,4.2597968069666186,56.089956171197066
Task_39008,1035,970,101,18,119,1.065911431513903,25.08972016447724
Task_39009,1856,444,197,166,363,4.170786516853933,38.59245368181535
Task_39010,2974,227,56,57,113,13.043859649122806,53.627163846923146
Task_39011,1382,672,36,82,118,2.053491827637444,30.36199140900281
Task_39012,2089,828,37,63,100,2.5199034981905912,41.606421681290904
Task_39013,1046,940,68,171,239,1.1115834218916048,26.750342143053615
Task_39014,1033,1004,112,142,254,1.0278606965174129,26.722681122297768
Task_39015,1623,67,96,16,112,23.86764705882353,30.41319548942856
Task_39016,1209,161,120,93,213,7.462962962962963,26.39961559898973
Task_39017,845,171,38,113,151,4.912790697674419,20.071433584973473
Task_39018,2302,1011,105,184,289,2.274703557312253,47.13373711132846
Task_39019,2683,361,152,179,331,7.411602209944752,51.279510731658775
Task_39020,2097,329,33,46,79,6.3545454545454545,39.42991060456353
Task_39021,1077,481,191,49,240,2.2344398340248963,25.232707415117773
Task_39022,1183,398,155,164,319,2.9649122807017543,27.59308121251594
Task_39023,539,508,199,71,270,1.0589390962671905,17.131280315329224
Task_39024,2207,146,45,96,141,15.013605442176871,41.38943131104753
Task_39025,566,853,154,177,331,0.6627634660421545,19.403854678782697
Task_39026,1362,583,25,148,173,2.3321917808219177,30.287179444675388
Task_39027,1366,538,165,75,240,2.5343228200371057,30.270286041785727
Task_39028,1418,92,151,88,239,15.24731182795699,29.189628917509395
Task_39029,2108,987,11,119,130,2.133603238866397,42.97618616076358
Task_39030,2722,574,22,193,215,4.733913043478261,52.07479664971196
Task_39031,2385,549,133,108,241,4.336363636363636,46.669289552669746
Task_39032,1740,276,105,155,260,6.281588447653429,35.72211287939798
Task_39033,2925,124,155,177,332,23.4,53.861582550826675
Task_39034,2938,130,23,35,58,22.427480916030536,51.55255017964715
Task_39035,2646,666,64,62,126,3.967016491754123,50.194392736394796
Task_39036,1934,311,99,80,179,6.198717948717949,38.312985427413395
Task_39037,1003,258,128,21,149,3.8725868725868726,22.678604772023487
Task_39038,748,999,153,70,223,0.748,21.71773871833356
Task_39039,2228,509,71,123,194,4.368627450980392,43.92540850418832
Task_39040,2094,680,124,34,158,3.0748898678414096,41.36923910631824
Task_39041,1490,813,192,197,389,1.8304668304668306,34.1209878433444
Task_39042,1596,311,121,85,206,5.115384615384615,33.14085826764282
Task_39043,2180,642,114,87,201,3.390357698289269,43.445882641676555
Task_39044,2096,194,113,50,163,10.748717948717948,40.06867335131724
Task_39045,1055,82,162,146,308,12.710843373493976,23.9715961649122
Task_39046,2623,291,198,50,248,8.982876712328768,49.095223860344056
Task_39047,1209,927,72,39,111,1.302801724137931,27.7212513767183
Task_39048,1455,971,145,142,287,1.4969135802469136,33.47389510907148
Task_39049,1875,222,93,91,184,8.408071748878923,37.1768907743285
Task_39050,2743,655,56,31,87,4.1814024390243905,50.82790860865816
Task_39051,1442,78,75,143,218,18.253164556962027,29.701086135159787
Task_39052,1978,779,72,27,99,2.5358974358974358,39.2925092008817
Task_39053,637,334,120,56,176,1.9014925373134328,17.626692671598928
Task_39054,2276,828,170,82,252,2.7454764776839564,45.76364726540357
Task_39055,1730,863,109,103,212,2.002314814814815,37.14357393435953
Task_39056,797,76,122,11,133,10.35064935064935,17.831954517336616
Task_39057,1766,299,153,162,315,5.886666666666667,36.469647754827434
Task_39058,2840,506,34,189,223,5.601577909270217,53.78433012280138
Task_39059,863,738,113,198,311,1.1677943166441136,23.53577911501264
Task_39060,2624,824,28,55,83,3.1806060606060607,49.74441256469516
Task_39061,2722,493,169,53,222,5.510121457489879,51.40617556063757
Task_39062,1991,647,123,135,258,3.072530864197531,40.856847624899196
Task_39063,1651,455,191,45,236,3.620614035087719,34.10697641768176
Task_39064,1335,230,112,70,182,5.779220779220779,28.37493690722377
Task_39065,582,73,163,194,357,7.864864864864865,16.85681959724822
Task_39066,838,65,97,107,204,12.696969696969697,20.063349103459117
Task_39067,719,466,16,138,154,1.5396145610278373,19.38942125796177
Task_39068,2228,458,85,150,235,4.8540305010893245,43.931366896850555
Task_39069,2793,602,187,41,228,4.6318407960199,52.631181687886986
Task_39070,1596,731,68,175,243,2.180327868852459,34.92763166249548
Task_39071,2505,998,119,139,258,2.5075075075075075,50.104549358798465
Task_39072,2545,405,54,190,244,6.268472906403941,48.9377977204144
Task_39073,1249,539,87,41,128,2.312962962962963,27.49376074256727
Task_39074,790,479,98,29,127,1.6458333333333333,19.90281783021258
Task_39075,2280,624,175,109,284,3.648,45.44046371600056
Task_39076,1625,567,139,63,202,2.8609154929577465,34.16794915125978
Task_39077,2628,519,153,126,279,5.053846153846154,50.618038480063056
Task_39078,2623,509,106,130,236,5.143137254901961,50.31862416197521
Task_39079,1698,630,132,194,326,2.6909667194928684,36.55574907753961
Task_39080,755,156,65,175,240,4.808917197452229,19.58481932396889
Task_39081,1618,185,40,41,81,8.698924731182796,31.64322830950594
Task_39082,659,868,111,125,236,0.7583429228998849,20.332727276798423
Task_39083,1694,168,88,56,144,10.023668639053254,33.21657984900722
Task_39084,1601,236,144,182,326,6.755274261603375,33.723757877892744
Task_39085,2465,899,140,75,215,2.738888888888889,48.69780679963011
Task_39086,2389,842,188,147,335,2.833926453143535,48.1383321572956
Task_39087,1219,611,39,171,210,1.9918300653594772,28.36339669662314
Task_39088,793,1008,108,42,150,0.7859266600594648,21.801323514693006
Task_39089,502,894,147,26,173,0.5608938547486033,17.213693869349072
Task_39090,2311,654,152,72,224,3.5282442748091603,45.48112572132544
Task_39091,1651,564,172,168,340,2.92212389380531,35.62856627760028
Task_39092,2016,865,200,161,361,2.327944572748268,42.43792583160583
Task_39093,1546,227,106,119,225,6.780701754385965,32.27566081497245
Task_39094,544,870,14,42,56,0.6245694603903559,16.75077177508982
Task_39095,2863,118,161,189,350,24.058823529411764,52.93592535303628
Task_39096,714,1014,98,35,133,0.7034482758620689,20.691161842720557
Task_39097,853,1018,119,75,194,0.8370951913640824,23.432650157911457
Task_39098,2711,366,151,169,320,7.386920980926431,51.67519739982919
Task_39099,782,916,81,88,169,0.8527808069792803,21.970187446717457
Task_39100,2743,124,192,56,248,21.944,50.1355950518736
Task_39101,2028,1015,96,12,108,1.9960629921259843,40.87295543248292
Task_39102,522,542,176,151,327,0.9613259668508287,17.565399492553016
Task_39103,2443,828,113,99,212,2.9469240048250906,48.31938513032145
Task_39104,2078,799,93,63,156,2.5975,41.77080481303006
Task_39105,2549,206,181,72,253,12.31400966183575,47.87104827614754
Task_39106,1305,708,93,117,210,1.840620592383639,29.977724387209935
Task_39107,822,1004,54,12,66,0.817910447761194,21.146561059965016
Task_39108,1423,847,74,199,273,1.678066037735849,32.69239571885983
Task_39109,1301,551,159,81,240,2.3568840579710146,29.363144087135908
Task_39110,972,898,144,105,249,1.0812013348164626,25.343781170455127
Task_39111,518,818,170,175,345,0.6324786324786325,18.604273349310546
Task_39112,809,153,105,53,158,5.253246753246753,19.29892514894776
Task_39113,2329,966,43,139,182,2.408479834539814,46.85217820273155
Task_39114,1089,581,37,41,78,1.8711340206185567,24.240365355381726
Task_39115,1516,290,96,134,230,5.209621993127148,32.070483421057645
Task_39116,548,165,193,73,266,3.3012048192771086,16.0005144298243
Task_39117,2652,649,124,29,153,4.08,50.0549621545122
Task_39118,2104,799,104,121,225,2.63,42.954518449796495
Task_39119,2119,762,172,84,256,2.7771952817824377,43.08723218761995
Task_39120,1115,501,94,72,166,2.2211155378486054,25.820017907590426
Task_39121,853,688,26,59,85,1.2380261248185775,21.31052576583654
Task_39122,869,573,15,42,57,1.5139372822299653,20.655623164378394
Task_39123,792,304,113,79,192,2.59672131147541,20.306272170440426
Task_39124,1342,196,83,76,159,6.812182741116751,28.346855011678638
Task_39125,1831,137,96,108,204,13.268115942028986,36.07434395964797
Task_39126,1997,967,55,33,88,2.06301652892562,39.9877999699207
Task_39127,2982,514,136,148,284,5.790291262135923,56.261272804710906
Task_39128,2470,221,182,139,321,11.126126126126126,47.30798939828677
Task_39129,1876,189,98,179,277,9.873684210526315,37.67730008714086
Task_39130,1228,926,62,16,78,1.3247033441208198,27.293995425721658
Task_39131,2680,541,119,81,200,4.944649446494465,50.986126864691805
Task_39132,1968,839,131,109,240,2.342857142857143,40.97473490946802
Task_39133,1985,249,71,31,102,7.94,37.735699647295355
Task_39134,2824,732,32,33,65,3.8526603001364257,52.01072376359024
Task_39135,2277,248,140,175,315,9.144578313253012,44.38643959150732
Task_39136,2163,489,53,134,187,4.414285714285715,42.81525270332605
Task_39137,1072,333,128,104,232,3.2095808383233533,25.148489403776523
Task_39138,1659,738,59,55,114,2.2449255751014885,34.49049540849815
Task_39139,2984,990,188,60,248,3.0110998990918265,57.18569044988434
Task_39140,2556,90,75,22,97,28.087912087912088,45.32474546151399
Task_39141,1983,240,114,22,136,8.228215767634854,37.973533345243816
Task_39142,2039,68,105,142,247,29.55072463768116,39.05899275245675
Task_39143,1857,93,54,12,66,19.75531914893617,33.864623610420644
Task_39144,924,701,197,20,217,1.3162393162393162,23.211949353228437
Task_39145,1976,326,85,127,212,6.042813455657492,39.37189600006078
Task_39146,1414,523,64,93,157,2.698473282442748,30.716237552804944
Task_39147,2717,532,30,128,158,5.097560975609756,51.3429709603431
Task_39148,2037,742,47,43,90,2.7415881561238225,40.03564681507996
Task_39149,595,934,122,80,202,0.6363636363636364,19.342033534807953
Task_39150,1003,892,190,149,339,1.1231802911534154,26.275891391791514
Task_39151,1991,807,73,192,265,2.464108910891089,41.53354516642846
Task_39152,1607,488,59,32,91,3.2862985685071573,32.353884886556116
Task_39153,1550,362,85,136,221,4.2699724517906334,32.806739890692
Task_39154,1528,551,30,155,185,2.7681159420289854,32.895723861282335
Task_39155,1774,626,50,85,135,2.8293460925039873,36.65631037375662
Task_39156,1803,118,80,152,232,15.15126050420168,35.730084628460524
Task_39157,1579,579,38,59,97,2.722413793103448,32.55453471563694
Task_39158,1038,99,148,141,289,10.38,23.68719552325472
Task_39159,1118,385,161,58,219,2.8963730569948187,25.604295055961288
Task_39160,937,269,133,52,185,3.4703703703703703,22.24241136200796
Task_39161,2891,671,105,189,294,4.302083333333333,55.429207257596524
Task_39162,542,194,36,140,176,2.7794871794871794,16.089756586688555
Task_39163,2875,432,78,77,155,6.63972286374134,53.389317188945256
Task_39164,1172,966,28,126,154,1.2119958634953465,28.090818846922264
Task_39165,2134,717,198,43,241,2.9721448467966574,42.6189444299589
Task_39166,1935,758,161,81,242,2.549407114624506,40.062739388822685
Task_39167,2091,508,162,171,333,4.1080550098231825,42.39013808446274
Task_39168,1831,543,105,197,302,3.3658088235294117,38.283538089202224
Task_39169,2554,586,21,34,55,4.350936967632027,47.29019356310217
Task_39170,1415,584,104,36,140,2.4188034188034186,30.200259023633933
Task_39171,756,280,145,60,205,2.6903914590747333,19.471121572632892
Task_39172,2186,209,60,58,118,10.40952380952381,41.11164812149636
Task_39173,2222,413,133,50,183,5.367149758454106,42.854440551437925
Task_39174,2901,94,124,124,248,30.53684210526316,52.665480130272634
Task_39175,2444,759,85,34,119,3.2157894736842105,46.78448094378513
Task_39176,1284,642,30,36,66,1.9968895800933126,27.3468852282062
Task_39177,2519,953,93,167,260,2.640461215932914,50.274666273299516
Task_39178,2129,801,188,95,283,2.6546134663341645,43.593626861483756
Task_39179,1611,459,57,91,148,3.502173913043478,33.583220663264825
Task_39180,1204,514,185,67,252,2.337864077669903,27.573966464785343
Task_39181,2286,811,161,163,324,2.815270935960591,46.383298539445185
Task_39182,942,867,31,108,139,1.0852534562211982,24.084015800339753
Task_39183,1131,877,119,26,145,1.2881548974943053,26.693275628229106
Task_39184,1310,692,134,161,295,1.8903318903318904,30.416182221263735
Task_39185,1772,902,92,121,213,1.9623477297895902,37.968934622256526
Task_39186,2477,958,97,83,180,2.5828988529718457,49.015923531925466
Task_39187,2785,394,182,134,316,7.050632911392405,52.87111467949743
Task_39188,2341,193,119,52,171,12.06701030927835,44.10924687164455
Task_39189,1836,568,48,44,92,3.226713532513181,36.29582753296033
Task_39190,1701,862,39,66,105,1.9710312862108923,35.62114819693685
Task_39191,1808,795,10,79,89,2.271356783919598,37.00357889360149
Task_39192,2975,531,134,145,279,5.592105263157895,56.178703089271416
Task_39193,2524,527,179,115,294,4.78030303030303,49.048701560652205
Task_39194,2063,241,58,38,96,8.524793388429751,38.78977318440649
Task_39195,2735,366,185,61,246,7.452316076294278,51.23432539820971
Task_39196,2680,116,130,40,170,22.905982905982906,48.326767628004255
Task_39197,1429,275,120,141,261,5.177536231884058,30.78708256377684
Task_39198,2710,342,69,139,208,7.900874635568513,51.101107626464106
Task_39199,2590,242,112,28,140,10.65843621399177,47.65556137171762
Task_39200,962,619,126,24,150,1.5516129032258064,23.145923438483774
Task_39201,1054,800,65,164,229,1.3158551810237205,26.418558984666237
Task_39202,1970,474,135,15,150,4.147368421052631,38.616723681453486
Task_39203,1229,515,64,156,220,2.381782945736434,28.304115770895972
Task_39204,1851,630,194,155,349,2.9334389857369256,39.0254281126633
Task_39205,2996,1013,196,146,342,2.9546351084812623,58.32111712465585
Task_39206,1621,738,190,129,319,2.1935047361299054,35.54746187015946
Task_39207,2321,186,127,126,253,12.411764705882353,44.52901055610636
Task_39208,1236,203,53,152,205,6.0588235294117645,27.32603569537908
Task_39209,691,864,120,33,153,0.7988439306358381,19.72695218945326
Task_39210,2630,358,178,33,211,7.325905292479109,49.16731896622883
Task_39211,2310,673,150,144,294,3.427299703264095,46.166895066547816
Task_39212,886,72,86,184,270,12.136986301369863,21.185528520809587
Task_39213,1084,582,135,80,215,1.8593481989708405,25.914660556910686
Task_39214,1845,166,67,50,117,11.047904191616766,35.16296657402916
Task_39215,847,621,122,90,212,1.3617363344051447,22.308992500318414
Task_39216,1755,641,51,98,149,2.7336448598130842,36.49867787644944
Task_39217,1910,560,119,164,283,3.4046345811051695,39.45435925723681
Task_39218,2886,97,51,123,174,29.448979591836736,52.114227722032325
Task_39219,2509,262,176,140,316,9.539923954372624,48.05663490955269
Task_39220,2916,211,86,196,282,13.754716981132075,54.178695453390155
Task_39221,2460,566,176,95,271,4.338624338624339,48.040878828908035
Task_39222,654,675,193,148,341,0.9674556213017751,20.126922811104322
Task_39223,804,812,141,57,198,0.988929889298893,21.934704858462904
Task_39224,1242,854,91,98,189,1.4526315789473685,29.224614787668894
Task_39225,2061,655,51,180,231,3.1417682926829267,42.03320470281498
Task_39226,2748,973,113,158,271,2.8213552361396306,53.96381973714538
Task_39227,1807,627,85,197,282,2.877388535031847,38.0847387278282
Task_39228,658,308,115,164,279,2.129449838187702,18.82120806654354
Task_39229,1587,297,188,169,357,5.325503355704698,33.83245400531404
Task_39230,2207,685,113,31,144,3.217201166180758,43.11327480371741
Task_39231,884,872,132,26,158,1.0126002290950744,22.76161095165017
Task_39232,1056,593,132,62,194,1.7777777777777777,25.155376372044472
Task_39233,2245,943,192,120,312,2.378177966101695,46.02864548733771
Task_39234,2332,935,117,58,175,2.4914529914529915,46.34097738261185
Task_39235,2365,589,144,60,204,4.008474576271187,45.91937143154946
Task_39236,755,832,118,136,254,0.9063625450180072,21.817283319953145
Task_39237,1992,689,121,194,315,2.8869565217391306,41.34819120011368
Task_39238,540,661,50,194,244,0.8157099697885196,17.979585530498227
Task_39239,638,103,191,95,286,6.134615384615385,17.38350105036425
Task_39240,2582,871,161,76,237,2.9610091743119265,50.569619675100625
Task_39241,1283,199,21,51,72,6.415,26.153923838150135
Task_39242,1997,793,157,119,276,2.5151133501259446,41.46748665617841
Task_39243,2496,744,63,141,204,3.350335570469799,48.99402792571465
Task_39244,2401,698,165,99,264,3.434907010014306,47.48002673813384
Task_39245,1012,415,160,50,210,2.4326923076923075,23.853512663014197
Task_39246,2474,104,147,65,212,23.561904761904763,45.453043431016056
Task_39247,1750,352,78,119,197,4.957507082152975,35.86554634030771
Task_39248,2736,828,68,53,121,3.3003618817852836,51.97370997702949
Task_39249,1858,685,67,199,266,2.7084548104956268,39.074060740031854
Task_39250,1170,597,76,47,123,1.9565217391304348,26.212926737683205
Task_39251,889,977,112,153,265,0.908997955010225,24.460464529975102
Task_39252,2791,379,131,25,156,7.344736842105263,51.37111111309864
Task_39253,2909,146,64,70,134,19.789115646258505,52.30971322735122
Task_39254,2976,677,83,62,145,4.389380530973451,55.6190859213998
Task_39255,842,777,75,38,113,1.082262210796915,21.54313117842388
Task_39256,2494,411,192,22,214,6.053398058252427,47.12984840624011
Task_39257,1242,212,29,76,105,5.830985915492958,26.384304238324873
Task_39258,868,222,21,137,158,3.89237668161435,21.06999229477341
Task_39259,1103,635,178,63,241,1.7342767295597483,26.281494698152642
Task_39260,1894,670,69,172,241,2.8226527570789868,39.44288981114878
Task_39261,2868,724,68,104,172,3.955862068965517,54.59946702961103
Task_39262,2965,448,133,122,255,6.603563474387528,55.60700416124896
Task_39263,1270,478,199,163,362,2.651356993736952,29.416451835642103
Task_39264,1019,126,198,193,391,8.023622047244094,24.177615361381555
Task_39265,1687,429,13,108,121,3.9232558139534883,34.42216179038879
Task_39266,2399,648,121,168,289,3.6964560862865947,47.51020444792963
Task_39267,1292,460,82,46,128,2.8026030368763557,27.955183242519524
Task_39268,1542,708,73,125,198,2.1748942172073344,33.711057383674834
Task_39269,1885,913,174,109,283,2.062363238512035,40.08392700190721
Task_39270,2048,503,109,47,156,4.063492063492063,40.08245111903187
Task_39271,1422,802,93,122,215,1.7708592777085927,32.140296471729094
Task_39272,2843,948,26,145,171,2.9957850368809273,54.852446293205816
Task_39273,2923,1016,11,62,73,2.8741396263520156,54.779644607133996
Task_39274,2274,640,73,67,140,3.547581903276131,44.395241296731264
Task_39275,1706,931,194,78,272,1.8304721030042919,37.08553137330278
Task_39276,1324,563,45,68,113,2.347517730496454,28.932925248866194
Task_39277,2516,786,45,164,209,3.1969504447268107,49.46008472307724
Task_39278,1211,646,182,192,374,1.8717156105100463,29.106092052351045
Task_39279,2019,138,181,188,369,14.525179856115107,39.886931528043085
Task_39280,594,186,77,60,137,3.176470588235294,16.373830937034793
Task_39281,1795,294,71,160,231,6.084745762711864,36.58959009418367
Task_39282,786,215,99,24,123,3.638888888888889,18.826326953487133
Task_39283,2429,771,57,46,103,3.1463730569948187,46.34133067065045
Task_39284,1308,779,92,182,274,1.676923076923077,30.585748520452153
Task_39285,517,350,129,175,304,1.4729344729344729,16.799026156196106
Task_39286,2940,912,38,150,188,3.2201533406352683,56.42612851811426
Task_39287,2439,770,137,143,280,3.1634241245136185,48.4510995086938
Task_39288,841,207,143,113,256,4.043269230769231,21.204921019929575
Task_39289,1529,519,40,77,117,2.9403846153846156,32.1193855433602
Task_39290,1805,249,185,123,308,7.22,36.82481194774609
Task_39291,1382,928,64,105,169,1.4876210979547901,31.624154869144558
Task_39292,1577,465,31,61,92,3.38412017167382,32.11480867741574
Task_39293,2358,659,61,81,142,3.5727272727272728,46.00277623290697
Task_39294,1282,966,29,88,117,1.3257497414684591,29.60794235721427
Task_39295,1014,163,38,168,206,6.182926829268292,23.410605520604733
Task_39296,2952,249,164,27,191,11.808,53.751602025919134
Task_39297,619,1013,152,134,286,0.6104536489151874,20.490639326080203
Task_39298,1247,165,37,170,207,7.5120481927710845,27.099294766373404
Task_39299,2575,830,112,171,283,3.098676293622142,50.848548331790234
Task_39300,1075,445,85,103,188,2.4103139013452917,25.345829647014728
Task_39301,1120,178,67,18,85,6.256983240223463,23.53421569368796
Task_39302,1868,412,69,80,149,4.523002421307506,37.518683734176385
Task_39303,1863,234,28,119,147,7.927659574468085,36.76624666989402
Task_39304,1044,609,75,193,268,1.7114754098360656,25.920835688837496
Task_39305,1353,205,178,105,283,6.567961165048544,29.39072302036675
Task_39306,1745,423,199,14,213,4.115566037735849,35.28322849511821
Task_39307,2113,109,120,74,194,19.20909090909091,39.82127881362196
Task_39308,779,740,148,27,175,1.0512820512820513,20.890236606519885
Task_39309,762,566,128,175,303,1.343915343915344,21.354196191687567
Task_39310,1849,184,183,130,313,9.994594594594595,37.2348484647968
Task_39311,698,1000,71,79,150,0.6973026973026973,20.902995513944624
Task_39312,1501,609,105,146,251,2.460655737704918,32.96143184752701
Task_39313,2961,189,185,25,210,15.58421052631579,53.78005089378365
Task_39314,994,469,19,148,167,2.1148936170212767,24.056662713070313
Task_39315,1954,500,20,50,70,3.900199600798403,37.67896439129149
Task_39316,1179,70,126,111,237,16.6056338028169,25.533641780055444
Task_39317,1286,605,158,132,290,2.122112211221122,29.699217308850134
Task_39318,2291,576,66,121,187,3.97053726169844,45.10655133355078
Task_39319,2155,461,65,188,253,4.6645021645021645,42.98615664327465
Task_39320,1051,279,94,68,162,3.7535714285714286,23.91845829196858
Task_39321,1893,215,67,117,184,8.76388888888889,37.560891195580815
Task_39322,1321,90,52,74,126,14.516483516483516,26.79422025124754
Task_39323,1428,456,27,189,216,3.12472647702407,31.217760138148922
Task_39324,1581,145,118,63,181,10.82876712328767,31.649113743730172
Task_39325,2252,678,92,38,130,3.3166421207658323,43.79603493001252
Task_39326,510,311,189,109,298,1.6346153846153846,16.482118661813384
Task_39327,1131,1023,13,195,208,1.1044921875,28.14068363420333
Task_39328,2916,728,113,185,298,4.0,56.017997112242405
Task_39329,1731,239,54,195,249,7.2125,35.52998065099821
Task_39330,2906,403,147,173,320,7.193069306930693,54.89114473920472
Task_39331,1503,816,153,150,303,1.8396572827417381,33.87978051957239
Task_39332,1226,132,135,123,258,9.218045112781954,26.771493942846504
Task_39333,2193,411,101,109,210,5.322815533980583,43.04544303791791
Task_39334,2341,994,111,45,156,2.3527638190954776,46.231543914310386
Task_39335,601,749,42,21,63,0.8013333333333333,17.04123674147009
Task_39336,1010,392,135,176,311,2.5699745547073793,24.818121372907274
Task_39337,2722,871,86,56,142,3.121559633027523,52.064376723718
Task_39338,719,504,134,156,290,1.4237623762376237,20.386746096500012
Task_39339,1807,424,180,55,235,4.251764705882353,36.70783969129966
Task_39340,2211,763,198,191,389,2.893979057591623,45.37873508002382
Task_39341,1419,715,108,138,246,1.9818435754189945,31.959956626866443
Task_39342,1861,963,106,148,254,1.9304979253112033,39.78553340718761
Task_39343,967,1016,109,111,220,0.9508357915437562,25.555046262932606
Task_39344,2236,214,120,140,260,10.4,43.31254001285507
Task_39345,942,677,54,51,105,1.3893805309734513,22.715496082816127
Task_39346,2662,962,63,158,221,2.7642782969885773,52.40846023656076
Task_39347,2907,827,111,55,166,3.510869565217391,55.11718360836256
Task_39348,1752,650,74,40,114,2.6912442396313363,35.48853283699879
Task_39349,657,711,87,17,104,0.922752808988764,18.232118965221833
Task_39350,1033,303,93,160,253,3.398026315789474,24.6498166191127
Task_39351,896,80,94,32,126,11.061728395061728,19.635456804016304
Task_39352,1820,218,66,32,98,8.310502283105023,34.94399323579514
Task_39353,2100,133,65,45,110,15.671641791044776,38.647709092157484
Task_39354,1346,402,128,103,231,3.339950372208437,29.699068345058482
Task_39355,1331,698,48,100,148,1.90414878397711,29.88885946735945
Task_39356,1244,163,33,192,225,7.585365853658536,27.141606207354133
Task_39357,626,759,75,57,132,0.8236842105263158,18.60958766006653
Task_39358,1819,428,97,126,223,4.24009324009324,37.27330139071319
Task_39359,2161,476,77,70,147,4.530398322851153,42.121726079003274
Task_39360,1725,802,34,65,99,2.148194271481943,35.68108372887262
Task_39361,2449,366,122,116,238,6.6730245231607626,47.08311895336146
Task_39362,2135,491,74,178,252,4.3394308943089435,42.73792721639356
Task_39363,2367,522,160,60,220,4.525812619502868,45.80901074367429
Task_39364,2146,763,59,20,79,2.8089005235602094,41.352477211023455
Task_39365,2439,423,53,125,178,5.752358490566038,46.90330827817999
Task_39366,704,729,153,45,198,0.9643835616438357,19.877086345392282
Task_39367,994,301,108,120,228,3.2913907284768213,23.816917343191278
Task_39368,2129,220,41,64,105,9.633484162895927,40.290221255303756
Task_39369,1851,64,170,127,297,28.476923076923075,36.332943154647346
Task_39370,2321,590,155,82,237,3.9272419627749575,45.65930648636487
Task_39371,578,159,179,33,212,3.6125,15.9013662610228
Task_39372,1168,583,180,32,212,2.0,26.76186136315596
Task_39373,1423,244,39,156,195,5.808163265306122,30.32103721425057
Task_39374,689,312,191,80,271,2.2012779552715656,19.065510673183226
Task_39375,930,415,73,103,176,2.235576923076923,22.94324626096709
Task_39376,966,637,88,190,278,1.5141065830721003,24.67558308878812
Task_39377,1448,778,148,39,187,1.858793324775353,31.6800234104165
Task_39378,1522,705,194,125,319,2.1558073654390935,33.8702880436151
Task_39379,622,526,141,101,242,1.1802656546489563,18.616745533095585
Task_39380,2304,475,186,148,334,4.840336134453781,45.62668123890543
Task_39381,1795,640,19,170,189,2.800312012480499,37.452855276925696
Task_39382,709,703,133,86,219,1.0071022727272727,20.324818635337127
Task_39383,2178,485,13,62,75,4.481481481481482,41.31839871427874
Task_39384,1549,597,193,67,260,2.5903010033444818,33.33396590877464
Task_39385,978,631,16,98,114,1.5474683544303798,23.707800544370752
Task_39386,758,405,101,97,198,1.8669950738916257,20.27503498655994
Task_39387,773,821,125,195,320,0.940389294403893,22.449768234906713
Task_39388,651,474,35,63,98,1.3705263157894736,17.64622197959631
Task_39389,2231,879,48,92,140,2.5352272727272727,44.67000160136396
Task_39390,2492,607,59,23,82,4.098684210526316,46.63268295199544
Task_39391,2466,225,130,53,183,10.91150442477876,46.239169158802355
Task_39392,726,230,16,128,144,3.142857142857143,18.765500027753195
Task_39393,715,476,86,166,252,1.49895178197065,20.048233008821473
Task_39394,2724,373,64,70,134,7.283422459893048,50.64961061893661
Task_39395,1736,835,80,24,104,2.076555023923445,35.61931867027591
Task_39396,557,801,198,23,221,0.6945137157107232,17.991264117132676
Task_39397,2298,987,91,175,266,2.325910931174089,46.87815883736001
Task_39398,2371,339,115,102,217,6.973529411764706,45.642883714457405
Task_39399,1911,892,193,136,329,2.139977603583427,40.677457302895114
Task_39400,2642,830,125,42,167,3.1793020457280385,50.67433643578111
Task_39401,531,858,155,138,293,0.6181606519208381,18.662754061118488
Task_39402,754,463,196,166,362,1.625,21.19226085666357
Task_39403,694,141,38,69,107,4.887323943661972,16.99122673725189
Task_39404,593,236,133,36,169,2.50210970464135,16.323623638107982
Task_39405,2276,487,154,92,246,4.663934426229508,44.69169771315726
Task_39406,526,776,124,16,140,0.676962676962677,16.94425314172514
Task_39407,1894,242,154,145,299,7.794238683127572,38.19771568026562
Task_39408,538,399,124,23,147,1.345,15.773344071474066
Task_39409,1099,962,71,182,253,1.1412253374870198,27.73378757693483
Task_39410,1477,451,178,150,328,3.267699115044248,32.4350080167176
Task_39411,611,492,162,153,315,1.2393509127789046,18.73723901683789
Task_39412,2825,143,114,153,267,19.618055555555557,52.13625384324902
Task_39413,1369,385,29,20,49,3.5466321243523318,27.722246963389512
Task_39414,2675,804,68,155,223,3.3229813664596275,52.130619737760725
Task_39415,2916,609,10,182,192,4.780327868852459,55.117897089702986
Task_39416,1638,70,73,31,104,23.070422535211268,30.629290224896394
Task_39417,2221,68,95,94,189,32.18840579710145,41.58744141990266
Task_39418,1161,588,118,25,143,1.971137521222411,26.185435005626797
Task_39419,2306,997,28,58,86,2.31062124248497,45.260268449039216
Task_39420,1412,308,21,122,143,4.56957928802589,29.85665542082695
Task_39421,1768,278,156,13,169,6.336917562724015,34.93886633617267
Task_39422,1698,619,57,189,246,2.738709677419355,36.21972112109946
Task_39423,1489,826,78,62,140,1.800483675937122,32.46310781792278
Task_39424,2578,777,53,127,180,3.3136246786632393,50.24727978213365
Task_39425,769,921,175,173,348,0.834056399132321,22.7816620157933
Task_39426,750,203,92,83,175,3.676470588235294,19.243595598038066
Task_39427,1759,184,17,195,212,9.508108108108107,35.378675934107655
Task_39428,531,972,99,149,248,0.5457348406988695,18.76810425035288
Task_39429,1110,745,22,144,166,1.4879356568364612,26.71904366928186
Task_39430,1714,156,88,46,134,10.9171974522293,33.18797498041277
Task_39431,1010,152,90,156,246,6.601307189542483,23.518046664567652
Task_39432,2923,660,159,101,260,4.422087745839637,55.618857451133444
Task_39433,790,724,33,16,49,1.089655172413793,19.725523151562317
Task_39434,2092,448,157,137,294,4.65924276169265,41.98718049277617
Task_39435,2681,877,26,166,192,3.0535307517084282,52.24343502443981
Task_39436,1589,573,183,101,284,2.768292682926829,34.324564366210105
Task_39437,824,689,55,97,152,1.1942028985507247,21.808179164508157
Task_39438,2089,589,184,103,287,3.5406779661016947,42.30944958336274
Task_39439,1642,621,100,171,271,2.639871382636656,35.358955068236945
Task_39440,1745,819,200,176,376,2.1280487804878048,38.09038634895122
Task_39441,702,705,111,93,204,0.9943342776203966,20.272382883657983
Task_39442,2864,809,40,105,145,3.5358024691358025,54.47635359130496
Task_39443,1838,558,126,117,243,3.2880143112701252,38.05874502229436
Task_39444,2281,636,102,92,194,3.5808477237048666,45.00996996417128
Task_39445,2837,559,73,30,103,5.066071428571429,52.26848569553325
Task_39446,1390,221,200,93,293,6.261261261261262,30.042738153031536
Task_39447,1702,624,160,175,335,2.7232,36.61295159585867
Task_39448,2259,432,102,169,271,5.2170900692840645,44.52151969079582
Task_39449,2642,944,93,52,145,2.795767195767196,51.23739459655308
Task_39450,2674,238,91,16,107,11.188284518828452,48.56343403305663
Task_39451,2129,335,151,42,193,6.336309523809524,41.09404260798528
Task_39452,2450,932,121,40,161,2.6259378349410505,47.818580118313776
Task_39453,2167,731,22,185,207,2.960382513661202,43.7339408052214
Task_39454,1278,915,145,74,219,1.3951965065502183,29.917545748678037
Task_39455,556,632,41,115,156,0.8783570300157978,17.360695658308515
Task_39456,2031,373,118,37,155,5.43048128342246,39.385216870645415
Task_39457,1432,662,189,137,326,2.1598793363499245,32.35947103655578
Task_39458,2878,173,130,83,213,16.54022988505747,52.66970590320892
Task_39459,917,953,15,14,29,0.9612159329140462,22.344019491735995
Task_39460,1764,512,120,184,304,3.43859649122807,37.114205351658825
Task_39461,2898,538,49,78,127,5.376623376623376,54.138501580866
Task_39462,2850,319,135,11,146,8.90625,52.064538377317895
Task_39463,516,796,178,170,348,0.6474278544542033,18.50350080026064
Task_39464,1262,905,46,118,164,1.3929359823399559,29.60101527813028
Task_39465,686,352,14,29,43,1.9433427762039661,16.872327636534497
Task_39466,2563,648,95,74,169,3.9491525423728815,49.21743035252214
Task_39467,1111,643,117,193,310,1.7251552795031055,27.21248347672527
Task_39468,1713,310,53,187,240,5.508038585209003,35.43937510909336
Task_39469,2532,739,168,43,211,3.4216216216216218,48.85769852768268
Task_39470,2910,398,46,77,123,7.293233082706767,53.66802249458996
Task_39471,2730,220,190,157,347,12.352941176470589,51.55348900706804
Task_39472,1615,710,68,73,141,2.271448663853727,34.24695160188457
Task_39473,1035,577,156,86,242,1.7906574394463668,25.28667161013975
Task_39474,735,147,86,26,112,4.966216216216216,17.42122414070042
Task_39475,2507,248,95,63,158,10.068273092369479,46.74390267923019
Task_39476,1921,477,60,100,160,4.018828451882845,38.58989383196445
Task_39477,2221,487,175,184,359,4.551229508196721,44.51697720876083
Task_39478,2692,694,196,161,357,3.873381294964029,52.592900305526996
Task_39479,2092,615,124,26,150,3.396103896103896,41.069300526738495
Task_39480,634,87,70,65,135,7.204545454545454,15.968427348602987
Task_39481,2980,792,177,175,352,3.7578814627994954,57.462576944302555
Task_39482,2201,738,44,72,116,2.9783491204330175,43.38680036470731
Task_39483,880,899,185,70,255,0.9777777777777777,23.701469357153684
Task_39484,772,296,67,134,201,2.5993265993265995,20.264221854983678
Task_39485,2870,1003,67,28,95,2.858565737051793,54.11659785225198
Task_39486,1521,901,196,65,261,1.6862527716186253,33.84477917695198
Task_39487,1147,771,30,83,113,1.4857512953367875,26.86594407424756
Task_39488,1715,152,39,106,145,11.209150326797385,33.671778841052166
Task_39489,1882,164,61,30,91,11.406060606060606,35.45665724231239
Task_39490,2130,391,66,18,84,5.433673469387755,40.27341977506684
Task_39491,2329,583,32,104,136,3.988013698630137,45.21105458895297
Task_39492,2862,777,140,189,329,3.67866323907455,55.462745612656
Task_39493,2130,700,31,16,47,3.0385164051355207,40.71271555629159
Task_39494,2909,64,61,12,73,44.753846153846155,49.656048784424904
Task_39495,507,68,52,181,233,7.3478260869565215,15.101638333823539
Task_39496,2141,165,34,15,49,12.897590361445783,39.13754545416152
Task_39497,2579,191,34,132,166,13.432291666666666,48.16130113136879
Task_39498,1823,769,47,181,228,2.3675324675324676,38.55057181547358
Task_39499,2880,886,134,182,316,3.2468996617812853,56.02144252846515
Task_39500,747,550,198,99,297,1.355716878402904,20.922441939022963
Task_39501,2264,805,48,188,236,2.8089330024813894,45.715838827980235
Task_39502,608,406,92,159,251,1.4938574938574938,18.174924291969432
Task_39503,756,332,165,83,248,2.27027027027027,20.116984527612342
Task_39504,1695,209,134,166,300,8.071428571428571,34.97046139118844
Task_39505,1124,394,190,89,279,2.8455696202531646,26.313958522256723
Task_39506,654,398,110,21,131,1.6390977443609023,17.483176057980973
Task_39507,841,338,101,55,156,2.4808259587020647,20.675972426122346
Task_39508,1034,147,16,150,166,6.986486486486487,23.319080809216803
Task_39509,1392,940,188,169,357,1.4792773645058448,32.73455361960969
Task_39510,2084,569,142,24,166,3.656140350877193,40.961454198450454
Task_39511,878,379,116,10,126,2.3105263157894735,20.884560874163324
Task_39512,1830,817,91,56,147,2.237163814180929,37.86252953941956
Task_39513,1166,350,142,133,275,3.321937321937322,26.92641828907548
Task_39514,1721,796,50,172,222,2.1593475533249684,37.03667522638678
Task_39515,1905,77,95,190,285,24.423076923076923,37.237456619642785
Task_39516,2263,492,52,18,70,4.59026369168357,42.22365736178008
Task_39517,615,547,139,118,257,1.1222627737226278,18.645103331591198
Task_39518,1950,149,183,123,306,13.0,38.538664109379845
Task_39519,674,190,114,180,294,3.5287958115183247,18.780398848604037
Task_39520,2914,695,167,195,362,4.186781609195402,56.1849527229763
Task_39521,2442,501,195,108,303,4.864541832669323,47.696968970380475
Task_39522,1174,486,196,29,225,2.410677618069815,26.602699963099738
Task_39523,2016,120,44,88,132,16.66115702479339,38.133542948987305
Task_39524,2128,699,177,50,227,3.04,42.496847987269334
Task_39525,2025,318,152,184,336,6.347962382445141,40.75617428582024
Task_39526,2835,382,93,162,255,7.402088772845953,53.42639527867272
Task_39527,2190,911,143,13,156,2.401315789473684,43.51173572211445
Task_39528,2023,410,169,111,280,4.922141119221411,40.67043121993573
Task_39529,1415,352,46,32,78,4.008498583569405,28.638495955218474
Task_39530,1245,695,94,19,113,1.7887931034482758,27.564395394136053
Task_39531,2986,309,127,35,162,9.63225806451613,54.346120833971696
Task_39532,1494,659,70,93,163,2.2636363636363637,32.558307194991485
Task_39533,2576,389,47,107,154,6.605128205128205,48.595064785165654
Task_39534,1181,208,33,78,111,5.650717703349282,25.583748014943733
Task_39535,2649,444,77,124,201,5.952808988764045,50.41880568487482
Task_39536,1327,70,128,164,292,18.690140845070424,28.17409372226037
Task_39537,1531,719,83,165,248,2.126388888888889,33.83086427922427
Task_39538,1964,906,92,178,270,2.165380374862183,41.364150994330124
Task_39539,860,787,175,69,244,1.0913705583756346,22.918442310434045
Task_39540,2748,946,37,104,141,2.901795142555438,53.05009771584892
Task_39541,1354,88,132,109,241,15.213483146067416,28.343344246663474
Task_39542,511,554,133,149,282,0.9207207207207208,17.229828868418224
Task_39543,1382,613,33,163,196,2.250814332247557,30.872719960122158
Task_39544,2025,76,189,184,373,26.2987012987013,39.486817909500154
Task_39545,609,214,102,19,121,2.832558139534884,15.952810957258059
Task_39546,1567,653,139,51,190,2.3960244648318043,33.41354970935384
Task_39547,2050,962,89,189,278,2.1287642782969884,42.924645649797874
Task_39548,2454,369,11,104,115,6.632432432432433,46.31047715791945
Task_39549,2719,264,25,176,201,10.260377358490565,50.90273363747952
Task_39550,2105,312,58,72,130,6.725239616613418,40.720191582428
Task_39551,770,472,68,99,167,1.627906976744186,20.514728931804573
Task_39552,1345,519,165,86,251,2.5865384615384617,30.05378868924561
Task_39553,2855,807,187,158,345,3.5334158415841586,55.47292627874331
Task_39554,596,779,107,126,233,0.764102564102564,19.045114673917457
Task_39555,2195,387,31,161,192,5.657216494845361,42.990661198723764
Task_39556,830,822,124,18,142,1.008505467800729,21.634716209906713
Task_39557,2817,505,88,45,133,5.567193675889328,52.12572587446206
Task_39558,644,853,152,76,228,0.7540983606557377,19.766810701702273
Task_39559,1185,71,194,169,363,16.458333333333332,26.287125543602
Task_39560,2622,663,198,103,301,3.9487951807228914,51.04856260211701
Task_39561,510,783,61,128,189,0.6505102040816326,17.642987078219306
Task_39562,2191,952,152,88,240,2.2990556138509968,44.77043670016129
Task_39563,2813,651,135,56,191,4.314417177914111,53.165218423529375
Task_39564,539,970,98,104,202,0.5550978372811535,18.63699258945227
Task_39565,1983,257,78,152,230,7.686046511627907,39.42355430931891
Task_39566,2278,957,166,145,311,2.3778705636743216,46.627318277222514
Task_39567,2439,983,131,39,170,2.4786585365853657,47.915125382813265
Task_39568,930,98,44,106,150,9.393939393939394,20.864435283869756
Task_39569,2631,844,54,86,140,3.113609467455621,50.90971040049583
Task_39570,1070,971,147,174,321,1.1008230452674896,27.552042064142565
Task_39571,670,588,139,168,307,1.137521222410866,19.951580678895628
Task_39572,2302,69,189,74,263,32.885714285714286,42.82122775728255
Task_39573,519,878,16,142,158,0.590443686006826,17.796277467878465
Task_39574,2642,496,56,30,86,5.315895372233401,48.71594082816106
Task_39575,1720,469,62,160,222,3.6595744680851063,35.94288286796347
Task_39576,1794,481,70,45,115,3.7219917012448134,35.60383804139911
Task_39577,978,636,31,139,170,1.5353218210361068,24.301276089487562
Task_39578,1206,621,42,42,84,1.9389067524115755,26.484975824330945
Task_39579,2435,285,45,180,225,8.513986013986013,46.646261077103304
Task_39580,2314,861,135,154,289,2.6844547563805103,46.812347057932435
Task_39581,2848,430,34,180,214,6.607888631090487,53.607898754480395
Task_39582,2316,560,37,124,161,4.128342245989304,45.14377226332442
Task_39583,566,297,80,71,151,1.8993288590604027,16.282955184357917
Task_39584,2952,75,191,198,389,38.8421052631579,54.08548169995137
Task_39585,571,311,115,70,185,1.830128205128205,16.58584360404654
Task_39586,2194,974,194,58,252,2.2502564102564104,44.642974363879176
Task_39587,2053,231,200,137,337,8.849137931034482,40.82899912979283
Task_39588,1498,245,87,66,153,6.0894308943089435,30.654675736572553
Task_39589,2542,455,47,87,134,5.574561403508772,48.2259167482237
Task_39590,2227,160,151,158,309,13.832298136645962,43.01983697219392
Task_39591,812,815,50,93,143,0.9950980392156863,22.041612976551036
Task_39592,1698,882,65,68,133,1.9229898074745186,36.0487891141671
Task_39593,2333,107,160,48,208,21.60185185185185,43.04445423594235
Task_39594,1803,982,200,82,282,1.834181078331638,38.88373265836077
Task_39595,911,933,72,45,117,0.9753747323340471,23.128304327308257
Task_39596,1552,638,103,188,291,2.428794992175274,34.101972842252984
Task_39597,755,211,78,89,167,3.561320754716981,19.438209575385226
Task_39598,1482,120,133,99,232,12.24793388429752,30.586889017344216
Task_39599,2051,807,153,89,242,2.5383663366336635,42.12697776505385
Task_39600,2786,951,63,18,81,2.926470588235294,52.372786802269786
Task_39601,2888,675,89,56,145,4.272189349112426,54.17250331838715
Task_39602,2227,1009,188,60,248,2.204950495049505,45.24869751859703
Task_39603,736,396,54,145,199,1.853904282115869,20.015085730335155
Task_39604,2829,573,125,91,216,4.928571428571429,53.58431057005847
Task_39605,2996,1012,110,57,167,2.9575518262586376,57.07877983106375
Task_39606,2651,545,100,160,260,4.855311355311355,51.030175637522426
Task_39607,602,607,63,187,250,0.9901315789473685,18.75369654088779
Task_39608,1896,771,18,196,214,2.4559585492227978,39.61639746722431
Task_39609,1480,785,60,129,189,1.8829516539440203,32.940618773095785
Task_39610,2524,698,113,172,285,3.6108726752503575,49.63600545755795
Task_39611,1735,344,116,64,180,5.028985507246377,35.07962910453458
Task_39612,1526,433,12,181,193,3.5161290322580645,32.55406384668441
Task_39613,1809,921,128,189,317,1.9620390455531453,39.17505148224562
Task_39614,1993,669,31,147,178,2.9746268656716417,40.59010437756559
Task_39615,2477,259,17,45,62,9.526923076923078,44.98756875887174
Task_39616,2173,332,20,136,156,6.525525525525525,42.06068068245788
Task_39617,1525,971,110,159,269,1.5689300411522633,34.52694837724447
Task_39618,2250,582,149,172,321,3.8593481989708405,45.09119783182724
Task_39619,1026,1022,97,179,276,1.002932551319648,26.797898316272835
Task_39620,1192,720,187,53,240,1.653259361997226,27.98094001734518
Task_39621,2822,825,38,60,98,3.416464891041162,53.01799192142249
Task_39622,2119,407,169,43,212,5.193627450980392,41.261937283727
Task_39623,2863,79,73,37,110,35.7875,50.119487454017836
Task_39624,1329,613,15,83,98,2.1644951140065145,28.963897300251876
Task_39625,1778,328,68,118,186,5.404255319148936,36.150689700246254
Task_39626,1277,681,169,111,280,1.8724340175953078,29.718261836117787
Task_39627,1283,776,69,43,112,1.6512226512226513,28.44810967229903
Task_39628,1049,822,44,66,110,1.2746051032806804,25.234204530858772
Task_39629,1685,968,172,13,185,1.73890608875129,35.90686805063533
Task_39630,2097,1020,45,118,163,2.0538687561214495,43.21713992643746
Task_39631,2085,912,71,125,196,2.2836801752464404,42.94120424249902
Task_39632,1816,495,151,180,331,3.661290322580645,37.99910813314607
Task_39633,2152,205,169,62,231,10.446601941747574,41.38671210645155
Task_39634,812,670,120,52,172,1.2101341281669151,21.459320493347974
Task_39635,2163,561,87,119,206,3.8487544483985765,43.0109833791314
Task_39636,1139,683,40,58,98,1.6652046783625731,25.903504509268085
Task_39637,1860,699,30,71,101,2.657142857142857,37.618600394093725
Task_39638,2503,67,169,153,322,36.80882352941177,46.66925415397992
Task_39639,600,754,71,55,126,0.7947019867549668,18.140494600773284
Task_39640,1550,67,161,53,214,22.794117647058822,30.66493714437102
Task_39641,1647,98,40,34,74,16.636363636363637,30.904773739115257
Task_39642,598,606,127,185,312,0.985172981878089,18.95677683158352
Task_39643,1974,573,98,117,215,3.4390243902439024,40.137878546270706
Task_39644,1767,509,177,169,346,3.4647058823529413,37.31946461035894
Task_39645,827,641,145,184,329,1.2881619937694704,22.732904047977485
Task_39646,2899,258,96,43,139,11.193050193050192,52.608254847425634
Task_39647,2976,419,165,178,343,7.085714285714285,56.16342801905665
Task_39648,2732,957,112,61,173,2.8517745302713986,52.719651282741005
Task_39649,913,434,139,26,165,2.098850574712644,22.022529805806965
Task_39650,2310,282,59,194,253,8.162544169611307,44.84827639248699
Task_39651,2092,309,92,182,274,6.748387096774193,41.510286530760936
Task_39652,2290,868,157,183,340,2.6352128883774455,46.72631530556621
Task_39653,2140,216,103,107,210,9.861751152073733,41.53061124524977
Task_39654,1779,210,186,12,198,8.431279620853081,35.042938054559265
Task_39655,881,756,14,197,211,1.1638044914134742,23.400792704861853
Task_39656,1195,789,58,63,121,1.5126582278481013,27.466144173049923
Task_39657,1951,277,60,113,173,7.017985611510792,38.64428562722588
Task_39658,1650,433,148,36,184,3.80184331797235,33.767040848018944
Task_39659,1658,417,15,185,200,3.9665071770334928,34.64860702996503
Task_39660,1692,779,68,200,268,2.169230769230769,36.747577456612916
Task_39661,873,966,78,104,182,0.9027921406411582,23.718948842338353
Task_39662,1423,860,196,25,221,1.6527293844367015,31.64465593208809
Task_39663,2584,214,147,80,227,12.018604651162791,48.471191286795516
Task_39664,1358,941,48,35,83,1.4416135881104033,29.849355855670865
Task_39665,2423,117,82,193,275,20.533898305084747,45.723787840127606
Task_39666,1618,585,174,23,197,2.7610921501706485,33.76466990778176
Task_39667,2490,452,60,90,150,5.496688741721854,47.48051782761407
Task_39668,999,294,128,80,208,3.386440677966102,23.625007218930055
Task_39669,2450,529,130,101,231,4.622641509433962,47.57902180837268
Task_39670,2727,86,59,11,70,31.344827586206897,47.39608988168018
Task_39671,1432,299,105,199,304,4.773333333333333,31.19367126049784
Task_39672,1715,415,177,192,369,4.122596153846154,36.3325297150532
Task_39673,2109,636,42,20,62,3.3108320251177394,40.289449462708504
Task_39674,1990,362,24,166,190,5.482093663911845,39.6498802968976
Task_39675,1782,651,53,156,209,2.733128834355828,37.44115700845271
Task_39676,2495,66,85,149,234,37.23880597014925,46.14869055719766
Task_39677,2332,626,98,195,293,3.719298245614035,46.441227498568814
Task_39678,2441,212,121,162,283,11.460093896713616,46.677479056755054
Task_39679,877,852,164,118,282,1.0281359906213365,23.87163473117211
Task_39680,907,243,166,50,216,3.7172131147540983,21.66576520707794
Task_39681,1491,697,193,41,234,2.1361031518624642,32.33635501511139
Task_39682,2474,745,68,54,122,3.316353887399464,47.5560544822204
Task_39683,2539,106,103,180,283,23.72897196261682,47.37312056190595
Task_39684,768,652,176,170,346,1.1761102603369067,21.89016225730936
Task_39685,1626,851,79,110,189,1.908450704225352,35.42194746764543
Task_39686,2878,76,149,28,177,37.37662337662338,51.0041279290952
Task_39687,959,71,72,102,174,13.319444444444445,21.812951392262665
Task_39688,1856,992,73,96,169,1.8690835850956697,39.3951645646681
Task_39689,2457,1019,175,104,279,2.4088235294117646,49.45261607840987
Task_39690,2072,778,65,184,249,2.6598202824133503,42.652129911090775
Task_39691,1774,879,112,112,224,2.015909090909091,37.957806701328245
Task_39692,551,672,51,173,224,0.8187221396731055,18.03811938052236
Task_39693,1019,975,75,90,165,1.0440573770491803,25.948310977182867
Task_39694,1540,427,27,113,140,3.5981308411214954,32.244369164755554
Task_39695,1329,378,77,122,199,3.5065963060686016,29.303536250497853
Task_39696,1463,982,119,72,191,1.4883011190233977,32.9029808806144
Task_39697,1140,670,44,133,177,1.698956780923994,27.059424464482948
Task_39698,2118,854,12,170,182,2.4771929824561405,43.15607714901957
Task_39699,1454,491,145,55,200,2.9552845528455283,31.177000283509596
Task_39700,1413,100,16,55,71,13.990099009900991,27.557705169562727
Task_39701,632,206,81,50,131,3.0531400966183573,16.73042971826528
Task_39702,704,872,142,31,173,0.8064146620847652,20.16045225019275
Task_39703,751,605,114,69,183,1.2392739273927393,20.315249718225033
Task_39704,877,1010,44,78,122,0.8674579624134521,23.324474272068567
Task_39705,2881,373,116,142,258,7.7032085561497325,54.069399522778006
Task_39706,516,903,45,193,238,0.5707964601769911,18.368351055052603
Task_39707,2200,891,30,79,109,2.4663677130044843,43.85252872240085
Task_39708,1724,692,21,128,149,2.4877344877344876,36.07367162022022
Task_39709,732,1015,185,29,214,0.7204724409448819,21.41478452268761
Task_39710,1943,694,135,152,287,2.79568345323741,40.399963974279245
Task_39711,622,591,150,173,323,1.0506756756756757,19.288998944870233
Task_39712,1332,484,156,127,283,2.7463917525773196,30.00806942451909
Task_39713,1830,1020,107,79,186,1.792360430950049,38.9313726115595
Task_39714,2170,629,105,153,258,3.4444444444444446,43.66145662306578
Task_39715,2252,397,38,164,202,5.658291457286432,43.987453088603395
Task_39716,1979,611,177,79,256,3.2336601307189543,40.35993134896672
Task_39717,838,838,54,178,232,0.99880810488677,23.113451257988356
Task_39718,575,521,149,117,266,1.1015325670498084,17.984568680224214
Task_39719,2502,482,116,163,279,5.180124223602484,48.55778818521075
Task_39720,539,716,32,200,232,0.7517433751743375,17.99849448914342
Task_39721,2672,308,16,93,109,8.647249190938512,49.46497393406059
Task_39722,603,473,162,66,228,1.2721518987341771,17.811367223081167
Task_39723,1664,243,122,139,261,6.819672131147541,34.38763368081555
Task_39724,2405,547,48,103,151,4.388686131386861,46.4207298749165
Task_39725,2186,307,63,149,212,7.097402597402597,42.7213919041914
Task_39726,2585,765,191,156,347,3.3746736292428197,51.06939121557563
Task_39727,2118,852,178,169,347,2.4830011723329424,43.96213492869487
Task_39728,2158,426,50,59,109,5.053864168618267,41.377224653896064
Task_39729,1965,702,26,57,83,2.795163584637269,38.91986461398846
Task_39730,765,284,200,33,233,2.6842105263157894,19.52790345638782
Task_39731,1782,620,96,154,250,2.869565217391304,37.461176352353284
Task_39732,2405,403,167,176,343,5.952970297029703,47.071480857767035
Task_39733,1095,801,28,41,69,1.3653366583541147,24.896348063977744
Task_39734,1448,633,55,162,217,2.2839116719242902,32.13710732154593
Task_39735,2412,265,106,127,233,9.06766917293233,46.14146452521576
Task_39736,824,739,150,23,173,1.1135135135135135,21.542039242206926
Task_39737,1646,892,59,154,213,1.843225083986562,36.05198626366697
Task_39738,540,657,187,79,266,0.8206686930091185,17.743350979619454
Task_39739,2453,752,192,99,291,3.257636122177955,48.5954461553081
Task_39740,1807,1019,138,63,201,1.7715686274509803,38.4489830226096
Task_39741,695,476,133,63,196,1.4570230607966457,19.11807600251331
Task_39742,2431,328,32,138,170,7.3890577507598785,46.34814193347136
Task_39743,558,844,46,146,192,0.6603550295857988,18.61008483803426
Task_39744,2759,277,30,27,57,9.924460431654676,49.530931794963436
Task_39745,2124,73,115,26,141,28.7027027027027,38.73444584663202
Task_39746,937,369,45,80,125,2.5324324324324325,22.455119340048498
Task_39747,1996,99,16,97,113,19.96,37.38738069578838
Task_39748,1438,353,64,42,106,4.062146892655368,29.3369709717892
Task_39749,1038,222,97,123,220,4.654708520179372,24.22649010526537
Task_39750,1809,186,46,34,80,9.67379679144385,34.614989661485524
Task_39751,1514,724,55,152,207,2.0882758620689654,33.40726528297192
Task_39752,1917,856,43,149,192,2.236872812135356,40.07863943943381
Task_39753,2525,716,190,167,357,3.521617852161785,50.02581061783555
Task_39754,2475,586,113,47,160,4.216354344122657,47.12931068185717
Task_39755,2437,498,172,90,262,4.88376753507014,47.365214311156386
Task_39756,505,206,62,62,124,2.4396135265700485,14.72535854365038
Task_39757,2596,627,94,170,264,4.13375796178344,50.46425569056476
Task_39758,1042,599,11,65,76,1.7366666666666666,23.746645232497244
Task_39759,540,600,194,145,339,0.8985024958402662,18.094202144178478
Task_39760,1739,817,121,155,276,2.125916870415648,37.5076018775968
Task_39761,559,999,19,146,165,0.559,18.881808352390333
Task_39762,2757,486,95,122,217,5.661190965092403,52.27828189545326
Task_39763,2473,687,179,103,282,3.5944767441860463,48.678764252030554
Task_39764,800,994,172,74,246,0.8040201005025126,22.758774112436626
Task_39765,630,811,79,145,224,0.7758620689655172,19.69610127441493
Task_39766,880,266,43,103,146,3.295880149812734,21.3468438895303
Task_39767,2265,80,13,113,126,27.962962962962962,41.56814963197475
Task_39768,2431,893,96,102,198,2.71923937360179,48.287481526546976
Task_39769,2032,726,190,173,363,2.795048143053645,42.28349551788986
Task_39770,2743,543,38,145,183,5.042279411764706,52.08351049646711
Task_39771,721,938,67,155,222,0.7678381256656017,21.552577588292404
Task_39772,2722,390,31,40,71,6.961636828644501,49.34656240867444
Task_39773,2938,429,141,112,253,6.832558139534884,55.09299753522714
Task_39774,2912,512,153,140,293,5.6764132553606235,55.17535724778653
Task_39775,1216,464,72,104,176,2.6150537634408604,27.626186580111508
Task_39776,1343,535,63,119,182,2.5055970149253732,29.90559110339828
Task_39777,2447,537,119,86,205,4.548327137546468,47.35170900244659
Task_39778,1709,333,176,118,294,5.116766467065868,35.52300827543213
Task_39779,1695,764,54,53,107,2.215686274509804,35.01774949876457
Task_39780,603,141,80,107,187,4.246478873239437,16.678657560943527
Task_39781,983,936,75,58,133,1.0490928495197438,24.750044884221747
Task_39782,1060,465,130,151,281,2.274678111587983,25.668556477515903
Task_39783,1384,1000,15,53,68,1.3826173826173827,30.312428780900287
Task_39784,1389,692,23,56,79,2.0043290043290045,29.577182622324404
Task_39785,783,357,11,160,171,2.1871508379888267,20.366933960153712
Task_39786,887,1019,170,174,344,0.8696078431372549,24.93845704373251
Task_39787,2048,130,67,177,244,15.633587786259541,39.794874467323176
Task_39788,2370,958,13,70,83,2.4713242961418143,46.260246385199025
Task_39789,1904,89,174,195,369,21.155555555555555,37.68377779199214
Task_39790,518,909,15,174,189,0.5692307692307692,18.157508851390705
Task_39791,2266,451,35,178,213,5.013274336283186,44.46018922225892
Task_39792,2551,458,196,39,235,5.557734204793029,48.364081081947155
Task_39793,2869,788,10,164,174,3.6362484157160964,54.81118530601858
Task_39794,827,682,182,40,222,1.2108345534407028,21.729266243697396
Task_39795,2071,669,192,174,366,3.091044776119403,42.73717069437375
Task_39796,1008,974,89,44,133,1.0338461538461539,24.961617509147136
Task_39797,1401,765,195,64,259,1.828981723237598,31.503810934432163
Task_39798,1619,392,15,187,202,4.119592875318066,33.962608737896055
Task_39799,1434,403,87,22,109,3.5495049504950495,29.54061484608214
Task_39800,1441,770,92,185,277,1.8690012970168612,32.696139248450656
Task_39801,1892,706,54,192,246,2.676096181046676,39.57361918862637
Task_39802,2413,542,79,73,152,4.443830570902394,46.31073787241497
Task_39803,2438,788,133,125,258,3.0899873257287704,48.36620912799547
Task_39804,2845,658,148,167,315,4.317147192716237,54.72170055637404
Task_39805,2500,154,77,104,181,16.129032258064516,46.65779163219123
Task_39806,1158,752,188,72,260,1.5378486055776892,27.66965958538296
Task_39807,1099,179,165,109,274,6.105555555555555,25.019005102542437
Task_39808,1433,311,115,61,176,4.592948717948718,30.12109616509875
Task_39809,1056,523,24,124,148,2.015267175572519,24.947615349694917
Task_39810,1588,233,84,142,226,6.786324786324786,33.00836189507481
Task_39811,1210,824,185,25,210,1.4666666666666666,28.116087678795065
Task_39812,2652,290,110,138,248,9.11340206185567,50.10842655334201
Task_39813,2697,199,76,38,114,13.485,48.924616448166965
Task_39814,1148,525,111,30,141,2.182509505703422,25.799840794102654
Task_39815,1166,108,142,105,247,10.697247706422019,25.53729267517647
Task_39816,857,604,15,199,214,1.4165289256198348,22.591883187916988
Task_39817,839,102,108,64,172,8.145631067961165,19.45779947263974
Task_39818,2786,214,113,98,211,12.95813953488372,51.721895943836614
Task_39819,1095,272,160,129,289,4.010989010989011,25.606664172077217
Task_39820,560,474,21,197,218,1.1789473684210525,17.474155968067127
Task_39821,1980,607,129,25,154,3.2565789473684212,39.24121679092365
Task_39822,2519,379,26,172,198,6.628947368421053,48.12164449510154
Task_39823,1322,74,192,48,240,17.626666666666665,26.90251342295259
Task_39824,1761,163,178,44,222,10.737804878048781,34.58228052610895
Task_39825,896,150,188,80,268,5.933774834437086,21.537983281781223
Task_39826,1027,998,150,193,343,1.028028028028028,27.084939011813915
Task_39827,1951,310,111,94,205,6.273311897106109,38.82990785522754
Task_39828,798,79,87,36,123,9.975,17.886264352691946
Task_39829,1735,353,78,93,171,4.901129943502825,35.40258517838557
Task_39830,1256,762,74,169,243,1.6461336828309305,29.60321470843839
Task_39831,2097,242,33,107,140,8.62962962962963,40.44377613477369
Task_39832,1743,974,60,146,206,1.7876923076923077,37.79991003937045
Task_39833,1592,559,93,24,117,2.842857142857143,32.66973320036296
Task_39834,2717,110,94,20,114,24.47747747747748,48.40370044673937
Task_39835,1057,749,158,192,350,1.4093333333333333,26.82522981795714
Task_39836,2241,569,181,70,251,3.931578947368421,44.16457105390639
Task_39837,2026,588,17,198,215,3.4397283531409166,41.08156789358282
Task_39838,1989,735,71,194,265,2.702445652173913,41.2795677052297
Task_39839,2452,471,102,65,167,5.194915254237288,46.805926207702385
Task_39840,1348,785,65,153,218,1.7150127226463103,31.005298251755335
Task_39841,2658,308,139,154,293,8.601941747572816,50.493286083332556
Task_39842,2638,912,119,179,298,2.8893756845564074,52.18271706191001
Task_39843,1129,779,48,35,83,1.4474358974358974,25.718469113951258
Task_39844,767,670,70,90,160,1.1430700447093889,20.877215028051058
Task_39845,2254,560,24,19,43,4.017825311942959,42.2158161921488
Task_39846,1509,764,186,132,318,1.9725490196078432,33.85416212053108
Task_39847,1357,897,76,27,103,1.5111358574610245,29.874419457361522
Task_39848,2022,348,181,124,305,5.793696275071634,40.581902670236474
Task_39849,1475,656,20,171,191,2.2450532724505328,32.44828241976653
Task_39850,2139,112,80,32,112,18.92920353982301,39.25577477034226
Task_39851,1091,498,178,23,201,2.186372745490982,25.16450316686372
Task_39852,958,252,85,16,101,3.7865612648221343,21.420849247073207
Task_39853,2689,983,90,49,139,2.7327235772357725,51.757893791217356
Task_39854,2242,563,88,116,204,3.975177304964539,44.2534137153035
Task_39855,875,233,44,105,149,3.7393162393162394,21.17976931020072
Task_39856,2154,462,134,176,310,4.652267818574514,43.14312136965585
Task_39857,996,721,197,27,224,1.3795013850415512,24.489908344325922
Task_39858,999,580,170,11,181,1.7194492254733218,23.805827654968837
Task_39859,2105,149,141,150,291,14.033333333333333,40.953097696917375
Task_39860,2086,102,34,161,195,20.25242718446602,39.7973804294908
Task_39861,1903,784,119,61,180,2.424203821656051,39.08949007036313
Task_39862,638,829,165,56,221,0.7686746987951807,19.432237348807284
Task_39863,763,313,79,120,199,2.429936305732484,20.132395887187634
Task_39864,1159,140,146,20,166,8.21985815602837,24.6200932652811
Task_39865,2285,464,71,148,219,4.913978494623656,44.83192983877226
Task_39866,2995,131,50,140,190,22.689393939393938,54.377924172460745
Task_39867,1346,675,25,43,68,1.9911242603550297,28.484106888217436
Task_39868,931,657,176,41,217,1.4148936170212767,23.26453068562348
Task_39869,2554,333,15,51,66,7.6467065868263475,46.683937080601446
Task_39870,545,364,182,90,272,1.4931506849315068,17.00054759692858
Task_39871,2058,305,66,44,110,6.7254901960784315,39.127604848622916
Task_39872,1646,179,68,58,126,9.144444444444444,32.50400023913008
Task_39873,1693,1012,170,51,221,1.6712734452122409,36.67531696120267
Task_39874,2656,872,153,92,245,3.042382588774341,51.92461661045806
Task_39875,1040,595,96,118,214,1.74496644295302,25.403366829750826
Task_39876,1416,695,150,63,213,2.0344827586206895,31.308874771296217
Task_39877,565,729,116,98,214,0.773972602739726,18.280284187690537
Task_39878,1475,232,66,46,112,6.330472103004292,29.721126983228526
Task_39879,2176,994,189,50,239,2.1869346733668342,44.23302985609271
Task_39880,2145,266,142,97,239,8.03370786516854,41.93691247844638
Task_39881,2660,915,15,32,47,2.903930131004367,49.924037274966814
Task_39882,722,424,193,181,374,1.6988235294117646,20.639621198233808
Task_39883,2751,598,148,74,222,4.592654424040067,52.30787613788714
Task_39884,1054,311,182,134,316,3.378205128205128,25.215215608056102
Task_39885,2681,598,172,60,232,4.475792988313857,51.07852652454443
Task_39886,1847,576,18,102,120,3.20103986135182,37.387396239190736
Task_39887,1514,978,198,166,364,1.5464759959141983,34.81277206908222
Task_39888,2899,1000,96,21,117,2.896103896103896,54.6763222675068
Task_39889,2147,961,69,199,268,2.231808731808732,44.52169496944572
Task_39890,762,465,139,24,163,1.6351931330472103,19.664380503964637
Task_39891,1918,515,82,70,152,3.7170542635658914,38.315888659834265
Task_39892,1713,500,26,149,175,3.4191616766467066,35.59937220483369
Task_39893,2401,367,189,95,284,6.524456521739131,46.51714091188469
Task_39894,2152,422,17,197,214,5.087470449172577,42.53783931565179
Task_39895,1562,386,146,101,247,4.036175710594315,33.134439735961834
Task_39896,2219,580,85,21,106,3.819277108433735,42.48099724520003
Task_39897,1697,320,172,125,297,5.286604361370716,35.31378283989803
Task_39898,2030,617,42,159,201,3.284789644012945,41.1748277172782
Task_39899,2660,482,173,117,290,5.507246376811594,51.04110221687571
Task_39900,2195,132,180,113,293,16.50375939849624,42.170898285339085
Task_39901,1785,102,91,33,124,17.33009708737864,33.849053574859404
Task_39902,578,757,137,106,243,0.762532981530343,18.706827070873956
Task_39903,2008,609,178,100,278,3.2918032786885245,41.04503082207224
Task_39904,932,628,56,107,163,1.4817170111287759,23.527426548652098
Task_39905,621,181,94,61,155,3.412087912087912,16.527573893869278
Task_39906,958,357,72,87,159,2.6759776536312847,22.959447699972202
Task_39907,2816,995,64,153,217,2.8273092369477912,54.92960994907266
Task_39908,2636,318,198,41,239,8.263322884012538,49.259704988495685
Task_39909,1656,182,143,134,277,9.049180327868852,34.023996640794536
Task_39910,1053,189,195,99,294,5.542105263157895,24.63957585995375
Task_39911,1853,978,142,85,227,1.8927477017364658,39.41429224422498
Task_39912,2347,685,91,38,129,3.4212827988338192,45.312361046419994
Task_39913,1321,435,29,73,102,3.029816513761468,28.268878691590526
Task_39914,1397,801,161,128,289,1.7418952618453865,32.044959469430495
Task_39915,1760,964,144,111,255,1.8238341968911918,38.138417033280305
Task_39916,725,142,163,183,346,5.06993006993007,19.449671773783653
Task_39917,2662,176,85,40,125,15.03954802259887,48.152030536742124
Task_39918,1243,186,185,96,281,6.647058823529412,27.642916583039305
Task_39919,2028,435,54,139,193,4.651376146788991,40.54984669486984
Task_39920,2836,952,153,181,334,2.9758656873032527,55.61038776544971
Task_39921,1733,429,193,50,243,4.030232558139535,35.45720819368071
Task_39922,1001,414,25,193,218,2.4120481927710844,24.33691473327635
Task_39923,942,259,56,173,229,3.623076923076923,23.009457551297434
Task_39924,2226,678,122,134,256,3.2783505154639174,44.66621698066928
Task_39925,2224,717,10,97,107,3.097493036211699,43.658896245785094
Task_39926,3000,484,189,144,333,6.185567010309279,56.66329893390563
Task_39927,2017,841,16,18,34,2.3954869358669835,39.24311394492492
Task_39928,2948,582,170,68,238,5.056603773584905,55.34170729591609
Task_39929,2405,502,64,44,108,4.78131212723658,45.13257940408383
Task_39930,1336,365,15,87,102,3.650273224043716,28.395673559976256
Task_39931,2216,852,147,47,194,2.5978898007034,44.152867663221315
Task_39932,828,227,117,30,147,3.6315789473684212,19.85734033768252
Task_39933,2371,1018,126,15,141,2.326790971540726,46.61711946802844
Task_39934,2728,978,136,127,263,2.7865168539325844,53.58099058599375
Task_39935,2986,977,130,15,145,3.053169734151329,56.32537684401158
Task_39936,1609,368,186,167,353,4.360433604336043,34.39402530427209
Task_39937,700,126,38,100,138,5.511811023622047,17.410011035854776
Task_39938,1657,816,143,25,168,2.0281517747858016,34.93748159685461
Task_39939,1396,857,192,17,209,1.627039627039627,31.099214981673697
Task_39940,2309,234,68,115,183,9.825531914893617,44.19276004271594
Task_39941,943,340,53,153,206,2.7653958944281527,23.157404324729555
Task_39942,1712,574,119,55,174,2.977391304347826,35.39071945646369
Task_39943,2406,287,174,13,187,8.354166666666666,45.165349424824534
Task_39944,875,835,79,67,146,1.0466507177033493,22.863228786620898
Task_39945,2133,242,144,177,321,8.777777777777779,42.119497089464886
Task_39946,1398,824,155,115,270,1.6945454545454546,32.02761176481575
Task_39947,2072,303,84,197,281,6.815789473684211,41.22927320666626
Task_39948,515,877,102,45,147,0.5865603644646925,17.289351229323
Task_39949,1174,84,43,193,236,13.811764705882354,25.586390556286972
Task_39950,1374,380,63,147,210,3.606299212598425,30.10834739085611
Task_39951,2691,471,168,169,337,5.701271186440678,51.78402241170276
Task_39952,1263,979,130,58,188,1.2887755102040817,29.589866184136724
Task_39953,1330,331,81,182,263,4.006024096385542,29.52975569207941
Task_39954,1330,179,147,26,173,7.388888888888889,27.594508124204154
Task_39955,2195,184,95,94,189,11.864864864864865,42.10408125508993
Task_39956,2664,614,180,130,310,4.331707317073171,51.638216877782156
Task_39957,2159,949,70,23,93,2.2726315789473683,42.666017192811914
Task_39958,985,597,105,173,278,1.6471571906354514,24.899988170685422
Task_39959,1333,227,153,156,309,5.8464912280701755,29.344430894197426
Task_39960,2641,207,169,26,195,12.697115384615385,48.69167527285532
Task_39961,2622,968,144,161,305,2.7058823529411766,52.1091892921339
Task_39962,935,414,117,61,178,2.253012048192771,22.584060607751923
Task_39963,895,257,189,121,310,3.4689922480620154,22.479432922914054
Task_39964,1441,716,177,50,227,2.0097629009762903,31.66762641269945
Task_39965,2701,411,85,11,96,6.555825242718447,49.50005136314613
Task_39966,2804,210,117,43,160,13.289099526066352,51.02502169105762
Task_39967,2550,909,94,152,246,2.802197802197802,50.51529184558371
Task_39968,682,882,106,39,145,0.7723669309173273,19.695019587915684
Task_39969,2765,779,93,149,242,3.5448717948717947,53.52002992432164
Task_39970,1947,446,173,115,288,4.355704697986577,39.6264145479512
Task_39971,560,853,57,116,173,0.6557377049180327,18.525257634587998
Task_39972,1443,579,79,141,220,2.4879310344827585,31.8616655117425
Task_39973,1026,161,120,182,302,6.333333333333333,24.08474150741753
Task_39974,2158,358,66,140,206,6.011142061281337,42.42124207248728
Task_39975,2922,587,143,159,302,4.969387755102041,55.64418995497753
Task_39976,1396,970,19,154,173,1.4376930998970134,31.989536273387657
Task_39977,790,174,120,197,317,4.514285714285714,20.461557257821855
Task_39978,606,413,198,172,370,1.463768115942029,18.697778222472394
Task_39979,1682,297,73,115,188,5.644295302013423,34.53996249443311
Task_39980,2419,687,107,167,274,3.515988372093023,47.881171283596096
Task_39981,2892,769,162,192,354,3.755844155844156,56.02988449732377
Task_39982,2487,733,200,139,339,3.388283378746594,49.35523457265631
Task_39983,1040,518,25,72,97,2.003853564547206,23.973689371604525
Task_39984,1215,973,25,186,211,1.2474332648870636,29.34960532756295
Task_39985,2478,491,149,144,293,5.036585365853658,48.24226736879609
Task_39986,1092,767,81,29,110,1.421875,25.310127613735734
Task_39987,2929,1024,28,112,140,2.857560975609756,56.123987696750355
Task_39988,1831,520,155,111,266,3.5143953934740884,37.922142018090426
Task_39989,561,88,106,51,157,6.303370786516854,14.661101553857577
Task_39990,2792,198,112,177,289,14.030150753768844,52.25111827584633
Task_39991,1175,611,123,96,219,1.9199346405228759,27.61561960297271
Task_39992,2654,377,13,72,85,7.021164021164021,48.946827988056306
Task_39993,1974,680,175,38,213,2.898678414096916,39.84874288873651
Task_39994,2641,81,127,124,251,32.207317073170735,48.53076162920062
Task_39995,1503,146,82,165,247,10.224489795918368,31.315315384761107
Task_39996,1732,378,15,173,188,4.569920844327177,35.60780818336739
Task_39997,2671,692,22,121,143,3.854256854256854,51.01864872469637
Task_39998,2564,834,83,53,136,3.0706586826347304,49.49604647319483
Task_39999,912,945,120,55,175,0.9640591966173362,23.951491676972736
Task_40000,532,149,145,67,212,3.546666666666667,15.359460987488298
Task_40001,512,135,68,33,101,3.764705882352941,13.76593646392949
Task_40002,2886,647,128,123,251,4.453703703703703,54.983142629088526
Task_40003,1229,795,180,183,363,1.5439698492462313,29.749530312300593
Task_40004,2462,384,10,110,120,6.394805194805195,46.49969086129292
Task_40005,2457,836,153,166,319,2.935483870967742,49.15268810132287
Task_40006,1626,679,182,90,272,2.3911764705882352,35.14147483926411
Task_40007,2834,930,115,64,179,3.0440386680988185,54.33572818911713
Task_40008,1269,643,179,136,315,1.970496894409938,29.667344027263038
Task_40009,2296,817,27,110,137,2.806845965770171,45.418510028785846
Task_40010,2340,664,151,17,168,3.518796992481203,45.23616208292527
Task_40011,904,433,178,146,324,2.0829493087557602,23.28504318897903
Task_40012,658,156,177,147,324,4.191082802547771,18.321505427019357
Task_40013,1881,1016,36,88,124,1.8495575221238938,39.43347243430003
Task_40014,2422,571,198,92,290,4.234265734265734,47.47107475563629
Task_40015,2663,516,74,17,91,5.150870406189555,49.21024955086714
Task_40016,2733,578,37,30,67,4.72020725388601,50.107519142412634
Task_40017,2475,159,156,156,312,15.46875,46.9355532579527
Task_40018,2625,958,103,137,240,2.7372262773722627,51.797388880119534
Task_40019,2911,147,183,103,286,19.66891891891892,53.5567616490383
Task_40020,1585,245,91,196,287,6.443089430894309,33.34663968853503
Task_40021,1628,873,55,103,158,1.862700228832952,35.19259684443821
Task_40022,2267,857,110,14,124,2.6421911421911424,44.27968430029566
Task_40023,1445,167,151,39,190,8.601190476190476,29.46250616694331
Task_40024,2169,553,185,185,370,3.9151624548736463,43.956149882947045
Task_40025,2284,129,29,177,206,17.56923076923077,43.226574499572415
Task_40026,841,200,186,116,302,4.1840796019900495,21.392898751378898
Task_40027,2060,529,61,93,154,3.8867924528301887,40.91546295842455
Task_40028,771,399,34,24,58,1.9275,18.462683316029928
Task_40029,1969,288,39,83,122,6.813148788927336,38.459439281579556
Task_40030,505,570,148,51,199,0.8844133099824869,16.43632799948686
Task_40031,1726,805,197,114,311,2.141439205955335,37.3618817391986
Task_40032,2191,964,94,150,244,2.270466321243523,44.986131374625955
Task_40033,1281,614,19,30,49,2.0829268292682928,27.17534978680691
Task_40034,2667,765,159,151,310,3.4817232375979112,52.194362135793675
Task_40035,2219,604,43,189,232,3.667768595041322,44.31057723537517
Task_40036,2478,71,198,188,386,34.416666666666664,46.646458673387706
Task_40037,2029,156,172,125,297,12.92356687898089,39.77793656512899
Task_40038,644,612,141,132,273,1.0505709624796085,19.417110513254112
Task_40039,2715,701,188,144,332,3.8675213675213675,52.841767422822294
Task_40040,2330,666,132,113,245,3.4932533733133435,46.19529494606312
Task_40041,1738,473,132,119,251,3.6666666666666665,36.24408256656307
Task_40042,1625,159,80,161,241,10.15625,33.27672049824371
Task_40043,664,685,198,151,349,0.967930029154519,20.356751627986867
Task_40044,2472,453,149,151,300,5.4449339207048455,48.065605752746045
Task_40045,2406,672,89,71,160,3.575037147102526,46.56928586278088
Task_40046,2398,340,190,74,264,7.032258064516129,46.0657420051856
Task_40047,1965,716,35,19,54,2.7405857740585775,38.25841645739869
Task_40048,1161,78,122,24,146,14.69620253164557,23.81257762714752
Task_40049,2648,697,184,47,231,3.793696275071633,50.67682713810661
Task_40050,2057,813,186,85,271,2.527027027027027,42.331175764426504
Task_40051,2712,1018,39,146,185,2.661432777232581,53.10500190327375
Task_40052,2616,484,59,90,149,5.393814432989691,49.61566657267212
Task_40053,1194,800,54,57,111,1.4906367041198503,27.19550765769723
Task_40054,1198,979,179,186,365,1.2224489795918367,29.820416534164337
Task_40055,1074,78,83,67,150,13.594936708860759,22.771209834211657
Task_40056,1496,706,23,64,87,2.1159830268741158,31.654707763059974
Task_40057,853,595,33,133,166,1.4312080536912752,22.179260277015022
Task_40058,775,280,120,195,315,2.7580071174377223,20.788841186476862
Task_40059,1586,1003,110,171,281,1.5796812749003983,35.664497666111764
Task_40060,2282,244,67,126,193,9.314285714285715,43.903577695220555
Task_40061,869,859,129,88,217,1.0104651162790699,23.3436941502187
Task_40062,2634,200,56,77,133,13.104477611940299,48.748480542397395
Task_40063,2858,523,40,77,117,5.4541984732824424,53.173732775154484
Task_40064,1131,404,15,186,201,2.7925925925925927,26.273401125467274
Task_40065,1831,1010,57,165,222,1.8110781404549952,39.40321829181597
Task_40066,2417,116,146,71,217,20.65811965811966,44.76681517089248
Task_40067,1044,378,46,96,142,2.7546174142480213,24.333161358619634
Task_40068,1579,897,57,131,188,1.7583518930957684,34.82907279731492
Task_40069,1057,91,60,89,149,11.48913043478261,22.9722633794225
Task_40070,1830,251,17,175,192,7.261904761904762,36.73848677189741
Task_40071,2544,589,150,124,274,4.311864406779661,49.4870609920946
Task_40072,1673,480,50,34,84,3.4781704781704783,33.374685879668654
Task_40073,2579,136,176,72,248,18.824817518248175,47.69206173961669
Task_40074,985,599,198,23,221,1.6416666666666666,23.89119812362236
Task_40075,766,458,12,22,34,1.6688453159041394,18.303143501779463
Task_40076,1388,592,62,125,187,2.3406408094435074,30.852906994543673
Task_40077,2183,291,82,70,152,7.476027397260274,41.77144285419969
Task_40078,2780,100,164,151,315,27.524752475247524,51.18512643755764
Task_40079,2972,566,79,48,127,5.241622574955908,54.76530445970164
Task_40080,2923,918,46,200,246,3.18063112078346,56.54763884846252
Task_40081,1634,247,36,195,231,6.588709677419355,33.88915693022252
Task_40082,2578,697,185,53,238,3.693409742120344,49.85004116120201
Task_40083,1983,345,30,95,125,5.73121387283237,38.95893458949072
Task_40084,2726,894,184,51,235,3.0458100558659216,52.73528616969236
Task_40085,2499,944,27,195,222,2.6444444444444444,49.75100040651716
Task_40086,2601,965,191,189,380,2.6925465838509317,52.14612989852932
Task_40087,1293,917,113,121,234,1.408496732026144,30.458631539600304
Task_40088,2839,387,196,52,248,7.31701030927835,53.01553248676174
Task_40089,1242,906,172,111,283,1.3693495038588754,29.829614973381904
Task_40090,1816,678,68,107,175,2.674521354933726,37.814708156765
Task_40091,871,918,80,39,119,0.9477693144722524,22.43727183962476
Task_40092,2921,529,200,37,237,5.511320754716981,54.47196661070274
Task_40093,989,534,135,37,172,1.8485981308411215,23.586511018844828
Task_40094,749,297,76,19,95,2.5134228187919465,18.229229666416767
Task_40095,2174,887,161,160,321,2.4481981981981984,44.828261484776085
Task_40096,545,382,75,61,136,1.422976501305483,16.09439338069613
Task_40097,1631,354,125,114,239,4.594366197183098,34.10476883875768
Task_40098,1963,843,80,100,180,2.325829383886256,40.65188323850304
Task_40099,2190,936,49,197,246,2.3372465314834576,45.046777306212554
Task_40100,1101,784,55,192,247,1.4025477707006369,27.240624314167906
Task_40101,1157,461,199,79,278,2.5043290043290045,26.970055966552376
Task_40102,668,797,119,120,239,0.8370927318295739,20.22915757397778
Task_40103,2500,677,155,122,277,3.687315634218289,49.080159800763475
Task_40104,2431,224,54,159,213,10.804444444444444,46.316209429414236
Task_40105,2421,886,194,137,331,2.729425028184893,48.75021801879643
Task_40106,1214,496,189,56,245,2.442655935613682,27.596804987378288
Task_40107,686,1005,68,157,225,0.6819085487077535,21.353872698803126
Task_40108,506,570,78,12,90,0.8861646234676007,15.396598074889488
Task_40109,684,610,171,82,253,1.1194762684124386,19.800558488781927
Task_40110,1374,307,140,19,159,4.461038961038961,28.70806782085621
Task_40111,2592,862,104,161,265,3.003476245654693,51.12234202805198
Task_40112,1296,992,21,184,205,1.3051359516616314,30.661393466733355
Task_40113,1172,100,57,87,144,11.603960396039604,24.759648525228243
Task_40114,2722,408,149,99,248,6.6552567237163816,51.55728489781734
Task_40115,2738,577,50,16,66,4.737024221453288,50.0080347451306
Task_40116,2610,456,123,140,263,5.711159737417943,50.07681667178415
Task_40117,1980,1003,126,41,167,1.9721115537848606,40.72277193751229
Task_40118,1495,958,126,147,273,1.5589155370177268,34.01167973222128
Task_40119,1419,360,33,48,81,3.930747922437673,29.066000423847527
Task_40120,1076,262,155,23,178,4.091254752851711,24.05624854091843
Task_40121,1550,916,195,38,233,1.6902944383860414,33.947232243612376
Task_40122,756,448,183,155,338,1.6837416481069043,21.05263555460477
Task_40123,768,1000,135,76,211,0.7672327672327672,22.13133208405091
Task_40124,556,172,88,50,138,3.213872832369942,15.044609094741412
Task_40125,1095,698,12,77,89,1.5665236051502145,25.308823216611987
Task_40126,732,730,102,174,276,1.0013679890560876,21.2333010775337
Task_40127,823,568,84,176,260,1.4463971880492092,22.135456644418287
Task_40128,2122,214,28,192,220,9.869767441860466,41.398497486192376
Task_40129,1125,638,39,136,175,1.7605633802816902,26.710701059920762
Task_40130,615,652,180,43,223,0.9418070444104135,18.381243020482746
Task_40131,2894,998,139,80,219,2.896896896896897,55.907351249649736
Task_40132,1921,277,194,161,355,6.910071942446043,39.02342162916204
Task_40133,2530,271,63,156,219,9.301470588235293,48.074578648250984
Task_40134,1285,487,109,131,240,2.6331967213114753,29.085587359288567
Task_40135,1233,670,12,13,25,1.8375558867362145,26.2562689087836
Task_40136,2058,235,139,55,194,8.720338983050848,39.85299315118288
Task_40137,1303,595,192,45,237,2.186241610738255,29.044382964891838
Task_40138,2169,337,90,75,165,6.4171597633136095,42.00889633632061
Task_40139,2845,949,127,16,143,2.9947368421052634,53.94407538593146
Task_40140,792,815,125,93,218,0.9705882352941176,22.09900161260694
Task_40141,2410,584,13,186,199,4.119658119658119,47.07800791817664
Task_40142,1705,307,89,37,126,5.535714285714286,33.836248296331945
Task_40143,1403,73,195,38,233,18.95945945945946,28.108615379322583
Task_40144,2205,178,167,183,350,12.318435754189943,42.90434719006654
Task_40145,1871,1021,25,126,151,1.8307240704500978,39.40573667656367
Task_40146,2150,287,30,53,83,7.465277777777778,40.532966876640174
Task_40147,2634,742,155,29,184,3.5450874831763124,50.3280250928442
Task_40148,1643,983,86,68,154,1.6697154471544715,35.35420904581652
Task_40149,2545,858,95,21,116,2.9627473806752036,48.648699742635436
Task_40150,687,77,132,36,168,8.807692307692308,16.65110846693877
Task_40151,2135,729,53,117,170,2.9246575342465753,42.996464607291365
Task_40152,2056,231,183,98,281,8.862068965517242,40.57434002821985
Task_40153,2700,186,74,198,272,14.438502673796792,50.7757383631346
Task_40154,2584,101,70,91,161,25.333333333333332,47.11699961161383
Task_40155,2966,1003,106,23,129,2.954183266932271,56.019590843460044
Task_40156,2557,813,139,138,277,3.1412776412776413,50.43464827180147
Task_40157,2863,615,109,50,159,4.6477272727272725,53.43387145377134
Task_40158,816,811,118,142,260,1.0049261083743843,22.695806218099133
Task_40159,1514,187,148,32,180,8.053191489361701,30.859525593554753
Task_40160,1834,658,126,103,229,2.7830045523520486,38.22716691931138
Task_40161,2538,481,57,102,159,5.265560165975104,48.36314433422814
Task_40162,2957,526,155,160,315,5.611005692599621,56.061741319833196
Task_40163,1425,835,116,119,235,1.7045454545454546,32.33769519929825
Task_40164,2732,661,142,140,282,4.126888217522659,52.753116670036015
Task_40165,2236,295,59,86,145,7.554054054054054,42.928828713922826
Task_40166,2238,400,174,29,203,5.581047381546135,43.06713087518358
Task_40167,1656,703,121,140,261,2.352272727272727,35.74723401495579
Task_40168,611,77,112,156,268,7.833333333333333,16.837971606591204
Task_40169,2476,714,39,88,127,3.462937062937063,47.98018210752235
Task_40170,1042,749,78,83,161,1.3893333333333333,25.46282569622593
Task_40171,896,834,80,98,178,1.0730538922155688,23.614074813751827
Task_40172,1838,88,143,168,311,20.651685393258425,36.3372866174333
Task_40173,2664,924,96,174,270,2.88,52.50636829766103
Task_40174,1289,666,154,154,308,1.9325337331334334,30.050768861724176
Task_40175,1942,975,113,25,138,1.9897540983606556,39.70013669904816
Task_40176,2492,592,47,47,94,4.202360876897133,46.813956698589585
Task_40177,1503,646,43,18,61,2.3230293663060277,30.717662533122212
Task_40178,2434,721,147,111,258,3.371191135734072,48.07175399001301
Task_40179,749,457,171,27,198,1.6353711790393013,19.63382962847662
Task_40180,1156,1015,123,99,222,1.1377952755905512,28.48387687351278
Task_40181,1855,800,192,125,317,2.3158551810237205,39.433223380144774
Task_40182,1555,516,66,106,172,3.007736943907157,33.15406789467685
Task_40183,1268,352,144,64,208,3.592067988668555,27.866288795755064
Task_40184,864,797,58,192,250,1.0827067669172932,23.482253394027794
Task_40185,1711,502,196,94,290,3.4015904572564613,36.041640378834636
Task_40186,1262,472,63,19,82,2.668076109936575,26.69741224396948
Task_40187,775,745,103,22,125,1.0388739946380696,20.46449558264737
Task_40188,1567,551,44,59,103,2.838768115942029,32.31549944381895
Task_40189,1675,323,28,179,207,5.169753086419753,34.639411621902525
Task_40190,2376,343,165,129,294,6.906976744186046,46.122170546244604
Task_40191,1797,992,137,48,185,1.809667673716012,37.90425897442238
Task_40192,717,860,114,70,184,0.8327526132404182,20.625695228748828
Task_40193,630,745,193,138,331,0.8445040214477212,19.907369308689336
Task_40194,2119,717,14,52,66,2.9512534818941503,41.06995686547503
Task_40195,2874,987,160,136,296,2.908906882591093,56.084633553021796
Task_40196,820,693,196,90,286,1.181556195965418,22.422860500999395
Task_40197,2487,146,187,61,248,16.918367346938776,46.27372529685548
Task_40198,2291,652,10,52,62,3.5084226646248085,43.55358426430254
Task_40199,1712,557,169,164,333,3.068100358422939,36.53495595814253
Task_40200,1527,337,130,105,235,4.517751479289941,32.372743062707094
Task_40201,682,683,55,24,79,0.9970760233918129,18.12778277199099
Task_40202,644,567,14,156,170,1.1338028169014085,18.771094161538716
Task_40203,503,900,120,12,132,0.55826859045505,16.958853828951735
Task_40204,2655,707,188,187,375,3.75,52.16714151046157
Task_40205,846,848,18,17,35,0.9964664310954063,20.86558459256285
Task_40206,2426,864,165,58,223,2.8046242774566474,47.84540664994366
Task_40207,1972,410,71,119,190,4.798053527980535,39.526332891159385
Task_40208,703,647,199,48,247,1.0848765432098766,19.796255147806097
Task_40209,771,970,21,77,98,0.7940267765190525,21.198116718666366
Task_40210,2835,953,143,128,271,2.9716981132075473,55.236028221420156
Task_40211,877,954,134,10,144,0.9183246073298429,22.927591231843184
Task_40212,2718,401,47,173,220,6.7611940298507465,51.49903353694153
Task_40213,611,955,172,105,277,0.6391213389121339,20.08430372837059
Task_40214,2324,800,36,17,53,2.9013732833957553,44.21025005756727
Task_40215,2081,301,50,179,229,6.8907284768211925,41.19225095541442
Task_40216,2612,599,125,113,238,4.3533333333333335,50.41745164891258
Task_40217,2494,920,137,185,322,2.7079261672095547,50.04290315173497
Task_40218,523,406,46,91,137,1.285012285012285,16.03326522877271
Task_40219,2408,487,155,35,190,4.934426229508197,45.98616940897109
Task_40220,1289,442,27,194,221,2.909706546275395,29.00302894018942
Task_40221,2395,322,96,133,229,7.414860681114551,46.07158066697213
Task_40222,706,732,156,32,188,0.9631650750341064,19.86728192657105
Task_40223,2350,67,25,69,94,34.55882352941177,42.07497017258531
Task_40224,651,149,119,53,172,4.34,16.99139339414666
Task_40225,997,914,22,48,70,1.0896174863387977,23.82570619486461
Task_40226,561,938,180,15,195,0.597444089456869,18.424934634130057
Task_40227,2423,313,155,194,349,7.7165605095541405,47.105883371774475
Task_40228,2854,480,34,18,52,5.9334719334719335,51.569234329926154
Task_40229,1416,850,33,151,184,1.663924794359577,32.030910124314666
Task_40230,1202,214,151,124,275,5.590697674418605,27.030305425545254
Task_40231,2668,680,104,133,237,3.9177679882525696,51.58654569351328
Task_40232,2408,102,152,17,169,23.37864077669903,43.82178575261444
Task_40233,2941,504,179,134,313,5.823762376237624,55.6898001726453
Task_40234,2685,499,87,138,225,5.37,51.19020864581869
Task_40235,2622,285,158,76,234,9.167832167832168,49.290681682138576
Task_40236,2461,834,39,31,70,2.947305389221557,46.62072466474333
Task_40237,1230,393,111,35,146,3.1218274111675126,26.779012102832
Task_40238,2978,929,73,75,148,3.2021505376344086,56.62453528911402
Task_40239,2775,512,143,34,177,5.409356725146199,51.808582171136635
Task_40240,2871,268,174,79,253,10.672862453531598,53.32400240989491
Task_40241,1605,664,10,119,129,2.4135338345864663,34.033167021669776
Task_40242,1081,133,146,180,326,8.067164179104477,24.885924813306342
Task_40243,2290,876,40,155,195,2.6111744583808436,46.06660400971871
Task_40244,1412,973,156,67,223,1.4496919917864477,32.14430263800617
Task_40245,834,758,84,113,197,1.098814229249012,22.46881847474089
Task_40246,1346,253,82,10,92,5.299212598425197,27.49521308303643
Task_40247,1543,780,133,182,315,1.9756722151088348,34.5024278656491
Task_40248,711,825,177,20,197,0.860774818401937,20.204091428058632
Task_40249,1623,829,54,179,233,1.955421686746988,35.61850990536716
Task_40250,2128,483,174,117,291,4.396694214876033,42.62717500676239
Task_40251,1758,785,91,173,264,2.236641221374046,37.68048382380572
Task_40252,2267,693,51,11,62,3.26657060518732,42.902656036141515
Task_40253,2646,199,33,161,194,13.23,49.47476312575842
Task_40254,804,482,159,23,182,1.6645962732919255,20.465090819303292
Task_40255,2755,541,160,19,179,5.083025830258302,51.51041956293
Task_40256,2638,110,88,195,283,23.765765765765767,48.95380026177933
Task_40257,845,227,58,47,105,3.706140350877193,19.560121697396756
Task_40258,854,241,116,73,189,3.5289256198347108,20.92835238306647
Task_40259,1135,475,170,45,215,2.384453781512605,25.908108976684527
Task_40260,662,186,78,134,212,3.5401069518716577,18.25569995709779
Task_40261,1369,643,189,140,329,2.125776397515528,31.32013897771807
Task_40262,2995,591,162,126,288,5.059121621621622,56.701587662303346
Task_40263,2393,867,87,165,252,2.756912442396313,47.89245060732983
Task_40264,800,95,16,153,169,8.333333333333334,19.22236214008296
Task_40265,1823,912,175,149,324,1.9967141292442496,39.341818976194425
Task_40266,1063,285,47,121,168,3.7167832167832167,24.578559844932204
Task_40267,1781,940,143,174,317,1.8926673751328373,38.768430841579246
Task_40268,1445,930,141,99,240,1.552094522019334,32.907470809566526
Task_40269,1239,424,62,143,205,2.915294117647059,28.08467284440417
Task_40270,2142,200,185,62,247,10.656716417910447,41.281512123106445
Task_40271,2429,440,139,140,279,5.507936507936508,47.23176067726509
Task_40272,790,130,171,105,276,6.030534351145038,19.95410133433951
Task_40273,2932,541,55,146,201,5.409594095940959,55.249741607362154
Task_40274,1657,563,108,200,308,2.9379432624113475,35.62310102749608
Task_40275,528,294,188,35,223,1.7898305084745763,15.771858797358087
Task_40276,1630,926,98,176,274,1.7583603020496223,36.13215293105031
Task_40277,1636,304,164,113,277,5.363934426229508,34.18799715100882
Task_40278,2896,539,37,102,139,5.362962962962963,54.09148877762177
Task_40279,1112,966,75,100,175,1.1499482936918304,27.458942243325765
Task_40280,2668,288,69,37,106,9.231833910034602,48.7114793828542
Task_40281,1615,217,130,28,158,7.408256880733945,32.26983252695351
Task_40282,1673,865,102,88,190,1.9318706697459584,36.06140283038139
Task_40283,1681,957,91,78,169,1.754697286012526,36.259929948372495
Task_40284,2666,167,32,14,46,15.869047619047619,47.36470506197775
Task_40285,1097,404,123,49,172,2.708641975308642,24.980542558483602
Task_40286,645,308,105,11,116,2.087378640776699,16.779816983540737
Task_40287,2278,118,28,97,125,19.142857142857142,42.079221769093664
Task_40288,2587,614,136,184,320,4.20650406504065,50.54298386676076
Task_40289,2269,258,46,81,127,8.76061776061776,43.188927481027044
Task_40290,1464,263,73,44,117,5.545454545454546,29.652286397457832
Task_40291,1728,939,176,114,290,1.8382978723404255,37.71583978910982
Task_40292,2014,975,60,171,231,2.0635245901639343,42.246778038904395
Task_40293,2179,906,167,102,269,2.402425578831312,44.647339670256144
Task_40294,1753,835,182,140,322,2.09688995215311,37.97083209717962
Task_40295,1134,434,84,153,237,2.606896551724138,26.556331264325383
Task_40296,2483,952,28,192,220,2.6054564533053517,49.509001536923044
Task_40297,1239,556,75,35,110,2.2244165170556554,27.002454499984395
Task_40298,2628,280,50,103,153,9.352313167259787,49.08911032969639
Task_40299,1860,165,95,28,123,11.204819277108435,35.52301680621442
Task_40300,1566,633,160,151,311,2.470031545741325,34.3439283247946
Task_40301,2229,614,140,188,328,3.624390243902439,44.915196635555304
Task_40302,1244,514,92,119,211,2.4155339805825244,28.38104152922053
Task_40303,1586,451,67,148,215,3.5088495575221237,33.72251216447673
Task_40304,2807,364,153,165,318,7.69041095890411,53.17221663049596
Task_40305,1459,1000,76,135,211,1.4575424575424576,33.33450009581774
Task_40306,1581,634,11,136,147,2.489763779527559,33.604497433544964
Task_40307,693,769,188,194,382,0.9,21.3020659554978
Task_40308,2846,468,83,17,100,6.068230277185501,51.975096057706104
Task_40309,2515,570,86,27,113,4.404553415061296,47.31251581087063
Task_40310,2930,136,20,132,152,21.386861313868614,52.66379608322027
Task_40311,2523,737,105,184,289,3.4186991869918697,49.77872932462761
Task_40312,843,213,33,29,62,3.939252336448598,19.02636055959223
Task_40313,1717,230,123,17,140,7.432900432900433,33.7386598421804
Task_40314,1846,1015,88,87,175,1.8169291338582678,39.15027652491053
Task_40315,2284,852,174,124,298,2.6776084407971865,46.30547942511529
Task_40316,1549,535,59,141,200,2.889925373134328,33.321239235119926
Task_40317,742,175,58,148,206,4.215909090909091,19.171525829983306
Task_40318,1971,558,130,148,278,3.525939177101968,40.367937903878676
Task_40319,653,647,112,38,150,1.007716049382716,18.40116581033457
Task_40320,2099,977,77,134,211,2.1462167689161555,43.45314970460578
Task_40321,539,274,24,125,149,1.96,16.00041209121286
Task_40322,2529,81,10,91,101,30.841463414634145,45.437380771700624
Task_40323,1868,373,86,117,203,4.994652406417113,37.71878940932527
Task_40324,1403,834,47,116,163,1.6802395209580838,31.63792758023618
Task_40325,1950,93,93,189,282,20.74468085106383,38.02492012483129
Task_40326,2389,680,94,66,160,3.5080763582966226,46.30048507908773
Task_40327,2307,784,161,154,315,2.9388535031847134,46.577677615550535
Task_40328,2234,162,106,159,265,13.705521472392638,42.93456627647424
Task_40329,2219,392,47,191,238,5.646310432569974,43.68089798190209
Task_40330,2987,853,187,57,244,3.497658079625293,56.79313306455631
Task_40331,1881,551,124,167,291,3.407608695652174,39.00706736245436
Task_40332,2320,517,162,200,362,4.478764478764479,46.21777117574575
Task_40333,2778,533,63,168,231,5.202247191011236,52.95052578911079
Task_40334,2018,632,72,94,166,3.1879936808846763,40.80496560203042
Task_40335,1759,360,42,71,113,4.872576177285318,35.21740696926067
Task_40336,2090,165,66,163,229,12.590361445783133,40.59851674266081
Task_40337,2467,969,37,92,129,2.543298969072165,48.71018318808351
Task_40338,1180,202,139,30,169,5.812807881773399,25.47751119967835
Task_40339,705,185,121,150,271,3.7903225806451615,19.03782068050295
Task_40340,2888,461,170,156,326,6.251082251082251,54.800943273791766
Task_40341,1627,544,18,65,83,2.985321100917431,33.19053638150496
Task_40342,2390,900,61,173,234,2.6526082130965594,47.98544783849264
Task_40343,1062,896,144,148,292,1.1839464882943145,27.02846832383349
Task_40344,761,222,102,86,188,3.412556053811659,19.558361422460997
Task_40345,1185,128,104,194,298,9.186046511627907,26.397341468763443
Task_40346,726,592,152,110,262,1.224283305227656,20.567330236984017
Task_40347,1694,279,147,172,319,6.05,35.29613512074174
Task_40348,2172,437,123,95,218,4.958904109589041,42.82702892746099
Task_40349,2183,223,43,183,226,9.745535714285714,42.43624773569473
Task_40350,1071,612,119,156,275,1.7471451876019577,26.27030234843981
Task_40351,1369,713,50,91,141,1.9173669467787116,30.543733980356212
Task_40352,1738,218,12,24,36,7.936073059360731,32.89477629739847
Task_40353,2378,776,122,130,252,3.0604890604890604,47.358289118357625
Task_40354,1640,259,178,92,270,6.3076923076923075,33.98406506243146
Task_40355,2436,874,115,23,138,2.784,47.20787188330803
Task_40356,824,913,60,54,114,0.9015317286652079,21.80324856500991
Task_40357,2835,840,21,171,192,3.370986920332937,54.570901582237894
Task_40358,1433,530,90,200,290,2.6986817325800376,31.885333967081646
Task_40359,763,998,198,50,248,0.7637637637637638,21.97465651773777
Task_40360,2125,967,62,75,137,2.1952479338842976,43.15397839860589
Task_40361,1190,490,91,68,159,2.423625254582485,26.706369064568573
Task_40362,2262,505,117,103,220,4.470355731225297,44.47876194922306
Task_40363,1778,486,169,76,245,3.650924024640657,36.65710300241923
Task_40364,1529,248,149,178,327,6.140562248995984,32.62686531614323
Task_40365,1955,876,12,106,118,2.2291904218928162,40.02615467435712
Task_40366,2374,666,143,192,335,3.5592203898050974,47.413660289111625
Task_40367,1102,782,48,55,103,1.4074074074074074,25.60602192027967
Task_40368,2425,555,122,105,227,4.361510791366906,47.25436048542483
Task_40369,569,964,198,23,221,0.5896373056994819,18.75078917192823
Task_40370,2383,91,35,186,221,25.902173913043477,44.525034866016064
Task_40371,2100,826,191,36,227,2.539298669891173,42.34659866941478
Task_40372,1240,918,39,77,116,1.3492927094668117,28.738463664149503
Task_40373,1569,922,86,188,274,1.6998916576381364,35.126762323198584
Task_40374,2964,726,168,76,244,4.0770288858321875,56.19723907610162
Task_40375,1353,723,118,21,139,1.8687845303867403,29.57943631809452
Task_40376,1861,342,12,47,59,5.425655976676385,35.59010217609673
Task_40377,2565,405,94,16,110,6.317733990147783,47.50000439025655
Task_40378,2563,713,60,183,243,3.589635854341737,50.197324108614204
Task_40379,1849,989,51,171,222,1.8676767676767676,39.66379506156211
Task_40380,2745,434,146,191,337,6.310344827586207,52.549481249934765
Task_40381,1907,661,81,90,171,2.880664652567976,39.085182516995154
Task_40382,2055,839,29,95,124,2.4464285714285716,41.62566543021068
Task_40383,2440,615,24,67,91,3.961038961038961,46.39740643701191
Task_40384,1820,666,94,182,276,2.7286356821589206,38.36848490084415
Task_40385,1745,201,157,81,238,8.638613861386139,35.221896084539765
Task_40386,2129,212,123,198,321,9.995305164319248,41.97539743271229
Task_40387,817,135,110,186,296,6.007352941176471,20.614142556942287
Task_40388,561,216,170,101,271,2.585253456221198,16.863994711147836
Task_40389,1826,158,17,73,90,11.484276729559749,34.87194739608997
Task_40390,2811,910,37,109,146,3.0856201975850714,53.98138813670585
Task_40391,1088,349,39,39,78,3.1085714285714285,23.44727632264531
Task_40392,2300,231,155,143,298,9.913793103448276,44.563361151744175
Task_40393,760,631,102,191,293,1.2025316455696202,21.490169318547192
Task_40394,886,925,107,26,133,0.9568034557235421,22.98064018866018
Task_40395,686,844,39,175,214,0.8118343195266272,20.580319512788265
Task_40396,1124,826,70,60,130,1.3591293833131801,26.64974283756352
Task_40397,2613,812,97,120,217,3.2140221402214024,51.02962628163667
Task_40398,2193,562,48,117,165,3.895204262877442,43.37136601081537
Task_40399,2688,579,59,172,231,4.63448275862069,51.68195059184685
Task_40400,1478,686,81,102,183,2.151382823871907,32.48279858102283
Task_40401,510,427,153,91,244,1.191588785046729,16.474884702016457
Task_40402,1991,320,147,72,219,6.202492211838006,39.313203629329216
Task_40403,811,574,90,33,123,1.4104347826086956,20.463933443076918
Task_40404,2304,292,186,104,290,7.863481228668942,44.75346836371413
Task_40405,2668,863,54,122,176,3.087962962962963,51.915588370055396
Task_40406,2885,585,188,23,211,4.92320819112628,53.8918597840867
Task_40407,630,661,168,110,278,0.9516616314199395,19.377444098082954
Task_40408,806,943,17,28,45,0.8538135593220338,20.771343370775266
Task_40409,2471,868,97,45,142,2.8434982738780206,47.81998989043339
Task_40410,1041,843,99,40,139,1.2334123222748816,25.051257595306677
Task_40411,1776,125,168,135,303,14.095238095238095,35.593288566986395
Task_40412,2232,591,26,132,158,3.77027027027027,43.84018229485168
Task_40413,571,266,152,141,293,2.1385767790262173,17.3412182405169
Task_40414,2646,130,190,153,343,20.198473282442748,49.54467535591726
Task_40415,2191,293,163,86,249,7.4523809523809526,42.693021420674484
Task_40416,693,530,51,192,243,1.305084745762712,19.98018279588526
Task_40417,616,537,184,158,342,1.1449814126394051,19.081114761254565
Task_40418,1344,705,137,128,265,1.9036827195467423,30.811700259988154
Task_40419,1686,263,57,91,148,6.386363636363637,34.12473333592458
Task_40420,2461,189,182,179,361,12.952631578947368,47.28289836963969
Task_40421,1524,116,24,97,121,13.025641025641026,30.104462518248734
Task_40422,1125,419,179,43,222,2.6785714285714284,25.61591593274822
Task_40423,872,824,14,175,189,1.056969696969697,23.30655535347319
Task_40424,1752,810,14,190,204,2.160295930949445,37.402148722782854
Task_40425,500,267,95,193,288,1.8656716417910448,16.286324197143077
Task_40426,2883,246,126,124,250,11.672064777327936,53.58561441949331
Task_40427,2720,992,19,83,102,2.7391742195367574,52.29243141898234
Task_40428,2919,871,161,27,188,3.3474770642201834,55.24727863052431
Task_40429,2159,452,122,103,225,4.766004415011038,42.6997789053481
Task_40430,1608,939,86,129,215,1.7106382978723405,35.44511866401199
Task_40431,2790,185,168,126,294,15.0,52.00369046048902
Task_40432,1599,437,63,164,227,3.6506849315068495,33.95361243892575
Task_40433,2945,464,77,177,254,6.333333333333333,55.48627092179611
Task_40434,2468,567,176,141,317,4.345070422535211,48.43203208944477
Task_40435,2945,238,111,112,223,12.322175732217573,54.39498554129068
Task_40436,1190,638,120,188,308,1.862284820031299,28.445188855323384
Task_40437,1249,669,143,136,279,1.864179104477612,29.269469376536378
Task_40438,2700,239,149,130,279,11.25,50.80734460303245
Task_40439,2034,403,26,45,71,5.034653465346534,38.48979931120508
Task_40440,2244,528,125,66,191,4.241965973534971,43.802972748391234
Task_40441,2376,869,185,44,229,2.731034482758621,46.86896252012057
Task_40442,2584,758,36,114,150,3.404479578392622,49.89839402596484
Task_40443,872,266,161,106,267,3.2659176029962547,21.929673036877443
Task_40444,1121,250,158,70,228,4.46613545816733,25.305123920605936
Task_40445,1287,122,108,123,231,10.463414634146341,27.54908347269452
Task_40446,2451,312,148,72,220,7.830670926517572,46.56434753038646
Task_40447,2541,140,29,73,102,18.02127659574468,46.01487214209599
Task_40448,520,663,38,39,77,0.7831325301204819,15.499171943006692
Task_40449,2265,72,15,52,67,31.027397260273972,40.39719110290418
Task_40450,1428,204,37,200,237,6.965853658536585,30.52690102696164
Task_40451,2774,372,18,61,79,7.436997319034853,50.46898410297333
Task_40452,716,907,113,79,192,0.788546255506608,20.985440101714442
Task_40453,927,65,28,50,78,14.045454545454545,19.36843482226344
Task_40454,2440,95,49,185,234,25.416666666666668,45.51594168306023
Task_40455,1490,251,22,134,156,5.912698412698413,30.980603330736177
Task_40456,1605,591,140,78,218,2.7111486486486487,34.18049654130143
Task_40457,2724,187,95,144,239,14.48936170212766,50.85580854214815
Task_40458,1639,188,87,175,262,8.671957671957673,33.856723518443864
Task_40459,2752,186,169,24,193,14.716577540106952,50.386863743642095
Task_40460,1895,787,38,32,70,2.4048223350253806,37.50705126730967
Task_40461,845,323,171,199,370,2.6080246913580245,22.287592553724682
Task_40462,1776,943,61,79,140,1.88135593220339,37.648264868786434
Task_40463,1670,118,106,60,166,14.033613445378151,32.7581033182546
Task_40464,582,561,47,68,115,1.0355871886120998,17.12427655080082
Task_40465,2712,383,43,153,196,7.0625,51.182777894529046
Task_40466,2714,526,78,66,144,5.149905123339659,51.01112248442592
Task_40467,559,309,153,150,303,1.803225806451613,17.346652317041276
Task_40468,2003,554,96,129,225,3.609009009009009,40.60290407856879
Task_40469,2931,140,183,35,218,20.78723404255319,52.86091183200636
Task_40470,1053,411,119,124,243,2.5558252427184467,25.176169335042754
Task_40471,2873,129,97,140,237,22.1,52.63319746568329
Task_40472,2096,315,135,144,279,6.632911392405063,41.55317968115827
Task_40473,1882,277,193,192,385,6.76978417266187,38.58763713271962
Task_40474,2123,205,62,190,252,10.305825242718447,41.59821234170397
Task_40475,2185,955,137,94,231,2.2855648535564854,44.705420189629855
Task_40476,2208,414,32,168,200,5.320481927710843,43.33153350181734
Task_40477,2887,217,65,149,214,13.243119266055047,53.479288017113504
Task_40478,1250,472,151,182,333,2.6427061310782243,28.97802713098832
Task_40479,2288,964,118,97,215,2.370984455958549,46.33292893717543
Task_40480,552,327,72,135,207,1.6829268292682926,16.884714860292235
Task_40481,2044,888,10,184,194,2.2992125984251968,42.194615564834145
Task_40482,2612,149,15,136,151,17.413333333333334,47.827668532992895
Task_40483,666,596,76,89,165,1.1155778894472361,19.184960585242454
Task_40484,2659,739,127,168,295,3.593243243243243,51.94305712935678
Task_40485,1215,220,95,88,183,5.497737556561086,26.701723083231993
Task_40486,2560,464,60,177,237,5.505376344086022,49.31795258656473
Task_40487,1390,956,166,172,338,1.452455590386625,32.66010403406936
Task_40488,899,591,137,110,247,1.5185810810810811,23.25799644285598
Task_40489,769,129,176,59,235,5.915384615384616,19.02415205560626
Task_40490,697,913,82,160,242,0.762582056892779,21.151532029154613
Task_40491,2201,631,63,189,252,3.482594936708861,44.25160608272548
Task_40492,1984,331,172,156,328,5.975903614457831,40.074537465930256
Task_40493,2546,849,197,101,298,2.9952941176470587,50.413581981537014
Task_40494,668,416,113,187,300,1.6019184652278178,19.435226210796735
Task_40495,1850,570,10,34,44,3.2399299474605954,35.98215475674105
Task_40496,2459,269,111,73,184,9.107407407407408,46.33351833052017
Task_40497,2123,218,62,185,247,9.69406392694064,41.61796006327109
Task_40498,1351,749,97,191,288,1.8013333333333332,31.263378020754406
Task_40499,2458,383,115,36,151,6.401041666666667,46.139231647413546
Task_40500,1110,395,120,104,224,2.803030303030303,25.912296049536565
Task_40501,888,458,153,92,245,1.934640522875817,22.62344665178824
Task_40502,2981,318,173,102,275,9.344827586206897,55.47866553816948
Task_40503,2926,99,159,110,269,29.26,53.20326814488042
Task_40504,842,640,56,172,228,1.313572542901716,22.570680528765497
Task_40505,2008,287,164,86,250,6.972222222222222,39.78374844329901
Task_40506,1376,439,137,161,298,3.1272727272727274,30.67908664786434
Task_40507,691,146,15,18,33,4.700680272108843,15.962597007883062
Task_40508,1384,263,157,44,201,5.242424242424242,29.103641145688787
Task_40509,726,999,173,19,192,0.726,21.091122231782794
Task_40510,2274,363,161,31,192,6.247252747252747,43.47101381909639
Task_40511,2875,634,185,58,243,4.52755905511811,54.323456210360746
Task_40512,2923,866,120,154,274,3.3713956170703576,56.40973097622962
Task_40513,666,214,23,198,221,3.097674418604651,18.419660080702844
Task_40514,1479,505,113,181,294,2.9229249011857705,32.53043787119073
Task_40515,1576,609,81,76,157,2.583606557377049,33.38013734990334
Task_40516,2016,981,185,115,300,2.0529531568228108,42.45664332866182
Task_40517,1513,450,50,109,159,3.354767184035477,32.08108988805751
Task_40518,2805,883,151,174,325,3.173076923076923,54.85250702400767
Task_40519,1870,542,44,51,95,3.443830570902394,37.01753390648655
Task_40520,2373,571,104,38,142,4.148601398601398,45.35940137204238
Task_40521,2284,816,182,59,241,2.795593635250918,45.51759052467682
Task_40522,2029,641,140,97,237,3.160436137071651,41.317831812347514
Task_40523,2305,976,101,41,142,2.3592630501535314,45.5278572185831
Task_40524,1850,533,196,90,286,3.4644194756554305,38.291923749969364
Task_40525,535,972,68,32,100,0.5498458376156218,17.251588498897135
Task_40526,1343,686,86,60,146,1.9548762736535663,29.71069156470301
Task_40527,1399,132,74,24,98,10.518796992481203,27.735465156356582
Task_40528,776,682,135,63,198,1.136163982430454,21.051105839181265
Task_40529,1738,581,72,104,176,2.986254295532646,36.260535044078104
Task_40530,2504,546,149,65,214,4.577696526508227,48.09747965792809
Task_40531,2456,186,167,120,287,13.133689839572192,46.80356329934043
Task_40532,2932,176,35,187,222,16.56497175141243,53.752723244302665
Task_40533,1658,407,162,56,218,4.063725490196078,34.21894848795743
Task_40534,667,962,137,115,252,0.6926272066458983,20.885449443472478
Task_40535,2707,655,161,188,349,4.126524390243903,52.710437086147884
Task_40536,1795,786,144,56,200,2.280813214739517,37.50468153040041
Task_40537,970,927,125,125,250,1.0452586206896552,25.44329562961967
Task_40538,2140,205,192,88,280,10.388349514563107,41.71700683682037
Task_40539,1591,95,113,65,178,16.572916666666668,31.183445058297867
Task_40540,903,503,41,145,186,1.7916666666666667,22.845005995026444
Task_40541,2455,508,178,163,341,4.823182711198428,48.17725717726251
Task_40542,2986,281,51,78,129,10.588652482269504,54.74116828631472
Task_40543,1693,765,14,200,214,2.210182767624021,36.38679485841222
Task_40544,913,400,173,57,230,2.2768079800498753,22.45669478008122
Task_40545,2488,107,85,48,133,23.037037037037038,44.867105107564704
Task_40546,1763,178,149,97,246,9.849162011173185,35.33765169949978
Task_40547,2118,755,92,112,204,2.8015873015873014,42.938394981650994
Task_40548,2219,72,137,172,309,30.397260273972602,42.22028025844645
Task_40549,2203,177,109,113,222,12.376404494382022,42.189116089093005
Task_40550,804,807,183,157,340,0.995049504950495,22.927667251355928
Task_40551,2856,603,171,118,289,4.728476821192053,54.53155324873834
Task_40552,737,399,50,55,105,1.8425,18.70910419778247
Task_40553,2496,446,55,146,201,5.583892617449664,48.03866245401331
Task_40554,1817,490,14,44,58,3.70061099796334,35.36069647808836
Task_40555,2409,383,102,39,141,6.2734375,45.30378093857038
Task_40556,668,305,97,167,264,2.183006535947712,18.914251656305026
Task_40557,775,890,23,31,54,0.8698092031425365,20.234952364472353
Task_40558,2736,170,153,105,258,16.0,50.76355628704972
Task_40559,2216,402,164,32,196,5.4987593052109185,42.70219379438132
Task_40560,1880,815,28,50,78,2.303921568627451,37.5934545874565
Task_40561,1149,745,154,163,317,1.5402144772117963,28.090152946105608
Task_40562,1577,267,105,106,211,5.884328358208955,32.82238148428478
Task_40563,2673,924,199,92,291,2.8897297297297295,52.563934797016834
Task_40564,719,147,152,157,309,4.858108108108108,19.20157551742582
Task_40565,898,814,16,47,63,1.101840490797546,21.921343290045076
Task_40566,1750,902,110,105,215,1.937984496124031,37.598237133545474
Task_40567,1754,583,139,114,253,3.0034246575342465,36.8483116945674
Task_40568,1886,939,94,17,111,2.0063829787234044,38.46083444159177
Task_40569,2459,905,90,156,246,2.7141280353200883,49.050772220936146
Task_40570,2058,787,108,148,256,2.6116751269035534,42.36751256660887
Task_40571,1071,158,59,43,102,6.735849056603773,22.513693048479098
Task_40572,2680,256,142,79,221,10.428015564202335,50.116936571608335
Task_40573,1287,742,191,115,306,1.7321668909825034,30.176320565949993
Task_40574,862,514,35,72,107,1.6737864077669904,21.362158030010097
Task_40575,2841,1016,101,30,131,2.793510324483776,54.12078077375974
Task_40576,2247,116,77,194,271,19.205128205128204,42.944001565716185
Task_40577,1285,149,95,129,224,8.566666666666666,27.723614455261554
Task_40578,2617,145,81,44,125,17.924657534246574,47.19734171227452
Task_40579,2606,407,194,72,266,6.387254901960785,49.54529443077383
Task_40580,2166,415,83,196,279,5.206730769230769,43.105456224052205
Task_40581,672,475,171,58,229,1.411764705882353,18.861454115647863
Task_40582,1272,523,42,160,202,2.427480916030534,28.88122648327437
Task_40583,1192,750,36,19,55,1.5872170439414115,26.1626652279765
Task_40584,962,843,168,69,237,1.1398104265402844,24.669489730618846
Task_40585,2503,525,96,190,286,4.758555133079848,48.79135443949311
Task_40586,1244,669,188,168,356,1.8567164179104478,29.584225898355175
Task_40587,743,302,109,91,200,2.452145214521452,19.628002261395892
Task_40588,1406,65,73,82,155,21.303030303030305,28.24232953700161
Task_40589,2695,196,119,11,130,13.680203045685278,49.02716530940639
Task_40590,2938,930,140,143,283,3.1557465091299677,56.87233431674182
Task_40591,804,814,108,70,178,0.9865030674846625,21.869293081728568
Task_40592,691,124,173,15,188,5.528,17.220539390277235
Task_40593,2267,214,55,11,66,10.544186046511628,41.28354799368822
Task_40594,1047,433,14,152,166,2.412442396313364,24.797620958113203
Task_40595,1805,486,105,68,173,3.706365503080082,36.608621499154545
Task_40596,2342,135,38,14,52,17.220588235294116,42.049779165696556
Task_40597,1681,878,127,49,176,1.912400455062571,35.74053068396703
Task_40598,2587,719,83,121,204,3.5930555555555554,50.29604934225154
Task_40599,1909,168,59,99,158,11.29585798816568,36.954089674248465
Task_40600,2447,256,113,65,178,9.521400778210117,46.03414899326764
Task_40601,1424,508,54,72,126,2.7976424361493124,30.57042248016154
Task_40602,2915,825,25,139,164,3.529055690072639,55.575577576348934
Task_40603,2098,972,40,12,52,2.1562178828365877,41.119733162412906
Task_40604,1555,566,51,57,108,2.742504409171076,32.19262761772698
Task_40605,1804,187,184,19,203,9.595744680851064,35.45621940903459
Task_40606,1674,953,185,128,313,1.7547169811320755,37.0143810058216
Task_40607,2926,813,33,43,76,3.5945945945945947,53.979099353298324
Task_40608,2368,510,11,108,119,4.634050880626223,45.41637831490374
Task_40609,1038,926,118,196,314,1.1197411003236246,26.891927870210708
Task_40610,1900,935,159,134,293,2.02991452991453,40.471757141908476
Task_40611,2822,807,82,49,131,3.492574257425743,53.31574309034107
Task_40612,2010,832,68,169,237,2.41296518607443,41.7659376086365
Task_40613,2117,447,28,119,147,4.725446428571429,41.500875592516024
Task_40614,1785,225,161,154,315,7.898230088495575,36.5000599854123
Task_40615,1417,394,16,123,139,3.5873417721518988,30.188592713607758
Task_40616,1558,138,104,56,160,11.20863309352518,30.96856571739337
Task_40617,2555,909,59,69,128,2.8076923076923075,49.81985941494664
Task_40618,2265,471,143,43,186,4.798728813559322,43.65003738232341
Task_40619,2707,426,18,149,167,6.339578454332552,51.031521804196394
Task_40620,1605,439,54,118,172,3.647727272727273,33.71051804922994
Task_40621,2462,133,158,154,312,18.37313432835821,46.52893810065978
Task_40622,2474,219,85,62,147,11.245454545454546,46.09946996699045
Task_40623,1561,1002,163,35,198,1.5563310069790628,34.22302643837934
Task_40624,1494,999,139,139,278,1.494,34.13373994214586
Task_40625,2593,863,97,113,210,3.0011574074074074,50.830758645404615
Task_40626,1226,174,104,33,137,7.005714285714285,25.634442094324644
Task_40627,914,986,40,148,188,0.9260385005065856,24.447708595832296
Task_40628,1059,971,117,44,161,1.0895061728395061,25.90137971539777
Task_40629,2768,958,191,188,379,2.886339937434828,54.76466068302951
Task_40630,1543,923,119,153,272,1.66991341991342,34.69728775492391
Task_40631,600,829,67,76,143,0.7228915662650602,18.79124560799389
Task_40632,2483,956,200,91,291,2.5945663531870427,49.64846023837523
Task_40633,2362,275,192,26,218,8.557971014492754,44.64392281507903
Task_40634,1407,190,108,23,131,7.366492146596858,28.77810017412199
Task_40635,2695,141,121,85,206,18.97887323943662,49.55667029816069
Task_40636,1092,219,93,158,251,4.963636363636364,25.29078800519748
Task_40637,721,779,105,173,278,0.9243589743589744,21.27007958700135
Task_40638,2770,763,97,39,136,3.6256544502617802,52.20368317253892
Task_40639,1825,374,98,197,295,4.866666666666666,37.61767383689662
Task_40640,2717,416,105,143,248,6.5155875299760195,51.57524230477522
Task_40641,1718,1000,59,51,110,1.7162837162837163,36.10089191048213
Task_40642,1960,206,42,78,120,9.468599033816425,37.925901988312475
Task_40643,2801,324,127,96,223,8.618461538461538,52.43840088262936
Task_40644,1439,288,188,150,338,4.97923875432526,31.349050248862827
Task_40645,2817,337,125,138,263,8.334319526627219,52.9502016666539
Task_40646,1062,265,36,68,104,3.992481203007519,23.631091902618966
Task_40647,1542,886,28,15,43,1.7384441939120632,31.946236589188427
Task_40648,2854,749,43,67,110,3.8053333333333335,53.63690684947966
Task_40649,2834,354,106,153,259,7.983098591549296,53.28164119414625
Task_40650,887,810,143,41,184,1.093711467324291,22.89766771821932
Task_40651,1641,249,133,91,224,6.564,33.75320407332138
Task_40652,1663,961,154,136,290,1.7286902286902286,36.7729684120508
Task_40653,1283,995,196,187,383,1.288152610441767,31.302811094043303
Task_40654,2581,346,10,123,133,7.438040345821325,48.45114592989649
Task_40655,2550,221,115,179,294,11.486486486486486,48.50828260710958
Task_40656,1207,953,134,49,183,1.2651991614255764,28.4919232165239
Task_40657,1000,224,90,142,232,4.444444444444445,23.70175268476899
Task_40658,1062,948,48,148,196,1.119072708113804,26.784793442803107
Task_40659,1704,926,74,121,195,1.838187702265372,36.93780785069888
Task_40660,1305,1005,65,126,191,1.297216699801193,30.7896149796928
Task_40661,1900,237,36,188,224,7.983193277310924,38.014133741274485
Task_40662,2269,813,14,157,171,2.7874692874692877,45.35085503700191
Task_40663,1620,169,146,155,301,9.529411764705882,33.42660232238849
Task_40664,1970,247,197,49,246,7.943548387096774,38.61566665741197
Task_40665,2583,852,105,30,135,3.0281359906213363,49.51135409154685
Task_40666,2431,771,154,111,265,3.1489637305699483,48.212985683769496
Task_40667,1726,625,172,82,254,2.757188498402556,36.423639246159425
Task_40668,1845,162,137,94,231,11.319018404907975,36.52961938069547
Task_40669,2673,595,50,110,160,4.48489932885906,50.9185964360747
Task_40670,1352,120,109,36,145,11.173553719008265,27.33459365944599
Task_40671,988,506,66,105,171,1.9487179487179487,24.113650485189368
Task_40672,1517,511,29,53,82,2.962890625,31.215303547187137
Task_40673,2557,923,41,90,131,2.767316017316017,49.968924618782644
Task_40674,2909,797,125,178,303,3.645363408521303,56.13702025331986
Task_40675,1113,78,40,196,236,14.08860759493671,24.606359754053383
Task_40676,2956,226,47,139,186,13.022026431718063,54.4011691096178
Task_40677,912,577,110,31,141,1.5778546712802768,22.216179736886403
Task_40678,2259,928,18,153,171,2.4316469321851453,45.546381604116114
Task_40679,1337,512,120,13,133,2.6062378167641325,28.642211467033135
Task_40680,2781,708,37,127,164,3.922425952045134,53.107386238875954
Task_40681,1726,211,163,84,247,8.141509433962264,35.03357648798326
Task_40682,2965,796,140,94,234,3.7202007528230867,56.58032216127376
Task_40683,2126,678,156,162,318,3.1310751104565537,43.40274182914809
Task_40684,609,437,78,59,137,1.3904109589041096,17.261014315884466
Task_40685,1171,581,95,66,161,2.0120274914089347,26.72269241621895
Task_40686,1004,435,98,107,205,2.302752293577982,24.28474005175494
Task_40687,1289,833,62,90,152,1.5455635491606714,29.604748414131574
Task_40688,2676,460,32,129,161,5.804772234273319,50.498550975294414
Task_40689,1030,950,92,17,109,1.0830704521556256,24.898523087786703
Task_40690,1408,548,176,105,281,2.564663023679417,31.372065197064188
Task_40691,2309,920,57,63,120,2.507057546145494,45.56058140710679
Task_40692,1977,629,149,150,299,3.138095238095238,40.78515694029932
Task_40693,1566,789,37,46,83,1.9822784810126581,32.703773309206056
Task_40694,1990,67,182,183,365,29.264705882352942,38.88821160078503
Task_40695,909,846,72,160,232,1.0731995277449824,24.209015275173375
Task_40696,2614,188,29,87,116,13.83068783068783,48.209194147372294
Task_40697,3000,491,33,27,60,6.097560975609756,54.05217077985777
Task_40698,2361,537,105,19,124,4.388475836431227,44.77967913029124
Task_40699,2174,82,57,29,86,26.19277108433735,39.16901839131997
Task_40700,2147,819,162,175,337,2.618292682926829,44.282260641477535
Task_40701,994,806,165,140,305,1.231722428748451,25.714359663558582
Task_40702,2768,1004,159,181,340,2.754228855721393,54.722173761270675
Task_40703,1699,695,147,37,184,2.4410919540229883,35.38866279994813
Task_40704,2054,1004,118,184,302,2.0437810945273633,43.24046918543316
Task_40705,2838,418,145,192,337,6.77326968973747,53.96968948950988
Task_40706,907,565,45,154,199,1.6024734982332156,23.20916178216684
Task_40707,642,794,36,85,121,0.8075471698113208,18.935018427214498
Task_40708,2668,702,58,197,255,3.795163584637269,51.90089662499208
Task_40709,2195,681,168,87,255,3.218475073313783,44.04985394679526
Task_40710,1233,974,193,199,392,1.2646153846153847,30.50361334246297
Task_40711,607,487,46,187,233,1.2438524590163935,18.361582471826637
Task_40712,2653,220,116,132,248,12.004524886877828,49.854694136951515
Task_40713,1621,644,177,193,370,2.5131782945736436,35.57701591403487
Task_40714,2462,655,98,196,294,3.7530487804878048,48.59801704520917
Task_40715,743,525,58,29,87,1.4125475285171103,18.770914640968414
Task_40716,1904,449,66,186,252,4.231111111111111,38.974744552159166
Task_40717,727,193,190,148,338,3.747422680412371,19.774367999622115
Task_40718,2757,419,17,29,46,6.564285714285714,49.84143909026597
Task_40719,531,840,109,171,280,0.6313912009512486,18.57934311744428
Task_40720,2952,532,36,24,60,5.538461538461538,53.39558008279184
Task_40721,1654,1000,148,67,215,1.6523476523476524,36.05628613713193
Task_40722,806,669,21,115,136,1.2029850746268658,21.30724407109855
Task_40723,558,714,108,66,174,0.7804195804195804,17.644033461115065
Task_40724,2203,818,195,55,250,2.68986568986569,44.293415705692134
Task_40725,2301,329,33,193,226,6.972727272727273,44.68202912780625
Task_40726,2270,1020,143,150,293,2.2233104799216457,46.62280417724827
Task_40727,2337,548,80,197,277,4.256830601092896,46.252075027988106
Task_40728,1155,941,171,184,355,1.2261146496815287,28.97339067686949
Task_40729,1416,84,136,15,151,16.658823529411766,27.750377530891964
Task_40730,2328,298,81,98,179,7.785953177257525,44.681040500082474
Task_40731,1920,644,75,10,85,2.9767441860465116,37.78832809925841
Task_40732,1387,631,66,136,202,2.194620253164557,31.06683554766202
Task_40733,999,726,120,72,192,1.37414030261348,24.754261120032933
Task_40734,1280,509,154,69,223,2.5098039215686274,28.62405642218515
Task_40735,872,933,154,95,249,0.9336188436830836,23.91162550817269
Task_40736,958,933,104,175,279,1.025695931477516,25.47570282756693
Task_40737,2669,528,46,75,121,5.045368620037808,50.235059171210004
Task_40738,1450,541,105,153,258,2.6752767527675276,31.98173263009218
Task_40739,1871,255,59,177,236,7.30859375,37.71338731433526
Task_40740,1052,433,194,38,232,2.423963133640553,24.55674321935476
Task_40741,874,962,103,192,295,0.9075804776739356,24.371620443521063
Task_40742,2336,505,90,97,187,4.616600790513834,45.51164334283582
Task_40743,2482,797,16,71,87,3.110275689223058,47.611315122141896
Task_40744,2949,688,83,143,226,4.28011611030479,56.0636222480149
Task_40745,2177,590,188,133,321,3.6835871404399323,43.903416159787945
Task_40746,2251,538,59,120,179,4.176252319109462,44.29465382236128
Task_40747,1875,628,156,138,294,2.9809220985691574,39.12642723834265
Task_40748,1693,805,91,117,208,2.100496277915633,36.378569784225185
Task_40749,924,590,121,29,150,1.5634517766497462,22.506504771758937
Task_40750,921,596,140,153,293,1.5427135678391959,23.89233334839071
Task_40751,1543,627,71,185,256,2.4570063694267517,33.82273209489775
Task_40752,1562,999,197,17,214,1.562,34.16741635556887
Task_40753,565,434,161,128,289,1.2988505747126438,17.67770171527278
Task_40754,1267,967,148,70,218,1.3088842975206612,29.81376287242921
Task_40755,2282,322,53,131,184,7.065015479876161,44.10540821045424
Task_40756,2137,666,168,160,328,3.2038980509745127,43.58131942802711
Task_40757,944,450,190,68,258,2.0931263858093128,23.283554368974166
Task_40758,2314,109,110,54,164,21.036363636363635,42.77044464365512
Task_40759,983,552,170,142,312,1.7775768535262206,24.83561213519661
Task_40760,2635,659,178,156,334,3.992424242424242,51.468215809354035
Task_40761,792,288,42,97,139,2.7404844290657437,20.029677309995854
Task_40762,1508,650,81,177,258,2.316436251920123,33.331129415840294
Task_40763,2034,494,125,19,144,4.109090909090909,39.695630850796924
Task_40764,800,634,100,169,269,1.2598425196850394,21.99111456105845
Task_40765,769,864,10,24,34,0.8890173410404625,19.780924995505334
Task_40766,855,437,77,110,187,1.952054794520548,21.905306712284084
Task_40767,1819,878,48,157,205,2.069397042093288,38.70789354018388
Task_40768,1487,650,126,96,222,2.284178187403994,32.69253281085195
Task_40769,1272,906,134,86,220,1.402425578831312,29.915120707171805
Task_40770,2642,642,59,149,208,4.108864696734059,51.0169127974551
Task_40771,1159,149,123,138,261,7.726666666666667,25.89340800921401
Task_40772,1253,137,84,163,247,9.079710144927537,27.24761249094784
Task_40773,2879,678,97,58,155,4.240058910162003,54.02101123387644
Task_40774,1689,1003,66,147,213,1.6822709163346614,37.06179714474879
Task_40775,1687,910,89,25,114,1.8518111964873765,35.21293089723597
Task_40776,1591,905,29,168,197,1.7560706401766004,35.0884071745763
Task_40777,1107,921,50,39,89,1.200650759219089,25.934651616112077
Task_40778,2381,989,136,133,269,2.405050505050505,48.1522821751736
Task_40779,971,390,199,196,395,2.483375959079284,24.602597414305198
Task_40780,2111,430,120,22,142,4.897911832946636,40.68316445977812
Task_40781,893,714,62,159,221,1.248951048951049,23.537625354106336
Task_40782,2422,382,39,110,149,6.323759791122716,46.137574665714595
Task_40783,2385,513,57,56,113,4.6400778210116735,45.29424041483031
Task_40784,1306,547,60,40,100,2.383211678832117,27.836000247981563
Task_40785,2457,247,98,67,165,9.90725806451613,46.1434162058294
Task_40786,1559,804,186,46,232,1.9366459627329193,33.74962685206426
Task_40787,2064,252,61,71,132,8.15810276679842,39.86517139163466
Task_40788,1231,832,69,135,204,1.4777911164465787,29.17474745561093
Task_40789,1446,173,64,12,76,8.310344827586206,28.245098590596204
Task_40790,2236,722,115,174,289,3.0926694329183957,45.1704563820677
Task_40791,1420,869,134,200,334,1.632183908045977,32.92902275534012
Task_40792,1179,1013,85,154,239,1.1627218934911243,28.994660264887127
Task_40793,2543,258,136,168,304,9.818532818532818,48.56624121816973
Task_40794,2899,840,75,130,205,3.447086801426873,55.66650639228248
Task_40795,2550,821,110,140,250,3.102189781021898,50.23006875088087
Task_40796,1738,494,192,110,302,3.511111111111111,36.52778313638001
Task_40797,1927,108,79,95,174,17.678899082568808,37.18034170763259
Task_40798,940,661,169,36,205,1.4199395770392749,23.35645316779122
Task_40799,2549,716,87,128,215,3.5550906555090656,49.66908596300271
Task_40800,1796,692,113,12,125,2.5916305916305915,36.34366401798685
Task_40801,2765,624,41,83,124,4.424,52.173778872422695
Task_40802,977,139,160,170,330,6.978571428571429,23.279875268995582
Task_40803,1525,577,180,171,351,2.63840830449827,33.72828000799986
Task_40804,2353,333,116,34,150,7.044910179640719,44.312283079827615
Task_40805,1618,710,93,100,193,2.2756680731364276,34.84053294572953
Task_40806,2968,940,20,185,205,3.1540913921360256,57.07413366884887
Task_40807,2835,267,71,64,135,10.578358208955224,52.01260336448069
Task_40808,2231,188,80,194,274,11.804232804232804,43.368226784502525
Task_40809,2465,560,131,57,188,4.393939393939394,47.32590905673789
Task_40810,866,470,190,96,286,1.8386411889596603,22.583640245696255
Task_40811,2835,678,187,120,307,4.175257731958763,54.52186172564232
Task_40812,2049,769,57,45,102,2.661038961038961,40.273211645146596
Task_40813,1198,376,75,41,116,3.1777188328912467,25.841993563034066
Task_40814,1296,172,109,171,280,7.491329479768786,28.245822630895304
Task_40815,1199,554,26,161,187,2.1603603603603605,27.712113195099807
Task_40816,1530,546,49,96,145,2.797074954296161,32.6497317640751
Task_40817,2310,302,91,100,191,7.623762376237623,44.4304554795491
Task_40818,2978,408,173,188,361,7.28117359413203,56.254032560447115
Task_40819,1552,389,127,61,188,3.9794871794871796,32.31342144508876
Task_40820,1519,702,200,61,261,2.1607396870554765,33.129459450547216
Task_40821,627,922,19,45,64,0.6793066088840737,18.194699556840302
Task_40822,1339,534,46,102,148,2.502803738317757,29.478796672399408
Task_40823,988,902,48,136,184,1.0941306755260243,25.352703611234034
Task_40824,780,353,30,58,88,2.2033898305084745,19.088045668097998
Task_40825,2303,647,29,166,195,3.5540123456790123,45.562411704030204
Task_40826,1601,345,17,81,98,4.627167630057803,32.37232647477227
Task_40827,736,275,119,95,214,2.6666666666666665,19.56792968847471
Task_40828,1455,1003,190,132,322,1.449203187250996,33.705031805128634
Task_40829,2919,755,181,167,348,3.861111111111111,56.34977603690959
Task_40830,2247,822,103,112,215,2.730255164034022,45.23378763114558
Task_40831,1528,373,33,53,86,4.0855614973262036,30.998435658994367
Task_40832,737,109,50,151,201,6.7,18.698889854425417
Task_40833,1928,537,41,198,239,3.58364312267658,39.53061413280137
Task_40834,2128,735,86,97,183,2.891304347826087,42.87347325521127
Task_40835,929,817,111,98,209,1.1356968215158925,24.227558204353585
Task_40836,2657,525,67,53,120,5.051330798479087,49.72939756179221
Task_40837,1274,160,167,82,249,7.913043478260869,27.50369787435406
Task_40838,680,991,54,192,246,0.6854838709677419,21.324526388240276
Task_40839,1194,905,111,40,151,1.3178807947019868,27.76454132252354
Task_40840,2529,75,72,160,232,33.276315789473685,46.7646721749417
Task_40841,2418,813,160,138,298,2.9705159705159705,48.327059889237695
Task_40842,1963,530,36,179,215,3.696798493408663,39.928321104185166
Task_40843,2410,788,30,47,77,3.0544993662864384,45.75033453300191
Task_40844,2947,538,85,73,158,5.467532467532467,54.770915371293825
Task_40845,2115,103,152,20,172,20.33653846153846,39.33035767104238
Task_40846,1999,519,62,152,214,3.8442307692307693,40.4716769581456
Task_40847,1983,390,158,111,269,5.071611253196931,39.92248058428611
Task_40848,1405,496,198,78,276,2.8269617706237424,30.975362346111453
Task_40849,1161,886,92,198,290,1.3089064261555805,28.64287631660309
Task_40850,2636,165,111,155,266,15.879518072289157,49.28327410050644
Task_40851,2718,178,196,71,267,15.184357541899441,50.26347502814445
Task_40852,897,722,18,77,95,1.2406639004149378,22.358412897147804
Task_40853,1478,400,116,31,147,3.685785536159601,30.704553981724626
Task_40854,1407,991,111,171,282,1.4183467741935485,32.784086728736064
Task_40855,587,792,113,122,235,0.7402269861286255,18.90790996074715
Task_40856,1082,840,33,156,189,1.286563614744352,26.707955711943995
Task_40857,721,95,38,38,76,7.510416666666667,16.344743449446725
Task_40858,599,416,77,181,258,1.4364508393285371,18.17605833937257
Task_40859,1903,162,104,22,126,11.674846625766872,36.14846718535007
Task_40860,1390,1014,97,165,262,1.3694581280788178,32.48957125579607
Task_40861,2301,194,33,40,73,11.8,42.15889837647193
Task_40862,2530,954,161,96,257,2.649214659685864,50.32433607944416
Task_40863,978,168,83,122,205,5.78698224852071,22.851601969737057
Task_40864,1128,130,44,193,237,8.610687022900763,25.191660168899745
Task_40865,2504,944,195,80,275,2.64973544973545,49.81108382863312
Task_40866,1719,254,113,104,217,6.741176470588235,35.0455344231608
Task_40867,551,132,189,45,234,4.142857142857143,15.338562576590782
Task_40868,2977,467,130,59,189,6.361111111111111,55.1436440015361
Task_40869,2586,364,62,53,115,7.0849315068493155,47.987927379249065
Task_40870,952,179,99,49,148,5.288888888888889,21.464123791923182
Task_40871,983,482,146,170,316,2.0351966873706004,24.688775313475364
Task_40872,2429,519,187,15,202,4.671153846153846,46.37174703892567
Task_40873,2538,685,69,125,194,3.6997084548104957,49.41010845612763
Task_40874,1957,287,16,49,65,6.795138888888889,36.99195682434621
Task_40875,556,592,73,185,258,0.9376053962900506,18.018759392612683
Task_40876,2063,197,18,36,54,10.419191919191919,38.25302157747995
Task_40877,1921,354,120,177,297,5.411267605633803,39.04587252683137
Task_40878,2662,838,191,171,362,3.172824791418355,52.60810382185222
Task_40879,2872,596,175,57,232,4.8107202680067,54.10376947297567
Task_40880,713,738,74,147,221,0.9648173207036536,20.727291616155817
Task_40881,1897,803,125,30,155,2.359452736318408,38.617729277475775
Task_40882,1745,444,87,42,129,3.9213483146067416,34.974492057943756
Task_40883,1145,229,163,82,245,4.978260869565218,25.91396349396902
Task_40884,1409,298,184,79,263,4.712374581939799,30.363808232171127
Task_40885,1425,551,194,199,393,2.5815217391304346,32.293279121359355
Task_40886,2476,194,107,10,117,12.697435897435897,45.38378825041002
Task_40887,2948,840,60,39,99,3.5053507728894173,54.69472932927602
Task_40888,658,745,99,177,276,0.8820375335120644,20.162624254567895
Task_40889,1735,738,140,83,223,2.3477672530446547,36.78136775983568
Task_40890,1546,265,77,137,214,5.81203007518797,32.45153030031216
Task_40891,2656,234,88,150,238,11.302127659574468,49.896505057030794
Task_40892,2947,798,145,182,327,3.688360450563204,56.85623725912893
Task_40893,2018,845,57,117,174,2.3853427895981087,41.540573375291125
Task_40894,2376,932,173,117,290,2.5466237942122185,47.96663362354732
Task_40895,2653,773,54,34,88,3.4276485788113695,49.77460057217588
Task_40896,534,683,78,114,192,0.7807017543859649,17.596802277102785
Task_40897,2969,691,196,84,280,4.290462427745664,56.43657674754874
Task_40898,1114,524,32,36,68,2.1219047619047617,24.298600484514072
Task_40899,575,456,83,136,219,1.2582056892778994,17.622963376522225
Task_40900,2405,470,88,73,161,5.10615711252654,45.89681875485627
Task_40901,1113,155,176,32,208,7.134615384615385,24.298404003566713
Task_40902,2302,770,69,123,192,2.985732814526589,45.927201335436074
Task_40903,1145,79,81,44,125,14.3125,23.28339217261807
Task_40904,2451,723,153,68,221,3.3853591160220993,47.84123845216811
Task_40905,575,842,56,142,198,0.6820877817319099,18.91068785238249
Task_40906,2439,684,95,173,268,3.5605839416058394,48.18055047909876
Task_40907,2328,126,49,15,64,18.330708661417322,41.727150215816614
Task_40908,765,649,135,45,180,1.176923076923077,20.43533467277832
Task_40909,2670,833,194,19,213,3.2014388489208634,51.25383187571489
Task_40910,887,408,12,135,147,2.1687041564792175,21.90802566415746
Task_40911,1924,607,13,117,130,3.164473684210526,38.885353391783205
Task_40912,630,353,77,191,268,1.7796610169491525,18.564470805402255
Task_40913,2528,857,154,178,332,2.9463869463869465,50.419540021592184
Task_40914,1388,620,120,34,154,2.2351046698872787,29.959052875862213
Task_40915,1812,569,91,87,178,3.1789473684210527,37.262518836537566
Task_40916,2525,508,84,52,136,4.960707269155206,47.81088918988204
Task_40917,618,367,145,76,221,1.6793478260869565,17.814732925710725
Task_40918,1120,793,124,16,140,1.4105793450881612,26.04450637998261
Task_40919,920,827,183,79,262,1.1111111111111112,24.221056798273395
Task_40920,2791,256,108,176,284,10.859922178988327,52.39924751950131
Task_40921,850,375,56,147,203,2.2606382978723403,21.772986678656554
Task_40922,539,148,111,139,250,3.61744966442953,16.071999727707055
Task_40923,1696,92,187,152,339,18.236559139784948,34.23147356601954
Task_40924,774,636,75,135,210,1.2150706436420722,21.32352651937159
Task_40925,675,460,105,67,172,1.4642082429501084,18.610658133307737
Task_40926,969,301,37,39,76,3.2086092715231787,21.32329124510161
Task_40927,1108,979,127,19,146,1.1306122448979592,26.622457424345455
Task_40928,2057,481,58,175,233,4.267634854771784,41.390227874235684
Task_40929,2312,68,177,66,243,33.507246376811594,42.75660708742481
Task_40930,689,905,81,36,117,0.760485651214128,19.47434301359326
Task_40931,973,901,74,119,193,1.0787139689578713,25.15803764480233
Task_40932,1605,584,64,110,174,2.7435897435897436,34.17447722645304
Task_40933,546,676,75,158,233,0.8064992614475628,17.988824515336788
Task_40934,1430,356,162,39,201,4.0056022408963585,30.139416488255588
Task_40935,1131,260,109,71,180,4.333333333333333,25.29615928421605
Task_40936,1961,839,82,91,173,2.3345238095238097,40.49998363811346
Task_40937,1240,475,90,145,235,2.6050420168067228,28.32763130497626
Task_40938,1083,846,189,14,203,1.2786304604486423,26.063358136378564
Task_40939,2766,454,123,91,214,6.079120879120879,52.19185030894215
Task_40940,2807,934,102,190,292,3.002139037433155,54.918492190694415
Task_40941,976,287,184,10,194,3.388888888888889,22.600370429718428
Task_40942,2024,863,140,70,210,2.3425925925925926,41.46675504775586
Task_40943,2904,495,10,147,157,5.854838709677419,54.16031384093325
Task_40944,1998,834,44,12,56,2.392814371257485,39.14962937901139
Task_40945,1976,65,140,183,323,29.939393939393938,38.49195464598446
Task_40946,810,873,113,18,131,0.9267734553775744,21.58294067591309
Task_40947,2373,921,152,138,290,2.5737527114967462,47.915572274785234
Task_40948,1918,880,20,40,60,2.177071509648127,38.15365117891522
Task_40949,2718,1024,72,52,124,2.651707317073171,52.34791624558391
Task_40950,1234,243,86,127,213,5.057377049180328,27.320727503526275
Task_40951,747,558,21,128,149,1.336314847942755,20.13600356674377
Task_40952,1255,390,21,81,102,3.209718670076726,27.16964538452507
Task_40953,933,590,49,116,165,1.5786802030456852,23.50248213911877
Task_40954,1404,71,152,44,196,19.5,27.949232169091985
Task_40955,590,316,42,37,79,1.861198738170347,15.538643624580708
Task_40956,1053,697,166,28,194,1.508595988538682,25.203260066670396
Task_40957,1842,510,66,103,169,3.604696673189824,37.64478664557176
Task_40958,1895,981,193,11,204,1.929735234215886,39.38211927035528
Task_40959,2004,378,32,143,175,5.287598944591029,39.81384222434188
Task_40960,2607,269,115,198,313,9.655555555555555,49.702394974016535
Task_40961,827,447,187,87,274,1.8459821428571428,21.737173578682263
Task_40962,625,193,24,159,183,3.2216494845360826,17.405519358086433
Task_40963,2275,230,169,147,316,9.848484848484848,44.25173545475709
Task_40964,1085,478,169,35,204,2.2651356993736953,25.080184982223003
Task_40965,959,804,187,19,206,1.191304347826087,24.042370984289118
Task_40966,1492,755,86,102,188,1.9735449735449735,32.87364809244129
Task_40967,1676,448,46,82,128,3.732739420935412,34.63962257730905
Task_40968,2465,507,111,78,189,4.852362204724409,47.39474397551087
Task_40969,1991,671,117,39,156,2.962797619047619,39.6999858479704
Task_40970,2439,788,96,76,172,3.091254752851711,47.72752911979743
Task_40971,2662,956,107,78,185,2.781609195402299,51.8900815988438
Task_40972,2609,346,56,51,107,7.518731988472623,48.1031687017314
Task_40973,1296,582,44,128,172,2.2229845626072042,29.232435106959002
Task_40974,2449,681,155,155,310,3.590909090909091,48.4820858767901
Task_40975,1054,177,73,189,262,5.921348314606742,24.41289648554618
Task_40976,1114,571,64,122,186,1.9475524475524475,26.422528663227045
Task_40977,842,432,144,142,286,1.9445727482678983,22.123522422941885
Task_40978,696,467,106,45,151,1.4871794871794872,18.49658366538382
Task_40979,1437,825,90,139,229,1.7397094430992737,32.49335943255048
Task_40980,1249,552,68,99,167,2.2585895117540686,28.362527923907606
Task_40981,665,450,124,115,239,1.4745011086474502,19.073321888736917
Task_40982,2310,412,134,72,206,5.593220338983051,44.60736872020116
Task_40983,2855,461,111,173,284,6.17965367965368,54.114219873288356
Task_40984,1102,261,130,49,179,4.206106870229007,24.635850899218998
Task_40985,2975,415,200,44,244,7.1514423076923075,54.97252497880087
Task_40986,1484,785,178,49,227,1.8880407124681935,32.57064953827207
Task_40987,2062,824,123,66,189,2.4993939393939395,41.84168188632631
Task_40988,2265,330,199,57,256,6.842900302114804,43.73317521297698
Task_40989,2307,169,163,70,233,13.570588235294117,43.572799808109814
Task_40990,1396,578,97,83,180,2.4110535405872193,30.70230759961368
Task_40991,2868,178,148,12,160,16.022346368715084,51.59875335140631
Task_40992,1185,188,106,128,234,6.26984126984127,26.523101884671252
Task_40993,883,73,110,96,206,11.932432432432432,20.763459957385518
Task_40994,1680,132,184,191,375,12.631578947368421,34.54645587925634
Task_40995,1363,922,28,97,125,1.47670639219935,30.880045383719303
Task_40996,1984,975,142,117,259,2.0327868852459017,41.74904158661116
Task_40997,2105,789,157,73,230,2.6645569620253164,42.661399829377075
Task_40998,2889,150,77,25,102,19.132450331125828,51.32121320816677
Task_40999,587,959,25,97,122,0.6114583333333333,18.79244046124978
Task_41000,877,550,68,20,88,1.5916515426497277,20.98728722769404
Task_41001,1307,903,143,184,327,1.4457964601769913,31.14861385515137
Task_41002,1203,915,69,56,125,1.3133187772925765,28.01989779041862
Task_41003,1861,513,176,148,324,3.6206225680933852,38.690472765332494
Task_41004,1042,236,89,24,113,4.39662447257384,22.869757018241785
Task_41005,1705,726,181,62,243,2.34525447042641,36.07999065445873
Task_41006,2855,345,64,163,227,8.251445086705202,53.52355536178536
Task_41007,1382,231,30,95,125,5.956896551724138,29.07125574994906
Task_41008,514,975,100,189,289,0.5266393442622951,18.84251128662319
Task_41009,2208,494,154,12,166,4.460606060606061,42.65172950837636
Task_41010,1447,458,181,62,243,3.1525054466230937,31.150469431098774
Task_41011,1851,126,41,183,224,14.5748031496063,36.46929431592531
Task_41012,1957,982,48,157,205,1.9908443540183114,41.2180379715928
Task_41013,2474,275,162,64,226,8.96376811594203,46.75653596403743
Task_41014,2721,881,46,130,176,3.0850340136054424,52.78717242835685
Task_41015,2630,318,11,160,171,8.244514106583072,49.45016198048091
Task_41016,1933,210,37,51,88,9.161137440758294,36.85534637473722
Task_41017,1887,182,126,137,263,10.311475409836065,37.60972152384863
Task_41018,2401,92,183,110,293,25.817204301075268,45.02648130984158
Task_41019,763,828,184,38,222,0.9203860072376358,21.253060468010386
Task_41020,989,668,141,98,239,1.4783258594917787,24.865846058491485
Task_41021,2876,1022,113,47,160,2.811339198435973,54.85329269370673
Task_41022,1678,860,179,188,367,1.948896631823461,37.13352122867373
Task_41023,1382,167,159,178,337,8.226190476190476,29.85961625399069
Task_41024,2179,726,165,91,256,2.9972489683631363,43.954740376268596
Task_41025,2708,646,83,22,105,4.185471406491499,50.42144495990027
Task_41026,974,1017,68,70,138,0.9567779960707269,25.01517783319595
Task_41027,2247,965,20,40,60,2.3260869565217392,43.63156892516551
Task_41028,1851,613,41,143,184,3.014657980456026,38.185569367614725
Task_41029,1700,987,186,40,226,1.7206477732793521,36.502417385035905
Task_41030,1535,763,39,88,127,2.0091623036649215,33.22689865146543
Task_41031,1025,831,93,76,169,1.2319711538461537,25.410531861354617
Task_41032,2811,344,139,10,149,8.147826086956522,51.527555769596354
Task_41033,1971,858,102,87,189,2.2945285215366704,40.755824550901046
Task_41034,507,999,191,147,338,0.507,18.936178184602657
Task_41035,2522,622,122,138,260,4.048154093097914,49.201144952892115
Task_41036,1210,363,186,101,287,3.3241758241758244,27.67150170861572
Task_41037,2183,623,120,41,161,3.4983974358974357,42.620127730787196
Task_41038,1520,889,126,117,243,1.7078651685393258,34.04380444197053
Task_41039,1945,782,166,12,178,2.4840357598978287,39.42794520895051
Task_41040,2245,376,123,46,169,5.954907161803714,42.925545084661564
Task_41041,2401,84,96,59,155,28.24705882352941,43.59067177064939
Task_41042,1472,847,147,143,290,1.7358490566037736,33.40272806880122
Task_41043,1482,908,192,139,331,1.6303630363036303,33.92954420145
Task_41044,1023,594,75,184,259,1.719327731092437,25.487705651080336
Task_41045,2001,503,19,66,85,3.9702380952380953,38.986128353562044
Task_41046,500,111,127,38,165,4.464285714285714,14.02588888243836
Task_41047,1196,773,41,41,82,1.545219638242894,26.768303652477872
Task_41048,1189,673,130,164,294,1.7640949554896141,28.426805507416713
Task_41049,2276,256,144,142,286,8.85603112840467,44.22064375068822
Task_41050,859,249,121,83,204,3.436,21.278924264807518
Task_41051,1564,824,71,53,124,1.8957575757575758,33.45066968752298
Task_41052,2669,763,152,55,207,3.493455497382199,51.309862725730575
Task_41053,1650,670,26,31,57,2.459016393442623,33.233577031449
Task_41054,1669,855,93,123,216,1.949766355140187,36.237981558045284
Task_41055,1169,598,158,39,197,1.9515859766277128,26.75779912146759
Task_41056,1120,296,101,87,188,3.771043771043771,25.484226496569732
Task_41057,2674,177,170,174,344,15.02247191011236,50.258102619952034
Task_41058,2773,723,156,47,203,3.8301104972375692,52.612863752145614
Task_41059,1843,753,136,182,318,2.444297082228117,39.18436576202746
Task_41060,2924,124,53,53,106,23.392,51.74578422942523
Task_41061,1192,855,135,29,164,1.3925233644859814,27.77101309302452
Task_41062,2159,507,187,195,382,4.25,43.71952413776656
Task_41063,2277,606,50,106,156,3.7512355848434926,44.66117734070135
Task_41064,851,365,130,147,277,2.3251366120218577,22.02100741607453
Task_41065,1858,767,147,143,290,2.4192708333333335,39.28238953293076
Task_41066,2692,852,140,123,263,3.155920281359906,52.61074648325698
Task_41067,2413,380,130,84,214,6.333333333333333,46.33078504680993
Task_41068,1723,1019,80,40,120,1.6892156862745098,36.12735939213751
Task_41069,2896,819,150,76,226,3.5317073170731708,55.33204451581241
Task_41070,2601,997,168,124,292,2.6062124248496996,51.75399779054777
Task_41071,2124,131,103,13,116,16.09090909090909,39.23907317001629
Task_41072,1151,417,160,69,229,2.7535885167464116,26.318023038905718
Task_41073,1781,451,28,177,205,3.940265486725664,36.721932775624815
Task_41074,2958,405,76,139,215,7.285714285714286,55.26456182654866
Task_41075,1496,569,116,52,168,2.624561403508772,31.949149735999367
Task_41076,1762,792,37,30,67,2.2219419924337958,35.402244075694824
Task_41077,2239,487,191,61,252,4.588114754098361,43.8106557703024
Task_41078,1630,711,133,45,178,2.289325842696629,34.309863145030704
Task_41079,1203,297,186,193,379,4.0369127516778525,27.89577476430128
Task_41080,2428,506,38,78,116,4.788954635108481,46.34442456454796
Task_41081,1725,192,99,132,231,8.937823834196891,35.02054167410511
Task_41082,1912,264,77,17,94,7.215094339622642,36.4971615744621
Task_41083,2823,465,99,159,258,6.05793991416309,53.484812275015294
Task_41084,2407,725,42,157,199,3.315426997245179,47.474811383512495
Task_41085,2306,534,153,168,321,4.310280373831776,45.81892895369475
Task_41086,2818,143,161,66,227,19.569444444444443,51.36903707576844
Task_41087,2569,170,192,200,392,15.023391812865498,48.87305687227484
Task_41088,2984,774,140,158,298,3.850322580645161,57.20091291179875
Task_41089,1576,205,43,86,129,7.650485436893204,32.126326872725166
Task_41090,1757,344,15,147,162,5.092753623188406,35.61655767885948
Task_41091,760,640,29,143,172,1.185647425897036,20.862978676852087
Task_41092,2917,704,181,185,366,4.137588652482269,56.26436374380635
Task_41093,1557,192,88,139,227,8.067357512953368,32.32021475225355
Task_41094,1561,982,31,57,88,1.5879959308240081,33.40515451640041
Task_41095,546,745,69,10,79,0.7319034852546917,16.395274254156295
Task_41096,2849,786,129,107,236,3.62007623888183,54.74577002115952
Task_41097,2208,724,52,175,227,3.04551724137931,44.527265503600425
Task_41098,2594,316,163,91,254,8.182965299684543,49.18620222191413
Task_41099,687,986,83,121,204,0.6960486322188449,21.097923699157565
Task_41100,2486,767,174,11,185,3.2369791666666665,47.97893253323512
Task_41101,2473,480,176,154,330,5.141372141372141,48.308894370153446
Task_41102,1905,676,49,17,66,2.813884785819793,37.13422548815192
Task_41103,911,633,186,90,276,1.4369085173501577,23.641410924369087
Task_41104,656,1018,87,41,128,0.6437684003925417,19.967238544500038
Task_41105,519,320,67,74,141,1.6168224299065421,15.729127691303022
Task_41106,2661,718,17,78,95,3.700973574408901,50.30070605951024
Task_41107,2136,691,128,151,279,3.086705202312139,43.41014828726648
Task_41108,2106,345,114,186,300,6.086705202312139,41.968886320859816
Task_41109,1084,276,50,135,185,3.9133574007220218,25.050899546914007
Task_41110,813,720,195,99,294,1.1276005547850207,22.450838347624465
Task_41111,2602,435,15,95,110,5.967889908256881,48.82908885739271
Task_41112,1103,393,163,18,181,2.799492385786802,24.877722289360875
Task_41113,1578,611,166,134,300,2.5784313725490198,34.39041734142057
Task_41114,2248,526,168,144,312,4.265654648956357,44.79924214078155
Task_41115,2180,763,178,182,360,2.8534031413612566,44.74372996826429
Task_41116,734,531,13,50,63,1.3796992481203008,18.44737165334166
Task_41117,2374,587,44,192,236,4.037414965986395,46.733630616974004
Task_41118,2365,72,23,190,213,32.397260273972606,44.0526271547483
Task_41119,918,1004,69,120,189,0.9134328358208955,24.63149598880655
Task_41120,2963,817,88,143,231,3.622249388753056,56.638459390828025
Task_41121,2911,367,139,41,180,7.9103260869565215,53.50748479463349
Task_41122,1322,552,176,183,359,2.390596745027125,30.488800394304125
Task_41123,1578,585,112,176,288,2.6928327645051193,34.31613780999876
Task_41124,796,369,196,59,255,2.151351351351351,20.612308841461616
Task_41125,1566,113,77,146,223,13.736842105263158,31.918319085524207
Task_41126,1916,467,190,16,206,4.094017094017094,38.10280323861352
Task_41127,2230,944,175,110,285,2.35978835978836,45.657719087022485
Task_41128,2688,445,198,127,325,6.026905829596412,51.53569331399533
Task_41129,912,485,98,98,196,1.876543209876543,22.939612409713302
Task_41130,825,846,170,149,319,0.974025974025974,23.267562974503363
Task_41131,1164,360,29,183,212,3.224376731301939,26.718795033450224
Task_41132,2982,488,188,78,266,6.098159509202454,55.86977656520185
Task_41133,1295,452,94,195,289,2.858719646799117,29.4579871214238
Task_41134,2679,168,34,170,204,15.85207100591716,49.671528688547816
Task_41135,2685,921,24,189,213,2.9121475054229933,52.57460021196735
Task_41136,1045,843,191,102,293,1.2381516587677726,26.5272619188172
Task_41137,1888,443,108,191,299,4.252252252252252,38.84389951511394
Task_41138,2679,672,77,154,231,3.9806835066864785,51.80612687871598
Task_41139,1013,167,47,147,194,6.029761904761905,23.35186774508266
Task_41140,2876,866,11,116,127,3.3171856978085352,54.745399920718874
Task_41141,2132,677,129,65,194,3.144542772861357,42.52986673425033
Task_41142,2259,267,37,159,196,8.42910447761194,43.63468730368741
Task_41143,932,957,179,150,329,0.9728601252609603,25.35280764197078
Task_41144,2852,262,12,82,94,10.844106463878328,51.87368776403719
Task_41145,2717,232,35,123,158,11.660944206008583,50.32799004027394
Task_41146,973,550,42,19,61,1.765880217785844,22.02109247311419
Task_41147,2336,954,17,93,110,2.446073298429319,46.222882423597916
Task_41148,1900,920,35,136,171,2.0629750271444083,39.83778893226606
Task_41149,1522,1014,169,60,229,1.4995073891625617,33.99048433078055
Task_41150,1629,1019,147,144,291,1.5970588235294119,36.430316025534545
Task_41151,2336,219,137,25,162,10.618181818181819,43.68827123328706
Task_41152,2252,535,51,30,81,4.201492537313433,42.71776611508767
Task_41153,1163,384,114,142,256,3.020779220779221,26.915695130089563
Task_41154,1846,670,18,177,195,2.751117734724292,38.39450658618825
Task_41155,2130,153,107,101,208,13.831168831168831,40.91397320860968
Task_41156,2564,349,160,172,332,7.325714285714286,49.350533671127494
Task_41157,1080,706,93,11,104,1.5275813295615275,24.850110990601305
Task_41158,1541,416,144,16,160,3.695443645083933,31.685151307784327
Task_41159,2200,144,158,169,327,15.172413793103448,42.60002963691817
Task_41160,1071,251,183,30,213,4.25,24.164529337524
Task_41161,791,278,177,168,345,2.835125448028674,21.13091322296577
Task_41162,2053,691,189,183,372,2.9667630057803467,42.5614925766776
Task_41163,615,254,93,94,187,2.411764705882353,17.47126013344926
Task_41164,545,906,184,26,210,0.6008820286659317,18.185175453167222
Task_41165,2267,225,190,165,355,10.030973451327434,44.30874468003918
Task_41166,1379,900,178,92,270,1.5305216426193118,31.847728152504406
Task_41167,2996,449,45,137,182,6.657777777777778,55.78424552725198
Task_41168,2738,382,151,44,195,7.148825065274152,50.890753579777346
Task_41169,528,672,140,44,184,0.7845468053491828,16.82743228105058
Task_41170,1241,494,120,146,266,2.507070707070707,28.55031142181211
Task_41171,1383,231,148,24,172,5.961206896551724,28.762290816934524
Task_41172,1075,231,162,80,242,4.633620689655173,24.770429574500103
Task_41173,2950,545,149,184,333,5.402930402930403,56.12871996713117
Task_41174,2964,166,123,183,306,17.748502994011975,54.66632319958447
Task_41175,595,726,117,159,276,0.8184319119669876,19.077044738196744
Task_41176,1770,610,177,63,240,2.8968903436988542,36.770996898147395
Task_41177,1348,782,16,54,70,1.7215836526181354,29.0848573021628
Task_41178,2890,346,197,49,246,8.328530259365994,53.507823715742155
Task_41179,1818,903,182,176,358,2.0110619469026547,39.42741984063263
Task_41180,2147,598,103,75,178,3.5843071786310516,42.52048144034574
Task_41181,2342,253,180,18,198,9.220472440944881,44.09564399206198
Task_41182,1783,932,79,26,105,1.9110396570203645,36.70251858390528
Task_41183,2000,730,178,64,242,2.735978112175103,40.8070709818834
Task_41184,1322,684,112,38,150,1.92992700729927,29.129340457017992
Task_41185,2585,657,103,171,274,3.9285714285714284,50.4214961386045
Task_41186,1473,371,104,69,173,3.9596774193548385,30.977985691383168
Task_41187,1284,300,88,164,252,4.26578073089701,28.53016576368238
Task_41188,2038,691,143,62,205,2.945086705202312,41.0739410332893
Task_41189,1817,572,46,184,230,3.1710296684118675,37.84389644361401
Task_41190,682,159,27,106,133,4.2625,17.366774560836287
Task_41191,2087,761,142,95,237,2.7388451443569553,42.59572182980174
Task_41192,1306,765,19,124,143,1.7049608355091384,29.623425844124117
Task_41193,2880,815,22,86,108,3.5294117647058822,54.38037828421008
Task_41194,786,913,72,120,192,0.8599562363238512,22.27085940233071
Task_41195,2037,924,148,168,316,2.2021621621621623,42.76191829960845
Task_41196,1149,495,61,180,241,2.316532258064516,27.101298997550213
Task_41197,1604,832,141,16,157,1.9255702280912366,33.975657647838055
Task_41198,967,505,127,50,177,1.9110671936758894,23.26509978474395
Task_41199,1850,417,82,169,251,4.425837320574162,37.9518701998036
Task_41200,2081,974,129,38,167,2.134358974358974,42.24277557023113
Task_41201,745,614,51,26,77,1.2113821138211383,18.858031172474046
Task_41202,979,616,62,73,135,1.586709886547812,23.838221815466756
Task_41203,2919,198,160,175,335,14.668341708542714,54.46003559268136
Task_41204,658,364,140,171,311,1.8027397260273972,19.153063668598463
Task_41205,858,693,51,15,66,1.2363112391930835,20.601511952090746
Task_41206,994,836,188,65,253,1.1875746714456392,25.26267109847738
Task_41207,642,538,83,139,222,1.1910946196660481,18.958400439262146
Task_41208,1196,989,151,99,250,1.208080808080808,29.172620072440576
Task_41209,2277,241,77,95,172,9.409090909090908,43.66175978482686
Task_41210,1780,408,124,38,162,4.352078239608802,35.612583593400714
Task_41211,789,701,78,21,99,1.123931623931624,20.18263237882402
Task_41212,2998,816,76,114,190,3.6695226438188495,57.067602064553135
Task_41213,1120,400,25,79,104,2.7930174563591024,25.1047381685888
Task_41214,2144,336,100,158,258,6.362017804154303,42.309316132933226
Task_41215,2433,689,183,180,363,3.526086956521739,48.529427580053756
Task_41216,711,833,177,36,213,0.8525179856115108,20.34187800206326
Task_41217,973,361,173,73,246,2.6878453038674035,23.460202478562106
Task_41218,1900,564,28,80,108,3.3628318584070795,38.04130985404645
Task_41219,2223,278,171,82,253,7.967741935483871,43.1537167436987
Task_41220,1634,462,123,81,204,3.529157667386609,34.19102235671355
Task_41221,646,243,93,162,255,2.6475409836065573,18.350159724111364
Task_41222,2293,358,120,157,277,6.387186629526463,44.82430083787025
Task_41223,1058,265,133,72,205,3.9774436090225564,24.316021709974674
Task_41224,2586,262,140,51,191,9.832699619771864,48.26565659748652
Task_41225,2199,1010,199,113,312,2.1750741839762613,45.497948490826104
Task_41226,2149,407,76,19,95,5.267156862745098,40.73205223665569
Task_41227,2937,183,156,191,347,15.96195652173913,54.644838219546976
Task_41228,2684,531,197,119,316,5.045112781954887,51.69989661087076
Task_41229,2114,479,196,111,307,4.404166666666667,42.45599448617815
Task_41230,1684,967,155,49,204,1.7396694214876034,36.189130899436584
Task_41231,1982,361,181,91,272,5.475138121546961,39.74034082464522
Task_41232,2125,679,79,86,165,3.125,42.60274575685344
Task_41233,2277,922,21,27,48,2.466955579631636,43.87678656079196
Task_41234,2220,167,175,120,295,13.214285714285714,42.79976516388405
Task_41235,2506,998,45,98,143,2.5085085085085086,49.39827048396288
Task_41236,821,273,124,92,216,2.9963503649635035,20.844264635838623
Task_41237,1216,221,162,194,356,5.4774774774774775,27.743380170641256
Task_41238,1262,574,39,108,147,2.194782608695652,28.376047715887292
Task_41239,554,890,154,147,301,0.621773288439955,19.167603113406802
Task_41240,1993,1009,164,30,194,1.9732673267326732,41.07139582413268
Task_41241,2194,956,176,123,299,2.2925809822361547,45.20677824987544
Task_41242,1180,418,45,198,243,2.8162291169451072,27.34473653168658
Task_41243,1807,504,21,110,131,3.5782178217821783,36.715353651501424
Task_41244,2033,444,81,149,230,4.568539325842696,40.82284419240512
Task_41245,1129,539,98,125,223,2.0907407407407406,26.698283067759288
Task_41246,943,823,170,171,341,1.1444174757281553,25.16237375626501
Task_41247,1785,648,17,78,95,2.7503852080123266,36.20460377744528
Task_41248,1801,682,12,84,96,2.636896046852123,36.62781240323964
Task_41249,955,711,180,117,297,1.3412921348314606,24.749625880306372
Task_41250,1650,449,94,61,155,3.6666666666666665,33.82814055463896
Task_41251,725,589,66,22,88,1.228813559322034,18.807876408399107
Task_41252,649,79,178,32,210,8.1125,16.37522028349667
Task_41253,2861,871,43,174,217,3.2809633027522938,55.232113379841984
Task_41254,2821,908,116,152,268,3.1034103410341034,54.89514151819628
Task_41255,1604,637,38,35,73,2.5141065830721003,32.43597201599193
Task_41256,764,160,43,13,56,4.745341614906832,17.475863162890995
Task_41257,1055,500,129,108,237,2.1057884231536925,25.438197309901778
Task_41258,2669,528,187,52,239,5.045368620037808,50.7476997073166
Task_41259,1115,353,76,82,158,3.1497175141242937,25.41597001907611
Task_41260,739,277,167,36,203,2.658273381294964,18.958909809845483
Task_41261,1475,270,45,40,85,5.442804428044281,29.5877016185598
Task_41262,1827,877,98,141,239,2.080865603644647,38.90571755543014
Task_41263,2147,91,64,80,144,23.33695652173913,39.97286713830912
Task_41264,899,194,107,45,152,4.61025641025641,20.84540834459951
Task_41265,1084,157,121,141,262,6.860759493670886,24.754477328807166
Task_41266,1257,268,18,142,160,4.672862453531598,27.386020597593333
Task_41267,2514,386,15,47,62,6.496124031007752,46.09526832451828
Task_41268,1781,526,105,44,149,3.379506641366224,35.89842695995392
Task_41269,698,1009,170,192,362,0.691089108910891,22.130416492329136
Task_41270,1317,402,121,108,229,3.267990074441687,29.23849629067381
Task_41271,1022,820,44,77,121,1.2448233861144946,24.98562240127046
Task_41272,826,907,103,69,172,0.9096916299559471,22.47021509419778
Task_41273,2957,642,176,151,327,4.598755832037325,56.4753207394862
Task_41274,2679,238,184,186,370,11.209205020920502,50.96402663456985
Task_41275,604,556,68,193,261,1.0843806104129263,18.671119803427693
Task_41276,1169,388,80,121,201,3.005141388174807,26.79804957129612
Task_41277,900,395,39,24,63,2.272727272727273,20.473193511619453
Task_41278,1116,817,86,161,247,1.3643031784841075,27.413955939102845
Task_41279,2104,849,22,73,95,2.4752941176470586,41.86595037756745
Task_41280,2599,691,154,109,263,3.755780346820809,50.61039676586014
Task_41281,1270,434,74,190,264,2.9195402298850577,28.935360604822296
Task_41282,1859,273,113,39,152,6.7846715328467155,36.275901395789234
Task_41283,950,274,160,16,176,3.4545454545454546,22.049806369400645
Task_41284,1036,176,53,134,187,5.853107344632768,23.644938531291128
Task_41285,2965,436,94,51,145,6.784897025171625,54.62014659987884
Task_41286,2981,762,167,112,279,3.90694626474443,56.962462280514124
Task_41287,2808,110,124,92,216,25.2972972972973,51.09423072180169
Task_41288,1641,421,177,101,278,3.8886255924170614,34.63728109660156
Task_41289,2303,455,13,181,194,5.050438596491228,44.93944081476735
Task_41290,1052,702,194,169,363,1.496443812233286,26.6360300036623
Task_41291,2949,586,177,47,224,5.023850085178876,55.059230794068306
Task_41292,1886,648,118,25,143,2.906009244992296,37.85575178715812
Task_41293,522,860,70,49,119,0.6062717770034843,17.007497988439024
Task_41294,1035,160,134,72,206,6.428571428571429,23.3784336488274
Task_41295,2888,873,162,77,239,3.3043478260869565,55.44031047005515
Task_41296,2207,217,59,35,94,10.123853211009175,40.938999726901294
Task_41297,2629,462,137,81,218,5.6781857451403885,50.00374423048424
Task_41298,1143,598,128,42,170,1.9081803005008346,26.185797732106902
Task_41299,1583,851,128,51,179,1.857981220657277,34.22522386347471
Task_41300,549,405,143,15,158,1.3522167487684729,15.910733422459195
Task_41301,577,202,75,52,127,2.8423645320197046,15.971771471886903
Task_41302,2115,1005,12,177,189,2.1023856858846917,43.651666549253235
Task_41303,2226,267,147,22,169,8.305970149253731,42.15503246941504
Task_41304,947,467,137,12,149,2.0235042735042734,22.436983057406064
Task_41305,2366,658,91,140,231,3.590288315629742,46.716048910503766
Task_41306,1673,493,198,97,295,3.38663967611336,35.473369117737114
Task_41307,1893,659,10,29,39,2.868181818181818,36.86159137976239
Task_41308,2452,369,83,24,107,6.627027027027027,45.507988786822416
Task_41309,2511,552,74,181,255,4.540687160940325,48.90468124563936
Task_41310,1079,260,165,134,299,4.134099616858237,25.366416451109842
Task_41311,2631,490,82,33,115,5.358452138492872,48.87026898200904
Task_41312,1014,353,75,134,209,2.864406779661017,24.300510423870723
Task_41313,547,375,72,61,133,1.4547872340425532,16.117846613526087
Task_41314,2057,785,46,128,174,2.6170483460559795,41.954472308083076
Task_41315,1212,444,103,123,226,2.7235955056179777,27.719111933227044
Task_41316,692,307,71,107,178,2.2467532467532467,18.851000277998402
Task_41317,2946,71,194,169,363,40.916666666666664,53.83638186350143
Task_41318,1044,693,166,200,366,1.5043227665706052,26.540288927548833
Task_41319,1142,491,126,45,171,2.321138211382114,25.824218098778697
Task_41320,1739,166,26,37,63,10.41317365269461,33.0092495950931
Task_41321,2636,120,107,20,127,21.785123966942148,47.388103440919984
Task_41322,1471,169,115,13,128,8.652941176470588,29.480074843512302
Task_41323,1664,937,79,50,129,1.7739872068230278,35.346163719634056
Task_41324,1957,835,82,11,93,2.340909090909091,39.02708406920162
Task_41325,1518,109,45,59,104,13.8,29.465598497046695
Task_41326,1075,223,99,92,191,4.799107142857143,24.579958602276076
Task_41327,2332,266,150,90,240,8.734082397003744,44.8263456832427
Task_41328,1391,688,54,15,69,2.018867924528302,28.982331560758098
Task_41329,2656,788,178,39,217,3.3662864385297846,50.997941384717855
Task_41330,2451,180,128,119,247,13.541436464088397,46.252761100583086
Task_41331,2904,182,43,131,174,15.868852459016393,53.181551497839244
Task_41332,1727,611,161,74,235,2.8218954248366015,36.19084962175982
Task_41333,2512,260,189,55,244,9.624521072796934,47.342694997291176
Task_41334,1308,425,43,133,176,3.0704225352112675,28.958215034991486
Task_41335,2118,241,67,171,238,8.75206611570248,41.570492070980535
Task_41336,2982,550,166,116,282,5.411978221415608,56.32202189482174
Task_41337,2452,260,171,85,256,9.39463601532567,46.720522657195964
Task_41338,677,306,177,96,273,2.205211726384365,19.016841840175264
Task_41339,2617,347,175,32,207,7.5201149425287355,48.91176902762962
Task_41340,1322,457,178,98,276,2.88646288209607,29.697661068089342
Task_41341,2362,970,175,115,290,2.43254376930999,47.860285624151096
Task_41342,515,808,83,186,269,0.6365883807169345,18.228612411530197
Task_41343,570,672,20,80,100,0.8469539375928677,17.14628276540259
Task_41344,646,745,33,182,215,0.8659517426273459,19.647530296385163
Task_41345,587,787,199,19,218,0.7449238578680203,18.19179312740648
Task_41346,947,922,180,137,317,1.0260021668472372,25.382942133572516
Task_41347,2272,987,126,167,293,2.299595141700405,46.576759625103364
Task_41348,1736,691,149,115,264,2.508670520231214,36.953761921066565
Task_41349,569,857,31,73,104,0.6631701631701632,17.88286860030275
Task_41350,1113,184,199,96,295,6.0162162162162165,25.53063409159698
Task_41351,1238,875,66,69,135,1.41324200913242,28.69869340255157
Task_41352,1595,338,189,80,269,4.705014749262537,33.46870928113276
Task_41353,863,512,127,193,320,1.6822612085769981,22.921380182096414
Task_41354,1840,908,36,76,112,2.024202420242024,38.23815248998964
Task_41355,627,825,109,176,285,0.7590799031476998,19.988470413724954
Task_41356,1825,370,67,187,254,4.919137466307277,37.475345917117465
Task_41357,1451,789,170,17,187,1.8367088607594937,31.659693645337388
Task_41358,1615,365,164,176,340,4.412568306010929,34.43375601960188
Task_41359,1964,779,126,106,232,2.517948717948718,40.683546846085285
Task_41360,1124,827,67,65,132,1.357487922705314,26.78534593989866
Task_41361,2968,646,118,86,204,4.587326120556415,55.946314527428605
Task_41362,1580,678,192,28,220,2.3269513991163477,33.607296877697344
Task_41363,2496,181,126,136,262,13.714285714285714,47.08860415775428
Task_41364,774,958,15,40,55,0.8070907194994786,20.46691105975835
Task_41365,1811,695,84,43,127,2.6020114942528734,36.7279698051485
Task_41366,1521,661,136,53,189,2.297583081570997,32.77048914938364
Task_41367,2207,595,11,199,210,3.703020134228188,43.951144669707524
Task_41368,692,1001,152,164,316,0.6906187624750499,21.762273571019378
Task_41369,2754,295,127,69,196,9.304054054054054,51.11897676405294
Task_41370,2581,381,123,195,318,6.7565445026178015,49.69819273002681
Task_41371,2753,127,47,14,61,21.5078125,48.42801387194359
Task_41372,2407,150,46,156,202,15.940397350993377,45.304555603940976
Task_41373,1966,361,41,195,236,5.430939226519337,39.54511943735853
Task_41374,1148,264,197,156,353,4.332075471698113,26.74576379887485
Task_41375,1880,726,19,154,173,2.5859697386519946,38.948152278356886
Task_41376,1565,292,103,38,141,5.341296928327645,31.662437824964204
Task_41377,2150,483,21,196,217,4.4421487603305785,42.7394319795599
Task_41378,2185,573,70,69,139,3.8066202090592336,42.77689753685536
Task_41379,605,628,80,33,113,0.9618441971383148,17.356136819239754
Task_41380,1293,276,159,20,179,4.667870036101083,27.513982954376743
Task_41381,2646,376,117,133,250,7.018567639257294,50.31240408183621
Task_41382,1405,399,192,132,324,3.5125,31.08469715067436
Task_41383,1676,327,80,187,267,5.109756097560975,35.01395315970637
Task_41384,1534,373,158,103,261,4.101604278074866,32.71530206345811
Task_41385,1199,588,84,150,234,2.0356536502546687,28.052103283903662
Task_41386,2100,519,199,101,300,4.038461538461538,42.31648242545316
Task_41387,1620,271,166,107,273,5.955882352941177,33.79655987352936
Task_41388,693,929,37,55,92,0.7451612903225806,19.590759811214756
Task_41389,2797,876,153,171,324,3.1892816419612315,54.69491691324007
Task_41390,1008,268,64,17,81,3.7472118959107807,22.059823249193858
Task_41391,2405,864,145,164,309,2.7803468208092488,48.36837617816199
Task_41392,2194,879,102,92,194,2.493181818181818,44.39436391681959
Task_41393,2219,974,24,64,88,2.275897435897436,43.95441023749191
Task_41394,1521,456,157,18,175,3.3282275711159737,31.67487281449168
Task_41395,2493,746,58,41,99,3.3373493975903616,47.19212655423692
Task_41396,2298,247,10,138,148,9.266129032258064,43.6801282027024
Task_41397,738,803,98,167,265,0.917910447761194,21.550511833253267
Task_41398,1138,184,175,30,205,6.151351351351352,24.95698482855624
Task_41399,836,194,88,75,163,4.287179487179487,20.42402534243082
Task_41400,1780,96,119,52,171,18.350515463917525,34.09920300128466
Task_41401,1100,327,24,191,215,3.3536585365853657,25.61029319036737
Task_41402,1441,909,83,120,203,1.5835164835164834,32.68311741373696
Task_41403,1082,261,167,109,276,4.129770992366412,25.276838357392133
Task_41404,2799,334,181,197,378,8.355223880597014,53.25991701522571
Task_41405,1215,519,43,142,185,2.3365384615384617,27.829823754272557
Task_41406,2534,306,109,198,307,8.254071661237784,48.65322698024121
Task_41407,2045,947,108,53,161,2.1571729957805905,41.748832072616224
Task_41408,1088,201,31,107,138,5.3861386138613865,24.339144618400397
Task_41409,726,1018,18,108,126,0.7124631992149166,21.328996707927534
Task_41410,2666,722,15,79,94,3.6874135546334714,50.426877054358265
Task_41411,1695,789,105,115,220,2.1455696202531644,36.412186662084586
Task_41412,2271,676,63,179,242,3.3545051698670605,45.4426817132053
Task_41413,826,404,102,126,228,2.039506172839506,21.497247001648145
Task_41414,2539,273,21,105,126,9.266423357664234,47.50276858664112
Task_41415,755,988,161,166,327,0.7633973710819009,22.692372366663275
Task_41416,2448,589,109,161,270,4.149152542372882,48.003006655749736
Task_41417,1534,512,141,118,259,2.990253411306043,33.173259384270956
Task_41418,2499,961,143,157,300,2.5977130977130978,50.109844414701854
Task_41419,619,608,41,14,55,1.0164203612479474,16.725408413394895
Task_41420,1863,387,70,48,118,4.801546391752577,36.47456161434523
Task_41421,1815,982,57,119,176,1.8463886063072228,38.76219650341776
Task_41422,2078,839,130,41,171,2.473809523809524,41.74842882159505
Task_41423,1697,368,39,119,158,4.598915989159892,34.66358853396304
Task_41424,1770,230,117,190,307,7.662337662337662,36.297925403373625
Task_41425,1688,888,17,35,52,1.8987626546681664,34.49142789115741
Task_41426,2641,380,45,79,124,6.9317585301837275,49.40730321646069
Task_41427,1920,792,29,119,148,2.421185372005044,39.481629412640444
Task_41428,827,844,118,161,279,0.978698224852071,23.134690761872804
Task_41429,1772,1010,185,20,205,1.7527200791295747,37.53289259671425
Task_41430,2577,485,132,56,188,5.302469135802469,48.866427711394884
Task_41431,1462,240,130,190,320,6.066390041493776,31.526665228524323
Task_41432,1153,936,160,50,210,1.2305229455709712,27.71279611986728
Task_41433,1891,201,145,47,192,9.361386138613861,36.87985709633198
Task_41434,767,854,153,69,222,0.8970760233918129,21.624963899543616
Task_41435,981,673,69,94,163,1.4554896142433233,24.44355883122503
Task_41436,2839,971,68,12,80,2.9207818930041154,53.250916219081795
Task_41437,1680,356,15,60,75,4.705882352941177,32.97973203191279
Task_41438,2830,759,71,65,136,3.723684210526316,53.566222077873796
Task_41439,1862,686,94,139,233,2.710334788937409,38.839680642492226
Task_41440,2064,439,177,186,363,4.6909090909090905,41.89766202284228
Task_41441,2327,184,63,157,220,12.578378378378378,44.43670180006193
Task_41442,801,72,41,14,55,10.972602739726028,16.766829638157095
Task_41443,809,418,104,177,281,1.9307875894988067,21.585983024643053
Task_41444,1644,548,71,98,169,2.9945355191256833,34.61385157829846
Task_41445,2369,997,130,198,328,2.37374749498998,48.348225564177845
Task_41446,805,875,93,45,138,0.9189497716894978,21.636490194969028
Task_41447,2288,238,47,155,202,9.573221757322175,44.024958284385434
Task_41448,1581,406,142,123,265,3.8845208845208847,33.61310578417631
Task_41449,1723,597,155,86,241,2.8812709030100336,36.24008932762052
Task_41450,1871,592,63,18,81,3.1551433389544687,36.75066919346619
Task_41451,1087,914,192,117,309,1.1879781420765028,27.511509236227113
Task_41452,1030,922,151,45,196,1.1159263271939328,25.537262600812227
Task_41453,1825,792,168,64,232,2.301387137452711,38.18353447786722
Task_41454,2890,509,21,62,83,5.666666666666667,52.99483697341183
Task_41455,1091,658,53,119,172,1.6555386949924127,26.252002211333775
Task_41456,1700,866,197,99,296,1.9607843137254901,37.044331715388154
Task_41457,1059,742,57,115,172,1.4253028263795424,25.95880100756737
Task_41458,966,173,19,105,124,5.551724137931035,21.689425179442384
Task_41459,2480,826,22,58,80,2.9987908101571947,47.374789241663024
Task_41460,1604,336,95,183,278,4.759643916913946,33.90573575383087
Task_41461,897,808,36,164,200,1.1087762669962917,23.71279123521033
Task_41462,572,138,16,105,121,4.115107913669065,15.278777261019151
Task_41463,944,437,30,135,165,2.1552511415525113,23.17510165471636
Task_41464,1715,863,111,147,258,1.9849537037037037,37.17773029449535
Task_41465,1880,264,33,154,187,7.09433962264151,37.555512411518144
Task_41466,1795,451,102,153,255,3.9712389380530975,37.143674512079066
Task_41467,1187,957,170,24,194,1.2390396659707725,28.083362964465906
Task_41468,1888,176,13,54,67,10.666666666666666,35.59739843340006
Task_41469,2373,506,133,100,233,4.680473372781065,46.293491069824064
Task_41470,2086,913,12,166,178,2.2822757111597376,42.82109265732706
Task_41471,720,497,128,173,301,1.4457831325301205,20.45523213584001
Task_41472,1158,305,57,144,201,3.784313725490196,26.402891972713984
Task_41473,1754,349,81,72,153,5.011428571428572,35.244259551111114
Task_41474,2303,845,13,173,186,2.7222222222222223,46.09801358168618
Task_41475,1278,436,177,72,249,2.9244851258581237,28.54662003447281
Task_41476,1235,865,25,150,175,1.426096997690531,29.122826992617302
Task_41477,930,132,28,34,62,6.992481203007519,19.959461004472097
Task_41478,1458,907,119,23,142,1.605726872246696,31.872848006975996
Task_41479,1371,482,125,141,266,2.8385093167701863,30.563018772535703
Task_41480,813,791,98,110,208,1.0265151515151516,22.327831705605234
Task_41481,1863,468,37,128,165,3.9722814498933903,37.830127026395296
Task_41482,920,441,32,128,160,2.081447963800905,22.610231815340722
Task_41483,2246,905,132,49,181,2.479028697571744,44.79152125950736
Task_41484,2051,722,51,139,190,2.8367911479944676,41.837456168630986
Task_41485,1485,407,53,159,212,3.639705882352941,31.983153117572105
Task_41486,2545,132,128,14,142,19.13533834586466,46.0541356067936
Task_41487,815,141,33,156,189,5.73943661971831,20.04771683523364
Task_41488,1783,306,159,133,292,5.807817589576548,36.615910771639825
Task_41489,1706,853,171,31,202,1.9976580796252927,36.07990019395323
Task_41490,1463,377,185,121,306,3.8703703703703702,31.834191813528935
Task_41491,1828,77,30,147,177,23.435897435897434,35.42943501429229
Task_41492,1354,488,76,46,122,2.7689161554192228,28.732957005685396
Task_41493,889,892,200,124,324,0.9955207166853304,24.396435060687164
Task_41494,2968,814,65,55,120,3.641717791411043,55.51896755841378
Task_41495,2817,925,119,188,307,3.0421166306695464,55.11348578649097
Task_41496,2639,940,158,101,259,2.8044633368756644,51.99591319346738
Task_41497,952,633,184,39,223,1.501577287066246,23.54724813081414
Task_41498,1763,445,125,195,320,3.9529147982062782,36.972428774879646
Task_41499,1599,767,169,99,268,2.08203125,35.00961695713377
Task_41500,1625,984,26,170,196,1.649746192893401,35.853986474965815
Task_41501,541,717,29,12,41,0.7534818941504178,15.770459621390138
Task_41502,518,578,124,14,138,0.8946459412780656,15.945234199370423
Task_41503,2388,438,171,62,233,5.439635535307517,45.9347489762203
Task_41504,2126,823,106,178,284,2.5800970873786406,43.72756869112148
Task_41505,896,731,34,183,217,1.2240437158469946,23.591366796103106
Task_41506,961,658,109,90,199,1.4582701062215477,24.164054911939505
Task_41507,2782,488,130,50,180,5.689161554192229,51.96382262564138
Task_41508,994,306,196,94,290,3.237785016286645,24.06782673065724
Task_41509,2347,442,63,51,114,5.297968397291196,44.409520029091134
Task_41510,1989,854,32,35,67,2.3263157894736843,39.17764791810158
Task_41511,2674,400,53,161,214,6.668329177057356,50.786722941200686
Task_41512,2435,665,30,39,69,3.656156156156156,45.657895219013064
Task_41513,572,509,107,145,252,1.1215686274509804,17.86319250782287
Task_41514,501,731,52,135,187,0.6844262295081968,17.33170471062292
Task_41515,2354,573,137,132,269,4.101045296167247,46.41643842843083
Task_41516,2737,1019,12,63,75,2.683333333333333,51.89503162877623
Task_41517,573,734,22,175,197,0.7795918367346939,18.378581689005927
Task_41518,1952,297,120,53,173,6.550335570469799,38.33104700187079
Task_41519,860,903,121,117,238,0.9513274336283186,23.60012050030657
Task_41520,551,827,85,111,196,0.6654589371980676,18.39168677445127
Task_41521,2474,130,111,20,131,18.885496183206108,44.93288450802631
Task_41522,1316,843,122,37,159,1.5592417061611374,29.55548410222403
Task_41523,1862,345,193,178,371,5.381502890173411,38.41774752527475
Task_41524,1572,229,75,50,125,6.834782608695652,31.546010205200933
Task_41525,2087,83,148,84,232,24.845238095238095,39.550413210635725
Task_41526,1476,326,95,73,168,4.513761467889908,30.917963627977983
Task_41527,571,424,101,146,247,1.3435294117647059,17.592794421185086
Task_41528,2655,343,51,111,162,7.718023255813954,49.877237634259274
Task_41529,2911,990,46,52,98,2.937436932391524,54.947717838287836
Task_41530,2213,1000,81,23,104,2.2107892107892106,43.69444012061003
Task_41531,1537,786,146,185,331,1.9529860228716645,34.50257177888451
Task_41532,1812,765,189,88,277,2.3655352480417755,38.34905472149672
Task_41533,2446,985,177,195,372,2.4807302231237323,49.724982672910244
Task_41534,1799,67,36,162,198,26.455882352941178,35.064869243570186
Task_41535,779,83,16,119,135,9.273809523809524,18.374906955987417
Task_41536,1595,661,100,84,184,2.409365558912387,34.103264204374746
Task_41537,2001,345,148,125,273,5.783236994219653,40.09696259310818
Task_41538,1930,510,107,116,223,3.776908023483366,39.27119462131938
Task_41539,2124,507,87,52,139,4.181102362204724,41.430935753671534
Task_41540,2288,1011,141,181,322,2.260869565217391,47.056211614110225
Task_41541,2908,796,70,132,202,3.648682559598494,55.667828521822976
Task_41542,2912,996,43,82,125,2.920762286860582,55.739488421843454
Task_41543,1212,90,130,73,203,13.31868131868132,25.5191801087002
Task_41544,2437,570,167,110,277,4.267950963222416,47.72500113931642
Task_41545,783,491,51,92,143,1.5914634146341464,20.535921461864636
Task_41546,2401,329,121,128,249,7.275757575757575,46.26559359473698
Task_41547,1996,361,38,50,88,5.513812154696133,38.27053078410773
Task_41548,624,840,178,11,189,0.7419738406658739,18.804962019072324
Task_41549,779,290,190,92,282,2.676975945017182,20.532805377976675
Task_41550,2109,944,90,104,194,2.231746031746032,43.31574452073202
Task_41551,1770,385,134,187,321,4.585492227979275,36.88176240072503
Task_41552,1057,318,35,50,85,3.3134796238244513,23.260433422514996
Task_41553,2956,778,195,124,319,3.7946084724005136,56.81474206611838
Task_41554,717,715,43,136,179,1.0013966480446927,20.395796110902364
Task_41555,1993,96,11,46,57,20.54639175257732,36.282305150978495
Task_41556,1807,447,181,164,345,4.033482142857143,37.742506938932785
Task_41557,678,570,157,108,265,1.1873905429071805,19.754191497659477
Task_41558,2482,1001,128,23,151,2.4770459081836327,48.43452099169624
Task_41559,949,625,108,184,292,1.5159744408945688,24.46703532501509
Task_41560,829,122,117,71,188,6.739837398373984,19.750208408993373
Task_41561,1253,437,182,157,339,2.8607305936073057,28.904937516182574
Task_41562,2249,947,48,96,144,2.3723628691983123,45.242225149806636
Task_41563,545,711,30,85,115,0.7654494382022472,17.137602753392073
Task_41564,1083,335,171,173,344,3.2232142857142856,25.934854578550375
Task_41565,1641,447,30,124,154,3.6629464285714284,33.974230098951395
Task_41566,1332,608,72,127,199,2.187192118226601,30.07957709624243
Task_41567,756,458,58,65,123,1.6470588235294117,19.629145057551273
Task_41568,2358,446,192,180,372,5.275167785234899,46.605414426985966
Task_41569,955,521,161,166,327,1.8295019157088122,24.41151230562473
Task_41570,2499,341,105,15,120,7.307017543859649,46.20897997007145
Task_41571,1523,188,190,106,296,8.058201058201059,32.10375035168687
Task_41572,1167,984,195,120,315,1.184771573604061,29.027301941714097
Task_41573,2645,151,62,136,198,17.401315789473685,49.07226154493489
Task_41574,1042,374,80,160,240,2.7786666666666666,24.976932808028895
Task_41575,635,915,191,154,345,0.6932314410480349,20.70466910502002
Task_41576,1279,198,176,177,353,6.42713567839196,28.65890217753817
Task_41577,505,597,124,95,219,0.8444816053511706,16.91501313235673
Task_41578,2623,786,27,45,72,3.3329097839898347,49.03357069249585
Task_41579,2367,905,40,32,72,2.6125827814569536,45.3569767549967
Task_41580,1268,145,94,32,126,8.684931506849315,26.18695152812685
Task_41581,1471,766,176,151,327,1.9178617992177314,33.326804337833856
Task_41582,2396,650,122,106,228,3.6804915514592933,47.103201577462265
Task_41583,2913,744,178,48,226,3.91006711409396,55.00985141389063
Task_41584,1643,861,69,95,164,1.906032482598608,35.5858146553682
Task_41585,1775,360,76,116,192,4.916897506925208,36.26042546627743
Task_41586,1134,816,156,63,219,1.3880048959608322,27.232191570057054
Task_41587,2437,233,41,46,87,10.414529914529915,44.66364201752524
Task_41588,2939,180,180,77,257,16.23756906077348,53.77403103426165
Task_41589,1982,606,76,14,90,3.2652388797364087,38.6762559405222
Task_41590,2806,580,48,42,90,4.82960413080895,51.69035698063391
Task_41591,2207,485,58,193,251,4.541152263374485,43.88515241557309
Task_41592,2346,263,173,109,282,8.886363636363637,45.28568535644832
Task_41593,2456,600,33,124,157,4.086522462562396,47.425092117984356
Task_41594,1833,272,167,100,267,6.714285714285714,37.12916139054867
Task_41595,1659,331,59,152,211,4.996987951807229,34.47128361343773
Task_41596,2729,259,191,58,249,10.496153846153845,50.78727341927223
Task_41597,2258,272,170,54,224,8.271062271062272,43.28944736407374
Task_41598,2029,114,109,90,199,17.643478260869564,38.835295344605676
Task_41599,1389,261,23,156,179,5.301526717557252,29.725262881221965
Task_41600,1636,988,34,152,186,1.6541961577350859,35.9659157629969
Task_41601,570,863,172,119,291,0.6597222222222222,19.23280320459628
Task_41602,2893,401,197,122,319,7.196517412935323,54.599455652900325
Task_41603,1885,869,34,150,184,2.1666666666666665,39.53874008297688
Task_41604,1656,212,120,74,194,7.774647887323944,33.572759761292545
Task_41605,1107,503,139,134,273,2.1964285714285716,26.47122844238568
Task_41606,2785,194,66,127,193,14.282051282051283,51.633990499334054
Task_41607,1512,391,132,43,175,3.857142857142857,31.427452083257222
Task_41608,2187,140,42,191,233,15.51063829787234,41.918644246909246
Task_41609,1124,258,62,149,211,4.33976833976834,25.763342151999705
Task_41610,2153,826,97,102,199,2.6033857315598548,43.6779079180468
Task_41611,1037,430,124,161,285,2.406032482598608,25.226691679717547
Task_41612,1513,448,91,70,161,3.3697104677060135,31.713906544250737
Task_41613,2980,319,115,130,245,9.3125,55.37222034074788
Task_41614,1334,462,56,176,232,2.8812095032397407,29.881576551217673
Task_41615,762,638,152,90,242,1.192488262910798,21.13518781463962
Task_41616,1737,598,48,22,70,2.8998330550918197,34.32216114118707
Task_41617,2378,724,197,73,270,3.28,46.96262628310296
Task_41618,1104,966,62,180,242,1.141675284384695,27.780066749252665
Task_41619,2486,852,58,29,87,2.914419695193435,47.37131299350285
Task_41620,2963,285,54,44,98,10.36013986013986,53.144748892482575
Task_41621,1228,499,103,101,204,2.456,28.014873067776197
Task_41622,2998,969,38,14,52,3.090721649484536,55.368754044431334
Task_41623,2408,87,78,110,188,27.363636363636363,44.68505325925084
Task_41624,1786,893,118,54,172,1.9977628635346756,37.5520516867233
Task_41625,1752,466,20,46,66,3.7516059957173447,34.266401086692994
Task_41626,2564,368,176,84,260,6.948509485094851,48.88679785285894
Task_41627,2188,982,156,81,237,2.2258392675483214,44.7474769684296
Task_41628,2969,357,173,83,256,8.293296089385475,55.23941211179143
Task_41629,2278,1006,129,28,157,2.2621648460774577,45.28988342502114
Task_41630,2604,213,141,113,254,12.16822429906542,49.052503213223474
Task_41631,1751,625,154,27,181,2.797124600638978,35.934593871038764
Task_41632,1876,110,14,113,127,16.9009009009009,35.6768991398683
Task_41633,1361,271,189,32,221,5.0036764705882355,28.857113224588787
Task_41634,2034,544,154,101,255,3.7321100917431194,41.148430657191234
Task_41635,1086,262,117,127,244,4.129277566539924,25.2255326881883
Task_41636,1538,926,149,96,245,1.6591154261057173,34.45043149096625
Task_41637,652,116,125,199,324,5.572649572649572,18.01193866577469
Task_41638,2402,449,188,13,201,5.337777777777778,45.72416671329422
Task_41639,2093,422,10,140,150,4.947990543735225,41.02663969470529
Task_41640,1922,376,175,148,323,5.098143236074271,39.20899751693107
Task_41641,671,300,37,154,191,2.229235880398671,18.613843567457636
Task_41642,2767,972,166,157,323,2.8437821171634123,54.49468544497379
Task_41643,2755,849,21,183,204,3.2411764705882353,53.40327808942431
Task_41644,2775,750,105,144,249,3.6950732356857525,53.57285858434517
Task_41645,2390,353,100,158,258,6.751412429378531,46.25770964073604
Task_41646,2393,518,54,138,192,4.610789980732177,46.58968560610031
Task_41647,2184,847,127,59,186,2.5754716981132075,43.75908332041734
Task_41648,2619,395,101,101,202,6.613636363636363,49.68566997668777
Task_41649,1297,533,136,122,258,2.4288389513108615,29.48856220127814
Task_41650,2011,342,71,137,208,5.862973760932944,40.02968321951962
Task_41651,1296,508,120,147,267,2.5461689587426326,29.471177346853793
Task_41652,2761,221,110,92,202,12.436936936936936,51.24638354860797
Task_41653,1840,169,124,193,317,10.823529411764707,37.02385412597879
Task_41654,608,526,54,146,200,1.1537001897533208,18.32251359934354
Task_41655,2697,274,27,168,195,9.807272727272727,50.557243287078194
Task_41656,1410,610,70,19,89,2.3076923076923075,29.632742257403546
Task_41657,1418,609,46,21,67,2.324590163934426,29.296492256197013
Task_41658,950,393,116,70,186,2.4111675126903553,22.84537870613005
Task_41659,2003,698,188,105,293,2.86552217453505,41.32107763645384
Task_41660,1740,486,158,78,236,3.572895277207392,36.066609671429504
Task_41661,1829,875,135,85,220,2.0878995433789953,38.682194019741864
Task_41662,842,201,173,105,278,4.1683168316831685,21.287790651085725
Task_41663,1698,803,179,172,351,2.111940298507463,37.1773424758363
Task_41664,1519,700,89,103,192,2.166904422253923,33.18147449372501
Task_41665,2327,797,82,121,203,2.9160401002506267,46.42414605383477
Task_41666,830,371,175,71,246,2.2311827956989245,21.21455115572623
Task_41667,2260,465,195,51,246,4.849785407725322,44.04504827241097
Task_41668,626,640,56,192,248,0.9765990639625585,19.23174274699402
Task_41669,2215,530,71,117,188,4.171374764595104,43.737518403372654
Task_41670,2810,653,101,56,157,4.296636085626911,52.85505433239691
Task_41671,1615,583,83,69,152,2.7654109589041096,33.73176023950778
Task_41672,1565,97,147,189,336,15.96938775510204,32.21188577995711
Task_41673,2109,501,96,179,275,4.201195219123506,42.41068451927957
Task_41674,2788,279,22,58,80,9.957142857142857,50.468704835118395
Task_41675,2709,406,17,105,122,6.656019656019656,50.499309921791735
Task_41676,1831,295,122,171,293,6.1858108108108105,37.39775394746601
Task_41677,1813,520,141,185,326,3.4798464491362764,38.01605656495537
Task_41678,2250,187,152,167,319,11.96808510638298,43.76053266545449
Task_41679,2715,224,107,55,162,12.066666666666666,49.97283675710852
Task_41680,716,832,39,114,153,0.8595438175270108,20.46834536140888
Task_41681,1444,414,186,173,359,3.4795180722891565,31.967845230455577
Task_41682,1363,75,169,47,216,17.93421052631579,27.44599898130576
Task_41683,1172,658,156,51,207,1.7784522003034902,27.24248767807704
Task_41684,1902,118,30,142,172,15.983193277310924,36.82698629748595
Task_41685,1211,69,10,94,104,17.3,24.71299221204301
Task_41686,984,246,171,38,209,3.983805668016194,22.77474708404635
Task_41687,591,743,49,98,147,0.7943548387096774,18.37194572966693
Task_41688,1939,477,116,59,175,4.056485355648536,38.664767893491785
Task_41689,1548,375,116,199,315,4.117021276595745,33.32739686619262
Task_41690,1704,187,126,113,239,9.063829787234043,34.705461356948085
Task_41691,1813,631,18,61,79,2.8686708860759493,36.09332346655289
Task_41692,974,529,10,159,169,1.8377358490566038,23.9307648387498
Task_41693,1451,387,13,20,33,3.7396907216494846,28.853938172877978
Task_41694,1892,601,61,31,92,3.142857142857143,37.23256531365431
Task_41695,2645,1013,100,86,186,2.608481262327416,51.86406964797224
Task_41696,792,761,72,64,136,1.0393700787401574,21.250012123913038
Task_41697,1736,932,108,101,209,1.8606645230439443,37.43673269881971
Task_41698,2963,498,127,58,185,5.937875751503006,54.994361078172915
Task_41699,2067,932,40,112,152,2.215434083601286,42.23033110039955
Task_41700,1551,143,107,177,284,10.770833333333334,32.1781792505432
Task_41701,1093,377,39,66,105,2.8915343915343916,24.47050450954535
Task_41702,1345,890,169,59,228,1.509539842873176,30.795877383905793
Task_41703,1067,319,167,198,365,3.334375,25.761388973327854
Task_41704,2298,843,118,144,262,2.7227488151658767,46.3662321909055
Task_41705,1610,138,95,79,174,11.582733812949641,32.16895828626872
Task_41706,2881,426,141,168,309,6.747072599531616,54.5154251964046
Task_41707,2320,254,156,53,209,9.098039215686274,44.179230451586555
Task_41708,1591,321,66,195,261,4.940993788819876,33.658621238878766
Task_41709,1668,866,176,157,333,1.9238754325259515,36.795056933076125
Task_41710,1588,465,84,149,233,3.407725321888412,33.81686776880003
Task_41711,2346,355,48,91,139,6.589887640449438,44.817726441306796
Task_41712,873,109,101,27,128,7.9363636363636365,19.634506308928074
Task_41713,2885,184,190,25,215,15.594594594594595,52.51566956775696
Task_41714,1077,140,51,105,156,7.638297872340425,23.660422950098646
Task_41715,835,653,132,146,278,1.2767584097859328,22.611326427903318
Task_41716,1902,703,178,60,238,2.7017045454545454,39.09932205164104
Task_41717,1494,499,113,160,273,2.988,32.62347000744591
Task_41718,533,328,99,125,224,1.6200607902735562,16.59109475531129
Task_41719,752,480,15,126,141,1.5634095634095635,19.920823692934594
Task_41720,840,1012,128,72,200,0.8292201382033564,23.19742979290073
Task_41721,842,721,154,107,261,1.1662049861495845,22.791813670810797
Task_41722,1012,474,47,14,61,2.130526315789474,22.355686539188074
Task_41723,1445,1007,98,183,281,1.433531746031746,33.453164089384416
Task_41724,2884,485,19,173,192,5.934156378600823,54.222385038147316
Task_41725,2890,474,189,97,286,6.08421052631579,54.636894109554696
Task_41726,1533,112,23,69,92,13.56637168141593,29.805162881829773
Task_41727,845,741,164,46,210,1.1388140161725067,22.140870735301945
Task_41728,2483,502,102,82,184,4.936381709741551,47.66836186318229
Task_41729,2905,1010,166,52,218,2.873392680514342,55.913221286675025
Task_41730,654,777,44,167,211,0.8406169665809768,19.846648128997625
Task_41731,1494,193,97,157,254,7.701030927835052,31.52115971668832
Task_41732,547,179,136,122,258,3.0388888888888888,16.257981723053323
Task_41733,2738,467,33,110,143,5.85042735042735,51.37105261423977
Task_41734,561,252,40,143,183,2.217391304347826,16.617535027369822
Task_41735,1476,669,122,169,291,2.2029850746268655,32.96744378945166
Task_41736,1187,881,161,166,327,1.3458049886621315,29.159582711008742
Task_41737,1844,932,139,75,214,1.9764201500535905,38.95601217007546
Task_41738,1826,897,158,192,350,2.0334075723830733,39.522915439173254
Task_41739,2521,90,53,187,240,27.703296703296704,46.824226230787964
Task_41740,1883,412,53,19,72,4.559322033898305,35.94460680441245
Task_41741,1467,505,67,86,153,2.899209486166008,31.426890176099196
Task_41742,861,323,127,35,162,2.6574074074074074,20.79060171317045
Task_41743,1297,762,60,11,71,1.6998689384010486,27.741124491459615
Task_41744,2142,598,137,169,306,3.5759599332220366,43.35968348567462
Task_41745,1129,520,169,49,218,2.166986564299424,26.079420033515035
Task_41746,759,196,158,110,268,3.8527918781725887,19.93903369034985
Task_41747,1219,150,26,172,198,8.072847682119205,26.542873521750025
Task_41748,2022,568,197,143,340,3.5536028119507908,41.47936671546493
Task_41749,2877,70,146,116,262,40.521126760563384,52.212096387440404
Task_41750,2515,423,146,164,310,5.931603773584905,48.71190690365656
Task_41751,768,442,174,197,371,1.7336343115124153,21.434051621449303
Task_41752,600,308,65,179,244,1.941747572815534,17.8381162841817
Task_41753,2383,865,173,70,243,2.751732101616628,47.30993265053781
Task_41754,2327,391,168,15,183,5.936224489795919,44.235553665838204
Task_41755,633,970,81,58,139,0.6519052523171988,19.491705406198534
Task_41756,734,401,34,134,168,1.8258706467661692,19.740800161474105
Task_41757,2365,372,106,148,254,6.340482573726542,45.89335622630083
Task_41758,1971,764,13,77,90,2.5764705882352943,39.481155801578076
Task_41759,686,138,200,37,237,4.9352517985611515,17.54342930951772
Task_41760,2723,715,145,109,254,3.803072625698324,52.60988273745005
Task_41761,2473,173,65,153,218,14.21264367816092,46.57107739824366
Task_41762,2966,925,105,100,205,3.203023758099352,56.88578557775829
Task_41763,1615,720,55,87,142,2.2399445214979194,34.44705809575187
Task_41764,718,733,11,88,99,0.9782016348773842,19.595526986129247
Task_41765,1017,861,36,158,194,1.179814385150812,25.77800823051217
Task_41766,1496,350,167,45,212,4.262108262108262,31.207056556262177
Task_41767,2194,217,117,58,175,10.064220183486238,41.82452371682603
Task_41768,1965,100,16,190,206,19.455445544554454,37.93047635625948
Task_41769,2754,920,154,33,187,2.990228013029316,52.809332535187686
Task_41770,2311,782,175,187,362,2.9514687100894,46.8949860017637
Task_41771,2034,250,176,26,202,8.103585657370518,39.29908869457835
Task_41772,2736,831,40,105,145,3.2884615384615383,52.517472545876075
Task_41773,591,731,151,149,300,0.8073770491803278,19.138708476171114
Task_41774,1090,964,161,24,185,1.1295336787564767,26.52000576181359
Task_41775,805,306,198,151,349,2.6221498371335503,21.435565370502616
Task_41776,1053,978,185,23,208,1.0755873340143003,26.102163501155477
Task_41777,2906,569,171,152,323,5.098245614035088,55.41738609688912
Task_41778,989,320,160,115,275,3.0809968847352023,24.003851916699215
Task_41779,1241,197,140,59,199,6.267676767676767,26.866785158806973
Task_41780,2541,1010,81,178,259,2.513353115727003,50.82740183374083
Task_41781,1862,897,39,54,93,2.0734966592427617,38.01184141714503
Task_41782,2821,746,98,174,272,3.7764390896921016,54.44084323955597
Task_41783,1941,740,173,56,229,2.619433198380567,39.80454986033431
Task_41784,2014,529,171,18,189,3.8,39.783237163697926
Task_41785,1915,164,80,12,92,11.606060606060606,36.07668045487612
Task_41786,2131,407,108,49,157,5.223039215686274,41.16855475288008
Task_41787,2285,153,94,146,240,14.837662337662337,43.591724804759586
Task_41788,2136,675,66,175,241,3.1597633136094676,43.3011209631916
Task_41789,1368,564,73,126,199,2.421238938053097,30.510166965821412
Task_41790,2608,701,63,51,114,3.715099715099715,49.37116242843336
Task_41791,2954,406,16,89,105,7.257985257985258,54.16115572133694
Task_41792,1768,791,119,168,287,2.2323232323232323,37.95462009813938
Task_41793,1201,231,138,47,185,5.176724137931035,26.047417237537037
Task_41794,1566,184,178,47,225,8.464864864864865,31.82784707318363
Task_41795,1885,242,180,58,238,7.757201646090535,37.34035709132603
Task_41796,2835,112,122,12,134,25.088495575221238,50.382881941814816
Task_41797,1517,565,49,79,128,2.6802120141342756,32.542294804822326
Task_41798,1962,917,133,80,213,2.1372549019607843,40.85905518413484
Task_41799,1665,765,82,87,169,2.1736292428198434,35.55518517415126
Task_41800,805,960,29,31,60,0.8376690946930281,20.881398988978173
Task_41801,2338,983,93,22,115,2.3760162601626016,45.7886844434254
Task_41802,1697,685,60,43,103,2.4737609329446064,34.46621265110653
Task_41803,656,223,65,148,213,2.9285714285714284,18.26432066367194
Task_41804,2660,856,167,130,297,3.103850641773629,52.27976087347366
Task_41805,1579,434,107,194,301,3.6298850574712644,33.937834699108
Task_41806,2137,633,198,24,222,3.3706624605678233,42.24395129604214
Task_41807,1405,613,47,155,202,2.288273615635179,31.28611617937388
Task_41808,2410,917,157,36,193,2.625272331154684,47.38932864049918
Task_41809,1937,787,139,56,195,2.4581218274111674,39.73494365145652
Task_41810,1592,134,24,144,168,11.792592592592593,31.977830755080944
Task_41811,1087,997,164,53,217,1.0891783567134268,27.057800230637937
Task_41812,538,889,120,174,294,0.604494382022472,18.919187324925502
Task_41813,2053,975,133,80,213,2.103483606557377,42.481474316493355
Task_41814,750,614,180,35,215,1.2195121951219512,20.260354059661918
Task_41815,2563,225,200,85,285,11.34070796460177,48.4737150994607
Task_41816,2457,316,153,107,260,7.750788643533123,47.12524291873584
Task_41817,1134,478,113,87,200,2.3674321503131526,26.360650176680064
Task_41818,741,226,142,197,339,3.26431718061674,20.18656329128699
Task_41819,778,974,11,75,86,0.7979487179487179,21.23660887958126
Task_41820,2317,496,16,176,192,4.661971830985915,45.273937346992646
Task_41821,2430,821,151,105,256,2.9562043795620436,48.30457050264537
Task_41822,836,893,123,33,156,0.9351230425055929,22.20953673763132
Task_41823,621,181,77,11,88,3.412087912087912,15.752564498691212
Task_41824,2284,142,144,108,252,15.972027972027972,43.47447840055332
Task_41825,2231,705,173,196,369,3.1600566572237963,45.43061427172719
Task_41826,1512,355,81,142,223,4.247191011235955,32.24787497898568
Task_41827,919,506,147,101,248,1.8126232741617356,23.34324507738873
Task_41828,1107,319,177,107,284,3.459375,25.89546263012457
Task_41829,2305,208,47,190,237,11.028708133971293,44.38850019922967
Task_41830,2322,171,186,121,307,13.5,44.48310603110382
Task_41831,719,936,39,99,138,0.767342582710779,20.815127995035102
Task_41832,2113,681,76,104,180,3.098240469208211,42.5404220576647
Task_41833,2430,105,188,145,333,22.92452830188679,45.82771544539042
Task_41834,2817,837,113,96,209,3.3615751789976134,54.289571016506734
Task_41835,2540,958,84,138,222,2.64859228362878,50.38066527838972
Task_41836,1926,90,21,143,164,21.164835164835164,36.8870864699818
Task_41837,899,121,139,118,257,7.368852459016393,21.549829147619647
Task_41838,982,630,140,70,210,1.5562599049128367,24.216876332062807
Task_41839,1205,589,144,187,331,2.042372881355932,28.631795429979572
Task_41840,2556,261,100,175,275,9.755725190839694,48.66222879271817
Task_41841,2235,498,137,21,158,4.478957915831663,42.953160286882245
Task_41842,2436,126,103,165,268,19.181102362204726,45.88407973326332
Task_41843,3000,801,165,21,186,3.7406483790523692,56.250853519711335
Task_41844,674,465,50,16,66,1.446351931330472,16.955656936308124
Task_41845,2434,329,49,144,193,7.375757575757576,46.654609364655535
Task_41846,2305,571,24,151,175,4.02972027972028,45.203612946803666
Task_41847,1194,393,22,157,179,3.030456852791878,27.069456819011723
Task_41848,1677,909,121,87,208,1.8428571428571427,36.34396307907925
Task_41849,964,412,118,53,171,2.334140435835351,23.041514216202845
Task_41850,568,911,138,92,230,0.6228070175438597,19.036892808754686
Task_41851,2738,810,105,117,222,3.376078914919852,53.014214379689314
Task_41852,2413,765,43,16,59,3.150130548302872,45.490095194083715
Task_41853,2406,480,195,162,357,5.002079002079002,47.38169972344576
Task_41854,2801,580,146,188,334,4.820998278829604,53.892339989783316
Task_41855,2130,350,36,48,84,6.068376068376068,40.29627570950949
Task_41856,2617,534,28,87,115,4.891588785046729,49.443095184497984
Task_41857,1884,335,49,28,77,5.607142857142857,35.9275919096051
Task_41858,2041,544,179,78,257,3.744954128440367,41.11161868277757
Task_41859,2275,462,67,166,233,4.913606911447085,44.77118813605586
Task_41860,1467,367,18,64,82,3.9864130434782608,30.059686724014657
Task_41861,2225,562,94,133,227,3.952042628774423,44.16112530934671
Task_41862,1275,884,17,142,159,1.4406779661016949,29.528245469745357
Task_41863,852,885,52,17,69,0.9616252821670429,21.282011179616592
Task_41864,1794,411,57,28,85,4.354368932038835,35.02000199035472
Task_41865,1982,775,179,93,272,2.554123711340206,41.10100832387561
Task_41866,2238,177,184,36,220,12.573033707865168,42.169224672804226
Task_41867,1974,504,169,75,244,3.908910891089109,39.80667284816803
Task_41868,846,433,175,153,328,1.9493087557603688,22.395396063374402
Task_41869,2241,642,126,128,254,3.4852255054432346,44.77237628185079
Task_41870,2519,708,161,62,223,3.552891396332863,48.827774462348884
Task_41871,1676,433,167,63,230,3.8617511520737327,34.67528260974455
Task_41872,2669,829,78,62,140,3.2156626506024097,51.16812406630143
Task_41873,1376,785,93,86,179,1.7506361323155217,31.040342022025012
Task_41874,1696,942,123,145,268,1.7985153764581123,37.16437112034
Task_41875,2044,673,182,30,212,3.0326409495548963,40.91149941009436
Task_41876,971,678,144,76,220,1.4300441826215022,24.328688763242017
Task_41877,648,652,60,150,210,0.9923430321592649,19.392564291176438
Task_41878,950,287,51,116,167,3.298611111111111,22.842853170350338
Task_41879,2457,809,192,167,359,3.033333333333333,49.24985936786576
Task_41880,2570,1010,103,21,124,2.5420375865479725,49.58337683030221
Task_41881,2332,724,96,17,113,3.216551724137931,44.82964673559261
Task_41882,1916,113,141,180,321,16.80701754385965,37.82170079207604
Task_41883,2810,490,86,63,149,5.723014256619145,52.34129136781775
Task_41884,2735,661,79,117,196,4.1314199395770395,52.43932569450829
Task_41885,758,371,121,141,262,2.0376344086021505,20.492347396883662
Task_41886,1702,515,79,31,110,3.298449612403101,34.191287608296555
Task_41887,2171,430,84,15,99,5.037122969837587,41.13586603540743
Task_41888,2589,101,46,79,125,25.38235294117647,46.77889039491263
Task_41889,2931,242,152,56,208,12.061728395061728,53.733815409593554
Task_41890,2345,144,73,179,252,16.17241379310345,44.6265170237387
Task_41891,2727,432,149,107,256,6.297921478060046,51.76978820603174
Task_41892,2353,910,194,194,388,2.5828759604829856,48.08812627060873
Task_41893,1666,789,156,90,246,2.108860759493671,36.001544610940236
Task_41894,1635,117,116,60,176,13.85593220338983,32.185237729782166
Task_41895,2501,338,142,11,153,7.377581120943953,46.566295531211445
Task_41896,550,724,46,178,224,0.7586206896551724,18.17680696273949
Task_41897,2849,298,75,117,192,9.528428093645484,53.03308626932495
Task_41898,1061,765,55,108,163,1.385117493472585,25.98689063705056
Task_41899,1660,526,30,150,180,3.1499051233396584,34.88440360804861
Task_41900,558,929,23,145,168,0.6,18.67870280977984
Task_41901,2290,105,19,42,61,21.60377358490566,41.10881524175864
Task_41902,2817,68,39,76,115,40.82608695652174,49.92466072158364
Task_41903,925,318,34,44,78,2.8996865203761755,20.792523112530343
Task_41904,2031,475,172,182,354,4.266806722689076,41.44515625121322
Task_41905,1275,501,176,160,336,2.539840637450199,29.446675012675033
Task_41906,1645,115,79,149,228,14.181034482758621,33.18616435797017
Task_41907,1898,921,160,133,293,2.058568329718004,40.39505848940251
Task_41908,1104,845,161,185,346,1.3049645390070923,27.83210187769789
Task_41909,1283,140,173,65,238,9.099290780141844,27.226618581125592
Task_41910,916,896,186,139,325,1.0211817168338908,24.842611738004834
Task_41911,2802,612,198,174,372,4.5709624796084825,54.1612992900729
Task_41912,1957,448,79,74,153,4.358574610244989,38.840841098633284
Task_41913,1961,915,112,10,122,2.140829694323144,39.57718970752176
Task_41914,1249,761,19,184,203,1.6391076115485563,29.255472013242294
Task_41915,1947,412,14,75,89,4.714285714285714,37.970969464901245
Task_41916,1065,136,160,158,318,7.773722627737226,24.579232189440116
Task_41917,2838,704,36,86,122,4.025531914893617,53.564871853468695
Task_41918,1059,547,183,145,328,1.9324817518248176,26.11330371999183
Task_41919,2465,128,120,42,162,19.108527131782946,44.987345689114534
Task_41920,1771,152,154,54,208,11.57516339869281,34.89941564907906
Task_41921,2886,470,140,53,193,6.127388535031847,53.796511717292454
Task_41922,2346,95,120,102,222,24.4375,43.81131489450922
Task_41923,554,152,79,19,98,3.6209150326797386,14.492974484869045
Task_41924,2983,430,22,189,211,6.921113689095128,55.71378943482443
Task_41925,855,1018,46,193,239,0.8390578999018645,23.963252459234408
Task_41926,1112,307,155,69,224,3.6103896103896105,25.325051952613958
Task_41927,829,945,195,171,366,0.8763213530655392,23.88548624704106
Task_41928,2152,808,118,142,260,2.6600741656365883,43.93166811914952
Task_41929,563,737,151,58,209,0.7628726287262872,17.921122431166566
Task_41930,688,723,87,130,217,0.9502762430939227,20.156808661037104
Task_41931,1001,397,190,41,231,2.5150753768844223,23.621478608312554
Task_41932,1307,273,142,116,258,4.7700729927007295,28.801920142674646
Task_41933,1504,835,111,37,148,1.799043062200957,32.48793005287322
Task_41934,2418,71,111,102,213,33.583333333333336,44.8020229948429
Task_41935,1982,664,113,174,287,2.9804511278195487,40.95568977284435
Task_41936,1317,975,46,27,73,1.3493852459016393,28.968897820785287
Task_41937,1479,869,158,147,305,1.7,33.65546103208368
Task_41938,1932,536,184,185,369,3.5977653631284916,40.144880689683816
Task_41939,640,148,65,15,80,4.295302013422819,15.690022092795958
Task_41940,663,245,110,132,242,2.6951219512195124,18.484193144284653
Task_41941,1648,657,110,117,227,2.5045592705167175,35.289508281622496
Task_41942,2966,225,116,67,183,13.123893805309734,54.11924950835216
Task_41943,1297,713,69,49,118,1.8165266106442577,28.59329411169593
Task_41944,1375,969,169,186,355,1.4175257731958764,32.559835751281426
Task_41945,639,367,56,56,112,1.736413043478261,17.078882865549122
Task_41946,1979,317,62,185,247,6.223270440251572,39.69283487811552
Task_41947,701,288,101,31,132,2.42560553633218,17.95395431777572
Task_41948,932,968,125,10,135,0.9618163054695562,23.75852119243302
Task_41949,664,165,94,175,269,4.0,18.256440879548492
Task_41950,503,568,109,149,258,0.8840070298769771,17.03773133483632
Task_41951,2548,529,84,50,134,4.807547169811321,48.06688543161521
Task_41952,2760,946,129,14,143,2.914466737064414,52.58484546030855
Task_41953,2269,956,67,167,234,2.3709508881922674,46.24128157930088
Task_41954,991,791,199,96,295,1.2512626262626263,25.539070295293993
Task_41955,1324,328,118,17,135,4.024316109422492,27.823910664837555
Task_41956,1650,251,49,29,78,6.5476190476190474,32.01271019545282
Task_41957,636,592,126,101,227,1.0725126475548061,18.96792478770196
Task_41958,594,341,131,188,319,1.736842105263158,18.115699405662188
Task_41959,1504,962,150,92,242,1.5617860851505712,33.894561450746885
Task_41960,1718,851,20,95,115,2.016431924882629,36.20397303104466
Task_41961,2623,542,27,45,72,4.830570902394107,48.25958492153631
Task_41962,1113,571,37,187,224,1.9458041958041958,26.66020174176967
Task_41963,1881,679,179,118,297,2.7661764705882352,39.36603528208469
Task_41964,722,681,138,86,224,1.0586510263929618,20.520295750881996
Task_41965,2409,566,163,141,304,4.248677248677248,47.43597889138425
Task_41966,2113,376,142,80,222,5.604774535809018,41.57649334845616
Task_41967,1075,341,193,81,274,3.1432748538011697,25.273175417471943
Task_41968,874,214,119,83,202,4.065116279069767,21.39030638695438
Task_41969,2440,744,98,166,264,3.2751677852348995,48.351084699639614
Task_41970,2868,938,142,88,230,3.0543130990415337,55.409515618309065
Task_41971,1519,233,185,186,371,6.4914529914529915,32.626619593248876
Task_41972,2453,237,110,195,305,10.306722689075631,47.1104076003914
Task_41973,2561,592,17,199,216,4.318718381112985,49.57258646360486
Task_41974,2681,685,123,34,157,3.9081632653061225,50.67843702596923
Task_41975,2913,718,34,190,224,4.051460361613352,55.62468327108355
Task_41976,2854,130,74,126,200,21.786259541984734,52.21808224544782
Task_41977,1516,113,132,177,309,13.298245614035087,31.473353446472945
Task_41978,2749,365,50,122,172,7.5109289617486334,51.603139357864656
Task_41979,2482,383,91,105,196,6.463541666666667,47.45609441410363
Task_41980,2389,929,57,103,160,2.5688172043010753,47.428390729261594
Task_41981,1211,147,82,91,173,8.182432432432432,26.157111289270745
Task_41982,1552,922,107,142,249,1.6814734561213434,34.71700784732212
Task_41983,539,851,23,48,71,0.6326291079812206,16.6214501662667
Task_41984,1972,555,54,94,148,3.5467625899280577,39.64365129410893
Task_41985,2905,424,35,90,125,6.8352941176470585,53.81583694902804
Task_41986,2024,301,63,28,91,6.701986754966887,38.352733562811984
Task_41987,1163,195,99,103,202,5.933673469387755,25.992032358171446
Task_41988,1489,139,20,14,34,10.635714285714286,28.539565869117997
Task_41989,738,645,26,66,92,1.1424148606811146,19.565856530070715
Task_41990,2427,77,143,165,308,31.115384615384617,45.47167620087409
Task_41991,1488,757,120,107,227,1.963060686015831,33.05287472724613
Task_41992,1504,102,19,95,114,14.601941747572816,29.65519357697853
Task_41993,1761,648,108,105,213,2.7134052388289676,36.970344747616444
Task_41994,1699,220,102,112,214,7.6877828054298645,34.60701632808588
Task_41995,1942,837,48,131,179,2.3174224343675416,40.347926668337635
Task_41996,2104,626,134,72,206,3.3556618819776713,42.03300975220699
Task_41997,2866,522,16,155,171,5.479923518164436,53.86965952283805
Task_41998,1215,207,126,147,273,5.841346153846154,27.235748613734824
Task_41999,925,625,189,93,282,1.4776357827476039,23.88092516544482
Task_42000,1504,982,61,40,101,1.5300101729399798,32.32726328147786
Task_42001,1295,257,80,169,249,5.01937984496124,28.6488661332363
Task_42002,1197,419,37,70,107,2.85,26.306526637790626
Task_42003,1240,251,101,50,151,4.920634920634921,26.529104678441666
Task_42004,762,832,167,193,360,0.9147659063625451,22.482499699397305
Task_42005,1620,902,189,45,234,1.7940199335548173,35.0096940037249
Task_42006,1243,443,140,199,339,2.7995495495495497,28.827293399657176
Task_42007,1791,478,196,18,214,3.7390396659707723,36.20564478893937
Task_42008,2189,525,160,61,221,4.161596958174905,43.001379893263625
Task_42009,864,765,61,183,244,1.1279373368146215,23.358943326828904
Task_42010,710,945,179,61,240,0.7505285412262156,20.95641738418199
Task_42011,1856,887,168,127,295,2.09009009009009,39.62397976232973
Task_42012,2798,600,26,170,196,4.655574043261232,53.24615271947538
Task_42013,2175,921,143,63,206,2.359002169197397,44.00710802133714
Task_42014,894,151,106,52,158,5.881578947368421,20.62193242035506
Task_42015,1447,164,75,119,194,8.76969696969697,30.240834201586853
Task_42016,2913,665,186,45,231,4.373873873873874,54.73724100578858
Task_42017,1197,986,18,42,60,1.2127659574468086,27.159320586797904
Task_42018,2266,68,151,47,198,32.84057971014493,41.41938797487257
Task_42019,2551,409,169,48,217,6.221951219512195,48.160294444228434
Task_42020,1265,263,123,143,266,4.791666666666667,28.180225181929515
Task_42021,582,214,18,84,102,2.7069767441860466,15.989463183452232
Task_42022,1200,754,120,110,230,1.5894039735099337,28.456251345331623
Task_42023,2308,257,197,184,381,8.945736434108527,45.21965459917902
Task_42024,1681,170,31,179,210,9.830409356725147,33.969654452899206
Task_42025,1747,378,51,195,246,4.6094986807387865,36.26688484940775
Task_42026,1957,300,162,33,195,6.501661129568106,38.25416236216246
Task_42027,2870,425,79,111,190,6.737089201877934,53.77504975087286
Task_42028,2697,791,140,18,158,3.4053030303030303,51.178997153924236
Task_42029,1863,249,179,161,340,7.452,37.941130280434685
Task_42030,860,797,132,12,144,1.0776942355889725,22.035622705177108
Task_42031,1508,144,21,172,193,10.4,31.018596171563058
Task_42032,2740,870,53,80,133,3.145809414466131,52.729275149731876
Task_42033,2658,72,170,54,224,36.41095890410959,48.0634890128261
Task_42034,890,506,180,26,206,1.755424063116371,22.046701131402102
Task_42035,744,332,65,178,243,2.234234234234234,20.18558785900878
Task_42036,2154,728,83,96,179,2.954732510288066,43.33272787191683
Task_42037,1497,482,148,103,251,3.099378881987578,32.434310662725125
Task_42038,1218,404,112,81,193,3.0074074074074075,27.370404487628292
Task_42039,2040,321,61,137,198,6.3354037267080745,40.37979083734661
Task_42040,2242,209,148,38,186,10.676190476190476,42.39356624671868
Task_42041,1379,398,121,77,198,3.456140350877193,29.855376547063017
Task_42042,2308,693,129,18,147,3.325648414985591,44.68708190365189
Task_42043,2827,536,79,103,182,5.264432029795159,53.3750217053342
Task_42044,2613,687,163,197,360,3.79796511627907,51.38569420045216
Task_42045,2773,361,127,24,151,7.6602209944751385,50.99650619537801
Task_42046,1170,744,56,164,220,1.570469798657718,28.057193978970403
Task_42047,2919,337,28,34,62,8.636094674556213,52.22812297830877
Task_42048,1966,1013,83,49,132,1.9388560157790926,40.39722831679895
Task_42049,1411,356,118,28,146,3.9523809523809526,29.512118949590867
Task_42050,2401,995,84,50,134,2.4106425702811247,47.20594808685482
Task_42051,2589,762,185,177,362,3.3931847968545217,51.22171442319941
Task_42052,1153,810,50,43,93,1.4217016029593095,26.267175270917104
Task_42053,2532,738,122,157,279,3.4262516914749663,49.83980087140625
Task_42054,2021,708,19,171,190,2.85049365303244,41.25215416769168
Task_42055,840,994,174,168,342,0.8442211055276382,24.09789355773691
Task_42056,1106,467,137,76,213,2.3632478632478633,25.81493454034826
Task_42057,644,975,80,160,240,0.6598360655737705,20.64153619769515
Task_42058,2331,853,148,192,340,2.7295081967213113,47.34226591710293
Task_42059,1172,435,90,72,162,2.688073394495413,26.379324532362133
Task_42060,1981,649,101,15,116,3.0476923076923077,38.99801802573777
Task_42061,2786,133,108,40,148,20.791044776119403,49.92006765382365
Task_42062,2263,614,135,118,253,3.6796747967479675,45.013017566348786
Task_42063,849,169,148,97,245,4.9941176470588236,20.930967685283836
Task_42064,1130,740,73,25,98,1.524966261808367,25.752853700148453
Task_42065,1887,873,145,45,190,2.1590389016018308,38.948792149656065
Task_42066,1420,873,164,44,208,1.6247139588100687,31.65638077095845
Task_42067,993,125,145,110,255,7.880952380952381,23.01759238654395
Task_42068,1236,766,28,188,216,1.6114732724902217,29.134425620653015
Task_42069,708,608,130,95,225,1.1625615763546797,20.15236964589096
Task_42070,2327,350,88,185,273,6.62962962962963,45.31702345517639
Task_42071,1003,902,66,12,78,1.1107419712070874,23.823898207872514
Task_42072,1202,589,76,122,198,2.0372881355932204,27.956507164510725
Task_42073,2954,530,100,124,224,5.5630885122410545,55.564293757378074
Task_42074,1554,776,23,100,123,2.0,33.44276964379909
Task_42075,2103,472,67,131,198,4.446088794926005,41.871852719607894
Task_42076,1156,513,28,176,204,2.2490272373540856,27.019031795291045
Task_42077,2010,634,20,96,116,3.1653543307086616,40.15444075494981
Task_42078,1751,739,18,156,174,2.366216216216216,36.95821223703891
Task_42079,1050,499,138,50,188,2.1,24.607259532611092
Task_42080,1669,595,120,125,245,2.8003355704697985,35.52014714832514
Task_42081,1446,1001,195,183,378,1.4431137724550898,33.88336842069902
Task_42082,2758,656,28,56,84,4.197869101978691,51.34244556379809
Task_42083,1290,575,52,39,91,2.2395833333333335,27.652687957553898
Task_42084,1022,523,73,45,118,1.950381679389313,23.499885717199145
Task_42085,2700,674,187,105,292,4.0,52.281250609013604
Task_42086,1300,696,24,10,34,1.8651362984218078,27.435579710121175
Task_42087,2598,773,148,140,288,3.356589147286822,51.01112414487485
Task_42088,624,490,79,142,221,1.2708757637474541,18.552562811118793
Task_42089,1615,435,147,181,328,3.7041284403669725,34.61343512580866
Task_42090,2476,204,130,52,182,12.078048780487805,46.30101243149996
Task_42091,1463,639,79,12,91,2.2859375,30.58231326093532
Task_42092,2445,412,116,89,205,5.920096852300242,46.94210852358063
Task_42093,1708,881,190,154,344,1.9365079365079365,37.52068047130817
Task_42094,2518,1015,46,195,241,2.4783464566929134,50.40272544456527
Task_42095,802,360,72,154,226,2.221606648199446,21.070328504789458
Task_42096,1025,496,113,167,280,2.062374245472837,25.230987823448885
Task_42097,876,1021,142,195,337,0.8571428571428571,24.769548072864172
Task_42098,1037,340,168,136,304,3.0410557184750733,24.988891314238643
Task_42099,1251,195,199,29,228,6.38265306122449,26.91161967672487
Task_42100,1453,713,133,192,325,2.0350140056022408,32.927519660473244
Task_42101,1901,567,35,37,72,3.346830985915493,36.946697098524545
Task_42102,2241,151,40,22,62,14.743421052631579,40.72972462133923
Task_42103,2554,864,122,195,317,2.952601156069364,50.81071656989301
Task_42104,877,905,137,145,282,0.9679911699779249,24.101347660358744
Task_42105,951,219,56,174,230,4.322727272727272,23.024162443118783
Task_42106,819,76,139,78,217,10.636363636363637,19.455638110295155
Task_42107,2394,459,36,15,51,5.2043478260869565,44.195339332611944
Task_42108,2405,513,80,189,269,4.678988326848249,47.168672965572135
Task_42109,1974,576,15,112,127,3.4211438474870017,39.5610964785047
Task_42110,2022,277,43,131,174,7.273381294964029,39.75095064512693
Task_42111,1147,469,152,17,169,2.4404255319148938,25.73365075800639
Task_42112,1498,913,119,55,174,1.6389496717724288,33.06456218535828
Task_42113,1133,263,33,95,128,4.291666666666667,25.439920375693504
Task_42114,1587,592,135,93,228,2.6762225969645868,34.07217562028105
Task_42115,2361,513,79,82,161,4.593385214007782,45.672389696050594
Task_42116,1208,483,26,70,96,2.4958677685950414,26.49435078539462
Task_42117,1719,531,138,184,322,3.231203007518797,36.54320635246553
Task_42118,2534,569,142,182,324,4.445614035087719,49.57519421897488
Task_42119,2501,92,60,19,79,26.892473118279568,44.123082020317575
Task_42120,1334,448,13,74,87,2.9710467706013364,28.350121198763574
Task_42121,1176,783,144,187,331,1.5,28.73422792533326
Task_42122,2045,390,200,173,373,5.2301790281329925,41.46309652945465
Task_42123,2239,772,58,48,106,2.8965071151358344,43.405378523730235
Task_42124,2873,863,104,83,187,3.3252314814814814,55.01877364467122
Task_42125,668,1020,70,140,210,0.6542605288932419,21.019504892515055
Task_42126,2876,241,138,134,272,11.884297520661157,53.569670787036365
Task_42127,2832,909,143,180,323,3.112087912087912,55.36150464805049
Task_42128,2849,457,78,44,122,6.220524017467249,52.25834260304163
Task_42129,1332,837,85,144,229,1.5894988066825775,30.855279442413703
Task_42130,2563,753,128,65,193,3.3992042440318304,49.591937937842836
Task_42131,2356,487,19,172,191,4.827868852459017,45.86443717398873
Task_42132,863,422,54,149,203,2.0401891252955084,22.13057796972205
Task_42133,2636,182,20,143,163,14.404371584699453,48.85956953048785
Task_42134,2350,506,77,139,216,4.6351084812623276,45.97685473118248
Task_42135,2860,589,128,102,230,4.8474576271186445,54.26070365930631
Task_42136,2477,728,173,107,280,3.3978052126200273,48.868254079035374
Task_42137,1999,281,83,175,258,7.088652482269503,39.88920287156799
Task_42138,1605,190,91,178,269,8.403141361256544,33.35721001116665
Task_42139,685,608,58,175,233,1.1247947454844007,19.978101565398138
Task_42140,768,561,134,36,170,1.3665480427046264,20.12617938885492
Task_42141,1103,720,133,166,299,1.5298196948682385,27.207013741125596
Task_42142,2166,253,200,18,218,8.527559055118111,41.4048470168074
Task_42143,1024,818,85,143,228,1.2503052503052503,25.87667527055093
Task_42144,1148,82,91,182,273,13.831325301204819,25.320754218846506
Task_42145,502,523,78,126,204,0.9580152671755725,16.630726278280147
Task_42146,843,961,29,102,131,0.8762993762993763,22.852362584190974
Task_42147,1478,578,123,46,169,2.552677029360967,31.433602896518476
Task_42148,806,564,121,29,150,1.4265486725663716,20.55970397269802
Task_42149,516,369,164,193,357,1.3945945945945946,17.108052721273424
Task_42150,2085,274,70,70,140,7.581818181818182,40.21759984575086
Task_42151,671,342,63,79,142,1.956268221574344,18.282955633630735
Task_42152,2871,713,62,174,236,4.0210084033613445,55.029270439300205
Task_42153,2505,288,28,89,117,8.667820069204152,46.84141082596423
Task_42154,1462,203,68,173,241,7.166666666666667,31.08773768393137
Task_42155,1668,387,102,98,200,4.298969072164948,34.60612358904604
Task_42156,1622,297,151,13,164,5.442953020134228,32.73007413629161
Task_42157,956,757,84,99,183,1.2612137203166227,24.307547028988967
Task_42158,2021,619,187,77,264,3.259677419354839,41.0195067760206
Task_42159,1282,847,188,143,331,1.5117924528301887,30.547824327242946
Task_42160,1385,858,25,139,164,1.6123399301513388,31.423776896988034
Task_42161,559,534,58,110,168,1.0448598130841122,17.305569113134364
Task_42162,1659,882,152,39,191,1.8788221970554926,35.378083876013726
Task_42163,2516,553,92,135,227,4.541516245487364,48.74052459040993
Task_42164,2914,454,125,116,241,6.404395604395605,54.74769686026419
Task_42165,1163,943,66,75,141,1.2319915254237288,27.855645473855933
Task_42166,1057,352,196,117,313,2.9943342776203967,25.356499098403514
Task_42167,1183,233,132,31,163,5.055555555555555,25.641174506690067
Task_42168,2389,747,42,160,202,3.193850267379679,47.27677408505454
Task_42169,2266,857,84,113,197,2.641025641025641,45.574441895171475
Task_42170,2835,505,102,81,183,5.602766798418973,53.21184646711817
Task_42171,1518,637,26,125,151,2.3793103448275863,32.615108470891684
Task_42172,1874,382,110,163,273,4.892950391644908,38.26590286162202
Task_42173,2473,586,169,25,194,4.212947189097104,47.29938598875621
Task_42174,1437,268,95,133,228,5.342007434944238,30.73970598930701
Task_42175,1764,585,132,152,284,3.0102389078498293,37.20840620746529
Task_42176,1314,134,164,65,229,9.733333333333333,27.61590618761502
Task_42177,570,563,98,35,133,1.0106382978723405,16.739176271817765
Task_42178,1972,359,179,64,243,5.477777777777778,39.183266193931736
Task_42179,2068,650,99,31,130,3.176651305683564,40.71815949502973
Task_42180,946,383,60,24,84,2.4635416666666665,21.463013682340605
Task_42181,1114,454,119,81,200,2.4483516483516485,25.916765840109353
Task_42182,2460,105,169,12,181,23.20754716981132,44.79230025473783
Task_42183,698,72,75,179,254,9.561643835616438,18.25585712675987
Task_42184,1692,308,33,95,128,5.475728155339806,34.426962070068164
Task_42185,1206,361,105,103,208,3.3314917127071824,27.24865809639972
Task_42186,2713,676,10,178,188,4.00738552437223,52.07856009948511
Task_42187,863,360,102,163,265,2.3905817174515236,22.164322688166123
Task_42188,2405,909,66,145,211,2.642857142857143,48.11680763856901
Task_42189,1382,492,89,12,101,2.8032454361054766,28.910234452025836
Task_42190,1849,266,133,189,322,6.925093632958801,37.7395477034847
Task_42191,1680,774,133,97,230,2.167741935483871,36.1748369903779
Task_42192,1560,823,45,165,210,1.8932038834951457,34.43556531854731
Task_42193,2234,386,129,15,144,5.772609819121447,42.47975727065266
Task_42194,2617,1001,141,166,307,2.6117764471057883,52.149190015558155
Task_42195,576,738,20,64,84,0.7794316644113667,17.237038999454313
Task_42196,2233,733,43,160,203,3.042234332425068,44.76601973061673
Task_42197,2208,518,106,103,209,4.254335260115607,43.615976293164174
Task_42198,2048,280,187,175,362,7.288256227758007,41.09333771259819
Task_42199,647,537,50,129,179,1.2026022304832713,18.868510271072882
Task_42200,2960,130,177,151,328,22.595419847328245,54.417309192131405
Task_42201,733,401,53,59,112,1.8233830845771144,18.74278108242638
Task_42202,1620,907,141,63,204,1.7841409691629957,35.15151931250908
Task_42203,2775,687,139,191,330,4.03343023255814,53.80774862753558
Task_42204,838,288,148,171,319,2.8996539792387543,21.793415843967594
Task_42205,2084,83,121,172,293,24.80952380952381,40.0779583493477
Task_42206,1451,915,63,139,202,1.584061135371179,32.920071689564935
Task_42207,1020,174,91,200,291,5.828571428571428,23.98348549402911
Task_42208,1973,113,179,67,246,17.30701754385965,37.80101314809574
Task_42209,1624,1020,46,39,85,1.5905974534769833,34.35398451044834
Task_42210,1682,667,140,135,275,2.5179640718562872,36.102111195267675
Task_42211,1095,392,76,196,272,2.786259541984733,26.083537342177067
Task_42212,572,674,188,197,385,0.8474074074074074,19.099514173017116
Task_42213,2386,466,70,156,226,5.109207708779444,46.492924187780865
Task_42214,592,313,180,95,275,1.8853503184713376,17.68778949665416
Task_42215,2937,725,157,177,334,4.045454545454546,56.491700580943835
Task_42216,1857,363,118,19,137,5.101648351648351,36.39207888772154
Task_42217,1094,601,141,51,192,1.8172757475083057,25.77167864197108
Task_42218,2618,1009,82,142,224,2.592079207920792,51.822737570616795
Task_42219,2171,445,129,158,287,4.867713004484305,43.227065334115686
Task_42220,2572,135,70,51,121,18.91176470588235,46.5438920450616
Task_42221,1573,990,73,30,103,1.5872855701311805,33.598467109441536
Task_42222,763,442,44,144,188,1.7223476297968396,20.455561744888573
Task_42223,1499,901,29,130,159,1.6618625277161863,33.19898898540516
Task_42224,1722,593,94,88,182,2.898989898989899,35.927724911041544
Task_42225,2190,209,184,61,245,10.428571428571429,42.054904546131105
Task_42226,1639,256,179,56,235,6.377431906614786,33.493357210476404
Task_42227,1814,855,180,144,324,2.119158878504673,39.0144969891123
Task_42228,2907,581,197,159,356,4.994845360824742,55.63077655179126
Task_42229,2750,403,36,186,222,6.806930693069307,52.01458595493228
Task_42230,2576,479,56,144,200,5.366666666666666,49.405154804695705
Task_42231,1525,976,62,179,241,1.5609007164790174,34.516294470273486
Task_42232,779,365,190,81,271,2.128415300546448,20.6540625350865
Task_42233,2498,234,46,148,194,10.629787234042553,47.27448628001559
Task_42234,1561,586,39,179,218,2.659284497444634,33.74885393398246
Task_42235,1457,156,111,104,215,9.280254777070065,30.361429818317617
Task_42236,564,520,10,138,148,1.0825335892514396,17.079576604901046
Task_42237,2130,317,195,170,365,6.69811320754717,42.52335932811872
Task_42238,1961,183,92,70,162,10.657608695652174,37.99729584215986
Task_42239,1286,618,13,114,127,2.0775444264943457,28.793214712614144
Task_42240,660,169,83,179,262,3.8823529411764706,18.17581799773494
Task_42241,1492,714,79,187,266,2.086713286713287,33.335198262341834
Task_42242,2731,893,171,90,261,3.0548098434004474,53.26795463851975
Task_42243,2338,705,84,130,214,3.311614730878187,46.34007789868614
Task_42244,2228,971,98,79,177,2.292181069958848,45.06088263768752
Task_42245,861,476,59,49,108,1.8050314465408805,20.733964886225706
Task_42246,1128,557,183,183,366,2.021505376344086,27.46416038251425
Task_42247,2772,342,61,17,78,8.081632653061224,49.87057406959962
Task_42248,810,524,73,182,255,1.542857142857143,21.84491689140032
Task_42249,2480,144,37,198,235,17.103448275862068,46.59164600532636
Task_42250,1116,902,172,70,242,1.2358803986710964,27.327900096683567
Task_42251,2440,675,126,66,192,3.6094674556213016,47.37863031087724
Task_42252,1388,883,124,47,171,1.5701357466063348,30.976044098787032
Task_42253,2743,408,150,105,255,6.706601466992665,51.93590881028482
Task_42254,1941,199,123,177,300,9.705,38.84189085589549
Task_42255,947,575,96,62,158,1.6440972222222223,23.113955670469323
Task_42256,1920,708,110,190,300,2.708039492242595,40.19385220497683
Task_42257,1701,917,19,81,100,1.8529411764705883,35.85344673997742
Task_42258,2610,919,71,52,123,2.8369565217391304,50.309967346485685
Task_42259,1204,945,32,17,49,1.2727272727272727,26.88411297639325
Task_42260,1754,464,34,49,83,3.772043010752688,34.73239869328129
Task_42261,2807,433,57,155,212,6.467741935483871,52.9777121998327
Task_42262,1743,568,185,18,203,3.063268892794376,35.682082706616214
Task_42263,2015,296,24,136,160,6.784511784511785,39.457182992665764
Task_42264,2464,694,47,182,229,3.545323741007194,48.47538051514681
Task_42265,2031,607,21,31,52,3.3404605263157894,39.0577193907629
Task_42266,1011,645,110,128,238,1.565015479876161,25.18579182954031
Task_42267,1966,649,126,150,276,3.0246153846153847,40.5702992701629
Task_42268,2507,432,35,136,171,5.789838337182448,47.90700238638388
Task_42269,1792,671,132,185,317,2.6666666666666665,38.11956835139518
Task_42270,1641,970,65,77,142,1.690010298661174,35.52373792828571
Task_42271,677,706,139,157,296,0.9575671852899575,20.411320350136993
Task_42272,765,590,189,32,221,1.2944162436548223,20.445269921145762
Task_42273,1335,137,84,143,227,9.673913043478262,28.419545052674327
Task_42274,2210,523,115,146,261,4.217557251908397,43.96105916166425
Task_42275,2168,427,151,66,217,5.065420560747664,42.39296852787903
Task_42276,2836,82,145,77,222,34.16867469879518,51.04111020206913
Task_42277,1492,258,30,36,66,5.760617760617761,29.406117187609524
Task_42278,2202,105,200,83,283,20.77358490566038,41.76609591397692
Task_42279,1412,302,13,154,167,4.66006600660066,30.133361025977635
Task_42280,2655,487,52,87,139,5.440573770491803,50.163653138765916
Task_42281,2948,610,33,120,153,4.824877250409165,55.18713195769674
Task_42282,2049,652,110,161,271,3.1378254211332313,41.88794277960708
Task_42283,1322,361,12,129,141,3.6519337016574585,28.588914869682977
Task_42284,821,791,122,24,146,1.0366161616161615,21.51221123589346
Task_42285,977,385,156,96,252,2.5310880829015545,23.91885359150505
Task_42286,1619,794,55,106,161,2.036477987421384,34.84681277499277
Task_42287,1246,165,149,113,262,7.506024096385542,27.286261575675766
Task_42288,2192,926,39,145,184,2.364617044228695,44.56767964109994
Task_42289,760,319,188,196,384,2.375,20.98932528351207
Task_42290,2893,899,26,193,219,3.2144444444444447,55.83273883294084
Task_42291,1717,383,95,177,272,4.471354166666667,35.81147559931498
Task_42292,1620,489,22,154,176,3.306122448979592,34.099980299919366
Task_42293,1209,875,25,153,178,1.38013698630137,28.75732758973143
Task_42294,1289,755,43,189,232,1.7050264550264551,30.040065747480543
Task_42295,1527,216,149,192,341,7.0368663594470044,32.566235500411
Task_42296,2932,994,73,192,265,2.9467336683417087,57.02792123996204
Task_42297,1471,814,120,70,190,1.8049079754601227,32.45728706016801
Task_42298,1367,822,175,200,375,1.660996354799514,32.128086546957775
Task_42299,1889,173,168,52,220,10.85632183908046,36.93214199188912
Task_42300,2462,451,88,106,194,5.446902654867257,47.31587375836265
Task_42301,509,256,65,61,126,1.9805447470817121,15.080135700079145
Task_42302,1365,339,164,137,301,4.014705882352941,30.16142020121389
Task_42303,1218,678,129,120,249,1.7938144329896908,28.647843820195167
Task_42304,2288,708,75,101,176,3.227080394922426,45.37231139318076
Task_42305,1427,172,101,86,187,8.248554913294798,29.620726774559415
Task_42306,2320,625,133,73,206,3.7060702875399363,45.44295702376767
Task_42307,2846,245,86,117,203,11.56910569105691,52.73541336767358
Task_42308,1976,499,91,184,275,3.952,40.29768927455554
Task_42309,935,587,44,127,171,1.5901360544217686,23.460048213119574
Task_42310,1220,220,180,66,246,5.520361990950226,26.841987745972208
Task_42311,1667,958,26,180,206,1.7382690302398331,36.498597541493396
Task_42312,1444,995,62,37,99,1.4497991967871486,31.364314138657182
Task_42313,636,882,172,99,271,0.7202718006795017,20.18260655031237
Task_42314,1440,490,79,32,111,2.9327902240325865,29.98417567912608
Task_42315,2036,289,82,175,257,7.020689655172414,40.503673352062286
Task_42316,1321,323,173,128,301,4.077160493827161,29.400074878097232
Task_42317,520,721,169,23,192,0.7202216066481995,17.009976343788953
Task_42318,2379,391,72,20,92,6.0688775510204085,44.3149667737709
Task_42319,2913,748,51,50,101,3.889185580774366,54.08488198474641
Task_42320,833,796,72,161,233,1.0451693851944792,22.856562290940715
Task_42321,1366,233,71,139,210,5.837606837606837,29.475318161716057
Task_42322,1597,722,33,139,172,2.2088520055325036,34.447329553020275
Task_42323,2586,395,95,154,249,6.53030303030303,49.46333448859577
Task_42324,2145,1019,16,100,116,2.1029411764705883,43.48329863412905
Task_42325,1392,944,174,135,309,1.4730158730158731,32.469657486483335
Task_42326,1359,911,119,179,298,1.4901315789473684,31.870465720458654
Task_42327,1466,260,184,63,247,5.616858237547893,30.861037187805834
Task_42328,1186,468,170,42,212,2.5287846481876333,26.69006304269115
Task_42329,1404,704,63,151,214,1.9914893617021276,31.629987320745915
Task_42330,2847,64,128,190,318,43.8,52.078009264938835
Task_42331,2774,934,43,137,180,2.966844919786096,53.80395748955858
Task_42332,1349,995,134,27,161,1.354417670682731,30.549525329433127
Task_42333,1269,752,140,160,300,1.6852589641434264,29.96120657616487
Task_42334,2488,501,54,34,88,4.956175298804781,46.29665926986913
Task_42335,2117,317,74,91,165,6.6572327044025155,41.32445941665974
Task_42336,2648,227,17,127,144,11.614035087719298,49.09135510091346
Task_42337,1929,725,165,33,198,2.65702479338843,39.191117251212674
Task_42338,1150,473,87,11,98,2.4261603375527425,25.135265326552652
Task_42339,778,942,70,48,118,0.8250265111346765,21.121531933564228
Task_42340,2672,536,154,129,283,4.975791433891993,51.39193772912438
Task_42341,845,847,37,25,62,0.9964622641509434,21.157889342392508
Task_42342,643,835,198,75,273,0.7691387559808612,19.91412478563264
Task_42343,1227,845,154,79,233,1.450354609929078,29.02605089750506
Task_42344,1956,993,55,10,65,1.9678068410462777,38.875046798424584
Task_42345,2521,640,67,182,249,3.932917316692668,49.33186524162351
Task_42346,772,678,113,14,127,1.1369661266568483,20.17541300488279
Task_42347,2154,597,129,152,281,3.6020066889632107,43.40895428354562
Task_42348,2595,302,83,24,107,8.564356435643564,47.53980878706389
Task_42349,2047,562,105,183,288,3.635879218472469,41.68045648964523
Task_42350,1423,557,116,14,130,2.550179211469534,30.107029673688093
Task_42351,1544,229,99,112,211,6.71304347826087,32.17948052878017
Task_42352,2696,868,164,164,328,3.102416570771001,53.07730807266254
Task_42353,789,564,91,26,117,1.3964601769911504,19.950836838352235
Task_42354,2869,795,111,181,292,3.6042713567839195,55.45182543264218
Task_42355,2595,977,167,89,256,2.6533742331288344,51.340437765033585
Task_42356,554,157,183,188,371,3.5063291139240507,16.96018953746862
Task_42357,2166,152,29,80,109,14.156862745098039,40.34571717461592
Task_42358,1294,986,174,23,197,1.3110435663627154,29.89058617709141
Task_42359,1006,114,63,194,257,8.747826086956522,23.276458564041025
Task_42360,1100,951,126,152,278,1.1554621848739495,27.734513319446915
Task_42361,1642,741,100,89,189,2.2129380053908356,35.20017363188979
Task_42362,2774,251,62,132,194,11.007936507936508,51.708860635015945
Task_42363,916,445,50,197,247,2.0538116591928253,23.338652136345654
Task_42364,988,324,17,183,200,3.04,23.720794887781143
Task_42365,1379,493,14,71,85,2.791497975708502,29.160600884573483
Task_42366,2635,949,55,127,182,2.7736842105263158,51.68350039964789
Task_42367,551,509,195,32,227,1.080392156862745,16.837711483943576
Task_42368,2444,595,12,86,98,4.100671140939597,46.55303159513988
Task_42369,1176,575,53,139,192,2.0416666666666665,27.50393041171023
Task_42370,974,412,164,88,252,2.358353510895884,23.85785993889661
Task_42371,2320,208,182,149,331,11.10047846889952,44.94872638113262
Task_42372,2172,884,57,63,120,2.454237288135593,43.27749762998053
Task_42373,1138,693,89,64,153,1.6397694524495676,26.447327687064472
Task_42374,1259,856,95,40,135,1.4690781796966161,28.572519026636925
Task_42375,946,752,143,189,332,1.2563081009296149,24.980005924827626
Task_42376,2977,873,120,95,215,3.4061784897025174,56.94837538668832
Task_42377,2700,537,143,107,250,5.018587360594796,51.657514016391985
Task_42378,2778,585,116,31,147,4.7406143344709895,51.878505344531455
Task_42379,1889,415,58,131,189,4.540865384615385,38.25210614961578
Task_42380,1893,183,157,173,330,10.28804347826087,38.07043089414001
Task_42381,946,544,29,172,201,1.7357798165137615,23.77089890388429
Task_42382,1362,912,30,44,74,1.4917853231106244,29.4608939770627
Task_42383,1095,554,14,113,127,1.972972972972973,25.57432680016692
Task_42384,2455,757,84,151,235,3.2387862796833775,48.48252371712545
Task_42385,2374,713,164,121,285,3.3249299719887957,47.23246233151281
Task_42386,1667,746,199,113,312,2.2315930388219547,36.24614933705692
Task_42387,864,372,154,30,184,2.316353887399464,21.13381951709272
Task_42388,2439,723,69,172,241,3.3687845303867405,48.24250008361144
Task_42389,1006,829,138,145,283,1.2120481927710844,25.883931687690083
Task_42390,2911,830,87,37,124,3.503008423586041,54.49322464971396
Task_42391,2874,177,132,50,182,16.146067415730336,52.058342249675185
Task_42392,2196,588,18,61,79,3.7283531409168083,42.02298630271175
Task_42393,2012,846,30,35,65,2.375442739079103,39.510438765487294
Task_42394,1353,412,23,98,121,3.276029055690073,29.08342056675981
Task_42395,638,606,48,83,131,1.0510708401976936,18.54008131889313
Task_42396,2385,555,159,93,252,4.289568345323741,46.69964506312442
Task_42397,759,461,136,138,274,1.6428571428571428,20.827475672407566
Task_42398,1466,422,167,33,200,3.465721040189125,30.911078913921642
Task_42399,2448,370,140,103,243,6.598382749326146,47.08421176946079
Task_42400,1245,286,175,119,294,4.337979094076655,28.031864118810372
Task_42401,1461,853,38,190,228,1.7107728337236534,33.04642067290339
Task_42402,1509,191,79,97,176,7.859375,31.36885578811462
Task_42403,2046,497,187,177,364,4.108433734939759,41.79099205839884
Task_42404,2727,427,138,70,208,6.371495327102804,51.20494756968012
Task_42405,788,713,171,29,200,1.1036414565826331,21.102398379340993
Task_42406,2982,608,190,117,307,4.896551724137931,56.62265476244708
Task_42407,622,904,110,185,295,0.687292817679558,20.297287969986552
Task_42408,582,429,50,17,67,1.3534883720930233,15.431593140328864
Task_42409,662,337,194,44,238,1.9585798816568047,18.096765768462152
Task_42410,2208,753,31,132,163,2.9283819628647216,44.133723745218276
Task_42411,2368,599,132,116,248,3.9466666666666668,46.60280635691504
Task_42412,2297,230,130,197,327,9.943722943722944,44.722089622386385
Task_42413,605,87,177,59,236,6.875,16.04182822360506
Task_42414,990,763,161,99,260,1.2958115183246073,25.252060161846074
Task_42415,2159,360,113,132,245,5.980609418282548,42.530367998962966
Task_42416,2894,145,36,38,74,19.82191780821918,51.11901774975962
Task_42417,1305,491,54,163,217,2.652439024390244,29.42811014139863
Task_42418,2049,532,91,176,267,3.844277673545966,41.511073274865545
Task_42419,2617,846,88,89,177,3.089728453364817,50.871483920913086
Task_42420,2527,840,32,103,135,3.004756242568371,49.15177788589171
Task_42421,2328,871,96,179,275,2.669724770642202,47.046654349069655
Task_42422,1278,983,100,127,227,1.298780487804878,30.395368387633635
Task_42423,1631,661,44,46,90,2.4637462235649545,33.381885123614936
Task_42424,2920,922,117,142,259,3.1635969664138677,56.45244184706206
Task_42425,618,618,175,143,318,0.9983844911147012,19.255719591345485
Task_42426,2460,236,60,65,125,10.379746835443038,45.88041600465218
Task_42427,2568,455,189,50,239,5.631578947368421,48.73934357495338
Task_42428,1507,921,46,57,103,1.6344902386117137,32.541696170298884
Task_42429,2713,289,158,108,266,9.355172413793104,51.10632390755552
Task_42430,1479,945,103,169,272,1.5634249471458774,33.745566442686005
Task_42431,762,193,189,129,318,3.9278350515463916,20.208731111532668
Task_42432,876,878,56,183,239,0.9965870307167235,23.877740663621168
Task_42433,2306,466,36,160,196,4.937901498929336,45.03939730567047
Task_42434,715,280,32,174,206,2.5444839857651247,19.315851031573224
Task_42435,1034,446,117,38,155,2.3131991051454137,23.845085659316414
Task_42436,2370,876,168,89,257,2.7023945267958953,47.46443048466781
Task_42437,1100,719,90,171,261,1.5277777777777777,26.99082984327586
Task_42438,611,373,95,74,169,1.6336898395721926,17.446521770707616
Task_42439,2276,167,199,15,214,13.547619047619047,42.618395181627655
Task_42440,1417,814,107,87,194,1.7386503067484662,31.854697950691563
Task_42441,2088,639,181,29,210,3.2625,41.4907975935542
Task_42442,1630,482,104,53,157,3.3747412008281574,33.6759253178696
Task_42443,1414,857,146,157,303,1.648018648018648,32.59393890650349
Task_42444,983,911,44,14,58,1.0778508771929824,23.3997518674155
Task_42445,693,712,139,176,315,0.9719495091164095,20.78315263783641
Task_42446,1063,750,177,137,314,1.4154460719041277,26.680506824397725
Task_42447,2748,214,20,64,84,12.78139534883721,49.80154999652559
Task_42448,688,524,132,177,309,1.3104761904761906,20.08168351932298
Task_42449,2892,771,72,47,119,3.7461139896373057,53.94534271091508
Task_42450,2945,692,100,116,216,4.24963924963925,55.89264498080136
Task_42451,2480,264,143,21,164,9.358490566037736,46.19157720732634
Task_42452,2979,703,52,133,185,4.231534090909091,56.38999248020309
Task_42453,768,266,47,68,115,2.8764044943820224,19.183622520507075
Task_42454,505,413,124,98,222,1.2198067632850242,16.32087395798037
Task_42455,1960,428,130,198,328,4.568764568764569,40.07587049566731
Task_42456,1437,847,84,124,208,1.6945754716981132,32.46062717578158
Task_42457,2150,898,76,125,201,2.3915461624026695,43.957065494956076
Task_42458,1914,271,82,144,226,7.036764705882353,38.32764231390884
Task_42459,1921,775,169,80,249,2.475515463917526,39.928898610368606
Task_42460,2570,373,29,145,174,6.871657754010696,48.75527229138576
Task_42461,2215,146,25,85,110,15.068027210884354,41.101011691785686
Task_42462,1269,179,162,21,183,7.05,26.644916597633934
Task_42463,1262,288,165,141,306,4.366782006920415,28.393563192961906
Task_42464,1186,625,183,194,377,1.8945686900958467,28.661031828248323
Task_42465,1254,911,32,86,118,1.375,28.99417720384231
Task_42466,569,1002,161,103,264,0.5672981056829511,19.487576899309854
Task_42467,2646,223,127,132,259,11.8125,49.80548211200878
Task_42468,703,824,78,189,267,0.8521212121212122,21.125766595365203
Task_42469,1491,519,44,130,174,2.8673076923076923,32.13997923336766
Task_42470,2134,379,12,22,34,5.61578947368421,39.68815444457897
Task_42471,942,127,16,119,135,7.359375,21.24192758020282
Task_42472,977,847,115,195,310,1.1521226415094339,25.67085959939914
Task_42473,2113,1019,60,154,214,2.0715686274509806,43.850844509559785
Task_42474,2189,534,17,21,38,4.091588785046729,41.08962084443288
Task_42475,1835,726,180,10,190,2.5240715268225586,37.56917852086238
Task_42476,2524,270,15,172,187,9.313653136531366,47.75831609372125
Task_42477,2938,130,86,186,272,22.427480916030536,53.8374740562613
Task_42478,2592,641,199,77,276,4.037383177570093,50.18664946187085
Task_42479,1582,759,95,75,170,2.081578947368421,34.034675847917136
Task_42480,2189,271,124,125,249,8.047794117647058,42.7077576562282
Task_42481,852,407,129,150,279,2.088235294117647,22.183180128103704
Task_42482,1446,250,136,35,171,5.760956175298805,29.854850445914668
Task_42483,2748,754,58,139,197,3.639735099337748,52.98585611954456
Task_42484,1663,479,171,165,336,3.464583333333333,35.52654095670693
Task_42485,1975,947,63,116,179,2.0833333333333335,41.19866785414691
Task_42486,2022,724,188,141,329,2.788965517241379,41.9186636768941
Task_42487,1937,157,62,182,244,12.259493670886076,38.21959963179486
Task_42488,1400,221,187,200,387,6.306306306306307,30.79759518714994
Task_42489,1142,733,150,38,188,1.555858310626703,26.705439543670384
Task_42490,765,625,117,102,219,1.2220447284345048,21.081971849873728
Task_42491,1787,258,16,36,52,6.899613899613899,34.06810451717256
Task_42492,1315,767,23,111,134,1.7122395833333333,29.71252314472183
Task_42493,1688,428,46,199,245,3.9347319347319347,35.43230672493191
Task_42494,1324,110,175,161,336,11.927927927927929,28.52088591399159
Task_42495,812,994,44,78,122,0.8160804020100503,22.239575893969416
Task_42496,838,587,108,166,274,1.4251700680272108,22.47220072943397
Task_42497,2146,734,107,199,306,2.919727891156463,43.895702560567976
Task_42498,2846,759,86,185,271,3.7447368421052634,54.84553902770198
Task_42499,809,260,62,38,100,3.099616858237548,19.083858130196354
Task_42500,2177,966,114,175,289,2.25129265770424,44.99967157706271
Task_42501,2780,130,61,108,169,21.221374045801525,50.70826021610129
Task_42502,1990,90,196,194,390,21.86813186813187,39.13301494451799
Task_42503,2939,503,101,73,174,5.8313492063492065,54.68193638644334
Task_42504,1896,570,193,123,316,3.320490367775832,39.35299095445956
Task_42505,1117,949,157,67,224,1.1757894736842105,27.41085088250118
Task_42506,1905,827,68,169,237,2.300724637681159,40.086736527678866
Task_42507,2195,968,67,36,103,2.265221878224974,43.346477108535304
Task_42508,2156,475,156,78,234,4.529411764705882,42.607619117337855
Task_42509,1901,686,89,63,152,2.7671033478893743,38.50729430150642
Task_42510,2617,485,103,193,296,5.38477366255144,50.50860827380558
Task_42511,1360,535,123,175,298,2.537313432835821,30.750335128387118
Task_42512,1695,348,153,116,269,4.856733524355301,35.235546604871466
Task_42513,596,725,18,97,115,0.8209366391184573,17.968975578438002
Task_42514,1082,382,170,50,220,2.825065274151436,24.901310348299038
Task_42515,1676,866,89,105,194,1.9331026528258362,36.198078729993874
Task_42516,2929,719,130,17,147,4.0680555555555555,54.60226449569361
Task_42517,876,664,163,140,303,1.3172932330827067,23.413057415367177
Task_42518,2853,850,105,182,287,3.3525264394829613,55.35006409215462
Task_42519,1316,746,97,193,290,1.7617135207496653,30.698098212838165
Task_42520,2735,869,162,32,194,3.1436781609195403,52.39926561240873
Task_42521,2763,1023,129,184,313,2.6982421875,54.58488151541079
Task_42522,1072,952,169,35,204,1.1248688352570828,26.35475737139666
Task_42523,1405,378,164,43,207,3.70712401055409,29.847599299134657
Task_42524,798,69,162,128,290,11.4,19.83228425317373
Task_42525,1788,641,133,77,210,2.7850467289719627,37.15523161528543
Task_42526,2304,95,21,171,192,24.0,43.09415345573956
Task_42527,641,71,60,133,193,8.902777777777779,16.98677567079564
Task_42528,594,820,53,80,133,0.7235079171741778,18.690987185767565
Task_42529,901,349,41,56,97,2.5742857142857143,21.09305068310573
Task_42530,2402,920,99,107,206,2.6080347448425623,47.9496303925985
Task_42531,799,675,127,44,171,1.1819526627218935,20.987443779771155
Task_42532,1872,828,184,157,341,2.2581423401688783,39.94498966102036
Task_42533,2955,602,183,42,225,4.900497512437811,55.184665617732456
Task_42534,1862,325,41,50,91,5.711656441717792,36.06991284703735
Task_42535,1651,334,48,33,81,4.928358208955224,32.56814974907481
Task_42536,2217,1021,120,22,142,2.1692759295499022,44.225160649300484
Task_42537,504,74,83,74,157,6.72,13.974640435441705
Task_42538,1446,309,81,194,275,4.664516129032258,31.363485658730855
Task_42539,2604,699,109,55,164,3.72,49.90268750441688
Task_42540,1565,546,76,159,235,2.8610603290676417,33.790479654676076
Task_42541,776,352,200,142,342,2.198300283286119,21.07894568267767
Task_42542,2482,821,189,151,340,3.019464720194647,49.574463588703225
Task_42543,2047,317,148,122,270,6.437106918238993,40.71232419317669
Task_42544,2244,385,139,102,241,5.813471502590674,43.89621577142899
Task_42545,2498,95,39,105,144,26.020833333333332,45.435543344342655
Task_42546,2606,610,186,108,294,4.265139116202946,50.60255960345226
Task_42547,1752,553,66,148,214,3.1624548736462095,36.67330108337659
Task_42548,903,263,186,200,386,3.4204545454545454,23.083894956492315
Task_42549,2474,95,199,47,246,25.770833333333332,45.165843000338384
Task_42550,1405,728,77,157,234,1.9272976680384089,31.819427787745393
Task_42551,2317,500,56,12,68,4.624750499001996,43.06631192244049
Task_42552,2424,851,21,190,211,2.8450704225352115,48.20689859549268
Task_42553,1097,737,144,51,195,1.486449864498645,26.25249576474852
Task_42554,1683,919,99,169,268,1.8293478260869565,36.92380559733861
Task_42555,1950,968,157,179,336,2.0123839009287927,41.62643037219555
Task_42556,2154,564,93,156,249,3.8123893805309734,43.204256670227984
Task_42557,2186,919,107,50,157,2.376086956521739,43.65645820896406
Task_42558,818,420,116,170,286,1.9429928741092637,21.74698071922735
Task_42559,2146,509,147,198,345,4.207843137254902,43.357758934292285
Task_42560,1583,205,146,23,169,7.684466019417476,31.79464716378065
Task_42561,1298,341,128,138,266,3.7953216374269005,28.951937996886766
Task_42562,2952,800,69,176,245,3.6853932584269664,56.63581764467744
Task_42563,2516,161,23,33,56,15.530864197530864,45.26339879070196
Task_42564,1274,777,118,76,194,1.6375321336760926,29.358640382535913
Task_42565,2969,922,86,97,183,3.2166847237269773,56.78404784198992
Task_42566,1452,200,17,10,27,7.223880597014926,28.198863147205174
Task_42567,820,290,115,124,239,2.8178694158075603,21.085861907056586
Task_42568,1177,643,188,157,345,1.8276397515527951,28.376214067263135
Task_42569,985,522,174,186,360,1.8833652007648183,25.067674025028907
Task_42570,2416,201,45,65,110,11.96039603960396,44.858675057385
Task_42571,2992,660,97,29,126,4.526475037821482,55.3496822896544
Task_42572,2167,981,30,113,143,2.206720977596741,43.94832109805609
Task_42573,2156,850,39,53,92,2.533490011750881,42.54977050511048
Task_42574,1131,413,57,193,250,2.7318840579710146,26.615989266805858
Task_42575,1654,188,14,119,133,8.751322751322752,33.257585544561415
Task_42576,1383,375,148,64,212,3.6781914893617023,29.777914869505405
Task_42577,2685,557,82,138,220,4.811827956989247,51.436606579187384
Task_42578,2269,338,52,36,88,6.6932153392330385,42.31973447329085
Task_42579,2988,113,178,46,224,26.210526315789473,53.454115467472946
Task_42580,2759,496,161,86,247,5.551307847082495,52.34830650122304
Task_42581,2610,988,43,190,233,2.639029322548028,51.71605765319856
Task_42582,750,480,57,191,248,1.5592515592515592,20.745722133461594
Task_42583,2894,160,19,88,107,17.975155279503106,51.925982436015666
Task_42584,2783,644,192,71,263,4.314728682170543,53.077954409515485
Task_42585,2428,560,185,163,348,4.327985739750446,47.94823098840033
Task_42586,1522,349,55,134,189,4.348571428571429,32.23469418583419
Task_42587,2303,236,42,48,90,9.717299578059071,42.66703914963088
Task_42588,2900,82,13,98,111,34.93975903614458,51.35506198357955
Task_42589,2338,694,83,24,107,3.3640287769784174,44.75052307946684
Task_42590,2707,737,133,129,262,3.668021680216802,52.49123873724043
Task_42591,2648,288,62,67,129,9.162629757785467,49.20683870381819
Task_42592,1097,540,179,97,276,2.0277264325323476,26.416718866106407
Task_42593,757,353,137,193,330,2.138418079096045,20.802247285054072
Task_42594,2855,782,85,182,267,3.6462324393358876,55.083916695935706
Task_42595,1272,384,97,71,168,3.303896103896104,27.871645293825736
Task_42596,1566,833,83,114,197,1.8776978417266188,34.43595502659988
Task_42597,2508,972,175,52,227,2.5775950668037,49.544055015381694
Task_42598,1769,425,112,63,175,4.152582159624413,35.846263192873316
Task_42599,2819,384,96,64,160,7.322077922077922,52.164454765454515
Task_42600,2496,288,174,21,195,8.636678200692042,46.65552286414381
Task_42601,858,189,167,195,362,4.515789473684211,22.015670179319972
Task_42602,627,406,187,195,382,1.5405405405405406,19.107076826003745
Task_42603,1392,185,49,194,243,7.483870967741935,29.89333538038233
Task_42604,890,489,142,66,208,1.816326530612245,22.32161435245167
Task_42605,1316,724,109,196,305,1.8151724137931033,30.70733319209393
Task_42606,876,881,18,153,171,0.9931972789115646,23.400320991071425
Task_42607,2020,194,45,57,102,10.35897435897436,38.33133998339488
Task_42608,1964,128,36,89,125,15.224806201550388,37.240744940585394
Task_42609,1320,97,114,13,127,13.46938775510204,26.237531757934658
Task_42610,2606,277,145,44,189,9.37410071942446,48.40885224621792
Task_42611,1192,895,55,144,199,1.3303571428571428,28.734871999737546
Task_42612,2003,739,191,126,317,2.7067567567567568,41.58862356745911
Task_42613,1265,196,116,67,183,6.4213197969543145,27.180683605705365
Task_42614,1901,933,102,21,123,2.0353319057815846,38.741169624382245
Task_42615,2525,777,21,108,129,3.2455012853470437,48.966063455784685
Task_42616,2251,241,35,26,61,9.301652892561984,41.343567601450474
Task_42617,1014,605,185,110,295,1.6732673267326732,25.368469469819633
Task_42618,2866,650,158,58,216,4.402457757296467,54.110177058958435
Task_42619,2347,965,50,146,196,2.429606625258799,47.32696673196588
Task_42620,2698,472,88,79,167,5.704016913319239,50.84451179401205
Task_42621,2289,148,181,105,286,15.36241610738255,43.75934577712557
Task_42622,1327,483,20,198,218,2.7417355371900825,29.721992152885736
Task_42623,1196,561,98,27,125,2.1281138790035588,26.50116607887092
Task_42624,862,920,34,110,144,0.9359391965255157,23.04522170271206
Task_42625,1124,598,110,94,204,1.8764607679465777,26.661839406845193
Task_42626,896,606,76,162,238,1.4761120263591434,23.353016210682355
Task_42627,1068,110,52,182,234,9.621621621621621,24.098644141226714
Task_42628,1898,336,92,105,197,5.632047477744807,38.0736033632645
Task_42629,783,360,178,91,269,2.1689750692520775,20.756334282428735
Task_42630,900,459,170,103,273,1.9565217391304348,23.01064987871547
Task_42631,1926,414,140,118,258,4.6409638554216865,39.05957687513456
Task_42632,2645,957,149,181,330,2.7609603340292277,52.58133074605062
Task_42633,1789,489,191,195,386,3.6510204081632653,37.82239952071058
Task_42634,1888,82,62,63,125,22.746987951807228,35.444529696967614
Task_42635,2231,894,119,42,161,2.492737430167598,44.23228283198484
Task_42636,955,881,86,83,169,1.082766439909297,24.443115847783474
Task_42637,2000,211,72,173,245,9.433962264150944,39.615621114969656
Task_42638,686,924,58,125,183,0.7416216216216216,20.668606936278856
Task_42639,2093,139,167,175,342,14.95,40.91863681416681
Task_42640,2912,479,31,42,73,6.066666666666666,52.666587457234165
Task_42641,873,234,47,22,69,3.7148936170212767,19.49152637434344
Task_42642,718,81,147,82,229,8.75609756097561,18.05387081462774
Task_42643,1252,610,139,51,190,2.049099836333879,28.28999497215686
Task_42644,1757,265,138,169,307,6.605263157894737,36.18520883795962
Task_42645,825,473,130,119,249,1.740506329113924,21.769257663380852
Task_42646,2092,666,14,174,188,3.136431784107946,42.228166592084705
Task_42647,2997,684,137,70,207,4.375182481751825,56.30520648286089
Task_42648,1157,367,98,129,227,3.1440217391304346,26.620774558112014
Task_42649,2372,855,58,57,115,2.7710280373831777,46.1495774243455
Task_42650,2124,205,167,28,195,10.310679611650485,40.54358804414443
Task_42651,1239,919,141,163,304,1.3467391304347827,29.993238404044856
Task_42652,1648,328,175,123,298,5.009118541033435,34.56705462630254
Task_42653,928,337,66,80,146,2.7455621301775146,22.39504864713919
Task_42654,828,456,200,173,373,1.811816192560175,22.41490186133683
Task_42655,1830,163,132,102,234,11.158536585365853,36.34413978018307
Task_42656,2824,130,198,128,326,21.557251908396946,52.233587857587075
Task_42657,1949,798,20,114,134,2.439299123904881,39.86416817064008
Task_42658,2064,356,13,187,200,5.781512605042017,40.86809767748286
Task_42659,2883,190,130,34,164,15.094240837696335,52.409173765116854
Task_42660,2679,437,15,89,104,6.116438356164384,49.90753953170136
Task_42661,2309,194,142,189,331,11.841025641025642,44.76766176754838
Task_42662,2304,1003,156,134,290,2.2948207171314743,47.07175459399955
Task_42663,2622,932,116,110,226,2.810289389067524,51.566010754420745
Task_42664,1638,903,78,125,203,1.8119469026548674,35.868842911225585
Task_42665,2092,548,179,68,247,3.8105646630236794,41.71879140534802
Task_42666,2783,773,154,24,178,3.595607235142119,52.70915360288791
Task_42667,2094,351,20,89,109,5.948863636363637,40.4546325871349
Task_42668,2660,333,142,25,167,7.9640718562874255,49.294719274905134
Task_42669,2200,453,123,143,266,4.845814977973569,43.59539709521514
Task_42670,1963,250,140,186,326,7.820717131474104,39.49822618429602
Task_42671,1205,401,96,68,164,2.9975124378109452,26.854212415310386
Task_42672,2512,181,98,32,130,13.802197802197803,45.985115058431354
Task_42673,1913,217,111,193,304,8.775229357798166,38.49967571329975
Task_42674,1554,359,110,130,240,4.316666666666666,32.931046238295124
Task_42675,2924,181,31,121,152,16.065934065934066,52.937600772035374
Task_42676,532,900,170,71,241,0.5904550499445061,18.310033772773423
Task_42677,1870,125,117,63,180,14.841269841269842,36.018925522220975
Task_42678,571,322,64,53,117,1.7678018575851393,15.952270027531469
Task_42679,1678,149,174,190,364,11.186666666666667,34.61216524640134
Task_42680,2519,591,192,143,335,4.2550675675675675,49.40031993173536
Task_42681,1558,210,89,69,158,7.38388625592417,31.58838726539902
Task_42682,622,927,151,148,299,0.6702586206896551,20.332896802628557
Task_42683,696,326,87,157,244,2.128440366972477,19.271627820841598
Task_42684,1064,741,115,148,263,1.4339622641509433,26.45470168127572
Task_42685,1788,955,33,14,47,1.8702928870292888,36.09562082269996
Task_42686,1939,512,194,57,251,3.779727095516569,39.14733330691258
Task_42687,1880,641,143,71,214,2.9283489096573208,38.54562639131962
Task_42688,2431,891,117,144,261,2.725336322869955,48.61905390577113
Task_42689,1259,144,84,166,250,8.682758620689656,27.439308888901838
Task_42690,832,510,144,100,244,1.6281800391389432,21.94546922912956
Task_42691,2937,314,82,41,123,9.323809523809524,53.19866785361637
Task_42692,1352,722,96,37,133,1.8699861687413555,29.65303526142925
Task_42693,2674,588,106,54,160,4.539898132427844,50.514500538501956
Task_42694,581,994,141,112,253,0.5839195979899497,19.64235311155617
Task_42695,2863,750,153,95,248,3.8122503328894806,54.90408081086807
Task_42696,1310,315,149,184,333,4.1455696202531644,29.42622029396124
Task_42697,2513,740,189,196,385,3.3913630229419702,50.08002748111742
Task_42698,1452,259,11,122,133,5.584615384615384,30.302228753523735
Task_42699,520,519,20,137,157,1.0,16.398804449086217
Task_42700,1654,95,47,165,212,17.229166666666668,33.003598870314136
Task_42701,2433,836,11,71,82,2.9068100358422937,46.869411307508976
Task_42702,1828,527,42,87,129,3.462121212121212,37.19135427779663
Task_42703,2367,979,98,45,143,2.4153061224489796,46.54116167479311
Task_42704,1689,426,11,143,154,3.9555035128805622,34.6494074645802
Task_42705,1387,934,193,99,292,1.483422459893048,32.23518042840155
Task_42706,1187,367,148,123,271,3.2255434782608696,27.280649302535625
Task_42707,1601,764,92,141,233,2.09281045751634,34.94939597146782
Task_42708,520,437,46,133,179,1.187214611872146,16.48480405058431
Task_42709,1457,340,160,36,196,4.2727272727272725,30.485164296225765
Task_42710,1868,456,138,70,208,4.087527352297593,37.70397380141221
Task_42711,2298,213,11,118,129,10.738317757009346,43.50651179298213
Task_42712,2809,651,140,133,273,4.308282208588957,53.890114944910295
Task_42713,1457,134,159,114,273,10.792592592592593,30.47486812512422
Task_42714,2887,396,101,151,252,7.272040302267002,54.228250366440555
Task_42715,770,824,23,88,111,0.9333333333333333,21.00738975039717
Task_42716,1753,582,65,167,232,3.006861063464837,36.88211618258773
Task_42717,1321,349,18,125,143,3.7742857142857145,28.55878949034577
Task_42718,2741,563,96,100,196,4.859929078014185,52.144397762806456
Task_42719,2726,76,149,31,180,35.4025974025974,48.65292078978879
Task_42720,1906,830,173,31,204,2.2936221419975933,39.18607399539115
Task_42721,1362,619,120,191,311,2.196774193548387,31.12780496404275
Task_42722,1943,366,134,165,299,5.294277929155314,39.42502402088531
Task_42723,992,994,20,143,163,0.9969849246231156,25.54059817597083
Task_42724,674,529,43,176,219,1.271698113207547,19.454515673200003
Task_42725,1843,722,120,122,242,2.549100968188105,38.65688625666479
Task_42726,2263,851,199,172,371,2.6561032863849765,46.36900335853691
Task_42727,2357,635,48,78,126,3.7059748427672954,45.85012710798967
Task_42728,1094,130,79,84,163,8.351145038167939,24.071328897708053
Task_42729,2011,777,110,31,141,2.5848329048843186,40.2633032331127
Task_42730,870,652,184,71,255,1.332312404287902,22.750924325726185
Task_42731,775,178,167,83,250,4.329608938547486,19.68038260073217
Task_42732,2229,367,69,29,98,6.057065217391305,41.99737377268787
Task_42733,1526,606,134,84,218,2.514003294892916,33.03371590568663
Task_42734,1398,773,85,10,95,1.806201550387597,30.011216894551925
Task_42735,536,761,112,159,271,0.7034120734908137,18.323918922015647
Task_42736,2297,185,40,48,88,12.349462365591398,42.39379283878997
Task_42737,895,860,112,158,270,1.0394889663182345,24.18614049257414
Task_42738,2597,929,77,185,262,2.79247311827957,51.49963571031233
Task_42739,1607,283,191,167,358,5.658450704225352,34.102986543498574
Task_42740,870,639,90,197,287,1.359375,23.238079344430574
Task_42741,1391,392,37,74,111,3.539440203562341,29.493651954127056
Task_42742,1582,502,94,113,207,3.1451292246520874,33.67008190550371
Task_42743,745,782,40,18,58,0.9514687100893997,19.34642981888905
Task_42744,2744,114,61,117,178,23.860869565217392,50.07798655448099
Task_42745,1045,123,108,24,132,8.42741935483871,22.408517384322938
Task_42746,2421,757,51,89,140,3.1939313984168867,47.347107664580655
Task_42747,638,399,115,181,296,1.595,18.88034594392261
Task_42748,2303,493,115,159,274,4.661943319838056,45.41468586743711
Task_42749,2177,336,198,86,284,6.459940652818991,42.77655911565489
Task_42750,1957,987,26,45,71,1.9807692307692308,39.11250102710745
Task_42751,600,461,53,99,152,1.2987012987012987,17.495242360986946
Task_42752,1042,366,120,19,139,2.8392370572207084,23.528278130161407
Task_42753,2102,496,183,135,318,4.229376257545272,42.40543488253665
Task_42754,1188,227,86,41,127,5.2105263157894735,25.35560610926647
Task_42755,1128,271,68,33,101,4.147058823529412,24.275905723721582
Task_42756,2004,912,138,141,279,2.1949616648411827,41.99531425429175
Task_42757,2417,941,51,188,239,2.5658174097664546,48.61677741678866
Task_42758,1585,587,183,112,295,2.695578231292517,34.37101681904811
Task_42759,852,1023,171,157,328,0.83203125,24.298402501430076
Task_42760,1311,572,195,190,385,2.287958115183246,30.504879590744476
Task_42761,1035,306,146,132,278,3.3713355048859937,24.724353595508223
Task_42762,2139,750,112,198,310,2.848202396804261,43.851558594870006
Task_42763,637,606,36,47,83,1.0494233937397035,17.503452709669123
Task_42764,584,68,93,48,141,8.46376811594203,14.673585871393849
Task_42765,2399,908,94,181,275,2.639163916391639,48.29272068154367
Task_42766,1575,333,97,11,108,4.7155688622754495,31.538691066073728
Task_42767,907,415,128,59,187,2.1802884615384617,22.18836278535699
Task_42768,2881,890,20,84,104,3.2334455667789,54.564255321968375
Task_42769,2478,936,56,46,102,2.644610458911419,47.632821297674944
Task_42770,1454,203,40,126,166,7.127450980392157,30.456715704747683
Task_42771,1967,766,18,57,75,2.564537157757497,38.826229342228466
Task_42772,966,218,66,176,242,4.410958904109589,23.322477733972107
Task_42773,1522,536,55,22,77,2.834264432029795,30.729617309081675
Task_42774,2162,423,49,134,183,5.099056603773585,42.56735247032418
Task_42775,828,530,32,134,166,1.5593220338983051,21.58378177231143
Task_42776,560,927,73,13,86,0.603448275862069,17.611908136130996
Task_42777,1189,178,165,115,280,6.64245810055866,26.46196053611362
Task_42778,2483,431,125,117,242,5.747685185185185,47.85641961050831
Task_42779,1873,605,31,66,97,3.0907590759075907,37.41152578210489
Task_42780,2361,470,24,182,206,5.012738853503185,45.973157868329
Task_42781,1489,125,105,111,216,11.817460317460318,30.649239160241482
Task_42782,2233,530,176,79,255,4.2052730696798495,44.120160721740525
Task_42783,2352,184,104,75,179,12.713513513513513,44.342822218422064
Task_42784,2971,875,86,35,121,3.391552511415525,55.52474708535197
Task_42785,1657,487,69,66,135,3.3954918032786887,34.133453171858
Task_42786,1189,840,126,156,282,1.4137931034482758,28.839657105857068
Task_42787,2517,289,189,126,315,8.679310344827586,48.25509412759228
Task_42788,1074,244,54,64,118,4.383673469387755,23.874774816815293
Task_42789,2927,680,39,107,146,4.298091042584435,55.07447091322558
Task_42790,1280,1024,153,22,175,1.248780487804878,29.662151666264165
Task_42791,1420,909,55,167,222,1.5604395604395604,32.54390332022042
Task_42792,1440,394,178,76,254,3.6455696202531644,31.053193991628532
Task_42793,2314,469,65,152,217,4.923404255319149,45.313837860635125
Task_42794,2758,825,120,36,156,3.3389830508474576,52.327826909210465
Task_42795,673,515,99,149,248,1.304263565891473,19.48758950575611
Task_42796,630,561,163,85,248,1.1209964412811388,18.761419059916843
Task_42797,2847,314,159,173,332,9.038095238095238,53.706563276544124
Task_42798,1312,144,185,12,197,9.048275862068966,27.220762730489813
Task_42799,2188,696,15,165,180,3.139167862266858,43.7853253433962
Task_42800,1980,657,163,36,199,3.0091185410334345,39.78972277020176
Task_42801,1895,891,196,96,292,2.124439461883408,40.22373304928508
Task_42802,1902,72,66,117,183,26.054794520547944,36.62949987925004
Task_42803,2195,662,116,151,267,3.310708898944193,44.19925264407962
Task_42804,1215,968,189,68,257,1.2538699690402477,29.167096399611665
Task_42805,508,365,165,56,221,1.3879781420765027,15.889963126946393
Task_42806,1188,416,130,156,286,2.8489208633093526,27.569118721009215
Task_42807,2567,113,177,195,372,22.517543859649123,48.3103047136209
Task_42808,2809,459,94,64,158,6.106521739130435,52.253326753167016
Task_42809,2923,279,111,189,300,10.439285714285715,54.661660916103585
Task_42810,1881,722,157,184,341,2.6016597510373445,39.7959293981159
Task_42811,1735,172,82,84,166,10.028901734104046,34.50177815315242
Task_42812,909,1023,157,74,231,0.8876953125,24.50702445825965
Task_42813,1653,869,159,176,335,1.9,36.60358376198193
Task_42814,910,356,94,79,173,2.549019607843137,22.23242298116699
Task_42815,1244,71,148,84,232,17.27777777777778,26.345507389791365
Task_42816,2452,997,11,11,22,2.4569138276553106,46.5686994420561
Task_42817,2315,128,32,19,51,17.94573643410853,41.58679082551758
Task_42818,2179,724,67,105,172,3.0055172413793105,43.68776927202242
Task_42819,2709,1010,159,23,182,2.679525222551929,52.292708741463095
Task_42820,1281,185,97,20,117,6.887096774193548,26.42462817010826
Task_42821,1114,989,161,199,360,1.1252525252525252,28.50288685875448
Task_42822,849,683,189,107,296,1.2412280701754386,22.94689145551852
Task_42823,1228,319,162,90,252,3.8375,27.60802236844249
Task_42824,911,544,34,26,60,1.6715596330275229,21.140010519439194
Task_42825,1625,661,88,72,160,2.4546827794561934,34.1425881380319
Task_42826,2400,416,112,141,253,5.755395683453237,46.57831590719376
Task_42827,2529,440,91,167,258,5.73469387755102,48.758743647194144
Task_42828,2255,617,45,41,86,3.6488673139158574,43.05854531280389
Task_42829,1310,706,86,108,194,1.852899575671853,29.887190623719743
Task_42830,913,372,60,92,152,2.447721179624665,22.22381189608754
Task_42831,2383,745,193,117,310,3.1943699731903483,47.58250983451365
Task_42832,1397,299,198,102,300,4.656666666666666,30.48009067323224
Task_42833,1907,481,47,76,123,3.9564315352697097,38.06124197508218
Task_42834,2335,792,34,196,230,2.9445145018915513,46.736849119574174
Task_42835,577,459,78,49,127,1.2543478260869565,16.595660981473827
Task_42836,1320,114,13,27,40,11.478260869565217,25.821461989383447
Task_42837,1613,105,112,42,154,15.216981132075471,31.206629472807126
Task_42838,2153,536,137,128,265,4.009310986964619,43.091782614288626
Task_42839,2976,689,38,72,110,4.3130434782608695,55.45207041269412
Task_42840,2615,831,96,122,218,3.1430288461538463,51.128341683167285
Task_42841,720,396,37,73,110,1.81360201511335,18.827861750048335
Task_42842,738,620,40,115,155,1.1884057971014492,20.185524601984593
Task_42843,1446,668,135,140,275,2.1614349775784754,32.374515251302235
Task_42844,2059,490,175,41,216,4.193482688391039,40.59627522887191
Task_42845,1108,392,106,166,272,2.8193384223918576,26.1783123486329
Task_42846,816,657,181,34,215,1.2401215805471124,21.428189372262
Task_42847,2718,91,115,67,182,29.543478260869566,48.9200077861099
Task_42848,1651,353,154,130,284,4.663841807909605,34.644127365197996
Task_42849,1258,136,61,157,218,9.182481751824817,27.20272350910958
Task_42850,2784,1001,177,173,350,2.7784431137724552,54.999714053759284
Task_42851,914,970,74,75,149,0.94129763130793,24.106252816702888
Task_42852,1962,754,186,15,201,2.5986754966887418,39.7146824209612
Task_42853,2207,536,123,128,251,4.109869646182496,43.88369013330912
Task_42854,2345,464,170,20,190,5.043010752688172,44.831312088980944
Task_42855,2326,583,194,54,248,3.982876712328767,45.50026087207522
Task_42856,2379,146,171,115,286,16.183673469387756,45.160605251489045
Task_42857,1087,673,76,163,239,1.6127596439169138,26.628774140259242
Task_42858,1212,779,188,156,344,1.5538461538461539,29.30528722366499
Task_42859,2200,455,123,51,174,4.824561403508772,42.72543990570841
Task_42860,2098,353,199,64,263,5.926553672316384,41.246598458134834
Task_42861,2669,617,10,130,140,4.318770226537217,50.72218720165251
Task_42862,2801,342,83,134,217,8.166180758017493,52.53689091653046
Task_42863,2071,401,80,119,199,5.151741293532338,41.10050762186405
Task_42864,1978,271,179,191,370,7.272058823529412,40.015030681081974
Task_42865,555,574,75,103,178,0.9652173913043478,17.44482218703796
Task_42866,1179,817,188,66,254,1.441320293398533,28.113820500094775
Task_42867,2444,989,65,98,163,2.4686868686868686,48.639183594749476
Task_42868,1072,544,91,149,240,1.9669724770642203,25.91833721974307
Task_42869,977,677,133,161,294,1.4410029498525074,25.036477646989514
Task_42870,2740,136,104,57,161,20.0,49.579838300402436
Task_42871,1837,82,50,172,222,22.132530120481928,35.923905223477945
Task_42872,2982,997,117,198,315,2.987975951903808,58.00384236278038
Task_42873,788,508,46,22,68,1.5481335952848723,19.034438587658446
Task_42874,1287,99,92,110,202,12.87,27.186058023463005
Task_42875,1972,330,199,52,251,5.957703927492447,39.12213207546391
Task_42876,814,628,166,25,191,1.2941176470588236,21.151723990817093
Task_42877,2619,459,169,178,347,5.693478260869565,50.66338405429362
Task_42878,1043,433,57,11,68,2.403225806451613,22.67645713327676
Task_42879,2687,916,56,173,229,2.93020719738277,52.72146390969718
Task_42880,918,709,198,124,322,1.2929577464788733,24.265966916089216
Task_42881,1332,821,144,175,319,1.6204379562043796,31.281409460261983
Task_42882,800,428,193,56,249,1.8648018648018647,20.847614105798698
Task_42883,1284,765,25,104,129,1.6762402088772845,29.257548783215043
Task_42884,1678,687,11,132,143,2.438953488372093,35.26910077162241
Task_42885,2204,963,87,53,140,2.2863070539419086,44.166432317764055
Task_42886,1156,588,134,154,288,1.9626485568760612,27.61052086008779
Task_42887,2430,294,196,127,323,8.23728813559322,46.934891981576165
Task_42888,2503,758,149,155,304,3.297760210803689,49.553057054889926
Task_42889,2440,120,81,141,222,20.165289256198346,45.7136411581285
Task_42890,580,323,42,180,222,1.7901234567901234,17.4185955811611
Task_42891,818,613,135,33,168,1.3322475570032573,21.068694810089003
Task_42892,1857,253,34,71,105,7.311023622047244,36.18208974495299
Task_42893,1519,258,79,159,238,5.864864864864865,32.13436711297575
Task_42894,2301,179,86,187,273,12.783333333333333,44.030528606199226
Task_42895,2691,1009,79,27,106,2.6643564356435645,51.35546985370558
Task_42896,1900,869,154,80,234,2.1839080459770117,39.82185636405497
Task_42897,1952,966,96,114,210,2.018614270941055,40.99642684914151
Task_42898,2679,253,16,90,106,10.547244094488189,49.29928523924446
Task_42899,961,505,188,181,369,1.8992094861660078,24.667669767825306
Task_42900,1122,228,175,18,193,4.899563318777292,24.711671426820235
Task_42901,905,78,96,99,195,11.455696202531646,21.05044047925555
Task_42902,612,956,178,89,267,0.6394984326018809,20.00553968692357
Task_42903,2489,538,163,163,326,4.617810760667903,48.74448192915494
Task_42904,2551,1003,70,49,119,2.5408366533864544,49.37185836040734
Task_42905,1838,282,183,86,269,6.4946996466431095,37.16485263444625
Task_42906,1137,156,149,146,295,7.24203821656051,25.73956657655957
Task_42907,2310,417,43,157,200,5.526315789473684,44.95858657048753
Task_42908,1370,352,35,154,189,3.8810198300283285,29.814068005096193
Task_42909,1554,490,118,39,157,3.164969450101833,32.212624861710694
Task_42910,2723,786,142,48,190,3.45997458703939,51.96690849537731
Task_42911,810,513,200,33,233,1.575875486381323,20.957549052044918
Task_42912,2077,618,198,108,306,3.355411954765751,42.30416457632273
Task_42913,1853,282,84,196,280,6.5477031802120145,37.68898990583969
Task_42914,1486,389,68,15,83,3.81025641025641,30.07624309111746
Task_42915,1192,602,25,196,221,1.976782752902156,27.96965768529913
Task_42916,1491,358,185,118,303,4.153203342618385,32.19754422663737
Task_42917,1157,645,132,14,146,1.7910216718266254,26.313950569228293
Task_42918,1783,798,161,37,198,2.2315394242803506,37.12328643385103
Task_42919,695,121,148,22,170,5.69672131147541,17.176406284006138
Task_42920,2737,483,175,10,185,5.654958677685951,51.04752936669066
Task_42921,2818,801,145,121,266,3.513715710723192,54.45756476033481
Task_42922,1419,208,42,191,233,6.7894736842105265,30.36077674608425
Task_42923,2937,158,32,142,174,18.471698113207548,53.43005339322341
Task_42924,1544,410,177,146,323,3.75669099756691,33.335623101116575
Task_42925,2955,195,175,112,287,15.076530612244898,54.668774449907126
Task_42926,927,956,136,72,208,0.9686520376175548,24.452988915287975
Task_42927,2324,631,54,120,174,3.6772151898734178,45.724070695826846
Task_42928,2449,344,22,49,71,7.098550724637681,44.98985497457644
Task_42929,2044,345,108,42,150,5.907514450867052,39.45193230372794
Task_42930,2669,148,24,112,136,17.91275167785235,48.59333742686504
Task_42931,2903,774,82,109,191,3.745806451612903,55.40562804364918
Task_42932,1267,315,53,57,110,4.0094936708860756,26.85912808175719
Task_42933,641,283,73,76,149,2.257042253521127,17.603047396321468
Task_42934,1684,646,91,144,235,2.6027820710973724,35.900172710451876
Task_42935,2609,246,173,186,359,10.562753036437247,49.83883640951965
Task_42936,1401,691,73,41,114,2.0245664739884393,30.063043756216974
Task_42937,874,593,28,94,122,1.4713804713804715,22.0104556344797
Task_42938,1573,494,125,50,175,3.1777777777777776,32.815152098755725
Task_42939,2759,319,80,39,119,8.621875,50.31876815166559
Task_42940,2887,900,129,198,327,3.2042175360710323,56.24924212341924
Task_42941,1676,455,171,151,322,3.675438596491228,35.572005258465516
Task_42942,2321,951,191,77,268,2.438025210084034,46.83034718296344
Task_42943,1284,722,102,19,121,1.7759336099585061,28.228474245897704
Task_42944,1700,802,129,175,304,2.1170610211706102,36.998477525058426
Task_42945,1855,881,54,116,170,2.1031746031746033,39.03179885237575
Task_42946,829,940,12,70,82,0.8809776833156217,21.797452600007976
Task_42947,2011,689,100,194,294,2.9144927536231884,41.55450192774658
Task_42948,751,859,66,34,100,0.8732558139534884,20.236650487706324
Task_42949,1451,581,125,65,190,2.493127147766323,31.421288679573568
Task_42950,1128,184,79,135,214,6.097297297297297,25.4931929908365
Task_42951,1009,954,42,183,225,1.056544502617801,26.07847367341464
Task_42952,2600,1002,193,76,269,2.59222333000997,51.40806385962342
Task_42953,535,943,25,117,142,0.5667372881355932,18.08576565137381
Task_42954,2445,164,32,56,88,14.818181818181818,44.581053269866175
Task_42955,2301,682,129,185,314,3.3689604685212298,46.20297071464612
Task_42956,2780,986,67,150,217,2.81661600810537,54.33086401981661
Task_42957,843,563,140,134,274,1.4946808510638299,22.440817721175815
Task_42958,2163,133,81,53,134,16.14179104477612,40.30891166044424
Task_42959,1471,620,165,100,265,2.368760064412238,32.51649290517245
Task_42960,1304,867,196,17,213,1.5023041474654377,29.665296707661525
Task_42961,1912,943,175,51,226,2.0254237288135593,39.949187685783954
Task_42962,1865,610,121,65,186,3.0523731587561374,38.02575767717018
Task_42963,1941,258,189,24,213,7.494208494208494,37.87607337125262
Task_42964,1226,579,170,56,226,2.113793103448276,27.961962762866918
Task_42965,2152,795,123,80,203,2.7035175879396984,43.44379282058471
Task_42966,912,650,104,51,155,1.400921658986175,22.734661734702712
Task_42967,2484,77,35,76,111,31.846153846153847,44.672128802152535
Task_42968,1820,691,90,190,280,2.6300578034682083,38.46072243147325
Task_42969,1472,267,88,186,274,5.492537313432836,31.522968144918906
Task_42970,822,370,97,110,207,2.215633423180593,21.216049051863127
Task_42971,709,341,133,144,277,2.073099415204678,19.694253866102677
Task_42972,2764,851,69,113,182,3.244131455399061,53.40332464882934
Task_42973,911,510,42,17,59,1.7827788649706457,20.908752132084235
Task_42974,2403,791,71,172,243,3.034090909090909,47.88235286788526
Task_42975,1109,865,122,37,159,1.2806004618937645,26.35208829589357
Task_42976,1887,982,80,111,191,1.9196337741607326,39.97168872672177
Task_42977,897,120,117,95,212,7.413223140495868,21.29445095743304
Task_42978,1343,783,87,69,156,1.7130102040816326,29.97130134597829
Task_42979,2404,657,146,60,206,3.653495440729483,46.761752147923744
Task_42980,2873,351,28,38,66,8.161931818181818,51.56495166589465
Task_42981,1081,662,78,189,267,1.6304675716440422,26.663800163505112
Task_42982,1768,902,66,34,100,1.9579180509413068,36.35283196943892
Task_42983,2761,820,136,92,228,3.3629719853836786,53.34861749177214
Task_42984,2968,615,83,189,272,4.818181818181818,56.40679307258416
Task_42985,873,979,160,63,223,0.8908163265306123,23.693381803406115
Task_42986,962,770,123,100,223,1.2477302204928664,24.667567902905233
Task_42987,2642,910,104,156,260,2.9001097694840836,52.03486408130764
Task_42988,2071,280,183,55,238,7.370106761565836,40.41717344188951
Task_42989,1115,969,26,75,101,1.1494845360824741,26.71153047064558
Task_42990,2234,467,78,28,106,4.773504273504273,42.4092444513503
Task_42991,1330,992,37,164,201,1.339375629405841,31.20613766211288
Task_42992,813,134,145,95,240,6.022222222222222,20.159378718448608
Task_42993,1037,490,16,113,129,2.1120162932790225,24.4996092342429
Task_42994,1639,206,181,183,364,7.917874396135265,34.38871002703932
Task_42995,1919,747,105,104,209,2.5655080213903743,39.76396509190853
Task_42996,1432,581,146,53,199,2.4604810996563575,31.158190142604145
Task_42997,911,525,31,43,74,1.731939163498099,21.1384703625243
Task_42998,561,643,33,161,194,0.8711180124223602,17.85998683189592
Task_42999,801,980,117,170,287,0.8165137614678899,23.207721730419582
Task_43000,1587,283,129,84,213,5.588028169014085,32.93704551710201
Task_43001,2060,588,60,160,220,3.497453310696095,41.69799363613913
Task_43002,2339,283,105,134,239,8.235915492957746,45.089239234336276
Task_43003,1424,324,65,24,89,4.381538461538462,28.920355485849672
Task_43004,2433,807,80,58,138,3.011138613861386,47.31325527688628
Task_43005,2137,261,180,21,201,8.15648854961832,40.91235367959379
Task_43006,2427,624,169,19,188,3.8832,46.61954441135277
Task_43007,882,906,132,192,324,0.9724366041896362,24.441860994334718
Task_43008,1055,559,27,195,222,1.8839285714285714,25.673089319878144
Task_43009,2341,963,83,76,159,2.4284232365145226,46.59583475295526
Task_43010,2829,947,138,28,166,2.9841772151898733,54.00540945752079
Task_43011,1594,797,123,98,221,1.9974937343358397,34.82409025937389
Task_43012,1120,459,73,35,108,2.4347826086956523,24.7938387208896
Task_43013,1945,596,182,134,316,3.257956448911223,40.22733751899224
Task_43014,2738,472,170,114,284,5.788583509513742,52.21177449729053
Task_43015,1630,498,98,28,126,3.2665330661322645,33.25779541769606
Task_43016,1845,478,154,68,222,3.8517745302713986,37.47208080841595
Task_43017,1854,892,33,114,147,2.0761478163493843,38.75272900636419
Task_43018,1152,78,183,36,219,14.582278481012658,24.236580051035883
Task_43019,946,179,15,173,188,5.2555555555555555,22.19099320313011
Task_43020,1595,689,35,146,181,2.3115942028985508,34.365463693902676
Task_43021,2545,75,134,128,262,33.48684210526316,47.03863927275433
Task_43022,897,703,58,48,106,1.2741477272727273,21.946453443788574
Task_43023,2089,699,38,173,211,2.9842857142857144,42.426459828190865
Task_43024,1277,584,119,109,228,2.1829059829059827,29.177757285191632
Task_43025,597,123,154,79,233,4.814516129032258,16.455640826444625
Task_43026,2305,803,156,50,206,2.866915422885572,45.53248050130676
Task_43027,2642,640,100,18,118,4.121684867394696,49.44001539763144
Task_43028,1299,616,161,101,262,2.1053484602917343,29.767886333545135
Task_43029,1681,739,91,57,148,2.2716216216216214,35.24792012158784
Task_43030,1010,113,43,64,107,8.859649122807017,21.69979522827032
Task_43031,2929,685,88,163,251,4.269679300291545,55.80243372517429
Task_43032,2254,145,81,157,238,15.438356164383562,43.083366644207224
Task_43033,1697,655,69,173,242,2.586890243902439,36.281477108210346
Task_43034,590,891,178,79,257,0.6614349775784754,19.36791690309488
Task_43035,1314,891,72,143,215,1.4730941704035874,30.721686378876147
Task_43036,634,872,139,45,184,0.7262313860252004,19.268705018417418
Task_43037,1466,701,75,76,151,2.0883190883190883,31.915642506614727
Task_43038,2023,87,79,22,101,22.988636363636363,36.999407749844
Task_43039,573,126,139,145,284,4.511811023622047,16.605491571512243
Task_43040,2212,685,157,65,222,3.2244897959183674,43.95039756934309
Task_43041,1620,204,104,163,267,7.902439024390244,33.614906071434156
Task_43042,676,809,121,80,201,0.8345679012345679,20.07695760607722
Task_43043,2655,692,26,161,187,3.831168831168831,51.206413337350234
Task_43044,1887,275,66,55,121,6.836956521739131,36.728083022703316
Task_43045,613,129,124,33,157,4.7153846153846155,15.799553875880598
Task_43046,2817,255,137,140,277,11.00390625,52.72201538702842
Task_43047,2865,648,149,103,252,4.414483821263483,54.628906440449576
Task_43048,2653,901,90,174,264,2.9412416851441243,52.2197858830724
Task_43049,2522,653,164,182,346,3.856269113149847,49.75161180247513
Task_43050,2339,109,109,63,172,21.263636363636362,43.0753755683185
Task_43051,744,263,147,60,207,2.8181818181818183,19.23548806713499
Task_43052,2476,527,146,18,164,4.6893939393939394,46.99677691629378
Task_43053,2524,1006,162,196,358,2.506454816285998,50.964824957077745
Task_43054,2223,148,144,96,240,14.919463087248323,42.49631594832155
Task_43055,1201,689,49,41,90,1.7405797101449276,26.59332197292763
Task_43056,1734,204,117,11,128,8.458536585365854,33.970641399845505
Task_43057,1734,931,124,20,144,1.8605150214592274,36.31955631545925
Task_43058,1395,718,165,127,292,1.9401947148817802,31.78033231852469
Task_43059,642,139,72,97,169,4.585714285714285,17.150015372415595
Task_43060,2519,252,117,146,263,9.956521739130435,47.94787000637422
Task_43061,1787,267,81,33,114,6.667910447761194,34.78457828580063
Task_43062,1507,325,186,91,277,4.622699386503068,32.13076498353174
Task_43063,1690,491,123,73,196,3.434959349593496,34.996500249301405
Task_43064,2430,481,124,83,207,5.04149377593361,46.90108351490583
Task_43065,862,497,99,26,125,1.7309236947791165,20.979808565045303
Task_43066,1835,543,166,21,187,3.3731617647058822,36.98782360031807
Task_43067,1222,89,132,33,165,13.577777777777778,25.15896934899087
Task_43068,1699,903,181,126,307,1.8794247787610618,37.23866717969188
Task_43069,1518,587,48,72,120,2.5816326530612246,32.102602251115925
Task_43070,1770,306,178,200,378,5.765472312703583,36.896184373979274
Task_43071,2810,179,138,169,307,15.61111111111111,52.24723483192511
Task_43072,1241,717,67,91,158,1.7284122562674096,28.563192187624498
Task_43073,2028,759,78,186,264,2.668421052631579,41.963327764582324
Task_43074,1638,388,175,56,231,4.210796915167095,33.89953609875469
Task_43075,785,606,52,43,95,1.2932454695222406,19.82521932039407
Task_43076,2973,134,103,50,153,22.022222222222222,52.931577218247014
Task_43077,1611,74,169,147,316,21.48,32.720277854580125
Task_43078,1299,521,86,187,273,2.4885057471264367,29.605601855394543
Task_43079,2064,865,38,67,105,2.3833718244803697,41.40091363111515
Task_43080,2506,906,14,91,105,2.762954796030871,48.672093642750305
Task_43081,1230,766,24,90,114,1.6036505867014341,28.207513588795095
Task_43082,2281,220,32,134,166,10.321266968325792,43.58017417545384
Task_43083,2895,104,87,151,238,27.571428571428573,52.67523234550567
Task_43084,567,521,43,117,160,1.0862068965517242,17.16246557269982
Task_43085,2850,465,195,130,325,6.115879828326181,54.16996793474635
Task_43086,2869,317,182,191,373,9.022012578616351,54.27619968893455
Task_43087,1659,283,93,182,275,5.841549295774648,34.611336451994056
Task_43088,736,1003,58,95,153,0.7330677290836654,21.479651685756483
Task_43089,1340,550,164,102,266,2.4319419237749544,30.229633486874537
Task_43090,1943,259,32,68,100,7.473076923076923,37.46178461856319
Task_43091,2481,139,14,79,93,17.72142857142857,45.074238228107674
Task_43092,2324,81,20,66,86,28.341463414634145,41.8986390498272
Task_43093,1907,746,192,52,244,2.5528781793842037,39.392490197264124
Task_43094,968,620,152,134,286,1.5587761674718197,24.652039611831352
Task_43095,653,425,53,43,96,1.5328638497652582,17.123271555821365
Task_43096,1055,195,54,28,82,5.38265306122449,22.714870685175498
Task_43097,2226,336,151,56,207,6.605341246290801,42.921053027413926
Task_43098,2400,440,49,171,220,5.442176870748299,46.64836165452933
Task_43099,2213,506,32,144,176,4.3648915187376724,43.5433177019735
Task_43100,1328,333,77,190,267,3.9760479041916166,29.548049297931087
Task_43101,2210,886,27,154,181,2.491544532130778,44.71163949454148
Task_43102,1477,255,67,156,223,5.76953125,31.402875314544165
Task_43103,1150,940,41,80,121,1.2221041445270988,27.44516490709057
Task_43104,2686,610,109,32,141,4.396072013093289,50.43002589190841
Task_43105,504,735,168,167,335,0.6847826086956522,18.05966860598231
Task_43106,2099,584,54,192,246,3.588034188034188,42.467652115057874
Task_43107,1597,916,123,164,287,1.7415485278080698,35.61495244590353
Task_43108,1871,962,137,191,328,1.9428868120456906,40.33744720940128
Task_43109,711,932,132,49,181,0.7620578778135049,20.628737526339638
Task_43110,1291,225,124,63,187,5.712389380530974,27.684269738100244
Task_43111,960,700,162,164,326,1.369472182596291,24.994268455321702
Task_43112,2997,187,161,24,185,15.941489361702128,54.207249991319124
Task_43113,1417,571,90,144,234,2.477272727272727,31.42662231744622
Task_43114,2950,718,83,121,204,4.1029207232267035,56.043132652321724
Task_43115,1350,359,197,112,309,3.75,29.988564033594145
Task_43116,2238,435,147,123,270,5.13302752293578,44.127012902463726
Task_43117,503,442,22,156,178,1.1354401805869074,16.198856300690352
Task_43118,2871,588,115,145,260,4.874363327674024,54.62994073905022
Task_43119,2786,287,184,158,342,9.67361111111111,52.66897373468646
Task_43120,2130,986,174,66,240,2.1580547112462005,43.65878819416997
Task_43121,2845,643,71,189,260,4.417701863354037,54.51829014181451
Task_43122,771,802,101,24,125,0.9601494396014943,20.67590362705005
Task_43123,513,903,25,30,55,0.5674778761061947,16.055996053441525
Task_43124,1788,741,75,177,252,2.4097035040431267,38.03556096135892
Task_43125,1843,812,154,19,173,2.2669126691266914,37.88650082424946
Task_43126,1249,644,37,200,237,1.9364341085271317,29.11984149029686
Task_43127,2411,689,144,182,326,3.4942028985507245,48.01711891969338
Task_43128,696,675,120,191,311,1.029585798816568,20.693813926648243
Task_43129,1443,809,33,167,200,1.7814814814814814,32.460989117651
Task_43130,1969,297,151,125,276,6.60738255033557,39.442278465626295
Task_43131,1333,256,51,154,205,5.186770428015564,29.070513775333897
Task_43132,2371,666,68,68,136,3.55472263868066,46.01358957974767
Task_43133,1534,569,81,156,237,2.6912280701754385,33.3631181871888
Task_43134,971,209,184,131,315,4.623809523809523,23.556395041852152
Task_43135,879,304,185,159,344,2.8819672131147542,22.588360798454772
Task_43136,523,367,119,196,315,1.421195652173913,17.027661365334627
Task_43137,911,969,145,155,300,0.9391752577319588,24.94523679988076
Task_43138,1382,880,145,71,216,1.568671963677639,31.39474157096431
Task_43139,1887,1001,80,79,159,1.8832335329341316,39.60058619606099
Task_43140,1551,141,40,195,235,10.922535211267606,31.92042270923484
Task_43141,699,664,161,42,203,1.0511278195488722,19.55752052397634
Task_43142,2975,354,123,62,185,8.380281690140846,54.702076063918405
Task_43143,694,798,16,51,67,0.8685857321652065,18.813565722010228
Task_43144,975,911,27,74,101,1.069078947368421,24.288578254022422
Task_43145,2391,71,30,60,90,33.208333333333336,42.69840897521234
Task_43146,1309,228,128,104,232,5.716157205240175,28.545580987437464
Task_43147,1457,636,111,193,304,2.2872841444270016,32.65700799198223
Task_43148,2646,761,146,19,165,3.47244094488189,50.44303679181473
Task_43149,932,534,108,70,178,1.7420560747663552,22.96210222983238
Task_43150,1415,914,153,192,345,1.546448087431694,32.998009405656894
Task_43151,1017,491,192,15,207,2.067073170731707,23.950935848518508
Task_43152,845,119,164,146,310,7.041666666666667,20.96390303312967
Task_43153,1985,621,39,12,51,3.1913183279742765,38.233057088670556
Task_43154,1757,822,10,198,208,2.134872417982989,37.52523028420607
Task_43155,1177,152,13,137,150,7.69281045751634,25.222017442114566
Task_43156,1594,71,118,114,232,22.13888888888889,32.01451141262964
Task_43157,1315,221,145,37,182,5.923423423423423,27.775760881426915
Task_43158,2936,117,121,10,131,24.88135593220339,52.049270494410166
Task_43159,1853,289,154,16,170,6.389655172413793,36.31517675079075
Task_43160,809,328,44,53,97,2.4589665653495443,19.590253932728725
Task_43161,2917,849,199,17,216,3.431764705882353,55.218092841835556
Task_43162,1862,251,64,22,86,7.388888888888889,35.50578258218111
Task_43163,2418,309,63,195,258,7.8,46.671400256994445
Task_43164,618,926,89,11,100,0.6666666666666666,18.518209963237712
Task_43165,1337,678,195,196,391,1.9690721649484537,31.28416612362383
Task_43166,873,660,160,126,286,1.3207261724659607,23.255970601971825
Task_43167,2273,762,91,114,205,2.979030144167759,45.41498305842584
Task_43168,1448,983,86,115,201,1.4715447154471544,32.91958343902567
Task_43169,2313,393,38,144,182,5.870558375634518,44.78218953893935
Task_43170,2501,916,42,188,230,2.727371864776445,49.747740354105964
Task_43171,2927,212,98,189,287,13.741784037558686,54.41271015832217
Task_43172,1230,528,69,151,220,2.325141776937618,28.355698277965185
Task_43173,2168,252,73,82,155,8.569169960474309,41.718914603211864
Task_43174,1900,815,43,174,217,2.3284313725490198,39.83076212037762
Task_43175,2611,75,72,97,169,34.35526315789474,47.62876512402874
Task_43176,1829,764,37,35,72,2.3908496732026143,36.40748301282957
Task_43177,2609,427,91,65,156,6.095794392523365,48.975289287842266
Task_43178,2601,112,128,132,260,23.01769911504425,48.23844184770632
Task_43179,727,571,77,126,203,1.270979020979021,20.337883071645333
Task_43180,1525,678,44,68,112,2.2459499263622975,32.37499502235162
Task_43181,1328,148,147,199,346,8.912751677852349,29.02498718483918
Task_43182,2623,896,148,194,342,2.9241917502787067,52.11531979048677
Task_43183,671,324,119,121,240,2.0646153846153847,18.83884259485478
Task_43184,1165,744,73,18,91,1.563758389261745,26.20400871846471
Task_43185,2600,905,150,193,343,2.869757174392936,51.782053144928284
Task_43186,1633,845,13,85,98,1.9302600472813238,34.50188119741843
Task_43187,775,233,155,46,201,3.3119658119658117,19.395768008037866
Task_43188,2819,678,171,145,316,4.151693667157585,54.345639437438955
Task_43189,732,985,145,105,250,0.742393509127789,21.824030720251113
Task_43190,1115,1010,42,125,167,1.1028684470820969,27.54524404423241
Task_43191,1962,727,123,185,308,2.6950549450549453,40.94745335365956
Task_43192,1033,1024,20,183,203,1.0078048780487805,26.526315149463855
Task_43193,601,1002,67,132,199,0.5992023928215354,19.859892898834435
Task_43194,812,897,13,175,188,0.9042316258351893,22.581656531345775
Task_43195,1854,281,167,184,351,6.574468085106383,37.99388895265132
Task_43196,572,361,12,168,180,1.580110497237569,17.091633628062414
Task_43197,606,494,62,40,102,1.2242424242424241,16.643904977166553
Task_43198,876,970,28,44,72,0.90216271884655,22.04410799554491
Task_43199,1394,764,120,60,180,1.8222222222222222,30.966833397435593
Task_43200,658,269,152,43,195,2.437037037037037,17.628798305845155
Task_43201,2258,159,131,160,291,14.1125,43.425900421801536
Task_43202,2968,699,137,123,260,4.24,56.48774076697898
Task_43203,1243,984,87,102,189,1.2619289340101523,29.57846987009955
Task_43204,2167,876,155,170,325,2.4709236031927024,44.715721761293715
Task_43205,1790,832,115,18,133,2.148859543817527,36.82006832435308
Task_43206,2266,151,108,11,119,14.907894736842104,41.59060184750842
Task_43207,1518,112,16,133,149,13.43362831858407,30.262413470571975
Task_43208,2772,887,62,197,259,3.1216216216216215,54.145520045467926
Task_43209,2958,976,39,184,223,3.0276356192425795,57.13263117700634
Task_43210,1122,502,180,20,200,2.2306163021868786,25.64037510509337
Task_43211,2124,164,159,65,224,12.872727272727273,40.622836530557976
Task_43212,1468,756,18,40,58,1.9392338177014532,30.671019129163145
Task_43213,1418,754,118,151,269,1.8781456953642384,32.188387649802046
Task_43214,1338,521,58,40,98,2.5632183908045976,28.213008781380896
Task_43215,2244,145,172,42,214,15.36986301369863,42.045323195399625
Task_43216,2523,460,186,100,286,5.4728850325379605,48.75783533881469
Task_43217,2396,108,88,127,215,21.98165137614679,44.72350534530963
Task_43218,753,70,114,42,156,10.605633802816902,17.335341022366766
Task_43219,1251,600,125,146,271,2.08153078202995,29.064170360049317
Task_43220,2715,848,199,100,299,3.197879858657244,53.091166612261475
Task_43221,1979,709,108,147,255,2.787323943661972,40.86573126906357
Task_43222,1162,800,53,51,104,1.4506866416978776,26.57462837663674
Task_43223,2080,621,62,180,242,3.3440514469453375,42.24537385266802
Task_43224,1971,610,170,119,289,3.2258592471358427,40.53965174516143
Task_43225,1266,347,102,169,271,3.6379310344827585,28.533238116695443
Task_43226,748,230,59,137,196,3.238095238095238,19.647777783490998
Task_43227,1870,585,107,57,164,3.1911262798634814,37.90889381951016
Task_43228,1228,567,116,15,131,2.1619718309859155,27.066393853639884
Task_43229,1247,1022,129,150,279,1.2189638318670577,30.289610805559562
Task_43230,537,370,193,171,364,1.4474393530997305,17.442752086943543
Task_43231,860,499,129,160,289,1.72,22.64512333216909
Task_43232,2635,948,135,105,240,2.7766069546891465,51.87773348523044
Task_43233,2564,552,151,99,250,4.636528028933093,49.53462741583687
Task_43234,555,634,97,160,257,0.8740157480314961,18.069743478573525
Task_43235,1894,408,53,65,118,4.63080684596577,37.410384485808656
Task_43236,932,678,134,168,302,1.3726067746686303,24.38009593645859
Task_43237,604,871,170,36,206,0.6926605504587156,18.947909708431094
Task_43238,2695,282,175,35,210,9.522968197879859,49.92923445891592
Task_43239,1488,627,15,117,132,2.3694267515923566,32.069654974808735
Task_43240,1113,900,187,149,336,1.2352941176470589,28.04397622840273
Task_43241,2534,204,121,174,295,12.360975609756098,48.18560500933621
Task_43242,1010,70,162,175,337,14.225352112676056,23.434833922135528
Task_43243,2332,430,28,101,129,5.410672853828307,44.80133462556336
Task_43244,1199,650,38,31,69,1.8417818740399385,26.05013780794289
Task_43245,1734,396,65,49,114,4.367758186397985,34.47902654080457
Task_43246,1396,461,71,82,153,3.0216450216450217,30.1534552278533
Task_43247,678,189,175,28,203,3.568421052631579,17.76652371785505
Task_43248,2764,491,87,112,199,5.617886178861789,52.25956423666053
Task_43249,1244,177,200,130,330,6.98876404494382,27.573226956170014
Task_43250,1382,786,141,200,341,1.7560355781448538,32.10057591041627
Task_43251,969,764,12,147,159,1.2666666666666666,24.301149927578766
Task_43252,2997,399,195,112,307,7.4925,56.169629204722696
Task_43253,1690,75,142,121,263,22.236842105263158,33.64734103490306
Task_43254,2022,413,185,24,209,4.884057971014493,39.66071751428852
Task_43255,1201,202,121,84,205,5.916256157635468,26.523680961630927
Task_43256,961,367,184,64,248,2.6114130434782608,23.238271847947377
Task_43257,2786,239,166,14,180,11.608333333333333,50.95897152560416
Task_43258,2584,626,35,42,77,4.121212121212121,48.002543756720684
Task_43259,1308,517,16,70,86,2.525096525096525,28.09306168283727
Task_43260,1862,721,140,169,309,2.5789473684210527,39.325604276012264
Task_43261,1363,407,162,159,321,3.340686274509804,30.47182737253647
Task_43262,2550,452,117,150,267,5.629139072847682,49.14672723095354
Task_43263,637,998,38,121,159,0.6376376376376376,19.996230118609795
Task_43264,1915,874,21,54,75,2.1885714285714286,38.34267228763475
Task_43265,2598,415,29,189,218,6.2451923076923075,49.62343573362588
Task_43266,1586,763,82,77,159,2.075916230366492,34.018899432878975
Task_43267,1751,392,106,89,195,4.455470737913486,35.84785865651421
Task_43268,2698,956,22,111,133,2.819226750261233,52.25908086757219
Task_43269,2293,988,80,116,196,2.3185035389282103,46.454011679600946
Task_43270,2022,82,123,147,270,24.36144578313253,38.957660733773544
Task_43271,1632,233,162,130,292,6.9743589743589745,33.97336113701311
Task_43272,2545,646,85,64,149,3.9335394126738796,48.706788036870186
Task_43273,1936,566,80,18,98,3.4144620811287476,37.86092448818598
Task_43274,2020,340,188,100,288,5.92375366568915,40.411724264049056
Task_43275,2554,686,182,199,381,3.7176128093158662,50.54556051013001
Task_43276,1364,309,25,33,58,4.4,27.55391225216684
Task_43277,1896,220,77,89,166,8.57918552036199,37.50454560289047
Task_43278,1417,676,26,109,135,2.0930576070901035,31.046547168837847
Task_43279,1151,149,102,134,236,7.673333333333333,25.6488052796381
Task_43280,1439,815,103,127,230,1.7634803921568627,32.48652929309705
Task_43281,1952,526,89,36,125,3.7039848197343455,38.3704413520691
Task_43282,974,133,21,86,107,7.268656716417911,21.447641301602193
Task_43283,510,466,90,146,236,1.0920770877944326,16.655962228257405
Task_43284,610,884,82,27,109,0.6892655367231638,18.321244165261138
Task_43285,2045,188,43,63,106,10.82010582010582,38.89986218079253
Task_43286,1986,575,35,21,56,3.4479166666666665,38.23447843072548
Task_43287,1245,687,82,24,106,1.809593023255814,27.39188761272045
Task_43288,2873,725,125,157,282,3.9573002754820936,55.214185666181
Task_43289,2415,964,139,74,213,2.5025906735751295,48.095936811014006
Task_43290,1989,336,64,31,95,5.902077151335312,37.936221599618364
Task_43291,1423,781,49,122,171,1.819693094629156,31.905295910405403
Task_43292,2810,287,135,148,283,9.756944444444445,52.76779230408175
Task_43293,1041,302,13,164,177,3.4356435643564356,24.351800960418064
Task_43294,1023,245,155,182,337,4.158536585365853,24.673216613643106
Task_43295,1314,87,104,22,126,14.931818181818182,26.13262946775402
Task_43296,1384,167,75,46,121,8.238095238095237,27.865615275261334
Task_43297,2551,311,21,71,92,8.176282051282051,47.18059655019022
Task_43298,1714,219,118,28,146,7.790909090909091,33.83676864063623
Task_43299,2790,459,147,132,279,6.065217391304348,52.9961533834966
Task_43300,2008,612,192,136,328,3.2756933115823816,41.33263644698081
Task_43301,1467,492,33,28,61,2.975659229208925,29.78832601195367
Task_43302,2571,324,154,191,345,7.9107692307692306,49.461919747249794
Task_43303,1879,881,47,154,201,2.130385487528345,39.62579932264624
Task_43304,1928,603,189,165,354,3.19205298013245,40.196947432512516
Task_43305,1526,806,20,126,146,1.8909541511771994,33.275538206076845
Task_43306,2802,865,101,21,122,3.235565819861432,52.763861903189316
Task_43307,1779,167,162,34,196,10.589285714285714,34.79284138659879
Task_43308,2806,174,195,180,375,16.034285714285716,52.49601847953733
Task_43309,1400,481,68,76,144,2.904564315352697,30.20501698957507
Task_43310,575,874,67,66,133,0.6571428571428571,18.430947241767335
Task_43311,2360,418,67,43,110,5.6324582338902145,44.30515699399001
Task_43312,591,1000,141,81,222,0.5904095904095904,19.579747372864066
Task_43313,1043,935,94,34,128,1.1143162393162394,25.522354855953335
Task_43314,2954,498,70,113,183,5.919839679358717,55.29400260550131
Task_43315,933,913,61,160,221,1.0207877461706782,24.753219370182965
Task_43316,1027,981,146,42,188,1.0458248472505092,25.659939250788227
Task_43317,1529,128,70,93,163,11.852713178294573,30.961932220469976
Task_43318,1983,519,172,78,250,3.8134615384615387,40.08206396776422
Task_43319,2846,548,84,110,194,5.183970856102004,53.766584454047255
Task_43320,876,980,74,80,154,0.8929663608562691,23.494770631040392
Task_43321,2576,516,15,61,76,4.982591876208898,47.69182429665178
Task_43322,2670,894,183,118,301,2.983240223463687,52.557591509193195
Task_43323,1641,666,161,99,260,2.4602698650674664,35.323222884122664
Task_43324,1243,602,156,26,182,2.0613598673300166,27.82019603226571
Task_43325,634,328,95,57,152,1.9270516717325228,17.318184137602923
Task_43326,2275,416,178,22,200,5.4556354916067145,43.61759101406472
Task_43327,2382,674,172,67,239,3.528888888888889,46.675037557724615
Task_43328,552,455,84,107,191,1.2105263157894737,17.05801228655984
Task_43329,1729,935,66,84,150,1.8472222222222223,36.935055617668674
Task_43330,1706,356,28,190,218,4.778711484593837,35.3045062614676
Task_43331,2856,807,89,179,268,3.5346534653465347,55.15148318746776
Task_43332,1077,688,111,98,209,1.5631349782293178,26.19784810833558
Task_43333,1946,120,56,86,142,16.082644628099175,37.13379828731331
Task_43334,938,684,188,27,215,1.3693430656934307,23.421388372140168
Task_43335,1256,774,171,156,327,1.6206451612903225,29.939494593744058
Task_43336,1563,376,40,78,118,4.1458885941644565,32.22175137612014
Task_43337,2229,242,39,71,110,9.17283950617284,42.15144249089905
Task_43338,1698,230,120,74,194,7.35064935064935,34.30102967026108
Task_43339,2578,118,54,162,216,21.66386554621849,47.84954351641306
Task_43340,2346,1010,27,42,69,2.320474777448071,45.3580261908912
Task_43341,2899,713,25,110,135,4.060224089635854,54.63946048726674
Task_43342,1894,126,169,125,294,14.913385826771654,37.41219825872483
Task_43343,2289,871,48,139,187,2.625,46.01208136305351
Task_43344,517,829,17,187,204,0.6228915662650603,18.000261156889824
Task_43345,2048,545,100,117,217,3.750915750915751,41.22547465832323
Task_43346,2494,532,186,102,288,4.679174484052533,48.543688702458894
Task_43347,2072,520,61,198,259,3.9769673704414585,41.90089422230879
Task_43348,1515,379,147,119,266,3.986842105263158,32.48015857970571
Task_43349,738,754,96,33,129,0.9774834437086093,20.110386914701056
Task_43350,1347,851,135,146,281,1.5809859154929577,31.369161201574652
Task_43351,1122,442,35,144,179,2.5327313769751694,26.09930932494554
Task_43352,2227,188,159,97,256,11.783068783068783,43.058971943082234
Task_43353,1639,327,109,17,126,4.996951219512195,32.755118860835395
Task_43354,2164,746,119,114,233,2.896921017402945,43.764879506481805
Task_43355,2862,305,151,157,308,9.352941176470589,53.78024487294933
Task_43356,1958,807,71,61,132,2.4232673267326734,39.81764008197522
Task_43357,1531,162,114,31,145,9.392638036809815,30.477739105768933
Task_43358,597,264,111,121,232,2.2528301886792454,17.44145154622519
Task_43359,521,992,33,160,193,0.5246727089627392,18.54786152057279
Task_43360,1335,317,107,100,207,4.19811320754717,29.137087316363488
Task_43361,1828,131,62,154,216,13.848484848484848,36.13049941670206
Task_43362,718,682,195,67,262,1.0512445095168375,20.425177702090345
Task_43363,1459,182,174,102,276,7.972677595628415,30.864563740267915
Task_43364,551,982,15,73,88,0.560528992878942,17.69983264226258
Task_43365,2538,123,117,42,159,20.467741935483872,46.013054262957446
Task_43366,1271,894,29,61,90,1.4201117318435754,28.54507229453426
Task_43367,1177,567,165,26,191,2.0721830985915495,26.72498927331037
Task_43368,1985,70,58,15,73,27.95774647887324,35.28054615065902
Task_43369,1306,326,187,95,282,3.99388379204893,29.052141090391853
Task_43370,2507,679,76,22,98,3.6867647058823527,47.30997922756976
Task_43371,1866,175,184,133,317,10.602272727272727,37.343305506517076
Task_43372,1076,676,28,37,65,1.589364844903988,24.171856621549395
Task_43373,2973,597,133,51,184,4.971571906354515,55.458703994322896
Task_43374,513,536,97,148,245,0.9553072625698324,17.041284232494842
Task_43375,1508,772,156,102,258,1.9508408796895214,33.548843644679316
Task_43376,568,824,99,101,200,0.6884848484848485,18.638365286410828
Task_43377,1274,486,146,41,187,2.616016427104723,28.012371302940977
Task_43378,2305,741,176,101,277,3.106469002695418,46.16210824666744
Task_43379,803,903,128,25,153,0.8882743362831859,21.585088762465507
Task_43380,1925,561,68,197,265,3.425266903914591,39.735464285117686
Task_43381,641,765,28,177,205,0.8368146214099217,19.561004870352523
Task_43382,1111,117,168,76,244,9.415254237288135,24.407270657412806
Task_43383,1473,602,155,193,348,2.442786069651741,33.002110236965386
Task_43384,1551,939,114,43,157,1.65,33.55693031360406
Task_43385,2202,309,186,128,314,7.103225806451613,43.34306900882452
Task_43386,2604,470,179,155,334,5.528662420382165,50.36955965780928
Task_43387,721,205,142,57,199,3.5,18.652355292606327
Task_43388,650,446,83,30,113,1.45413870246085,17.38708755593304
Task_43389,1953,998,198,36,234,1.954954954954955,40.58449539095474
Task_43390,1554,217,128,42,170,7.128440366972477,31.4514663152025
Task_43391,2883,377,137,165,302,7.626984126984127,54.34665352081432
Task_43392,1337,73,13,187,200,18.06756756756757,27.883287438660926
Task_43393,2718,170,42,48,90,15.894736842105264,48.81025242697398
Task_43394,2082,654,178,128,306,3.1786259541984734,42.52629542906666
Task_43395,549,590,35,42,77,0.9289340101522843,15.777800822701224
Task_43396,2809,359,72,30,102,7.802777777777778,51.14693820354949
Task_43397,2819,708,115,49,164,3.9760225669957685,53.19985105119738
Task_43398,1053,568,128,172,300,1.850615114235501,25.997381534927502
Task_43399,1213,74,94,178,272,16.173333333333332,26.34491081269883
Task_43400,2728,487,59,107,166,5.590163934426229,51.59571122333744
Task_43401,633,597,11,57,68,1.0585284280936456,17.158435529641388
Task_43402,2771,91,125,73,198,30.119565217391305,49.96525969875341
Task_43403,1702,140,79,191,270,12.070921985815604,34.54936982724777
Task_43404,2621,850,105,27,132,3.079905992949471,50.0998652852538
Task_43405,2921,504,72,102,174,5.784158415841584,54.733388605589674
Task_43406,1984,171,156,173,329,11.534883720930232,39.327811073707274
Task_43407,1440,704,161,172,333,2.0425531914893615,32.700244581831775
Task_43408,2425,836,119,166,285,2.8972520908004777,48.492441063039614
Task_43409,1097,368,58,160,218,2.97289972899729,25.745233043110982
Task_43410,913,586,38,87,125,1.555366269165247,22.705475728360316
Task_43411,1840,591,30,20,50,3.108108108108108,35.85716398972752
Task_43412,2975,998,82,175,257,2.977977977977978,57.642949560292315
Task_43413,868,504,28,20,48,1.7188118811881188,20.132931475261124
Task_43414,2275,453,195,185,380,5.011013215859031,45.35787738325326
Task_43415,2845,848,166,170,336,3.3510011778563014,55.42029054667504
Task_43416,1618,1015,51,84,135,1.5925196850393701,35.39694845366148
Task_43417,1867,792,111,110,221,2.3543505674653216,39.14370020857839
Task_43418,1518,892,53,160,213,1.6998880179171332,34.02129815413581
Task_43419,1387,826,133,178,311,1.6771463119709795,32.13668741805427
Task_43420,2205,198,10,135,145,11.080402010050252,42.059003378386684
Task_43421,2725,108,121,58,179,25.0,49.214160021918254
Task_43422,2749,696,151,197,348,3.9440459110473456,53.51432535656429
Task_43423,2858,826,126,36,162,3.4558645707376057,53.993669779153954
Task_43424,2129,868,35,37,72,2.4499424626006903,41.50323575945754
Task_43425,718,497,100,75,175,1.4417670682730923,19.52224287762736
Task_43426,1587,255,17,169,186,6.19921875,32.847309279114874
Task_43427,2794,740,27,73,100,3.770580296896086,52.531853179521995
Task_43428,2722,312,67,40,107,8.696485623003195,49.62825093542124
Task_43429,1421,659,200,128,328,2.153030303030303,32.171683122749826
Task_43430,1883,203,177,193,370,9.230392156862745,38.27103653893821
Task_43431,2385,676,12,131,143,3.5228951255539145,46.43547005893063
Task_43432,617,868,67,125,192,0.7100115074798619,19.616430340068096
Task_43433,2489,80,102,109,211,30.728395061728396,45.937558637732415
Task_43434,2061,991,197,156,353,2.0776209677419355,43.4998104056045
Task_43435,2557,954,28,155,183,2.6774869109947645,50.43270340765199
Task_43436,1437,167,149,49,198,8.553571428571429,29.45030614224933
Task_43437,2040,763,112,154,266,2.670157068062827,42.0611175483978
Task_43438,536,210,200,128,328,2.5402843601895735,16.74616288214065
Task_43439,2650,450,172,60,232,5.875831485587583,50.10957344591086
Task_43440,869,356,73,27,100,2.434173669467787,20.458038149298456
Task_43441,734,421,193,48,241,1.7393364928909953,19.540813277743343
Task_43442,939,499,94,79,173,1.878,23.142795266101405
Task_43443,1011,210,187,158,345,4.791469194312796,24.366132899744645
Task_43444,2022,311,194,146,340,6.480769230769231,40.64729107291484
Task_43445,2995,311,119,86,205,9.599358974358974,55.269933995707994
Task_43446,1605,833,14,24,38,1.9244604316546763,32.81670170744367
Task_43447,1021,819,26,68,94,1.2451219512195122,24.589946703257485
Task_43448,1633,1008,19,52,71,1.6184340931615462,34.32556078392431
Task_43449,1530,662,37,40,77,2.3076923076923075,31.405785402085893
Task_43450,2586,613,174,21,195,4.2117263843648205,49.15235715503619
Task_43451,2338,308,56,24,80,7.566343042071197,43.153260969609185
Task_43452,1464,580,13,191,204,2.5197934595524956,32.11457757645703
Task_43453,557,678,28,11,39,0.8203240058910162,15.892255102497293
Task_43454,2113,441,133,58,191,4.780542986425339,41.40411447592424
Task_43455,878,708,149,11,160,1.2383638928067702,22.07618038623561
Task_43456,2534,482,149,133,282,5.246376811594203,49.03389802586812
Task_43457,1893,626,116,181,297,3.0191387559808613,39.481759404389834
Task_43458,751,241,151,72,223,3.103305785123967,19.467230326497976
Task_43459,2367,860,96,124,220,2.749128919860627,47.301709432522365
Task_43460,955,936,45,29,74,1.0192102454642475,23.218898922482822
Task_43461,1805,501,43,48,91,3.595617529880478,35.68967795637115
Task_43462,2752,417,157,98,255,6.583732057416268,52.105547847975934
Task_43463,2939,1014,169,59,228,2.8955665024630544,56.45647630580953
Task_43464,557,429,114,185,299,1.2953488372093023,17.664104384807544
Task_43465,2831,770,138,49,187,3.6718547341115433,53.6698467832914
Task_43466,2753,656,26,78,104,4.190258751902587,51.75289443832039
Task_43467,1604,489,124,17,141,3.273469387755102,32.81637111337178
Task_43468,1083,944,95,164,259,1.146031746031746,27.3776827839643
Task_43469,906,334,134,145,279,2.7044776119402987,22.798231235767755
Task_43470,2373,492,168,95,263,4.813387423935091,46.38970409567809
Task_43471,621,762,119,87,206,0.8138925294888598,19.140849991343035
Task_43472,2084,901,124,22,146,2.3104212860310422,41.83552230827408
Task_43473,2029,982,30,71,101,2.064089521871821,41.17909393599317
Task_43474,2377,479,168,178,346,4.952083333333333,46.89326769567818
Task_43475,1029,583,191,99,290,1.7619863013698631,25.492725224169927
Task_43476,1355,153,76,68,144,8.7987012987013,27.98055222562748
Task_43477,1317,696,39,150,189,1.8895265423242469,30.05245366956608
Task_43478,2396,750,106,19,125,3.1904127829560585,46.03980475635054
Task_43479,1906,136,61,33,94,13.912408759124087,35.56937929568781
Task_43480,506,409,137,134,271,1.2341463414634146,16.590305888988805
Task_43481,1159,795,188,190,378,1.4560301507537687,28.707271411328772
Task_43482,1449,426,135,56,191,3.3934426229508197,30.85092482014775
Task_43483,633,663,48,104,152,0.9533132530120482,18.65571133294795
Task_43484,1524,813,199,165,364,1.8722358722358723,34.500079047227224
Task_43485,1337,930,188,48,236,1.4360902255639099,30.666693389052522
Task_43486,1183,719,38,117,155,1.6430555555555555,27.606260222977642
Task_43487,2682,492,45,172,217,5.440162271805274,51.20159283683025
Task_43488,1906,424,89,153,242,4.484705882352941,38.73370324522893
Task_43489,2812,367,187,143,330,7.641304347826087,53.283364987272726
Task_43490,2620,209,158,175,333,12.476190476190476,49.736101019531475
Task_43491,728,472,142,148,290,1.5391120507399578,20.428670561079752
Task_43492,2238,550,126,75,201,4.061705989110708,43.93970511500125
Task_43493,551,160,187,159,346,3.422360248447205,16.76595785237055
Task_43494,834,276,51,13,64,3.0108303249097474,18.883829045737947
Task_43495,1621,363,130,11,141,4.4532967032967035,32.68021628702143
Task_43496,1292,908,112,96,208,1.4213421342134214,30.289402759629365
Task_43497,2079,917,86,139,225,2.264705882352941,42.91325718925375
Task_43498,810,69,46,93,139,11.571428571428571,18.85079896359885
Task_43499,993,286,91,111,202,3.4599303135888504,23.621237742798257
Task_43500,2502,557,21,20,41,4.483870967741935,46.12891939589303
Task_43501,2153,720,93,132,225,2.986130374479889,43.53781943209484
Task_43502,1440,194,26,77,103,7.384615384615385,29.497555859378455
Task_43503,1546,333,110,51,161,4.62874251497006,31.827642080594256
Task_43504,1916,71,181,179,360,26.61111111111111,37.72409885950378
Task_43505,2735,578,198,57,255,4.723661485319516,51.98024510160519
Task_43506,880,395,144,71,215,2.2222222222222223,21.941922186274365
Task_43507,2288,865,169,36,205,2.6420323325635104,45.34796880274646
Task_43508,1463,600,183,160,343,2.4342762063227954,32.76655564697014
Task_43509,1140,270,94,89,183,4.206642066420664,25.70413530495149
Task_43510,2768,243,34,130,164,11.344262295081966,51.34399128577027
Task_43511,2293,982,15,63,78,2.3326551373346898,44.86570666660932
Task_43512,2647,421,153,151,304,6.2725118483412325,50.74817545249736
Task_43513,572,860,26,11,37,0.6643437862950058,16.798653198758178
Task_43514,1469,900,135,134,269,1.6304106548279689,33.41195631768494
Task_43515,1207,323,42,106,148,3.7253086419753085,26.70738859407602
Task_43516,2000,782,78,90,168,2.554278416347382,40.94297491111033
Task_43517,893,431,44,106,150,2.0671296296296298,22.07654675144056
Task_43518,891,980,190,129,319,0.908256880733945,24.712452718930233
Task_43519,2601,728,41,103,144,3.567901234567901,50.0363268959833
Task_43520,911,255,171,64,235,3.55859375,22.02717987874536
Task_43521,1354,799,21,183,204,1.6925,31.036719446458246
Task_43522,2531,553,87,18,105,4.568592057761733,47.306906548403305
Task_43523,2399,263,196,147,343,9.087121212121213,46.45388665957372
Task_43524,1145,907,68,161,229,1.2610132158590308,28.176736753655813
Task_43525,633,204,100,159,259,3.0878048780487806,17.99223397805575
Task_43526,2261,537,79,186,265,4.202602230483271,44.95003174206929
Task_43527,976,559,181,42,223,1.7428571428571429,23.690032832952934
Task_43528,1204,621,31,21,52,1.9356913183279743,25.946364290029972
Task_43529,898,428,136,152,288,2.093240093240093,23.020868354733135
Task_43530,1567,969,18,67,85,1.6154639175257732,33.652192675679764
Task_43531,1137,234,104,18,122,4.8382978723404255,24.363475159290743
Task_43532,2311,727,26,78,104,3.1744505494505493,44.975898306442865
Task_43533,1257,158,116,125,241,7.90566037735849,27.366362732311377
Task_43534,2713,64,134,115,249,41.738461538461536,49.56392580408803
Task_43535,589,984,67,28,95,0.5979695431472081,18.363276565122444
Task_43536,1668,984,197,145,342,1.6934010152284265,37.1711334093637
Task_43537,2290,157,62,60,122,14.49367088607595,42.25612836393407
Task_43538,1048,135,121,37,158,7.705882352941177,22.657828822390815
Task_43539,1139,426,89,69,158,2.667447306791569,25.680437547220617
Task_43540,1827,780,115,91,206,2.3393085787451984,38.32212357818688
Task_43541,2052,349,89,183,272,5.862857142857143,40.97650106481238
Task_43542,1431,155,38,162,200,9.173076923076923,29.92153225475526
Task_43543,660,799,93,99,192,0.825,19.896937259027894
Task_43544,1230,209,112,10,122,5.857142857142857,25.751735439989744
Task_43545,2722,244,135,134,269,11.110204081632654,51.13469671335656
Task_43546,2018,975,13,29,42,2.067622950819672,39.90674656782912
Task_43547,2646,233,127,128,255,11.307692307692308,49.820292560707266
Task_43548,2324,646,113,13,126,3.591962905718702,44.62749238943413
Task_43549,789,160,170,151,321,4.900621118012422,20.39361923808527
Task_43550,2330,552,111,151,262,4.213381555153707,45.96568171114108
Task_43551,1837,670,174,195,369,2.737704918032787,39.07822565806405
Task_43552,2307,989,59,160,219,2.33030303030303,46.86376476166479
Task_43553,2466,1022,83,151,234,2.410557184750733,49.50631709299185
Task_43554,1403,371,197,157,354,3.771505376344086,31.13464100754916
Task_43555,751,452,61,115,176,1.6578366445916115,20.238580965781953
Task_43556,2886,506,10,46,56,5.6923076923076925,52.35903128634599
Task_43557,2198,630,46,96,142,3.4833597464342314,43.402336092347916
Task_43558,2901,1018,177,114,291,2.846908734052993,56.55445787433492
Task_43559,609,1003,66,47,113,0.6065737051792829,18.84548362121176
Task_43560,1591,805,159,198,357,1.9739454094292803,35.55350513628715
Task_43561,975,131,20,136,156,7.386363636363637,21.917197932453927
Task_43562,507,602,139,106,245,0.8407960199004975,17.082003230053022
Task_43563,1487,494,109,94,203,3.004040404040404,32.077920364989325
Task_43564,1068,180,188,78,266,5.900552486187845,24.356936019223884
Task_43565,2313,997,164,44,208,2.317635270541082,46.17512373155884
Task_43566,2983,263,64,149,213,11.299242424242424,55.17019693405547
Task_43567,2693,953,186,172,358,2.8228511530398324,53.442472419694546
Task_43568,1381,572,80,196,276,2.4101221640488655,31.184177754679283
Task_43569,2604,1020,111,194,305,2.5504407443682666,52.03440393916387
Task_43570,2192,818,119,162,281,2.6764346764346763,44.720642126929505
Task_43571,665,304,88,138,226,2.180327868852459,18.600948884807973
Task_43572,1700,991,181,199,380,1.7137096774193548,37.95037745937052
Task_43573,1209,1011,66,34,100,1.1946640316205535,27.908510868494886
Task_43574,987,357,62,33,95,2.7569832402234637,22.144025092509935
Task_43575,2944,572,64,199,263,5.137870855148342,55.897514088133846
Task_43576,1491,726,148,144,292,2.0508940852819806,33.350939288816726
Task_43577,1978,834,139,13,152,2.3688622754491018,39.87276540034283
Task_43578,1759,564,58,29,87,3.113274336283186,34.95022182388386
Task_43579,2966,337,178,199,377,8.775147928994082,55.91003950107222
Task_43580,2511,128,119,51,170,19.46511627906977,45.963894029613414
Task_43581,1604,172,138,11,149,9.271676300578035,31.58488398609089
Task_43582,2553,68,163,83,246,37.0,46.851454770706134
Task_43583,1757,636,100,11,111,2.758241758241758,35.42089711578489
Task_43584,1734,756,47,99,146,2.2906208718626155,36.42589419747507
Task_43585,1464,147,103,200,303,9.891891891891891,30.9760774067481
Task_43586,1518,221,68,185,253,6.837837837837838,32.108263582197736
Task_43587,1280,365,197,38,235,3.4972677595628414,27.96094832250797
Task_43588,1573,399,186,164,350,3.9325,33.90712266833784
Task_43589,856,973,93,79,172,0.8788501026694046,23.324798434261222
Task_43590,1652,424,63,19,82,3.887058823529412,32.71708029135276
Task_43591,2982,427,127,144,271,6.9672897196261685,55.91072331276155
Task_43592,2444,313,158,105,263,7.7834394904458595,46.91987590830538
Task_43593,803,667,63,127,190,1.2020958083832336,21.781218966147254
Task_43594,1544,464,117,103,220,3.3204301075268816,32.98130373796648
Task_43595,1322,931,48,136,184,1.4184549356223175,30.784601555677202
Task_43596,1574,89,24,30,54,17.488888888888887,29.630033376458375
Task_43597,1324,476,192,104,296,2.7756813417190775,29.880978828157676
Task_43598,1630,251,91,166,257,6.468253968253968,33.899331882535556
Task_43599,835,347,169,91,260,2.3994252873563218,21.49702587025458
Task_43600,604,773,94,20,114,0.7803617571059431,17.750857220165265
Task_43601,1340,450,189,87,276,2.9711751662971175,29.875300534812737
Task_43602,1631,773,197,96,293,2.107235142118863,35.677837958311336
Task_43603,1475,282,193,95,288,5.212014134275618,31.605494012510917
Task_43604,883,978,23,171,194,0.9019407558733401,23.99045093530764
Task_43605,1615,843,153,101,254,1.9135071090047393,35.445609692769544
Task_43606,1194,957,61,129,190,1.2463465553235908,28.87291011469993
Task_43607,822,840,125,34,159,0.9774078478002378,21.814906559228522
Task_43608,1501,911,187,151,338,1.6458333333333333,34.28905985132686
Task_43609,2404,93,72,139,211,25.574468085106382,44.81537946558105
Task_43610,1933,327,36,15,51,5.8932926829268295,36.46579695470546
Task_43611,2899,450,88,131,219,6.427937915742794,54.3787079826319
Task_43612,1450,425,174,148,322,3.403755868544601,31.89463554465628
Task_43613,1205,460,130,140,270,2.613882863340564,27.88223804773472
Task_43614,2839,491,191,178,369,5.770325203252033,54.34955337636293
Task_43615,2155,687,99,116,215,3.1322674418604652,43.36045251945114
Task_43616,979,976,158,127,285,1.0020470829068577,25.87961813667121
Task_43617,2302,510,131,95,226,4.504892367906066,45.15690071556844
Task_43618,2303,724,92,142,234,3.176551724137931,45.95095472748569
Task_43619,2395,1015,145,26,171,2.357283464566929,47.28218747445087
Task_43620,1013,703,58,180,238,1.4389204545454546,25.53712242346874
Task_43621,954,277,83,149,232,3.431654676258993,23.20258480808492
Task_43622,1206,970,199,139,338,1.2420185375901134,29.728743667472685
Task_43623,1685,964,117,104,221,1.7461139896373057,36.77300502037258
Task_43624,731,779,35,86,121,0.9371794871794872,20.310033066004934
Task_43625,1465,154,79,16,95,9.451612903225806,28.89973919310452
Task_43626,2810,518,104,72,176,5.414258188824663,52.70517039503605
Task_43627,523,590,112,129,241,0.8849407783417935,17.316693511021466
Task_43628,2129,843,105,137,242,2.522511848341232,43.588173691356936
Task_43629,1975,346,39,167,206,5.69164265129683,39.458518918159214
Task_43630,1405,473,33,148,181,2.9641350210970465,30.672017298751342
Task_43631,1826,893,176,160,336,2.0425055928411635,39.400462775374
Task_43632,1691,245,100,94,194,6.873983739837398,34.44468238899777
Task_43633,2690,112,26,155,181,23.805309734513273,49.205913046269124
Task_43634,2965,169,50,188,238,17.441176470588236,54.46463838087532
Task_43635,2470,659,169,23,192,3.742424242424242,47.46934800838091
Task_43636,509,399,60,96,156,1.2725,15.955463506049805
Task_43637,2906,690,176,46,222,4.205499276410999,54.68538897085556
Task_43638,2256,1007,27,147,174,2.238095238095238,45.787630780143616
Task_43639,2495,531,90,137,227,4.68984962406015,48.32702671753697
Task_43640,2947,980,49,76,125,3.0040774719673804,56.217920359575686
Task_43641,1039,678,124,26,150,1.5301914580265095,24.581640793405608
Task_43642,2128,580,92,195,287,3.6626506024096384,43.04102090328189
Task_43643,1671,957,15,33,48,1.744258872651357,34.39074670681612
Task_43644,2687,241,61,136,197,11.103305785123966,50.31592835704733
Task_43645,541,915,39,75,114,0.5906113537117904,17.911644165680734
Task_43646,1981,267,85,108,193,7.391791044776119,39.13503389190756
Task_43647,2047,1013,164,104,268,2.0187376725838266,42.88699083000418
Task_43648,1272,583,13,196,209,2.1780821917808217,29.113396513958108
Task_43649,857,474,49,189,238,1.8042105263157895,22.44146027982764
Task_43650,1101,354,165,113,278,3.101408450704225,25.895315183010158
Task_43651,1192,95,51,187,238,12.416666666666666,25.944841197048003
Task_43652,2990,481,65,103,168,6.203319502074689,55.712976488239406
Task_43653,1360,191,136,199,335,7.083333333333333,29.822013257370802
Task_43654,1345,154,83,129,212,8.67741935483871,28.64107879629268
Task_43655,2222,475,122,165,287,4.668067226890757,44.14173434886161
Task_43656,1180,518,138,178,316,2.2736030828516376,27.932430644760558
Task_43657,2408,602,84,92,176,3.9933665008291874,46.828795690550756
Task_43658,2424,940,137,55,192,2.575982996811902,47.91467442790698
Task_43659,2858,215,55,168,223,13.231481481481481,53.0815582166052
Task_43660,2333,123,135,137,272,18.81451612903226,44.213032299997714
Task_43661,1419,204,187,13,200,6.921951219512195,29.348131168627443
Task_43662,1716,375,59,40,99,4.5638297872340425,33.69925405330458
Task_43663,2081,497,182,67,249,4.178714859437751,41.39083082098906
Task_43664,564,809,120,56,176,0.6962962962962963,18.091497724227633
Task_43665,660,612,61,15,76,1.0766721044045677,17.28424519417108
Task_43666,1860,468,77,189,266,3.9658848614072495,38.396414723207634
Task_43667,1639,553,129,112,241,2.9584837545126352,34.8755208545088
Task_43668,1323,146,187,34,221,9.0,27.589954788554497
Task_43669,2129,945,34,159,193,2.2505285412262155,43.72958613039395
Task_43670,596,781,122,89,211,0.7621483375959079,18.85665026803235
Task_43671,966,656,129,110,239,1.4703196347031964,24.47429198015341
Task_43672,1911,706,18,194,212,2.702970297029703,39.6386008575941
Task_43673,1190,98,40,17,57,12.02020202020202,23.501339448794464
Task_43674,1070,543,12,143,155,1.9669117647058822,25.265697013690325
Task_43675,2790,268,125,119,244,10.371747211895912,52.164137166382716
Task_43676,2693,576,157,149,306,4.667244367417678,51.985911726133146
Task_43677,1914,1019,171,198,369,1.8764705882352941,41.39094284121945
Task_43678,2073,541,102,167,269,3.8247232472324724,41.91624255841942
Task_43679,2949,447,188,175,363,6.582589285714286,55.914910422711024
Task_43680,1563,864,183,90,273,1.806936416184971,34.72478103667737
Task_43681,709,531,111,196,307,1.3327067669172932,20.454817699304147
Task_43682,1465,981,139,128,267,1.4918533604887985,33.55269292455512
Task_43683,1743,262,27,105,132,6.6273764258555135,34.91336351630243
Task_43684,535,820,140,108,248,0.6516443361753959,18.337045114011804
Task_43685,1243,240,96,146,242,5.157676348547718,27.65866835449751
Task_43686,2211,185,29,71,100,11.887096774193548,41.3988039991031
Task_43687,2793,458,139,76,215,6.084967320261438,52.49816981321254
Task_43688,2052,491,182,81,263,4.170731707317073,41.16666438199335
Task_43689,2230,237,41,123,164,9.369747899159664,42.812084916695305
Task_43690,1786,455,99,155,254,3.9166666666666665,37.01418460662077
Task_43691,1760,500,189,114,303,3.5129740518962076,36.90555805713361
Task_43692,1358,617,55,34,89,2.197411003236246,28.796281166524327
Task_43693,1051,179,42,199,241,5.838888888888889,24.1801302428068
Task_43694,1907,199,87,87,174,9.535,37.49334129729657
Task_43695,908,470,143,163,306,1.9278131634819533,23.408520939620228
Task_43696,2518,280,106,82,188,8.96085409252669,47.5095759616658
Task_43697,2353,74,96,101,197,31.373333333333335,43.7304206235421
Task_43698,1828,993,55,195,250,1.8390342052313884,39.47622908041516
Task_43699,1827,425,127,67,194,4.288732394366197,36.88866815712513
Task_43700,1970,245,29,30,59,8.008130081300813,36.88584438270893
Task_43701,2020,811,165,108,273,2.4876847290640396,41.85847398872379
Task_43702,2154,695,69,147,216,3.0948275862068964,43.490487043050564
Task_43703,2325,697,188,64,252,3.330945558739255,45.89668584371686
Task_43704,2162,1006,171,153,324,2.1469712015888778,45.011887391469116
Task_43705,695,172,24,144,168,4.017341040462428,18.040707727505794
Task_43706,2398,828,54,25,79,2.8926417370325694,45.63191892414029
Task_43707,2309,1018,183,39,222,2.26594700686948,46.240768776269825
Task_43708,1661,707,23,171,194,2.346045197740113,35.56987121206004
Task_43709,2262,975,187,24,211,2.317622950819672,45.245597975097496
Task_43710,1778,558,69,114,183,3.1806797853309483,36.86850114805768
Task_43711,2154,321,19,183,202,6.6894409937888195,42.18602820243697
Task_43712,1798,322,22,181,203,5.56656346749226,36.55780052105698
Task_43713,1428,322,161,130,291,4.421052631578948,31.0467627808938
Task_43714,1438,430,37,11,48,3.336426914153132,28.925632432407934
Task_43715,868,717,142,66,208,1.2089136490250696,22.683159889821226
Task_43716,1215,441,183,50,233,2.748868778280543,27.252301183833
Task_43717,857,869,13,149,162,0.9850574712643678,22.945404435333085
Task_43718,2600,921,76,106,182,2.819956616052061,51.008026954272566
Task_43719,2574,671,87,15,102,3.830357142857143,48.325869763131344
Task_43720,936,710,37,169,206,1.3164556962025316,24.119158839481827
Task_43721,1961,243,66,134,200,8.03688524590164,38.874868857856725
Task_43722,1350,370,164,193,357,3.638814016172507,30.359221355474304
Task_43723,1112,659,147,177,324,1.6848484848484848,27.317832353935774
Task_43724,1233,242,10,178,188,5.074074074074074,27.250124441714764
Task_43725,2302,940,195,82,277,2.4463336875664186,46.637914427307955
Task_43726,2036,225,144,146,290,9.008849557522124,40.339725763341065
Task_43727,1288,996,139,37,176,1.291875626880642,29.79013931719413
Task_43728,2978,993,52,29,81,2.995975855130785,55.65112020485853
Task_43729,1246,766,16,77,93,1.6245110821382007,28.045437643566387
Task_43730,2504,673,198,136,334,3.71513353115727,49.4082965556074
Task_43731,1528,913,45,156,201,1.6717724288840263,34.14104906309729
Task_43732,2265,324,136,126,262,6.969230769230769,44.15336559390888
Task_43733,1794,822,99,70,169,2.1798298906439855,37.47671433787006
Task_43734,643,702,49,167,216,0.914651493598862,19.535108826450905
Task_43735,1527,157,94,136,230,9.664556962025317,31.610662394769303
Task_43736,926,876,47,72,119,1.055872291904219,23.57969106710053
Task_43737,2717,100,192,131,323,26.900990099009903,50.20233121011275
Task_43738,2954,434,89,16,105,6.7908045977011495,53.62221053901187
Task_43739,2135,99,104,149,253,21.35,40.765411700376056
Task_43740,1776,576,20,156,176,3.0779896013864816,36.85206979276197
Task_43741,1444,813,94,89,183,1.7739557739557739,32.22532654549
Task_43742,2122,574,149,102,251,3.690434782608696,42.62071141383512
Task_43743,1021,1010,73,41,114,1.009891196834817,25.06579600324231
Task_43744,1203,1012,165,81,246,1.1875616979269497,29.22122796986365
Task_43745,1845,890,151,113,264,2.0707070707070705,39.29877909817505
Task_43746,1824,585,167,132,299,3.112627986348123,38.19684850472371
Task_43747,1424,522,143,73,216,2.7227533460803057,30.973695956525273
Task_43748,2923,917,116,99,215,3.184095860566449,56.21701644433504
Task_43749,2317,423,179,17,196,5.464622641509434,44.26814703328794
Task_43750,729,818,54,193,247,0.8901098901098901,21.424832487698854
Task_43751,2492,532,16,125,141,4.675422138836773,47.664199236812124
Task_43752,518,972,76,42,118,0.5323741007194245,17.13180870774549
Task_43753,842,926,146,83,229,0.9083063646170443,23.230914829818516
Task_43754,1407,723,114,145,259,1.9433701657458564,31.863665729911542
Task_43755,1027,469,172,25,197,2.1851063829787236,24.047440188637037
Task_43756,2622,456,186,150,336,5.737417943107221,50.610431368251
Task_43757,2403,133,167,36,203,17.932835820895523,44.39375237164291
Task_43758,1160,218,36,144,180,5.296803652968037,25.974570834050994
Task_43759,647,187,136,182,318,3.4414893617021276,18.484237574869
Task_43760,792,982,20,129,149,0.8056968463886063,22.190305044197306
Task_43761,2974,627,145,192,337,4.735668789808917,56.80187323862083
Task_43762,2937,590,44,147,191,4.969543147208122,55.39013834257472
Task_43763,657,816,37,105,142,0.8041615667074663,19.482967153351513
Task_43764,1481,718,190,15,205,2.0598052851182196,32.00048588076578
Task_43765,2918,987,186,54,240,2.9534412955465585,56.113648653352016
Task_43766,857,386,153,38,191,2.214470284237726,21.13746588814691
Task_43767,675,662,165,117,282,1.0180995475113122,20.074027084944387
Task_43768,2167,858,50,147,197,2.522700814901048,44.147103579149444
Task_43769,1519,965,24,137,161,1.5724637681159421,33.71463319566792
Task_43770,1053,793,153,79,232,1.3261964735516374,26.110426646257476
Task_43771,783,626,47,100,147,1.2488038277511961,20.902492023462525
Task_43772,503,563,127,149,276,0.8918439716312057,17.103357978764254
Task_43773,519,937,29,152,181,0.5533049040511727,18.137173753421543
Task_43774,2267,940,103,12,115,2.4091392136025505,44.4448004367168
Task_43775,747,661,78,84,162,1.1283987915407856,20.52636815715896
Task_43776,1576,890,148,144,292,1.7687991021324354,35.19466127346933
Task_43777,842,369,101,26,127,2.2756756756756755,20.338979891757067
Task_43778,1981,644,27,153,180,3.071317829457364,40.3317051319985
Task_43779,582,486,90,118,208,1.1950718685831623,17.716968003515614
Task_43780,2134,512,90,112,202,4.159844054580897,42.401153255709836
Task_43781,2890,326,48,18,66,8.837920489296636,51.59029921481221
Task_43782,2528,651,17,167,184,3.8773006134969323,49.01222024538921
Task_43783,1022,85,64,50,114,11.883720930232558,21.410306297965803
Task_43784,1869,364,18,86,104,5.120547945205479,36.86589564805982
Task_43785,2106,72,114,125,239,28.84931506849315,40.06776680745932
Task_43786,2874,585,183,130,313,4.90443686006826,54.88471531756875
Task_43787,1130,383,12,190,202,2.9427083333333335,26.18141928665611
Task_43788,609,101,28,164,192,5.970588235294118,16.56693073820723
Task_43789,2686,986,108,52,160,2.7213779128672746,51.98858914143369
Task_43790,619,430,53,29,82,1.4361948955916473,16.502146489080175
Task_43791,1652,605,195,56,251,2.726072607260726,34.90250162878953
Task_43792,1517,154,21,66,87,9.787096774193548,29.93168120481572
Task_43793,1110,646,74,190,264,1.7156105100463679,27.054838061923164
Task_43794,2359,497,118,134,252,4.736947791164659,46.17831900806783
Task_43795,1339,311,34,34,68,4.291666666666667,27.187287186888398
Task_43796,1633,1010,107,181,288,1.6152324431256182,36.50651912306105
Task_43797,2395,537,159,180,339,4.451672862453532,47.33643380879219
Task_43798,1933,66,11,142,153,28.850746268656717,36.41908359023955
Task_43799,2302,97,98,143,241,23.489795918367346,43.288463698976464
Task_43800,2383,396,186,184,370,6.002518891687657,46.83360970070103
Task_43801,751,664,28,61,89,1.1293233082706766,19.64780245639152
Task_43802,2272,786,179,25,204,2.8869123252858957,44.79200394285369
Task_43803,1679,156,55,189,244,10.694267515923567,34.15418607043781
Task_43804,1364,774,117,83,200,1.76,30.903232977110225
Task_43805,2532,104,146,28,174,24.114285714285714,45.98539496021834
Task_43806,2793,752,23,103,126,3.7091633466135456,53.10483055592247
Task_43807,656,543,152,141,293,1.2058823529411764,19.49645517696149
Task_43808,548,372,76,59,135,1.4691689008042896,16.0938277525633
Task_43809,629,455,132,137,269,1.3793859649122806,18.686560534830708
Task_43810,593,470,24,122,146,1.2590233545647558,17.396366169850914
Task_43811,615,555,29,59,88,1.106115107913669,17.118529735014643
Task_43812,2214,795,55,164,219,2.7814070351758793,44.79032420550959
Task_43813,760,564,173,96,269,1.345132743362832,21.075562666510137
Task_43814,2413,989,163,133,296,2.437373737373737,48.78107277418544
Task_43815,2450,609,105,151,256,4.016393442622951,48.0205731838669
Task_43816,2721,345,156,131,287,7.864161849710983,51.557289729552735
Task_43817,1264,756,197,16,213,1.6697490092470277,28.708130173500788
Task_43818,560,874,162,200,362,0.64,19.54853942561913
Task_43819,1332,694,121,136,257,1.916546762589928,30.562985340617427
Task_43820,2977,250,159,72,231,11.860557768924302,54.703617826720965
Task_43821,1851,1006,151,143,294,1.8381330685203574,39.93355674001733
Task_43822,2311,252,147,41,188,9.134387351778656,43.64429294331239
Task_43823,2979,520,190,138,328,5.717850287907869,56.41692958846814
Task_43824,689,491,107,140,247,1.4004065040650406,19.653953745687776
Task_43825,2947,971,119,70,189,3.0318930041152266,56.32975662185772
Task_43826,978,617,104,91,195,1.5825242718446602,24.270984685534955
Task_43827,1182,641,122,22,144,1.841121495327103,26.674438561854583
Task_43828,754,237,198,194,392,3.168067226890756,20.662601350615805
Task_43829,1044,922,181,149,330,1.1310942578548213,26.980142026674603
Task_43830,641,677,152,127,279,0.9454277286135693,19.63066701955647
Task_43831,2648,838,53,29,82,3.156138259833135,49.89987152687797
Task_43832,1366,930,107,73,180,1.4672395273899033,31.116942939852805
Task_43833,1729,389,29,76,105,4.433333333333334,34.67583149175574
Task_43834,2730,1002,47,56,103,2.7218344965104686,52.1497177915542
Task_43835,1423,997,28,80,108,1.4258517034068137,31.770511894455698
Task_43836,2222,653,72,119,191,3.397553516819572,44.26899862130477
Task_43837,782,776,61,51,112,1.0064350064350065,20.59897630824418
Task_43838,1485,183,123,30,153,8.070652173913043,30.070636805396376
Task_43839,1476,306,157,177,334,4.807817589576548,32.01558056960465
Task_43840,2384,601,116,91,207,3.9601328903654487,46.58617306946558
Task_43841,2530,168,125,159,284,14.970414201183432,47.70827579797834
Task_43842,1457,360,107,125,232,4.03601108033241,31.356465531069507
Task_43843,2167,950,179,56,235,2.2786540483701367,44.06778523769989
Task_43844,1687,853,101,192,293,1.9754098360655739,36.92668136642241
Task_43845,827,760,24,111,135,1.0867279894875164,21.899134950712693
Task_43846,1576,898,180,75,255,1.753058954393771,34.7798000983071
Task_43847,2664,405,134,121,255,6.561576354679803,50.699261230759966
Task_43848,755,512,31,100,131,1.4717348927875245,20.041276915946906
Task_43849,1879,885,98,141,239,2.120767494356659,39.75455694489633
Task_43850,1458,979,111,196,307,1.4877551020408164,33.71553094260936
Task_43851,2624,313,25,51,76,8.356687898089172,47.728534766544705
Task_43852,986,771,26,153,179,1.2772020725388602,24.88385338791824
Task_43853,1748,315,175,178,353,5.531645569620253,36.43363734919742
Task_43854,1972,380,130,173,303,5.175853018372703,39.95972048856765
Task_43855,2606,967,186,65,251,2.6921487603305785,51.206688491529746
Task_43856,2113,322,160,131,291,6.541795665634675,41.88083754090825
Task_43857,2779,983,131,49,180,2.8241869918699187,53.490484483675026
Task_43858,755,879,28,195,223,0.8579545454545454,21.835482129125367
Task_43859,1568,818,157,81,238,1.9145299145299146,34.41759555420732
Task_43860,1175,923,27,81,108,1.2716450216450217,27.64337550070489
Task_43861,1787,965,18,124,142,1.849896480331263,37.866265215206745
Task_43862,2161,869,164,134,298,2.4839080459770115,44.42434951251936
Task_43863,2445,584,92,57,149,4.17948717948718,46.88646368401927
Task_43864,502,743,96,102,198,0.6747311827956989,17.35968131699598
Task_43865,1710,144,184,103,287,11.793103448275861,34.60344499512899
Task_43866,2366,93,36,35,71,25.170212765957448,42.13197987215856
Task_43867,584,936,17,133,150,0.6232657417289221,18.94365113784897
Task_43868,1059,570,155,147,302,1.8546409807355517,26.07101232075658
Task_43869,2120,699,186,151,337,3.0285714285714285,43.44327255592989
Task_43870,1608,521,65,67,132,3.0804597701149423,33.48554634524497
Task_43871,1125,665,61,15,76,1.6891891891891893,24.741447732528982
Task_43872,1245,74,145,186,331,16.6,27.116112688277777
Task_43873,2756,411,159,142,301,6.689320388349515,52.41318654557332
Task_43874,1765,926,87,87,174,1.9039913700107876,37.587277811914824
Task_43875,2544,679,168,72,240,3.7411764705882353,49.322798046817304
Task_43876,2517,800,18,144,162,3.142322097378277,49.10544436553246
Task_43877,2981,291,169,33,202,10.20890410958904,54.4431428564613
Task_43878,1261,865,105,134,239,1.456120092378753,29.831980524827213
Task_43879,2440,788,194,19,213,3.0925221799746514,47.46871458682819
Task_43880,1879,986,139,111,250,1.9037487335359675,40.069952920115504
Task_43881,1351,98,115,110,225,13.646464646464647,28.24344246530299
Task_43882,527,877,43,45,88,0.6002277904328018,16.965758296385314
Task_43883,2847,360,52,17,69,7.886426592797784,51.018382817452874
Task_43884,2663,530,117,15,132,5.015065913370998,49.678174704217334
Task_43885,664,274,33,79,112,2.4145454545454546,17.648059533610063
Task_43886,2470,302,42,53,95,8.151815181518153,45.76403634546043
Task_43887,1078,635,32,103,135,1.6949685534591195,25.54808559806179
Task_43888,1140,873,50,103,153,1.3043478260869565,27.366329945731376
Task_43889,2683,475,170,99,269,5.63655462184874,51.25537823432918
Task_43890,1179,743,67,119,186,1.5846774193548387,27.948999556112643
Task_43891,924,999,181,57,238,0.924,24.614175239868022
Task_43892,2815,475,198,83,281,5.913865546218488,53.309586075760556
Task_43893,2923,777,76,193,269,3.7570694087403598,56.231523111593646
Task_43894,868,945,19,50,69,0.9175475687103594,21.964778055884683
Task_43895,2700,215,194,102,296,12.5,50.74942847566704
Task_43896,1039,137,200,126,326,7.528985507246377,24.163801666610137
Task_43897,2185,530,111,25,136,4.114877589453861,42.14811849006451
Task_43898,726,1002,84,117,201,0.7238285144566301,21.716603893678084
Task_43899,1978,987,24,37,61,2.0020242914979756,39.42269560745751
Task_43900,1760,311,45,175,220,5.641025641025641,36.03421971303897
Task_43901,2716,438,65,25,90,6.186788154897494,49.76328293598482
Task_43902,2696,365,153,15,168,7.366120218579235,49.895372698528554
Task_43903,2984,581,144,147,291,5.1271477663230245,56.53957685969929
Task_43904,1991,554,198,198,396,3.5873873873873876,41.27705293486137
Task_43905,689,232,62,198,260,2.9570815450643777,19.097520020726595
Task_43906,2879,781,197,24,221,3.6815856777493607,54.45989007617512
Task_43907,1492,436,126,37,163,3.414187643020595,31.205739303936365
Task_43908,887,1018,156,137,293,0.8704612365063789,24.65126952852717
Task_43909,2876,760,97,68,165,3.7792378449408672,54.467392141109976
Task_43910,1044,697,160,98,258,1.495702005730659,25.92396349292504
Task_43911,708,123,54,97,151,5.709677419354839,17.738050168922452
Task_43912,1003,265,148,63,211,3.7706766917293235,23.398763694524703
Task_43913,1704,741,186,190,376,2.2964959568733154,37.21799932993166
Task_43914,1469,962,193,42,235,1.525441329179647,32.817712955291974
Task_43915,2481,973,102,101,203,2.547227926078029,49.342738796709774
Task_43916,1076,95,77,55,132,11.208333333333334,22.77778200625566
Task_43917,1608,458,186,11,197,3.503267973856209,33.164727891284926
Task_43918,2067,90,173,47,220,22.714285714285715,38.66964874599128
Task_43919,2311,841,181,104,285,2.7446555819477436,46.61097904492096
Task_43920,2945,913,24,113,137,3.2221006564551424,56.00398322156118
Task_43921,798,413,28,13,41,1.9275362318840579,18.68089070682522
Task_43922,2559,201,28,27,55,12.668316831683168,46.04901047330524
Task_43923,506,894,186,164,350,0.5653631284916201,18.6330192078855
Task_43924,1445,243,177,142,319,5.922131147540983,31.19362549742753
Task_43925,1411,959,72,126,198,1.4697916666666666,32.3680163533486
Task_43926,1115,496,74,194,268,2.243460764587525,26.701844204584557
Task_43927,2973,437,66,197,263,6.787671232876712,55.92059364602608
Task_43928,2377,342,134,144,278,6.930029154518951,46.084470345799446
Task_43929,2148,76,46,28,74,27.896103896103895,38.40375648145233
Task_43930,2738,539,115,126,241,5.07037037037037,52.25292340160297
Task_43931,1441,601,171,80,251,2.393687707641196,31.789944964331585
Task_43932,2400,984,24,103,127,2.436548223350254,47.58182017235064
Task_43933,1351,509,178,92,270,2.649019607843137,30.226186415486755
Task_43934,1319,790,90,28,118,1.6675094816687737,29.07920131920976
Task_43935,1687,689,100,86,186,2.444927536231884,35.673668433328054
Task_43936,941,804,138,26,164,1.168944099378882,23.615540857099507
Task_43937,2176,1009,109,125,234,2.1544554455445546,44.796393508434676
Task_43938,1117,1012,97,156,253,1.102665350444225,28.086400181974074
Task_43939,1981,688,193,122,315,2.8751814223512335,41.065265972527875
Task_43940,2992,269,169,71,240,11.08148148148148,55.02978420570489
Task_43941,2721,77,176,50,226,34.88461538461539,48.856238746122756
Task_43942,2119,471,176,84,260,4.489406779661017,42.18335131113208
Task_43943,2853,77,35,143,178,36.57692307692308,51.4859036884799
Task_43944,2834,280,158,179,337,10.08540925266904,53.41062372587078
Task_43945,2854,991,195,48,243,2.877016129032258,54.9264649703892
Task_43946,2507,158,200,89,289,15.767295597484276,47.16388437190176
Task_43947,2924,520,40,125,165,5.612284069097889,54.772604657039174
Task_43948,2616,869,10,55,65,3.0068965517241377,49.382022235276565
Task_43949,573,580,43,72,115,0.9862306368330465,17.106355306115447
Task_43950,2720,600,57,40,97,4.525790349417638,50.363381271134564
Task_43951,1853,1006,117,27,144,1.840119165839126,38.47804516157888
Task_43952,821,639,155,22,177,1.2828125,21.19949709285034
Task_43953,2113,494,187,194,381,4.268686868686869,42.94358879556399
Task_43954,1792,189,112,114,226,9.43157894736842,36.02240371929482
Task_43955,2694,581,92,33,125,4.628865979381444,50.3605930052403
Task_43956,1996,537,143,128,271,3.7100371747211898,40.63615713065085
Task_43957,1157,751,80,116,196,1.538563829787234,27.678182851296224
Task_43958,503,199,190,108,298,2.515,16.034266541643817
Task_43959,2155,362,25,19,44,5.9366391184573,40.009854408593874
Task_43960,2843,246,50,195,245,11.510121457489879,53.13337174400397
Task_43961,1386,276,17,78,95,5.003610108303249,28.695820359438375
Task_43962,1996,793,192,98,290,2.513853904282116,41.49148072901091
Task_43963,1122,562,100,200,300,1.9928952042628774,27.1122652441375
Task_43964,1007,91,111,149,260,10.945652173913043,23.06307074349516
Task_43965,2692,805,86,16,102,3.339950372208437,50.61539547695957
Task_43966,1880,790,84,131,215,2.3767383059418457,39.357032207770025
Task_43967,1392,692,73,22,95,2.0086580086580086,29.70192990954123
Task_43968,1672,1008,148,76,224,1.6570862239841426,36.519319457001394
Task_43969,2785,534,100,45,145,5.205607476635514,51.81618587113159
Task_43970,1037,944,159,102,261,1.0973544973544973,26.56961979309115
Task_43971,980,190,52,63,115,5.130890052356021,22.345221437569837
Task_43972,804,329,73,39,112,2.4363636363636365,19.42856832077754
Task_43973,2059,163,71,105,176,12.554878048780488,39.718452701304166
Task_43974,572,411,165,191,356,1.3883495145631068,18.118195636374427
Task_43975,1474,725,44,148,192,2.0303030303030303,32.65033598228968
Task_43976,2643,451,178,156,334,5.847345132743363,50.92622292193638
Task_43977,900,258,145,102,247,3.474903474903475,22.249931875693864
Task_43978,2178,923,113,80,193,2.357142857142857,44.208296782509954
Task_43979,2267,92,185,51,236,24.376344086021504,42.02035546351092
Task_43980,2780,215,182,16,198,12.87037037037037,50.85899292897787
Task_43981,2344,936,119,186,305,2.501600853788687,47.64078850716296
Task_43982,844,1004,22,104,126,0.8398009950248756,22.977014392808474
Task_43983,2676,907,52,165,217,2.947136563876652,52.455666566843
Task_43984,1944,697,121,98,219,2.7851002865329515,40.04710257134415
Task_43985,1734,276,155,44,199,6.259927797833935,34.67055780706155
Task_43986,662,649,187,51,238,1.0184615384615385,19.280631026141318
Task_43987,1746,570,53,111,164,3.0577933450087564,36.29970824077947
Task_43988,1813,82,187,20,207,21.843373493975903,34.46130110973053
Task_43989,1287,552,157,169,326,2.3273056057866186,29.765344075269084
Task_43990,678,901,34,51,85,0.7516629711751663,19.21886406598274
Task_43991,1762,123,121,82,203,14.209677419354838,34.71151677176311
Task_43992,2977,867,196,92,288,3.4297235023041477,57.18889470782967
Task_43993,1259,208,68,89,157,6.023923444976076,27.23276974123713
Task_43994,1543,678,58,21,79,2.272459499263623,31.582404934364174
Task_43995,2759,322,178,99,277,8.541795665634675,51.98072240608519
Task_43996,1364,966,157,122,279,1.4105480868665978,31.939836212303334
Task_43997,575,866,147,20,167,0.6632064590542099,18.251642315796076
Task_43998,2389,203,93,157,250,11.71078431372549,45.70339290506674
Task_43999,1579,871,101,125,226,1.8107798165137614,34.87126311884813
Task_44000,786,670,100,43,143,1.1713859910581221,20.549690996066136
Task_44001,1112,389,41,198,239,2.8512820512820514,26.1429584892481
Task_44002,1211,317,152,95,247,3.808176100628931,27.362675372863873
Task_44003,2747,222,108,79,187,12.318385650224215,50.87096023638407
Task_44004,2870,630,71,164,235,4.5483359746434235,54.72349790857144
Task_44005,1045,70,139,115,254,14.71830985915493,23.520229104814785
Task_44006,673,711,104,64,168,0.9452247191011236,19.430216902889082
Task_44007,2183,293,107,136,243,7.425170068027211,42.67912598318522
Task_44008,2056,612,49,108,157,3.3539967373572592,41.185535544993414
Task_44009,1406,958,148,177,325,1.4661105318039624,32.86858189243073
Task_44010,2603,853,75,73,148,3.048009367681499,50.38102448852565
Task_44011,1084,1006,50,26,76,1.0764647467725919,25.44119042179588
Task_44012,1953,573,123,135,258,3.402439024390244,40.021285945145316
Task_44013,1257,868,162,89,251,1.4464902186421174,29.727528127729325
Task_44014,611,159,96,199,295,3.81875,17.553569415516105
Task_44015,950,958,19,182,201,0.9906152241918665,25.037445742135485
Task_44016,662,140,120,31,151,4.695035460992908,16.615126606872057
Task_44017,680,1007,159,200,359,0.6746031746031746,21.844738944080458
Task_44018,1602,993,38,105,143,1.6116700201207244,35.025852679296804
Task_44019,2109,213,97,80,177,9.855140186915888,40.72848747748734
Task_44020,1453,645,173,45,218,2.2492260061919507,31.490944553082556
Task_44021,1932,756,109,191,300,2.5521796565389696,40.53574611999162
Task_44022,601,124,185,187,372,4.808,17.484164236056483
Task_44023,1696,254,119,133,252,6.650980392156863,34.88236914830767
Task_44024,1307,743,151,94,245,1.756720430107527,30.183913373653315
Task_44025,2977,600,65,17,82,4.953410981697171,54.31675748040044
Task_44026,2149,780,181,18,199,2.7516005121638925,42.76123896252577
Task_44027,953,958,92,40,132,0.9937434827945777,24.20831517250178
Task_44028,1282,1012,81,144,225,1.265547877591313,30.604182935831943
Task_44029,1284,810,175,173,348,1.5832305795314427,30.58523116214057
Task_44030,2740,68,167,96,263,39.710144927536234,50.057693277872204
Task_44031,2812,227,50,100,150,12.333333333333334,51.79903490171602
Task_44032,1200,204,179,12,191,5.853658536585366,25.84897433409904
Task_44033,2046,300,45,199,244,6.79734219269103,40.66228829307602
Task_44034,2511,977,35,110,145,2.567484662576687,49.42400033319154
Task_44035,2103,747,191,151,342,2.8114973262032086,43.347179300735355
Task_44036,2576,384,35,147,182,6.6909090909090905,48.92585870788864
Task_44037,1236,589,55,132,187,2.094915254237288,28.449141203923592
Task_44038,647,773,153,54,207,0.8359173126614987,19.34850172283407
Task_44039,1885,877,20,105,125,2.146924829157175,39.06826397885926
Task_44040,2332,407,143,91,234,5.715686274509804,45.25872520976694
Task_44041,2676,413,168,43,211,6.463768115942029,50.09144918456542
Task_44042,2769,356,184,190,374,7.756302521008403,52.832833578658665
Task_44043,709,388,182,194,376,1.8226221079691516,20.362237418763577
Task_44044,1185,1006,27,76,103,1.1767626613704072,27.977633046149847
Task_44045,1993,908,44,111,155,2.1925192519251926,41.03912399847851
Task_44046,2216,441,95,99,194,5.013574660633484,43.42497657290877
Task_44047,1833,83,31,126,157,21.821428571428573,35.04554048300398
Task_44048,1787,258,27,97,124,6.899613899613899,35.51372389225863
Task_44049,1659,776,124,154,278,2.135135135135135,36.119890420284825
Task_44050,992,465,146,169,315,2.128755364806867,24.77181189060076
Task_44051,1675,116,15,87,102,14.316239316239317,32.347862754742636
Task_44052,2962,933,164,40,204,3.171306209850107,56.24383146566055
Task_44053,2511,855,60,164,224,2.933411214953271,49.70601712463148
Task_44054,2333,390,193,132,325,5.966751918158568,45.743536897212586
Task_44055,1050,205,18,169,187,5.097087378640777,24.239417279987546
Task_44056,2643,192,49,94,143,13.694300518134716,49.01032117810084
Task_44057,885,589,74,179,253,1.5,23.22313049370283
Task_44058,595,456,163,62,225,1.301969365426696,17.5701115707009
Task_44059,1468,481,10,82,92,3.045643153526971,30.70515662314941
Task_44060,873,282,24,80,104,3.0848056537102475,20.82978470175188
Task_44061,1841,216,135,133,268,8.483870967741936,37.10885967279286
Task_44062,503,580,160,64,224,0.8657487091222031,16.590997064444416
Task_44063,2533,122,200,44,244,20.59349593495935,46.533959058303424
Task_44064,2928,542,186,125,311,5.392265193370166,55.58503711627153
Task_44065,2557,182,126,191,317,13.972677595628415,48.502675068697066
Task_44066,1387,456,115,25,140,3.035010940919037,29.310277876164864
Task_44067,2715,108,188,51,239,24.908256880733944,49.29027223069494
Task_44068,1444,169,63,49,112,8.494117647058824,28.60363041786165
Task_44069,1359,92,110,167,277,14.612903225806452,28.685322512564067
Task_44070,958,208,96,132,228,4.583732057416268,22.964779366239714
Task_44071,2045,829,132,136,268,2.463855421686747,42.329286104720545
Task_44072,2641,341,188,102,290,7.722222222222222,50.2492111318762
Task_44073,1540,738,163,145,308,2.0838971583220567,34.23817967929794
Task_44074,1821,552,133,150,283,3.2929475587703436,37.9992049387445
Task_44075,1523,847,128,128,256,1.7959905660377358,34.04898001385769
Task_44076,2981,125,188,61,249,23.658730158730158,53.87035365361521
Task_44077,2851,285,136,190,326,9.968531468531468,53.66405536160001
Task_44078,2668,143,13,127,140,18.52777777777778,48.586742588423846
Task_44079,2748,963,18,164,182,2.8506224066390042,53.490453645701244
Task_44080,1350,983,15,65,80,1.3719512195121952,30.066481308348816
Task_44081,2349,134,90,67,157,17.4,43.28648294570477
Task_44082,2430,901,117,123,240,2.694013303769401,48.50900636590335
Task_44083,2581,179,12,87,99,14.338888888888889,46.95326321660792
Task_44084,649,425,91,120,211,1.5234741784037558,18.63749741229017
Task_44085,2506,949,169,123,292,2.6378947368421053,50.097448894808245
Task_44086,1812,438,67,199,266,4.12756264236902,37.56239792977935
Task_44087,1365,860,88,99,187,1.5853658536585367,31.127734595579593
Task_44088,1341,546,165,180,345,2.4515539305301646,30.703284094416972
Task_44089,743,825,101,86,187,0.8995157384987893,21.157814373960317
Task_44090,2955,223,139,100,239,13.191964285714286,54.548309609320974
Task_44091,1991,680,91,152,243,2.923641703377386,40.91734047183164
Task_44092,848,78,85,92,177,10.734177215189874,19.932928071964557
Task_44093,775,111,95,46,141,6.919642857142857,18.113057369067803
Task_44094,1697,704,138,30,168,2.40709219858156,35.271546488561434
Task_44095,836,499,158,45,203,1.672,21.194896278014713
Task_44096,1353,506,97,132,229,2.668639053254438,30.181712950410382
Task_44097,2472,89,59,80,139,27.466666666666665,45.03803277239859
Task_44098,654,177,28,81,109,3.6741573033707864,16.705164900250622
Task_44099,2877,753,166,17,183,3.815649867374005,54.11458016569236
Task_44100,2402,791,101,191,292,3.032828282828283,48.05526513796764
Task_44101,598,849,131,88,219,0.7035294117647058,19.210288770161768
Task_44102,2599,583,164,72,236,4.450342465753424,49.870815141447196
Task_44103,1982,902,107,76,183,2.194905869324474,40.88066248814573
Task_44104,853,220,121,150,271,3.8597285067873304,21.559988935089635
Task_44105,1633,737,107,23,130,2.2127371273712737,34.043067565988885
Task_44106,2330,271,92,124,216,8.566176470588236,44.793707593537704
Task_44107,1220,661,30,192,222,1.8429003021148036,28.613573783078902
Task_44108,2070,876,71,43,114,2.3603192702394526,41.248617721316705
Task_44109,1536,242,50,187,237,6.320987654320987,32.42234351802787
Task_44110,1565,566,154,194,348,2.760141093474427,34.347238968919946
Task_44111,1658,595,30,177,207,2.7818791946308723,35.25411115874253
Task_44112,2408,501,54,171,225,4.796812749003984,46.96952382697811
Task_44113,1172,980,102,174,276,1.1946992864424058,28.99754068098792
Task_44114,2514,734,132,142,274,3.4204081632653063,49.49753742900392
Task_44115,1976,622,109,171,280,3.171749598715891,40.692385862675565
Task_44116,1885,958,161,36,197,1.9655891553701772,39.2158806394178
Task_44117,2256,314,31,185,216,7.161904761904762,43.85344417860896
Task_44118,2147,718,48,12,60,2.9860917941585536,41.09682597223964
Task_44119,2433,548,108,52,160,4.4316939890710385,46.60133973481368
Task_44120,2102,188,11,168,179,11.121693121693122,40.723613446549805
Task_44121,506,604,44,128,172,0.8363636363636363,16.71198973397493
Task_44122,2869,783,66,65,131,3.6594387755102042,54.30277891843338
Task_44123,2928,197,74,125,199,14.787878787878787,53.97220323107454
Task_44124,781,317,42,179,221,2.4559748427672954,20.572103711196622
Task_44125,1408,424,54,37,91,3.3129411764705883,29.029542205027486
Task_44126,1568,348,153,70,223,4.492836676217765,32.67421988361522
Task_44127,1259,431,88,183,271,2.9143518518518516,28.67124222660591
Task_44128,518,261,66,127,193,1.9770992366412214,16.09384413526707
Task_44129,2764,498,16,136,152,5.539078156312625,51.89776714094745
Task_44130,2771,317,21,44,65,8.713836477987421,49.84560294989015
Task_44131,1297,273,152,172,324,4.733576642335766,29.023423755960568
Task_44132,569,600,120,136,256,0.9467554076539102,18.16124868937539
Task_44133,1884,813,178,64,242,2.3144963144963144,39.2288864142479
Task_44134,2855,439,95,13,108,6.488636363636363,52.175108225482994
Task_44135,2151,419,110,99,209,5.121428571428571,42.38184552927635
Task_44136,1812,524,195,79,274,3.4514285714285715,37.52098419831146
Task_44137,1677,772,40,200,240,2.169469598965071,36.298617393656045
Task_44138,1082,92,10,121,131,11.634408602150538,23.157814408286963
Task_44139,607,359,63,13,76,1.6861111111111111,15.622436183811379
Task_44140,1198,811,37,180,217,1.4753694581280787,28.662718365133497
Task_44141,941,208,35,128,163,4.502392344497608,22.34837495318475
Task_44142,1882,874,163,92,255,2.150857142857143,39.71208905688005
Task_44143,2860,344,108,127,235,8.289855072463768,53.51220623234798
Task_44144,812,472,128,40,168,1.7167019027484143,20.528632518798123
Task_44145,595,223,80,126,206,2.65625,17.22072972153374
Task_44146,1626,850,69,200,269,1.9106933019976498,35.926846275581575
Task_44147,2819,442,139,77,216,6.363431151241535,52.86844092023571
Task_44148,2865,783,102,12,114,3.6543367346938775,53.43595047122193
Task_44149,1224,404,15,63,78,3.022222222222222,26.119945624852097
Task_44150,1884,862,66,45,111,2.183082271147161,38.1744180183175
Task_44151,561,392,79,53,132,1.4274809160305344,16.397145744724202
Task_44152,731,674,121,120,241,1.082962962962963,20.817860166750652
Task_44153,1108,972,93,88,181,1.1387461459403905,27.333534884820324
Task_44154,2337,176,101,140,241,13.203389830508474,44.423845150457716
Task_44155,677,888,105,158,263,0.7615298087739033,20.84978112172212
Task_44156,2407,317,87,25,112,7.569182389937107,44.689204445959625
Task_44157,2646,846,19,176,195,3.12396694214876,51.61944078807023
Task_44158,2888,133,181,138,319,21.55223880597015,53.24452059025362
Task_44159,1548,320,171,173,344,4.822429906542056,33.23973325167826
Task_44160,1405,178,98,136,234,7.849162011173185,29.69505312909968
Task_44161,1324,720,93,42,135,1.8363384188626908,29.253300557530512
Task_44162,612,428,70,52,122,1.4265734265734267,17.029239131041816
Task_44163,2868,441,48,156,204,6.48868778280543,53.92842452656998
Task_44164,1541,175,124,183,307,8.755681818181818,32.2452025284454
Task_44165,2662,950,174,173,347,2.7991587802313354,52.893761369020446
Task_44166,1102,721,67,117,184,1.5263157894736843,26.644438444029547
Task_44167,2415,223,147,193,340,10.78125,46.611910497770964
Task_44168,616,360,15,33,48,1.706371191135734,15.820084697855295
Task_44169,1263,856,178,132,310,1.4737456242707119,30.152819599652272
Task_44170,2358,998,174,35,209,2.3603603603603602,46.893755567892946
Task_44171,1876,808,181,185,366,2.318912237330037,40.099697111707066
Task_44172,1901,184,142,26,168,10.275675675675675,36.75979968806666
Task_44173,2420,903,127,12,139,2.6769911504424777,47.02068248117046
Task_44174,742,966,91,94,185,0.7673216132368149,21.62846017121215
Task_44175,2755,398,171,78,249,6.904761904761905,51.902818510420566
Task_44176,992,672,134,70,204,1.473997028231798,24.471576149388824
Task_44177,2886,953,47,170,217,3.0251572327044025,55.9025218945917
Task_44178,2216,145,70,22,92,15.178082191780822,40.67936829444296
Task_44179,2138,531,82,43,125,4.018796992481203,41.32261561429596
Task_44180,1897,747,181,130,311,2.536096256684492,39.913281339094716
Task_44181,1282,536,60,87,147,2.387337057728119,28.64622225830181
Task_44182,791,150,100,133,233,5.23841059602649,19.96425190834439
Task_44183,1869,155,133,140,273,11.98076923076923,37.16038870772277
Task_44184,2447,261,149,144,293,9.33969465648855,46.975421175944085
Task_44185,2242,149,48,188,236,14.946666666666667,42.94238889567118
Task_44186,2491,706,75,17,92,3.5233380480905234,47.101686533891176
Task_44187,917,899,154,40,194,1.018888888888889,23.69439206397492
Task_44188,2884,172,128,13,141,16.670520231213874,51.72180239375236
Task_44189,2238,632,68,133,201,3.5355450236966823,44.534861736743885
Task_44190,1709,900,48,35,83,1.8967813540510543,35.26204463410864
Task_44191,1956,520,116,134,250,3.7543186180422263,39.862813669214724
Task_44192,2711,718,27,47,74,3.7705146036161334,50.25116097753811
Task_44193,1254,510,93,58,151,2.4540117416829745,27.78635950783985
Task_44194,767,227,71,52,123,3.3640350877192984,18.93837944144032
Task_44195,1959,493,134,51,185,3.965587044534413,39.079610679249264
Task_44196,2166,919,128,48,176,2.3543478260869564,43.48684576145333
Task_44197,680,655,12,60,72,1.0365853658536586,18.10982446340427
Task_44198,2081,549,73,198,271,3.7836363636363637,42.18279526234512
Task_44199,2833,176,73,82,155,16.005649717514125,51.59488862400209
Task_44200,911,492,114,40,154,1.8478701825557808,21.98896541910804
Task_44201,1632,874,181,194,375,1.8651428571428572,36.49306036144098
Task_44202,1210,193,173,177,350,6.237113402061856,27.493483793385792
Task_44203,1883,181,85,43,128,10.346153846153847,36.13027822554641
Task_44204,2792,180,139,46,185,15.425414364640885,50.76496454423454
Task_44205,1574,292,98,199,297,5.3720136518771335,33.387921912146446
Task_44206,2713,606,43,20,63,4.469522240527183,49.76456493036246
Task_44207,638,532,57,56,113,1.1969981238273921,17.701061990540566
Task_44208,1736,208,143,36,179,8.30622009569378,34.353938479898055
Task_44209,915,753,164,168,332,1.2135278514588859,24.46122510437181
Task_44210,2074,955,67,115,182,2.1694560669456067,42.79975423071463
Task_44211,1830,424,187,24,211,4.305882352941176,36.66701225384399
Task_44212,2689,271,50,39,89,9.886029411764707,48.786710834228636
Task_44213,2502,361,23,189,212,6.911602209944752,47.88199344096495
Task_44214,652,326,193,77,270,1.9938837920489296,18.44924126324422
Task_44215,551,763,192,107,299,0.7212041884816754,18.612173939002023
Task_44216,2636,829,125,99,224,3.175903614457831,51.43445523532021
Task_44217,639,425,113,135,248,1.5,18.66460077605403
Task_44218,1878,546,46,28,74,3.43327239488117,36.48933169481244
Task_44219,1879,918,166,87,253,2.044613710554951,39.775563417461804
Task_44220,594,577,10,167,177,1.027681660899654,18.036373972881737
Task_44221,2584,909,192,125,317,2.8395604395604397,51.32416112383502
Task_44222,671,1023,91,96,187,0.6552734375,20.884427889491747
Task_44223,1011,227,152,19,171,4.434210526315789,22.818251195611413
Task_44224,1635,647,164,91,255,2.5231481481481484,35.08539044476606
Task_44225,1634,665,96,79,175,2.4534534534534536,34.68492568905531
Task_44226,1804,539,104,90,194,3.3407407407407406,37.16601951018753
Task_44227,690,453,190,124,314,1.5198237885462555,19.840743699839386
Task_44228,1325,187,151,42,193,7.047872340425532,27.946945005207066
Task_44229,2270,812,96,47,143,2.7921279212792127,44.54570598093765
Task_44230,1679,722,95,74,169,2.322268326417704,35.447936285662045
Task_44231,1940,510,43,99,142,3.796477495107632,38.85634956276255
Task_44232,658,550,44,51,95,1.1941923774954628,17.884126031833482
Task_44233,1453,172,130,154,284,8.398843930635838,30.715097458608728
Task_44234,1753,162,140,51,191,10.754601226993865,34.483412899341694
Task_44235,2932,111,181,149,330,26.178571428571427,53.76229591231291
Task_44236,2835,705,143,153,296,4.015580736543909,54.60620938942683
Task_44237,1534,596,71,54,125,2.5695142378559463,32.28616677847208
Task_44238,570,524,97,77,174,1.0857142857142856,17.278756835601897
Task_44239,1971,916,169,26,195,2.149400218102508,40.410169264242526
Task_44240,1971,922,25,170,195,2.1354279523293607,41.15310111149544
Task_44241,1427,370,113,199,312,3.8463611859838274,31.38336447438711
Task_44242,2622,604,86,170,256,4.333884297520661,50.71671550560458
Task_44243,1938,821,31,58,89,2.3576642335766422,38.91769754605583
Task_44244,2619,483,105,184,289,5.411157024793388,50.48902500379561
Task_44245,1423,889,25,34,59,1.598876404494382,30.327790684632266
Task_44246,1029,775,27,107,134,1.3260309278350515,25.166091527817603
Task_44247,2175,634,24,168,192,3.425196850393701,43.46842693933578
Task_44248,2654,609,103,84,187,4.350819672131148,50.74629640155018
Task_44249,856,379,77,145,222,2.2526315789473683,21.96064170678618
Task_44250,2247,73,53,18,71,30.364864864864863,39.48691539923936
Task_44251,2637,82,69,142,211,31.771084337349397,48.386313690791724
Task_44252,912,942,110,73,183,0.9671261930010604,24.02588196469094
Task_44253,1493,520,189,19,208,2.8656429942418424,31.6034898372825
Task_44254,2270,452,188,194,382,5.011037527593819,45.29769492546518
Task_44255,1306,803,174,42,216,1.6243781094527363,29.673290375612055
Task_44256,2157,229,151,89,240,9.378260869565217,41.91412584510068
Task_44257,816,747,132,57,189,1.0909090909090908,21.80471028634608
Task_44258,2565,669,165,115,280,3.828358208955224,50.08767579030454
Task_44259,2215,180,136,109,245,12.237569060773481,42.50600253749765
Task_44260,715,452,70,24,94,1.5783664459161149,18.264330272931442
Task_44261,630,223,150,115,265,2.8125,17.969956316180554
Task_44262,2710,450,167,200,367,6.008869179600887,52.196642842575294
Task_44263,2530,339,182,171,353,7.4411764705882355,48.87180967898555
Task_44264,2918,351,191,101,292,8.289772727272727,54.67256579598919
Task_44265,2607,556,69,150,219,4.6804308797127465,50.24179191989239
Task_44266,2936,815,135,179,314,3.5980392156862746,56.672461637732226
Task_44267,1058,150,145,174,319,7.006622516556291,24.61948196740899
Task_44268,2133,589,86,138,224,3.6152542372881356,42.73386797590022
Task_44269,1244,341,168,137,305,3.6374269005847952,28.272143977699546
Task_44270,1091,382,99,149,248,2.848563968668407,25.746030231733894
Task_44271,1668,1009,42,112,154,1.6514851485148514,36.148711211407644
Task_44272,1551,965,132,69,201,1.6055900621118013,34.245726144585994
Task_44273,821,463,195,177,372,1.769396551724138,22.31398869120002
Task_44274,2187,678,13,94,107,3.2209131075110458,42.95312090176967
Task_44275,1423,344,157,184,341,4.12463768115942,31.34428723119858
Task_44276,1027,902,200,35,235,1.1373200442967886,25.628994091964856
Task_44277,1842,816,195,23,218,2.254589963280294,38.13097907897188
Task_44278,2555,1022,139,147,286,2.4975562072336266,51.10958011009067
Task_44279,1955,170,132,154,286,11.432748538011696,38.64466737812962
Task_44280,592,518,102,187,289,1.140655105973025,18.445679629426433
Task_44281,1047,975,15,52,67,1.0727459016393444,24.90840887498972
Task_44282,1819,522,166,138,304,3.478011472275335,37.94936025968888
Task_44283,1381,468,136,96,232,2.9445628997867805,30.486023263591147
Task_44284,1991,552,140,32,172,3.600361663652803,39.497439584610824
Task_44285,2981,254,123,44,167,11.690196078431372,54.141881826752915
Task_44286,2132,379,85,44,129,5.610526315789474,40.86777930224311
Task_44287,2776,553,118,108,226,5.0108303249097474,52.80571007557114
Task_44288,820,572,118,171,289,1.431064572425829,22.215382012989142
Task_44289,2199,207,119,108,227,10.572115384615385,42.50573756986562
Task_44290,2935,732,190,11,201,4.004092769440655,55.067438497088204
Task_44291,1504,345,143,128,271,4.3468208092485545,32.231164061519216
Task_44292,638,910,152,182,334,0.7003293084522503,20.715937037061156
Task_44293,1599,590,195,56,251,2.7055837563451774,34.0159657832873
Task_44294,693,862,95,154,249,0.8030127462340672,20.930194248697816
Task_44295,2429,396,138,98,236,6.1183879093199,46.83898066399101
Task_44296,1639,521,167,174,341,3.1398467432950192,35.315843879970465
Task_44297,973,858,53,146,199,1.1327124563445867,25.131316141423344
Task_44298,1828,637,138,69,207,2.865203761755486,37.63280244177181
Task_44299,1809,288,94,47,141,6.259515570934256,35.57719926854971
Task_44300,2711,451,191,70,261,5.997787610619469,51.269712012714194
Task_44301,1230,834,174,83,257,1.473053892215569,29.183157023051564
Task_44302,836,883,155,130,285,0.9457013574660633,23.38888269122944
Task_44303,2382,102,15,192,207,23.12621359223301,44.53167960600364
Task_44304,2031,336,34,196,230,6.026706231454006,40.46364094467461
Task_44305,940,281,158,27,185,3.3333333333333335,22.026779352237885
Task_44306,1789,499,72,24,96,3.578,35.40552384278998
Task_44307,1457,193,169,125,294,7.510309278350515,31.06292018658793
Task_44308,2487,105,144,97,241,23.462264150943398,46.2395660222075
Task_44309,590,806,115,165,280,0.7311028500619579,19.31085571900331
Task_44310,2718,818,105,177,282,3.318681318681319,53.08084401218881
Task_44311,532,973,177,89,266,0.5462012320328542,18.748283270172728
Task_44312,2071,622,48,28,76,3.3242375601926164,39.78008779398139
Task_44313,1254,77,86,186,272,16.076923076923077,26.936048722788552
Task_44314,1082,72,130,104,234,14.821917808219178,23.99182397007944
Task_44315,1210,382,133,34,167,3.1592689295039165,26.57257933157017
Task_44316,540,903,80,32,112,0.5973451327433629,17.356236382984807
Task_44317,540,726,130,130,260,0.7427785419532325,18.063553248900654
Task_44318,2314,554,162,176,338,4.169369369369369,46.09790570402026
Task_44319,979,184,110,135,245,5.291891891891892,23.209127505407626
Task_44320,2510,84,179,43,222,29.529411764705884,45.548701122049074
Task_44321,2509,217,65,33,98,11.509174311926605,45.78388439252029
Task_44322,2135,308,81,103,184,6.909385113268608,41.67318646194258
Task_44323,1123,356,26,30,56,3.145658263305322,23.895692771473957
Task_44324,767,402,29,67,96,1.903225806451613,19.26951697064411
Task_44325,1949,970,47,181,228,2.007209062821833,41.17311637723484
Task_44326,2147,985,115,154,269,2.1774847870182557,44.462458513162126
Task_44327,2790,110,11,169,180,25.135135135135137,50.729730189685775
Task_44328,2429,402,63,173,236,6.027295285359801,47.02841128299341
Task_44329,2201,257,175,34,209,8.531007751937985,42.02504882870302
Task_44330,1901,790,174,40,214,2.4032869785082176,39.03080586352517
Task_44331,1022,591,105,191,296,1.7263513513513513,25.574724641546677
Task_44332,1786,71,63,13,76,24.805555555555557,32.25288055411533
Task_44333,1902,517,147,48,195,3.671814671814672,38.138497340412044
Task_44334,1921,350,88,92,180,5.472934472934473,38.28206723316249
Task_44335,2774,108,82,162,244,25.44954128440367,50.93809917757502
Task_44336,2447,923,198,194,392,2.648268398268398,49.63620619322419
Task_44337,2342,400,148,195,343,5.840399002493766,46.09252435953858
Task_44338,913,207,171,64,235,4.389423076923077,21.898203576535106
Task_44339,1199,686,32,40,72,1.745269286754003,26.18358105903455
Task_44340,2598,364,36,117,153,7.117808219178082,48.84918005109165
Task_44341,819,248,109,25,134,3.289156626506024,19.630177604915485
Task_44342,1624,878,72,71,143,1.8475540386803186,34.90217690833283
Task_44343,2259,139,124,65,189,16.135714285714286,42.34868340178788
Task_44344,1009,227,75,85,160,4.425438596491228,23.319174877991404
Task_44345,1682,306,137,76,213,5.478827361563518,34.40769317691116
Task_44346,1058,661,50,93,143,1.5981873111782476,25.491549918516956
Task_44347,897,720,199,198,397,1.2441054091539527,24.410660759211783
Task_44348,2610,348,149,110,259,7.478510028653295,49.65483848674703
Task_44349,2934,354,157,123,280,8.264788732394367,54.9141547821583
Task_44350,2068,655,41,101,142,3.152439024390244,41.34818910327593
Task_44351,2880,95,11,163,174,30.0,51.93854348678016
Task_44352,1239,229,117,22,139,5.386956521739131,26.19788999189323
Task_44353,2585,372,109,125,234,6.93029490616622,49.25002279802633
Task_44354,1994,611,183,170,353,3.258169934640523,41.270275315441964
Task_44355,2020,670,141,33,174,3.0104321907600595,40.34089047588643
Task_44356,939,650,183,94,277,1.4423963133640554,24.16916177456822
Task_44357,2656,887,125,109,234,2.990990990990991,51.99869607641807
Task_44358,2855,452,68,99,167,6.30242825607064,53.4669284387829
Task_44359,1361,764,70,110,180,1.7790849673202613,30.8885175025907
Task_44360,844,383,124,172,296,2.1979166666666665,22.08961056328165
Task_44361,2496,215,81,30,111,11.555555555555555,45.749028424401956
Task_44362,1300,880,114,86,200,1.4755959137343928,30.188061726132233
Task_44363,607,306,32,20,52,1.977198697068404,15.446348850938207
Task_44364,2562,507,118,165,283,5.043307086614173,49.60955454843497
Task_44365,1813,420,174,142,316,4.306413301662708,37.58739498833878
Task_44366,2804,897,143,99,242,3.1224944320712695,54.39049855946564
Task_44367,802,339,13,60,73,2.3588235294117648,19.026757882909948
Task_44368,2604,771,87,71,158,3.373056994818653,49.97792169638337
Task_44369,2587,222,151,125,276,11.600896860986547,48.93619355505456
Task_44370,805,635,79,71,150,1.2657232704402517,21.132253430848017
Task_44371,1075,310,145,158,303,3.4565916398713825,25.520613929205172
Task_44372,1254,104,51,99,150,11.942857142857143,26.133800591735902
Task_44373,2778,738,27,162,189,3.7591339648173205,53.32543143796574
Task_44374,2806,619,149,185,334,4.525806451612903,54.09184572480368
Task_44375,976,258,122,183,305,3.7683397683397684,23.831030191950685
Task_44376,2921,695,91,81,172,4.19683908045977,55.129025054874006
Task_44377,984,246,167,94,261,3.983805668016194,23.58222230132688
Task_44378,1596,611,13,64,77,2.607843137254902,32.5957889546432
Task_44379,686,553,126,141,267,1.2382671480144405,19.88063545905304
Task_44380,1873,860,166,142,308,2.175377468060395,39.889847721294835
Task_44381,2458,501,194,52,246,4.896414342629482,47.35151273511172
Task_44382,1128,330,54,129,183,3.40785498489426,25.872490580520417
Task_44383,2629,439,32,169,201,5.975,50.082314343289035
Task_44384,927,543,178,181,359,1.7040441176470589,24.18977790174256
Task_44385,652,460,26,155,181,1.4143167028199566,18.64937677448141
Task_44386,2733,261,35,76,111,10.431297709923664,50.27378997991463
Task_44387,1794,719,49,94,143,2.4916666666666667,37.34157322715895
Task_44388,1931,591,106,157,263,3.261824324324324,39.78466177326916
Task_44389,2183,927,47,151,198,2.3523706896551726,44.568138085549855
Task_44390,1153,290,178,197,375,3.9621993127147768,27.070119772703816
Task_44391,775,863,52,124,176,0.8969907407407407,21.85789587963762
Task_44392,668,390,48,22,70,1.7084398976982098,16.743925357772934
Task_44393,1902,484,23,71,94,3.9216494845360823,37.50749699649357
Task_44394,1146,540,18,63,81,2.1182994454713495,25.524907162527054
Task_44395,1834,865,36,23,59,2.1177829099307157,36.73117211170442
Task_44396,2501,132,39,88,127,18.804511278195488,45.74849353781289
Task_44397,955,546,180,90,270,1.7458866544789762,24.080314184716467
Task_44398,1568,941,143,162,305,1.664543524416136,35.311225697781886
Task_44399,2008,992,181,183,364,2.0221550855991945,42.75218918603301
Task_44400,1357,850,199,189,388,1.5945945945945945,32.099083409506655
Task_44401,2019,126,35,47,82,15.89763779527559,37.28080608782006
Task_44402,2735,412,131,41,172,6.62227602905569,50.82440899142561
Task_44403,1061,593,89,149,238,1.7861952861952861,25.868003898892947
Task_44404,936,182,55,105,160,5.114754098360656,21.962634356429486
Task_44405,2095,323,157,190,347,6.466049382716049,41.938459410841965
Task_44406,1480,498,180,162,342,2.9659318637274548,32.71258261280797
Task_44407,804,400,192,46,238,2.0049875311720697,20.556725052034206
Task_44408,678,995,77,96,173,0.6807228915662651,20.86350560983819
Task_44409,2038,431,176,180,356,4.717592592592593,41.419861497742225
Task_44410,2146,960,160,147,307,2.2330905306971904,44.52984166160277
Task_44411,562,283,30,174,204,1.9788732394366197,16.903701565889147
Task_44412,2906,330,71,37,108,8.779456193353475,52.63225511353025
Task_44413,742,734,116,78,194,1.0095238095238095,20.76158062193491
Task_44414,2996,728,86,174,260,4.109739368998628,57.058167015843566
Task_44415,2345,335,44,195,239,6.979166666666667,45.470203305897236
Task_44416,1174,598,182,18,200,1.9599332220367278,26.752278603276736
Task_44417,616,104,93,113,206,5.866666666666666,16.72017227013427
Task_44418,1247,497,96,37,133,2.504016064257028,27.28548912754042
Task_44419,2994,469,187,78,265,6.370212765957447,55.992906172208535
Task_44420,1241,361,51,21,72,3.4281767955801103,25.70772123599973
Task_44421,2270,84,82,81,163,26.705882352941178,42.060996288364976
Task_44422,1217,875,31,171,202,1.389269406392694,29.05262474933238
Task_44423,1826,632,150,189,339,2.8846761453396526,38.64054730386322
Task_44424,2191,461,162,66,228,4.742424242424242,42.91704019576284
Task_44425,2578,77,29,189,218,33.05128205128205,47.45956812193697
Task_44426,1293,755,51,37,88,1.7103174603174602,28.215472033777562
Task_44427,1098,819,199,195,394,1.3390243902439025,27.90171038561125
Task_44428,1607,917,36,147,183,1.7505446623093681,35.263288372529104
Task_44429,1536,627,70,65,135,2.445859872611465,32.67027422280645
Task_44430,1702,635,91,42,133,2.6761006289308176,34.932851015439724
Task_44431,2783,326,192,190,382,8.510703363914374,52.986828212020704
Task_44432,2383,771,126,47,173,3.0867875647668392,46.43182935946769
Task_44433,2047,515,131,169,300,3.9670542635658914,41.56425913434509
Task_44434,1294,221,90,112,202,5.828828828828829,28.155195962676444
Task_44435,1464,720,42,107,149,2.030513176144244,32.0505144240181
Task_44436,2483,729,102,98,200,3.4013698630136986,48.60021355231917
Task_44437,557,453,153,84,237,1.2268722466960353,17.2376783140413
Task_44438,2845,872,46,198,244,3.258877434135166,55.15569478713652
Task_44439,1909,932,173,76,249,2.0460878885316185,40.1500651867187
Task_44440,2809,253,69,159,228,11.059055118110237,52.46754365025236
Task_44441,2731,852,95,15,110,3.201641266119578,51.540402318772976
Task_44442,2547,857,58,196,254,2.9685314685314683,50.46523535070443
Task_44443,1035,1019,50,116,166,1.0147058823529411,26.378529028253165
Task_44444,1965,721,18,107,125,2.721606648199446,39.850625512148206
Task_44445,2020,969,194,188,382,2.082474226804124,42.9593144793969
Task_44446,714,532,106,191,297,1.3395872420262664,20.484698504850392
Task_44447,2896,817,197,33,230,3.5403422982885084,54.94367663215406
Task_44448,561,410,45,88,133,1.364963503649635,16.71715674016801
Task_44449,2834,906,134,156,290,3.1245865490628444,55.19989234221337
Task_44450,1890,414,96,43,139,4.554216867469879,37.18701071890373
Task_44451,1382,439,123,81,204,3.140909090909091,30.12898157052021
Task_44452,1376,799,34,126,160,1.72,30.94855796974315
Task_44453,1201,147,30,79,109,8.114864864864865,25.095708152280626
Task_44454,1331,529,118,61,179,2.5113207547169814,29.219833393389603
Task_44455,1754,637,186,93,279,2.749216300940439,37.088364245973786
Task_44456,2989,249,49,139,188,11.956,55.09690856162982
Task_44457,2088,163,150,128,278,12.731707317073171,40.648390448116714
Task_44458,1129,692,160,177,337,1.6291486291486292,27.748457622615547
Task_44459,723,607,197,191,388,1.1891447368421053,21.257818446760965
Task_44460,715,837,128,52,180,0.8532219570405728,20.54007911407943
Task_44461,1263,940,111,138,249,1.3421891604675877,30.154064548380294
Task_44462,2875,728,134,175,309,3.943758573388203,55.403427692708455
Task_44463,1163,818,13,49,62,1.42002442002442,26.105870556842916
Task_44464,2472,848,42,18,60,2.911660777385159,46.70237948043437
Task_44465,919,335,156,89,245,2.7351190476190474,22.72913835658939
Task_44466,2663,167,147,82,229,15.851190476190476,49.33478454587387
Task_44467,1207,431,180,79,259,2.7939814814814814,27.580736861250973
Task_44468,885,489,184,125,309,1.8061224489795917,23.061843435182414
Task_44469,1901,442,162,114,276,4.291196388261851,38.82989024458151
Task_44470,2844,492,73,17,90,5.768762677484787,51.987204510844094
Task_44471,1296,914,118,62,180,1.4163934426229507,29.87400885019755
Task_44472,1763,248,194,111,305,7.080321285140562,36.12658727537896
Task_44473,1745,804,143,194,337,2.1677018633540373,37.89424109988711
Task_44474,1297,112,119,141,260,11.47787610619469,27.748269290571304
Task_44475,1428,424,155,21,176,3.36,30.11892901034317
Task_44476,2773,740,115,19,134,3.7422402159244266,52.1122547639389
Task_44477,1411,309,85,131,216,4.551612903225807,30.404517437983774
Task_44478,2656,913,134,105,239,2.9059080962800876,52.09666867753398
Task_44479,2178,1002,17,183,200,2.1714855433698905,44.69631216825414
Task_44480,2409,642,95,63,158,3.7465007776049766,46.50060528804705
Task_44481,2397,106,141,137,278,22.401869158878505,45.05593257578247
Task_44482,2248,1002,81,126,207,2.2412761714855436,45.84869562333148
Task_44483,1731,954,36,10,46,1.8125654450261781,35.197061790747746
Task_44484,625,179,99,25,124,3.4722222222222223,16.02758821085902
Task_44485,2105,641,101,196,297,3.278816199376947,42.90869860463679
Task_44486,2181,628,153,69,222,3.4674085850556438,43.262806714333884
Task_44487,2526,305,134,25,159,8.254901960784315,46.93908542954952
Task_44488,1214,502,143,43,186,2.4135188866799204,27.111156208514416
Task_44489,1670,663,97,174,271,2.5150602409638556,35.94633738689119
Task_44490,2842,142,110,23,133,19.874125874125873,50.84568920144479
Task_44491,2226,695,149,156,305,3.1982758620689653,44.972856123561336
Task_44492,2258,206,65,132,197,10.908212560386474,43.402996141684476
Task_44493,1615,768,71,90,161,2.1001300390117037,34.69577055195803
Task_44494,1729,472,12,156,168,3.6553911205073994,35.698086396886474
Task_44495,2607,896,152,95,247,2.9063545150501673,51.30198024535924
Task_44496,2302,110,73,191,264,20.73873873873874,43.68310766735873
Task_44497,2013,719,157,51,208,2.7958333333333334,40.76917364118273
Task_44498,2907,722,101,44,145,4.020746887966805,54.3540708576451
Task_44499,1100,459,123,159,282,2.391304347826087,26.2990127950726
Task_44500,1050,1023,91,142,233,1.025390625,26.91816193666833
Task_44501,2580,150,178,131,309,17.08609271523179,48.4958202839139
Task_44502,1472,916,171,49,220,1.6052344601962922,32.77142674644558
Task_44503,1087,355,154,20,174,3.053370786516854,24.492095347670887
Task_44504,2209,851,94,27,121,2.5927230046948355,43.42428754107984
Task_44505,1826,824,184,25,209,2.2133333333333334,37.86721450374212
Task_44506,1348,565,131,169,300,2.381625441696113,30.654914844692453
Task_44507,650,408,27,177,204,1.5892420537897312,18.642280848678123
Task_44508,2298,92,86,88,174,24.70967741935484,42.62652906147006
Task_44509,707,368,151,13,164,1.915989159891599,18.48952374657239
Task_44510,797,67,34,20,54,11.720588235294118,16.711628558442467
Task_44511,901,983,167,139,306,0.915650406504065,24.829261450167554
Task_44512,571,130,44,169,213,4.358778625954199,16.27968925973286
Task_44513,2411,1006,51,37,88,2.394240317775571,46.72744988496493
Task_44514,1424,596,57,32,89,2.3852596314907872,29.772988411461785
Task_44515,1092,460,55,200,255,2.368763557483731,26.183547120749882
Task_44516,1345,384,90,187,277,3.4935064935064934,29.95023401076629
Task_44517,1210,279,150,129,279,4.321428571428571,27.402452619792673
Task_44518,2626,573,152,123,275,4.574912891986063,50.73750097168797
Task_44519,1610,228,69,109,178,7.03056768558952,33.11017937712202
Task_44520,1368,109,102,178,280,12.436363636363636,28.972366774394303
Task_44521,2031,636,127,184,311,3.1883830455259026,41.76640826869326
Task_44522,2209,365,160,47,207,6.03551912568306,42.54856008474278
Task_44523,2101,788,77,49,126,2.6628643852978455,41.774199978049005
Task_44524,1058,171,59,178,237,6.151162790697675,24.360189963071694
Task_44525,1136,598,174,182,356,1.8964941569282137,27.672587012638328
Task_44526,2652,700,197,134,331,3.783166904422254,51.82149940641485
Task_44527,769,986,193,192,385,0.779128672745694,23.2075758583006
Task_44528,2225,773,154,198,352,2.8746770025839794,45.47537195126978
Task_44529,2114,613,147,162,309,3.44299674267101,42.96701071995896
Task_44530,1241,628,112,184,296,1.972972972972973,29.161744778113956
Task_44531,2135,992,115,65,180,2.1500503524672707,43.479592550487155
Task_44532,1102,609,50,197,247,1.8065573770491803,26.79739177611832
Task_44533,2555,257,102,118,220,9.9031007751938,48.3002990405667
Task_44534,1030,837,73,155,228,1.2291169451073987,26.107921430832857
Task_44535,1800,1022,98,100,198,1.7595307917888563,38.670102048132506
Task_44536,1801,983,187,139,326,1.8302845528455285,39.208169267259215
Task_44537,580,990,172,50,222,0.5852674066599395,19.149385669623282
Task_44538,877,896,170,40,210,0.9777034559643255,23.201763785286005
Task_44539,2981,1011,18,55,73,2.9456521739130435,55.66840246028372
Task_44540,1538,105,86,175,261,14.50943396226415,31.494036885249397
Task_44541,1648,848,133,10,143,1.9411071849234394,34.66744113750723
Task_44542,1506,247,179,142,321,6.07258064516129,32.18020171382412
Task_44543,868,506,148,111,259,1.7120315581854044,22.586637976873842
Task_44544,2719,938,53,113,166,2.895633652822151,52.893307428901096
Task_44545,2284,115,88,182,270,19.689655172413794,43.3693958999753
Task_44546,827,785,63,24,87,1.0521628498727735,20.957837180732337
Task_44547,2084,704,169,186,355,2.956028368794326,43.02116572669896
Task_44548,738,595,144,178,322,1.238255033557047,21.136794925529887
Task_44549,1151,500,162,27,189,2.2974051896207586,26.092392403510786
Task_44550,2990,707,70,104,174,4.22316384180791,56.49224247246007
Task_44551,2770,308,45,138,183,8.964401294498382,51.73527906577522
Task_44552,2583,254,173,156,329,10.129411764705882,49.27864160919315
Task_44553,1615,211,125,122,247,7.617924528301887,33.411356627119766
Task_44554,1880,274,83,186,269,6.836363636363636,38.04967972746348
Task_44555,2607,483,57,175,232,5.386363636363637,50.09541453984365
Task_44556,2608,611,102,133,235,4.261437908496732,50.40814938395145
Task_44557,1211,327,118,30,148,3.692073170731707,26.235347874103876
Task_44558,1060,237,130,43,173,4.453781512605042,23.75764538966298
Task_44559,793,372,85,195,280,2.1260053619302948,21.215536356145027
Task_44560,550,586,80,135,215,0.9369676320272572,17.63033073393904
Task_44561,2198,429,61,96,157,5.111627906976744,42.850248003541346
Task_44562,827,620,19,53,72,1.3317230273752012,20.348878577600573
Task_44563,1252,350,24,183,207,3.566951566951567,28.04102762280226
Task_44564,647,581,141,126,267,1.111683848797251,19.31424119705881
Task_44565,1075,305,142,49,191,3.5130718954248366,24.418727821144895
Task_44566,1927,445,166,78,244,4.320627802690583,38.93113913551719
Task_44567,630,742,147,162,309,0.847913862718708,19.83483294997008
Task_44568,1975,776,43,173,216,2.541827541827542,40.891195345668564
Task_44569,1241,937,140,57,197,1.3230277185501067,29.16979291871615
Task_44570,1574,507,97,183,280,3.0984251968503935,33.98831549374666
Task_44571,1350,777,188,130,318,1.7352185089974292,31.359340622281035
Task_44572,1300,887,195,100,295,1.4639639639639639,30.720719866471168
Task_44573,1704,354,169,110,279,4.8,35.4339326762972
Task_44574,1319,221,13,72,85,5.941441441441442,27.307259105480117
Task_44575,757,371,57,137,194,2.03494623655914,20.230631150422884
Task_44576,1114,76,101,142,243,14.467532467532468,24.574622487543653
Task_44577,1003,612,87,49,136,1.636215334420881,23.84880059510996
Task_44578,2439,366,46,66,112,6.645776566757493,45.82957946154955
Task_44579,1174,239,51,69,120,4.891666666666667,25.515174098997548
Task_44580,1634,582,104,126,230,2.8027444253859346,34.858791455137336
Task_44581,1739,511,73,97,170,3.396484375,36.040403175014085
Task_44582,829,808,23,119,142,1.0247218788627936,22.119851480060436
Task_44583,1832,143,125,168,293,12.722222222222221,36.63226502124877
Task_44584,1909,501,182,89,271,3.802788844621514,39.044178627856915
Task_44585,2394,651,194,139,333,3.6717791411042944,47.596305291516266
Task_44586,2155,272,133,66,199,7.893772893772894,41.58440194298567
Task_44587,2542,777,120,110,230,3.2673521850899743,49.83112880358592
Task_44588,1346,766,109,27,136,1.754889178617992,29.615018168685467
Task_44589,1844,329,133,139,272,5.587878787878788,37.57639174811187
Task_44590,1678,526,80,141,221,3.1840607210626186,35.413252783894265
Task_44591,2586,199,51,133,184,12.93,48.49566897160133
Task_44592,1812,721,79,73,152,2.509695290858726,37.358166409913515
Task_44593,705,554,85,59,144,1.2702702702702702,19.159024855457023
Task_44594,2046,529,159,23,182,3.860377358490566,40.277815229970706
Task_44595,2138,605,18,123,141,3.5280528052805282,42.29622720159447
Task_44596,1563,772,108,30,138,2.021992238033635,33.11028489617176
Task_44597,2454,94,192,58,250,25.83157894736842,45.127428945622974
Task_44598,945,181,184,188,372,5.1923076923076925,23.191623169258246
Task_44599,2239,885,187,55,242,2.5270880361173815,45.03703587708083
Task_44600,1212,823,59,68,127,1.470873786407767,28.07478908784815
Task_44601,961,666,160,106,266,1.4407796101949026,24.54202475388084
Task_44602,1916,893,159,160,319,2.1431767337807606,40.749907126332985
Task_44603,618,299,193,65,258,2.06,17.658609995975777
Task_44604,2977,512,131,193,324,5.803118908382066,56.42185421075823
Task_44605,2364,251,85,120,205,9.380952380952381,45.201625861028866
Task_44606,2726,169,68,17,85,16.03529411764706,48.81627451346491
Task_44607,1899,683,74,20,94,2.776315789473684,37.66573267409975
Task_44608,892,686,14,58,72,1.2983988355167395,21.561064967980087
Task_44609,2912,669,125,64,189,4.3462686567164175,54.817107093751865
Task_44610,2105,505,103,70,173,4.160079051383399,41.42026242841781
Task_44611,1955,414,31,46,77,4.710843373493976,37.34567330999569
Task_44612,781,906,30,92,122,0.8610804851157663,21.504162993419133
Task_44613,733,347,130,113,243,2.1063218390804597,19.894206808603865
Task_44614,1730,127,57,192,249,13.515625,34.750616140063535
Task_44615,2478,372,184,11,195,6.64343163538874,46.64239789173869
Task_44616,2586,1022,42,92,134,2.527859237536657,50.680893622915825
Task_44617,644,311,185,58,243,2.0641025641025643,17.979032243934274
Task_44618,1759,154,178,180,358,11.348387096774193,35.86291640841485
Task_44619,527,284,43,19,62,1.8491228070175438,14.131262427977157
Task_44620,1445,393,46,160,206,3.66751269035533,31.241274492442255
Task_44621,2446,87,105,166,271,27.795454545454547,45.68308677546091
Task_44622,1830,64,145,138,283,28.153846153846153,35.95793759047476
Task_44623,1598,333,55,32,87,4.7844311377245505,31.669707752516587
Task_44624,2567,632,40,68,108,4.055292259083728,48.65917821483759
Task_44625,1830,402,83,106,189,4.540942928039702,37.20541475653617
Task_44626,776,866,143,140,283,0.895040369088812,22.396210981241506
Task_44627,990,862,70,25,95,1.1471610660486675,24.01811322007416
Task_44628,1279,91,90,63,153,13.902173913043478,25.9467438587594
Task_44629,1853,868,144,151,295,2.132336018411968,39.5524746310228
Task_44630,2039,304,38,67,105,6.685245901639345,39.211295057349176
Task_44631,2020,988,128,87,215,2.042467138523761,42.056259914886006
Task_44632,834,443,71,46,117,1.8783783783783783,20.308406156487756
Task_44633,1588,342,141,187,328,4.629737609329446,33.89334704688619
Task_44634,2954,501,192,103,295,5.884462151394422,55.75926416706469
Task_44635,867,837,107,177,284,1.0346062052505967,23.76227578145249
Task_44636,1834,126,184,148,332,14.440944881889763,36.67285449501572
Task_44637,2403,825,31,114,145,2.9092009685230025,47.22429783716148
Task_44638,2446,64,177,132,309,37.63076923076923,45.68858368417676
Task_44639,1561,540,29,119,148,2.88539741219963,33.00457611856668
Task_44640,850,716,83,185,268,1.185495118549512,23.080128787976843
Task_44641,999,187,48,26,74,5.3138297872340425,21.559081880884964
Task_44642,2813,187,191,101,292,14.962765957446809,52.425683437147704
Task_44643,930,791,115,140,255,1.1742424242424243,24.43332600137271
Task_44644,2110,662,21,154,175,3.1825037707390647,42.402227966066896
Task_44645,2144,131,185,58,243,16.242424242424242,40.72502004873852
Task_44646,2577,468,118,47,165,5.494669509594883,48.53399692349544
Task_44647,2020,604,103,174,277,3.3388429752066116,41.3232357261857
Task_44648,2338,604,84,129,213,3.8644628099173555,46.01478180788524
Task_44649,2734,625,158,108,266,4.36741214057508,52.55131784887053
Task_44650,1139,155,45,84,129,7.301282051282051,24.588123544071493
Task_44651,794,1017,190,62,252,0.7799607072691552,22.62898069120476
Task_44652,2585,556,108,26,134,4.640933572710951,48.591788613788644
Task_44653,2609,926,142,150,292,2.81445523193096,51.697378865773864
Task_44654,2203,207,32,143,175,10.591346153846153,42.36112962915326
Task_44655,2113,229,71,98,169,9.18695652173913,40.97493158056044
Task_44656,2168,548,46,91,137,3.948998178506375,42.58054304980508
Task_44657,1299,938,99,126,225,1.3833865814696487,30.587242880818888
Task_44658,1685,886,128,128,256,1.8996617812852312,36.737058772885625
Task_44659,2309,531,164,22,186,4.340225563909774,44.45133665282942
Task_44660,1054,989,92,57,149,1.0646464646464646,26.107456981857833
Task_44661,1065,898,58,199,257,1.1846496106785318,27.06099342161029
Task_44662,2095,596,125,98,223,3.509212730318258,42.1383898482512
Task_44663,1899,951,136,11,147,1.9947478991596639,39.010011412043696
Task_44664,784,78,15,185,200,9.924050632911392,19.249268364507973
Task_44665,2947,578,127,15,142,5.089810017271157,54.36040222290709
Task_44666,1593,646,196,111,307,2.462132921174652,34.7356639648231
Task_44667,669,165,84,162,246,4.030120481927711,18.20956514003596
Task_44668,2793,624,187,98,285,4.4688,53.561046906822604
Task_44669,1176,983,132,31,163,1.1951219512195121,27.911127646267115
Task_44670,2213,621,44,61,105,3.557877813504823,42.77859442789222
Task_44671,1229,128,103,103,206,9.527131782945736,26.541886313678116
Task_44672,1714,271,13,111,124,6.301470588235294,34.39047255512016
Task_44673,2676,808,41,154,195,3.30778739184178,51.9709430326753
Task_44674,2976,1003,107,181,288,2.9641434262948207,57.780882487128316
Task_44675,790,870,172,188,360,0.9070034443168772,23.04331252045778
Task_44676,2528,554,153,72,225,4.554954954954955,48.604145927468714
Task_44677,1998,729,177,107,284,2.736986301369863,41.301494148732154
Task_44678,2338,621,155,96,251,3.7588424437299035,46.21005146573276
Task_44679,2185,820,140,80,220,2.661388550548112,44.12143357890878
Task_44680,1641,642,147,86,233,2.552099533437014,35.0468626277433
Task_44681,888,568,184,130,314,1.5606326889279438,23.343400332447374
Task_44682,730,140,167,185,352,5.177304964539007,19.53466063094058
Task_44683,1454,922,106,103,209,1.5752979414951247,32.89738072892483
Task_44684,742,190,84,79,163,3.884816753926702,19.106534502426552
Task_44685,2892,256,106,77,183,11.252918287937744,53.19336405614734
Task_44686,2649,931,12,37,49,2.842274678111588,49.86822449056248
Task_44687,514,436,79,33,112,1.1762013729977117,15.220573608149904
Task_44688,1044,550,82,126,208,1.894736842105263,25.358521929092152
Task_44689,2151,842,166,187,353,2.5516014234875444,44.50720057294092
Task_44690,1504,976,90,90,180,1.5394063459570113,33.663757945952916
Task_44691,2180,939,169,18,187,2.3191489361702127,43.68124526526315
Task_44692,1763,422,80,48,128,4.167848699763593,35.32277205932009
Task_44693,1800,138,192,83,275,12.949640287769784,35.72549522235443
Task_44694,1733,147,139,33,172,11.70945945945946,33.809876386896406
Task_44695,1097,623,94,108,202,1.7580128205128205,26.327313290213436
Task_44696,2895,846,38,28,66,3.4179456906729633,53.51458324643925
Task_44697,1121,249,95,91,186,4.484,25.34313338913498
Task_44698,1373,792,126,200,326,1.7313997477931904,31.909045440328992
Task_44699,2870,809,91,86,177,3.54320987654321,54.75191882532456
Task_44700,1202,233,178,30,208,5.136752136752137,26.150697851759876
Task_44701,1894,128,88,67,155,14.682170542635658,36.034429005644334
Task_44702,2059,78,17,189,206,26.063291139240505,39.2443978880953
Task_44703,2392,361,35,179,214,6.607734806629834,46.162978410541804
Task_44704,1936,100,114,127,241,19.168316831683168,37.55981052045852
Task_44705,555,589,176,72,248,0.940677966101695,17.622363960055036
Task_44706,2212,91,197,130,327,24.043478260869566,42.24561325132758
Task_44707,1205,523,184,171,355,2.299618320610687,28.509481831957356
Task_44708,2700,434,39,55,94,6.206896551724138,49.81995506555291
Task_44709,1620,610,173,101,274,2.65139116202946,34.88687124051448
Task_44710,2850,672,135,76,211,4.234769687964339,54.07159286859744
Task_44711,2390,581,16,150,166,4.106529209621993,46.51588771129431
Task_44712,2015,959,52,111,163,2.0989583333333335,41.76177577874492
Task_44713,1492,886,90,106,196,1.6820744081172492,33.35721293510409
Task_44714,1747,599,55,194,249,2.9116666666666666,36.95676266373071
Task_44715,2788,404,85,53,138,6.883950617283951,51.6446779010376
Task_44716,1465,361,112,187,299,4.04696132596685,31.87912991118331
Task_44717,604,450,54,133,187,1.3392461197339247,17.9555455548218
Task_44718,2945,932,61,148,209,3.1564844587352625,56.73044289714685
Task_44719,1081,738,128,63,191,1.462787550744249,26.02227712865354
Task_44720,1486,773,127,122,249,1.9198966408268734,33.19217966088805
Task_44721,524,421,40,194,234,1.2417061611374407,16.827342184415393
Task_44722,2304,132,118,136,254,17.32330827067669,43.74497709490124
Task_44723,1542,909,167,29,196,1.6945054945054945,33.611015106259195
Task_44724,2171,462,135,121,256,4.688984881209503,43.08820438615055
Task_44725,1449,609,116,127,243,2.375409836065574,32.074001241863606
Task_44726,1076,691,15,87,102,1.5549132947976878,25.22655279754937
Task_44727,1926,242,131,46,177,7.925925925925926,37.489826766507186
Task_44728,1687,414,145,19,164,4.065060240963855,34.152429595890624
Task_44729,1737,838,171,180,351,2.070321811680572,37.91601321831444
Task_44730,749,677,96,67,163,1.1047197640117994,20.44769978922714
Task_44731,2879,497,55,141,196,5.781124497991968,54.23798119585582
Task_44732,1133,104,172,38,210,10.790476190476191,24.166793516795096
Task_44733,2405,520,199,117,316,4.616122840690979,47.24417583138924
Task_44734,1085,907,159,179,338,1.1949339207048457,27.679736783209663
Task_44735,2310,649,71,37,108,3.5538461538461537,44.24138101496331
Task_44736,966,625,163,173,336,1.5431309904153354,24.918460936584253
Task_44737,739,902,27,145,172,0.8183831672203765,21.323128967592105
Task_44738,2123,902,48,112,160,2.3510520487264674,43.136431163178486
Task_44739,2088,758,112,126,238,2.7509881422924902,42.638637776891606
Task_44740,2816,668,27,88,115,4.2092675635276535,53.024103697810006
Task_44741,923,931,20,99,119,0.990343347639485,23.785104997501037
Task_44742,2091,228,21,99,120,9.131004366812228,40.082536804496655
Task_44743,530,592,116,129,245,0.893760539629005,17.45229721291817
Task_44744,1793,428,159,92,251,4.17948717948718,36.87869086067057
Task_44745,858,314,47,139,186,2.723809523809524,21.553851855116346
Task_44746,1956,980,113,106,219,1.9938837920489296,41.124466090513884
Task_44747,520,471,124,42,166,1.1016949152542372,15.98476134463899
Task_44748,660,82,88,12,100,7.951807228915663,15.51819224250756
Task_44749,578,790,104,91,195,0.7307206068268015,18.556537180595562
Task_44750,1095,810,52,78,130,1.3501849568434032,26.422841910944356
Task_44751,1765,334,68,151,219,5.268656716417911,36.19551756866636
Task_44752,923,318,160,91,251,2.8934169278996866,22.755420982425235
Task_44753,1427,817,155,48,203,1.7444987775061125,31.580236307914365
Task_44754,2289,800,150,122,272,2.857677902621723,46.101920103474804
Task_44755,1986,777,178,118,296,2.5526992287917736,41.331872888035114
Task_44756,2228,1021,54,126,180,2.1800391389432487,45.46007375912095
Task_44757,1385,697,13,58,71,1.984240687679083,29.38320772004646
Task_44758,533,407,60,155,215,1.3063725490196079,16.85460608138338
Task_44759,562,821,147,73,220,0.683698296836983,18.45601248228758
Task_44760,2637,675,184,140,324,3.9008875739644973,51.48206445039369
Task_44761,738,618,66,162,228,1.1922455573505655,20.835283255810484
Task_44762,1375,882,148,94,242,1.5571913929784824,31.65039302255766
Task_44763,1939,450,53,64,117,4.299334811529934,38.23910117699485
Task_44764,1146,447,147,164,311,2.5580357142857144,27.127204434188187
Task_44765,977,777,54,189,243,1.255784061696658,25.20977466797233
Task_44766,758,828,129,153,282,0.9143546441495778,21.996566210270682
Task_44767,2315,991,92,23,115,2.3336693548387095,45.43997291804828
Task_44768,2535,266,193,131,324,9.49438202247191,48.504949207719044
Task_44769,1093,942,106,46,152,1.159066808059385,26.266366995304036
Task_44770,2081,962,60,99,159,2.1609553478712358,42.630277156953724
Task_44771,1896,522,190,94,284,3.625239005736138,39.00719827538858
Task_44772,891,627,32,16,48,1.4187898089171975,20.86499504528972
Task_44773,1683,958,20,20,40,1.7549530761209593,34.385607732165084
Task_44774,2472,427,58,183,241,5.775700934579439,47.831244859662014
Task_44775,1259,840,112,66,178,1.497027348394768,29.080409138774034
Task_44776,1918,967,144,135,279,1.9814049586776858,40.79483163974959
Task_44777,1009,554,75,191,266,1.818018018018018,25.19629262698578
Task_44778,1467,259,132,159,291,5.642307692307693,31.49494152777679
Task_44779,1613,824,88,103,191,1.955151515151515,35.032573929753
Task_44780,2870,895,116,45,161,3.203125,54.35021068925511
Task_44781,962,579,112,81,193,1.6586206896551725,23.85961821614573
Task_44782,1595,329,81,50,131,4.833333333333333,32.35652939812121
Task_44783,2465,400,171,70,241,6.14713216957606,47.11813022331025
Task_44784,2709,872,17,185,202,3.1030927835051547,52.716916100840926
Task_44785,2028,979,25,68,93,2.0693877551020408,41.014264754717864
Task_44786,1570,852,39,131,170,1.8405627198124268,34.38769797070702
Task_44787,1521,962,193,148,341,1.5794392523364487,34.74403684169291
Task_44788,1330,260,140,114,254,5.095785440613027,29.100695008123775
Task_44789,2734,133,173,156,329,20.402985074626866,50.89120499019855
Task_44790,1582,574,178,130,308,2.751304347826087,34.36754852442588
Task_44791,2827,739,70,128,198,3.8202702702702704,54.18105082629403
Task_44792,2966,255,42,68,110,11.5859375,53.77415498572896
Task_44793,2674,494,178,163,341,5.402020202020202,51.5990347021214
Task_44794,1384,415,194,135,329,3.326923076923077,30.830640723044024
Task_44795,2919,372,68,73,141,7.825737265415549,53.80506035736917
Task_44796,2584,418,176,158,334,6.167064439140812,49.886728010129424
Task_44797,2076,314,26,171,197,6.59047619047619,40.88916593848739
Task_44798,679,168,185,42,227,4.017751479289941,17.568783510987707
Task_44799,1072,65,99,99,198,16.242424242424242,23.703974946707955
Task_44800,2937,449,144,183,327,6.526666666666666,55.58106128654381
Task_44801,2034,200,16,70,86,10.119402985074627,38.51495296379915
Task_44802,2508,503,79,113,192,4.976190476190476,48.31536549924463
Task_44803,891,722,157,174,331,1.2323651452282158,23.989171872449614
Task_44804,1037,224,124,62,186,4.608888888888889,23.624102982055973
Task_44805,818,315,19,13,32,2.588607594936709,18.62109167364899
Task_44806,1610,241,36,178,214,6.652892561983471,33.387446854884665
Task_44807,1767,396,54,151,205,4.45088161209068,36.364553500583135
Task_44808,1710,738,21,14,35,2.313937753721245,34.06549562572931
Task_44809,2966,362,128,178,306,8.170798898071626,55.64565494352363
Task_44810,1002,235,25,14,39,4.245762711864407,21.293714438783294
Task_44811,2533,241,89,10,99,10.46694214876033,46.212953472515984
Task_44812,2052,231,196,148,344,8.844827586206897,40.86087857232227
Task_44813,1488,485,115,170,285,3.0617283950617282,32.5528202697817
Task_44814,1219,1024,96,161,257,1.1892682926829268,29.76941537384147
Task_44815,812,430,99,122,221,1.8839907192575407,21.321854284855764
Task_44816,1898,819,164,52,216,2.3146341463414632,39.351785066862654
Task_44817,2434,180,128,43,171,13.447513812154696,44.99401059129304
Task_44818,2949,888,200,104,304,3.3172103487064115,56.95259278965244
Task_44819,2871,379,68,148,216,7.5552631578947365,53.82421773224431
Task_44820,1622,558,195,163,358,2.901610017889088,35.224213969905
Task_44821,2155,218,71,48,119,9.840182648401827,40.498102497941325
Task_44822,2551,323,165,38,203,7.8734567901234565,47.780236410982674
Task_44823,2474,723,74,76,150,3.4171270718232045,47.95448124776129
Task_44824,2416,160,200,23,223,15.006211180124224,44.87624203904193
Task_44825,1476,747,38,51,89,1.9732620320855614,31.387545629859176
Task_44826,1165,702,171,61,232,1.6571834992887624,27.395367843768724
Task_44827,1081,440,114,78,192,2.45124716553288,25.288955261023347
Task_44828,2846,233,178,66,244,12.162393162393162,52.56124615248575
Task_44829,2154,480,42,132,174,4.478170478170478,42.51462483813916
Task_44830,1870,663,62,96,158,2.816265060240964,38.407556654251934
Task_44831,2882,312,182,145,327,9.207667731629392,54.18935910434694
Task_44832,1808,248,113,140,253,7.261044176706827,36.645710215951155
Task_44833,2301,820,12,142,154,2.802679658952497,45.58958049045125
Task_44834,649,583,33,162,195,1.1113013698630136,19.07150461242129
Task_44835,1944,228,120,121,241,8.489082969432314,38.64026677806188
Task_44836,1741,374,37,54,91,4.642666666666667,34.434736997829695
Task_44837,1180,72,198,178,376,16.164383561643834,26.273719080838514
Task_44838,614,1000,139,34,173,0.6133866133866134,19.39788437416312
Task_44839,2563,149,116,75,191,17.086666666666666,47.350799819323136
Task_44840,2156,221,150,90,240,9.711711711711711,41.88071090985419
Task_44841,2517,952,84,176,260,2.6411332633788036,50.224459031003356
Task_44842,2694,926,99,132,231,2.9061488673139158,52.74464295985439
Task_44843,2542,272,181,167,348,9.311355311355312,48.7982648361103
Task_44844,2368,418,105,104,209,5.651551312649165,45.82594386555551
Task_44845,1763,469,133,126,259,3.751063829787234,36.67333916724177
Task_44846,2308,147,169,161,330,15.594594594594595,44.33899144261036
Task_44847,2963,584,179,168,347,5.064957264957265,56.49984370643489
Task_44848,1028,990,188,102,290,1.0373360242179617,26.70378046815867
Task_44849,1468,167,36,40,76,8.738095238095237,28.78484622753378
Task_44850,2693,217,105,155,260,12.353211009174313,50.56228928496868
Task_44851,1738,927,152,33,185,1.8728448275862069,36.72259382573579
Task_44852,1257,271,156,76,232,4.6213235294117645,27.65751006568118
Task_44853,2627,415,82,176,258,6.314903846153846,50.283161647570985
Task_44854,1900,362,106,126,232,5.234159779614325,38.37242610257784
Task_44855,1967,277,54,97,151,7.075539568345324,38.65963644072095
Task_44856,1538,501,28,162,190,3.0637450199203187,32.9421717196551
Task_44857,1240,466,132,135,267,2.6552462526766596,28.434385737950695
Task_44858,1651,870,174,156,330,1.8955223880597014,36.523150845265576
Task_44859,2384,351,106,98,204,6.7727272727272725,45.83223298688586
Task_44860,1168,407,35,112,147,2.8627450980392157,26.37465387570335
Task_44861,2918,243,167,197,364,11.959016393442623,54.747883415420425
Task_44862,2553,163,63,20,83,15.567073170731707,45.942438517444174
Task_44863,937,582,72,131,203,1.6072041166380788,23.75341808008422
Task_44864,2913,271,76,176,252,10.709558823529411,54.305721778955586
Task_44865,2254,671,109,51,160,3.3541666666666665,44.0935338716431
Task_44866,1373,611,154,100,254,2.2434640522875817,30.886657315715095
Task_44867,1293,320,43,132,175,4.02803738317757,28.376302751073396
Task_44868,1656,475,178,151,329,3.4789915966386555,35.35090091924369
Task_44869,2321,397,59,62,121,5.831658291457287,44.003602026429895
Task_44870,2363,982,48,113,161,2.4038657171922684,47.22217952468109
Task_44871,759,307,60,58,118,2.4642857142857144,18.90195880020256
Task_44872,1685,971,11,10,21,1.7335390946502058,34.32740806774191
Task_44873,1009,453,39,184,223,2.2224669603524227,24.620313302981
Task_44874,846,446,137,43,180,1.8926174496644295,21.091497201125012
Task_44875,1974,287,63,171,234,6.854166666666667,39.432210384204296
Task_44876,1457,77,18,100,118,18.67948717948718,28.7406985530007
Task_44877,2053,391,20,23,43,5.237244897959184,38.57893055402411
Task_44878,1038,854,152,148,300,1.2140350877192982,26.549412783270125
Task_44879,1856,751,77,97,174,2.4680851063829787,38.69223760524414
Task_44880,908,322,23,104,127,2.8111455108359134,21.87419499797694
Task_44881,2463,156,105,132,237,15.687898089171975,46.35869385406716
Task_44882,1327,949,71,90,161,1.3968421052631579,30.646053180160717
Task_44883,2597,197,160,102,262,13.116161616161616,48.936324867448256
Task_44884,2702,127,41,194,235,21.109375,49.93827955349624
Task_44885,1732,70,37,166,203,24.3943661971831,34.06836297669522
Task_44886,1499,662,163,157,320,2.2609351432880844,33.422961271761146
Task_44887,755,155,42,130,172,4.839743589743589,18.99194051710033
Task_44888,2465,910,96,188,284,2.7058177826564216,49.39298447629026
Task_44889,2013,68,110,132,242,29.17391304347826,38.61529908699188
Task_44890,2598,777,122,174,296,3.339331619537275,51.10959467346595
Task_44891,1732,460,22,84,106,3.75704989154013,35.0400223243258
Task_44892,1916,459,34,105,139,4.165217391304348,38.30854640229564
Task_44893,2127,366,182,127,309,5.795640326975477,42.32524691778002
Task_44894,1432,305,110,57,167,4.6797385620915035,30.067957444745854
Task_44895,629,627,157,122,279,1.0015923566878981,19.219956832793482
Task_44896,2419,934,94,43,137,2.5871657754010697,47.22696476663766
Task_44897,2133,727,35,95,130,2.9299450549450547,42.64664662217041
Task_44898,2929,311,27,24,51,9.387820512820513,52.235762720381494
Task_44899,1842,853,166,89,255,2.1569086651053864,39.01772604107878
Task_44900,2869,151,147,141,288,18.875,52.97508193916786
Task_44901,1288,206,136,86,222,6.222222222222222,27.999052830357147
Task_44902,2291,420,128,164,292,5.441805225653207,45.076004069844714
Task_44903,844,622,79,128,207,1.3547351524879614,22.377672570265887
Task_44904,1959,799,184,83,267,2.44875,40.71895119968198
Task_44905,1130,648,30,110,140,1.7411402157164868,26.44963457827988
Task_44906,2734,167,96,105,201,16.273809523809526,50.47579230832516
Task_44907,518,158,45,66,111,3.257861635220126,14.33821916083347
Task_44908,1221,502,172,180,352,2.427435387673956,28.696361549959168
Task_44909,1550,599,67,29,96,2.5833333333333335,31.950815531116106
Task_44910,713,868,139,90,229,0.8204833141542003,21.042418666488867
Task_44911,515,175,95,193,288,2.9261363636363638,16.015483295624954
Task_44912,1391,813,97,185,282,1.7088452088452089,32.04690884175111
Task_44913,1525,359,158,144,302,4.236111111111111,32.77225486656068
Task_44914,1908,297,191,104,295,6.402684563758389,38.5327226331424
Task_44915,1971,126,59,108,167,15.51968503937008,37.93170465513186
Task_44916,992,913,103,14,117,1.0853391684901532,24.2023994768262
Task_44917,2425,561,84,61,145,4.314946619217082,46.49337353605506
Task_44918,2411,712,93,22,115,3.3814866760168303,46.097393674562085
Task_44919,1070,74,134,37,171,14.266666666666667,22.54340387161906
Task_44920,2200,361,188,10,198,6.077348066298343,42.21968546202164
Task_44921,560,985,185,17,202,0.5679513184584178,18.54478022655081
Task_44922,862,357,190,95,285,2.4078212290502794,22.142901681329175
Task_44923,1287,344,92,102,194,3.7304347826086954,28.418074113215024
Task_44924,2849,285,183,144,327,9.961538461538462,53.569515654121595
Task_44925,1862,962,124,171,295,1.933541017653167,40.01677823348539
Task_44926,981,783,174,102,276,1.2512755102040816,25.250691723199797
Task_44927,2811,365,160,68,228,7.680327868852459,52.414758388239584
Task_44928,2183,737,177,77,254,2.9579945799457996,43.91185622999592
Task_44929,2862,435,68,42,110,6.564220183486238,52.31331385281271
Task_44930,2747,452,191,100,291,6.06401766004415,52.29972107760327
Task_44931,1432,481,151,197,348,2.970954356846473,31.9771569449475
Task_44932,1694,680,119,62,181,2.487518355359765,35.453950036270236
Task_44933,895,472,163,62,225,1.8921775898520083,22.375991294946406
Task_44934,1663,1005,15,35,50,1.6530815109343937,34.485656286449654
Task_44935,2978,457,70,186,256,6.502183406113537,56.013263656670205
Task_44936,1141,161,41,60,101,7.04320987654321,24.037074128049962
Task_44937,2683,848,197,196,393,3.160188457008245,53.148541857774205
Task_44938,1871,756,100,177,277,2.4715984147952446,39.44520061290998
Task_44939,2998,481,200,140,340,6.219917012448133,56.64749213607396
Task_44940,1103,266,25,101,126,4.131086142322097,24.79070498798535
Task_44941,1667,400,93,86,179,4.157107231920199,34.4438315298703
Task_44942,2540,1009,122,76,198,2.514851485148515,50.15904200672753
Task_44943,2824,362,140,10,150,7.779614325068871,51.76849450887764
Task_44944,2155,294,68,54,122,7.305084745762712,41.04600882974296
Task_44945,828,245,154,128,282,3.3658536585365852,21.26540927173991
Task_44946,806,435,159,96,255,1.848623853211009,21.384357497933422
Task_44947,1717,335,127,126,253,5.1101190476190474,35.48310343559092
Task_44948,2038,630,51,93,144,3.2297939778129954,40.92490121959427
Task_44949,1325,344,174,115,289,3.8405797101449277,29.45869344886039
Task_44950,677,836,23,88,111,0.8088410991636799,19.568720985363136
Task_44951,1190,539,176,169,345,2.2037037037037037,28.274254851811403
Task_44952,894,469,51,63,114,1.902127659574468,21.808386259280866
Task_44953,1168,823,130,158,288,1.4174757281553398,28.48421076685604
Task_44954,1189,511,71,38,109,2.322265625,26.078347460712155
Task_44955,1238,101,27,53,80,12.137254901960784,25.008238006858466
Task_44956,913,142,101,192,293,6.384615384615385,22.18549237709487
Task_44957,1810,761,158,30,188,2.3753280839895012,37.358970821256506
Task_44958,711,347,49,43,92,2.043103448275862,17.81001205832216
Task_44959,2082,216,26,84,110,9.59447004608295,39.84138311978963
Task_44960,529,205,37,152,189,2.5679611650485437,16.048799705288356
Task_44961,1809,72,154,125,279,24.78082191780822,35.60086273668464
Task_44962,711,272,16,191,207,2.6043956043956045,19.23141805095854
Task_44963,1128,733,30,95,125,1.5367847411444142,26.584120508893317
Task_44964,1951,550,47,79,126,3.540834845735027,39.15197652323914
Task_44965,512,779,114,63,177,0.6564102564102564,17.247178091023113
Task_44966,863,104,107,71,178,8.219047619047618,19.959494856545106
Task_44967,1256,451,34,39,73,2.7787610619469025,26.329280696248347
Task_44968,2191,596,152,38,190,3.6700167504187604,42.91380466167275
Task_44969,866,627,119,110,229,1.3789808917197452,22.755156570282207
Task_44970,1297,609,183,144,327,2.1262295081967215,30.0702969621112
Task_44971,2654,296,15,133,148,8.936026936026936,49.49913243854811
Task_44972,1372,104,150,123,273,13.066666666666666,28.897349024118594
Task_44973,1812,632,11,114,125,2.862559241706161,37.14368026116105
Task_44974,1410,371,93,95,188,3.7903225806451615,30.4473764360168
Task_44975,1798,327,83,32,115,5.4817073170731705,35.15322390311868
Task_44976,990,106,18,62,80,9.25233644859813,21.1232744092698
Task_44977,1891,306,147,153,300,6.159609120521172,38.38892588107455
Task_44978,986,422,199,84,283,2.33096926713948,24.19778023627659
Task_44979,2305,600,140,93,233,3.8352745424292847,45.49053617209184
Task_44980,889,834,93,64,157,1.0646706586826347,23.027862390847215
Task_44981,1995,142,189,197,386,13.951048951048952,39.65636853334519
Task_44982,594,152,194,92,286,3.8823529411764706,16.94839543614997
Task_44983,1227,457,176,120,296,2.6790393013100435,28.308832642205417
Task_44984,2625,932,166,58,224,2.8135048231511255,51.21559505757127
Task_44985,1406,523,186,105,291,2.683206106870229,31.306658074969167
Task_44986,1987,904,87,77,164,2.1955801104972377,40.890826037082796
Task_44987,574,997,13,40,53,0.5751503006012024,17.449295707515493
Task_44988,523,525,36,196,232,0.9942965779467681,17.11063083824833
Task_44989,2546,375,169,109,278,6.7712765957446805,48.817961209619966
Task_44990,2964,848,10,21,31,3.491166077738516,54.32240026806406
Task_44991,2579,844,84,196,280,3.05207100591716,50.98879337393745
Task_44992,534,477,191,10,201,1.1171548117154813,16.21176856338177
Task_44993,1087,922,162,144,306,1.1776814734561214,27.562332879801428
Task_44994,2441,878,200,21,221,2.777019340159272,47.807017593188306
Task_44995,997,836,142,199,341,1.1911589008363201,26.108355653712284
Task_44996,743,669,113,18,131,1.108955223880597,19.705935539233113
Task_44997,1839,283,46,134,180,6.475352112676056,36.92761086218296
Task_44998,2667,408,168,129,297,6.52078239608802,50.957742119511465
Task_44999,2006,504,72,175,247,3.9722772277227723,40.70983750204517
Task_45000,1128,600,82,161,243,1.8768718801996673,27.054101531299917
Task_45001,2068,575,45,160,205,3.5902777777777777,41.67456165202406
Task_45002,1863,911,25,15,40,2.0427631578947367,37.068353224445275
Task_45003,1930,779,173,11,184,2.4743589743589745,39.198379682886724
Task_45004,1403,937,13,112,125,1.495735607675906,31.555220929036313
Task_45005,2673,364,10,47,57,7.323287671232877,48.53024209882546
Task_45006,1683,369,82,114,196,4.548648648648649,34.82471972501571
Task_45007,2884,997,185,63,248,2.8897795591182365,55.66848646898177
Task_45008,2078,172,14,38,52,12.011560693641618,38.39182203099152
Task_45009,1356,361,194,49,243,3.74585635359116,29.279093488654755
Task_45010,2795,86,25,135,160,32.12643678160919,50.22553123187905
Task_45011,1093,168,158,108,266,6.4674556213017755,24.89145931803864
Task_45012,2519,373,14,73,87,6.735294117647059,46.83430093605276
Task_45013,716,74,38,77,115,9.546666666666667,17.10941442250346
Task_45014,2991,611,39,128,167,4.887254901960785,56.11949107962482
Task_45015,1417,723,29,198,227,1.957182320441989,31.958004655401563
Task_45016,1185,269,140,53,193,4.388888888888889,26.22314582272125
Task_45017,2911,159,81,121,202,18.19375,53.314046812456816
Task_45018,1113,113,194,135,329,9.763157894736842,25.16488820644148
Task_45019,2881,89,28,95,123,32.01111111111111,51.26555433420296
Task_45020,1835,820,84,53,137,2.2350791717417784,37.87494233255077
Task_45021,1315,230,31,60,91,5.692640692640692,27.179846964720713
Task_45022,1186,923,84,198,282,1.2835497835497836,29.09999655180647
Task_45023,1244,980,72,199,271,1.2680937818552498,30.203325084902986
Task_45024,804,894,169,107,276,0.8983240223463688,22.84650492436918
Task_45025,821,371,82,35,117,2.206989247311828,19.833695310803616
Task_45026,2571,535,33,20,53,4.7966417910447765,47.28609784550929
Task_45027,890,991,167,49,216,0.8971774193548387,23.823675256433564
Task_45028,1739,195,75,29,104,8.872448979591837,33.767333028589476
Task_45029,2190,296,135,82,217,7.373737373737374,42.53270099950621
Task_45030,534,149,144,126,270,3.56,16.067750472318163
Task_45031,2060,372,147,145,292,5.522788203753351,41.234955750260504
Task_45032,2831,952,96,138,234,2.9706190975865687,55.025109903654084
Task_45033,2131,450,164,170,334,4.725055432372505,42.83960060588135
Task_45034,503,66,164,88,252,7.507462686567164,14.895300159034113
Task_45035,738,823,147,118,265,0.8956310679611651,21.547795728827364
Task_45036,2959,906,17,195,212,3.262403528114664,56.84439528748255
Task_45037,1996,221,195,184,379,8.99099099099099,40.15002739059228
Task_45038,2968,233,149,48,197,12.683760683760683,54.04191452947095
Task_45039,2222,671,168,167,335,3.306547619047619,44.98522682498549
Task_45040,1772,690,24,143,167,2.564399421128799,37.06549850079133
Task_45041,1778,319,50,158,208,5.55625,36.33676725692433
Task_45042,2229,810,164,16,180,2.74845869297164,44.0219064649635
Task_45043,620,598,89,137,226,1.0350584307178632,18.71914936971515
Task_45044,2612,175,89,176,265,14.840909090909092,48.925462655540166
Task_45045,2282,308,77,145,222,7.385113268608414,44.281790571453406
Task_45046,1020,473,96,173,269,2.151898734177215,25.046440825394424
Task_45047,2886,120,124,191,315,23.85123966942149,53.17627733154628
Task_45048,861,285,131,104,235,3.0104895104895104,21.670479448814376
Task_45049,2179,120,129,108,237,18.00826446280992,41.58007161162197
Task_45050,1650,515,98,138,236,3.197674418604651,34.94919739938956
Task_45051,2106,222,156,142,298,9.443946188340806,41.46423605857252
Task_45052,1533,303,159,164,323,5.042763157894737,32.83819876189216
Task_45053,2812,204,73,166,239,13.717073170731707,52.36992480382268
Task_45054,716,622,10,63,73,1.1492776886035314,18.670080047827614
Task_45055,1119,956,41,64,105,1.1692789968652038,26.684276914980696
Task_45056,1259,906,130,55,185,1.388092613009923,29.28437988981095
Task_45057,2431,303,39,21,60,7.996710526315789,44.353882332029
Task_45058,542,788,14,75,89,0.6869455006337135,17.158738620977516
Task_45059,1223,675,62,72,134,1.8091715976331362,27.91725598023518
Task_45060,953,785,186,186,372,1.2124681933842238,25.36910984563038
Task_45061,2775,982,66,50,116,2.822990844354018,52.865715462079486
Task_45062,1878,613,38,23,61,3.0586319218241043,36.63465881109038
Task_45063,2038,217,139,87,226,9.34862385321101,39.905176155468816
Task_45064,1812,744,102,134,236,2.4322147651006714,38.225188554421266
Task_45065,2139,892,69,38,107,2.395296752519597,42.301464370207235
Task_45066,1023,674,137,196,333,1.5155555555555555,25.993963824345474
Task_45067,2269,735,129,11,140,3.082880434782609,44.11675170317045
Task_45068,966,336,169,69,238,2.8664688427299705,23.17308640444828
Task_45069,2870,96,134,128,262,29.587628865979383,52.266875203654244
Task_45070,896,950,194,181,375,0.9421661409043113,25.02213361270776
Task_45071,2441,171,28,50,78,14.19186046511628,44.290426029011805
Task_45072,1876,88,165,131,296,21.078651685393258,36.811505323395586
Task_45073,2393,239,64,191,255,9.970833333333333,46.00913062755806
Task_45074,1735,763,10,15,25,2.270942408376963,34.48137220698708
Task_45075,1877,646,31,19,50,2.901081916537867,36.60693123839105
Task_45076,840,942,29,186,215,0.8907741251325557,23.342326283186054
Task_45077,766,1021,91,59,150,0.7495107632093934,21.62583948507859
Task_45078,931,320,84,60,144,2.9003115264797508,22.016432368480892
Task_45079,940,405,26,79,105,2.315270935960591,22.2768452965841
Task_45080,2204,934,55,180,235,2.3572192513368986,45.16142782132297
Task_45081,1339,539,36,135,171,2.47962962962963,29.759392878179458
Task_45082,2698,969,23,185,208,2.781443298969072,52.902096009020276
Task_45083,856,102,132,165,297,8.310679611650485,20.941165193734044
Task_45084,1113,472,162,100,262,2.3530655391120505,26.369182177171172
Task_45085,2461,598,158,107,265,4.108514190317195,48.135847576656865
Task_45086,2059,863,71,61,132,2.3831018518518516,41.59263674407813
Task_45087,2112,210,140,86,226,10.009478672985782,41.040678521317695
Task_45088,1412,907,84,162,246,1.5550660792951543,32.44698570641027
Task_45089,1919,865,158,89,247,2.215935334872979,40.23907882715886
Task_45090,1368,738,158,112,270,1.851150202976996,31.29380415686604
Task_45091,1261,624,179,100,279,2.0176,29.266240249348314
Task_45092,2535,603,180,174,354,4.197019867549669,49.82302054585919
Task_45093,1982,248,140,182,322,7.959839357429719,39.76738571218318
Task_45094,1353,410,86,191,277,3.291970802919708,30.132060106603472
Task_45095,2131,672,187,179,366,3.166419019316493,43.704306091106865
Task_45096,2997,893,169,123,292,3.3523489932885906,57.702597056345724
Task_45097,1714,766,199,183,382,2.2346805736636246,37.47126725508265
Task_45098,2378,75,79,63,142,31.289473684210527,43.22626275595703
Task_45099,1236,113,196,179,375,10.842105263157896,27.3708462494278
Task_45100,1806,1014,130,121,251,1.7793103448275862,39.005781753298805
Task_45101,2002,714,85,185,270,2.8,41.37508490107404
Task_45102,2918,976,96,155,251,2.986693961105425,56.580268812787345
Task_45103,930,437,170,88,258,2.1232876712328768,23.267527201459774
Task_45104,2932,618,193,10,203,4.736672051696284,54.665264866134834
Task_45105,2411,720,186,183,369,3.3439667128987516,48.31009252422829
Task_45106,971,865,101,176,277,1.1212471131639723,25.44541753825887
Task_45107,2594,124,26,20,46,20.752,45.86031871028112
Task_45108,1644,567,31,69,100,2.8943661971830985,33.735104215010104
Task_45109,2817,164,172,191,363,17.072727272727274,52.62253171401298
Task_45110,2855,163,35,150,185,17.408536585365855,52.257018420494994
Task_45111,850,926,188,115,303,0.9169363538295577,23.796237346694884
Task_45112,2830,888,71,41,112,3.1833520809898763,53.27587377801721
Task_45113,1432,179,109,84,193,7.955555555555556,29.797121489476524
Task_45114,2641,691,80,70,150,3.816473988439306,50.341215591729416
Task_45115,1164,459,86,134,220,2.5304347826086957,26.956223412959535
Task_45116,2656,228,121,133,254,11.59825327510917,49.96179078778217
Task_45117,2203,813,61,10,71,2.7063882063882065,42.252887014240244
Task_45118,1672,797,62,64,126,2.0952380952380953,35.3007510204706
Task_45119,1791,394,183,189,372,4.534177215189874,37.476159649930274
Task_45120,1147,677,149,109,258,1.691740412979351,27.531131176368888
Task_45121,651,801,179,33,212,0.8117206982543641,19.286114194136076
Task_45122,1427,920,25,74,99,1.5494028230184582,31.322986482353596
Task_45123,2396,875,73,100,173,2.7351598173515983,47.58073073768708
Task_45124,2039,179,110,89,199,11.327777777777778,39.434259664741845
Task_45125,1155,325,194,180,374,3.542944785276074,27.18665912401543
Task_45126,1637,317,173,56,229,5.147798742138365,33.64155073822275
Task_45127,2880,763,61,72,133,3.769633507853403,54.46620830704294
Task_45128,2499,815,41,10,51,3.0625,46.98771091833913
Task_45129,2267,272,179,127,306,8.304029304029305,44.2039296167769
Task_45130,1954,626,147,188,335,3.116427432216906,40.62938657090286
Task_45131,2188,791,115,15,130,2.7626262626262625,42.95982292023655
Task_45132,1585,634,71,190,261,2.4960629921259843,34.539746462213195
Task_45133,507,171,17,40,57,2.947674418604651,13.609843204107234
Task_45134,1573,433,30,52,82,3.6244239631336406,31.876850982171987
Task_45135,631,577,10,180,190,1.0916955017301038,18.715331972907503
Task_45136,2499,276,63,189,252,9.021660649819495,47.79972320962781
Task_45137,1796,987,55,180,235,1.8178137651821862,38.860907394827194
Task_45138,2605,770,129,90,219,3.378728923476005,50.69657025319206
Task_45139,517,869,20,70,90,0.5942528735632184,16.970261929263277
Task_45140,2516,208,139,81,220,12.038277511961722,47.338968154955374
Task_45141,921,205,24,187,211,4.470873786407767,22.35417214663626
Task_45142,1587,276,104,27,131,5.729241877256317,31.883332966649277
Task_45143,1124,929,80,129,209,1.2086021505376343,27.756660414519825
Task_45144,684,836,148,108,256,0.8172043010752689,20.678299311249177
Task_45145,700,506,77,79,156,1.3806706114398422,19.22768102931213
Task_45146,2434,841,106,146,252,2.8907363420427554,48.47263459788528
Task_45147,2786,951,198,19,217,2.926470588235294,53.47917212791415
Task_45148,2118,559,147,115,262,3.782142857142857,42.57831933405128
Task_45149,1268,752,105,22,127,1.6839309428950864,28.249339720008994
Task_45150,2748,838,61,116,177,3.2753277711561384,53.09758704051324
Task_45151,1160,579,159,122,281,2.0,27.56724674743518
Task_45152,1515,590,140,112,252,2.563451776649746,33.07812546372698
Task_45153,1127,235,26,181,207,4.77542372881356,25.680742636508516
Task_45154,1742,997,189,156,345,1.745490981963928,38.41378514436217
Task_45155,1423,826,67,64,131,1.720677146311971,31.490434595320924
Task_45156,2214,682,158,98,256,3.2415812591508053,44.44349396705862
Task_45157,2881,836,107,34,141,3.4420549581839905,54.229219358886745
Task_45158,1714,758,195,133,328,2.2582345191040845,37.12961641506477
Task_45159,954,762,76,13,89,1.2503276539973787,22.900869720887993
Task_45160,918,437,125,64,189,2.095890410958904,22.50866978151129
Task_45161,2805,209,126,110,236,13.357142857142858,52.12437481681019
Task_45162,1350,832,138,12,150,1.6206482593037215,29.919054062165667
Task_45163,2776,498,20,64,84,5.56312625250501,51.23277918705699
Task_45164,1925,885,102,129,231,2.172686230248307,40.42553927405283
Task_45165,2182,724,44,112,156,3.009655172413793,43.464415733649055
Task_45166,2774,731,77,63,140,3.789617486338798,52.57705444395157
Task_45167,807,215,109,137,246,3.736111111111111,20.685137195938413
Task_45168,923,370,146,48,194,2.487870619946092,22.170888153543075
Task_45169,2040,880,118,160,278,2.315550510783201,42.48940657434388
Task_45170,580,665,115,40,155,0.8708708708708709,17.3564272286436
Task_45171,1701,992,109,192,301,1.7129909365558913,37.60300742407708
Task_45172,2278,162,134,128,262,13.975460122699387,43.56931413867161
Task_45173,1705,450,162,200,362,3.7804878048780486,36.26710622866398
Task_45174,2361,599,29,43,72,3.935,44.322301127772924
Task_45175,1790,590,33,89,122,3.0287648054145517,36.59324204500316
Task_45176,2332,1009,175,92,267,2.3089108910891087,47.317116419118044
Task_45177,2859,466,175,61,236,6.122055674518201,53.484726204648126
Task_45178,1393,81,69,127,196,16.98780487804878,28.793111270281596
Task_45179,1462,452,137,61,198,3.227373068432671,31.15568419913708
Task_45180,2606,147,23,75,98,17.60810810810811,47.069036455510656
Task_45181,1969,989,195,192,387,1.988888888888889,42.24169414775945
Task_45182,991,246,135,55,190,4.012145748987854,23.014328543533352
Task_45183,2942,950,140,182,322,3.0935856992639326,57.23121841136098
Task_45184,2994,643,76,194,270,4.649068322981367,56.9376007010212
Task_45185,2779,1009,186,57,243,2.7514851485148513,53.9806851372241
Task_45186,1253,594,144,51,195,2.1058823529411765,28.28130862028908
Task_45187,1342,800,124,100,224,1.6754057428214733,30.836473915098185
Task_45188,1278,279,132,83,215,4.564285714285714,28.049502233788573
Task_45189,1764,947,25,38,63,1.860759493670886,35.927293947054984
Task_45190,2643,342,129,70,199,7.705539358600583,49.54949531823295
Task_45191,2442,535,153,154,307,4.5559701492537314,47.89185163034072
Task_45192,1611,611,111,68,179,2.6323529411764706,33.967434024007126
Task_45193,704,598,120,164,284,1.1752921535893155,20.42065078057703
Task_45194,2165,401,179,117,296,5.385572139303482,42.96887792655978
Task_45195,2034,773,60,13,73,2.627906976744186,39.462265823651215
Task_45196,739,187,26,98,124,3.9308510638297873,18.616855483379755
Task_45197,1793,535,111,30,141,3.345149253731343,36.04377801277072
Task_45198,1583,220,12,103,115,7.16289592760181,32.02969620694011
Task_45199,2831,102,131,63,194,27.485436893203882,50.947699986820425
Task_45200,2140,488,200,137,337,4.376278118609407,43.069869921427596
Task_45201,1947,67,183,12,195,28.63235294117647,36.250926569535935
Task_45202,910,454,116,147,263,2.0,23.172644756096883
Task_45203,1269,708,176,103,279,1.7898448519040904,29.659462435441583
Task_45204,1870,225,122,32,154,8.274336283185841,36.299143542515445
Task_45205,1699,899,164,155,319,1.8877777777777778,37.32282978860083
Task_45206,1641,399,151,40,191,4.1025,33.573574700677895
Task_45207,2690,430,127,182,309,6.241299303944316,51.52642317732049
Task_45208,1237,634,49,158,207,1.948031496062992,28.773956784162852
Task_45209,2883,236,119,70,189,12.164556962025317,52.91030584947444
Task_45210,2963,801,182,147,329,3.6945137157107233,57.07687872138526
Task_45211,2215,688,123,147,270,3.2148040638606674,44.60563694461541
Task_45212,2661,905,181,35,216,2.937086092715232,51.436629441453505
Task_45213,2965,327,116,45,161,9.039634146341463,54.01843460341765
Task_45214,2898,796,178,177,355,3.6361355081555833,56.19250118263951
Task_45215,2355,898,20,135,155,2.6195773081201335,46.743925031279154
Task_45216,1283,542,129,130,259,2.3627992633517496,29.311436310419438
Task_45217,2734,443,192,195,387,6.157657657657658,52.63629057579649
Task_45218,2612,623,115,25,140,4.185897435897436,49.23765112834508
Task_45219,2109,505,12,184,196,4.16798418972332,42.03114702907496
Task_45220,1208,309,177,173,350,3.8967741935483873,27.854177343003958
Task_45221,2712,388,189,161,350,6.97172236503856,51.88874163946127
Task_45222,854,444,106,34,140,1.9191011235955056,20.885609363743068
Task_45223,1123,516,106,125,231,2.172147001934236,26.56290584924335
Task_45224,1465,378,45,115,160,3.865435356200528,31.03599599007393
Task_45225,2486,798,67,24,91,3.111389236545682,47.31748131670227
Task_45226,1767,440,44,77,121,4.006802721088436,35.666186815926785
Task_45227,1165,624,109,70,179,1.864,26.946235113481915
Task_45228,515,819,153,176,329,0.6280487804878049,18.499209339499554
Task_45229,850,400,156,101,257,2.119700748129676,21.958446645942995
Task_45230,508,530,17,31,48,0.9566854990583804,14.786362597124578
Task_45231,964,568,54,24,78,1.6942003514938488,22.059095748309137
Task_45232,1939,134,24,152,176,14.362962962962962,37.563680493164334
Task_45233,918,984,174,23,197,0.9319796954314721,24.0447617506118
Task_45234,2454,809,188,102,290,3.0296296296296297,48.79605836019336
Task_45235,1715,211,138,70,208,8.089622641509434,34.460477219255964
Task_45236,2621,314,188,37,225,8.320634920634921,48.95360051682525
Task_45237,630,390,55,20,75,1.6112531969309463,16.100539183101784
Task_45238,2894,229,88,180,268,12.582608695652175,53.81549604289062
Task_45239,1736,586,19,119,138,2.9574105621805793,35.84123094536198
Task_45240,1043,643,135,194,329,1.6195652173913044,26.222577594580212
Task_45241,2787,1019,138,96,234,2.7323529411764707,54.49600022472253
Task_45242,507,833,167,25,192,0.6079136690647482,17.261442274146724
Task_45243,2626,271,197,183,380,9.654411764705882,50.289941513066275
Task_45244,2038,753,13,176,189,2.702917771883289,41.656296162674344
Task_45245,2562,241,14,156,170,10.586776859504132,48.120775236420904
Task_45246,1546,621,25,192,217,2.485530546623794,33.61161044487718
Task_45247,2900,580,88,174,262,4.991394148020654,55.07383235306987
Task_45248,585,227,29,126,155,2.5657894736842106,16.608198298321014
Task_45249,1609,318,89,140,229,5.043887147335423,33.6100113174636
Task_45250,2954,1021,105,170,275,2.8904109589041096,57.413703432889214
Task_45251,1443,1024,20,72,92,1.4078048780487804,31.868842367093823
Task_45252,1014,145,140,27,167,6.945205479452055,22.3969991123507
Task_45253,1713,752,80,74,154,2.2749003984063747,35.934086303774116
Task_45254,1424,116,73,71,144,12.17094017094017,28.723090610917225
Task_45255,1752,922,196,17,213,1.8981581798483207,36.973094507784346
Task_45256,1698,739,139,177,316,2.2945945945945945,36.82722108396917
Task_45257,2104,590,59,178,237,3.560067681895093,42.50467531805548
Task_45258,1579,240,91,106,197,6.551867219917012,32.696806362195304
Task_45259,1820,433,173,63,236,4.193548387096774,36.9813402200126
Task_45260,1600,689,136,118,254,2.318840579710145,34.75258983854144
Task_45261,890,724,145,170,315,1.2275862068965517,23.901558548359834
Task_45262,2765,846,185,11,196,3.2644628099173554,52.71047643066874
Task_45263,644,263,28,194,222,2.4393939393939394,18.232950153376375
Task_45264,1253,584,89,98,187,2.141880341880342,28.56975187348712
Task_45265,2236,743,87,131,218,3.0053763440860215,44.81364883993172
Task_45266,2693,862,78,117,195,3.1205098493626884,52.409588452002076
Task_45267,1174,486,70,10,80,2.410677618069815,25.377602493449714
Task_45268,2043,883,40,182,222,2.3110859728506785,42.33602210589881
Task_45269,2200,829,21,180,201,2.6506024096385543,44.529310225560515
Task_45270,2373,586,73,190,263,4.042589437819421,46.87665498796363
Task_45271,719,822,20,33,53,0.8736330498177399,19.12686673982815
Task_45272,1354,608,198,162,360,2.2233169129720856,31.14499032510463
Task_45273,2413,255,64,133,197,9.42578125,46.03774263296351
Task_45274,586,803,89,70,159,0.7288557213930348,18.26760467111432
Task_45275,1110,371,133,76,209,2.9838709677419355,25.55534431635573
Task_45276,2492,759,16,125,141,3.278947368421053,48.38430950502652
Task_45277,1980,83,136,37,173,23.571428571428573,36.967096826766394
Task_45278,2368,981,196,89,285,2.4114052953156824,47.88640481394274
Task_45279,2143,555,86,138,224,3.8543165467625897,42.78416703161471
Task_45280,1884,920,12,147,159,2.045602605863192,39.3547620628105
Task_45281,1791,215,107,93,200,8.291666666666666,35.93413220460706
Task_45282,2184,579,31,140,171,3.7655172413793103,43.256415413156525
Task_45283,593,553,129,159,288,1.0703971119133573,18.52587016429459
Task_45284,2521,651,85,174,259,3.8665644171779143,49.3316162163948
Task_45285,1624,963,196,189,385,1.6846473029045643,36.66702855106603
Task_45286,1359,450,58,100,158,3.0133037694013303,29.601471232349123
Task_45287,842,104,125,69,194,8.019047619047619,19.724959635313883
Task_45288,1123,158,143,163,306,7.062893081761007,25.60268372168675
Task_45289,1725,454,92,191,283,3.791208791208791,36.234903100578066
Task_45290,2868,728,33,113,146,3.934156378600823,54.29798254838088
Task_45291,1884,424,101,176,277,4.432941176470588,38.59802637860816
Task_45292,2970,259,60,196,256,11.423076923076923,55.21154012385896
Task_45293,1764,410,153,170,323,4.291970802919708,36.85218682699175
Task_45294,569,773,82,13,95,0.7351421188630491,17.12896555201529
Task_45295,1757,910,41,142,183,1.928649835345774,37.61899825301597
Task_45296,1935,387,14,87,101,4.987113402061856,37.939973022157616
Task_45297,1331,1012,74,124,198,1.313919052319842,31.257025238516178
Task_45298,1022,700,158,135,293,1.4579172610556348,25.7781506330991
Task_45299,1709,815,14,17,31,2.094362745098039,34.2815718938533
Task_45300,2095,823,113,168,281,2.5424757281553396,43.20823489633312
Task_45301,2361,473,168,158,326,4.981012658227848,46.50109595501187
Task_45302,2403,390,29,192,221,6.145780051150895,46.47279339659431
Task_45303,1073,164,133,97,230,6.503030303030303,24.386541074679624
Task_45304,1016,925,122,16,138,1.0971922246220303,24.813633291214746
Task_45305,2697,491,60,173,233,5.4817073170731705,51.550669892314545
Task_45306,1241,110,42,133,175,11.18018018018018,26.336216152859762
Task_45307,2711,80,28,193,221,33.46913580246913,49.5677452700483
Task_45308,1046,694,88,125,213,1.5050359712230217,25.73180465374578
Task_45309,1143,190,84,106,190,5.984293193717278,25.609410222548842
Task_45310,1432,158,122,37,159,9.0062893081761,28.921323375795282
Task_45311,2487,300,135,154,289,8.262458471760798,47.7434653001683
Task_45312,1223,305,12,85,97,3.996732026143791,26.287759309840784
Task_45313,707,997,63,14,77,0.7084168336673347,19.561224112909112
Task_45314,1253,233,134,32,166,5.354700854700854,26.78559966728417
Task_45315,2628,822,20,75,95,3.193195625759417,50.10042678474408
Task_45316,1152,743,176,128,304,1.5483870967741935,28.021563407249044
Task_45317,2942,762,186,95,281,3.855832241153342,56.34219204641906
Task_45318,2868,611,23,74,97,4.686274509803922,53.25973972349342
Task_45319,2447,489,51,199,250,4.993877551020408,47.7300385566138
Task_45320,1937,259,93,78,171,7.45,38.102275267083336
Task_45321,2506,992,19,108,127,2.523665659617321,49.28202533442404
Task_45322,2518,826,32,128,160,3.0447400241837967,49.12781721489582
Task_45323,1243,85,14,151,165,14.453488372093023,26.1909108075799
Task_45324,524,445,108,196,304,1.1748878923766817,17.231866903038576
Task_45325,2411,73,65,132,197,32.58108108108108,44.70380241757497
Task_45326,922,804,63,121,184,1.1453416149068323,24.00907679790907
Task_45327,1922,867,99,168,267,2.2142857142857144,40.54305199708121
Task_45328,2539,526,74,120,194,4.817836812144212,48.90016312527695
Task_45329,1576,127,153,186,339,12.3125,32.707971948747506
Task_45330,2022,866,54,196,250,2.332179930795848,42.15715560662583
Task_45331,2582,759,50,145,195,3.3973684210526316,50.399968989275415
Task_45332,2484,917,74,51,125,2.7058823529411766,48.319777384328546
Task_45333,2604,882,121,91,212,2.9490373725934313,50.978634355856705
Task_45334,2154,130,106,189,295,16.442748091603054,41.63575677020386
Task_45335,2161,812,33,83,116,2.658056580565806,43.11587293327671
Task_45336,1399,866,120,125,245,1.6136101499423299,32.075899349714554
Task_45337,1463,961,138,150,288,1.5207900207900207,33.58590128397004
Task_45338,2768,221,153,93,246,12.468468468468469,51.59207650519469
Task_45339,2364,272,126,67,193,8.659340659340659,44.8631151982201
Task_45340,793,242,160,39,199,3.263374485596708,19.686903036751335
Task_45341,1950,564,105,103,208,3.4513274336283186,39.672986914661166
Task_45342,1235,756,61,153,214,1.631439894319683,29.104275752972168
Task_45343,1960,681,39,21,60,2.873900293255132,38.1256868056175
Task_45344,2989,635,161,128,289,4.699685534591195,56.754828125939206
Task_45345,1622,974,165,17,182,1.6635897435897435,34.90518360027754
Task_45346,2946,597,73,131,204,4.926421404682274,55.63353279401548
Task_45347,706,164,120,117,237,4.278787878787878,18.66128744072591
Task_45348,1710,907,126,66,192,1.8832599118942732,36.53948546166693
Task_45349,2098,663,67,148,215,3.1596385542168677,42.50174164345186
Task_45350,1653,173,172,57,229,9.5,33.21819569036277
Task_45351,1430,157,180,95,275,9.050632911392405,30.18798044426788
Task_45352,506,955,21,59,80,0.5292887029288703,16.477070148229558
Task_45353,2883,270,32,56,88,10.638376383763838,52.06232875869199
Task_45354,1314,1008,192,155,347,1.3022794846382557,31.625152095795684
Task_45355,2584,154,140,13,153,16.670967741935485,46.9136323845764
Task_45356,2864,950,38,90,128,3.0115667718191377,55.02998597784042
Task_45357,1644,825,39,54,93,1.9903147699757868,34.333635510725024
Task_45358,1375,754,53,43,96,1.8211920529801324,29.5752194598698
Task_45359,2271,841,10,186,196,2.697149643705463,45.65660009358444
Task_45360,1605,776,21,39,60,2.0656370656370657,32.839797739375406
Task_45361,2566,421,64,25,89,6.080568720379147,47.25338602870141
Task_45362,1249,423,141,39,180,2.9457547169811322,27.39152751308478
Task_45363,1050,121,149,155,304,8.60655737704918,24.191691024410744
Task_45364,1433,841,100,24,124,1.7019002375296912,31.035776726633447
Task_45365,738,632,137,193,330,1.1658767772511849,21.305431816742477
Task_45366,933,665,45,60,105,1.4009009009009008,22.572886316383943
Task_45367,2054,783,96,192,288,2.6198979591836733,42.508049645266816
Task_45368,2180,925,63,133,196,2.3542116630669545,44.50594513850087
Task_45369,1701,690,20,92,112,2.4616497829232995,35.352953744113705
Task_45370,1004,494,169,128,297,2.0282828282828285,24.91170558434021
Task_45371,693,780,52,122,174,0.8873239436619719,20.29009384576844
Task_45372,1660,373,167,139,306,4.438502673796791,34.964297403527816
Task_45373,1570,880,44,69,113,1.7820658342792282,33.794973980699304
Task_45374,1466,292,88,20,108,5.003412969283277,29.662166268348955
Task_45375,2500,173,79,168,247,14.367816091954023,47.15413551412261
Task_45376,697,698,195,17,212,0.9971387696709585,19.61644879456653
Task_45377,1902,350,91,198,289,5.418803418803419,38.72613188170611
Task_45378,2655,823,90,175,265,3.2220873786407767,52.01317879396334
Task_45379,1369,466,170,14,184,2.931477516059957,29.32002489355162
Task_45380,1660,295,13,199,212,5.608108108108108,34.34634198766696
Task_45381,2223,738,77,102,179,3.0081190798376185,44.45460677414778
Task_45382,2692,653,170,154,324,4.116207951070336,52.30398984626529
Task_45383,1767,586,167,132,299,3.0102214650766608,37.297358262467704
Task_45384,635,162,45,54,99,3.895705521472393,15.996793650807538
Task_45385,1844,559,23,119,142,3.2928571428571427,37.49488022757807
Task_45386,2218,351,141,28,169,6.301136363636363,42.387199258505184
Task_45387,2164,124,146,117,263,17.312,41.48692419995131
Task_45388,2062,459,164,130,294,4.482608695652174,41.53764682746397
Task_45389,1425,761,71,14,85,1.8700787401574803,30.305070327015247
Task_45390,829,976,120,14,134,0.8485158648925282,22.08870337442565
Task_45391,736,546,188,105,293,1.3455210237659962,20.732546600250647
Task_45392,946,755,45,132,177,1.2513227513227514,24.198689890408236
Task_45393,892,757,173,130,303,1.1767810026385224,23.927616164226876
Task_45394,1005,625,119,39,158,1.6054313099041533,23.969150355475062
Task_45395,632,771,128,12,140,0.8186528497409327,18.361437310843645
Task_45396,1463,314,180,23,203,4.644444444444445,30.469887589312624
Task_45397,1670,667,153,196,349,2.5,36.33498350734617
Task_45398,1454,812,107,143,250,1.7884378843788438,32.84187354629201
Task_45399,815,166,147,58,205,4.880239520958084,19.856382811537944
Task_45400,2114,922,126,133,259,2.2903575297941496,43.66760305435175
Task_45401,2347,219,131,147,278,10.668181818181818,45.175850990684864
Task_45402,617,243,34,169,203,2.528688524590164,17.64147028939901
Task_45403,2287,573,120,56,176,3.984320557491289,44.502502349779405
Task_45404,1194,661,92,95,187,1.8036253776435045,27.914649219861833
Task_45405,711,927,24,52,76,0.7661637931034483,19.487507429562616
Task_45406,2303,683,31,108,139,3.3669590643274856,45.138738630211634
Task_45407,725,636,100,28,128,1.1381475667189953,19.51120971395602
Task_45408,2768,615,184,116,300,4.4935064935064934,53.222879928019324
Task_45409,1313,323,198,168,366,4.052469135802469,29.625156728766893
Task_45410,1663,938,54,178,232,1.7710330138445154,36.571746990028515
Task_45411,2816,674,174,21,195,4.1718518518518515,52.98902403073987
Task_45412,1904,234,156,26,182,8.102127659574467,37.07861979241699
Task_45413,1442,147,35,148,183,9.743243243243244,29.894164066535925
Task_45414,1012,955,161,184,345,1.0585774058577406,26.71009385037135
Task_45415,2309,643,68,78,146,3.5854037267080745,45.19823199059616
Task_45416,1856,886,181,126,307,2.092446448703495,39.673486130729465
Task_45417,2217,499,64,65,129,4.434,43.082266332929315
Task_45418,1162,845,15,74,89,1.3735224586288417,26.86187225587665
Task_45419,592,603,197,149,346,0.9801324503311258,18.950119919917583
Task_45420,1964,312,153,24,177,6.274760383386582,38.25307912280997
Task_45421,2657,367,17,154,171,7.220108695652174,50.034385006781804
Task_45422,2808,1008,42,172,214,2.7829534192269576,54.80410877617394
Task_45423,2827,734,34,49,83,3.8462585034013603,52.58235190935478
Task_45424,1408,443,80,130,210,3.171171171171171,30.809543610955433
Task_45425,935,388,45,179,224,2.403598971722365,23.259104656179545
Task_45426,1130,950,45,163,208,1.188222923238696,27.93359363261737
Task_45427,1905,90,169,101,270,20.934065934065934,37.12220919337379
Task_45428,2684,852,85,152,237,3.1465416178194605,52.41534142814256
Task_45429,685,143,74,172,246,4.756944444444445,18.435803678207716
Task_45430,627,801,112,173,285,0.7817955112219451,19.907506280195744
Task_45431,1285,128,45,31,76,9.96124031007752,25.581859167583005
Task_45432,2334,639,24,68,92,3.646875,44.797139694156094
Task_45433,1560,491,155,175,330,3.1707317073170733,33.9218237601218
Task_45434,869,380,81,90,171,2.2808398950131235,21.76487205078065
Task_45435,1475,325,35,196,231,4.524539877300613,31.64044000105012
Task_45436,2850,283,40,51,91,10.035211267605634,51.63328123349756
Task_45437,1909,408,200,48,248,4.667481662591687,38.1375126984669
Task_45438,2682,380,11,21,32,7.039370078740157,48.360115938305974
Task_45439,1228,813,33,32,65,1.5085995085995085,27.00048671337426
Task_45440,805,755,161,67,228,1.0648148148148149,21.87629160674413
Task_45441,2787,910,111,65,176,3.0592755214050493,53.53155422305906
Task_45442,2939,335,134,168,302,8.74702380952381,55.09256372916036
Task_45443,689,265,57,22,79,2.5902255639097747,16.77343291486464
Task_45444,2572,423,104,63,167,6.066037735849057,48.524439723695224
Task_45445,1150,889,29,195,224,1.2921348314606742,28.15137650074932
Task_45446,2474,613,128,120,248,4.029315960912052,48.3318786062959
Task_45447,2571,163,13,78,91,15.676829268292684,46.70536783099728
Task_45448,2716,692,60,88,148,3.919191919191919,51.83724753770607
Task_45449,1442,657,113,73,186,2.1914893617021276,31.51750599120331
Task_45450,2820,491,165,52,217,5.7317073170731705,52.91922572058098
Task_45451,1116,762,122,132,254,1.4626474442988204,27.279680331154243
Task_45452,1448,107,175,167,342,13.407407407407407,30.481981921405595
Task_45453,954,872,73,84,157,1.092783505154639,24.388569616551678
Task_45454,1237,202,196,148,344,6.093596059113301,27.886848506224894
Task_45455,2408,814,11,77,88,2.954601226993865,46.50750912386891
Task_45456,1178,485,107,91,198,2.4238683127572016,27.082543603982785
Task_45457,632,726,53,70,123,0.8693259972489684,18.534827056427197
Task_45458,2279,419,189,159,348,5.4261904761904765,45.12788745767966
Task_45459,769,592,162,119,281,1.296795952782462,21.35040847510332
Task_45460,1059,787,27,137,164,1.3439086294416243,25.99319233574788
Task_45461,1735,819,104,33,137,2.1158536585365852,35.97404681586431
Task_45462,2836,175,111,137,248,16.113636363636363,52.33829663678072
Task_45463,2351,672,194,93,287,3.4933135215453195,46.69042053115147
Task_45464,2114,334,63,21,84,6.3104477611940295,39.790025073907856
Task_45465,2514,784,67,84,151,3.202547770700637,48.89555198679094
Task_45466,1411,888,48,165,213,1.5871766029246344,32.28289126704557
Task_45467,616,670,142,121,263,0.9180327868852459,19.12553313249192
Task_45468,1760,886,69,25,94,1.984216459977452,36.16138571575224
Task_45469,2807,119,168,22,190,23.391666666666666,50.524755030653544
Task_45470,1089,872,110,65,175,1.2474226804123711,26.496586473006023
Task_45471,2345,775,22,23,45,3.0219072164948453,44.43518397720797
Task_45472,2890,544,181,187,368,5.302752293577981,55.33760048507755
Task_45473,717,104,192,14,206,6.828571428571428,17.521544131609637
Task_45474,1890,261,194,94,288,7.213740458015267,38.070862407102496
Task_45475,1348,601,65,51,116,2.2392026578073088,29.15182452362292
Task_45476,1292,837,109,186,295,1.541766109785203,30.57600502937918
Task_45477,1797,122,38,108,146,14.609756097560975,34.73184598884612
Task_45478,2053,632,103,17,120,3.2432859399684046,40.100923634497086
Task_45479,1014,658,121,14,135,1.5386949924127467,23.90404573792473
Task_45480,1542,391,112,31,143,3.933673469387755,31.644566187175666
Task_45481,2370,931,19,13,32,2.5429184549356223,45.13530063316801
Task_45482,1384,598,165,176,341,2.310517529215359,31.5236345368322
Task_45483,2904,964,196,44,240,3.0093264248704665,55.58186862102457
Task_45484,2726,999,189,200,389,2.726,54.28970294728223
Task_45485,2431,576,33,78,111,4.213171577123051,46.566606426424904
Task_45486,1226,802,45,123,168,1.526774595267746,28.740423812048892
Task_45487,2485,348,69,197,266,7.1203438395415475,47.9091575537527
Task_45488,1544,580,92,139,231,2.657487091222031,33.458501684727494
Task_45489,2267,766,37,17,54,2.955671447196871,43.1984492495259
Task_45490,1694,517,124,177,301,3.27027027027027,35.998056190235324
Task_45491,1742,593,186,40,226,2.9326599326599325,35.94851473871867
Task_45492,1708,694,112,67,179,2.4575539568345324,35.76429528988096
Task_45493,706,235,29,125,154,2.9915254237288136,18.501839688061605
Task_45494,718,928,198,167,365,0.7728740581270183,22.093509012171
Task_45495,2238,817,191,93,284,2.7359413202933984,45.342268399310605
Task_45496,2159,671,38,56,94,3.212797619047619,42.01185949291857
Task_45497,1671,803,174,10,184,2.078358208955224,35.16850101768967
Task_45498,561,488,78,24,102,1.147239263803681,15.981056720334072
Task_45499,877,288,21,49,70,3.0346020761245676,19.93615696233716
Task_45500,524,537,95,176,271,0.9739776951672863,17.36353634351445
Task_45501,1932,475,100,84,184,4.0588235294117645,38.85101786370703
Task_45502,1333,259,37,46,83,5.126923076923077,27.328256601762707
Task_45503,1945,172,35,170,205,11.242774566473988,38.097395017598636
Task_45504,1845,694,43,145,188,2.6546762589928057,38.394303598367095
Task_45505,1727,187,61,160,221,9.186170212765957,35.10437773246599
Task_45506,2174,448,12,137,149,4.841870824053452,42.41799145367316
Task_45507,2661,774,56,79,135,3.4335483870967742,51.12854286850138
Task_45508,1481,434,84,126,210,3.4045977011494255,31.88688373985301
Task_45509,1157,537,135,95,230,2.150557620817844,27.132159362055543
Task_45510,2122,800,25,48,73,2.6491885143570535,41.242536398380864
Task_45511,824,205,134,194,328,4.0,21.373030859048857
Task_45512,2238,553,137,160,297,4.03971119133574,44.683056876486695
Task_45513,1520,664,187,124,311,2.2857142857142856,33.672901969401885
Task_45514,1367,859,32,39,71,1.5895348837209302,29.3681953098404
Task_45515,1813,960,138,34,172,1.886576482830385,37.95150976217521
Task_45516,2108,342,79,169,248,6.145772594752186,41.79118329077195
Task_45517,1977,1009,147,79,226,1.9574257425742574,41.43711005533998
Task_45518,2358,671,195,32,227,3.5089285714285716,45.953047129440726
Task_45519,984,675,170,20,190,1.455621301775148,23.953855967468503
Task_45520,2691,367,169,92,261,7.3125,50.93160170819936
Task_45521,752,512,189,163,352,1.46588693957115,21.223857240899672
Task_45522,1508,641,115,67,182,2.3489096573208723,32.43584811490951
Task_45523,1230,898,102,33,135,1.3681868743047831,28.21533726112771
Task_45524,2166,337,141,21,162,6.408284023668639,41.402423669470586
Task_45525,1214,695,55,45,100,1.7442528735632183,26.816526058294205
Task_45526,952,547,92,124,216,1.7372262773722629,23.877719597966376
Task_45527,1789,370,67,11,78,4.822102425876011,34.516563795876515
Task_45528,2891,948,137,111,248,3.0463645943097997,55.97920790414628
Task_45529,2064,156,193,159,352,13.146496815286625,40.62735287859384
Task_45530,1081,682,128,83,211,1.582723279648609,26.154203007340598
Task_45531,512,243,89,116,205,2.098360655737705,15.880917448457547
Task_45532,2490,600,127,120,247,4.143094841930116,48.53940386352888
Task_45533,1983,715,65,48,113,2.7695530726256985,39.39218067776067
Task_45534,832,713,63,15,78,1.165266106442577,20.43679836725941
Task_45535,707,643,31,144,175,1.0978260869565217,20.021037732228997
Task_45536,1030,998,24,10,34,1.031031031031031,24.20766954910496
Task_45537,2959,851,146,160,306,3.473004694835681,57.08608101239673
Task_45538,1458,796,93,27,120,1.8293601003764115,31.34314992644356
Task_45539,2273,820,73,119,192,2.7685749086479903,45.6060074486765
Task_45540,622,820,62,148,210,0.7576126674786845,19.521174877339796
Task_45541,2627,808,119,71,190,3.2472187886279356,50.790541677634764
Task_45542,736,690,48,199,247,1.065123010130246,21.107269186683677
Task_45543,692,342,108,100,208,2.0174927113702625,19.05305053818545
Task_45544,2555,266,50,154,204,9.569288389513108,48.412067979680536
Task_45545,2378,896,143,76,219,2.6510590858416947,47.3342527882424
Task_45546,856,81,13,33,46,10.439024390243903,18.179727479713517
Task_45547,1191,379,143,23,166,3.1342105263157896,26.224081546453203
Task_45548,792,915,185,111,296,0.8646288209606987,22.80303618481994
Task_45549,1544,471,166,187,353,3.2711864406779663,33.72618243493094
Task_45550,1956,431,52,107,159,4.527777777777778,39.00178244619953
Task_45551,1535,641,13,170,183,2.3909657320872273,33.270871569012094
Task_45552,1968,536,67,75,142,3.664804469273743,39.35384632684772
Task_45553,1905,670,116,24,140,2.8390461997019374,38.17887422159129
Task_45554,2002,169,39,198,237,11.776470588235295,39.19407476214493
Task_45555,820,1019,57,101,158,0.803921568627451,22.79513517386097
Task_45556,679,200,11,89,100,3.3781094527363185,17.401286050543963
Task_45557,2881,306,104,43,147,9.384364820846905,52.56645999909503
Task_45558,2537,381,34,64,98,6.641361256544503,47.21909249635927
Task_45559,2742,148,13,149,162,18.40268456375839,50.05962877602898
Task_45560,2715,92,67,68,135,29.193548387096776,48.65103121446396
Task_45561,1577,508,100,63,163,3.0982318271119844,33.035261757909765
Task_45562,966,236,85,15,100,4.075949367088608,21.485107389419085
Task_45563,644,256,96,82,178,2.5058365758754864,17.773184043715627
Task_45564,2529,591,128,44,172,4.27195945945946,48.14116659557475
Task_45565,610,89,128,22,150,6.777777777777778,15.239265355851282
Task_45566,1396,830,99,80,179,1.6799037304452467,31.43675715288561
Task_45567,2908,384,56,57,113,7.5532467532467535,53.149511208775074
Task_45568,2613,263,72,103,175,9.897727272727273,49.04768191282068
Task_45569,2850,175,44,159,203,16.193181818181817,52.34469197614637
Task_45570,2213,888,13,196,209,2.489313835770529,44.97337224050754
Task_45571,899,78,144,199,343,11.379746835443038,21.75141448992979
Task_45572,1049,150,74,18,92,6.947019867549669,22.304211555736867
Task_45573,997,787,73,173,246,1.265228426395939,25.54091676088201
Task_45574,2401,981,93,199,292,2.445010183299389,48.68318345382665
Task_45575,602,582,137,88,225,1.032590051457976,18.32734396312426
Task_45576,2379,163,37,72,109,14.50609756097561,43.79132913606326
Task_45577,1179,1017,18,101,119,1.1581532416502947,28.107669369891514
Task_45578,2318,123,130,148,278,18.693548387096776,44.02016258302922
Task_45579,2638,986,34,133,167,2.67274569402229,51.72120138406313
Task_45580,649,224,124,89,213,2.8844444444444446,17.95823952811082
Task_45581,923,939,101,11,112,0.9819148936170212,23.292186097185564
Task_45582,876,611,48,27,75,1.4313725490196079,20.832629610011253
Task_45583,1751,306,59,182,241,5.703583061889251,36.021836756095844
Task_45584,2186,196,160,23,183,11.096446700507615,41.37963425388273
Task_45585,731,365,67,172,239,1.9972677595628416,20.062504925567296
Task_45586,2397,683,98,46,144,3.504385964912281,46.114290368157164
Task_45587,550,309,182,87,269,1.7741935483870968,16.888017320210597
Task_45588,1987,403,65,105,170,4.9183168316831685,39.594909792761236
Task_45589,2107,678,170,30,200,3.1030927835051547,41.87103719905332
Task_45590,2561,392,53,13,66,6.516539440203562,46.566039454735495
Task_45591,1014,446,152,112,264,2.2684563758389262,24.74674349962359
Task_45592,1313,384,67,67,134,3.4103896103896103,28.36755210498592
Task_45593,1230,564,38,118,156,2.1769911504424777,27.886110928735942
Task_45594,1714,506,27,74,101,3.380670611439842,34.742366192338785
Task_45595,1053,320,117,101,218,3.2803738317757007,24.738504861901117
Task_45596,2826,515,81,169,250,5.476744186046512,53.72553842007503
Task_45597,1193,808,112,190,302,1.4746600741656366,28.943755916520615
Task_45598,2496,260,165,174,339,9.563218390804598,47.997404325005704
Task_45599,2191,567,99,101,200,3.857394366197183,43.46144902925968
Task_45600,861,884,12,176,188,0.9728813559322034,23.311586334816184
Task_45601,1921,987,149,99,248,1.944331983805668,40.70605167273836
Task_45602,2483,499,49,164,213,4.966,48.112108766887815
Task_45603,603,668,47,76,123,0.9013452914798207,17.957392536547413
Task_45604,715,963,172,42,214,0.741701244813278,20.81188331322325
Task_45605,734,177,68,80,148,4.123595505617978,18.458056405220013
Task_45606,1370,663,54,126,180,2.0632530120481927,30.75064870326789
Task_45607,2603,509,96,57,153,5.103921568627451,49.0664715935753
Task_45608,2013,964,154,25,179,2.0860103626943007,41.12004987515121
Task_45609,2674,805,139,16,155,3.3176178660049627,50.83485599946112
Task_45610,860,274,55,33,88,3.1272727272727274,19.80379625255932
Task_45611,1798,819,81,93,174,2.1926829268292685,37.914298387516915
Task_45612,2496,315,67,44,111,7.89873417721519,46.11068360385597
Task_45613,1028,603,113,68,181,1.7019867549668874,24.70163932811821
Task_45614,1789,682,150,177,327,2.6193265007320643,38.13989863096318
Task_45615,1509,783,29,103,132,1.9247448979591837,32.887325996525014
Task_45616,2383,542,112,96,208,4.388581952117864,46.477198140093584
Task_45617,2210,190,57,48,105,11.570680628272251,41.16440963820265
Task_45618,1642,511,136,44,180,3.20703125,33.89152187816813
Task_45619,2202,164,19,125,144,13.345454545454546,41.404490655728225
Task_45620,588,477,78,146,224,1.2301255230125523,17.96518289731068
Task_45621,2867,585,168,25,193,4.892491467576792,53.53103665055982
Task_45622,2003,210,176,88,264,9.492890995260664,39.5011697321607
Task_45623,2487,137,83,30,113,18.02173913043478,45.02711490144907
Task_45624,2928,288,83,123,206,10.131487889273357,54.288744080372915
Task_45625,959,363,123,72,195,2.6346153846153846,23.02110485348631
Task_45626,1622,778,56,117,173,2.0821566110397947,35.050020290579305
Task_45627,946,126,139,148,287,7.448818897637795,22.493982638525452
Task_45628,1150,104,63,25,88,10.952380952380953,23.31366360374767
Task_45629,1123,899,167,41,208,1.2477777777777779,27.025134879062136
Task_45630,2062,916,19,22,41,2.248636859323882,40.34423302599168
Task_45631,2359,334,184,132,316,7.04179104477612,45.92625508685353
Task_45632,2911,76,174,175,349,37.8051948051948,53.238706801493485
Task_45633,1051,731,143,56,199,1.435792349726776,25.529186871691625
Task_45634,1682,124,30,37,67,13.456,31.74269972538983
Task_45635,575,941,26,54,80,0.6104033970276008,17.820916258167504
Task_45636,1497,499,121,121,242,2.994,32.47407474810036
Task_45637,1759,896,192,83,275,1.9609810479375698,37.88845002194364
Task_45638,2412,280,180,39,219,8.583629893238435,45.49197411806995
Task_45639,1596,157,157,25,182,10.10126582278481,31.731128238640917
Task_45640,2950,955,44,193,237,3.085774058577406,57.02330309646779
Task_45641,922,171,96,104,200,5.3604651162790695,21.912587578004647
Task_45642,2533,438,51,109,160,5.769931662870159,48.19271439934229
Task_45643,1642,874,43,50,93,1.8765714285714286,34.34328555808762
Task_45644,1878,68,177,137,314,27.217391304347824,36.83646769423092
Task_45645,2179,228,144,46,190,9.51528384279476,41.50146041391315
Task_45646,2451,262,154,159,313,9.319391634980988,47.15439717195428
Task_45647,1229,418,105,21,126,2.9331742243436754,26.579621036756905
Task_45648,1118,836,179,101,280,1.3357228195937874,27.619700120365167
Task_45649,2063,197,29,161,190,10.419191919191919,40.273179708369135
Task_45650,1680,424,80,117,197,3.9529411764705884,34.97582727014268
Task_45651,2567,348,120,193,313,7.355300859598854,49.33973032876613
Task_45652,1543,1002,197,151,348,1.538384845463609,35.252628715136545
Task_45653,2483,247,11,140,151,10.012096774193548,46.59773670072665
Task_45654,1505,450,147,132,279,3.337028824833703,32.62776620154134
Task_45655,1275,849,69,169,238,1.5,30.13883965378527
Task_45656,2129,898,22,86,108,2.368186874304783,42.74098023320985
Task_45657,2893,317,95,115,210,9.09748427672956,53.81995699642036
Task_45658,1555,868,30,167,197,1.7894131185270425,34.41573522582695
Task_45659,2248,668,83,150,233,3.3602391629297457,44.93860400881334
Task_45660,1648,614,98,136,234,2.6796747967479675,35.218149509532864
Task_45661,2590,999,128,10,138,2.59,50.00032346202462
Task_45662,2255,985,26,109,135,2.287018255578093,45.28680546201351
Task_45663,652,116,116,178,294,5.572649572649572,17.845942796704396
Task_45664,2058,802,147,38,185,2.5628891656288917,41.42178145822722
Task_45665,2262,878,175,144,319,2.573378839590444,46.162067123089365
Task_45666,1362,900,194,30,224,1.51165371809101,30.87075420667651
Task_45667,2910,344,170,53,223,8.434782608695652,53.88859673634394
Task_45668,2452,830,16,41,57,2.950661853188929,46.50982287222326
Task_45669,2739,893,116,45,161,3.063758389261745,52.26823091658059
Task_45670,1605,261,127,60,187,6.125954198473282,32.72571581547777
Task_45671,1112,510,138,23,161,2.176125244618395,25.261541902228103
Task_45672,1161,831,143,53,196,1.3954326923076923,27.61820604929306
Task_45673,2574,397,129,22,151,6.467336683417085,47.96519264297066
Task_45674,2590,488,24,146,170,5.296523517382413,49.39705065297574
Task_45675,741,364,53,170,223,2.03013698630137,20.14005145792154
Task_45676,2354,96,184,175,359,24.2680412371134,44.67152196153796
Task_45677,2374,500,42,169,211,4.738522954091817,46.30863693947868
Task_45678,1495,277,185,18,203,5.377697841726619,30.816724382880228
Task_45679,2666,930,141,116,257,2.8635875402792696,52.405497171130115
Task_45680,2245,744,45,164,209,3.0134228187919465,45.034994786704225
Task_45681,2556,598,47,83,130,4.267111853088481,48.92119238892398
Task_45682,740,900,22,195,217,0.8213096559378469,21.619005664379632
Task_45683,1744,556,12,160,172,3.1310592459605027,36.24263879610734
Task_45684,1237,868,140,185,325,1.4234752589182968,29.923382826738262
Task_45685,2406,965,140,197,337,2.4906832298136647,48.87399086980196
Task_45686,2142,297,129,128,257,7.1879194630872485,42.09616120434695
Task_45687,524,948,177,199,376,0.5521601685985248,19.222720068064444
Task_45688,2109,902,89,88,177,2.335548172757475,42.990003766299964
Task_45689,2143,274,86,76,162,7.792727272727273,41.24686692512567
Task_45690,731,254,120,148,268,2.8666666666666667,19.72847777543769
Task_45691,2873,743,49,15,64,3.861559139784946,52.65833648841374
Task_45692,611,167,18,150,168,3.636904761904762,16.710447401564323
Task_45693,852,310,106,18,124,2.739549839228296,20.152182816267388
Task_45694,2747,781,23,151,174,3.5127877237851663,52.86443113308184
Task_45695,1028,258,179,126,305,3.969111969111969,24.569177066758954
Task_45696,1033,865,161,29,190,1.1928406466512702,25.406578618104035
Task_45697,1994,424,57,169,226,4.691764705882353,40.165182909163256
Task_45698,998,64,114,146,260,15.353846153846154,22.86970606163568
Task_45699,898,771,196,138,334,1.1632124352331605,24.208406428733614
Task_45700,612,91,40,41,81,6.6521739130434785,14.828558124554073
Task_45701,1857,569,149,84,233,3.2578947368421054,38.22639625820912
Task_45702,2104,532,94,65,159,3.947467166979362,41.3375381749569
Task_45703,1599,733,65,167,232,2.178474114441417,34.916682282832745
Task_45704,2878,475,16,44,60,6.046218487394958,52.080551433090534
Task_45705,2640,893,26,118,144,2.953020134228188,51.16330447339078
Task_45706,1283,559,163,119,282,2.2910714285714286,29.4523856518741
Task_45707,1555,577,20,90,110,2.690311418685121,32.68468504122492
Task_45708,1280,592,54,116,170,2.1585160202360876,29.02103319221693
Task_45709,582,325,195,28,223,1.7852760736196318,16.712671760071746
Task_45710,1705,119,65,144,209,14.208333333333334,34.106226352425026
Task_45711,2177,386,100,175,275,5.625322997416021,43.099698634189956
Task_45712,696,370,106,20,126,1.876010781671159,17.992550158432188
Task_45713,757,708,77,119,196,1.0677009873060648,21.157600011784087
Task_45714,1619,77,38,182,220,20.756410256410255,32.435567727220835
Task_45715,1409,478,40,196,236,2.941544885177453,31.107169143310525
Task_45716,669,1000,96,69,165,0.6683316683316683,20.40749216386985
Task_45717,1499,119,70,139,209,12.491666666666667,30.859063184721148
Task_45718,1226,906,176,45,221,1.3517089305402425,28.72454688375276
Task_45719,678,454,116,151,267,1.4901098901098901,19.48168082363713
Task_45720,2955,894,167,86,253,3.3016759776536313,56.74389423981925
Task_45721,2574,319,139,43,182,8.04375,48.0097917419563
Task_45722,2507,198,138,11,149,12.597989949748744,46.22108014479968
Task_45723,2517,852,169,116,285,2.950762016412661,49.92688563411971
Task_45724,2272,570,124,142,266,3.978984238178634,45.10952438196289
Task_45725,2533,879,15,111,126,2.878409090909091,49.38980056849096
Task_45726,1507,222,23,120,143,6.757847533632287,31.067491966606074
Task_45727,2442,924,84,190,274,2.64,49.03227832773822
Task_45728,2793,641,162,176,338,4.350467289719626,53.96088503831182
Task_45729,1899,917,142,24,166,2.0686274509803924,39.122086845798265
Task_45730,1275,963,18,164,182,1.3226141078838174,30.088590460649595
Task_45731,2302,1018,169,41,210,2.2590775269872423,46.0781717044861
Task_45732,1771,150,186,104,290,11.728476821192054,35.621977270485594
Task_45733,2599,276,199,132,331,9.382671480144404,49.58569516806699
Task_45734,2438,552,159,188,347,4.4086799276672695,48.113125145569576
Task_45735,1196,959,125,40,165,1.2458333333333333,28.18432710942437
Task_45736,2872,492,101,16,117,5.825557809330629,52.60572111064662
Task_45737,2791,331,51,138,189,8.406626506024097,52.279745631112355
Task_45738,2139,241,58,78,136,8.838842975206612,41.09236108636131
Task_45739,1208,296,51,86,137,4.0673400673400675,26.64298482186038
Task_45740,580,249,34,117,151,2.32,16.56266159908035
Task_45741,2519,850,165,34,199,2.9600470035252644,48.935784102144844
Task_45742,802,724,144,15,159,1.1062068965517242,20.927213068647553
Task_45743,1509,89,80,35,115,16.766666666666666,29.11784559938366
Task_45744,763,245,137,133,270,3.1016260162601625,20.191733912431335
Task_45745,1839,82,39,31,70,22.156626506024097,33.759736816173096
Task_45746,2455,92,155,92,247,26.397849462365592,45.52190890152823
Task_45747,604,718,145,132,277,0.8400556328233658,19.159793572542068
Task_45748,1237,497,176,55,231,2.4839357429718874,27.900371540929267
Task_45749,1818,465,112,198,310,3.9012875536480687,37.866529797048976
Task_45750,564,691,13,146,159,0.815028901734104,17.705948924075745
Task_45751,2766,364,43,35,78,7.578082191780822,50.070735378308115
Task_45752,2439,260,145,49,194,9.344827586206897,45.83885751016646
Task_45753,2595,1006,20,151,171,2.576961271102284,51.11171351946003
Task_45754,2650,94,53,42,95,27.894736842105264,46.74105831263096
Task_45755,936,169,24,71,95,5.5058823529411764,20.920284466442762
Task_45756,2074,948,70,125,195,2.185458377239199,42.88696936547038
Task_45757,1384,296,119,188,307,4.65993265993266,30.422213649837087
Task_45758,581,792,182,155,337,0.7326607818411097,19.367253987088606
Task_45759,2131,348,159,113,272,6.106017191977077,42.141169411813316
Task_45760,1286,759,135,13,148,1.6921052631578948,28.6886561176477
Task_45761,2108,120,182,178,360,17.421487603305785,41.120035418968016
Task_45762,2358,772,198,16,214,3.0504527813712805,46.10464278562168
Task_45763,2635,856,177,27,204,3.074679113185531,50.78598545809058
Task_45764,1246,723,54,180,234,1.7209944751381216,29.308486518622903
Task_45765,2034,546,123,148,271,3.7184643510054847,41.29580666698481
Task_45766,2273,473,109,174,283,4.79535864978903,44.937745541884475
Task_45767,1518,169,111,123,234,8.929411764705883,31.469164063808794
Task_45768,2727,914,124,26,150,2.980327868852459,52.068261743884314
Task_45769,2117,338,26,188,214,6.244837758112094,41.72033233848044
Task_45770,2743,377,81,181,262,7.256613756613756,52.0281708247968
Task_45771,2277,987,147,81,228,2.304655870445344,46.132836337729316
Task_45772,2537,86,149,111,260,29.160919540229884,46.97182282413697
Task_45773,1428,719,170,121,291,1.9833333333333334,32.2928975816727
Task_45774,2232,770,58,123,181,2.894941634241245,44.728241974575845
Task_45775,1084,758,193,107,300,1.4281949934123848,26.930989927005484
Task_45776,1879,243,102,75,177,7.700819672131147,37.10815985152381
Task_45777,2343,871,111,170,281,2.686926605504587,47.29048071348581
Task_45778,2516,181,29,199,228,13.824175824175825,47.26385774273245
Task_45779,1510,401,59,24,83,3.756218905472637,30.434344676075742
Task_45780,509,726,35,181,216,0.7001375515818432,17.583445756756348
Task_45781,1889,111,154,35,189,16.866071428571427,35.98776149952476
Task_45782,2261,913,95,138,233,2.473741794310722,45.869309332857675
Task_45783,1687,154,63,38,101,10.883870967741936,32.27524553043434
Task_45784,1789,529,160,116,276,3.3754716981132074,37.33817193396923
Task_45785,931,273,123,12,135,3.397810218978102,21.432280787567993
Task_45786,2628,986,119,132,251,2.662613981762918,51.97451231158342
Task_45787,1218,561,22,35,57,2.167259786476868,26.078332586568937
Task_45788,2458,289,97,16,113,8.475862068965517,45.39469596202134
Task_45789,1585,784,96,44,140,2.0191082802547773,33.53504947759942
Task_45790,1872,187,184,90,274,9.957446808510639,37.490747754589734
Task_45791,1390,823,132,57,189,1.6868932038834952,31.1356230601385
Task_45792,2246,224,68,139,207,9.982222222222223,43.34132477127097
Task_45793,2021,347,103,122,225,5.807471264367816,40.199250451940316
Task_45794,2182,930,69,59,128,2.343716433941998,43.84840798880538
Task_45795,941,79,111,34,145,11.7625,20.390554297225755
Task_45796,2180,904,74,145,219,2.408839779005525,44.5551944306423
Task_45797,1595,551,42,165,207,2.8894927536231885,34.11360472599645
Task_45798,709,807,113,56,169,0.8774752475247525,20.233891900523208
Task_45799,941,257,14,14,28,3.647286821705426,20.34178570745056
Task_45800,1639,812,36,120,156,2.015990159901599,35.15050189859713
Task_45801,2928,755,70,138,208,3.873015873015873,55.89129695932474
Task_45802,515,215,105,116,221,2.384259259259259,15.931031460635461
Task_45803,1063,888,111,115,226,1.1957255343082114,26.67370112121273
Task_45804,569,820,105,90,195,0.6930572472594397,18.575114089718802
Task_45805,1360,728,166,92,258,1.8655692729766804,31.00072156661534
Task_45806,922,342,133,12,145,2.688046647230321,21.646995022715554
Task_45807,771,497,121,156,277,1.5481927710843373,21.140647954983525
Task_45808,1895,526,55,152,207,3.5958254269449714,38.81831000810214
Task_45809,968,150,17,134,151,6.410596026490066,21.88637595594807
Task_45810,2974,774,43,152,195,3.8374193548387097,56.58612321821147
Task_45811,2738,767,58,149,207,3.5651041666666665,52.92811371409852
Task_45812,516,349,32,138,170,1.4742857142857142,16.079123482988063
Task_45813,2497,858,15,10,25,2.9068684516880094,46.87218572561102
Task_45814,1980,860,111,134,245,2.299651567944251,41.289535327866545
Task_45815,1984,671,177,164,341,2.9523809523809526,41.23810791962086
Task_45816,1480,337,24,40,64,4.378698224852071,29.487725016726085
Task_45817,2418,604,82,102,184,3.996694214876033,47.10580934704233
Task_45818,2887,581,19,26,45,4.9604810996563575,52.42998483392057
Task_45819,575,669,139,112,251,0.8582089552238806,18.403006948888414
Task_45820,1140,739,108,35,143,1.5405405405405406,26.362929290817718
Task_45821,1009,132,26,185,211,7.586466165413534,23.174803034387022
Task_45822,2921,787,16,16,32,3.7068527918781724,53.38899507524969
Task_45823,1362,64,167,33,200,20.953846153846154,27.291425970388747
Task_45824,1469,672,128,72,200,2.1827637444279344,32.09304364195923
Task_45825,1087,147,24,20,44,7.344594594594595,22.336311809532702
Task_45826,2237,946,76,61,137,2.362196409714889,44.651863615245894
Task_45827,590,437,197,54,251,1.3470319634703196,17.56081371406684
Task_45828,1309,541,97,164,261,2.415129151291513,29.786517426785057
Task_45829,2865,467,172,60,232,6.121794871794871,53.56847927409583
Task_45830,2054,912,139,81,220,2.249726177437021,42.329588917670044
Task_45831,2875,280,181,165,346,10.231316725978647,54.07874116231807
Task_45832,2181,627,129,49,178,3.4729299363057327,42.88442732981122
Task_45833,1523,560,126,55,181,2.714795008912656,32.37715685351932
Task_45834,998,68,199,192,391,14.46376811594203,23.50569681015463
Task_45835,881,997,59,113,172,0.8827655310621243,23.918188524047874
Task_45836,2513,926,35,38,73,2.7108953613807985,47.767364277443704
Task_45837,2962,322,99,173,272,9.170278637770897,55.28456975341103
Task_45838,1596,761,11,97,108,2.094488188976378,33.86526673718745
Task_45839,678,320,126,124,250,2.1121495327102804,18.986300225353148
Task_45840,2871,86,22,148,170,33.0,51.73773344770685
Task_45841,1858,284,167,166,333,6.519298245614035,37.95992159362167
Task_45842,2697,809,142,31,173,3.3296296296296295,51.4942469458934
Task_45843,2597,1013,48,183,231,2.5611439842209074,51.611868660287094
Task_45844,1027,104,18,171,189,9.780952380952382,23.109967740317973
Task_45845,2462,685,190,87,277,3.5889212827988337,48.390838839941544
Task_45846,2240,614,31,139,170,3.6422764227642275,44.25838370566303
Task_45847,1130,357,169,90,259,3.1564245810055866,26.212609852526686
Task_45848,2005,326,106,73,179,6.131498470948012,39.339564953741395
Task_45849,1271,557,111,63,174,2.2777777777777777,28.37757070129108
Task_45850,1135,763,137,37,174,1.4856020942408377,26.629049800539494
Task_45851,1120,568,191,104,295,1.968365553602812,26.9361169184529
Task_45852,1897,115,138,169,307,16.353448275862068,37.4626350598087
Task_45853,2014,624,160,65,225,3.2224,40.63552131732239
Task_45854,2688,670,33,64,97,4.0059612518628915,50.533830743972565
Task_45855,1313,671,76,163,239,1.9538690476190477,30.215665400463
Task_45856,595,1013,199,171,370,0.5867850098619329,20.532535148179957
Task_45857,2083,941,165,22,187,2.2112526539278132,42.16557328042672
Task_45858,831,612,156,33,189,1.3556280587275693,21.40608416738712
Task_45859,2538,902,30,118,148,2.8106312292358804,49.61626636880678
Task_45860,2251,436,133,143,276,5.151029748283753,44.39238130895731
Task_45861,844,147,153,196,349,5.702702702702703,21.408576993816723
Task_45862,1607,316,196,192,388,5.069400630914826,34.38560964401564
Task_45863,1548,149,150,73,223,10.32,31.464604173560218
Task_45864,1088,129,107,69,176,8.36923076923077,23.716654724058525
Task_45865,1480,816,193,33,226,1.8115055079559363,32.488107124533265
Task_45866,1131,975,180,151,331,1.158811475409836,28.537425565429768
Task_45867,2841,66,49,81,130,42.40298507462686,50.483652706064724
Task_45868,1405,362,60,28,88,3.8705234159779613,28.701358021146575
Task_45869,1748,958,133,145,278,1.8227320125130344,38.083131601421556
Task_45870,2026,400,186,62,248,5.052369077306733,40.149262272405814
Task_45871,1922,946,33,121,154,2.0295670538542767,39.99525709883807
Task_45872,1847,526,23,30,53,3.504743833017078,35.89123851576266
Task_45873,2873,560,65,163,228,5.121212121212121,54.5235802392771
Task_45874,1516,227,91,155,246,6.649122807017544,31.948615120287652
Task_45875,2394,443,113,181,294,5.391891891891892,46.81532485738584
Task_45876,2824,980,151,57,208,2.8786952089704383,54.445572121393774
Task_45877,1922,325,120,193,313,5.895705521472393,39.060487910856324
Task_45878,688,439,107,45,152,1.5636363636363637,18.255111733664176
Task_45879,2809,598,51,60,111,4.689482470784641,52.285584271976624
Task_45880,2167,617,39,43,82,3.5064724919093853,41.66023216946936
Task_45881,1869,1016,145,171,316,1.8377581120943953,40.390047504423464
Task_45882,616,907,19,105,124,0.6784140969162996,19.101690095550136
Task_45883,648,975,42,127,169,0.6639344262295082,20.235798417576518
Task_45884,2847,592,171,113,284,4.801011804384486,54.32395167299069
Task_45885,2219,189,123,64,187,11.678947368421053,42.27952746379485
Task_45886,2337,119,36,99,135,19.475,43.130528239637755
Task_45887,1913,370,157,22,179,5.15633423180593,37.63300477876405
Task_45888,2887,304,58,181,239,9.465573770491803,53.965975698715425
Task_45889,1894,458,124,40,164,4.126361655773421,37.65226827360799
Task_45890,1396,536,60,170,230,2.5996275605214154,31.079055811853152
Task_45891,1124,126,61,83,144,8.850393700787402,24.22911578930046
Task_45892,1279,293,38,158,196,4.350340136054422,28.217885888201128
Task_45893,2252,259,70,64,134,8.661538461538461,42.78896727280045
Task_45894,1433,355,77,68,145,4.025280898876405,30.224045229293296
Task_45895,2795,644,47,54,101,4.333333333333333,52.0224047924423
Task_45896,2549,483,130,42,172,5.266528925619835,48.11510065652933
Task_45897,1927,458,40,134,174,4.198257080610022,38.84667335638152
Task_45898,2539,733,178,193,371,3.4591280653950953,50.40236796722297
Task_45899,1618,220,144,153,297,7.321266968325792,33.76209077546983
Task_45900,1263,551,80,89,169,2.2880434782608696,28.530938833925713
Task_45901,1386,306,178,136,314,4.514657980456026,30.442303558978946
Task_45902,1331,66,57,111,168,19.865671641791046,27.519643493654346
Task_45903,2421,527,130,102,232,4.5852272727272725,47.11941258060506
Task_45904,1632,593,167,83,250,2.7474747474747474,34.81696194787532
Task_45905,1369,826,87,97,184,1.6553808948004838,31.124033451955242
Task_45906,1024,438,166,65,231,2.3325740318906605,24.400398438462172
Task_45907,2194,189,37,157,194,11.547368421052632,42.27959849632972
Task_45908,994,732,122,180,302,1.3560709413369714,25.547512355628005
Task_45909,610,233,164,56,220,2.606837606837607,17.09158989040088
Task_45910,888,296,76,45,121,2.98989898989899,20.69206317181584
Task_45911,2694,983,141,190,331,2.7378048780487805,53.456632583657495
Task_45912,2349,852,131,92,223,2.753810082063306,46.89862482492782
Task_45913,2036,511,91,90,181,3.9765625,40.66425437881996
Task_45914,903,370,161,88,249,2.4339622641509435,22.587723274948445
Task_45915,920,647,111,174,285,1.4197530864197532,24.018864273234716
Task_45916,2226,838,81,146,227,2.6531585220500595,45.1083179486448
Task_45917,2791,686,123,95,218,4.0625909752547305,53.42597996218176
Task_45918,1014,954,38,54,92,1.0617801047120419,24.744423877239218
Task_45919,1016,407,72,108,180,2.4901960784313726,24.304728978254072
Task_45920,1515,718,147,189,336,2.1070931849791377,33.97043389340585
Task_45921,2303,68,145,151,296,33.3768115942029,43.42056393726535
Task_45922,747,885,41,168,209,0.8431151241534989,21.63519516708725
Task_45923,2347,948,40,148,188,2.4731296101159117,47.139049908141466
Task_45924,613,262,44,32,76,2.3307984790874525,15.594733842859858
Task_45925,1289,1011,85,196,281,1.273715415019763,30.993360509122017
Task_45926,1158,848,182,193,375,1.3639575971731448,28.85370566678071
Task_45927,2327,169,124,42,166,13.688235294117646,43.263079986334326
Task_45928,1467,282,80,104,184,5.18374558303887,31.025528628144702
Task_45929,834,533,97,115,212,1.5617977528089888,21.905136534175824
Task_45930,2305,778,19,170,189,2.958921694480103,45.964781724592484
Task_45931,1248,668,41,19,60,1.8654708520179373,26.748492075071994
Task_45932,2866,953,125,48,173,3.0041928721174003,54.663789467776205
Task_45933,1985,961,96,47,143,2.0634095634095635,40.494528804319806
Task_45934,755,151,118,148,266,4.967105263157895,19.57126080009091
Task_45935,2666,414,107,130,237,6.424096385542168,50.69289612418353
Task_45936,1580,385,105,16,121,4.0932642487046635,31.844017099965367
Task_45937,2491,171,135,10,145,14.482558139534884,45.57005202211528
Task_45938,2839,624,155,139,294,4.5424,54.382719121255754
Task_45939,1622,338,75,83,158,4.784660766961652,33.37465637539898
Task_45940,709,1017,63,13,76,0.6964636542239686,19.6188925067362
Task_45941,1148,974,153,34,187,1.1774358974358974,27.544462974126855
Task_45942,591,192,59,56,115,3.062176165803109,15.973690405760449
Task_45943,1732,866,123,86,209,1.9976931949250287,37.079831277722526
Task_45944,2810,602,28,158,186,4.660033167495854,53.35457786951213
Task_45945,1331,509,37,144,181,2.6098039215686275,29.62615699825497
Task_45946,1167,80,189,26,215,14.407407407407407,24.45068358420842
Task_45947,940,181,173,67,240,5.164835164835165,22.125541467281593
Task_45948,1674,270,66,117,183,6.177121771217712,34.29524108574613
Task_45949,1716,441,117,67,184,3.8823529411764706,35.10508881269288
Task_45950,1624,333,77,131,208,4.862275449101796,33.87707169073562
Task_45951,1947,698,177,38,215,2.7854077253218885,39.48660336868233
Task_45952,2840,594,133,58,191,4.773109243697479,53.40700829568565
Task_45953,759,627,111,30,141,1.2085987261146496,19.971298222424178
Task_45954,2380,209,197,130,327,11.333333333333334,45.85402161694583
Task_45955,2143,572,50,181,231,3.7399650959860384,43.07073861052297
Task_45956,1696,544,179,169,348,3.1119266055045873,36.31541643453392
Task_45957,2928,831,111,69,180,3.519230769230769,55.52534850403589
Task_45958,1235,561,27,70,97,2.197508896797153,27.1747693063995
Task_45959,1517,741,71,146,217,2.0444743935309972,33.53444891737821
Task_45960,1767,553,179,94,273,3.1895306859205776,37.0135213867189
Task_45961,787,787,199,133,332,0.998730964467005,22.504710852429493
Task_45962,1260,286,199,163,362,4.390243902439025,28.63996288553619
Task_45963,900,544,199,96,295,1.651376146788991,23.38064237924536
Task_45964,2032,860,146,77,223,2.3600464576074334,41.76455128622195
Task_45965,859,255,188,70,258,3.35546875,21.317153703534494
Task_45966,1943,460,99,154,253,4.214750542299349,39.50935086071061
Task_45967,1509,963,177,16,193,1.5653526970954357,33.114931213300586
Task_45968,873,641,75,53,128,1.3598130841121496,22.206448087498057
Task_45969,2448,408,19,44,63,5.985330073349633,45.06627021737874
Task_45970,1895,549,115,99,214,3.4454545454545453,38.7697049720052
Task_45971,627,422,150,108,258,1.4822695035460993,18.470791774092927
Task_45972,3000,709,54,89,143,4.225352112676056,56.35495689320903
Task_45973,2308,139,37,78,115,16.485714285714284,42.57897297138502
Task_45974,2527,438,180,45,225,5.75626423690205,47.8672799808484
Task_45975,1927,126,129,188,317,15.173228346456693,38.12759277815363
Task_45976,1949,530,44,135,179,3.670433145009416,39.45617868505818
Task_45977,1815,947,182,71,253,1.9145569620253164,38.64736612776314
Task_45978,963,653,53,54,107,1.4724770642201834,22.99541662083767
Task_45979,2739,908,123,44,167,3.0132013201320134,52.45103985559561
Task_45980,2014,803,31,55,86,2.5049751243781095,40.034362212613814
Task_45981,2090,241,43,42,85,8.636363636363637,39.23290954218074
Task_45982,1624,612,163,165,328,2.6492659053833605,35.29370576304505
Task_45983,1783,700,29,103,132,2.543509272467903,36.96872246077694
Task_45984,2186,824,40,19,59,2.64969696969697,42.07634486701141
Task_45985,1169,887,102,184,286,1.3164414414414414,28.734564165471724
Task_45986,2239,859,37,113,150,2.603488372093023,44.75678629682534
Task_45987,2173,409,59,115,174,5.3,42.61306893196477
Task_45988,969,895,55,149,204,1.0814732142857142,25.178676796212454
Task_45989,1197,385,154,106,260,3.1010362694300517,27.42209713033135
Task_45990,1240,291,65,37,102,4.2465753424657535,26.057298945196155
Task_45991,691,901,16,54,70,0.7660753880266076,19.110256154109695
Task_45992,2153,577,170,108,278,3.7249134948096887,43.251626994773424
Task_45993,2269,426,25,193,218,5.313817330210773,44.442128136530165
Task_45994,2263,223,23,146,169,10.102678571428571,43.31475638717785
Task_45995,664,893,109,130,239,0.7427293064876958,20.449486770989903
Task_45996,2911,882,83,175,258,3.2967157417893547,56.26408907686966
Task_45997,826,896,63,111,174,0.9208472686733556,22.71983181583623
Task_45998,2727,250,10,54,64,10.864541832669323,49.10853703715569
Task_45999,1943,574,194,45,239,3.3791304347826085,39.12220576091498
Task_46000,1806,590,164,83,247,3.0558375634517767,37.54948179151329
Task_46001,1788,526,85,98,183,3.3927893738140416,36.84426209001576
Task_46002,2224,67,115,36,151,32.705882352941174,40.30018849556115
Task_46003,2773,877,176,76,252,3.1583143507972666,53.682361302667914
Task_46004,543,739,186,39,225,0.7337837837837838,17.530534763942402
Task_46005,2308,521,57,15,72,4.421455938697318,42.98922288178766
Task_46006,2680,886,45,179,224,3.0214205186020293,52.46148084251907
Task_46007,2110,563,159,50,209,3.7411347517730498,41.70089288169004
Task_46008,2098,347,74,173,247,6.028735632183908,41.651680041867
Task_46009,1343,505,69,152,221,2.6541501976284585,30.07824945186201
Task_46010,1020,824,33,34,67,1.2363636363636363,23.781764011997435
Task_46011,2153,735,162,74,236,2.9252717391304346,43.33262381973907
Task_46012,1534,161,154,164,318,9.469135802469136,32.13938490015634
Task_46013,2899,459,22,68,90,6.302173913043478,53.14437635384547
Task_46014,1293,358,113,31,144,3.6016713091922004,27.60298087525482
Task_46015,2125,862,17,22,39,2.46234067207416,41.120812349896006
Task_46016,2134,464,65,127,192,4.589247311827957,42.29909870325435
Task_46017,2175,655,143,41,184,3.3155487804878048,42.79441700860659
Task_46018,2010,549,160,182,342,3.6545454545454548,41.29517509043398
Task_46019,597,748,85,29,114,0.7970627503337784,17.587966012091556
Task_46020,664,241,127,189,316,2.743801652892562,18.904066891677367
Task_46021,2453,712,68,39,107,3.44039270687237,46.682743052209105
Task_46022,637,182,199,32,231,3.480874316939891,17.16069048552235
Task_46023,2392,160,188,164,352,14.857142857142858,45.8236579310242
Task_46024,1901,382,43,163,206,4.9634464751958225,38.40777244935366
Task_46025,1949,104,23,30,53,18.561904761904763,35.780431854708
Task_46026,972,873,161,34,195,1.1121281464530892,24.47334509178587
Task_46027,2326,306,32,73,105,7.576547231270358,43.78612045862564
Task_46028,1251,363,192,94,286,3.4368131868131866,28.298697040116622
Task_46029,986,727,54,163,217,1.3543956043956045,25.05949609500978
Task_46030,2905,931,170,155,325,3.116952789699571,56.55943663684169
Task_46031,1878,572,86,109,195,3.277486910994764,38.46868067777469
Task_46032,556,550,20,89,109,1.0090744101633393,16.67850618070015
Task_46033,1190,182,175,73,248,6.502732240437158,26.28776394078567
Task_46034,2735,66,60,53,113,40.82089552238806,48.35217423563841
Task_46035,1016,646,94,181,275,1.5703245749613601,25.52689419297518
Task_46036,941,611,125,29,154,1.5375816993464053,22.837130719722467
Task_46037,2097,91,165,51,216,22.793478260869566,39.265175497699886
Task_46038,1072,164,43,152,195,6.496969696969697,24.25762235046591
Task_46039,1235,948,181,88,269,1.3013698630136987,29.682661561449404
Task_46040,2802,126,56,146,202,22.062992125984252,51.355971275377385
Task_46041,1837,253,43,46,89,7.232283464566929,35.303937647151955
Task_46042,1504,965,155,30,185,1.556935817805383,33.129712131518765
Task_46043,2114,249,48,121,169,8.456,41.08920877258713
Task_46044,1772,136,144,113,257,12.934306569343066,35.37206458233705
Task_46045,2294,108,105,179,284,21.045871559633028,43.542803257216626
Task_46046,2017,262,192,154,346,7.669201520912548,40.43733921782234
Task_46047,2389,874,86,170,256,2.7302857142857144,47.876304537456754
Task_46048,791,400,94,49,143,1.972568578553616,19.94653033835712
Task_46049,2934,599,20,168,188,4.89,55.343679058987306
Task_46050,2396,496,159,131,290,4.82092555331992,46.92771479526726
Task_46051,2868,126,104,162,266,22.58267716535433,52.66982923967644
Task_46052,2076,130,110,44,154,15.84732824427481,38.748630244252
Task_46053,1171,738,83,168,251,1.584573748308525,28.160955459305967
Task_46054,2072,561,151,111,262,3.6868327402135233,41.85041969676461
Task_46055,2172,342,83,18,101,6.332361516034985,40.892174708396404
Task_46056,1640,568,24,36,60,2.882249560632689,32.73533294891245
Task_46057,954,548,58,144,202,1.7377049180327868,23.940888571993185
Task_46058,1641,912,187,126,313,1.7973713033953997,36.37463958282475
Task_46059,2647,433,187,61,248,6.099078341013825,50.0747757413981
Task_46060,2693,415,177,16,193,6.4735576923076925,50.17219809343931
Task_46061,2490,908,153,67,220,2.7392739273927393,49.03466626088048
Task_46062,2523,296,150,73,223,8.494949494949495,47.65250354108817
Task_46063,2430,563,175,51,226,4.308510638297872,46.96149283921116
Task_46064,2986,743,46,30,76,4.013440860215054,54.667691585707956
Task_46065,2238,293,20,144,164,7.612244897959184,43.14286165121274
Task_46066,2993,428,177,56,233,6.976689976689976,55.48207627074452
Task_46067,989,986,75,81,156,1.0020263424518743,25.269356719353947
Task_46068,2507,203,155,91,246,12.28921568627451,47.357909413856156
Task_46069,1121,74,143,109,252,14.946666666666667,24.706227476332057
Task_46070,2543,736,94,11,105,3.4504748982360924,48.15640905066877
Task_46071,1651,823,172,52,224,2.003640776699029,35.48693502874599
Task_46072,1594,725,57,18,75,2.1955922865013773,32.372611729500896
Task_46073,2575,828,124,172,296,3.106151990349819,50.902337528735835
Task_46074,2819,72,83,116,199,38.61643835616438,51.06745559846695
Task_46075,915,855,196,103,299,1.0689252336448598,24.530449425296684
Task_46076,786,325,13,156,169,2.411042944785276,20.323495498112575
Task_46077,876,911,71,86,157,0.9605263157894737,23.310730787522697
Task_46078,2074,348,15,182,197,5.9426934097421205,40.986282323248744
Task_46079,584,479,156,185,341,1.2166666666666666,18.433413169561845
Task_46080,2576,876,70,92,162,2.937286202964652,50.27866797931177
Task_46081,1405,167,183,81,264,8.363095238095237,29.614334545895293
Task_46082,1397,561,118,85,203,2.48576512455516,30.780905937576303
Task_46083,2492,627,112,27,139,3.968152866242038,47.357442034323434
Task_46084,1348,608,192,179,371,2.213464696223317,31.124466818218767
Task_46085,718,959,19,176,195,0.7479166666666667,21.36020207267889
Task_46086,2152,750,83,106,189,2.8655126498002663,43.4098571826291
Task_46087,1875,473,135,64,199,3.9556962025316458,37.8208302619742
Task_46088,1636,638,84,79,163,2.560250391236307,34.60335308580178
Task_46089,655,537,12,29,41,1.2174721189591078,17.007244618832498
Task_46090,2887,655,100,183,283,4.400914634146342,55.25662005371007
Task_46091,1657,704,197,186,383,2.350354609929078,36.38349588693088
Task_46092,1041,695,200,16,216,1.4956896551724137,24.97169696546072
Task_46093,1833,107,28,74,102,16.97222222222222,34.58078980774315
Task_46094,2658,131,73,197,270,20.136363636363637,49.5444084014955
Task_46095,1196,432,124,47,171,2.7621247113163974,26.528086692770234
Task_46096,2896,955,109,106,215,3.0292887029288704,55.92425595904363
Task_46097,705,966,70,131,201,0.7290589451913133,21.33783808280044
Task_46098,1501,917,173,134,307,1.6350762527233116,34.143042475645984
Task_46099,1781,566,76,50,126,3.1410934744268078,36.00943241445353
Task_46100,2538,553,39,36,75,4.581227436823105,46.97346518750419
Task_46101,612,421,157,180,337,1.4502369668246446,18.680765353291942
Task_46102,2530,661,110,144,254,3.821752265861027,49.433306623004036
Task_46103,2388,782,196,28,224,3.049808429118774,46.75090917592937
Task_46104,2285,182,86,150,236,12.486338797814208,43.75600341139756
Task_46105,967,263,62,162,224,3.662878787878788,23.376569943258087
Task_46106,1370,131,151,25,176,10.378787878787879,27.935202998025716
Task_46107,511,199,187,21,208,2.555,15.048551482588827
Task_46108,1449,949,61,143,204,1.5252631578947369,33.008714357002994
Task_46109,2484,257,129,43,172,9.627906976744185,46.32177042150506
Task_46110,2411,759,148,84,232,3.1723684210526315,47.59554397249789
Task_46111,1593,822,179,178,357,1.9356014580801943,35.60879878756604
Task_46112,1507,739,187,112,299,2.0364864864864867,33.62959183598135
Task_46113,2620,863,105,14,119,3.0324074074074074,49.79508055764445
Task_46114,2593,501,102,76,178,5.165338645418327,49.278390571598514
Task_46115,1832,363,16,117,133,5.032967032967033,36.66695369999665
Task_46116,2756,523,127,52,179,5.259541984732825,51.82561163026286
Task_46117,1639,956,40,87,127,1.7126436781609196,35.4579396376947
Task_46118,2220,494,53,18,71,4.484848484848484,41.542043296859866
Task_46119,2910,794,163,176,339,3.660377358490566,56.30274294078032
Task_46120,2563,158,167,163,330,16.11949685534591,48.41065319448194
Task_46121,951,119,166,82,248,7.925,22.110523801217653
Task_46122,980,807,170,165,335,1.2128712871287128,25.667512550762172
Task_46123,920,428,121,180,301,2.1445221445221447,23.468678957136557
Task_46124,1552,621,75,88,163,2.495176848874598,33.33274837015742
Task_46125,1637,329,59,80,139,4.960606060606061,33.502040586357765
Task_46126,1196,545,115,105,220,2.1904761904761907,27.73089150803004
Task_46127,539,504,130,61,191,1.0673267326732674,16.66723700958966
Task_46128,2831,364,183,143,326,7.756164383561644,53.555694673291136
Task_46129,2334,126,126,74,200,18.37795275590551,43.561855647166986
Task_46130,1491,417,120,88,208,3.5669856459330145,31.856950071669388
Task_46131,1717,604,86,66,152,2.83801652892562,35.3240627389041
Task_46132,599,585,25,19,44,1.022184300341297,16.251680174228834
Task_46133,1874,567,151,103,254,3.2992957746478875,38.68636125872989
Task_46134,2860,684,36,173,209,4.175182481751825,54.58747487132667
Task_46135,2432,719,81,39,120,3.3777777777777778,46.446114615221916
Task_46136,737,652,167,165,332,1.1286370597243491,21.310108932556876
Task_46137,841,452,186,101,287,1.8565121412803531,22.114960022474595
Task_46138,2863,606,47,37,84,4.716639209225701,52.66032792414936
Task_46139,2281,991,122,112,234,2.2993951612903225,46.3852881060674
Task_46140,2221,486,179,51,230,4.560574948665297,43.42342467908122
Task_46141,2460,355,143,200,343,6.910112359550562,47.81642431337443
Task_46142,2423,566,51,36,87,4.27336860670194,45.50488427671686
Task_46143,2953,296,29,104,133,9.942760942760943,54.172637445747974
Task_46144,1974,563,56,127,183,3.5,40.00416214950827
Task_46145,1977,918,130,12,142,2.1512513601741023,40.074958500716065
Task_46146,927,128,41,50,91,7.186046511627907,20.263799087431668
Task_46147,2876,430,171,98,269,6.672853828306264,54.17420799860008
Task_46148,1983,714,200,175,375,2.7734265734265735,41.526671493204965
Task_46149,2440,782,184,142,326,3.1162196679438057,48.71046986425387
Task_46150,1643,691,81,31,112,2.3742774566473988,33.82604735443652
Task_46151,2040,106,153,186,339,19.065420560747665,39.79221387421018
Task_46152,1290,876,169,170,339,1.4709236031927024,30.829076628813638
Task_46153,1039,677,178,119,297,1.5324483775811208,25.98159992581918
Task_46154,620,692,64,73,137,0.8946608946608947,18.43799631205376
Task_46155,1831,563,68,160,228,3.24645390070922,38.032330175540174
Task_46156,1709,476,102,192,294,3.5828092243186584,36.09542322690619
Task_46157,1419,208,102,161,263,6.7894736842105265,30.435353658315165
Task_46158,1116,276,101,175,276,4.028880866425993,25.960641889285654
Task_46159,865,285,128,80,208,3.0244755244755246,21.477415811604498
Task_46160,2349,835,39,88,127,2.8098086124401913,46.34802068930094
Task_46161,1119,890,119,109,228,1.2558922558922558,27.5626750776112
Task_46162,1687,177,67,52,119,9.47752808988764,32.97227981593472
Task_46163,1641,713,101,111,212,2.2983193277310923,35.27753891311597
Task_46164,1813,834,42,103,145,2.17125748502994,37.906799642882156
Task_46165,2059,404,188,70,258,5.083950617283951,40.78350586125371
Task_46166,2509,639,71,93,164,3.9203125,48.57538640382166
Task_46167,1512,479,178,173,351,3.15,33.21554850333819
Task_46168,650,911,49,134,183,0.7127192982456141,20.20747045233944
Task_46169,721,761,122,34,156,0.9461942257217848,19.970240537408632
Task_46170,565,234,14,183,197,2.404255319148936,16.75593655697053
Task_46171,2819,117,152,69,221,23.889830508474578,51.093413906961935
Task_46172,2933,408,135,58,193,7.1711491442542785,54.28147355267814
Task_46173,948,655,165,133,298,1.4451219512195121,24.4857159715129
Task_46174,738,371,83,199,282,1.9838709677419355,20.386759709553143
Task_46175,639,640,115,145,260,0.9968798751950078,19.398042964106907
Task_46176,2020,933,182,137,319,2.1627408993576016,42.488629087977976
Task_46177,1012,853,125,74,199,1.1850117096018735,25.4283409886382
Task_46178,985,722,197,139,336,1.3623789764868603,25.46703218172016
Task_46179,516,111,31,28,59,4.607142857142857,13.228813778252173
Task_46180,1901,154,60,81,141,12.264516129032257,36.6643997678836
Task_46181,2862,773,149,185,334,3.697674418604651,55.466816295670924
Task_46182,1090,228,32,124,156,4.759825327510917,24.588523670177356
Task_46183,2155,426,100,59,159,5.046838407494145,41.740635952788615
Task_46184,1668,619,155,96,251,2.6903225806451614,35.59266653061368
Task_46185,2711,562,73,21,94,4.815275310834814,50.16091284091549
Task_46186,726,423,139,157,296,1.7122641509433962,20.313052472114965
Task_46187,1384,258,198,126,324,5.343629343629344,30.280317102093722
Task_46188,2013,541,184,133,317,3.7140221402214024,41.1327178118022
Task_46189,888,401,55,175,230,2.208955223880597,22.619282981057022
Task_46190,1268,143,27,152,179,8.805555555555555,27.082601080581174
Task_46191,1415,706,23,120,143,2.0014144271570014,31.171514639409427
Task_46192,1306,603,36,27,63,2.162251655629139,27.60369427479708
Task_46193,2587,638,90,67,157,4.048513302034428,49.28544878222676
Task_46194,2103,1018,95,110,205,2.0637880274779197,43.52512333467808
Task_46195,696,463,98,137,235,1.5,19.63422564123046
Task_46196,2628,333,47,148,195,7.868263473053892,49.69550010538635
Task_46197,2443,134,40,127,167,18.096296296296295,45.360599752769154
Task_46198,906,452,59,88,147,2.0,22.415740535089398
Task_46199,883,194,24,39,63,4.528205128205128,19.721765994945475
Task_46200,1842,239,34,13,47,7.675,34.66905704798382
Task_46201,2103,971,193,82,275,2.1635802469135803,43.57199887011674
Task_46202,1109,219,65,68,133,5.040909090909091,24.617513599594485
Task_46203,2220,568,130,40,170,3.9015817223198592,43.14393597648905
Task_46204,570,253,170,43,213,2.2440944881889764,16.2678324041857
Task_46205,1163,157,20,81,101,7.360759493670886,24.535585381950956
Task_46206,1006,368,169,145,314,2.7262872628726287,24.64647715297117
Task_46207,2341,115,143,52,195,20.18103448275862,43.41561353219097
Task_46208,1632,134,33,72,105,12.088888888888889,31.669264844430458
Task_46209,686,72,116,188,304,9.397260273972602,18.234205128391686
Task_46210,2775,810,32,17,49,3.4217016029593097,51.338432425298826
Task_46211,842,201,67,121,188,4.1683168316831685,20.966572103749474
Task_46212,859,947,175,113,288,0.9061181434599156,23.940214932540766
Task_46213,2168,426,69,72,141,5.07728337236534,42.103227608453956
Task_46214,816,933,42,151,193,0.8736616702355461,22.799424276815603
Task_46215,564,1018,97,43,140,0.5534838076545633,18.39327075895797
Task_46216,2803,813,137,104,241,3.4434889434889433,54.12003712477772
Task_46217,1122,978,133,89,222,1.146067415730337,27.78061908496449
Task_46218,2704,727,157,141,298,3.7142857142857144,52.59201286180536
Task_46219,2961,763,47,45,92,3.8756544502617802,54.73182123050228
Task_46220,1754,490,44,103,147,3.5723014256619146,35.89995890514935
Task_46221,715,724,110,125,235,0.9862068965517241,20.740608011583504
Task_46222,2160,579,104,56,160,3.7241379310344827,42.335001328046125
Task_46223,1027,407,167,94,261,2.517156862745098,24.782558032117333
Task_46224,634,238,104,70,174,2.6527196652719667,17.301032341222147
Task_46225,2076,418,162,52,214,4.954653937947494,40.891529650275345
Task_46226,2316,221,195,140,335,10.432432432432432,44.9406091977585
Task_46227,2108,141,76,126,202,14.845070422535212,40.576842876428266
Task_46228,1610,920,29,18,47,1.748099891422367,33.166824812567114
Task_46229,1722,494,48,62,110,3.478787878787879,34.75317241390917
Task_46230,1205,497,173,152,325,2.4196787148594376,28.264566192798927
Task_46231,1600,986,176,38,214,1.6210739614994933,34.89892777119137
Task_46232,1028,383,161,190,351,2.6770833333333335,25.275091239260664
Task_46233,2748,707,115,166,281,3.8813559322033897,53.18586305675058
Task_46234,2752,530,57,11,68,5.182674199623352,50.04049084992593
Task_46235,2346,869,100,98,198,2.696551724137931,46.859657344134014
Task_46236,2548,335,116,161,277,7.583333333333333,48.78560359669202
Task_46237,2680,683,199,165,364,3.91812865497076,52.40542580351278
Task_46238,2663,916,103,94,197,2.9040348964013085,52.00490564151668
Task_46239,753,406,67,171,238,1.8501228501228502,20.53392245329222
Task_46240,1012,752,134,87,221,1.343957503320053,25.336031614773162
Task_46241,2165,725,27,114,141,2.982093663911846,43.094654797155194
Task_46242,2509,576,52,122,174,4.348353552859619,48.483923131406335
Task_46243,1913,506,86,34,120,3.7731755424063116,37.56907083526123
Task_46244,957,527,113,105,218,1.8125,23.881268061338982
Task_46245,2424,557,195,56,251,4.344086021505376,46.97546613341307
Task_46246,1439,884,62,125,187,1.6259887005649718,32.55776062066658
Task_46247,2268,379,20,144,164,5.968421052631579,43.909113378539
Task_46248,2337,532,34,186,220,4.384615384615385,45.88655856720336
Task_46249,579,171,172,62,234,3.366279069767442,16.278432383127612
Task_46250,1238,476,159,48,207,2.5953878406708597,27.550556427563368
Task_46251,2110,797,66,28,94,2.644110275689223,41.40274045591048
Task_46252,2296,606,145,92,237,3.782537067545305,45.348243350326165
Task_46253,818,589,136,182,318,1.3864406779661016,22.383433205694676
Task_46254,1735,491,171,86,257,3.5264227642276422,36.166402086950924
Task_46255,1439,490,139,126,265,2.930753564154786,31.638342867169893
Task_46256,626,603,52,90,142,1.0364238410596027,18.339357802404823
Task_46257,521,582,85,84,169,0.8936535162950258,16.748011440248252
Task_46258,2244,1014,188,185,373,2.210837438423645,46.603987661546654
Task_46259,1465,600,193,12,205,2.437603993344426,31.387363840596652
Task_46260,2717,130,148,146,294,20.740458015267176,50.43129132124833
Task_46261,1779,631,89,15,104,2.814873417721519,35.64280283170091
Task_46262,1060,142,176,179,355,7.4125874125874125,24.761516391633734
Task_46263,2803,67,26,99,125,41.220588235294116,49.834394503541766
Task_46264,2603,734,59,12,71,3.5414965986394558,48.34099369198859
Task_46265,2457,620,14,162,176,3.9565217391304346,47.78338331340879
Task_46266,1170,207,74,170,244,5.625,26.488904408949267
Task_46267,2628,707,52,145,197,3.711864406779661,50.947667204347376
Task_46268,2502,608,58,42,100,4.108374384236453,46.98204983641862
Task_46269,2206,745,107,178,285,2.9571045576407506,44.75527791832938
Task_46270,1720,335,147,44,191,5.119047619047619,34.61183569020363
Task_46271,1848,120,192,175,367,15.272727272727273,37.056697678032556
Task_46272,1362,641,87,84,171,2.121495327102804,30.234207514368663
Task_46273,2596,396,59,93,152,6.53904282115869,48.96283371944492
Task_46274,891,243,183,145,328,3.651639344262295,22.486358831976208
Task_46275,2039,820,101,159,260,2.4835566382460414,42.203779515348444
Task_46276,1334,286,166,174,340,4.648083623693379,29.726717879600244
Task_46277,1780,210,62,112,174,8.436018957345972,35.71041365258414
Task_46278,2226,1013,157,84,241,2.195266272189349,45.49803882933664
Task_46279,739,259,155,169,324,2.8423076923076924,20.154320245076644
Task_46280,2239,974,187,119,306,2.2964102564102564,46.001586387650185
Task_46281,2822,66,168,20,188,42.11940298507463,49.922920153240256
Task_46282,2572,356,91,123,214,7.204481792717087,48.89655481587187
Task_46283,2330,614,52,157,209,3.7886178861788617,46.005012881902125
Task_46284,2862,802,56,164,220,3.564134495641345,55.08311205948607
Task_46285,1146,348,155,137,292,3.2836676217765044,26.68609824334703
Task_46286,1146,346,62,85,147,3.3025936599423633,25.878864782199184
Task_46287,554,538,160,30,190,1.0278293135435992,16.802914720381693
Task_46288,1717,114,189,181,370,14.930434782608696,34.92184672249719
Task_46289,2733,799,172,77,249,3.41625,52.79730750593331
Task_46290,2941,280,115,89,204,10.466192170818506,54.32800303553478
Task_46291,2497,227,45,25,70,10.951754385964913,45.16754389919302
Task_46292,1082,246,96,165,261,4.380566801619433,25.248936200860456
Task_46293,969,87,113,43,156,11.011363636363637,20.88594327218568
Task_46294,913,240,93,47,140,3.788381742738589,21.295262473483245
Task_46295,2498,469,68,56,124,5.314893617021276,47.114007149358706
Task_46296,1922,717,42,90,132,2.6768802228412256,39.27236525386703
Task_46297,1345,320,170,110,280,4.190031152647975,29.648743440796384
Task_46298,2742,121,56,106,162,22.475409836065573,49.86533227932431
Task_46299,829,936,135,36,171,0.8847385272145144,22.311019761411032
Task_46300,1060,115,128,62,190,9.137931034482758,23.245459810545317
Task_46301,1871,417,168,55,223,4.476076555023924,37.64391259318908
Task_46302,1552,232,148,97,245,6.660944206008583,32.47437972617919
Task_46303,654,775,85,145,230,0.8427835051546392,19.900306159427497
Task_46304,666,1019,102,25,127,0.6529411764705882,19.834581450139453
Task_46305,897,449,150,126,276,1.9933333333333334,22.978964510939306
Task_46306,1386,171,120,58,178,8.05813953488372,28.680028752820565
Task_46307,566,612,151,21,172,0.9233278955954323,17.175359186626878
Task_46308,1444,808,58,28,86,1.784919653893696,30.72371532819369
Task_46309,2745,940,112,168,280,2.917109458023379,53.86845709437663
Task_46310,1866,450,172,178,350,4.137472283813747,38.729057438602005
Task_46311,1216,542,97,114,211,2.2394106813996317,28.018473386577842
Task_46312,2074,428,30,47,77,4.834498834498834,39.285261697653134
Task_46313,2795,618,106,17,123,4.51534733441034,51.89879866605249
Task_46314,2779,393,83,174,257,7.053299492385787,52.60119746424669
Task_46315,843,149,27,115,142,5.62,19.87573694604373
Task_46316,1305,128,59,52,111,10.116279069767442,26.334518379393327
Task_46317,2457,348,48,171,219,7.040114613180516,47.20372230603288
Task_46318,554,122,143,171,314,4.504065040650406,16.459948376471075
Task_46319,729,538,76,176,252,1.3525046382189239,20.575261403420196
Task_46320,2759,973,73,59,132,2.8326488706365502,53.02277479850795
Task_46321,680,647,124,147,271,1.0493827160493827,20.10880353865153
Task_46322,2361,288,90,80,170,8.16955017301038,44.922814028363916
Task_46323,2862,298,128,95,223,9.57190635451505,53.294762212423215
Task_46324,1299,656,22,134,156,1.9771689497716896,29.25832753804232
Task_46325,2411,527,100,10,110,4.566287878787879,45.41376290719472
Task_46326,2282,449,183,73,256,5.071111111111111,44.50275676018322
Task_46327,841,1016,18,25,43,0.8269419862340216,21.55618150596855
Task_46328,1083,521,22,197,219,2.074712643678161,25.97847467387389
Task_46329,642,841,26,182,208,0.7624703087885986,19.866233255367494
Task_46330,2820,132,99,134,233,21.203007518796994,51.7731926120598
Task_46331,1330,546,13,12,25,2.4314442413162705,27.40975747569693
Task_46332,1628,283,87,82,169,5.732394366197183,33.311199976904284
Task_46333,2509,173,51,174,225,14.419540229885058,47.19606979689322
Task_46334,1172,570,159,10,169,2.052539404553415,26.445738557428665
Task_46335,2052,85,140,22,162,23.86046511627907,37.91645777455665
Task_46336,1971,370,87,71,158,5.3126684636118595,38.672999695576316
Task_46337,1034,808,170,105,275,1.2781211372064276,26.17106580242529
Task_46338,1013,621,152,155,307,1.6286173633440515,25.522566859336663
Task_46339,1157,907,25,122,147,1.274229074889868,27.689396869393363
Task_46340,1833,362,13,167,180,5.049586776859504,37.09215069978873
Task_46341,2981,688,70,95,165,4.32656023222061,56.26380887256263
Task_46342,1764,83,40,181,221,21.0,34.740150418837814
Task_46343,1466,171,110,185,295,8.523255813953488,31.02266229273531
Task_46344,2292,341,67,62,129,6.701754385964913,43.65942730079877
Task_46345,1942,726,129,95,224,2.671251719394773,40.130452037843085
Task_46346,1061,156,141,112,253,6.75796178343949,24.30248010226799
Task_46347,1891,897,72,137,209,2.1057906458797326,39.89667835552991
Task_46348,2406,384,66,67,133,6.249350649350649,45.68530521913138
Task_46349,2096,991,160,90,250,2.1129032258064515,43.46173887285638
Task_46350,2394,259,85,132,217,9.207692307692307,45.776515983487826
Task_46351,2056,952,23,141,164,2.157397691500525,42.36636910557286
Task_46352,1811,131,30,27,57,13.719696969696969,33.861175731132946
Task_46353,1770,222,148,98,246,7.937219730941704,35.866722259290704
Task_46354,1150,292,14,24,38,3.9249146757679183,23.903834554983362
Task_46355,2420,659,43,181,224,3.6666666666666665,47.62037693460895
Task_46356,699,134,199,150,349,5.177777777777778,18.934598923783295
Task_46357,2248,188,12,85,97,11.894179894179894,42.118023241498825
Task_46358,1023,814,193,117,310,1.2552147239263804,26.187433319609998
Task_46359,915,823,28,74,102,1.1104368932038835,23.079076226787393
Task_46360,2211,980,163,14,177,2.253822629969419,44.244498363687285
Task_46361,950,704,42,112,154,1.3475177304964538,23.77572733149187
Task_46362,1514,619,165,24,189,2.4419354838709677,32.18126078722589
Task_46363,919,683,11,60,71,1.3435672514619883,21.9500716762448
Task_46364,1169,533,52,141,193,2.189138576779026,27.268839785153762
Task_46365,1927,523,114,128,242,3.677480916030534,39.368377424012685
Task_46366,1007,458,147,163,310,2.1938997821350763,24.95586904654606
Task_46367,1540,836,133,185,318,1.8399044205495818,34.64712032017427
Task_46368,1668,192,148,47,195,8.642487046632125,33.4004537396329
Task_46369,2799,605,13,136,149,4.618811881188119,52.82910657297955
Task_46370,1118,893,93,104,197,1.250559284116331,27.439501061584227
Task_46371,2571,887,19,33,52,2.89527027027027,48.485663220808654
Task_46372,2435,115,149,182,331,20.99137931034483,46.051010654849875
Task_46373,1070,516,110,195,305,2.0696324951644103,26.15992879285376
Task_46374,1814,194,124,173,297,9.302564102564103,36.778861794851785
Task_46375,2584,891,21,23,44,2.896860986547085,48.58059856611168
Task_46376,2508,821,54,131,185,3.051094890510949,49.29515818900537
Task_46377,1481,603,102,103,205,2.4519867549668874,32.355501587105
Task_46378,515,178,147,181,328,2.877094972067039,16.14282449263931
Task_46379,2502,424,60,84,144,5.8870588235294115,47.56112284546879
Task_46380,1134,609,157,44,201,1.859016393442623,26.255318303021387
Task_46381,2284,615,132,117,249,3.707792207792208,45.32927435665402
Task_46382,2161,571,84,13,97,3.777972027972028,41.47807664681866
Task_46383,639,754,137,26,163,0.8463576158940397,18.723810956604982
Task_46384,1919,482,159,104,263,3.9730848861283645,39.17019515678989
Task_46385,2126,943,129,86,215,2.2521186440677967,43.58960852230206
Task_46386,929,952,23,200,223,0.974816369359916,24.812065970769833
Task_46387,1520,1024,46,120,166,1.4829268292682927,34.094133762456856
Task_46388,2629,984,66,149,215,2.669035532994924,51.92420583487109
Task_46389,2948,838,193,102,295,3.5137067938021453,56.736369198959174
Task_46390,634,261,59,84,143,2.4198473282442747,17.47222410047335
Task_46391,2015,214,106,174,280,9.372093023255815,39.96303316002868
Task_46392,730,672,29,128,157,1.0846953937592867,20.211114946063738
Task_46393,542,679,153,42,195,0.7970588235294118,17.14099721151688
Task_46394,1984,973,25,183,208,2.0369609856262834,41.59536312252129
Task_46395,2064,704,63,96,159,2.927659574468085,41.60579608862958
Task_46396,992,984,100,195,295,1.0071065989847716,26.25510974949394
Task_46397,700,316,166,172,338,2.2082018927444795,19.788452176399574
Task_46398,1194,482,41,86,127,2.472049689440994,26.932154858665204
Task_46399,1025,166,45,161,206,6.137724550898204,23.597186941040277
Task_46400,2774,608,82,176,258,4.555008210180624,53.23625660996084
Task_46401,2594,653,152,31,183,3.9663608562691133,49.41534181706262
Task_46402,658,799,134,176,310,0.8225,20.479002524661208
Task_46403,1939,241,170,167,337,8.012396694214877,39.10854849955915
Task_46404,836,865,31,58,89,0.9653579676674365,21.64496699687301
Task_46405,2307,779,98,100,198,2.957692307692308,45.9597589623725
Task_46406,1175,549,32,61,93,2.1363636363636362,26.01725581457489
Task_46407,2257,485,120,140,260,4.6440329218107,44.56972586023662
Task_46408,2283,194,26,32,58,11.707692307692307,41.81417068804412
Task_46409,685,659,141,125,266,1.0378787878787878,20.170418624950006
Task_46410,1425,933,21,95,116,1.525695931477516,31.731622812972855
Task_46411,776,604,19,82,101,1.2826446280991735,20.24679501168812
Task_46412,949,373,33,168,201,2.537433155080214,23.29138766968302
Task_46413,895,521,126,154,280,1.71455938697318,23.218706566991443
Task_46414,1697,183,75,133,208,9.222826086956522,34.45259659215878
Task_46415,1877,961,73,15,88,1.9511434511434511,38.10781937651125
Task_46416,1887,278,62,72,134,6.763440860215054,37.15118692985588
Task_46417,2376,547,27,95,122,4.335766423357664,45.72958342099306
Task_46418,2566,525,136,168,304,4.8783269961977185,49.83000707405845
Task_46419,1781,239,195,17,212,7.420833333333333,35.24113471794696
Task_46420,2242,703,71,131,202,3.184659090909091,44.810546183220346
Task_46421,1576,686,131,188,319,2.2940320232896654,34.75861983255656
Task_46422,517,263,164,147,311,1.9583333333333333,16.5681626809378
Task_46423,2926,786,128,91,219,3.717916137229987,55.810649237898495
Task_46424,1152,605,82,179,261,1.900990099009901,27.55731887634323
Task_46425,1136,591,108,84,192,1.9189189189189189,26.691322366874772
Task_46426,1201,223,196,73,269,5.361607142857143,26.714070080430957
Task_46427,1198,224,72,126,198,5.3244444444444445,26.717631549361425
Task_46428,2519,146,143,149,292,17.13605442176871,47.44328150395583
Task_46429,2950,64,162,121,283,45.38461538461539,53.42803140869166
Task_46430,2343,769,142,152,294,3.0428571428571427,47.00338822828699
Task_46431,2096,681,119,176,295,3.0733137829912023,42.85385443247043
Task_46432,704,827,105,11,116,0.8502415458937198,19.41675430951918
Task_46433,1718,624,79,13,92,2.7488,34.58716772975763
Task_46434,1987,227,42,197,239,8.714912280701755,39.43478725665989
Task_46435,561,680,139,53,192,0.8237885462555066,17.675619674303896
Task_46436,571,405,41,67,108,1.4064039408866995,16.2841990669631
Task_46437,1974,224,76,112,188,8.773333333333333,38.90072243323618
Task_46438,1568,387,137,127,264,4.041237113402062,33.34734560841712
Task_46439,559,152,62,44,106,3.65359477124183,14.402112681702485
Task_46440,1899,330,66,62,128,5.737160120845921,37.48558934074743
Task_46441,2661,501,35,54,89,5.300796812749004,49.36466407602031
Task_46442,2029,840,37,61,98,2.412604042806183,40.51425747208232
Task_46443,1675,208,55,184,239,8.014354066985646,34.472079367713775
Task_46444,2065,349,87,30,117,5.9,39.4580782022753
Task_46445,2237,392,54,138,192,5.692111959287532,43.71056357621205
Task_46446,2458,557,63,184,247,4.405017921146953,48.05636852131761
Task_46447,1254,1018,192,184,376,1.2306182531894014,30.875191001497896
Task_46448,2072,697,104,74,178,2.968481375358166,41.641596508880816
Task_46449,932,844,125,21,146,1.1029585798816568,23.42243645739475
Task_46450,1965,456,130,100,230,4.299781181619256,39.660180929768636
Task_46451,1872,401,171,28,199,4.656716417910448,37.25600180621487
Task_46452,2267,930,184,152,336,2.435016111707841,46.49182930450663
Task_46453,577,158,156,179,335,3.6289308176100628,17.149835579890055
Task_46454,1773,820,119,192,311,2.1595615103532277,38.26761829473954
Task_46455,2700,244,158,91,249,11.020408163265307,50.5790152556753
Task_46456,2862,355,115,76,191,8.039325842696629,53.13502489644492
Task_46457,1179,461,39,112,151,2.551948051948052,26.702492010271282
Task_46458,746,272,125,157,282,2.7326007326007327,20.100179990892688
Task_46459,1998,776,118,91,209,2.5714285714285716,41.03222248131135
Task_46460,581,189,90,87,177,3.057894736842105,16.614520187010807
Task_46461,2113,350,52,182,234,6.01994301994302,41.86506976473344
Task_46462,1336,118,69,59,128,11.22689075630252,27.287899380057336
Task_46463,1816,535,133,159,292,3.388059701492537,37.91986789686295
Task_46464,1576,625,95,102,197,2.5175718849840254,33.90186864665347
Task_46465,2139,235,192,61,253,9.063559322033898,41.38341247666197
Task_46466,1629,349,100,132,232,4.654285714285714,34.051559426965206
Task_46467,2172,608,191,87,278,3.5665024630541873,43.55868653936281
Task_46468,1893,452,110,183,293,4.178807947019868,38.91327903759144
Task_46469,1124,972,120,62,182,1.1551901336073997,27.323528396064077
Task_46470,544,750,152,102,254,0.7243675099866844,18.250956600139823
Task_46471,730,460,83,167,250,1.5835140997830803,20.30454610035913
Task_46472,653,326,122,121,243,1.996941896024465,18.574050249594332
Task_46473,2640,386,157,47,204,6.821705426356589,49.42409969195915
Task_46474,1817,253,51,100,151,7.153543307086614,36.17908732895534
Task_46475,2790,415,44,13,57,6.706730769230769,50.36084049027781
Task_46476,2243,436,49,103,152,5.132723112128146,43.52195491313595
Task_46477,2834,234,65,32,97,12.059574468085106,51.005726606173944
Task_46478,1313,401,167,137,304,3.2661691542288556,29.552539495359294
Task_46479,2602,89,29,125,154,28.91111111111111,47.097841351443144
Task_46480,2660,433,38,44,82,6.129032258064516,48.849327147458304
Task_46481,2265,198,155,17,172,11.381909547738694,42.5647307918415
Task_46482,839,400,18,30,48,2.092269326683292,19.46616608572417
Task_46483,791,91,193,34,227,8.597826086956522,18.695817451287905
Task_46484,1304,492,115,150,265,2.6450304259634887,29.54269962235466
Task_46485,1061,413,89,89,178,2.5628019323671496,24.880850716444595
Task_46486,2973,665,145,85,230,4.463963963963964,56.19102509411386
Task_46487,1455,314,100,73,173,4.619047619047619,30.567096540776095
Task_46488,879,404,167,169,336,2.1703703703703705,22.88571037179439
Task_46489,1626,933,156,82,238,1.740899357601713,35.71913000416603
Task_46490,2590,605,103,71,174,4.273927392739274,49.46882481517438
Task_46491,1167,970,10,138,148,1.2018537590113285,28.045191488714938
Task_46492,1688,787,75,118,193,2.1421319796954315,36.24256151828158
Task_46493,1746,986,50,156,206,1.7689969604863223,37.91472913573351
Task_46494,2095,578,164,82,246,3.618307426597582,42.08284238314037
Task_46495,993,545,56,107,163,1.8186813186813187,24.272891704553455
Task_46496,2963,229,63,124,187,12.882608695652173,54.552946492378105
Task_46497,2279,171,54,188,242,13.25,43.64966074132889
Task_46498,1064,193,97,102,199,5.484536082474227,24.40655227760837
Task_46499,1227,523,185,175,360,2.3416030534351147,28.886200718919408
Task_46500,2561,333,189,34,223,7.667664670658683,48.04607168916348
Task_46501,2362,516,50,121,171,4.568665377176015,45.94281692025489
Task_46502,2266,893,100,100,200,2.534675615212528,45.671418609612196
Task_46503,2447,984,70,172,242,2.484263959390863,49.190523839437326
Task_46504,2626,814,96,86,182,3.222085889570552,50.93138492368291
Task_46505,1243,594,30,98,128,2.089075630252101,28.208016193219112
Task_46506,2302,545,35,115,150,4.216117216117216,44.758326653530766
Task_46507,2630,336,30,104,134,7.804154302670623,49.16482639132891
Task_46508,2567,747,200,149,349,3.4318181818181817,50.72635664044592
Task_46509,2207,965,31,166,197,2.2846790890269153,45.041578929236266
Task_46510,1314,413,77,43,120,3.1739130434782608,27.79760286117754
Task_46511,1398,647,178,33,211,2.1574074074074074,30.594559473720352
Task_46512,1939,594,200,92,292,3.2588235294117647,39.90446274350503
Task_46513,2691,322,146,199,345,8.3312693498452,51.36440815543504
Task_46514,2507,395,50,144,194,6.33080808080808,48.038644617633224
Task_46515,1150,955,177,20,197,1.202928870292887,27.499194229570396
Task_46516,2092,462,48,146,194,4.518358531317495,41.65478963645898
Task_46517,1071,1009,141,175,316,1.0603960396039604,27.668144167221055
Task_46518,947,600,144,153,297,1.5757071547420964,24.334575959185518
Task_46519,1131,186,73,61,134,6.048128342245989,24.870116248188737
Task_46520,1671,839,133,25,158,1.9892857142857143,35.11283886379908
Task_46521,1721,415,68,182,250,4.137019230769231,35.949644750091316
Task_46522,2355,190,105,12,117,12.329842931937172,43.48217752765092
Task_46523,1717,345,188,97,285,4.96242774566474,35.646286195357156
Task_46524,2319,278,31,104,135,8.311827956989248,44.04183605055564
Task_46525,1281,173,101,151,252,7.362068965517241,27.85007235064656
Task_46526,1366,595,159,143,302,2.291946308724832,31.00502047950617
Task_46527,2467,572,107,51,158,4.305410122164049,47.14127212264577
Task_46528,2195,345,13,59,72,6.34393063583815,41.07769180365863
Task_46529,2795,653,139,26,165,4.273700305810397,52.51554514875045
Task_46530,2507,308,138,78,216,8.11326860841424,47.52430136369108
Task_46531,1190,737,128,115,243,1.6124661246612466,28.340193920437134
Task_46532,1116,647,22,146,168,1.7222222222222223,26.532408086260148
Task_46533,624,708,118,161,279,0.8801128349788434,19.49790672222713
Task_46534,798,566,101,118,219,1.4074074074074074,21.455095573128116
Task_46535,2619,960,84,83,167,2.72528616024974,51.2309233138567
Task_46536,2474,479,109,80,189,5.154166666666667,47.47310227513128
Task_46537,2786,529,133,89,222,5.256603773584906,52.79820613014753
Task_46538,2803,505,15,130,145,5.5395256916996045,52.5494842176983
Task_46539,1404,181,74,19,93,7.714285714285714,28.126884117315253
Task_46540,727,859,193,78,271,0.8453488372093023,21.344910251285096
Task_46541,1154,429,155,132,287,2.683720930232558,27.04169159996867
Task_46542,2478,325,119,155,274,7.601226993865031,47.621856882265796
Task_46543,542,529,77,110,187,1.0226415094339623,17.141202206249883
Task_46544,2098,418,176,169,345,5.007159904534606,42.26138547439525
Task_46545,1157,307,53,117,170,3.7564935064935066,26.171743497933154
Task_46546,2655,633,18,49,67,4.187697160883281,49.16974364644825
Task_46547,2454,611,78,78,156,4.009803921568627,47.3596776812357
Task_46548,2297,888,127,114,241,2.5838020247469067,46.35232622320435
Task_46549,1384,554,91,136,227,2.4936936936936935,30.81233497140847
Task_46550,1563,985,153,92,245,1.5851926977687627,34.9143526586141
Task_46551,1293,1013,75,163,238,1.2751479289940828,30.885334553339845
Task_46552,1399,594,62,121,183,2.3512605042016808,30.985225748547293
Task_46553,2280,97,109,140,249,23.26530612244898,42.97495312160621
Task_46554,2625,987,136,162,298,2.6568825910931175,52.18589875552275
Task_46555,1250,611,173,80,253,2.042483660130719,28.805453475153985
Task_46556,2197,722,43,110,153,3.0387275242047025,43.641614187055204
Task_46557,1828,381,172,151,323,4.785340314136126,37.74259672747953
Task_46558,2014,181,78,152,230,11.065934065934066,39.42643924941071
Task_46559,1886,866,48,116,164,2.1753171856978084,39.43985080273179
Task_46560,2131,229,53,185,238,9.265217391304347,41.749802765860466
Task_46561,2366,1021,142,27,169,2.315068493150685,46.838112153816446
Task_46562,2192,458,75,130,205,4.775599128540305,43.25579396335786
Task_46563,2805,1010,102,96,198,2.7744807121661723,54.59093354168443
Task_46564,2670,804,109,176,285,3.3167701863354035,52.28846026514858
Task_46565,1463,557,155,63,218,2.621863799283154,31.6433025344737
Task_46566,884,1011,41,157,198,0.8735177865612648,24.130435821065593
Task_46567,1156,576,74,115,189,2.003466204506066,27.12708189302261
Task_46568,1199,528,182,141,323,2.2665406427221173,28.242000069737383
Task_46569,1033,492,28,127,155,2.0953346855983774,24.526142150439842
Task_46570,1226,175,42,35,77,6.965909090909091,25.038075129263362
Task_46571,1799,253,15,23,38,7.082677165354331,34.02212949054503
Task_46572,1800,587,139,25,164,3.061224489795918,36.51576512837691
Task_46573,2538,508,75,171,246,4.986247544204322,49.139659857724546
Task_46574,2571,168,117,90,207,15.21301775147929,47.84467273420526
Task_46575,1131,692,172,87,259,1.632034632034632,27.23934659241544
Task_46576,2489,618,87,173,260,4.021001615508886,48.67737501959047
Task_46577,2514,321,10,183,193,7.807453416149069,47.81365000187986
Task_46578,2633,963,185,61,246,2.7313278008298756,51.52668626135468
Task_46579,1883,778,159,97,256,2.417201540436457,39.52053760368077
Task_46580,2793,454,198,98,296,6.138461538461539,53.06151287154756
Task_46581,1273,560,95,111,206,2.269162210338681,28.95321325387273
Task_46582,504,217,54,175,229,2.311926605504587,15.956397568712624
Task_46583,2402,527,13,172,185,4.549242424242424,46.655701616439394
Task_46584,1730,154,184,54,238,11.161290322580646,34.39305967421097
Task_46585,1472,131,130,50,180,11.151515151515152,29.60180433576332
Task_46586,1205,836,85,188,273,1.4396654719235364,29.091684753294217
Task_46587,2734,426,46,198,244,6.402810304449648,51.97378391405664
Task_46588,2568,786,68,73,141,3.263024142312579,49.58229462784568
Task_46589,1944,995,35,143,178,1.9518072289156627,40.84239627152553
Task_46590,1279,201,28,17,45,6.3316831683168315,25.61821994451655
Task_46591,997,795,29,164,193,1.2525125628140703,25.247449837717355
Task_46592,1942,607,79,95,174,3.1940789473684212,39.57891277310898
Task_46593,959,550,176,36,212,1.7404718693284937,23.3326627386321
Task_46594,1155,669,197,101,298,1.7238805970149254,27.801479333493972
Task_46595,2381,566,71,139,210,4.199294532627866,46.625945887168086
Task_46596,2178,604,93,112,205,3.6,43.44851405157118
Task_46597,1829,624,19,55,74,2.9264,36.200504761094464
Task_46598,1218,408,68,152,220,2.97799511002445,27.788201616790232
Task_46599,1764,79,137,152,289,22.05,34.99551068987069
Task_46600,1942,829,161,55,216,2.3397590361445784,40.039333910173504
Task_46601,2499,895,91,110,201,2.7890625,49.38810134060446
Task_46602,2350,300,191,82,273,7.807308970099668,45.32861564174592
Task_46603,2267,853,40,51,91,2.6545667447306793,44.254487034488335
Task_46604,1530,247,126,199,325,6.169354838709677,32.66096906366556
Task_46605,2055,617,93,114,207,3.325242718446602,41.55364555563722
Task_46606,2889,422,10,160,170,6.829787234042553,53.906277735630276
Task_46607,750,1003,18,112,130,0.7470119521912351,21.531803123104137
Task_46608,2923,698,57,128,185,4.1816881258941345,55.47415798002268
Task_46609,800,282,29,16,45,2.8268551236749118,18.30802206946345
Task_46610,2730,505,192,33,225,5.395256916996048,51.299181053264014
Task_46611,2571,722,197,185,382,3.5560165975103732,50.912471991383235
Task_46612,941,153,188,55,243,6.1103896103896105,21.973476609424058
Task_46613,1805,1024,168,135,303,1.7609756097560976,39.27585203403226
Task_46614,1556,754,170,28,198,2.060927152317881,33.365356250332574
Task_46615,1595,156,126,39,165,10.159235668789808,31.637040792947104
Task_46616,596,262,28,21,49,2.2661596958174903,15.161787563064287
Task_46617,600,806,149,60,209,0.7434944237918215,18.64516751480735
Task_46618,1912,805,52,66,118,2.372208436724566,38.94828576960976
Task_46619,2793,643,44,200,244,4.336956521739131,53.59542405545784
Task_46620,1997,585,43,89,132,3.407849829351536,40.03234842591423
Task_46621,915,517,28,73,101,1.7664092664092663,22.0805791287373
Task_46622,1580,863,186,125,311,1.8287037037037037,35.24534088785425
Task_46623,917,355,180,144,324,2.5758426966292136,23.240683235268154
Task_46624,2896,240,128,155,283,12.016597510373444,53.96212939666285
Task_46625,631,755,196,29,225,0.8346560846560847,18.886563432426257
Task_46626,1006,419,84,40,124,2.395238095238095,23.01125185795722
Task_46627,2576,449,43,133,176,5.724444444444444,49.1042343105209
Task_46628,2730,598,115,34,149,4.557595993322204,51.1731321985342
Task_46629,843,947,48,98,146,0.8892405063291139,22.9102151655031
Task_46630,2742,964,43,196,239,2.8414507772020725,53.768783949535454
Task_46631,2711,209,19,40,59,12.90952380952381,48.500941293171344
Task_46632,752,966,44,123,167,0.7776628748707343,21.723752543109452
Task_46633,2222,351,175,123,298,6.3125,43.72249972947416
Task_46634,1101,441,128,160,288,2.490950226244344,26.286457183814395
Task_46635,2795,691,188,29,217,4.039017341040463,52.88502369314701
Task_46636,2111,630,162,167,329,3.345483359746434,43.07071090271163
Task_46637,1529,229,88,108,196,6.647826086956521,31.826198897616592
Task_46638,1539,715,36,138,174,2.149441340782123,33.528767993116695
Task_46639,1747,255,171,37,208,6.82421875,34.8550272323135
Task_46640,1943,329,159,180,339,5.887878787878788,39.504158144489466
Task_46641,2527,86,101,83,184,29.04597701149425,46.21752029606213
Task_46642,2952,945,97,174,271,3.120507399577167,57.14015120653668
Task_46643,1895,949,41,144,185,1.9947368421052631,39.94334921116784
Task_46644,1375,600,136,170,306,2.2878535773710484,31.220834562048186
Task_46645,1610,494,11,160,171,3.2525252525252526,33.89000718269842
Task_46646,2385,825,171,28,199,2.887409200968523,46.72544473362185
Task_46647,972,493,196,42,238,1.9676113360323886,23.498334765945685
Task_46648,2989,566,38,22,60,5.271604938271605,54.057727584420626
Task_46649,2383,271,91,54,145,8.761029411764707,44.87238218275397
Task_46650,2855,587,163,117,280,4.855442176870748,54.4224550293373
Task_46651,2482,848,191,52,243,2.923439340400471,48.81693709196594
Task_46652,2131,920,161,158,319,2.3137893593919654,44.23782185632624
Task_46653,2044,366,177,29,206,5.569482288828338,39.89889159915331
Task_46654,1281,958,98,169,267,1.3357664233576643,30.625863872240696
Task_46655,2921,982,34,66,100,2.9715157680569684,55.260366821163785
Task_46656,1632,771,165,27,192,2.1139896373056994,34.57525382942387
Task_46657,1291,276,62,161,223,4.6606498194945845,28.53440637280562
Task_46658,2223,807,83,35,118,2.751237623762376,43.405702289851604
Task_46659,674,69,176,84,260,9.628571428571428,17.543886498038137
Task_46660,1318,420,147,43,190,3.130641330166271,28.526146152292682
Task_46661,593,470,83,192,275,1.2590233545647558,18.286022522658005
Task_46662,1918,890,139,25,164,2.1526374859708195,39.333733890117294
Task_46663,2621,614,86,85,171,4.261788617886179,50.087746731682955
Task_46664,2381,970,129,17,146,2.45211122554068,46.72836438426043
Task_46665,2044,967,72,48,120,2.1115702479338845,41.15869300543262
Task_46666,839,352,194,41,235,2.376770538243626,20.933520806651085
Task_46667,699,261,200,46,246,2.66793893129771,18.48926736948689
Task_46668,2968,169,113,190,303,17.458823529411763,54.74509486674669
Task_46669,2185,644,124,24,148,3.387596899224806,42.60888703866061
Task_46670,1719,826,28,132,160,2.0785973397823456,36.462577445107534
Task_46671,2015,232,32,159,191,8.648068669527897,39.60414148697939
Task_46672,2607,131,83,78,161,19.75,47.61264555776044
Task_46673,2451,155,145,193,338,15.711538461538462,46.70443482222174
Task_46674,1310,218,55,20,75,5.981735159817352,26.254860817245405
Task_46675,2244,334,102,70,172,6.6985074626865675,43.05481515729915
Task_46676,1773,735,72,123,195,2.4089673913043477,37.4382561120539
Task_46677,2667,86,131,165,296,30.655172413793103,49.25186978889845
Task_46678,2815,70,140,172,312,39.647887323943664,51.54979692613501
Task_46679,872,669,177,176,353,1.3014925373134327,23.629073466188853
Task_46680,1730,622,200,196,396,2.7768860353130016,37.355828026656845
Task_46681,1730,899,41,22,63,1.9222222222222223,35.17969665712357
Task_46682,2212,674,111,189,300,3.277037037037037,44.710792466727675
Task_46683,567,388,144,83,227,1.4575835475578407,17.15952725254895
Task_46684,988,274,19,128,147,3.5927272727272728,23.085881319847278
Task_46685,926,727,90,42,132,1.271978021978022,22.94066149600184
Task_46686,2984,194,73,136,209,15.302564102564103,54.84121259903139
Task_46687,1715,596,198,200,398,2.8726968174204357,37.05129440186531
Task_46688,948,567,135,176,311,1.6690140845070423,24.37358936154982
Task_46689,1496,232,57,177,234,6.420600858369099,31.69560304081592
Task_46690,2421,164,166,91,257,14.672727272727272,45.66009375923335
Task_46691,1872,680,47,122,169,2.748898678414097,38.647550722541276
Task_46692,2136,156,157,103,260,13.605095541401274,41.265511598116724
Task_46693,1896,573,40,144,184,3.303135888501742,38.77042857592675
Task_46694,1511,946,25,92,117,1.5955649419218585,33.21315021462454
Task_46695,1244,715,71,123,194,1.7374301675977655,28.977980682484567
Task_46696,1047,396,177,168,345,2.63727959697733,25.557799072601778
Task_46697,1396,403,99,92,191,3.4554455445544554,30.24664188915357
Task_46698,1633,550,51,95,146,2.9637023593466423,34.29408279605327
Task_46699,1396,409,22,60,82,3.4048780487804877,28.951778395510853
Task_46700,1537,144,54,49,103,10.6,29.82948633640311
Task_46701,2934,948,171,75,246,3.0916754478398314,56.42230784577858
Task_46702,2499,880,41,58,99,2.836549375709421,48.024977595843445
Task_46703,774,172,55,169,224,4.473988439306359,19.794659429574985
Task_46704,772,753,95,59,154,1.023872679045093,20.810369767011196
Task_46705,1871,585,157,158,315,3.1928327645051193,39.051362442135925
Task_46706,2101,982,135,22,157,2.1373346897253307,42.349885234572575
Task_46707,1809,405,45,77,122,4.455665024630542,36.23307528801706
Task_46708,1153,533,105,146,251,2.1591760299625467,27.212200811065475
Task_46709,1085,450,57,96,153,2.4057649667405765,25.255956917814824
Task_46710,619,865,194,106,300,0.7147806004618937,20.00767896946333
Task_46711,655,180,128,49,177,3.6187845303867405,17.064837382057608
Task_46712,767,676,71,93,164,1.1329394387001477,21.026888074077416
Task_46713,1540,860,131,120,251,1.7886178861788617,34.32448133565348
Task_46714,1519,201,91,141,232,7.51980198019802,31.818912194715285
Task_46715,1817,254,18,129,147,7.125490196078432,36.11967866910698
Task_46716,1242,138,160,139,299,8.93525179856115,27.262244713396708
Task_46717,1232,190,114,100,214,6.450261780104712,27.10799138176527
Task_46718,1801,566,144,68,212,3.17636684303351,37.0103202985177
Task_46719,1228,501,17,58,75,2.446215139442231,26.2673230787086
Task_46720,580,527,74,33,107,1.0984848484848484,16.515539108101482
Task_46721,1720,228,149,153,302,7.510917030567685,35.42424639440933
Task_46722,2139,601,20,148,168,3.553156146179402,42.60949562443648
Task_46723,2551,217,51,81,132,11.70183486238532,47.61446932492856
Task_46724,2341,334,156,58,214,6.988059701492538,44.7606613384134
Task_46725,2595,444,47,164,211,5.831460674157303,49.64103773699338
Task_46726,1368,271,56,141,197,5.029411764705882,29.590626744019257
Task_46727,2750,833,106,131,237,3.2973621103117505,53.364670556845965
Task_46728,1237,872,52,169,221,1.4169530355097366,29.519923871691564
Task_46729,575,587,99,177,276,0.9778911564625851,18.354202442392296
Task_46730,1052,856,180,155,335,1.2275379229871646,26.9454384895248
Task_46731,1694,586,162,118,280,2.885860306643952,36.035177050000144
Task_46732,1547,675,104,95,199,2.2884615384615383,33.60116006928758
Task_46733,1149,157,100,121,221,7.272151898734177,25.564972631947956
Task_46734,2107,803,106,95,201,2.620646766169154,42.88175206063571
Task_46735,1854,406,127,18,145,4.555282555282555,36.60067472777661
Task_46736,871,563,194,35,229,1.5443262411347518,22.067506353080756
Task_46737,1888,529,79,138,217,3.5622641509433963,38.731993717780384
Task_46738,1680,461,137,10,147,3.6363636363636362,34.001789483965645
Task_46739,2867,551,52,26,78,5.193840579710145,52.207467017852224
Task_46740,640,829,114,102,216,0.7710843373493976,19.78493670369286
Task_46741,2888,660,23,167,190,4.369137670196672,54.83011788728708
Task_46742,2294,346,10,60,70,6.610951008645533,42.61926163118488
Task_46743,1993,769,22,182,204,2.588311688311688,41.07862409034923
Task_46744,938,370,183,169,352,2.5283018867924527,23.783526793882988
Task_46745,957,64,88,19,107,14.723076923076922,19.988386165377275
Task_46746,1444,677,128,131,259,2.129793510324484,32.28566063503152
Task_46747,2768,468,151,176,327,5.901918976545843,52.95826109035992
Task_46748,1001,133,98,141,239,7.470149253731344,23.176740841332485
Task_46749,2986,347,127,16,143,8.580459770114942,54.241370608524726
Task_46750,1141,419,77,200,277,2.716666666666667,26.925756207229075
Task_46751,2889,646,26,96,122,4.4652241112828435,54.172440587503246
Task_46752,2983,646,134,152,286,4.6105100463678514,56.716545652773526
Task_46753,2647,125,83,62,145,21.00793650793651,47.999518637943645
Task_46754,625,524,197,179,376,1.1904761904761905,19.376309241519138
Task_46755,1070,84,145,94,239,12.588235294117647,23.832677758281346
Task_46756,2847,836,30,91,121,3.401433691756272,54.08516685579781
Task_46757,837,557,169,60,229,1.5,21.719004472626438
Task_46758,1700,206,91,130,221,8.21256038647343,34.62884135521685
Task_46759,1499,502,168,68,236,2.9801192842942346,32.13419475550321
Task_46760,969,906,85,38,123,1.0683572216097024,24.003385684136443
Task_46761,1533,627,200,196,396,2.4410828025477707,34.251526124125405
Task_46762,2436,336,96,26,122,7.228486646884273,45.314596328444935
Task_46763,560,995,70,33,103,0.5622489959839357,17.78322141738057
Task_46764,1301,375,67,33,100,3.4601063829787235,27.333272286122433
Task_46765,956,163,168,116,284,5.829268292682927,22.80985968620631
Task_46766,1204,356,120,186,306,3.372549019607843,27.764271066243605
Task_46767,1976,878,94,181,275,2.248009101251422,41.496663554817054
Task_46768,1699,115,116,29,145,14.64655172413793,32.75308223870157
Task_46769,1705,924,167,152,319,1.8432432432432433,37.491195739120094
Task_46770,1755,680,187,56,243,2.5770925110132157,36.733313775461035
Task_46771,2551,697,180,57,237,3.654727793696275,49.36317426571469
Task_46772,1760,257,28,197,225,6.821705426356589,35.866272771815595
Task_46773,2284,898,23,183,206,2.5406006674082313,46.10839853309773
Task_46774,1341,705,200,47,247,1.8994334277620397,30.07072460660451
Task_46775,2131,934,177,165,342,2.279144385026738,44.39534721732281
Task_46776,766,64,140,125,265,11.784615384615385,19.23749032141794
Task_46777,1175,647,104,181,285,1.8132716049382716,28.121774039887242
Task_46778,2571,998,193,123,316,2.5735735735735736,51.388407641021274
Task_46779,2520,854,51,50,101,2.9473684210526314,48.19163690909728
Task_46780,2083,827,176,65,241,2.5157004830917873,42.43760533110473
Task_46781,856,848,100,91,191,1.0082449941107186,22.992204137780643
Task_46782,988,623,51,92,143,1.5833333333333333,24.19494457846032
Task_46783,1399,811,143,109,252,1.7229064039408868,31.913124780664578
Task_46784,1605,218,109,20,129,7.328767123287672,31.93624745347472
Task_46785,939,430,171,170,341,2.1786542923433876,23.941308784216744
Task_46786,1615,1021,152,75,227,1.5802348336594911,35.6331669022073
Task_46787,1038,895,74,152,226,1.1584821428571428,26.394785336450482
Task_46788,1607,139,187,161,348,11.478571428571428,33.270505412283875
Task_46789,846,231,126,139,265,3.646551724137931,21.442968387674302
Task_46790,1372,489,73,31,104,2.8,28.848546636670296
Task_46791,2827,235,134,109,243,11.978813559322035,52.605101833688174
Task_46792,2587,727,88,132,220,3.5535714285714284,50.33264668368212
Task_46793,1145,73,110,189,299,15.472972972972974,25.399034726475293
Task_46794,684,103,126,40,166,6.576923076923077,16.867752473200508
Task_46795,2420,518,133,158,291,4.66281310211946,47.42265660329597
Task_46796,1960,561,123,86,209,3.487544483985765,39.735079115734514
Task_46797,1505,309,164,48,212,4.854838709677419,31.259280523940962
Task_46798,1164,85,119,142,261,13.534883720930232,25.48513600309069
Task_46799,1528,992,139,150,289,1.5387713997985901,34.71654387759623
Task_46800,2188,852,45,109,154,2.5650644783118404,43.91871800777781
Task_46801,1900,873,24,193,217,2.1739130434782608,40.010218186736715
Task_46802,2653,548,91,169,260,4.832422586520948,51.08402601775336
Task_46803,1139,791,20,66,86,1.4381313131313131,26.24219219869617
Task_46804,2207,684,171,129,300,3.221897810218978,44.57514717183087
Task_46805,2466,757,91,54,145,3.253298153034301,47.770369734830645
Task_46806,1547,679,96,179,275,2.275,34.07356073045369
Task_46807,2189,697,73,100,173,3.1361031518624642,43.74339704504168
Task_46808,2232,919,176,73,249,2.4260869565217393,45.16516712920053
Task_46809,1207,582,88,187,275,2.0703259005145798,28.34794919185659
Task_46810,1180,156,185,134,319,7.515923566878981,26.50793239940978
Task_46811,1009,877,141,26,167,1.1492027334851935,24.914509645009677
Task_46812,807,570,17,110,127,1.4133099824868651,20.96681203726605
Task_46813,2425,580,13,125,138,4.173838209982788,46.733359729075886
Task_46814,1186,180,54,29,83,6.552486187845304,24.58286530531443
Task_46815,535,565,178,72,250,0.9452296819787986,17.235251481421972
Task_46816,1687,593,170,189,359,2.84006734006734,36.40652372974929
Task_46817,2537,970,69,95,164,2.612770339855819,50.09122806144671
Task_46818,1602,299,175,173,348,5.34,34.04161820734131
Task_46819,2099,784,47,84,131,2.6738853503184714,42.2843996240427
Task_46820,1886,906,117,109,226,2.079382579933848,39.821090977447035
Task_46821,1217,895,27,101,128,1.3582589285714286,28.658911308630334
Task_46822,1167,256,161,42,203,4.5408560311284045,25.664435703818054
Task_46823,1327,950,145,34,179,1.3953732912723449,30.258031333903457
Task_46824,1031,775,122,114,236,1.3286082474226804,25.872895253655983
Task_46825,2004,913,172,26,198,2.192560175054705,40.93725611550636
Task_46826,530,214,43,169,212,2.4651162790697674,16.218411707275937
Task_46827,2917,146,180,69,249,19.843537414965986,53.07067412607706
Task_46828,817,325,87,154,241,2.5061349693251533,21.164082305170183
Task_46829,2761,539,122,114,236,5.112962962962963,52.57697044745502
Task_46830,2369,451,145,82,227,5.241150442477876,45.92747673303435
Task_46831,2854,911,184,94,278,3.129385964912281,55.38084233208267
Task_46832,2196,238,66,160,226,9.188284518828452,42.724412001675574
Task_46833,2706,382,48,165,213,7.065274151436031,51.22188342913994
Task_46834,1616,166,121,158,279,9.676646706586826,33.252055699706524
Task_46835,2836,274,133,64,197,10.312727272727273,52.343840402039085
Task_46836,1640,679,145,94,239,2.411764705882353,35.245459231605345
Task_46837,1371,425,89,95,184,3.2183098591549295,29.910136376664855
Task_46838,2772,293,89,67,156,9.428571428571429,51.05445392751803
Task_46839,2932,917,19,121,140,3.1938997821350763,55.84550028856091
Task_46840,1560,624,178,136,314,2.496,34.212196650693166
Task_46841,1165,466,78,97,175,2.4946466809421843,26.858652284127416
Task_46842,2535,324,20,138,158,7.8,47.77028067918753
Task_46843,2291,788,30,56,86,2.903675538656527,44.373121036603145
Task_46844,1269,446,44,199,243,2.838926174496644,28.83231154382683
Task_46845,1474,937,57,49,106,1.5714285714285714,31.817478824180693
Task_46846,2213,695,100,197,297,3.1795977011494254,44.79097946843043
Task_46847,1401,504,164,197,361,2.774257425742574,31.61783474578209
Task_46848,1022,892,58,130,188,1.1444568868980962,25.92418396850458
Task_46849,913,156,52,11,63,5.8152866242038215,19.712045829797884
Task_46850,643,71,61,12,73,8.930555555555555,14.328489848323839
Task_46851,711,850,160,118,278,0.8354876615746181,21.24712382905018
Task_46852,549,199,97,109,206,2.745,16.354842281006604
Task_46853,686,551,120,171,291,1.2427536231884058,20.026560510192493
Task_46854,2086,536,125,84,209,3.8845437616387337,41.63944589918756
Task_46855,1630,941,103,183,286,1.7303609341825903,36.23883091620842
Task_46856,2129,728,182,160,342,2.9204389574759944,43.7126559941037
Task_46857,690,1012,24,112,136,0.6811451135241856,20.738188733015416
Task_46858,2332,668,21,51,72,3.485799701046338,44.28246923138786
Task_46859,2212,214,74,103,177,10.288372093023256,42.54003682318339
Task_46860,2088,574,74,63,137,3.631304347826087,41.19959386947473
Task_46861,1270,82,66,107,173,15.301204819277109,26.675148644416982
Task_46862,2472,422,93,100,193,5.843971631205674,47.44543429697449
Task_46863,1030,121,136,182,318,8.442622950819672,23.979694847048894
Task_46864,781,545,145,100,245,1.4304029304029304,21.21131788000109
Task_46865,2298,316,74,96,170,7.249211356466877,44.247936615443244
Task_46866,1073,67,178,98,276,15.779411764705882,24.060738566241497
Task_46867,1552,924,159,161,320,1.6778378378378378,35.07106976131292
Task_46868,2448,142,46,19,65,17.11888111888112,43.847669261523414
Task_46869,2478,162,129,137,266,15.202453987730062,46.75377147372651
Task_46870,1720,359,146,80,226,4.777777777777778,35.32119043188289
Task_46871,556,579,85,37,122,0.9586206896551724,16.473625264434062
Task_46872,2501,414,60,69,129,6.026506024096386,47.313127925300925
Task_46873,549,66,164,49,213,8.194029850746269,14.654367636843785
Task_46874,1655,963,109,104,213,1.716804979253112,36.25845134186836
Task_46875,2828,185,34,62,96,15.204301075268818,51.000400444601894
Task_46876,1121,891,34,194,228,1.256726457399103,27.71774795372943
Task_46877,1273,869,168,126,294,1.4632183908045977,30.27068524591401
Task_46878,971,757,62,145,207,1.2810026385224274,24.82633275335343
Task_46879,739,930,54,106,160,0.7937701396348013,21.285309051815645
Task_46880,754,826,98,111,209,0.9117291414752116,21.544833793074503
Task_46881,2883,976,115,147,262,2.9508700102354144,56.055792661587475
Task_46882,612,367,54,132,186,1.6630434782608696,17.837496147241904
Task_46883,931,111,113,198,311,8.3125,22.288376733233395
Task_46884,1337,301,31,54,85,4.427152317880795,27.721877708871645
Task_46885,1418,135,55,15,70,10.426470588235293,27.468204822905715
Task_46886,1113,282,85,116,201,3.932862190812721,25.514522069100476
Task_46887,1692,852,78,191,269,1.9835873388042204,36.960098810331964
Task_46888,871,553,58,18,76,1.5722021660649819,20.39328117639114
Task_46889,1066,317,80,72,152,3.352201257861635,24.256753299193907
Task_46890,2843,267,33,72,105,10.60820895522388,51.811075698902194
Task_46891,760,309,68,37,105,2.4516129032258065,18.59193697406945
Task_46892,2686,389,123,51,174,6.887179487179488,50.1992936246179
Task_46893,960,507,135,95,230,1.889763779527559,23.919036299860135
Task_46894,2187,244,151,198,349,8.926530612244898,43.13687734845365
Task_46895,2145,117,16,164,180,18.177966101694917,40.704531000130835
Task_46896,1989,515,162,51,213,3.854651162790698,39.76694339989026
Task_46897,2567,758,111,20,131,3.3820816864295127,48.90832342821316
Task_46898,1922,80,131,40,171,23.728395061728396,35.96417289207536
Task_46899,1685,195,188,128,316,8.596938775510203,34.77923125876219
Task_46900,549,349,84,17,101,1.5685714285714285,15.239897750762266
Task_46901,585,1010,55,40,95,0.5786350148367952,18.187222543824195
Task_46902,2732,918,97,158,255,2.9727965179542983,53.474062797103464
Task_46903,2462,496,84,30,114,4.953722334004024,46.239772702840234
Task_46904,2102,423,106,48,154,4.9575471698113205,40.65738990089981
Task_46905,1523,675,175,118,293,2.252958579881657,33.66491318685707
Task_46906,1600,733,169,76,245,2.1798365122615806,34.61632321373706
Task_46907,2258,1018,32,200,232,2.215897939156035,46.22224910016033
Task_46908,2356,718,153,116,269,3.2767732962447846,46.88362524341719
Task_46909,2846,360,104,101,205,7.883656509695291,53.17240441105753
Task_46910,1563,832,21,148,169,1.8763505402160865,34.210460874299464
Task_46911,1685,102,81,143,224,16.359223300970875,33.66740010847237
Task_46912,1151,994,42,65,107,1.1567839195979899,27.34900803044289
Task_46913,1865,810,53,49,102,2.2996300863131935,37.61860094056288
Task_46914,1001,903,19,137,156,1.1073008849557522,25.21519456228052
Task_46915,2694,414,14,97,111,6.491566265060241,50.24682103855295
Task_46916,656,430,151,29,180,1.5220417633410672,18.021423203454074
Task_46917,2283,276,74,192,266,8.24187725631769,44.44657854167148
Task_46918,2010,949,62,192,254,2.1157894736842104,42.23473598089251
Task_46919,1059,700,89,155,244,1.5106990014265336,26.1602619492857
Task_46920,2192,490,19,122,141,4.464358452138493,42.783710764752755
Task_46921,2544,871,164,156,320,2.9174311926605503,50.630521774643796
Task_46922,1002,502,79,77,156,1.9920477137176937,23.964380181417038
Task_46923,2586,931,16,200,216,2.774678111587983,51.051902409933206
Task_46924,503,368,120,180,300,1.3631436314363143,16.630307898919174
Task_46925,1408,392,104,111,215,3.5826972010178118,30.5875980727663
Task_46926,1076,132,162,134,296,8.090225563909774,24.5972285377109
Task_46927,1584,354,184,178,362,4.461971830985916,34.00948973771985
Task_46928,627,255,190,27,217,2.44921875,17.153642649922123
Task_46929,2407,269,151,80,231,8.914814814814815,45.89952550059562
Task_46930,1818,114,165,91,256,15.808695652173913,35.74431578551383
Task_46931,1399,252,142,30,172,5.529644268774703,29.14699162559741
Task_46932,1153,510,190,87,277,2.2563600782778863,27.109249635276104
Task_46933,2584,478,34,16,50,5.3945720250521925,47.2577735565936
Task_46934,1054,152,40,94,134,6.888888888888889,23.23682922380608
Task_46935,544,1015,47,155,202,0.5354330708661418,18.96392438358507
Task_46936,1505,676,144,144,288,2.2230428360413588,33.39850775684936
Task_46937,2195,858,43,124,167,2.5552968568102443,44.28998966696472
Task_46938,1757,201,189,141,330,8.698019801980198,36.01804894086419
Task_46939,1688,394,54,198,252,4.273417721518987,35.38876707649711
Task_46940,2089,253,17,116,133,8.224409448818898,40.33534894354698
Task_46941,767,69,184,163,347,10.957142857142857,19.655720151346266
Task_46942,1071,952,184,130,314,1.123819517313746,27.398547110804206
Task_46943,2068,64,70,71,141,31.815384615384616,38.29921786610498
Task_46944,2383,897,137,157,294,2.653674832962138,48.04501159540348
Task_46945,1173,514,34,82,116,2.2776699029126215,26.551408205084126
Task_46946,2194,749,173,86,259,2.925333333333333,44.25935441969664
Task_46947,2590,636,100,58,158,4.065934065934066,49.31344764721149
Task_46948,851,456,14,35,49,1.8621444201312911,19.89851010654607
Task_46949,2144,930,180,181,361,2.3029001074113857,44.697976143233234
Task_46950,1084,233,166,91,257,4.632478632478633,25.047577120483982
Task_46951,1669,797,178,87,265,2.091478696741855,36.1256007210723
Task_46952,1753,663,200,122,322,2.6400602409638556,37.40691939802343
Task_46953,872,311,41,81,122,2.7948717948717947,21.150693707880446
Task_46954,1210,782,186,180,366,1.5453384418901661,29.41725896066157
Task_46955,1069,200,192,53,245,5.318407960199005,24.39059192746195
Task_46956,2697,268,35,16,51,10.026022304832713,48.33941336978532
Task_46957,1125,732,148,156,304,1.534788540245566,27.600698048914765
Task_46958,818,1015,123,86,209,0.8051181102362205,23.0511502583788
Task_46959,2315,76,141,15,156,30.064935064935064,41.74018458016021
Task_46960,553,847,54,83,137,0.652122641509434,18.111083479340966
Task_46961,994,444,28,46,74,2.2337078651685394,22.186893467122218
Task_46962,943,783,28,70,98,1.2028061224489797,23.29044696411727
Task_46963,911,345,157,126,283,2.632947976878613,22.90267726266015
Task_46964,2059,484,148,84,232,4.245360824742268,41.149210136611366
Task_46965,749,400,109,143,252,1.8678304239401495,20.3993046346977
Task_46966,1133,940,73,22,95,1.20403825717322,26.476628481905934
Task_46967,1973,701,179,127,306,2.8105413105413106,40.946128051146445
Task_46968,1716,967,133,92,225,1.7727272727272727,37.22219944689232
Task_46969,2406,569,134,145,279,4.221052631578948,47.29123873922273
Task_46970,1110,381,179,39,218,2.905759162303665,25.234151865842776
Task_46971,1967,730,37,90,127,2.6908344733242133,39.99251639072916
Task_46972,835,360,131,132,263,2.3130193905817173,21.66692926128104
Task_46973,1435,755,94,159,253,1.8981481481481481,32.41072860010843
Task_46974,2845,173,131,196,327,16.350574712643677,52.921923596210945
Task_46975,2683,678,33,133,166,3.95139911634757,51.47323434288736
Task_46976,2810,793,24,56,80,3.53904282115869,52.49033044477448
Task_46977,2292,753,74,150,224,3.0397877984084882,45.88736530872296
Task_46978,1248,446,93,63,156,2.791946308724832,27.51601433090607
Task_46979,2156,752,177,177,354,2.863213811420983,44.29466730801295
Task_46980,989,517,46,80,126,1.9092664092664093,23.81506897534669
Task_46981,631,1022,127,145,272,0.6168132942326491,20.661597314776365
Task_46982,2986,707,138,73,211,4.2175141242937855,56.274231793995455
Task_46983,1116,846,119,64,183,1.3175914994096811,26.855099214661163
Task_46984,1726,590,167,69,236,2.9204737732656514,36.00008902759185
Task_46985,1425,901,152,125,277,1.5798226164079823,32.711435292643664
Task_46986,1612,507,122,173,295,3.173228346456693,34.63517641539067
Task_46987,2228,431,82,168,250,5.157407407407407,43.97356298407343
Task_46988,1465,426,117,190,307,3.430913348946136,32.12918671718873
Task_46989,839,355,95,196,291,2.356741573033708,21.944629364756093
Task_46990,999,936,17,162,179,1.0661686232657417,25.5588046145252
Task_46991,657,194,152,29,181,3.3692307692307693,17.302687498173732
Task_46992,2952,329,21,193,214,8.945454545454545,54.8989371548521
Task_46993,1069,471,101,84,185,2.264830508474576,25.187153032976738
Task_46994,2798,350,46,176,222,7.971509971509971,52.59916468057914
Task_46995,769,826,59,111,170,0.9298669891172914,21.57007439243628
Task_46996,1926,603,65,157,222,3.1887417218543046,39.628366610182255
Task_46997,1017,863,16,93,109,1.1770833333333333,25.014722758208062
Task_46998,2386,856,87,148,235,2.7841306884480748,47.645612486041294
Task_46999,2468,405,178,153,331,6.078817733990148,47.98720450135395
Task_47000,1889,1009,35,75,110,1.8702970297029704,39.29401867640273
Task_47001,1997,580,96,79,175,3.4371772805507743,40.16621189537697
Task_47002,1534,959,93,178,271,1.5979166666666667,34.73697897296754
Task_47003,1973,959,60,105,165,2.0552083333333333,41.123410402912576
Task_47004,798,768,17,90,107,1.0377113133940181,21.124519379295872
Task_47005,1351,456,52,26,78,2.9562363238512037,27.902568124991415
Task_47006,2277,821,154,84,238,2.77007299270073,45.693985720654894
Task_47007,574,64,138,76,214,8.830769230769231,15.597436725903654
Task_47008,2263,75,171,114,285,29.776315789473685,42.706898043395505
Task_47009,660,140,49,30,79,4.680851063829787,16.02493522695283
Task_47010,2673,661,185,62,247,4.037764350453172,51.22663151515877
Task_47011,1146,348,61,182,243,3.2836676217765044,26.598340776794146
Task_47012,2640,466,113,138,251,5.653104925053533,50.527351625457676
Task_47013,1432,589,78,23,101,2.4271186440677965,30.046243424320977
Task_47014,1472,829,187,109,296,1.7734939759036144,33.32397941530565
Task_47015,943,337,43,43,86,2.789940828402367,21.42321159460003
Task_47016,1569,707,177,146,323,2.2161016949152543,34.66985203643339
Task_47017,2471,947,18,106,124,2.6065400843881856,48.52695519712744
Task_47018,2375,542,138,101,239,4.373848987108656,46.469268182386315
Task_47019,2991,832,70,127,197,3.590636254501801,57.06620331388388
Task_47020,2331,253,143,14,157,9.17716535433071,43.61011218687745
Task_47021,1780,156,36,131,167,11.337579617834395,35.08978018992061
Task_47022,2391,644,121,54,175,3.7069767441860466,46.37766530587774
Task_47023,2074,258,119,189,308,8.007722007722007,41.20392356314839
Task_47024,2114,837,165,191,356,2.522673031026253,43.924741089470054
Task_47025,2217,512,119,142,261,4.321637426900585,44.030766509513626
Task_47026,2478,692,98,154,252,3.5757575757575757,48.71753927287788
Task_47027,2633,120,194,26,220,21.760330578512395,48.01057263610898
Task_47028,1055,533,150,124,274,1.9756554307116105,25.731951342880375
Task_47029,1264,325,61,174,235,3.8773006134969323,28.34228272796159
Task_47030,2485,273,71,48,119,9.069343065693431,45.914102726968316
Task_47031,2086,551,161,68,229,3.778985507246377,41.55221107147489
Task_47032,2608,520,99,40,139,5.005758157389636,48.85719054610062
Task_47033,1609,941,133,152,285,1.708067940552017,35.85611377077449
Task_47034,1065,547,66,76,142,1.9434306569343065,25.09868296430409
Task_47035,1890,969,126,145,271,1.9484536082474226,40.335946138243266
Task_47036,1639,644,138,135,273,2.5410852713178294,35.33989885099847
Task_47037,2910,1015,77,151,228,2.8641732283464565,56.52496101271566
Task_47038,2588,262,93,189,282,9.840304182509506,49.26211993904113
Task_47039,2317,591,92,175,267,3.9138513513513513,45.94950028728846
Task_47040,2820,305,132,172,304,9.215686274509803,53.12012966517324
Task_47041,1454,640,162,15,177,2.268330733229329,31.191969840722404
Task_47042,1722,351,60,151,211,4.892045454545454,35.53178494929693
Task_47043,817,933,66,167,233,0.8747323340471093,23.09504200488559
Task_47044,662,874,119,197,316,0.7565714285714286,20.829095200608243
Task_47045,562,1009,154,42,196,0.5564356435643565,18.71007288192625
Task_47046,2703,117,182,152,334,22.906779661016948,50.27466490524097
Task_47047,2416,687,50,33,83,3.511627906976744,45.79441088561311
Task_47048,1310,865,71,134,205,1.51270207852194,30.53050335954332
Task_47049,955,151,186,49,235,6.282894736842105,21.94633385513625
Task_47050,1479,642,153,97,250,2.300155520995334,32.66851908543233
Task_47051,1991,827,83,57,140,2.404589371980676,40.3861012400303
Task_47052,2420,512,10,124,134,4.717348927875244,46.41049561933358
Task_47053,1444,1023,44,176,220,1.41015625,33.212800195799815
Task_47054,2729,752,52,108,160,3.6241699867197874,52.27369273609006
Task_47055,1947,813,166,188,354,2.391891891891892,41.19049497519996
Task_47056,1230,790,141,43,184,1.5549936788874843,28.24644896429427
Task_47057,1645,859,25,38,63,1.9127906976744187,33.768166693286325
Task_47058,2455,396,126,11,137,6.183879093198993,45.94044276044553
Task_47059,2550,125,193,161,354,20.238095238095237,48.04233150669999
Task_47060,2181,490,14,128,142,4.441955193482689,42.62023219814267
Task_47061,2093,162,151,125,276,12.840490797546012,40.71127209353775
Task_47062,642,902,179,37,216,0.7109634551495017,19.674144769276086
Task_47063,999,295,44,55,99,3.375,22.418964689650483
Task_47064,1668,548,126,150,276,3.0382513661202184,35.53235965534737
Task_47065,946,461,61,179,240,2.0476190476190474,23.774852438552216
Task_47066,2190,561,124,70,194,3.8967971530249113,43.07264457524261
Task_47067,1489,871,155,19,174,1.7075688073394495,32.46298832487525
Task_47068,1274,556,180,149,329,2.287253141831239,29.55626360731991
Task_47069,2670,620,162,41,203,4.299516908212561,50.6279741225981
Task_47070,603,710,136,119,255,0.8481012658227848,19.001706041107465
Task_47071,2299,399,194,136,330,5.7475,45.26373249217787
Task_47072,2091,443,193,188,381,4.70945945945946,42.42202553860247
Task_47073,2863,270,120,112,232,10.564575645756458,53.260888322786116
Task_47074,2658,384,191,82,273,6.903896103896104,50.486909757390016
Task_47075,2214,181,38,33,71,12.164835164835164,40.61162846497962
Task_47076,1478,716,73,66,139,2.0613668061366806,32.01550872576393
Task_47077,2152,952,147,44,191,2.2581322140608604,43.407139602497494
Task_47078,1010,993,49,104,153,1.0160965794768613,25.644958013071236
Task_47079,2308,74,190,55,245,30.773333333333333,42.69847457553298
Task_47080,2334,528,180,109,289,4.4120982986767485,46.01231675347253
Task_47081,790,262,172,76,248,3.0038022813688214,20.319496726755187
Task_47082,2988,879,11,193,204,3.3954545454545455,57.18239762502976
Task_47083,2841,442,109,35,144,6.413092550790068,52.37217564249165
Task_47084,1250,529,67,62,129,2.358490566037736,27.776982822862532
Task_47085,1898,378,20,162,182,5.007915567282322,38.17184752728659
Task_47086,2501,758,30,133,163,3.2951251646903823,48.79832212284456
Task_47087,1362,693,69,148,217,1.962536023054755,30.94482090938567
Task_47088,651,593,144,158,302,1.095959595959596,19.634014565014414
Task_47089,2473,713,143,121,264,3.4635854341736696,48.70604532004776
Task_47090,861,989,99,48,147,0.8696969696969697,22.82226247928341
Task_47091,1752,674,174,81,255,2.5955555555555554,36.95938092962718
Task_47092,1236,849,55,199,254,1.4541176470588235,29.623038590716757
Task_47093,2610,786,133,158,291,3.3163913595933927,51.281998316694285
Task_47094,888,920,121,166,287,0.9641693811074918,24.375349031489105
Task_47095,2781,313,134,16,150,8.856687898089172,50.913606972575586
Task_47096,2355,622,108,166,274,3.780096308186196,46.660426521826345
Task_47097,2073,560,157,164,321,3.695187165775401,42.206685053938024
Task_47098,2622,993,190,103,293,2.6378269617706236,52.048039716272626
Task_47099,918,420,195,170,365,2.1805225653206652,23.685576416792276
Task_47100,1639,585,124,136,260,2.7969283276450514,35.09729417430827
Task_47101,2144,965,175,148,323,2.219461697722567,44.58728682947673
Task_47102,2540,614,114,145,259,4.130081300813008,49.466535701995475
Task_47103,995,938,21,157,178,1.0596379126730564,25.51080764506894
Task_47104,1502,572,123,16,139,2.6212914485165792,31.43350017396666
Task_47105,1878,799,147,107,254,2.3475,39.48416210196863
Task_47106,2048,690,137,133,270,2.963820549927641,41.94613388264221
Task_47107,1944,274,100,16,116,7.069090909090909,37.19595866237873
Task_47108,1360,134,141,153,294,10.074074074074074,29.09931041196178
Task_47109,1727,79,122,141,263,21.5875,34.282561356556016
Task_47110,2192,817,87,172,259,2.6797066014669926,44.59328803142551
Task_47111,1181,179,26,104,130,6.561111111111111,25.23808954638345
Task_47112,649,944,14,65,79,0.6867724867724868,18.91329164645178
Task_47113,1134,281,104,16,120,4.0212765957446805,24.424968214950592
Task_47114,2833,880,62,155,217,3.2156640181611804,54.83927592797735
Task_47115,2410,527,135,157,292,4.5643939393939394,47.29629851567984
Task_47116,1503,845,179,80,259,1.7765957446808511,33.560261512850424
Task_47117,546,684,92,163,255,0.7970802919708029,18.097950906966606
Task_47118,723,474,71,196,267,1.5221052631578946,20.38673734164431
Task_47119,2888,338,135,193,328,8.519174041297935,54.45020723274217
Task_47120,1190,644,26,171,197,1.8449612403100775,27.9243587531609
Task_47121,2007,606,91,110,201,3.3064250411861615,40.68667146217755
Task_47122,2266,947,87,136,223,2.390295358649789,45.95646943282129
Task_47123,2426,295,144,155,299,8.195945945945946,46.808042798290785
Task_47124,648,1008,91,190,281,0.6422200198216056,20.990820698749715
Task_47125,1206,748,128,157,285,1.610146862483311,28.878729098609558
Task_47126,2855,85,148,63,211,33.19767441860465,51.208602351368434
Task_47127,2675,407,17,103,120,6.556372549019608,49.924525780386574
Task_47128,1732,342,111,143,254,5.049562682215743,35.77295382878157
Task_47129,2682,106,24,68,92,25.065420560747665,47.81239840103898
Task_47130,1085,445,176,159,335,2.4327354260089686,26.256237362528577
Task_47131,1469,1005,158,190,348,1.4602385685884691,34.135293584152336
Task_47132,1981,101,158,34,192,19.42156862745098,37.38346925385442
Task_47133,1071,486,54,177,231,2.1991786447638604,25.791602153174207
Task_47134,2283,249,110,14,124,9.132,42.5614459487407
Task_47135,763,94,177,18,195,8.031578947368422,17.972731565564107
Task_47136,2067,119,115,83,198,17.225,39.45058048483777
Task_47137,2567,334,85,101,186,7.6626865671641795,48.55724809798983
Task_47138,2035,516,163,101,264,3.9361702127659575,41.11553205689092
Task_47139,2964,918,176,99,275,3.2252448313384114,57.14024167057543
Task_47140,2209,797,183,116,299,2.7681704260651627,44.937976684055975
Task_47141,1995,811,40,152,192,2.456896551724138,41.17169314980265
Task_47142,1780,254,130,34,164,6.980392156862745,35.16521924842737
Task_47143,1667,480,166,23,189,3.4656964656964657,34.16885852976686
Task_47144,2689,539,173,126,299,4.979629629629629,51.73848609921392
Task_47145,2163,478,149,157,306,4.515657620041754,43.291363784300756
Task_47146,2101,823,60,58,118,2.549757281553398,41.77537716595352
Task_47147,1611,102,33,139,172,15.640776699029127,32.08426200699869
Task_47148,2314,962,100,147,247,2.402907580477674,46.92784057995527
Task_47149,915,637,42,64,106,1.4341692789968652,22.40583400947413
Task_47150,722,756,171,26,197,0.9537648612945839,20.244323574207304
Task_47151,1355,262,16,37,53,5.152091254752852,27.282130860245847
Task_47152,2391,892,196,19,215,2.677491601343785,47.02683242718957
Task_47153,2525,432,28,111,139,5.831408775981524,47.84197620840724
Task_47154,959,912,48,21,69,1.0503833515881709,23.079845917222997
Task_47155,987,117,142,200,342,8.364406779661017,23.38953056200336
Task_47156,2614,976,165,166,331,2.6755373592630503,52.1318815758832
Task_47157,1344,753,101,125,226,1.7824933687002653,30.76762963734136
Task_47158,2545,246,12,162,174,10.303643724696355,47.90060627819741
Task_47159,894,111,42,108,150,7.982142857142857,20.383299669536687
Task_47160,1412,322,106,118,224,4.371517027863777,30.474174090674467
Task_47161,1881,815,57,133,190,2.3051470588235294,39.39464859700575
Task_47162,596,175,29,27,56,3.3863636363636362,15.02417681552884
Task_47163,1371,800,138,141,279,1.7116104868913857,31.603914790372528
Task_47164,2141,201,167,99,266,10.599009900990099,41.72343401061195
Task_47165,709,404,178,88,266,1.7506172839506173,19.69293581974047
Task_47166,2166,795,59,186,245,2.721105527638191,44.17962386426635
Task_47167,1609,637,151,83,234,2.5219435736677114,34.518875077759795
Task_47168,2679,458,132,147,279,5.836601307189542,51.25789816168011
Task_47169,1859,598,30,171,201,3.1035058430717863,38.410853030826296
Task_47170,1127,117,57,149,206,9.55084745762712,24.922567603453114
Task_47171,2854,1011,175,12,187,2.8201581027667983,54.584149848473345
Task_47172,2332,384,99,72,171,6.057142857142857,44.65038086759299
Task_47173,1114,817,118,196,314,1.3618581907090463,27.78990493158995
Task_47174,832,377,169,58,227,2.201058201058201,21.089942669792915
Task_47175,1749,350,41,105,146,4.982905982905983,35.36239003359123
Task_47176,1073,297,66,196,262,3.6006711409395975,25.394970539295
Task_47177,861,375,189,190,379,2.2898936170212765,22.73369879601111
Task_47178,2808,679,44,143,187,4.129411764705883,53.59336390002517
Task_47179,1186,584,64,84,148,2.0273504273504273,27.269399268499143
Task_47180,2541,712,94,131,225,3.5638148667601683,49.62924291586983
Task_47181,934,899,164,188,352,1.0377777777777777,25.338313880808712
Task_47182,913,502,111,84,195,1.8151093439363817,22.895366204646905
Task_47183,2147,526,200,188,388,4.074003795066414,43.60715619854347
Task_47184,812,714,175,164,339,1.1356643356643357,22.729990732849853
Task_47185,2051,847,30,115,145,2.418632075471698,41.718675974252704
Task_47186,1735,310,137,21,158,5.578778135048232,34.42627646550084
Task_47187,1378,999,111,126,237,1.378,32.08048357627698
Task_47188,2375,611,109,63,172,3.880718954248366,46.01408407400701
Task_47189,2329,841,158,81,239,2.7660332541567696,46.551000767328595
Task_47190,638,266,42,80,122,2.3895131086142323,17.31804478691289
Task_47191,885,776,126,102,228,1.138996138996139,23.48742741645421
Task_47192,850,310,87,194,281,2.733118971061093,21.876767134068484
Task_47193,976,379,139,180,319,2.568421052631579,24.280751066757787
Task_47194,1741,878,182,180,362,1.9806598407281002,38.153471066208525
Task_47195,1563,1024,88,74,162,1.5248780487804878,34.36987556209048
Task_47196,823,332,39,23,62,2.4714714714714714,19.048975508286173
Task_47197,2108,678,93,30,123,3.1045655375552283,41.39596400446064
Task_47198,1264,318,176,199,375,3.9623824451410656,28.919928547966524
Task_47199,1978,299,29,181,210,6.593333333333334,39.37850157911029
Task_47200,884,623,106,117,223,1.4166666666666667,23.011010281585914
Task_47201,2825,212,196,186,382,13.262910798122066,53.22178022740902
Task_47202,2474,263,70,133,203,9.371212121212121,47.06005358044113
Task_47203,2106,682,16,86,102,3.0834553440702783,41.59665087365641
Task_47204,2231,258,175,158,333,8.613899613899614,43.75206862819949
Task_47205,986,767,108,188,296,1.2838541666666667,25.499787673945857
Task_47206,1707,781,77,69,146,2.182864450127877,35.91666640959906
Task_47207,539,618,53,71,124,0.8707592891760905,16.784211984824786
Task_47208,2905,380,59,101,160,7.624671916010499,53.84578657825792
Task_47209,1805,255,157,54,211,7.05078125,36.011950063541036
Task_47210,1183,620,27,180,207,1.9049919484702094,27.8011995021232
Task_47211,2472,459,198,145,343,5.373913043478261,48.27018502196527
Task_47212,1564,86,195,38,233,17.977011494252874,30.794109898265628
Task_47213,1215,156,74,171,245,7.738853503184713,26.862906181973585
Task_47214,589,104,114,71,185,5.609523809523809,15.710490787720772
Task_47215,1968,915,115,155,270,2.148471615720524,41.41417169598544
Task_47216,811,878,157,83,240,0.9226393629124005,22.64080152749952
Task_47217,2646,614,92,170,262,4.302439024390244,51.203104376044
Task_47218,668,381,199,190,389,1.7486910994764397,19.730801800464608
Task_47219,840,662,78,148,226,1.2669683257918551,22.546216230867685
Task_47220,1511,616,80,99,179,2.4489465153970826,32.77114689066452
Task_47221,2602,188,26,44,70,13.767195767195767,46.8419189846596
Task_47222,744,215,124,27,151,3.4444444444444446,18.46132195634026
Task_47223,2626,410,114,141,255,6.3892944038929445,50.14388352405867
Task_47224,613,770,71,190,261,0.795071335927367,19.534832707847347
Task_47225,1753,323,42,63,105,5.410493827160494,34.69576451228426
Task_47226,959,213,125,92,217,4.481308411214953,22.829928263456978
Task_47227,1486,505,68,84,152,2.9367588932806323,31.71581121683864
Task_47228,1393,355,10,158,168,3.912921348314607,30.003495170090407
Task_47229,1891,443,117,76,193,4.259009009009009,38.071444690426155
Task_47230,1158,480,49,98,147,2.4074844074844073,26.523759622480608
Task_47231,2036,383,84,72,156,5.302083333333333,39.84241727146867
Task_47232,1173,280,114,133,247,4.174377224199288,26.682558197055112
Task_47233,2959,364,23,166,189,8.106849315068493,54.98122483585842
Task_47234,2150,673,115,112,227,3.1899109792284865,43.2837068591623
Task_47235,2405,237,18,29,47,10.105042016806722,43.670955668213175
Task_47236,2881,541,132,87,219,5.31549815498155,54.305883961290256
Task_47237,533,493,132,141,273,1.0789473684210527,17.29545102735091
Task_47238,1347,582,130,83,213,2.3104631217838767,30.1023611623188
Task_47239,1566,369,188,163,351,4.232432432432432,33.702139123407896
Task_47240,539,486,59,91,150,1.106776180698152,16.614389595225514
Task_47241,2929,419,155,75,230,6.973809523809524,54.582854142543205
Task_47242,948,848,184,111,295,1.11660777385159,25.0142082486632
Task_47243,696,262,147,124,271,2.6463878326996197,19.179692041428822
Task_47244,2547,816,108,59,167,3.1175030599755202,49.343337002365224
Task_47245,841,680,108,195,303,1.234948604992658,22.97141037970854
Task_47246,696,528,45,91,136,1.3156899810964082,19.168777015276998
Task_47247,2133,998,117,78,195,2.135135135135135,43.71118181952636
Task_47248,2826,803,39,19,58,3.514925373134328,52.17224933593477
Task_47249,1182,616,122,65,187,1.9157212317666126,27.24118181178535
Task_47250,902,214,159,163,322,4.195348837209302,22.562445064170117
Task_47251,689,1011,114,131,245,0.6808300395256917,21.384754990675138
Task_47252,1213,233,163,136,299,5.183760683760684,27.395396582377874
Task_47253,514,427,133,77,210,1.2009345794392523,16.280691042054205
Task_47254,2709,828,131,191,322,3.267792521109771,53.17043986373303
Task_47255,886,894,151,12,163,0.9899441340782122,23.060010687130553
Task_47256,666,950,24,166,190,0.7003154574132492,20.60480544759164
Task_47257,2251,146,143,94,237,15.312925170068027,42.861046795923166
Task_47258,1329,477,52,164,216,2.780334728033473,29.76272915799265
Task_47259,2349,552,24,96,120,4.247739602169982,45.284658097178884
Task_47260,2642,481,179,171,350,5.481327800829876,51.10248747880098
Task_47261,538,695,88,134,222,0.7729885057471264,17.767837814894655
Task_47262,1723,119,136,198,334,14.358333333333333,34.960615738320314
Task_47263,1939,650,139,197,336,2.978494623655914,40.48512723315972
Task_47264,746,94,63,24,87,7.852631578947369,16.764916313024774
Task_47265,2457,927,120,185,305,2.6476293103448274,49.40183782437788
Task_47266,2434,857,72,123,195,2.836829836829837,48.29201497650181
Task_47267,2405,916,137,152,289,2.6226826608505998,48.42304895329977
Task_47268,1511,309,197,105,302,4.874193548387097,32.32918801388113
Task_47269,1478,934,91,184,275,1.5807486631016043,33.73449927470585
Task_47270,2061,914,56,171,227,2.2524590163934426,42.78394249721498
Task_47271,1048,384,90,38,128,2.722077922077922,23.870355894114017
Task_47272,2374,474,68,178,246,4.997894736842105,46.45203966946412
Task_47273,1326,86,74,113,187,15.241379310344827,27.714845075808324
Task_47274,1602,508,169,30,199,3.1473477406679766,33.33230966215207
Task_47275,753,932,152,72,224,0.8070739549839229,21.686846612143906
Task_47276,730,760,170,23,193,0.9592641261498029,20.342492315830945
Task_47277,638,70,191,105,296,8.985915492957746,17.328972622137034
Task_47278,2112,470,80,66,146,4.484076433121019,41.32787561681891
Task_47279,1845,731,25,81,106,2.5204918032786887,37.661894852483776
Task_47280,1647,574,60,169,229,2.8643478260869566,35.16733726084161
Task_47281,2629,293,15,101,116,8.9421768707483,48.83205826348202
Task_47282,919,790,133,166,299,1.161820480404551,24.483277622280593
Task_47283,2114,888,111,63,174,2.377952755905512,42.766279005426135
Task_47284,567,587,143,10,153,0.9642857142857143,16.89071451434744
Task_47285,2607,853,120,36,156,3.0526932084309135,50.023167934810225
Task_47286,873,72,43,113,156,11.95890410958904,19.909984072150806
Task_47287,1036,199,128,134,262,5.18,24.323023886923433
Task_47288,1161,464,79,73,152,2.496774193548387,26.241318687413923
Task_47289,2555,909,83,50,133,2.8076923076923075,49.40695883028754
Task_47290,842,584,159,19,178,1.4393162393162393,21.35641998375772
Task_47291,2926,163,30,128,158,17.841463414634145,52.92449921956881
Task_47292,2082,987,75,185,260,2.1072874493927127,43.50831776995199
Task_47293,670,81,95,42,137,8.170731707317072,16.06896998400563
Task_47294,1918,359,28,84,112,5.3277777777777775,37.76186586118789
Task_47295,2637,453,133,190,323,5.808370044052864,50.838073616388954
Task_47296,2812,1009,167,71,238,2.784158415841584,54.57192949441153
Task_47297,2504,97,80,96,176,25.551020408163264,46.14708710424708
Task_47298,2587,685,194,154,348,3.771137026239067,50.85041521417562
Task_47299,1010,99,21,194,215,10.1,22.977983972888524
Task_47300,2386,304,130,128,258,7.822950819672132,45.98271445763455
Task_47301,1630,879,59,23,82,1.8522727272727273,33.83085987787276
Task_47302,2302,537,98,198,296,4.278810408921933,45.70074037737666
Task_47303,1188,688,151,91,242,1.7242380261248185,28.061384413018285
Task_47304,1128,778,135,185,320,1.44801026957638,27.89463001124706
Task_47305,1515,868,116,17,133,1.7433831990794015,32.560369903085906
Task_47306,1703,130,172,84,256,13.0,34.067037777015614
Task_47307,2990,513,183,79,262,5.817120622568093,56.082168623414475
Task_47308,1718,554,24,94,118,3.0954954954954954,35.28872234114524
Task_47309,1462,548,151,45,196,2.663023679417122,31.229721932456414
Task_47310,1438,927,45,10,55,1.5495689655172413,30.530058348313702
Task_47311,1480,252,87,36,123,5.849802371541502,29.96070758578908
Task_47312,2211,767,110,187,297,2.87890625,44.97076039984699
Task_47313,829,107,38,26,64,7.675925925925926,18.18502517765355
Task_47314,2837,961,49,13,62,2.949064449064449,52.79725906483009
Task_47315,1939,89,98,56,154,21.544444444444444,36.39923798668426
Task_47316,2337,775,126,116,242,3.01159793814433,46.64001654377905
Task_47317,1893,944,127,84,211,2.003174603174603,39.871343144402
Task_47318,2378,708,29,76,105,3.3540197461212977,45.9688272968289
Task_47319,2295,194,39,136,175,11.76923076923077,43.730113770662086
Task_47320,701,456,173,197,370,1.5339168490153172,20.38364493158003
Task_47321,566,332,120,175,295,1.6996996996996998,17.51722139027036
Task_47322,686,530,155,86,241,1.2919020715630884,19.55228818300114
Task_47323,2826,674,161,55,216,4.1866666666666665,53.556253697910286
Task_47324,1717,65,97,47,144,26.015151515151516,32.2892388625884
Task_47325,2826,145,78,97,175,19.356164383561644,51.698048461287534
Task_47326,550,108,170,142,312,5.045871559633028,16.202000948171836
Task_47327,1626,347,75,183,258,4.672413793103448,34.254283492035555
Task_47328,2350,236,184,20,204,9.915611814345992,44.19882559476957
Task_47329,1046,1020,19,166,185,1.0244857982370226,26.602197205823604
Task_47330,2144,803,31,33,64,2.6666666666666665,41.46115658462632
Task_47331,667,400,196,100,296,1.6633416458852868,19.223627985838935
Task_47332,2583,246,77,39,116,10.45748987854251,47.285055620021076
Task_47333,656,300,151,61,212,2.179401993355482,17.982422619244364
Task_47334,2454,673,73,135,208,3.6409495548961424,48.106912810385374
Task_47335,932,937,138,180,318,0.9936034115138592,25.292491417974176
Task_47336,2118,684,181,127,308,3.091970802919708,43.198530816796506
Task_47337,1228,804,196,175,371,1.5254658385093167,29.78596712368442
Task_47338,2142,391,126,152,278,5.464285714285714,42.54221976624469
Task_47339,1472,732,75,171,246,2.00818553888131,32.96572994516186
Task_47340,2241,880,164,104,268,2.543700340522134,45.54707070546208
Task_47341,2479,113,50,13,63,21.74561403508772,44.026405186718215
Task_47342,1769,331,26,102,128,5.328313253012048,35.65606307889972
Task_47343,868,323,132,143,275,2.6790123456790123,22.14105699625306
Task_47344,2875,511,138,135,273,5.615234375,54.48885164754645
Task_47345,1783,648,59,191,250,2.7473035439137132,37.68154570840701
Task_47346,675,584,172,93,265,1.1538461538461537,19.702673471968428
Task_47347,916,387,89,180,269,2.3608247422680413,23.110477262489606
Task_47348,1237,685,166,151,317,1.8032069970845481,29.322540034128043
Task_47349,1148,749,177,183,360,1.5306666666666666,28.309864070971688
Task_47350,2917,993,161,42,203,2.9346076458752517,55.716171343015866
Task_47351,1043,463,187,194,381,2.247844827586207,25.90690126361157
Task_47352,2141,377,171,127,298,5.664021164021164,42.53365005006879
Task_47353,2793,75,20,35,55,36.75,48.397735242218694
Task_47354,1028,421,160,123,283,2.4360189573459716,24.991057427650986
Task_47355,776,763,96,90,186,1.0157068062827226,21.440698326630955
Task_47356,1331,961,192,154,346,1.3835758835758836,31.750294444458575
Task_47357,1239,536,30,124,154,2.3072625698324023,27.8924538536575
Task_47358,2073,638,131,35,166,3.244131455399061,41.0699390061474
Task_47359,1259,340,184,148,332,3.69208211143695,28.643965290519546
Task_47360,1916,100,84,110,194,18.97029702970297,37.034952476189034
Task_47361,1087,759,154,134,288,1.430263157894737,26.96711557455706
Task_47362,1685,158,75,138,213,10.59748427672956,34.09291845129554
Task_47363,630,1020,130,75,205,0.6170421155729677,20.151797571770928
Task_47364,2782,1009,115,157,272,2.7544554455445542,54.61796407464709
Task_47365,875,726,55,112,167,1.203576341127923,22.934358790709393
Task_47366,609,249,70,154,224,2.436,17.66755130056401
Task_47367,1778,272,17,124,141,6.512820512820513,35.489846070027546
Task_47368,1548,287,54,74,128,5.375,32.029653112134895
Task_47369,2194,779,64,15,79,2.812820512820513,42.17186627719871
Task_47370,1930,169,71,150,221,11.352941176470589,38.01991985753849
Task_47371,2288,873,60,38,98,2.6178489702517163,44.37864451253733
Task_47372,949,952,124,81,205,0.9958027282266527,24.831839519659656
Task_47373,1943,824,39,21,60,2.355151515151515,38.303974127270195
Task_47374,978,990,156,66,222,0.9868819374369324,25.390824029238576
Task_47375,2572,790,51,187,238,3.2515802781289507,50.59434667712089
Task_47376,1199,996,73,67,140,1.2026078234704112,28.477470295988468
Task_47377,1930,512,70,86,156,3.7621832358674463,38.822874728614025
Task_47378,1145,296,165,51,216,3.855218855218855,25.71875591767088
Task_47379,2002,152,120,43,163,13.084967320261438,37.99827941546094
Task_47380,2227,759,159,19,178,2.930263157894737,43.8347075076093
Task_47381,1177,204,62,35,97,5.741463414634146,24.650532626534712
Task_47382,2547,584,121,66,187,4.3538461538461535,48.74257967426484
Task_47383,1584,877,77,171,248,1.8041002277904328,35.202664812246006
Task_47384,853,484,142,171,313,1.7587628865979381,22.611636604009163
Task_47385,2624,399,53,196,249,6.56,50.20126826942643
Task_47386,1800,673,11,48,59,2.6706231454005933,35.70966507609053
Task_47387,2912,725,131,193,324,4.011019283746556,56.07405715072584
Task_47388,1766,909,24,16,40,1.9406593406593406,35.521370613716236
Task_47389,2133,561,16,81,97,3.795373665480427,41.505739892236456
Task_47390,2357,444,182,109,291,5.296629213483146,46.11391169192816
Task_47391,2005,920,83,133,216,2.176981541802389,41.776049024139944
Task_47392,2397,761,138,119,257,3.145669291338583,47.61861961532774
Task_47393,1449,604,110,184,294,2.3950413223140496,32.371731601273616
Task_47394,1124,632,19,162,181,1.7756714060031595,26.708178845957487
Task_47395,2751,862,77,160,237,3.1877172653534185,53.58090153083364
Task_47396,535,229,17,38,55,2.3260869565217392,14.209820940550458
Task_47397,529,462,171,165,336,1.142548596112311,17.453653257247215
Task_47398,849,94,61,159,220,8.936842105263159,20.437449858839013
Task_47399,1036,423,147,62,209,2.443396226415094,24.38115419014751
Task_47400,2282,107,149,102,251,21.12962962962963,43.08452455759635
Task_47401,908,640,66,127,193,1.4165366614664587,23.405183304803558
Task_47402,1482,219,115,77,192,6.736363636363636,30.85808499089636
Task_47403,1810,511,15,33,48,3.53515625,35.19583185892837
Task_47404,1697,319,115,106,221,5.303125,34.9400581569471
Task_47405,2984,967,50,135,185,3.0826446280991737,57.32837062700538
Task_47406,2506,743,116,52,168,3.368279569892473,48.49396566308098
Task_47407,2661,64,132,162,294,40.93846153846154,49.02337252311464
Task_47408,2230,122,188,113,301,18.130081300813007,42.6878051412825
Task_47409,1432,576,101,150,251,2.481802426343154,31.770941904325582
Task_47410,1929,643,55,136,191,2.9953416149068324,39.631356887478546
Task_47411,1143,344,11,171,182,3.3130434782608695,26.105957788072573
Task_47412,1282,703,173,183,356,1.8210227272727273,30.314126441351874
Task_47413,1605,1012,81,146,227,1.5844027640671274,35.765295290543676
Task_47414,1448,850,13,57,70,1.701527614571093,30.8542100210677
Task_47415,1929,974,172,124,296,1.9784615384615385,41.05139176187875
Task_47416,512,539,151,40,191,0.9481481481481482,16.23892965964597
Task_47417,1113,616,48,91,139,1.8038897893030794,26.136969745771978
Task_47418,964,386,10,49,59,2.490956072351421,21.56749843925137
Task_47419,1046,350,171,84,255,2.9800569800569803,24.79169790037885
Task_47420,701,140,194,59,253,4.971631205673759,18.10606192716578
Task_47421,1988,168,125,74,199,11.763313609467456,38.456457846811105
Task_47422,1972,832,44,158,202,2.36734693877551,40.9334910096419
Task_47423,740,719,173,52,225,1.0277777777777777,20.735698193164534
Task_47424,1313,843,140,76,216,1.5556872037914693,30.25231364637487
Task_47425,2570,1014,175,163,338,2.5320197044334973,51.58019745815511
Task_47426,2983,349,189,166,355,8.522857142857143,56.073053921116035
Task_47427,2267,625,91,85,176,3.621405750798722,44.602347729492784
Task_47428,1066,345,156,80,236,3.0809248554913293,24.97566814721002
Task_47429,2072,194,36,134,170,10.625641025641025,40.17804483706088
Task_47430,1526,895,195,94,289,1.703125,34.32448115882135
Task_47431,2617,333,182,34,216,7.835329341317365,48.90019766489834
Task_47432,2134,589,36,200,236,3.616949152542373,42.94899520183009
Task_47433,1927,271,160,169,329,7.084558823529412,38.99194189759172
Task_47434,891,914,169,78,247,0.9737704918032787,24.004921015379
Task_47435,2488,643,141,117,258,3.8633540372670807,48.68950639002825
Task_47436,1816,556,15,125,140,3.2603231597845603,37.03626951665313
Task_47437,1883,243,110,31,141,7.717213114754099,36.5097798603775
Task_47438,1125,637,90,168,258,1.7633228840125392,27.138837197515993
Task_47439,1511,308,57,13,70,4.889967637540453,29.692545249795256
Task_47440,1774,221,158,41,199,7.990990990990991,35.11168329904688
Task_47441,2447,337,22,155,177,7.239644970414201,46.69506849745892
Task_47442,2460,516,177,47,224,4.758220502901354,47.09123701876752
Task_47443,553,682,61,104,165,0.8096632503660323,17.716235456462528
Task_47444,1181,433,154,90,244,2.7211981566820276,27.19459062865661
Task_47445,1655,941,148,173,321,1.756900212314225,36.7780707232663
Task_47446,715,527,31,23,54,1.3541666666666667,17.98723182023349
Task_47447,2088,813,171,181,352,2.5651105651105652,43.40514319531252
Task_47448,1389,599,119,123,242,2.315,31.082061034992737
Task_47449,2767,746,14,95,109,3.7041499330655956,52.41247672733555
Task_47450,2820,545,171,96,267,5.164835164835165,53.67215110580773
Task_47451,955,325,134,124,258,2.9294478527607364,23.418853851372035
Task_47452,945,157,36,129,165,5.981012658227848,21.946888057024054
Task_47453,830,164,63,88,151,5.03030303030303,19.90954770284969
Task_47454,1974,195,153,98,251,10.071428571428571,39.010942922377914
Task_47455,1525,1006,140,182,322,1.5143992055610724,34.90803731077422
Task_47456,1089,886,130,185,315,1.2277339346110485,27.578456602963215
Task_47457,2280,187,169,182,351,12.127659574468085,44.4001180161039
Task_47458,675,818,42,82,124,0.8241758241758241,19.632496949061522
Task_47459,1062,782,107,40,147,1.3563218390804597,25.29786968488661
Task_47460,529,798,191,160,351,0.6620775969962454,18.713015122992726
Task_47461,2941,342,165,74,239,8.574344023323615,54.548422100635314
Task_47462,1047,889,26,43,69,1.1764044943820224,24.488112088651036
Task_47463,2815,384,74,68,142,7.311688311688312,52.146316796369454
Task_47464,2140,915,73,138,211,2.336244541484716,43.90871809746261
Task_47465,1146,462,43,181,224,2.475161987041037,26.824104352327797
Task_47466,719,519,182,196,378,1.3826923076923077,20.888744004399033
Task_47467,1122,499,166,114,280,2.244,26.698350798627775
Task_47468,2902,927,113,144,257,3.127155172413793,56.17678053637943
Task_47469,1355,580,106,22,128,2.332185886402754,29.239587202661777
Task_47470,1239,530,163,145,308,2.3333333333333335,28.819867801028266
Task_47471,2072,352,89,113,202,5.8696883852691215,40.884767693087355
Task_47472,2194,145,78,105,183,15.027397260273972,41.777617362832366
Task_47473,2419,691,158,109,267,3.495664739884393,47.777221423711204
Task_47474,2209,72,29,161,190,30.26027397260274,41.47085141323471
Task_47475,1995,823,45,162,207,2.421116504854369,41.309640623156916
Task_47476,2284,536,58,154,212,4.253258845437617,45.03502010050553
Task_47477,930,726,38,76,114,1.2792297111416782,23.251725362612934
Task_47478,639,565,125,89,214,1.1289752650176679,18.803434555299624
Task_47479,2337,406,20,103,123,5.742014742014742,44.659081273782554
Task_47480,1109,624,146,46,192,1.7744,25.869408839542075
Task_47481,1307,471,126,93,219,2.7690677966101696,29.21644652406114
Task_47482,1252,633,134,139,273,1.974763406940063,29.18195628447052
Task_47483,664,159,71,58,129,4.15,16.989366610655775
Task_47484,1197,355,86,185,271,3.3623595505617976,27.451372757913514
Task_47485,513,732,38,165,203,0.6998635743519782,17.57859413979944
Task_47486,2178,349,195,169,364,6.222857142857142,43.38469600087961
Task_47487,1394,307,13,79,92,4.525974025974026,28.94698814338895
Task_47488,2333,505,155,15,170,4.6106719367588935,44.620144486565174
Task_47489,1581,908,72,42,114,1.7392739273927393,33.57519503199572
Task_47490,1794,562,41,68,109,3.186500888099467,36.229458667418186
Task_47491,974,209,113,101,214,4.6380952380952385,23.104567746547897
Task_47492,1807,732,135,26,161,2.4652114597544337,36.99171860323698
Task_47493,1347,104,181,120,301,12.82857142857143,28.626328592899785
Task_47494,1152,919,45,178,223,1.2521739130434784,28.271328013058408
Task_47495,1090,594,62,164,226,1.8319327731092436,26.386432769921782
Task_47496,2347,218,104,47,151,10.71689497716895,43.82195505940223
Task_47497,1576,731,77,63,140,2.1530054644808745,33.599220960361016
Task_47498,2764,999,193,163,356,2.764,54.68891855630758
Task_47499,2155,221,95,15,110,9.707207207207206,40.3604197060356
Task_47500,1587,663,99,184,283,2.3900602409638556,34.69443480743902
Task_47501,1335,968,74,168,242,1.3777089783281733,31.452035365722068
Task_47502,2654,94,152,103,255,27.936842105263157,48.78907682640471
Task_47503,649,345,128,28,156,1.8757225433526012,17.41814314703657
Task_47504,670,748,90,34,124,0.8945260347129506,18.85760517440711
Task_47505,2353,798,151,168,319,2.944931163954944,47.38887636518867
Task_47506,1453,187,153,100,253,7.7287234042553195,30.7889684246588
Task_47507,2566,597,63,43,106,4.290969899665551,47.98510343735728
Task_47508,812,925,98,141,239,0.8768898488120951,22.942167518737005
Task_47509,2696,715,125,140,265,3.7653631284916202,52.27720219192391
Task_47510,1479,427,112,125,237,3.455607476635514,31.943174094057472
Task_47511,1504,477,122,173,295,3.1464435146443517,32.83015571927755
Task_47512,2959,731,12,169,181,4.0423497267759565,56.08777467584633
Task_47513,2979,97,87,174,261,30.397959183673468,54.03163442135437
Task_47514,547,966,43,43,86,0.5656670113753878,17.299566605276862
Task_47515,1220,817,166,28,194,1.4914425427872862,28.221665125569874
Task_47516,1850,892,113,41,154,2.0716685330347144,38.11171177184927
Task_47517,2995,432,59,81,140,6.916859122401847,55.34157674956814
Task_47518,1952,431,133,123,256,4.518518518518518,39.5245345304074
Task_47519,1122,772,137,173,310,1.4514877102199224,27.71828457721873
Task_47520,2129,133,49,174,223,15.888059701492537,40.96847124298007
Task_47521,2928,678,154,71,225,4.312223858615611,55.31139203348291
Task_47522,1379,604,87,38,125,2.2793388429752066,29.560699616017065
Task_47523,2055,250,51,46,97,8.187250996015937,38.74167829746265
Task_47524,2784,529,153,101,254,5.252830188679245,52.97092824787861
Task_47525,2058,139,61,108,169,14.7,39.391268556581146
Task_47526,2697,361,51,11,62,7.4502762430939224,48.63673362455995
Task_47527,839,899,74,85,159,0.9322222222222222,22.6934375004714
Task_47528,2588,664,183,61,244,3.8917293233082706,49.86602276923987
Task_47529,1622,832,97,191,288,1.9471788715486193,35.81515401533171
Task_47530,854,526,15,166,181,1.6204933586337762,22.10602440745498
Task_47531,938,501,189,170,359,1.8685258964143425,24.229811820384565
Task_47532,2837,765,47,106,153,3.7036553524804177,53.931320772761374
Task_47533,2251,728,155,128,283,3.0877914951989025,45.332453636696776
Task_47534,1358,719,187,198,385,1.886111111111111,31.72057269457345
Task_47535,2691,223,53,15,68,12.013392857142858,48.02708991914178
Task_47536,2501,813,196,27,223,3.0724815724815726,48.61379919841138
Task_47537,2600,497,197,176,373,5.220883534136546,50.60055058345559
Task_47538,2071,946,115,145,260,2.1869060190073917,43.08304089473564
Task_47539,2970,973,81,60,141,3.0492813141683777,56.36916369622522
Task_47540,2135,74,36,73,109,28.466666666666665,39.139797593609046
Task_47541,2158,400,89,129,218,5.381546134663342,42.49983994369114
Task_47542,1757,105,44,58,102,16.57547169811321,33.196739923512276
Task_47543,2762,227,37,97,134,12.114035087719298,50.939653259673925
Task_47544,1643,272,44,91,135,6.018315018315018,33.36207279507952
Task_47545,2305,947,101,92,193,2.431434599156118,46.36072623142295
Task_47546,1149,760,45,109,154,1.5098554533508541,27.126643050878045
Task_47547,2484,240,88,198,286,10.307053941908714,47.48893014856595
Task_47548,756,431,170,10,180,1.75,19.500643642868773
Task_47549,1119,323,94,183,277,3.4537037037037037,26.188364939738914
Task_47550,980,570,49,42,91,1.7162872154115587,22.74101136735489
Task_47551,1025,126,71,140,211,8.070866141732283,23.45515761519138
Task_47552,2303,476,176,146,322,4.828092243186583,45.55707007753287
Task_47553,1011,114,134,58,192,8.791304347826086,22.465016534547697
Task_47554,2715,766,165,110,275,3.5397653194263365,52.740087620122154
Task_47555,857,141,180,162,342,6.035211267605634,21.46990680907261
Task_47556,2128,141,27,134,161,14.985915492957746,40.24029037810626
Task_47557,2163,551,45,68,113,3.9184782608695654,42.18015192803761
Task_47558,1435,684,110,171,281,2.0948905109489053,32.322764657913396
Task_47559,2694,893,171,183,354,3.0134228187919465,53.26890533644297
Task_47560,770,387,46,89,135,1.9845360824742269,19.9493009433296
Task_47561,880,604,20,168,188,1.4545454545454546,22.781492559322828
Task_47562,1622,248,51,65,116,6.514056224899599,32.619776870763026
Task_47563,2031,138,87,101,188,14.611510791366907,39.06401257862819
Task_47564,717,142,125,88,213,5.013986013986014,18.46188579924754
Task_47565,808,908,123,103,226,0.8888888888888888,22.709789923212522
Task_47566,2813,802,101,68,169,3.503113325031133,53.545862823346845
Task_47567,1066,891,115,125,240,1.195067264573991,26.80828402115981
Task_47568,1872,560,118,190,308,3.336898395721925,39.00343041435109
Task_47569,1138,262,14,111,125,4.326996197718631,25.31009998825974
Task_47570,820,505,70,130,200,1.6205533596837944,21.65796869326384
Task_47571,806,228,23,126,149,3.519650655021834,20.071212243521646
Task_47572,1543,661,159,66,225,2.3308157099697886,33.277498943270125
Task_47573,2246,833,90,57,147,2.693045563549161,44.49461421497117
Task_47574,1526,689,149,58,207,2.2115942028985507,32.96793465825739
Task_47575,1891,607,27,137,164,3.1101973684210527,38.669688837029796
Task_47576,1586,857,29,174,203,1.8484848484848484,34.909281482756526
Task_47577,2888,406,17,115,132,7.0958230958230954,53.49456996758977
Task_47578,2948,887,191,175,366,3.31981981981982,57.317130427185326
Task_47579,1399,197,49,77,126,7.065656565656566,29.30809581722455
Task_47580,1515,555,102,95,197,2.7248201438848922,32.70861493712315
Task_47581,1900,872,96,51,147,2.176403207331042,39.10187892076751
Task_47582,2563,377,183,143,326,6.78042328042328,49.35981494502207
Task_47583,1722,375,122,112,234,4.579787234042553,35.587627629255714
Task_47584,2719,626,64,16,80,4.33652312599681,50.18098722416163
Task_47585,1042,127,157,200,357,8.140625,24.404585655789656
Task_47586,598,724,94,145,239,0.8248275862068966,18.93350586806332
Task_47587,1225,327,136,128,264,3.7347560975609757,27.728180010132387
Task_47588,2580,246,107,129,236,10.445344129554655,48.74273914772542
Task_47589,1879,258,19,139,158,7.254826254826255,37.17137286124273
Task_47590,1292,208,121,57,178,6.181818181818182,27.56207614253661
Task_47591,2785,962,29,53,82,2.8920041536863965,52.71743537859346
Task_47592,1150,789,59,87,146,1.4556962025316456,27.289969461448237
Task_47593,902,357,58,123,181,2.5195530726256985,22.366511134572846
Task_47594,2791,641,45,34,79,4.3473520249221185,51.3805177198773
Task_47595,2462,642,36,57,93,3.828926905132193,46.71473182092436
Task_47596,1680,458,149,173,322,3.6601307189542482,35.67717343092914
Task_47597,778,455,76,198,274,1.706140350877193,21.264316555672192
Task_47598,2721,108,136,133,269,24.96330275229358,50.11949146730746
Task_47599,1843,821,170,63,233,2.2420924574209247,38.55665576651959
Task_47600,2638,352,172,194,366,7.473087818696884,50.716774824707386
Task_47601,1853,96,94,198,292,19.103092783505154,36.55600786515675
Task_47602,2611,682,145,128,273,3.822840409956076,50.84493803994985
Task_47603,1356,153,158,54,212,8.805194805194805,28.377219353634157
Task_47604,2539,694,64,185,249,3.6532374100719425,49.7880475707733
Task_47605,1897,578,92,187,279,3.2763385146804835,39.3288682266682
Task_47606,660,939,75,144,219,0.7021276595744681,20.664277692860665
Task_47607,569,857,138,46,184,0.6631701631701632,18.30206851054088
Task_47608,2699,689,103,47,150,3.911594202898551,50.95681945500933
Task_47609,676,205,156,132,288,3.2815533980582523,18.765483809276756
Task_47610,1068,394,11,159,170,2.7037974683544306,24.99755323055413
Task_47611,2785,792,20,10,30,3.511979823455233,51.26219661961316
Task_47612,1756,413,200,109,309,4.241545893719807,36.582786124341965
Task_47613,2307,267,51,55,106,8.60820895522388,43.08075102370509
Task_47614,1882,102,158,24,182,18.271844660194176,35.74408625325635
Task_47615,2426,836,96,26,122,2.898446833930705,46.76185988995855
Task_47616,2050,929,10,72,82,2.204301075268817,41.07960788748236
Task_47617,2024,812,198,161,359,2.4895448954489545,42.39027157927067
Task_47618,2130,525,41,114,155,4.0494296577946765,42.005684866279275
Task_47619,2563,291,91,51,142,8.777397260273972,47.66966730923329
Task_47620,1723,155,124,105,229,11.044871794871796,34.609541863359404
Task_47621,2807,369,17,89,106,7.5864864864864865,51.70710477652789
Task_47622,2663,917,154,45,199,2.900871459694989,51.42552279383437
Task_47623,1036,590,85,57,142,1.7529610829103215,24.49466168749851
Task_47624,2619,227,154,30,184,11.486842105263158,48.38266175872629
Task_47625,986,352,91,35,126,2.7932011331444757,22.629039608129528
Task_47626,1452,425,89,161,250,3.408450704225352,31.599808938738477
Task_47627,2528,317,161,172,333,7.949685534591195,48.675742912301
Task_47628,2849,400,42,52,94,7.104738154613466,52.089269850765525
Task_47629,1267,654,78,190,268,1.9343511450381679,29.60428700053092
Task_47630,2818,825,164,134,298,3.4116222760290555,54.69626539308016
Task_47631,2577,226,57,61,118,11.352422907488986,47.375789300251334
Task_47632,1612,838,107,174,281,1.9213349225268177,35.61122235471416
Task_47633,2816,926,43,167,210,3.0377562028047467,54.64945589692436
Task_47634,1296,483,153,175,328,2.677685950413223,29.70819705978819
Task_47635,848,886,188,48,236,0.9560315670800451,22.875624628938954
Task_47636,2611,702,176,47,223,3.7140825035561877,50.07047868035667
Task_47637,1833,741,131,61,192,2.4703504043126685,37.91444957196227
Task_47638,2136,577,103,15,118,3.6955017301038064,41.22575999261077
Task_47639,2161,492,153,52,205,4.383367139959432,42.43587842876641
Task_47640,1172,143,83,130,213,8.13888888888889,25.849084051556442
Task_47641,2261,84,154,195,349,26.6,43.152131763049454
Task_47642,1639,224,182,141,323,7.2844444444444445,34.20768343358433
Task_47643,2603,641,165,53,218,4.054517133956386,49.97855938642121
Task_47644,1414,230,158,67,225,6.121212121212121,29.850467604502157
Task_47645,2532,775,92,187,279,3.2628865979381443,50.00780081850262
Task_47646,1794,889,154,41,195,2.0157303370786517,37.559377856840655
Task_47647,1726,168,183,198,381,10.21301775147929,35.523865491156364
Task_47648,1065,360,47,38,85,2.9501385041551247,23.41509180773187
Task_47649,2543,449,155,19,174,5.651111111111111,47.83309237316271
Task_47650,2485,681,128,69,197,3.6436950146627565,48.132635246841005
Task_47651,624,214,180,93,273,2.902325581395349,17.833070166299034
Task_47652,2770,355,190,129,319,7.780898876404494,52.507925182342625
Task_47653,1232,831,177,185,362,1.4807692307692308,29.907254028694926
Task_47654,672,760,83,30,113,0.8830486202365309,18.82474771096666
Task_47655,1940,663,169,182,351,2.9216867469879517,40.587482577576196
Task_47656,1978,404,31,118,149,4.883950617283951,39.184976340144686
Task_47657,1450,222,196,181,377,6.502242152466367,31.51780157355559
Task_47658,2348,557,28,90,118,4.207885304659499,45.26000683346799
Task_47659,1565,1000,145,98,243,1.5634365634365635,35.051651739232724
Task_47660,2793,99,90,177,267,27.93,51.21457597650644
Task_47661,2503,713,64,70,134,3.5056022408963585,48.249065421968005
Task_47662,1650,819,33,117,150,2.0121951219512195,35.28541082737447
Task_47663,586,593,124,158,282,0.9865319865319865,18.551630272398512
Task_47664,1839,376,27,48,75,4.877984084880636,35.40322934257561
Task_47665,2067,562,144,149,293,3.6714031971580816,41.96984741042616
Task_47666,2947,306,42,46,88,9.599348534201955,53.01708064446911
Task_47667,2250,122,34,177,211,18.29268292682927,42.64985004671086
Task_47668,1517,835,14,129,143,1.8145933014354068,33.1990843962386
Task_47669,2844,179,120,115,235,15.8,52.37992779734122
Task_47670,2809,111,93,49,142,25.080357142857142,50.118370254042276
Task_47671,2482,277,184,182,366,8.928057553956835,47.971026197540404
Task_47672,2742,215,84,95,179,12.694444444444445,50.88456460615404
Task_47673,639,361,24,30,54,1.7651933701657458,16.23639825794636
Task_47674,2584,530,134,98,232,4.866290018832392,49.71150391390029
Task_47675,1260,776,119,193,312,1.6216216216216217,29.99571342046441
Task_47676,1014,171,102,35,137,5.895348837209302,22.25770219403201
Task_47677,1786,319,143,107,250,5.58125,36.479636768378185
Task_47678,1106,702,67,150,217,1.57325746799431,26.883614646788786
Task_47679,868,177,123,114,237,4.876404494382022,21.199471165049605
Task_47680,907,556,136,124,260,1.628366247755835,23.383938788656508
Task_47681,1544,211,169,111,280,7.283018867924528,32.422981052786774
Task_47682,700,442,74,79,153,1.580135440180587,18.994516153573027
Task_47683,789,726,49,114,163,1.0852819807427785,21.54430003124142
Task_47684,2844,576,196,76,272,4.92894280762565,53.94517624310322
Task_47685,1396,762,11,136,147,1.8296199213630406,31.07393371013887
Task_47686,975,790,71,167,238,1.2326169405815424,25.1535299262776
Task_47687,2837,67,55,112,167,41.720588235294116,51.04117510101338
Task_47688,2228,213,97,19,116,10.411214953271028,41.4833009290828
Task_47689,1921,748,198,36,234,2.5647530040053406,39.29842731950328
Task_47690,1148,851,26,149,175,1.3474178403755868,27.68894428017643
Task_47691,1234,600,93,187,280,2.05324459234609,28.934080635790746
Task_47692,2316,790,123,166,289,2.9279393173198485,46.639474054295526
Task_47693,1624,919,51,101,152,1.7652173913043478,35.22655732866238
Task_47694,2855,989,125,107,232,2.8838383838383836,55.45882311432282
Task_47695,1236,1008,34,162,196,1.2249752229930624,29.71115750228809
Task_47696,880,733,158,83,241,1.1989100817438691,23.24411592201251
Task_47697,904,432,145,169,314,2.087759815242494,23.27053701513235
Task_47698,1644,1016,89,10,99,1.6165191740412979,34.63966581635464
Task_47699,1050,491,10,16,26,2.1341463414634148,22.77978206562574
Task_47700,2066,158,167,153,320,12.9937106918239,40.51633983661495
Task_47701,1564,530,162,47,209,2.945386064030132,32.882185383271995
Task_47702,1692,293,107,79,186,5.755102040816326,34.44407831101868
Task_47703,592,691,155,199,354,0.8554913294797688,19.332137439409564
Task_47704,991,683,41,113,154,1.4488304093567252,24.365751321848393
Task_47705,1008,348,86,77,163,2.8882521489971347,23.630238979470175
Task_47706,1897,874,111,151,262,2.168,40.11959449878668
Task_47707,1871,230,83,156,239,8.0995670995671,37.57251816722053
Task_47708,2454,912,193,162,355,2.687842278203724,49.49912253894919
Task_47709,1574,555,70,108,178,2.8309352517985613,33.609441771370456
Task_47710,2859,768,18,94,112,3.717815344603381,53.968722195042766
Task_47711,2030,116,179,73,252,17.35042735042735,38.837936177979
Task_47712,1373,308,27,131,158,4.44336569579288,29.336021062141594
Task_47713,1614,116,172,91,263,13.794871794871796,32.60650142954834
Task_47714,2961,882,110,64,174,3.3533408833522085,56.175274306682205
Task_47715,1350,884,100,10,110,1.5254237288135593,29.681274995119036
Task_47716,1260,256,128,154,282,4.902723735408561,28.165872692191044
Task_47717,1276,490,165,29,194,2.5987780040733197,28.090323846842125
Task_47718,519,982,114,182,296,0.5279755849440488,18.947096693528664
Task_47719,2203,714,155,160,315,3.081118881118881,44.71922444158071
Task_47720,846,366,199,39,238,2.3051771117166213,21.099845710194355
Task_47721,2111,401,175,105,280,5.251243781094527,42.02469931410912
Task_47722,2743,922,184,81,265,2.971830985915493,53.48124214731791
Task_47723,1299,1011,80,147,227,1.283596837944664,30.889693475450603
Task_47724,2729,797,178,24,202,3.419799498746867,52.04816860668632
Task_47725,944,680,109,148,257,1.3861967694566812,24.33723918089778
Task_47726,941,662,108,144,252,1.4193061840120664,24.205410873551177
Task_47727,1218,681,99,120,219,1.7859237536656891,28.523671720167968
Task_47728,1594,72,176,116,292,21.835616438356166,32.28213643727293
Task_47729,2154,96,166,105,271,22.20618556701031,41.03219574853443
Task_47730,2740,352,132,109,241,7.762039660056657,51.64224347181744
Task_47731,1038,711,44,133,177,1.4578651685393258,25.535217469525673
Task_47732,902,265,75,136,211,3.3909774436090228,22.256897091390282
Task_47733,1266,670,186,99,285,1.886736214605067,29.508691705944155
Task_47734,747,598,31,159,190,1.2470784641068446,20.647052544376532
Task_47735,2079,814,198,11,209,2.550920245398773,41.80002704132678
Task_47736,610,255,140,148,288,2.3828125,17.909917164824112
Task_47737,1545,172,156,121,277,8.93063583815029,32.086175563235095
Task_47738,927,481,141,197,338,1.9232365145228216,23.937882121403305
Task_47739,1040,476,18,112,130,2.180293501048218,24.47568257258691
Task_47740,2283,634,143,81,224,3.5952755905511813,45.10403646670679
Task_47741,1473,205,15,132,147,7.150485436893204,30.51600571673593
Task_47742,2602,547,173,53,226,4.748175182481752,49.6987410648193
Task_47743,1613,702,94,22,116,2.294452347083926,33.41086986609546
Task_47744,1703,512,111,60,171,3.3196881091617936,34.98727772832291
Task_47745,2265,752,53,95,148,3.00796812749004,44.92009240852053
Task_47746,869,715,60,10,70,1.2136871508379887,20.8685586649281
Task_47747,1785,427,91,186,277,4.170560747663552,37.05497334553648
Task_47748,2807,229,60,150,210,12.204347826086957,52.246588069986124
Task_47749,875,873,57,187,244,1.0011441647597255,23.84222652734617
Task_47750,848,806,156,194,350,1.050805452292441,23.687676297088387
Task_47751,2923,404,178,63,241,7.217283950617284,54.36371844839607
Task_47752,564,608,73,196,269,0.9261083743842364,18.26075213842208
Task_47753,2605,957,128,71,199,2.719206680584551,50.953660125492526
Task_47754,2013,654,19,128,147,3.073282442748092,40.522066062561855
Task_47755,2908,220,67,154,221,13.158371040723981,53.866582347000936
Task_47756,1639,533,121,32,153,3.0692883895131087,33.65328366362356
Task_47757,1252,882,187,189,376,1.4178935447338619,30.440192355558327
Task_47758,2079,881,111,109,220,2.357142857142857,42.77430458306725
Task_47759,1831,341,167,45,212,5.353801169590644,36.47621815241095
Task_47760,2915,839,87,130,217,3.4702380952380953,55.866420833895866
Task_47761,951,464,100,185,285,2.0451612903225804,24.007921320391944
Task_47762,1161,977,26,162,188,1.187116564417178,28.358392662257007
Task_47763,2583,827,199,103,302,3.119565217391304,50.95184849140721
Task_47764,1777,189,200,174,374,9.352631578947369,36.54070490547418
Task_47765,2624,943,90,32,122,2.7796610169491527,50.300258317253615
Task_47766,662,983,90,97,187,0.6727642276422764,20.606694232912897
Task_47767,2325,478,65,100,165,4.853862212943633,45.17680602361884
Task_47768,695,132,73,137,210,5.225563909774436,18.280906068519318
Task_47769,1684,204,196,162,358,8.214634146341464,35.03388529330892
Task_47770,2656,517,84,116,200,5.127413127413128,50.694047547865445
Task_47771,2156,850,167,108,275,2.533490011750881,44.144045874874486
Task_47772,2486,564,155,65,220,4.4,47.89714771182986
Task_47773,2417,412,92,184,276,5.852300242130751,47.00851159613711
Task_47774,1685,66,132,165,297,25.149253731343283,33.8005224288928
Task_47775,1011,547,81,42,123,1.844890510948905,23.489322311635775
Task_47776,1350,412,32,183,215,3.2687651331719128,29.837021854848114
Task_47777,710,294,139,105,244,2.406779661016949,19.35441437651966
Task_47778,2240,129,17,190,207,17.23076923076923,42.51522579833841
Task_47779,1045,273,40,140,180,3.8138686131386863,24.328642819565346
Task_47780,1026,477,89,65,154,2.1464435146443517,24.02283530573281
Task_47781,2996,1011,122,151,273,2.960474308300395,58.011216213796125
Task_47782,1361,602,42,153,195,2.257048092868988,30.496845092252915
Task_47783,582,416,185,112,297,1.39568345323741,17.91036214062632
Task_47784,2659,389,13,169,182,6.817948717948718,50.24994455024236
Task_47785,632,782,93,22,115,0.8071519795657727,18.246508519387053
Task_47786,2111,717,80,144,224,2.9401114206128134,42.891000745292494
Task_47787,1880,1024,81,93,174,1.8341463414634147,39.851154568892376
Task_47788,1226,833,101,163,264,1.4700239808153477,29.33333843780103
Task_47789,2575,270,113,61,174,9.501845018450185,48.023986818325675
Task_47790,2367,396,93,116,209,5.962216624685139,45.79358766361832
Task_47791,2267,865,199,48,247,2.6177829099307157,45.24962279643936
Task_47792,639,890,62,131,193,0.7171717171717171,20.016131480993675
Task_47793,532,596,13,116,129,0.8911222780569514,16.829984984848462
Task_47794,2174,745,48,21,69,2.9142091152815013,41.69683504009159
Task_47795,912,678,31,165,196,1.3431516936671575,23.565432973043343
Task_47796,1341,613,184,23,207,2.1840390879478826,29.510950228937276
Task_47797,2013,505,13,117,130,3.9782608695652173,39.97063319629299
Task_47798,1626,740,114,20,134,2.194331983805668,33.94541597726826
Task_47799,2302,649,44,119,163,3.5415384615384617,45.294633240127574
Task_47800,518,307,117,48,165,1.6818181818181819,15.443649562724081
Task_47801,2895,854,104,34,138,3.3859649122807016,54.465805451260685
Task_47802,2484,339,148,123,271,7.305882352941176,47.704309703254616
Task_47803,1163,112,119,45,164,10.29203539823009,24.42709294505039
Task_47804,1259,634,167,111,278,1.9826771653543307,29.277436700548574
Task_47805,2483,586,192,40,232,4.229982964224872,47.68791760140496
Task_47806,530,754,145,62,207,0.7019867549668874,17.529970686278897
Task_47807,2405,923,96,145,241,2.6028138528138527,48.22598302103081
Task_47808,771,473,61,131,192,1.6265822784810127,20.742272992293724
Task_47809,2649,816,68,87,155,3.2423500611995104,51.193247935448255
Task_47810,1866,285,144,91,235,6.524475524475524,37.48324347394425
Task_47811,837,333,179,116,295,2.5059880239520957,21.73335165481623
Task_47812,1496,748,111,58,169,1.9973297730307076,32.46808046939267
Task_47813,1523,719,68,128,196,2.1152777777777776,33.45303890447261
Task_47814,2608,283,68,93,161,9.183098591549296,48.85009755426574
Task_47815,1735,74,56,196,252,23.133333333333333,34.46421835076588
Task_47816,2718,935,64,145,209,2.9038461538461537,53.14154349632249
Task_47817,855,825,24,142,166,1.0351089588377724,22.864400913927327
Task_47818,2751,739,46,194,240,3.7175675675675675,53.22444781013784
Task_47819,1981,842,65,24,89,2.3499406880189797,39.380980785824896
Task_47820,1525,640,47,166,213,2.3790951638065523,33.3369582299894
Task_47821,2475,267,114,127,241,9.235074626865671,47.180390855378015
Task_47822,1120,126,166,59,225,8.818897637795276,24.475625110096853
Task_47823,2884,881,170,43,213,3.2698412698412698,54.889509772974954
Task_47824,702,517,13,130,143,1.3552123552123552,19.249961226843823
Task_47825,510,394,181,83,264,1.2911392405063291,16.43587232800823
Task_47826,2177,159,126,194,320,13.60625,42.32953203188367
Task_47827,1905,283,33,72,105,6.707746478873239,37.042413279526016
Task_47828,2418,802,168,165,333,3.0112079701120797,48.4899160374683
Task_47829,2275,645,32,171,203,3.521671826625387,45.15100473660876
Task_47830,1617,302,156,191,347,5.336633663366337,34.310718200126885
Task_47831,1853,773,48,177,225,2.3940568475452197,39.03865496706074
Task_47832,2813,407,176,172,348,6.894607843137255,53.55763976168917
Task_47833,1975,343,24,47,71,5.741279069767442,37.40770102584861
Task_47834,1507,521,19,82,101,2.8869731800766285,31.6054968587094
Task_47835,2346,669,33,71,104,3.5014925373134327,45.26812637369792
Task_47836,1297,639,131,102,233,2.0265625,29.678897172741728
Task_47837,2657,123,24,70,94,21.427419354838708,47.60438630924087
Task_47838,1924,627,78,188,266,3.0636942675159236,39.913364760599656
Task_47839,2032,649,156,125,281,3.126153846153846,41.601531434496486
Task_47840,2202,706,53,49,102,3.1145685997171144,42.63167928253451
Task_47841,547,87,56,119,175,6.215909090909091,15.396182145844293
Task_47842,2315,424,61,32,93,5.447058823529412,43.365125308322824
Task_47843,1402,387,183,31,214,3.61340206185567,29.853111060215195
Task_47844,2607,330,40,126,166,7.876132930513595,49.1252845479201
Task_47845,2208,213,37,120,157,10.317757009345794,42.21731870089078
Task_47846,2067,867,170,33,203,2.3813364055299537,41.843767300996205
Task_47847,2198,868,16,25,41,2.529344073647871,42.38203554688512
Task_47848,1441,963,11,43,54,1.4948132780082988,30.89258365060275
Task_47849,1148,786,128,45,173,1.4587039390088945,26.879727296523626
Task_47850,982,837,195,130,325,1.171837708830549,25.700533642308354
Task_47851,706,963,43,168,211,0.7323651452282157,21.34118484737296
Task_47852,1212,91,95,18,113,13.173913043478262,24.425307854658367
Task_47853,1821,555,177,170,347,3.2751798561151078,38.32648122136185
Task_47854,1656,850,52,162,214,1.945945945945946,36.09818352209125
Task_47855,998,737,29,195,224,1.3523035230352303,25.28610638314835
Task_47856,2463,302,52,145,197,8.128712871287128,47.015217900599055
Task_47857,2652,285,45,80,125,9.272727272727273,49.29531445480745
Task_47858,1972,169,107,144,251,11.6,38.736219454243425
Task_47859,2855,329,30,81,111,8.651515151515152,52.47052454244746
Task_47860,2292,196,189,52,241,11.634517766497462,43.67932980323337
Task_47861,1014,525,30,42,72,1.9277566539923954,22.771497977341326
Task_47862,2181,802,33,34,67,2.7160647571606478,42.068348957122176
Task_47863,2959,546,165,111,276,5.409506398537477,55.910543423280295
Task_47864,2056,262,109,135,244,7.817490494296578,40.56607971996592
Task_47865,1825,1012,38,59,97,1.8015794669299112,37.802937505872116
Task_47866,2300,812,64,27,91,2.8290282902829027,44.35482456261101
Task_47867,1602,214,62,85,147,7.4511627906976745,32.64101434376024
Task_47868,571,810,21,93,114,0.7040690505548706,17.994937794723786
Task_47869,2636,178,103,187,290,14.726256983240223,49.43873155952044
Task_47870,1780,463,12,106,118,3.836206896551724,35.95471374983873
Task_47871,975,695,119,119,238,1.4008620689655173,24.74674040130864
Task_47872,2944,445,123,81,204,6.6008968609865475,54.87060852368746
Task_47873,1920,757,196,197,393,2.532981530343008,40.77672314411166
Task_47874,2201,945,81,106,187,2.3266384778012683,44.79351629579318
Task_47875,2293,459,40,194,234,4.984782608695652,45.027310815023554
Task_47876,1353,279,25,92,117,4.832142857142857,28.594039045713775
Task_47877,943,713,93,39,132,1.3207282913165266,23.232120681710523
Task_47878,2426,84,105,101,206,28.541176470588237,44.95662122794669
Task_47879,2820,116,95,123,218,24.102564102564102,51.54365203064294
Task_47880,2905,935,149,82,231,3.1036324786324787,55.97011501183755
Task_47881,877,513,98,92,190,1.706225680933852,22.36279068583127
Task_47882,1977,693,74,168,242,2.8487031700288186,40.81658794443627
Task_47883,2559,1007,73,161,234,2.5386904761904763,50.97235034483058
Task_47884,874,603,133,69,202,1.4470198675496688,22.370922923736288
Task_47885,571,97,66,58,124,5.826530612244898,14.753999210464599
Task_47886,2071,952,82,51,133,2.1731374606505773,41.989332760424524
Task_47887,1653,104,158,184,342,15.742857142857142,33.71306000877776
Task_47888,1983,194,175,35,210,10.169230769230769,38.38558049644936
Task_47889,1659,808,136,13,149,2.050679851668727,34.78103776587425
Task_47890,2552,394,120,41,161,6.460759493670886,47.72257536893591
Task_47891,772,157,116,82,198,4.886075949367089,19.343561179465368
Task_47892,983,369,158,138,296,2.656756756756757,24.194415060855153
Task_47893,1364,714,96,41,137,1.9076923076923078,29.77848732802624
Task_47894,1716,529,30,157,187,3.237735849056604,35.83101075169219
Task_47895,536,674,76,51,127,0.794074074074074,16.818481095996805
Task_47896,2749,908,53,84,137,3.024202420242024,52.95958946745572
Task_47897,2223,954,111,133,244,2.3277486910994765,45.42686439741649
Task_47898,2197,922,101,53,154,2.380281690140845,44.00370696953564
Task_47899,2240,697,177,177,354,3.2091690544412605,45.45254443012973
Task_47900,613,359,156,12,168,1.7027777777777777,16.922799676910284
Task_47901,1590,210,72,103,175,7.535545023696683,32.69425939542964
Task_47902,2442,744,102,154,256,3.2778523489932887,48.32488021780796
Task_47903,939,561,20,72,92,1.6708185053380782,22.49149048298098
Task_47904,1139,355,191,66,257,3.199438202247191,26.058406359671352
Task_47905,2613,496,191,57,248,5.257545271629779,49.75284610757958
Task_47906,1963,616,156,26,182,3.1815235008103726,39.26681167519525
Task_47907,660,997,128,42,170,0.6613226452905812,20.062937596006194
Task_47908,1603,840,157,196,353,1.906064209274673,35.831607269626936
Task_47909,2056,981,68,92,160,2.0936863543788187,42.30875315447786
Task_47910,2359,692,134,58,192,3.404040404040404,46.10446974647223
Task_47911,2776,582,131,200,331,4.761578044596913,53.50692667654744
Task_47912,2850,639,163,200,363,4.453125,55.005154123479805
Task_47913,1684,549,21,76,97,3.061818181818182,34.30120551540526
Task_47914,2304,721,98,45,143,3.1911357340720223,44.73613010055914
Task_47915,2340,485,199,65,264,4.814814814814815,45.530003572069226
Task_47916,1307,219,162,167,329,5.9409090909090905,29.012174996350836
Task_47917,1063,410,145,169,314,2.586374695863747,25.717207804096642
Task_47918,1017,460,190,90,280,2.2060737527114966,24.846497480949694
Task_47919,912,449,179,138,317,2.026666666666667,23.41876179279932
Task_47920,2805,506,12,80,92,5.5325443786982245,51.92305371464306
Task_47921,962,920,101,107,208,1.0445168295331162,25.07919412270185
Task_47922,882,921,11,163,174,0.9566160520607375,23.666248367534266
Task_47923,648,603,137,43,180,1.0728476821192052,18.4653899467361
Task_47924,2030,581,44,174,218,3.4879725085910653,41.15952170037722
Task_47925,2778,480,95,156,251,5.775467775467775,52.79422909155705
Task_47926,1249,258,191,144,335,4.822393822393822,28.22301337182063
Task_47927,708,217,24,141,165,3.2477064220183487,18.730735319375558
Task_47928,2692,190,26,124,150,14.094240837696335,49.65775544050772
Task_47929,615,910,138,141,279,0.6750823271130626,20.068280811959138
Task_47930,1575,345,105,29,134,4.5520231213872835,31.946360633947606
Task_47931,745,712,37,112,149,1.0448807854137447,20.579083837585895
Task_47932,2292,131,62,159,221,17.363636363636363,43.46534607626767
Task_47933,1459,925,138,181,319,1.5755939524838012,33.59603364858132
Task_47934,950,361,96,70,166,2.6243093922651934,22.708319830647866
Task_47935,2540,424,64,19,83,5.976470588235294,46.78008904082227
Task_47936,1555,126,195,103,298,12.244094488188976,32.06252376598536
Task_47937,2575,550,14,41,55,4.673321234119782,47.56367518329978
Task_47938,2161,561,96,185,281,3.8451957295373664,43.46151753102905
Task_47939,2037,479,65,174,239,4.24375,41.09271035822322
Task_47940,2389,206,14,172,186,11.541062801932368,45.364244179688455
Task_47941,1572,807,44,121,165,1.9455445544554455,34.267434727625215
Task_47942,2315,849,96,17,113,2.723529411764706,44.952171203756855
Task_47943,2837,721,80,91,171,3.9293628808864267,53.982384351486736
Task_47944,1963,512,194,176,370,3.8265107212475633,40.55052871397829
Task_47945,766,489,158,15,173,1.563265306122449,19.760896291501627
Task_47946,715,921,85,37,122,0.7754880694143167,20.011198471805052
Task_47947,919,730,44,107,151,1.2571819425444597,23.35580492958864
Task_47948,1774,209,197,176,373,8.447619047619048,36.56137230225163
Task_47949,1276,607,164,60,224,2.098684210526316,28.820380337270247
Task_47950,994,288,16,75,91,3.4394463667820068,22.51451447823493
Task_47951,1633,664,97,66,163,2.4556390977443607,34.43849870205622
Task_47952,1745,779,46,63,109,2.2371794871794872,36.092572828601035
Task_47953,987,352,33,44,77,2.7960339943342776,21.807486692766663
Task_47954,680,371,93,160,253,1.8279569892473118,19.284107519828925
Task_47955,1247,645,65,125,190,1.9303405572755419,28.812305497711844
Task_47956,775,542,124,135,259,1.427255985267035,21.22136987448074
Task_47957,1810,150,47,102,149,11.986754966887418,35.21365977820122
Task_47958,2718,827,166,174,340,3.282608695652174,53.366103032496994
Task_47959,1593,871,13,138,151,1.826834862385321,34.54062547568457
Task_47960,1281,866,148,79,227,1.4775086505190311,29.919754775280705
Task_47961,2899,654,73,186,259,4.425954198473282,55.39967492229215
Task_47962,2132,106,25,124,149,19.925233644859812,39.85594008106314
Task_47963,2568,146,172,189,361,17.46938775510204,48.58493270128977
Task_47964,1602,936,110,31,141,1.7097118463180363,34.267537387321404
Task_47965,2721,982,11,142,153,2.768056968463886,52.742452323863006
Task_47966,2329,283,101,166,267,8.200704225352112,45.10427251652428
Task_47967,1069,778,180,134,314,1.3722721437740693,26.865088603831328
Task_47968,1370,965,18,75,93,1.4182194616977226,30.544813558957035
Task_47969,1655,89,158,46,204,18.38888888888889,32.117670906977644
Task_47970,1741,671,44,175,219,2.5907738095238093,36.8720684767595
Task_47971,1109,923,150,176,326,1.2002164502164503,28.05108458647203
Task_47972,1179,266,101,155,256,4.415730337078652,26.803692131594634
Task_47973,511,482,56,98,154,1.0579710144927537,16.12977341661789
Task_47974,2795,133,26,132,158,20.85820895522388,50.59174788701586
Task_47975,1160,79,112,159,271,14.5,25.462401738881265
Task_47976,1663,130,127,85,212,12.694656488549619,33.23806701604516
Task_47977,1658,488,160,151,311,3.390593047034765,35.34287169440468
Task_47978,1428,176,101,138,239,8.067796610169491,30.07349685345474
Task_47979,1022,160,77,157,234,6.3478260869565215,23.772491268015887
Task_47980,813,250,148,100,248,3.239043824701195,20.850555994033957
Task_47981,634,457,16,38,54,1.3842794759825328,16.53129363215686
Task_47982,1624,400,67,167,234,4.049875311720698,34.27341853340098
Task_47983,1748,926,79,115,194,1.8856526429341964,37.6211719755873
Task_47984,2159,945,133,132,265,2.2822410147991543,44.47786706927976
Task_47985,2444,373,146,193,339,6.53475935828877,47.59559796984511
Task_47986,695,581,22,37,59,1.1941580756013745,17.933545336733726
Task_47987,877,192,108,90,198,4.544041450777202,21.424013709222006
Task_47988,2643,395,42,65,107,6.674242424242424,49.073637285695604
Task_47989,2890,746,138,63,201,3.8688085676037485,54.764482798544954
Task_47990,2256,457,56,194,250,4.925764192139738,44.56699820711989
Task_47991,1576,998,26,100,126,1.5775775775775776,34.54028117333221
Task_47992,2768,392,68,163,231,7.043256997455471,52.32798860915884
Task_47993,1690,175,179,189,368,9.602272727272727,34.879152858558726
Task_47994,2670,293,130,160,290,9.081632653061224,50.625229518200705
Task_47995,2906,140,27,10,37,20.609929078014183,50.886858133254556
Task_47996,2932,865,121,14,135,3.3856812933025404,54.98353808516825
Task_47997,2683,901,39,133,172,2.97450110864745,52.203879205565606
Task_47998,2867,497,124,178,302,5.757028112449799,54.510399490702014
Task_47999,2300,150,183,94,277,15.2317880794702,43.854890419448395
Task_48000,940,293,61,30,91,3.197278911564626,21.166887305093038
Task_48001,2871,384,75,155,230,7.457142857142857,53.90613868708255
Task_48002,1325,386,69,82,151,3.4237726098191215,28.820985511852488
Task_48003,2509,693,100,38,138,3.615273775216138,47.8575606320332
Task_48004,2173,506,168,15,183,4.285996055226825,42.172343695854515
Task_48005,667,227,15,152,167,2.925438596491228,18.11686610537704
Task_48006,2634,115,81,82,163,22.70689655172414,48.11607718710393
Task_48007,1559,643,107,200,307,2.420807453416149,34.31821902475635
Task_48008,2367,166,18,146,164,14.173652694610778,44.372953964435986
Task_48009,2512,949,119,149,268,2.6442105263157893,50.12246985019389
Task_48010,2397,668,70,19,89,3.5829596412556053,45.44759513655182
Task_48011,512,588,148,198,346,0.8692699490662139,17.708606642359616
Task_48012,1998,606,59,74,133,3.2915980230642505,40.0502500351285
Task_48013,774,658,180,127,307,1.1745068285280729,21.765007500627053
Task_48014,2931,709,189,172,361,4.128169014084507,56.46037601723663
Task_48015,2550,409,138,150,288,6.219512195121951,49.09983682877667
Task_48016,2234,987,99,53,152,2.2611336032388665,44.7785981230293
Task_48017,2103,967,114,23,137,2.1725206611570247,42.212409548674074
Task_48018,2989,448,61,129,190,6.657015590200445,55.768209430955466
Task_48019,681,631,164,110,274,1.0775316455696202,20.026637643462617
Task_48020,1414,967,194,111,305,1.4607438016528926,32.836356833335635
Task_48021,1615,153,172,22,194,10.487012987012987,32.0581472819545
Task_48022,972,339,68,76,144,2.8588235294117648,22.979759066013163
Task_48023,2601,73,25,154,179,35.148648648648646,47.51165755152913
Task_48024,2066,839,59,21,80,2.4595238095238097,40.52987084242997
Task_48025,2122,654,192,138,330,3.23969465648855,43.28267340676348
Task_48026,2373,465,14,10,24,5.092274678111588,43.660511408907475
Task_48027,2479,486,181,12,193,5.090349075975359,47.02576444153858
Task_48028,2361,718,159,166,325,3.2837273991655076,47.28852027512974
Task_48029,1255,190,147,196,343,6.570680628272251,28.193077061426276
Task_48030,894,206,167,85,252,4.318840579710145,21.902137903759087
Task_48031,739,876,88,79,167,0.8426453819840365,21.058739663808755
Task_48032,2104,174,193,38,231,12.022857142857143,40.11327907148013
Task_48033,695,873,135,34,169,0.7951945080091534,19.98349883973475
Task_48034,1490,659,143,53,196,2.257575757575758,32.30778819854242
Task_48035,1583,595,177,80,257,2.6560402684563758,34.04691780533169
Task_48036,2064,505,100,29,129,4.07905138339921,40.212937894589494
Task_48037,2880,201,116,58,174,14.257425742574258,52.586651337679946
Task_48038,2281,764,11,135,146,2.981699346405229,45.09452611691322
Task_48039,1798,926,155,140,295,1.9395900755124056,38.84530710931785
Task_48040,1789,506,142,34,176,3.5285996055226825,36.17454070609361
Task_48041,1880,774,15,161,176,2.425806451612903,39.12681498169231
Task_48042,1107,225,156,159,315,4.898230088495575,25.79966353703664
Task_48043,665,346,72,157,229,1.9164265129682998,18.876796453852894
Task_48044,2226,981,154,81,235,2.2668024439918533,45.33752780200191
Task_48045,1328,505,127,25,152,2.624505928853755,28.58270469672121
Task_48046,1123,202,170,101,271,5.532019704433497,25.689421138885848
Task_48047,1974,396,100,158,258,4.972292191435768,39.81905146545063
Task_48048,766,180,23,154,177,4.232044198895028,19.234033427944958
Task_48049,1083,1009,132,79,211,1.0722772277227723,27.147826621188226
Task_48050,1220,933,147,196,343,1.3062098501070665,29.945405682789275
Task_48051,2917,297,122,87,209,9.788590604026846,54.01104046800353
Task_48052,2527,126,33,111,144,19.89763779527559,46.21701479996861
Task_48053,519,447,27,158,185,1.1584821428571428,16.50291332204813
Task_48054,728,458,23,164,187,1.5860566448801743,19.921629053520302
Task_48055,943,666,97,92,189,1.4137931034482758,23.846158331547358
Task_48056,504,387,41,11,52,1.2989690721649485,14.072855831870266
Task_48057,2611,254,125,57,182,10.239215686274509,48.57256257613606
Task_48058,1598,280,196,16,212,5.686832740213523,32.485299813805035
Task_48059,820,596,57,70,127,1.373534338358459,21.16974731235643
Task_48060,933,733,113,81,194,1.271117166212534,23.843927726966385
Task_48061,1739,453,127,21,148,3.8303964757709252,34.934126317967184
Task_48062,2573,596,117,60,177,4.309882747068677,49.093644095866246
Task_48063,2941,677,169,11,180,4.337758112094395,54.88874481777062
Task_48064,1438,81,178,62,240,17.536585365853657,29.068746680978276
Task_48065,1835,659,124,55,179,2.7803030303030303,37.62889069239346
Task_48066,1045,94,160,90,250,11.0,23.39824255432147
Task_48067,2691,101,35,166,201,26.38235294117647,49.331325854993956
Task_48068,839,553,52,90,142,1.5144404332129964,21.611139286162302
Task_48069,2824,943,108,200,308,2.9915254237288136,55.30277737930752
Task_48070,2085,807,82,168,250,2.5804455445544554,42.90212264303219
Task_48071,1863,995,102,63,165,1.8704819277108433,39.12184945914189
Task_48072,705,611,154,190,344,1.1519607843137254,20.77629656803091
Task_48073,1992,475,47,194,241,4.184873949579832,40.37623821347548
Task_48074,2854,586,77,185,262,4.862010221465076,54.488910576769406
Task_48075,1961,278,118,143,261,7.028673835125448,39.209090179017075
Task_48076,2506,730,187,95,282,3.4281805745554035,49.3388497064576
Task_48077,706,621,177,128,305,1.135048231511254,20.556518647242356
Task_48078,1880,613,41,67,108,3.0618892508143323,37.7170231411894
Task_48079,2872,443,94,41,135,6.468468468468468,52.82802058929304
Task_48080,2941,386,162,174,336,7.5994832041343665,55.46123955889485
Task_48081,631,413,31,79,110,1.5241545893719808,17.47118513705249
Task_48082,1432,135,31,171,202,10.529411764705882,29.80918442903497
Task_48083,1729,786,67,48,115,2.1969504447268107,35.62243168673191
Task_48084,1332,507,174,161,335,2.622047244094488,30.36497015948919
Task_48085,2362,1019,35,161,196,2.315686274509804,47.6707934772187
Task_48086,2427,536,180,35,215,4.5195530726256985,46.5604834758688
Task_48087,3000,718,84,17,101,4.172461752433936,55.24290897967479
Task_48088,1634,94,146,159,305,17.2,33.085539586178875
Task_48089,652,915,51,112,163,0.7117903930131004,20.098688770147508
Task_48090,2645,817,177,46,223,3.2334963325183375,50.95559626981326
Task_48091,2046,266,141,135,276,7.662921348314606,40.56641348763564
Task_48092,2936,252,123,177,300,11.604743083003953,54.74889985756656
Task_48093,1604,974,17,70,87,1.6451282051282052,34.21497055874776
Task_48094,2668,755,39,143,182,3.5291005291005293,51.562179931788364
Task_48095,755,948,66,199,265,0.7955742887249737,22.383460630754588
Task_48096,1055,733,104,35,139,1.4373297002724796,24.943515621417763
Task_48097,1015,290,96,68,164,3.4879725085910653,23.49119048943528
Task_48098,2829,967,132,184,316,2.9225206611570247,55.469590249920735
Task_48099,2467,453,154,66,220,5.433920704845815,47.223618043066416
Task_48100,2548,899,56,100,156,2.831111111111111,49.837649600766575
Task_48101,1789,123,154,105,259,14.42741935483871,35.54725645778118
Task_48102,571,491,162,165,327,1.160569105691057,18.168229938137543
Task_48103,2251,561,126,156,282,4.005338078291815,44.8409479791409
Task_48104,1254,355,195,94,289,3.5224719101123596,28.33385443074677
Task_48105,2048,312,18,109,127,6.543130990415335,39.86298575418243
Task_48106,1512,174,50,13,63,8.64,29.27988652735685
Task_48107,2355,708,87,48,135,3.321579689703808,45.49500222130715
Task_48108,1227,220,168,114,282,5.552036199095022,27.462826523298364
Task_48109,1883,512,184,133,317,3.6705653021442495,38.982054051827575
Task_48110,1127,265,128,109,237,4.2368421052631575,25.82550345664025
Task_48111,1300,156,136,130,266,8.280254777070065,28.154692888898296
Task_48112,1117,911,125,104,229,1.224780701754386,27.593201046746334
Task_48113,2893,937,133,34,167,3.0842217484008527,54.977672253669105
Task_48114,2813,591,190,156,346,4.7516891891891895,54.12479031412926
Task_48115,1446,81,167,181,348,17.634146341463413,30.324938576200978
Task_48116,1398,846,94,167,261,1.6505312868949233,32.141926602474626
Task_48117,907,293,20,135,155,3.0850340136054424,21.906665103230846
Task_48118,1786,448,101,103,204,3.977728285077951,36.68842576307355
Task_48119,1057,542,28,152,180,1.9465930018416207,25.37705171336313
Task_48120,1992,86,62,92,154,22.896551724137932,37.52148758961818
Task_48121,1085,623,144,39,183,1.7387820512820513,25.41281649846982
Task_48122,535,976,51,81,132,0.5475946775844421,18.315248536990335
Task_48123,646,110,70,116,186,5.81981981981982,17.129369998077337
Task_48124,1685,216,169,141,310,7.764976958525345,34.84660985214464
Task_48125,766,112,31,12,43,6.778761061946903,16.988696718535568
Task_48126,2833,66,70,23,93,42.28358208955224,49.03497214419551
Task_48127,2138,469,133,82,215,4.548936170212766,42.27534794164153
Task_48128,1882,288,122,146,268,6.5121107266435985,38.03076572257549
Task_48129,1761,435,71,88,159,4.0389908256880735,35.90392177337047
Task_48130,1965,611,158,168,326,3.2107843137254903,40.68637838701465
Task_48131,614,622,145,83,228,0.985553772070626,18.663157203767017
Task_48132,1087,447,147,112,259,2.4263392857142856,25.882780180837045
Task_48133,2463,994,179,42,221,2.4753768844221105,48.605905737027285
Task_48134,2722,234,161,135,296,11.582978723404254,51.219655449075354
Task_48135,2241,916,109,125,234,2.4438386041439477,45.536902189343444
Task_48136,2701,808,114,40,154,3.338689740420272,51.33169250639718
Task_48137,1483,843,70,76,146,1.7571090047393365,32.67283565364016
Task_48138,2833,969,78,71,149,2.9206185567010308,54.37642179950431
Task_48139,563,650,117,123,240,0.8648233486943164,18.12066345561256
Task_48140,2454,880,183,108,291,2.7854710556186153,49.031560760303705
Task_48141,670,451,185,58,243,1.4823008849557522,18.81537670949294
Task_48142,819,838,97,61,158,0.9761620977353993,21.93296803988149
Task_48143,2296,908,134,60,194,2.525852585258526,45.7841759689023
Task_48144,610,787,131,50,181,0.7741116751269036,18.571480885866688
Task_48145,1712,652,32,113,145,2.621745788667688,35.73413214987947
Task_48146,1001,450,177,161,338,2.2195121951219514,24.958951759185382
Task_48147,2343,466,163,143,306,5.017130620985011,46.08133954691207
Task_48148,2775,666,64,58,122,4.160419790104948,51.995145365815745
Task_48149,1708,225,146,87,233,7.557522123893805,34.75481433866159
Task_48150,2622,308,141,91,232,8.485436893203884,49.501838629806684
Task_48151,1588,700,80,34,114,2.265335235378031,33.02473860028102
Task_48152,1895,347,117,85,202,5.445402298850575,37.97131853971663
Task_48153,1889,200,29,190,219,9.398009950248756,37.67184522139298
Task_48154,1317,570,156,187,343,2.306479859894921,30.399919244911658
Task_48155,2266,454,153,107,260,4.98021978021978,44.56348460981312
Task_48156,2806,905,152,193,345,3.097130242825607,55.05521848394553
Task_48157,2383,282,174,169,343,8.420494699646643,46.301261046328214
Task_48158,2396,701,127,114,241,3.4131054131054133,47.33457761410316
Task_48159,1907,168,16,108,124,11.284023668639053,36.549247181033955
Task_48160,1935,892,35,11,46,2.1668533034714446,38.23245413076297
Task_48161,2171,771,25,100,125,2.812176165803109,43.27122274226367
Task_48162,1664,216,172,180,352,7.668202764976958,34.761482143272126
Task_48163,689,999,59,69,128,0.689,20.752095604890965
Task_48164,987,961,14,179,193,1.025987525987526,25.57945171188615
Task_48165,2205,920,91,48,139,2.3941368078175898,43.83127514575741
Task_48166,760,661,50,153,203,1.148036253776435,21.20086285161651
Task_48167,688,936,23,170,193,0.7342582710779082,20.84593315117186
Task_48168,2224,595,196,129,325,3.7315436241610738,44.67575324412841
Task_48169,758,853,64,191,255,0.8875878220140515,22.0370188519144
Task_48170,2713,330,141,105,246,8.196374622356496,51.15612241061524
Task_48171,1845,916,84,68,152,2.0119956379498363,38.39652886770685
Task_48172,1689,209,95,145,240,8.042857142857143,34.58482592883126
Task_48173,1499,420,40,35,75,3.5605700712589075,30.091517425420495
Task_48174,2222,468,71,183,254,4.73773987206823,44.056705498522184
Task_48175,664,141,24,92,116,4.676056338028169,16.693227378720135
Task_48176,2961,948,190,126,316,3.120126448893572,57.41690962932906
Task_48177,894,248,157,44,201,3.5903614457831323,21.31076221785329
Task_48178,1351,825,79,137,216,1.6355932203389831,31.1349487011079
Task_48179,1438,843,166,62,228,1.7037914691943128,32.13821889676917
Task_48180,2784,473,157,177,334,5.8734177215189876,53.260906719338756
Task_48181,2881,494,39,78,117,5.820202020202021,53.47936087255845
Task_48182,2639,407,78,199,277,6.4681372549019605,50.590752763967856
Task_48183,1022,308,89,118,207,3.307443365695793,24.163743950604765
Task_48184,1206,753,22,186,208,1.5994694960212201,28.57144989465957
Task_48185,2458,653,20,135,155,3.758409785932722,47.60637897346454
Task_48186,2814,730,81,22,103,3.849521203830369,52.34892274860196
Task_48187,1971,331,95,19,114,5.936746987951807,37.86875346202244
Task_48188,2512,215,166,101,267,11.62962962962963,47.648760049154085
Task_48189,1108,919,172,98,270,1.2043478260869565,27.663641166936788
Task_48190,1629,343,21,37,58,4.7354651162790695,31.90343156057543
Task_48191,2545,141,49,33,82,17.922535211267604,45.79335829265935
Task_48192,2110,72,188,61,249,28.904109589041095,39.63098768052959
Task_48193,708,747,188,50,238,0.946524064171123,20.30617220060108
Task_48194,1500,697,160,151,311,2.1489971346704873,33.49886763740604
Task_48195,864,367,79,52,131,2.347826086956522,21.103072987234846
Task_48196,680,431,46,20,66,1.5740740740740742,17.013656971830624
Task_48197,1334,576,13,186,199,2.3119584055459272,30.01352288884726
Task_48198,2432,507,20,29,49,4.78740157480315,45.06788586389508
Task_48199,1794,941,191,107,298,1.9044585987261147,38.79368720036255
Task_48200,699,149,149,183,332,4.66,19.03078323513855
Task_48201,2145,86,150,57,207,24.655172413793103,40.07787569348854
Task_48202,2985,207,123,19,142,14.350961538461538,53.70647886828814
Task_48203,1286,925,62,181,243,1.388768898488121,30.57246532543932
Task_48204,1679,262,106,148,254,6.38403041825095,34.67251110749502
Task_48205,711,67,187,167,354,10.455882352941176,18.822830373256718
Task_48206,1692,718,13,42,55,2.35326842837274,34.11375308063089
Task_48207,1758,397,108,33,141,4.417085427135678,35.04839346431849
Task_48208,1733,420,66,163,229,4.116389548693586,36.037450960144156
Task_48209,2504,429,53,98,151,5.823255813953488,47.62454559660336
Task_48210,2220,389,26,158,184,5.6923076923076925,43.30639503094398
Task_48211,765,224,191,134,325,3.4,20.403532153863726
Task_48212,1801,994,46,10,56,1.8100502512562815,36.499580122734216
Task_48213,892,327,99,104,203,2.7195121951219514,22.15343813496848
Task_48214,1694,712,194,70,264,2.375876577840112,36.01050729964957
Task_48215,1527,518,155,29,184,2.9421965317919074,32.08853131855455
Task_48216,2632,101,36,23,59,25.80392156862745,46.4024890618928
Task_48217,1879,453,191,46,237,4.138766519823789,37.73410077150979
Task_48218,2929,687,95,97,192,4.257267441860465,55.52600889255897
Task_48219,2555,1019,158,20,178,2.5049019607843137,49.847396549760184
Task_48220,889,1012,175,28,203,0.8775913129318855,23.664758538146085
Task_48221,1408,779,64,163,227,1.8051282051282052,32.00635636847452
Task_48222,2546,73,36,166,202,34.4054054054054,46.81961950933107
Task_48223,2468,949,121,119,240,2.5978947368421053,49.25506226827065
Task_48224,1957,915,146,11,157,2.13646288209607,39.83375677118349
Task_48225,1977,180,188,54,242,10.922651933701658,38.44262896380328
Task_48226,684,762,42,131,173,0.8964613368283093,20.03986274178477
Task_48227,2231,289,141,25,166,7.6931034482758625,42.378148316567824
Task_48228,798,530,143,120,263,1.502824858757062,21.555275128147628
Task_48229,1413,590,192,99,291,2.3908629441624365,31.61358970723111
Task_48230,1789,876,85,198,283,2.039908779931585,38.58415046421888
Task_48231,892,620,188,11,199,1.4363929146537842,22.310967654683513
Task_48232,978,201,41,196,237,4.841584158415841,23.39588315493123
Task_48233,2995,966,81,186,267,3.097207859358842,57.93237257451286
Task_48234,2190,833,25,18,43,2.6258992805755397,42.0625578900961
Task_48235,2071,372,172,173,345,5.552278820375335,41.68890162107848
Task_48236,671,575,21,75,96,1.1649305555555556,18.353908526713038
Task_48237,2328,909,129,120,249,2.558241758241758,46.953910626145706
Task_48238,1460,969,79,39,118,1.5051546391752577,31.819138698487503
Task_48239,2250,685,54,149,203,3.2798833819241984,44.92156370451954
Task_48240,786,528,107,153,260,1.4858223062381852,21.39389214209507
Task_48241,2630,754,30,31,61,3.4834437086092715,49.01355752632492
Task_48242,749,483,114,38,152,1.5475206611570247,19.396263292737476
Task_48243,665,84,169,200,369,7.823529411764706,18.22824526797859
Task_48244,1526,921,174,199,373,1.6550976138828633,34.944348093315334
Task_48245,1341,170,159,29,188,7.842105263157895,27.84759797890605
Task_48246,2596,482,122,134,256,5.374741200828157,49.89965103267317
Task_48247,1800,522,196,144,340,3.4416826003824093,37.819589359557035
Task_48248,2490,200,104,189,293,12.388059701492537,47.48788921140197
Task_48249,2218,416,42,169,211,5.3189448441247,43.5665695650365
Task_48250,2917,1018,68,12,80,2.86261040235525,54.633673714193684
Task_48251,2798,496,35,35,70,5.629778672032193,50.89273900172133
Task_48252,2675,921,197,54,251,2.901301518438178,52.10641502892489
Task_48253,809,844,110,31,141,0.9573964497041421,21.53176962607621
Task_48254,2164,992,66,154,220,2.179254783484391,44.61019638932251
Task_48255,1809,264,161,175,336,6.826415094339622,37.14301594909487
Task_48256,2964,417,130,57,187,7.090909090909091,54.75467578811166
Task_48257,2504,493,172,167,339,5.068825910931174,48.90138343530649
Task_48258,1353,203,80,137,217,6.632352941176471,29.1863030836508
Task_48259,2067,579,162,12,174,3.5637931034482757,40.70386187393783
Task_48260,2443,142,91,32,123,17.083916083916083,44.50513231138643
Task_48261,1018,333,40,85,125,3.0479041916167664,23.633875617497306
Task_48262,2458,257,148,118,266,9.527131782945736,46.974854660863095
Task_48263,2733,755,128,200,328,3.615079365079365,53.36140736718128
Task_48264,1171,485,56,145,201,2.409465020576132,27.18894512302187
Task_48265,1532,975,80,74,154,1.569672131147541,33.726979777385566
Task_48266,1368,761,61,155,216,1.795275590551181,31.252194249813012
Task_48267,1273,89,130,67,197,14.144444444444444,26.36387688665211
Task_48268,710,672,60,172,232,1.0549777117384844,20.54498403077248
Task_48269,1336,148,111,91,202,8.966442953020135,28.237872753735434
Task_48270,2912,638,23,45,68,4.557120500782473,53.161393674146325
Task_48271,928,385,54,95,149,2.4041450777202074,22.607661892476
Task_48272,2558,342,194,90,284,7.457725947521866,48.863471769277965
Task_48273,2181,232,138,17,155,9.360515021459227,41.16348456304677
Task_48274,1143,243,33,18,51,4.684426229508197,23.71516142721354
Task_48275,550,478,49,75,124,1.1482254697286012,16.59238932276584
Task_48276,781,206,61,200,261,3.7729468599033815,20.47152722667077
Task_48277,2235,843,32,62,94,2.6481042654028437,43.782837778884925
Task_48278,1873,225,140,29,169,8.287610619469026,36.500716795402916
Task_48279,2836,399,92,22,114,7.09,51.79342503677709
Task_48280,1503,520,77,34,111,2.8848368522072936,31.072540564527472
Task_48281,1801,446,141,144,285,4.029082774049217,37.34458216685048
Task_48282,669,636,74,184,258,1.0502354788069075,19.90993122057158
Task_48283,757,344,92,127,219,2.1942028985507247,20.184316217432503
Task_48284,540,689,113,103,216,0.782608695652174,17.769383246758373
Task_48285,705,696,193,41,234,1.011477761836442,19.852221210732566
Task_48286,804,898,43,200,243,0.8943270300333704,22.800369068539425
Task_48287,697,889,52,76,128,0.7831460674157303,20.524027410848248
Task_48288,1835,410,87,69,156,4.464720194647202,36.59405500462511
Task_48289,1519,994,141,139,280,1.5266331658291457,34.523432421151064
Task_48290,1855,899,31,190,221,2.061111111111111,39.40177561634969
Task_48291,2121,443,93,178,271,4.777027027027027,42.42487517853356
Task_48292,2967,362,157,11,168,8.173553719008265,54.180310843728876
Task_48293,1535,114,41,25,66,13.347826086956522,29.351315128423888
Task_48294,940,918,30,44,74,1.0228509249183895,22.873319536958775
Task_48295,2256,403,187,88,275,5.584158415841584,44.21912878545916
Task_48296,2928,685,116,19,135,4.2682215743440235,54.38416952709545
Task_48297,2632,514,49,110,159,5.110679611650485,50.00006473292336
Task_48298,2331,317,107,26,133,7.330188679245283,43.79657763861203
Task_48299,631,139,115,44,159,4.507142857142857,16.08113054487704
Task_48300,918,252,184,176,360,3.6284584980237153,23.132366544734428
Task_48301,1972,136,11,84,95,14.394160583941606,37.06322623387064
Task_48302,2367,287,35,65,100,8.21875,44.26437761497328
Task_48303,1967,760,123,178,301,2.5847568988173455,41.08818235604298
Task_48304,1344,344,24,113,137,3.8956521739130436,28.84715837279722
Task_48305,2657,1021,38,19,57,2.599804305283757,50.18108935348628
Task_48306,2953,908,192,38,230,3.2486248624862486,56.1507061753476
Task_48307,2200,533,11,179,190,4.119850187265918,43.52032127290227
Task_48308,1277,1005,74,38,112,1.2693836978131212,29.052461472048247
Task_48309,2274,241,121,139,260,9.396694214876034,44.01269277289341
Task_48310,561,987,14,87,101,0.5678137651821862,18.233110335707483
Task_48311,1219,267,130,167,297,4.548507462686567,27.64156845568345
Task_48312,568,101,138,114,252,5.568627450980392,16.13520491819777
Task_48313,996,307,26,142,168,3.2337662337662336,23.570932685270773
Task_48314,1492,836,76,149,225,1.7825567502986859,33.46819767781073
Task_48315,2051,1004,114,144,258,2.0407960199004975,42.935980992964254
Task_48316,875,862,123,26,149,1.0139049826187718,22.58602655058155
Task_48317,2121,878,175,198,373,2.4129692832764507,44.250481926301994
Task_48318,2860,513,132,193,325,5.56420233463035,54.5772539877006
Task_48319,2553,464,153,82,235,5.490322580645161,48.918340899150415
Task_48320,1279,503,14,68,82,2.5376984126984126,27.53412767332199
Task_48321,1740,540,57,68,125,3.2162661737523104,35.52893914956541
Task_48322,2514,71,137,21,158,34.916666666666664,44.82425972840529
Task_48323,1897,242,91,152,243,7.806584362139918,38.00232025054395
Task_48324,1763,693,120,107,227,2.5403458213256482,37.209220271206924
Task_48325,2924,983,66,54,120,2.9715447154471546,55.37072993320089
Task_48326,2379,991,33,113,146,2.3981854838709675,47.3741090681558
Task_48327,2880,319,77,21,98,9.0,52.01944315159414
Task_48328,2214,258,183,110,293,8.548262548262548,43.23278913018671
Task_48329,1096,830,54,99,153,1.3188929001203369,26.509306174015062
Task_48330,947,520,157,161,318,1.817658349328215,24.23382807285505
Task_48331,2337,947,145,31,176,2.4651898734177213,46.24299907097066
Task_48332,767,252,77,137,214,3.0316205533596836,20.098226366620434
Task_48333,999,534,73,105,178,1.8672897196261682,24.422037451599625
Task_48334,1862,703,65,27,92,2.6448863636363638,37.147332191561624
Task_48335,711,424,198,101,299,1.6729411764705882,20.010236327509833
Task_48336,1580,918,23,31,54,1.719260065288357,32.89874437770845
Task_48337,1933,748,16,88,104,2.5807743658210947,39.09690064223468
Task_48338,1857,1003,96,95,191,1.849601593625498,39.5039420207272
Task_48339,536,704,155,147,302,0.7602836879432624,18.206920813755954
Task_48340,903,832,75,106,181,1.084033613445378,23.735850836685355
Task_48341,1631,447,80,165,245,3.640625,34.56090600588778
Task_48342,2484,823,18,191,209,3.0145631067961167,49.06497031090237
Task_48343,2397,242,17,169,186,9.864197530864198,45.59847073109069
Task_48344,1544,306,200,174,374,5.029315960912052,33.26664666347268
Task_48345,2985,1011,21,137,158,2.949604743083004,57.092841762546215
Task_48346,1390,315,40,161,201,4.39873417721519,30.072484235273507
Task_48347,635,404,194,122,316,1.5679012345679013,18.822920363521902
Task_48348,2061,703,26,140,166,2.9275568181818183,41.68918512989944
Task_48349,1502,561,85,58,143,2.6725978647686834,31.81621005057416
Task_48350,2582,642,193,85,278,4.015552099533437,50.14134540279252
Task_48351,2346,290,85,141,226,8.061855670103093,45.182238729871166
Task_48352,784,413,69,47,116,1.893719806763285,19.44864991680188
Task_48353,2650,538,192,113,305,4.916512059369202,51.125742023801706
Task_48354,1428,360,21,35,56,3.955678670360111,28.760237914349702
Task_48355,1931,550,192,180,372,3.50453720508167,40.179733529156145
Task_48356,1036,793,21,20,41,1.3047858942065491,23.680849412469275
Task_48357,2017,147,71,137,208,13.628378378378379,39.23657016630016
Task_48358,1347,539,63,54,117,2.4944444444444445,28.902043051013177
Task_48359,2277,947,119,189,308,2.401898734177215,46.63130119203159
Task_48360,2605,446,32,72,104,5.827740492170022,48.64814529921977
Task_48361,2438,984,87,26,113,2.4751269035532997,47.36823704350244
Task_48362,2928,342,176,176,352,8.536443148688047,55.1799972897785
Task_48363,2307,481,15,186,201,4.786307053941909,45.133439570897316
Task_48364,870,313,70,199,269,2.770700636942675,22.268076330027668
Task_48365,993,250,187,124,311,3.956175298804781,24.013690853986407
Task_48366,2435,636,66,46,112,3.8226059654631084,46.23134874778726
Task_48367,1964,111,135,144,279,17.535714285714285,38.30602041539068
Task_48368,1127,630,167,39,206,1.786053882725832,26.233146384368172
Task_48369,2548,800,19,28,47,3.1810237203495633,47.77524498999018
Task_48370,2940,1021,87,166,253,2.8767123287671232,57.04709057336617
Task_48371,1909,166,185,125,310,11.431137724550899,37.96356871126347
Task_48372,2005,442,83,77,160,4.525959367945824,39.641969679076006
Task_48373,2737,910,34,160,194,3.004390779363337,53.26061525722799
Task_48374,2532,694,56,160,216,3.643165467625899,49.49111422084706
Task_48375,1464,296,151,166,317,4.929292929292929,31.69981537475503
Task_48376,536,387,200,70,270,1.3814432989690721,16.660539040309434
Task_48377,2060,619,105,22,127,3.3225806451612905,40.3790103665633
Task_48378,2842,387,88,126,214,7.324742268041237,53.236793039425386
Task_48379,2085,216,25,35,60,9.608294930875577,38.60503188717924
Task_48380,2756,900,102,144,246,3.0588235294117645,53.72927719576993
Task_48381,1494,861,27,192,219,1.7331786542923433,33.53665564656153
Task_48382,2360,769,13,15,28,3.064935064935065,44.432578613192014
Task_48383,2394,749,127,61,188,3.192,46.789430396662134
Task_48384,2400,163,196,95,291,14.634146341463415,45.57284672507466
Task_48385,1277,421,89,45,134,3.0260663507109005,27.477037748096876
Task_48386,2744,199,138,187,325,13.72,51.64381825805978
Task_48387,2078,82,138,125,263,25.03614457831325,39.77155391290183
Task_48388,1592,298,167,103,270,5.3244147157190636,33.42599633772032
Task_48389,786,808,136,180,316,0.9715698393077874,22.5640087090781
Task_48390,2625,155,77,76,153,16.826923076923077,48.02528608055806
Task_48391,664,77,25,125,150,8.512820512820513,16.634076191996936
Task_48392,1053,581,23,62,85,1.809278350515464,24.1565215815007
Task_48393,1168,909,144,36,180,1.2835164835164836,27.62608240222258
Task_48394,2096,272,49,54,103,7.677655677655678,39.754198395465316
Task_48395,968,245,130,181,311,3.934959349593496,23.685634630025522
Task_48396,1253,908,190,63,253,1.3784378437843785,29.55619224522816
Task_48397,1115,705,134,184,318,1.5793201133144477,27.46247658518385
Task_48398,2397,472,16,164,180,5.067653276955602,46.36892214826861
Task_48399,750,439,43,70,113,1.7045454545454546,19.440813993141294
Task_48400,2048,319,157,133,290,6.4,40.84118828163169
Task_48401,2471,192,37,138,175,12.803108808290155,46.51745726475881
Task_48402,1479,898,147,57,204,1.6451612903225807,32.864181910991576
Task_48403,2368,831,62,154,216,2.8461538461538463,47.31223537887555
Task_48404,2168,190,68,44,112,11.350785340314136,40.59910252448209
Task_48405,1055,327,200,185,385,3.216463414634146,25.668580292131736
Task_48406,2446,195,170,75,245,12.479591836734693,46.23162326313848
Task_48407,1448,633,198,83,281,2.2839116719242902,32.16824684471416
Task_48408,1169,446,92,164,256,2.615212527964206,27.247843716216696
Task_48409,1897,979,85,185,270,1.9357142857142857,40.53809146459961
Task_48410,592,590,83,125,208,1.0016920473773265,18.192303961607312
Task_48411,1877,1004,43,95,138,1.8676616915422886,39.437164702296904
Task_48412,2679,132,179,62,241,20.142857142857142,49.13828267316621
Task_48413,1728,636,177,26,203,2.7127158555729984,35.721581612513624
Task_48414,1003,908,57,41,98,1.1034103410341034,24.226555874425955
Task_48415,640,192,109,132,241,3.316062176165803,17.94132719225738
Task_48416,1522,927,133,90,223,1.6400862068965518,34.036079862547034
Task_48417,2984,540,190,84,274,5.515711645101663,56.163794474951516
Task_48418,2439,581,63,129,192,4.190721649484536,47.503647164921084
Task_48419,2288,508,53,135,188,4.495088408644401,44.861233238656745
Task_48420,1114,195,160,42,202,5.683673469387755,24.64506028745331
Task_48421,2136,644,76,92,168,3.311627906976744,42.64920150943823
Task_48422,1984,254,117,120,237,7.780392156862745,39.34640279931891
Task_48423,1573,172,47,89,136,9.092485549132949,31.514827599968353
Task_48424,1178,632,106,133,239,1.8609794628751974,27.844791520549915
Task_48425,1571,726,53,106,159,2.160935350756534,33.837666963684896
Task_48426,1182,751,88,16,104,1.571808510638298,26.512163158917648
Task_48427,1545,1021,158,37,195,1.5117416829745598,34.03134148443191
Task_48428,2150,922,37,122,159,2.3293607800650054,43.610157006482666
Task_48429,2905,130,159,128,287,22.17557251908397,53.33296162747333
Task_48430,626,506,58,85,143,1.2347140039447733,18.052354238780612
Task_48431,622,378,46,122,168,1.641160949868074,17.883411913513
Task_48432,1386,577,150,194,344,2.397923875432526,31.529307178264606
Task_48433,895,226,32,117,149,3.94273127753304,21.47151997182075
Task_48434,1218,477,67,200,267,2.5481171548117154,28.290693724654236
Task_48435,957,849,38,92,130,1.1258823529411766,24.304068474146288
Task_48436,2493,279,171,108,279,8.903571428571428,47.65146179225309
Task_48437,872,549,156,187,343,1.5854545454545454,23.245033080023873
Task_48438,1599,678,41,18,59,2.3549337260677468,32.33769724229666
Task_48439,1582,1012,187,151,338,1.5616979269496545,35.856593448200464
Task_48440,2874,632,16,155,171,4.540284360189573,54.34965358320951
Task_48441,1329,634,25,151,176,2.0929133858267717,29.948495778617417
Task_48442,2426,649,182,112,294,3.732307692307692,47.88145528273634
Task_48443,1171,538,168,97,265,2.1725417439703154,27.53255536287209
Task_48444,889,447,192,172,364,1.984375,23.31010570989581
Task_48445,2091,181,140,199,339,11.489010989010989,41.13861308734724
Task_48446,2025,791,54,117,171,2.5568181818181817,41.44046621620153
Task_48447,1430,717,110,130,240,1.9916434540389971,32.10167410613098
Task_48448,2669,149,198,183,381,17.793333333333333,50.29451238116517
Task_48449,2241,841,87,156,243,2.661520190023753,45.34909317050426
Task_48450,1597,828,45,116,161,1.9264173703256937,34.577835822708664
Task_48451,883,329,52,173,225,2.675757575757576,22.288171771842627
Task_48452,2448,567,54,101,155,4.309859154929577,47.20443227607189
Task_48453,675,676,33,91,124,0.9970457902511078,19.19392090630733
Task_48454,1966,150,175,145,320,13.019867549668874,38.890199329648134
Task_48455,2634,160,33,92,125,16.36024844720497,48.05105476058272
Task_48456,1538,654,40,148,188,2.348091603053435,33.40385835642248
Task_48457,984,115,18,15,33,8.482758620689655,20.362506476719968
Task_48458,2595,662,26,105,131,3.914027149321267,49.69246067027132
Task_48459,827,474,113,17,130,1.7410526315789474,20.408904681798806
Task_48460,2265,518,169,186,355,4.364161849710983,45.29812645458146
Task_48461,1048,847,73,50,123,1.2358490566037736,25.144590469077738
Task_48462,2340,984,118,146,264,2.3756345177664975,47.48351583258426
Task_48463,1921,728,66,76,142,2.635116598079561,39.222979214996805
Task_48464,1959,665,100,167,267,2.9414414414414414,40.494133010476624
Task_48465,1516,73,107,63,170,20.486486486486488,29.91817165515846
Task_48466,2661,992,50,50,100,2.6797583081570995,50.863649745007116
Task_48467,2986,808,102,149,251,3.6909765142150803,57.114686805993394
Task_48468,885,159,113,74,187,5.53125,20.89619183407773
Task_48469,1067,614,197,35,232,1.7349593495934958,25.336795002917555
Task_48470,2775,66,32,67,99,41.417910447761194,48.73611484193007
Task_48471,590,706,81,14,95,0.8345120226308345,17.161532333756682
Task_48472,1665,424,12,104,116,3.9176470588235293,34.00719213035409
Task_48473,2643,817,147,135,282,3.2310513447432765,51.82787261403028
Task_48474,2444,832,186,51,237,2.9339735894357744,48.082082457100064
Task_48475,2592,360,76,84,160,7.18005540166205,48.78765006409615
Task_48476,1568,414,190,73,263,3.778313253012048,33.12100116596765
Task_48477,1019,812,115,189,304,1.2533825338253382,26.19636250307806
Task_48478,1917,119,17,62,79,15.975,35.72092825076363
Task_48479,1297,121,23,126,149,10.631147540983607,26.885429168749905
Task_48480,2767,128,70,192,262,21.449612403100776,51.20721384758198
Task_48481,908,292,13,46,59,3.098976109215017,20.354383278933337
Task_48482,2201,970,101,17,118,2.266735324407827,43.49578814467486
Task_48483,2858,651,50,151,201,4.383435582822086,54.46625993277692
Task_48484,1877,949,165,97,262,1.9757894736842105,39.98525232404479
Task_48485,999,860,150,112,262,1.1602787456445993,25.72168403349131
Task_48486,2669,175,156,58,214,15.164772727272727,49.180022531672044
Task_48487,1362,834,19,68,87,1.6311377245508982,29.971400890868036
Task_48488,1428,825,190,110,300,1.728813559322034,32.63391333897869
Task_48489,583,514,151,189,340,1.1320388349514563,18.516318893461364
Task_48490,1704,840,38,57,95,2.0261593341260404,35.33614465166033
Task_48491,2466,961,66,120,186,2.5634095634095635,49.062937508343225
Task_48492,2071,592,117,191,308,3.4924114671163573,42.25755338595375
Task_48493,1672,887,179,105,284,1.882882882882883,36.626664544087355
Task_48494,2376,376,104,104,208,6.30238726790451,45.808923647544646
Task_48495,2566,717,180,128,308,3.573816155988858,50.400421567245964
Task_48496,620,632,151,13,164,0.9794628751974723,18.06225312184424
Task_48497,806,835,49,153,202,0.9641148325358851,22.452189250969194
Task_48498,1335,566,168,148,316,2.3544973544973544,30.493530556178726
Task_48499,811,440,145,100,245,1.8390022675736961,21.411684638480263
Task_48500,2832,328,12,163,175,8.60790273556231,52.738079131832045
Task_48501,902,70,75,85,160,12.704225352112676,20.478639125209636
Task_48502,2949,1004,50,138,188,2.934328358208955,56.927041190808296
Task_48503,2476,272,31,176,207,9.06959706959707,47.13029341826021
Task_48504,926,966,130,95,225,0.9576008273009308,24.76335463133526
Task_48505,2353,280,119,92,211,8.373665480427047,45.06036104358781
Task_48506,1857,709,141,187,328,2.6154929577464787,39.320830259253775
Task_48507,1007,1002,46,130,176,1.003988035892323,25.878963947203246
Task_48508,2298,875,109,169,278,2.6232876712328768,46.57497256198107
Task_48509,1273,338,39,17,56,3.7551622418879056,26.10256521634624
Task_48510,936,680,107,41,148,1.3744493392070485,22.976512752591777
Task_48511,2246,561,106,85,191,3.99644128113879,44.168563444586766
Task_48512,1928,689,148,149,297,2.794202898550725,40.18734150456472
Task_48513,1524,204,38,166,204,7.434146341463415,31.829782076459026
Task_48514,2902,194,191,184,375,14.882051282051282,54.31738757329645
Task_48515,634,74,30,21,51,8.453333333333333,14.30624167374385
Task_48516,2409,209,102,192,294,11.471428571428572,46.25402027200388
Task_48517,983,139,38,21,59,7.021428571428571,20.817914859950097
Task_48518,2520,330,113,26,139,7.613293051359516,46.82933890401423
Task_48519,934,810,159,137,296,1.1516646115906288,24.72685551819811
Task_48520,1645,852,37,27,64,1.928487690504103,33.72709014103531
Task_48521,1161,703,149,99,248,1.6491477272727273,27.76814297214715
Task_48522,2629,427,176,53,229,6.142523364485982,49.749551707198286
Task_48523,2744,787,45,172,217,3.482233502538071,53.12316430702606
Task_48524,2080,885,64,66,130,2.3476297968397293,42.07218003194314
Task_48525,617,149,84,108,192,4.113333333333333,17.00487046574835
Task_48526,981,810,82,96,178,1.2096177558569667,24.933997442991203
Task_48527,1335,840,168,101,269,1.587395957193817,31.024827009970338
Task_48528,1561,340,71,167,238,4.577712609970675,33.084709643294715
Task_48529,1308,175,137,104,241,7.431818181818182,28.156747849594364
Task_48530,1088,922,64,105,169,1.1787648970747562,26.917600914766055
Task_48531,2125,820,104,165,269,2.5883069427527405,43.615687677182024
Task_48532,2182,822,20,139,159,2.651275820170109,43.78400234955016
Task_48533,798,909,38,173,211,0.8769230769230769,22.531663672889206
Task_48534,1578,806,105,105,210,1.9553903345724908,34.55178930803687
Task_48535,2289,71,153,54,207,31.791666666666668,42.216740289513005
Task_48536,2192,90,136,138,274,24.087912087912088,41.69743543476712
Task_48537,1979,541,114,102,216,3.651291512915129,40.093714631178415
Task_48538,2261,256,70,85,155,8.797665369649806,43.190190339287234
Task_48539,1813,282,189,141,330,6.406360424028269,37.191555466704024
Task_48540,2342,176,73,150,223,13.231638418079097,44.518125919961534
Task_48541,715,925,179,34,213,0.7721382289416847,20.709317251273163
Task_48542,1386,412,18,91,109,3.3559322033898304,29.450253678517345
Task_48543,2522,341,169,128,297,7.374269005847953,48.43668242609036
Task_48544,1734,927,119,61,180,1.8685344827586208,36.857217299768
Task_48545,574,609,37,155,192,0.940983606557377,17.943319771527726
Task_48546,2312,714,163,86,249,3.2335664335664336,45.97359772035327
Task_48547,2362,788,39,47,86,2.993662864385298,45.30604129948304
Task_48548,2056,961,67,10,77,2.137214137214137,40.55791360536352
Task_48549,2544,98,88,147,235,25.696969696969695,47.045922965238475
Task_48550,1567,965,49,193,242,1.6221532091097308,35.22739849526882
Task_48551,977,436,24,31,55,2.2356979405034325,21.828130078820426
Task_48552,2776,425,103,51,154,6.516431924882629,51.51620314015929
Task_48553,1415,282,93,34,127,5.0,29.24982265397146
Task_48554,1511,538,97,120,217,2.803339517625232,32.712648462122225
Task_48555,1365,570,61,59,120,2.3905429071803854,29.337682856782067
Task_48556,1134,186,24,87,111,6.064171122994653,24.784398867660595
Task_48557,1721,198,29,157,186,8.64824120603015,34.82854371277191
Task_48558,2085,579,115,109,224,3.5948275862068964,41.93924178816628
Task_48559,1146,844,127,75,202,1.3562130177514793,27.535881651557947
Task_48560,2079,357,16,50,66,5.807262569832402,39.18073408437311
Task_48561,2406,862,117,102,219,2.7879490150637314,47.881446681712674
Task_48562,2362,642,28,151,179,3.6734059097978227,46.35235203720319
Task_48563,730,319,105,116,221,2.28125,19.662994417437044
Task_48564,1932,398,190,190,380,4.842105263157895,39.75778651869977
Task_48565,621,476,81,18,99,1.3018867924528301,16.744110345831082
Task_48566,1367,198,13,155,168,6.869346733668341,29.115836630368282
Task_48567,1915,225,146,100,246,8.473451327433628,38.16301765903557
Task_48568,924,412,163,33,196,2.23728813559322,22.28401486020502
Task_48569,1331,235,189,99,288,5.639830508474576,29.156388747233493
Task_48570,1414,483,122,84,206,2.9214876033057853,30.81830663522959
Task_48571,1712,1005,189,125,314,1.7017892644135189,37.77803158611196
Task_48572,931,345,20,101,121,2.6907514450867054,22.180014924970223
Task_48573,605,294,107,12,119,2.0508474576271185,16.10812461106532
Task_48574,894,965,46,50,96,0.9254658385093167,22.873331542529513
Task_48575,2410,64,170,131,301,37.07692307692308,45.0887215135296
Task_48576,1018,423,126,152,278,2.400943396226415,24.85910854407865
Task_48577,1786,811,98,31,129,2.1995073891625614,36.781931369879764
Task_48578,2275,507,93,35,128,4.478346456692913,43.733431767162436
Task_48579,2696,579,37,198,235,4.6482758620689655,51.81872715533557
Task_48580,2118,370,165,73,238,5.708894878706199,41.56713403662625
Task_48581,2438,959,168,60,228,2.5395833333333333,48.346560823151115
Task_48582,2248,200,167,55,222,11.18407960199005,42.84668707313724
Task_48583,834,249,97,12,109,3.336,19.548619614139977
Task_48584,975,384,108,135,243,2.5324675324675323,23.872329033389537
Task_48585,1215,647,147,170,317,1.875,28.88341429578203
Task_48586,2297,459,25,16,41,4.993478260869566,42.53617536310334
Task_48587,2228,315,182,97,279,7.050632911392405,43.59997956761952
Task_48588,2174,584,103,24,127,3.7162393162393164,42.07764716293942
Task_48589,2598,482,57,59,116,5.37888198757764,48.57966197251735
Task_48590,1586,161,51,181,232,9.790123456790123,32.65702941902432
Task_48591,2340,484,100,123,223,4.824742268041237,45.68873359704376
Task_48592,858,126,140,92,232,6.755905511811024,20.667937865310293
Task_48593,1107,322,21,67,88,3.4272445820433437,24.30332858995816
Task_48594,2975,64,124,112,236,45.76923076923077,53.59351989558755
Task_48595,2323,169,78,174,252,13.66470588235294,44.39896305031542
Task_48596,2500,898,72,95,167,2.7808676307007785,49.28051568212734
Task_48597,2961,717,69,74,143,4.123955431754875,55.652256656505266
Task_48598,1562,630,173,39,212,2.4754358161648176,33.14964072127571
Task_48599,862,145,154,67,221,5.904109589041096,20.560545061560628
Task_48600,2294,673,69,27,96,3.4035608308605343,44.009281305652905
Task_48601,1794,465,68,80,148,3.8497854077253217,36.50239965330355
Task_48602,1524,589,134,104,238,2.5830508474576273,33.14268028070334
Task_48603,1996,994,82,118,200,2.006030150753769,41.775837616330286
Task_48604,545,566,194,91,285,0.9611992945326279,17.678672596551845
Task_48605,1361,598,181,131,312,2.2721202003338896,30.962724956316013
Task_48606,698,160,140,38,178,4.3354037267080745,17.590658483428843
Task_48607,2500,937,69,64,133,2.6652452025586353,48.91742964742446
Task_48608,1644,935,56,12,68,1.7564102564102564,33.77364045654055
Task_48609,1899,621,140,47,187,3.053054662379421,38.361770372281335
Task_48610,1153,814,127,20,147,1.4147239263803681,26.787202721026336
Task_48611,1065,738,125,25,150,1.4411366711772666,25.160782858675756
Task_48612,2957,388,148,12,160,7.6015424164524426,54.007290783126116
Task_48613,532,1018,130,183,313,0.5220804710500491,19.35973081196683
Task_48614,2686,584,164,151,315,4.591452991452991,51.944164486415694
Task_48615,2864,997,35,195,230,2.869739478957916,55.76060313090258
Task_48616,1255,782,54,109,163,1.602809706257982,29.151147373950078
Task_48617,2401,623,171,188,359,3.84775641025641,47.80747463765673
Task_48618,2523,351,102,181,283,7.167613636363637,48.501146917979895
Task_48619,1712,282,167,137,304,6.049469964664311,35.47198721967468
Task_48620,530,996,123,144,267,0.5315947843530592,18.96035681626842
Task_48621,2925,857,28,100,128,3.409090909090909,55.642763636596726
Task_48622,627,819,40,161,201,0.7646341463414634,19.511089242932652
Task_48623,954,874,58,199,257,1.0902857142857143,25.19225840927776
Task_48624,1261,406,129,74,203,3.098280098280098,28.01975618752698
Task_48625,2831,528,126,35,161,5.351606805293006,52.59509426227785
Task_48626,1404,307,10,200,210,4.558441558441558,30.315611348058752
Task_48627,2775,151,26,13,39,18.25657894736842,48.91004093956247
Task_48628,2516,827,101,39,140,3.0386473429951693,48.4093414918891
Task_48629,1411,131,112,133,245,10.68939393939394,29.63593276339671
Task_48630,1226,1009,190,56,246,1.2138613861386138,29.383161245064063
Task_48631,2027,420,46,52,98,4.814726840855107,39.14247296639
Task_48632,1968,256,24,163,187,7.657587548638133,38.91229125327364
Task_48633,2102,488,94,73,167,4.298568507157464,41.375115214244346
Task_48634,2527,455,90,123,213,5.541666666666667,48.50386949365117
Task_48635,1827,251,148,99,247,7.25,36.863389600110686
Task_48636,2688,527,29,168,197,5.090909090909091,51.288275197202715
Task_48637,858,533,13,186,199,1.6067415730337078,22.328814612823397
Task_48638,1424,356,163,173,336,3.988795518207283,31.360533762723804
Task_48639,1976,939,117,82,199,2.1021276595744682,41.11744339426968
Task_48640,1787,939,76,139,215,1.901063829787234,38.416315860174926
Task_48641,1453,530,37,137,174,2.736346516007533,31.594192831534173
Task_48642,2109,637,165,15,180,3.30564263322884,41.57608529172749
Task_48643,2481,846,176,123,299,2.9291617473435654,49.41107354045395
Task_48644,2281,1006,189,193,382,2.2651439920556107,47.2177425247977
Task_48645,590,915,84,162,246,0.6441048034934498,19.592397058430887
Task_48646,2458,967,103,130,233,2.5392561983471076,49.137291001664494
Task_48647,706,226,22,84,106,3.1101321585903086,18.055351954787962
Task_48648,756,973,194,160,354,0.7761806981519507,22.7747977790861
Task_48649,2050,318,103,45,148,6.4263322884012535,39.45220879802199
Task_48650,1595,705,47,197,244,2.2592067988668556,34.834304974150164
Task_48651,1957,195,42,81,123,9.98469387755102,37.98409200525017
Task_48652,2203,193,96,68,164,11.355670103092784,41.975301607835725
Task_48653,2717,421,62,116,178,6.438388625592417,51.27809142598641
Task_48654,1385,92,16,42,58,14.89247311827957,26.6839987324597
Task_48655,2016,329,14,131,145,6.109090909090909,39.516704476496535
Task_48656,2099,536,143,98,241,3.908752327746741,42.09215155704966
Task_48657,2185,320,14,18,32,6.806853582554517,40.24082047054136
Task_48658,2568,1011,28,61,89,2.5375494071146245,49.49048445808473
Task_48659,1415,847,127,103,230,1.6686320754716981,32.17054840815663
Task_48660,2092,996,140,63,203,2.0982948846539617,42.911738948285226
Task_48661,1349,348,98,52,150,3.865329512893983,28.76417038073131
Task_48662,2525,829,154,35,189,3.0421686746987953,48.91919769564237
Task_48663,2495,736,82,51,133,3.385345997286296,48.03176890772068
Task_48664,1883,885,198,151,349,2.125282167042889,40.324132828833214
Task_48665,1621,666,160,141,301,2.4302848575712144,35.25876624670472
Task_48666,2868,521,115,90,205,5.494252873563219,54.006289518917015
Task_48667,1521,760,15,53,68,1.9986859395532195,31.748676733778336
Task_48668,1170,721,125,119,244,1.6204986149584488,27.983975732285234
Task_48669,2703,579,141,192,333,4.660344827586207,52.33859881587127
Task_48670,1362,909,48,163,211,1.4967032967032967,31.560397261369122
Task_48671,1901,436,137,148,285,4.350114416475972,38.90091415498767
Task_48672,1719,364,149,122,271,4.7095890410958905,35.685586324545206
Task_48673,565,601,78,179,257,0.9385382059800664,18.18181661150352
Task_48674,1386,718,81,53,134,1.9276773296244785,30.471668732236164
Task_48675,785,383,26,125,151,2.0442708333333335,20.21181133255477
Task_48676,935,515,107,141,248,1.812015503875969,23.68337384445265
Task_48677,1056,187,134,15,149,5.617021276595745,23.33185145406614
Task_48678,882,432,160,93,253,2.0369515011547343,22.519593507691656
Task_48679,2574,942,13,23,36,2.7295864262990457,48.47300703897892
Task_48680,2035,346,103,148,251,5.8645533141210375,40.5726521938853
Task_48681,768,174,96,186,282,4.388571428571429,19.957069149097517
Task_48682,1571,455,126,143,269,3.4451754385964914,33.65943783662217
Task_48683,1646,854,148,164,312,1.9251461988304093,36.32476362293895
Task_48684,2140,738,101,156,257,2.8958051420838973,43.529324410430526
Task_48685,612,465,69,62,131,1.3133047210300428,17.472164990661945
Task_48686,2843,814,116,166,282,3.4883435582822084,55.032592675557474
Task_48687,2814,308,174,60,234,9.106796116504855,52.23250057329216
Task_48688,920,767,78,43,121,1.1979166666666667,22.729543682373972
Task_48689,1244,813,113,191,304,1.5282555282555284,29.788887367477987
Task_48690,1104,323,37,182,219,3.4074074074074074,25.701852176337482
Task_48691,1804,824,161,34,195,2.1866666666666665,37.50808890237404
Task_48692,1116,344,138,50,188,3.234782608695652,25.159643670914193
Task_48693,725,160,108,134,242,4.503105590062112,19.003681975516265
Task_48694,1499,374,97,42,139,3.997333333333333,30.848711127393685
Task_48695,1800,695,131,177,308,2.586206896551724,38.269256947484195
Task_48696,1036,306,17,76,93,3.3745928338762217,23.22087676857953
Task_48697,1140,178,198,121,319,6.368715083798882,25.873565648251656
Task_48698,2783,601,192,64,256,4.622923588039867,52.86428059110043
Task_48699,818,729,31,197,228,1.1205479452054794,22.392368153496236
Task_48700,2898,463,199,76,275,6.245689655172414,54.44703157055269
Task_48701,2011,716,49,173,222,2.804741980474198,41.38003403606448
Task_48702,2263,716,52,58,110,3.1562064156206415,43.94904968519398
Task_48703,987,858,76,183,259,1.1490104772991852,25.671628239730214
Task_48704,2082,312,85,190,275,6.651757188498403,41.3770030518393
Task_48705,2218,320,200,60,260,6.909657320872274,42.96697019929599
Task_48706,1585,758,46,96,142,2.0882740447957837,34.09407715900246
Task_48707,1957,287,146,185,331,6.795138888888889,39.554057300618105
Task_48708,1167,877,147,56,203,1.3291571753986333,27.843546995541505
Task_48709,827,369,184,137,321,2.235135135135135,21.83767159699417
Task_48710,2800,577,109,19,128,4.844290657439446,52.10642207689141
Task_48711,2030,94,104,193,297,21.36842105263158,39.31535147721797
Task_48712,1342,500,127,147,274,2.6786427145708585,30.20572513117767
Task_48713,960,607,52,192,244,1.5789473684210527,24.4562092861651
Task_48714,2936,594,152,54,206,4.934453781512605,55.0061027820625
Task_48715,1783,414,43,102,145,4.296385542168674,36.10430933088674
Task_48716,2518,693,97,80,177,3.628242074927954,48.79060916622799
Task_48717,2156,425,144,194,338,5.061032863849765,43.20720409187253
Task_48718,1580,200,167,156,323,7.8606965174129355,33.21088510752565
Task_48719,1183,669,15,132,147,1.7656716417910447,27.41889098367993
Task_48720,2288,430,145,97,242,5.3085846867749416,44.766087065825104
Task_48721,2834,600,125,30,155,4.715474209650583,52.81973941941083
Task_48722,2150,916,60,60,120,2.3446019629225736,42.85789370416661
Task_48723,2528,864,176,197,373,2.922543352601156,50.65408526798353
Task_48724,2524,516,166,77,243,4.882011605415861,48.561520263659276
Task_48725,835,389,97,55,152,2.141025641025641,20.705704682407077
Task_48726,1360,752,16,126,142,1.8061088977423638,30.433605643812133
Task_48727,2726,574,43,156,199,4.740869565217391,52.04673643667373
Task_48728,1253,604,65,122,187,2.0710743801652893,28.750813653843675
Task_48729,1139,132,146,41,187,8.563909774436091,24.373742182797724
Task_48730,2581,130,40,34,74,19.702290076335878,45.96279750057488
Task_48731,2186,637,30,164,194,3.426332288401254,43.67102796097234
Task_48732,1142,539,150,63,213,2.1148148148148147,26.481442753200984
Task_48733,1191,813,118,37,155,1.4631449631449631,27.469671358261525
Task_48734,2602,979,49,99,148,2.6551020408163266,50.93125811458473
Task_48735,1387,656,66,111,177,2.111111111111111,30.96991911894092
Task_48736,2179,693,181,53,234,3.139769452449568,43.49918183440365
Task_48737,526,101,43,43,86,5.1568627450980395,13.666264012894834
Task_48738,2455,352,69,155,224,6.954674220963173,47.19731997573795
Task_48739,2380,625,110,74,184,3.801916932907348,46.311692996236864
Task_48740,2423,289,21,199,220,8.355172413793104,46.42964479285693
Task_48741,2541,202,148,135,283,12.517241379310345,48.176778370790664
Task_48742,1852,750,149,31,180,2.466045272969374,37.9677456299814
Task_48743,1272,540,70,52,122,2.3512014787430684,27.89541700292096
Task_48744,1904,851,174,187,361,2.2347417840375585,40.657820063773165
Task_48745,2631,149,60,160,220,17.54,48.975636325364015
Task_48746,2893,266,51,64,115,10.835205992509364,52.76803208841469
Task_48747,1480,106,188,13,201,13.83177570093458,29.5118558980233
Task_48748,1027,814,61,138,199,1.2601226993865031,25.84395862990566
Task_48749,571,615,53,198,251,0.926948051948052,18.305499268100984
Task_48750,2547,991,126,135,261,2.567540322580645,50.75597017734623
Task_48751,1285,220,89,92,181,5.8144796380090495,27.792090856917046
Task_48752,1058,756,73,39,112,1.3976221928665786,24.78189536348145
Task_48753,1315,999,146,100,246,1.315,31.091582018125752
Task_48754,2132,952,12,89,101,2.237145855194124,42.81707605001941
Task_48755,2970,182,150,134,284,16.229508196721312,54.786177809113184
Task_48756,581,932,120,35,155,0.6227224008574491,18.49490961536533
Task_48757,2104,223,184,112,296,9.392857142857142,41.38339923334909
Task_48758,752,628,177,113,290,1.1955484896661368,21.226289502898084
Task_48759,2078,212,90,25,115,9.755868544600938,39.15321618791271
Task_48760,2984,710,71,179,250,4.19690576652602,56.8730162169874
Task_48761,2572,690,77,35,112,3.7221418234442836,48.54419152829925
Task_48762,926,127,93,150,243,7.234375,22.013604585620286
Task_48763,1575,307,135,185,320,5.113636363636363,33.53288373351564
Task_48764,1330,201,44,35,79,6.584158415841584,26.835180600065243
Task_48765,736,101,175,134,309,7.215686274509804,19.060439219009776
Task_48766,872,331,41,199,240,2.6265060240963853,22.1670299626934
Task_48767,1968,171,57,97,154,11.44186046511628,37.85723268433434
Task_48768,747,153,105,25,130,4.85064935064935,17.9201953702807
Task_48769,1538,606,78,105,183,2.5337726523887976,33.20054824814227
Task_48770,1663,961,65,65,130,1.7286902286902286,35.723944557176935
Task_48771,2132,486,97,90,187,4.37782340862423,42.152507953218674
Task_48772,2111,647,182,131,313,3.257716049382716,42.99948971543656
Task_48773,858,292,196,41,237,2.9283276450511946,21.050717584265783
Task_48774,1269,970,145,94,239,1.3069001029866116,30.21156856106128
Task_48775,1905,278,86,72,158,6.827956989247312,37.36911563299524
Task_48776,2211,912,92,51,143,2.4216867469879517,44.145569780060846
Task_48777,1639,211,29,159,188,7.731132075471698,33.567538223176314
Task_48778,1135,908,138,166,304,1.2486248624862486,28.29804494062984
Task_48779,1231,298,122,59,181,4.117056856187291,26.90138474844178
Task_48780,1651,850,14,134,148,1.9400705052878966,35.40417609057778
Task_48781,2551,911,102,105,207,2.7971491228070176,50.282412947214254
Task_48782,2345,924,184,111,295,2.535135135135135,47.46420504097919
Task_48783,1894,623,124,166,290,3.03525641025641,39.43460416666507
Task_48784,674,531,22,198,220,1.2669172932330828,19.46570460129386
Task_48785,860,82,45,57,102,10.36144578313253,18.998215100455976
Task_48786,2032,97,134,36,170,20.73469387755102,37.836149229846065
Task_48787,1595,604,27,67,94,2.6363636363636362,32.99141221798073
Task_48788,1675,538,86,99,185,3.1076066790352503,35.048841195890155
Task_48789,2369,527,53,172,225,4.486742424242424,46.439208174570815
Task_48790,2053,689,24,91,115,2.97536231884058,40.990363678567
Task_48791,1461,574,138,161,299,2.5408695652173914,32.456345532396604
Task_48792,1070,874,188,150,338,1.2228571428571429,27.292591596920506
Task_48793,2661,123,41,24,65,21.45967741935484,47.09812678445351
Task_48794,616,673,64,161,225,0.913946587537092,19.02836951434603
Task_48795,1718,896,200,67,267,1.915273132664437,36.97650650521284
Task_48796,1824,999,16,121,137,1.824,38.50912148502414
Task_48797,2486,445,63,131,194,5.573991031390134,47.821105479809994
Task_48798,1361,531,79,42,121,2.558270676691729,28.942418721679076
Task_48799,1600,96,131,82,213,16.49484536082474,31.86174078798291
Task_48800,1745,233,170,15,185,7.457264957264957,34.507824427137315
Task_48801,1499,406,193,98,291,3.6830466830466833,32.403588799815815
Task_48802,587,546,94,146,240,1.0731261425959782,18.171942908816842
Task_48803,760,457,39,198,237,1.6593886462882097,20.76184546218555
Task_48804,1407,905,47,31,78,1.5529801324503312,30.257233226143452
Task_48805,737,448,31,80,111,1.641425389755011,19.35755969501401
Task_48806,2141,789,149,151,300,2.710126582278481,43.89143208926102
Task_48807,731,734,47,68,115,0.9945578231292517,20.05710506468657
Task_48808,1785,970,45,122,167,1.8383110195674561,38.15049079737282
Task_48809,2999,929,28,163,191,3.224731182795699,57.44049087835037
Task_48810,632,794,167,76,243,0.7949685534591195,19.484245211766073
Task_48811,1201,615,45,65,110,1.9496753246753247,27.016250541887533
Task_48812,2950,972,23,163,186,3.0318602261048304,56.74367370180701
Task_48813,1537,753,175,106,281,2.0384615384615383,34.05857738540133
Task_48814,2516,667,185,90,275,3.7664670658682633,49.21430484311687
Task_48815,2166,483,64,97,161,4.475206611570248,42.568008093489915
Task_48816,1430,729,124,140,264,1.9589041095890412,32.26192335918267
Task_48817,1234,965,180,58,238,1.2774327122153208,29.331569223738338
Task_48818,687,94,185,127,312,7.231578947368421,18.20508333649136
Task_48819,1728,332,74,71,145,5.1891891891891895,34.86033011781344
Task_48820,2578,885,119,133,252,2.909706546275395,50.87283752212962
Task_48821,2659,231,99,53,152,11.461206896551724,49.05039757521967
Task_48822,2144,216,83,126,209,9.880184331797235,41.65277494706863
Task_48823,569,129,22,10,32,4.376923076923077,13.94033352001582
Task_48824,540,138,45,104,149,3.884892086330935,15.057577172077563
Task_48825,659,1011,172,44,216,0.6511857707509882,20.353289333781024
Task_48826,1865,781,141,193,334,2.3849104859335037,39.7086318548584
Task_48827,2905,472,168,89,257,6.141649048625792,54.65438901426838
Task_48828,2197,253,142,65,207,8.649606299212598,42.23084667154843
Task_48829,2921,430,188,121,309,6.7772621809744775,55.09286527069321
Task_48830,2432,260,142,137,279,9.31800766283525,46.66138538706405
Task_48831,2429,366,47,87,134,6.618528610354224,46.143273098489345
Task_48832,2629,270,184,92,276,9.70110701107011,49.679791216113536
Task_48833,2642,476,182,86,268,5.538784067085954,50.52569905487801
Task_48834,2587,506,199,35,234,5.102564102564102,49.08271905640751
Task_48835,567,764,38,132,170,0.7411764705882353,18.146656164411326
Task_48836,1010,322,106,67,173,3.126934984520124,23.50262856007438
Task_48837,725,233,113,168,281,3.0982905982905984,19.652980059759443
Task_48838,1707,826,18,82,100,2.064087061668682,35.6954975119904
Task_48839,532,679,108,93,201,0.7823529411764706,17.516072124814034
Task_48840,1971,100,17,181,198,19.514851485148515,37.95599033264256
Task_48841,1658,804,66,168,234,2.0596273291925464,36.090957114372586
Task_48842,915,734,87,95,182,1.2448979591836735,23.552546001613905
Task_48843,1999,857,95,117,212,2.3298368298368297,41.41787216897816
Task_48844,1332,794,190,198,388,1.6754716981132076,31.5422095424026
Task_48845,994,551,48,169,217,1.8007246376811594,24.691345371385854
Task_48846,2819,874,112,115,227,3.2217142857142855,54.51796061495535
Task_48847,2437,483,146,34,180,5.035123966942149,46.38322760524423
Task_48848,1266,493,174,30,204,2.562753036437247,27.98802618665431
Task_48849,1085,928,83,166,249,1.1679224973089344,27.334202870428673
Task_48850,559,959,30,76,106,0.5822916666666667,18.194582249783746
Task_48851,2342,845,48,21,69,2.768321513002364,44.67162106556905
Task_48852,1242,400,74,147,221,3.0972568578553616,28.12700267067761
Task_48853,2979,720,185,60,245,4.1317614424410545,56.24484404099818
Task_48854,690,536,70,191,261,1.2849162011173185,20.00529469534627
Task_48855,2964,627,28,146,174,4.719745222929936,55.80927048452954
Task_48856,2380,1022,173,148,321,2.326490713587488,48.495501540159296
Task_48857,1146,649,38,161,199,1.763076923076923,27.24821948364776
Task_48858,579,153,58,126,184,3.75974025974026,16.371714534037434
Task_48859,1262,970,188,156,344,1.2996910401647785,30.67140691833164
Task_48860,1520,964,138,29,167,1.5751295336787565,33.29911716744786
Task_48861,1442,332,135,116,251,4.33033033033033,31.100219063815192
Task_48862,2305,764,143,112,255,3.0130718954248366,46.151283128400486
Task_48863,667,172,73,192,265,3.8554913294797686,18.362048654897716
Task_48864,2641,273,119,185,304,9.638686131386862,50.19467628699281
Task_48865,1467,900,35,138,173,1.6281908990011098,32.93923738758388
Task_48866,1292,525,112,10,122,2.456273764258555,27.760609473210234
Task_48867,2386,855,43,85,128,2.7873831775700935,47.13668378318621
Task_48868,1942,257,122,32,154,7.5271317829457365,37.55144142435258
Task_48869,1226,198,43,40,83,6.160804020100502,25.45194014200349
Task_48870,1633,938,61,112,173,1.739084132055378,35.69875419288001
Task_48871,837,1004,27,121,148,0.8328358208955224,22.929159282284843
Task_48872,1716,899,72,24,96,1.9066666666666667,35.50402924203467
Task_48873,773,345,23,125,148,2.2341040462427744,19.90904404666301
Task_48874,1346,743,189,128,317,1.8091397849462365,31.19614827893832
Task_48875,2968,102,65,185,250,28.815533980582526,54.01806414932144
Task_48876,1851,215,41,145,186,8.569444444444445,36.89047618197505
Task_48877,2704,896,168,155,323,3.0144927536231885,53.25597828879078
Task_48878,2007,401,145,111,256,4.992537313432836,40.27967000481414
Task_48879,2488,408,133,10,143,6.083129584352078,46.57376484538593
Task_48880,1540,802,12,22,34,1.917808219178082,31.624799122726795
Task_48881,1213,604,82,37,119,2.0049586776859503,26.77804571850166
Task_48882,1012,219,192,58,250,4.6,23.525215453355873
Task_48883,1329,764,59,54,113,1.7372549019607844,29.332510657607372
Task_48884,2576,358,186,186,372,7.1754874651810585,49.771736341148106
Task_48885,586,343,24,117,141,1.7034883720930232,16.885790438134
Task_48886,930,472,77,96,173,1.9661733615221988,23.14239771991596
Task_48887,1847,765,148,33,181,2.411227154046997,37.92165422947077
Task_48888,1813,109,168,154,322,16.48181818181818,36.12172178248272
Task_48889,2305,78,69,178,247,29.17721518987342,43.37375268199682
Task_48890,1652,120,184,100,284,13.652892561983471,33.48906896938654
Task_48891,2042,138,196,188,384,14.690647482014388,40.316776076201556
Task_48892,1643,590,138,115,253,2.7800338409475467,35.11405509147218
Task_48893,1150,696,170,94,264,1.6499282639885222,27.636228413692105
Task_48894,2343,659,43,175,218,3.55,46.3649425414384
Task_48895,2366,269,105,69,174,8.762962962962963,44.766437515454356
Task_48896,1079,960,112,31,143,1.1227887617065557,26.10230218261871
Task_48897,2020,187,170,141,311,10.74468085106383,40.05718710308694
Task_48898,1379,118,135,123,258,11.588235294117647,29.0805157478465
Task_48899,1368,855,147,92,239,1.5981308411214954,31.42335401935195
Task_48900,1320,475,116,140,256,2.773109243697479,29.6869824811611
Task_48901,2798,724,64,103,167,3.8593103448275863,53.44542811713052
Task_48902,1296,150,194,171,365,8.582781456953642,28.572933217850757
Task_48903,1226,933,28,75,103,1.3126338329764453,28.369690855170134
Task_48904,851,768,18,101,119,1.106631989596879,22.124212222950813
Task_48905,2493,370,51,138,189,6.7196765498652296,47.69914167346952
Task_48906,1907,353,181,142,323,5.387005649717514,38.88697756087965
Task_48907,2959,351,61,126,187,8.40625,54.938108377768735
Task_48908,1473,736,168,52,220,1.9986431478968791,32.37784926963308
Task_48909,2530,699,61,49,110,3.6142857142857143,47.90989323134766
Task_48910,1113,462,126,44,170,2.4038876889848813,25.279366439137274
Task_48911,2337,488,75,40,115,4.779141104294479,44.22823377504661
Task_48912,2817,665,66,83,149,4.22972972972973,53.38505817928689
Task_48913,2855,957,111,27,138,2.980167014613779,54.13536705317887
Task_48914,1606,262,11,66,77,6.106463878326996,31.613173676840507
Task_48915,1292,892,126,134,260,1.446808510638298,30.501558175691894
Task_48916,1729,905,82,151,233,1.9083885209713025,37.46540901229546
Task_48917,777,191,108,68,176,4.046875,19.463555297745263
Task_48918,2950,544,51,49,100,5.412844036697248,53.99785895078387
Task_48919,855,298,158,31,189,2.859531772575251,20.798637231638104
Task_48920,1597,367,50,110,160,4.3396739130434785,33.15134112683475
Task_48921,1698,96,60,101,161,17.50515463917526,33.12672475477762
Task_48922,2235,850,167,57,224,2.6263219741480612,44.77867946187106
Task_48923,2891,1001,199,53,252,2.885229540918164,55.82584402824327
Task_48924,2972,161,12,189,201,18.34567901234568,54.23247369602134
Task_48925,2128,154,25,107,132,13.729032258064516,40.11828818924469
Task_48926,2821,238,66,37,103,11.803347280334728,50.89270499357724
Task_48927,1703,742,194,162,356,2.292059219380888,37.074095353704394
Task_48928,592,110,76,163,239,5.333333333333333,16.66724209385898
Task_48929,1681,994,108,75,183,1.6894472361809045,36.381812936783554
Task_48930,1858,792,79,112,191,2.343001261034048,38.928849201995796
Task_48931,2762,722,25,179,204,3.8201936376210237,53.11269811130424
Task_48932,644,412,52,45,97,1.5593220338983051,16.91976148537783
Task_48933,1920,321,18,58,76,5.962732919254658,36.661952933344566
Task_48934,1064,218,94,101,195,4.858447488584475,24.48109173483317
Task_48935,2088,545,11,169,180,3.8241758241758244,41.7064428730475
Task_48936,872,281,196,34,230,3.0921985815602837,21.197514898544565
Task_48937,1245,522,101,191,292,2.3804971319311665,28.885016658691427
Task_48938,1486,996,194,30,224,1.4904714142427282,33.13331308696771
Task_48939,1113,826,21,133,154,1.3458282950423217,26.734010771646382
Task_48940,2365,910,107,54,161,2.5960482985729967,46.65831365301968
Task_48941,1215,251,191,93,284,4.821428571428571,27.34112193515691
Task_48942,1735,658,21,170,191,2.6327769347496206,36.56777299132321
Task_48943,514,79,191,167,358,6.425,15.746030145264841
Task_48944,641,206,144,76,220,3.0966183574879227,17.65606016643199
Task_48945,970,404,131,196,327,2.3950617283950617,24.324700644409592
Task_48946,2871,635,13,112,125,4.514150943396227,53.93839148361135
Task_48947,2822,962,123,114,237,2.930425752855659,54.88437805120028
Task_48948,2367,251,76,129,205,9.392857142857142,45.323140957764565
Task_48949,2660,1015,88,21,109,2.6181102362204722,50.868030617657126
Task_48950,1962,762,140,64,204,2.5714285714285716,40.1340217301723
Task_48951,2336,967,102,54,156,2.4132231404958677,46.33135476522275
Task_48952,2786,238,172,153,325,11.656903765690377,52.40310179980446
Task_48953,2056,357,97,173,270,5.743016759776537,41.07148914749212
Task_48954,2512,911,10,159,169,2.754385964912281,49.48809195669856
Task_48955,2144,503,165,44,209,4.253968253968254,41.94907145669326
Task_48956,2756,260,188,89,277,10.559386973180077,51.659430047248804
Task_48957,2218,669,40,115,155,3.31044776119403,43.85469993631049
Task_48958,1222,77,27,106,133,15.666666666666666,25.272668036598727
Task_48959,1762,218,10,133,143,8.045662100456621,35.072386106114756
Task_48960,2948,880,137,40,177,3.3461975028376845,55.72345392278792
Task_48961,1934,584,103,173,276,3.305982905982906,39.89207304173974
Task_48962,1848,278,103,72,175,6.623655913978495,36.68353091479703
Task_48963,2689,741,164,123,287,3.623989218328841,52.322585117161545
Task_48964,1570,863,76,19,95,1.8171296296296295,33.00422387520754
Task_48965,1777,75,41,73,114,23.38157894736842,33.69661874869683
Task_48966,570,436,99,155,254,1.3043478260869565,17.64660118257859
Task_48967,2915,950,60,162,222,3.0651945320715037,56.39272250985334
Task_48968,713,72,95,174,269,9.767123287671232,18.48574001832609
Task_48969,2007,993,129,45,174,2.0191146881287727,41.14362661784371
Task_48970,1149,436,19,54,73,2.6292906178489703,24.84028289687855
Task_48971,2651,650,189,76,265,4.072196620583718,51.09318288697642
Task_48972,2674,168,28,137,165,15.822485207100591,49.256615709564606
Task_48973,2653,909,26,194,220,2.9153846153846152,52.06710934488188
Task_48974,1811,354,149,30,179,5.101408450704225,36.042248793829586
Task_48975,2352,554,134,14,148,4.237837837837838,44.92602685382254
Task_48976,1333,324,141,108,249,4.101538461538461,29.329434321261044
Task_48977,2520,646,20,124,144,3.894899536321484,48.49357568763211
Task_48978,2085,1019,184,54,238,2.0441176470588234,43.00367596119361
Task_48979,2772,76,116,60,176,36.0,49.618824142033446
Task_48980,2459,899,159,115,274,2.732222222222222,49.103787392313144
Task_48981,2449,194,196,179,375,12.558974358974359,47.160798051989836
Task_48982,1600,193,40,155,195,8.24742268041237,32.903459331439315
Task_48983,621,422,101,13,114,1.4680851063829787,16.707121506454435
Task_48984,521,355,108,183,291,1.4634831460674158,16.831138540733985
Task_48985,2055,457,97,62,159,4.486899563318778,40.27905841806287
Task_48986,1500,453,109,40,149,3.303964757709251,31.219735864477077
Task_48987,2095,509,88,114,202,4.107843137254902,41.74147808620171
Task_48988,861,472,15,98,113,1.8202959830866807,21.463088634394307
Task_48989,2810,288,183,118,301,9.72318339100346,52.808549535449025
Task_48990,512,902,103,65,168,0.5669988925802879,17.585789336991684
Task_48991,2809,898,93,163,256,3.124582869855395,54.67420725993407
Task_48992,2323,468,174,93,267,4.953091684434968,45.505749589429364
Task_48993,1658,284,84,153,237,5.817543859649123,34.356558707830246
Task_48994,1362,832,57,193,250,1.6350540216086435,31.57273917575887
Task_48995,1439,145,160,121,281,9.856164383561644,30.33754916137038
Task_48996,1695,934,37,59,96,1.8128342245989304,35.50207586032737
Task_48997,552,399,90,22,112,1.38,15.62935183725475
Task_48998,2008,342,108,163,271,5.854227405247814,40.244347996100686
Task_48999,582,931,157,179,336,0.6244635193133047,19.94246723777893
Task_49000,2543,125,65,66,131,20.182539682539684,46.370628344351246
Task_49001,1098,75,157,89,246,14.447368421052632,24.17110966389974
Task_49002,2426,128,135,195,330,18.8062015503876,46.07726881798961
Task_49003,2141,407,61,151,212,5.247549019607843,42.347167421198726
Task_49004,2310,248,185,125,310,9.27710843373494,44.811994190249834
Task_49005,2175,94,110,143,253,22.894736842105264,41.319816430783895
Task_49006,1395,796,116,102,218,1.7503136762860727,31.639609117985845
Task_49007,749,140,119,172,291,5.3120567375886525,19.539943949197326
Task_49008,2747,973,109,100,209,2.820328542094456,53.58351288205779
Task_49009,2248,865,159,13,172,2.595842956120092,44.454480416072045
Task_49010,1565,202,162,11,173,7.70935960591133,31.50225977117265
Task_49011,2552,885,47,166,213,2.880361173814898,50.37361436182988
Task_49012,2554,818,50,173,223,3.1184371184371185,50.308896612670075
Task_49013,1733,607,66,38,104,2.8503289473684212,34.91837978551027
Task_49014,2186,84,123,82,205,25.71764705882353,40.98036635348845
Task_49015,2824,454,64,73,137,6.206593406593407,52.543955794577414
Task_49016,2314,532,11,86,97,4.341463414634147,44.28445441590423
Task_49017,2099,1008,132,15,147,2.0802775024777005,42.348453115360066
Task_49018,2813,771,118,157,275,3.643782383419689,54.3772759999766
Task_49019,2289,565,104,30,134,4.044169611307421,43.9584372408082
Task_49020,558,331,91,183,274,1.680722891566265,17.303966422881455
Task_49021,2117,251,149,178,327,8.40079365079365,41.92781538136129
Task_49022,2413,164,179,127,306,14.624242424242425,45.90180171554179
Task_49023,581,720,83,191,274,0.8058252427184466,18.876149790424595
Task_49024,1082,139,11,86,97,7.728571428571429,23.08063119666671
Task_49025,2905,640,42,177,219,4.53198127925117,55.213365341498616
Task_49026,2083,1010,172,138,310,2.060336300692384,43.68730673041267
Task_49027,1734,66,173,102,275,25.880597014925375,34.37477652028746
Task_49028,2843,795,64,169,233,3.571608040201005,54.826666902418935
Task_49029,2194,514,174,103,277,4.260194174757282,43.68798403542291
Task_49030,902,504,180,35,215,1.7861386138613862,22.31437825156267
Task_49031,2629,538,75,112,187,4.877551020408164,50.31121554452469
Task_49032,2537,349,57,15,72,7.248571428571428,46.048311500149076
Task_49033,1952,315,38,157,195,6.177215189873418,38.926454874331064
Task_49034,585,763,123,23,146,0.7657068062827225,17.744353151264654
Task_49035,1790,286,20,175,195,6.2369337979094075,36.26818678599637
Task_49036,1226,746,200,149,349,1.641231593038822,29.466069341888772
Task_49037,2321,536,111,121,232,4.322160148975791,45.59280819886285
Task_49038,959,347,190,87,277,2.7557471264367814,23.522713530912558
Task_49039,1976,331,17,98,115,5.951807228915663,38.602153006098334
Task_49040,2572,613,72,120,192,4.188925081433225,49.691464758668644
Task_49041,957,132,198,165,363,7.195488721804511,23.071062193121005
Task_49042,1937,811,119,142,261,2.3854679802955663,40.53922899436433
Task_49043,1399,95,55,105,160,14.572916666666666,28.381361320216296
Task_49044,1564,373,129,22,151,4.181818181818182,31.905966697762313
Task_49045,761,287,74,69,143,2.642361111111111,19.345580795496037
Task_49046,1513,68,69,103,172,21.92753623188406,30.405724432241716
Task_49047,2107,549,70,87,157,3.830909090909091,41.76954326811282
Task_49048,1322,714,59,68,127,1.848951048951049,29.51825393608897
Task_49049,2602,340,151,31,182,7.6304985337243405,48.51743603057967
Task_49050,2956,925,61,61,122,3.1922246220302375,55.70515782952493
Task_49051,2791,895,65,158,223,3.114955357142857,54.25482591162728
Task_49052,1804,747,178,86,264,2.411764705882353,38.097343599892106
Task_49053,961,949,18,21,39,1.0115789473684211,23.10982062106774
Task_49054,700,512,112,49,161,1.364522417153996,18.88483011216187
Task_49055,2068,470,77,22,99,4.3906581740976645,39.65819319367662
Task_49056,559,828,108,43,151,0.6743063932448733,17.80422297098396
Task_49057,1682,148,74,137,211,11.288590604026846,33.983050977843476
Task_49058,657,447,105,12,117,1.4665178571428572,17.35662812770352
Task_49059,2021,234,188,45,233,8.6,39.20461194061366
Task_49060,1838,919,104,106,210,1.9978260869565216,39.024431850056
Task_49061,2197,114,94,77,171,19.104347826086958,40.9835991124414
Task_49062,1891,477,78,176,254,3.9560669456066946,38.84285266344042
Task_49063,538,405,32,28,60,1.3251231527093597,14.838458329079153
Task_49064,1655,829,96,102,198,1.9939759036144578,35.79256143398568
Task_49065,905,252,101,144,245,3.5770750988142295,22.361738093353107
Task_49066,2933,230,113,89,202,12.696969696969697,54.003192441013994
Task_49067,2228,628,76,15,91,3.5421303656597773,42.660757850165176
Task_49068,2698,119,46,12,58,22.483333333333334,47.543321044064164
Task_49069,1135,140,151,29,180,8.049645390070921,24.36703174483722
Task_49070,2148,79,89,142,231,26.85,40.71133819630296
Task_49071,1431,460,19,32,51,3.10412147505423,29.08339751293394
Task_49072,1607,251,118,100,218,6.376984126984127,33.26405514583749
Task_49073,1302,415,51,45,96,3.1298076923076925,27.342828419366665
Task_49074,2927,223,140,133,273,13.066964285714286,54.30773497274614
Task_49075,2163,705,101,113,214,3.0637393767705383,43.533197316708105
Task_49076,2551,973,92,49,141,2.6190965092402463,49.595973690043344
Task_49077,1734,284,119,20,139,6.08421052631579,34.205430254732725
Task_49078,636,274,185,14,199,2.3127272727272725,17.198460400239323
Task_49079,965,941,176,22,198,1.0244161358811041,24.538920075469758
Task_49080,2134,1016,100,12,112,2.0983284169124876,42.57500155827014
Task_49081,2264,712,108,36,144,3.1753155680224405,44.09144054253085
Task_49082,2092,607,99,27,126,3.4407894736842106,40.900318953726554
Task_49083,2480,435,107,198,305,5.6880733944954125,48.22475456872104
Task_49084,2015,148,112,62,174,13.523489932885907,38.469352096042485
Task_49085,1046,279,178,124,302,3.7357142857142858,24.906512816976072
Task_49086,1974,380,117,32,149,5.181102362204724,38.504730681712566
Task_49087,1281,376,152,182,334,3.3978779840848805,29.16714868170547
Task_49088,1837,299,11,115,126,6.123333333333333,36.49703947438663
Task_49089,1228,71,147,102,249,17.055555555555557,26.347800949735927
Task_49090,1957,920,77,36,113,2.1248642779587406,39.56869870899785
Task_49091,2251,806,133,89,222,2.7893432465923174,45.202363937753056
Task_49092,1290,149,143,44,187,8.6,26.90159088870391
Task_49093,900,286,116,184,300,3.1358885017421603,22.700459864950883
Task_49094,2013,498,33,185,218,4.034068136272545,40.63178312740996
Task_49095,519,368,24,175,199,1.4065040650406504,16.403221651641346
Task_49096,1433,101,48,44,92,14.049019607843137,27.874583079072483
Task_49097,2975,458,115,13,128,6.481481481481482,54.4715615792309
Task_49098,2070,541,94,91,185,3.819188191881919,41.300890968098095
Task_49099,770,65,98,148,246,11.666666666666666,19.250519641963862
Task_49100,1608,524,161,22,183,3.0628571428571427,33.311338616704106
Task_49101,2937,67,99,109,208,43.19117647058823,52.876594221225155
Task_49102,1080,334,72,82,154,3.2238805970149254,24.755013450846857
Task_49103,1940,855,134,129,263,2.2663551401869158,40.71396921390642
Task_49104,2042,809,85,59,144,2.5209876543209875,41.144858479225796
Task_49105,1057,338,120,159,279,3.117994100294985,25.219823531161126
Task_49106,1633,1015,57,122,179,1.6072834645669292,35.98491854397404
Task_49107,2091,752,195,30,225,2.7768924302788847,41.962627463586166
Task_49108,995,569,80,32,112,1.7456140350877194,23.165437499540626
Task_49109,2064,885,150,194,344,2.329571106094808,43.232576478801285
Task_49110,2146,785,10,185,195,2.7302798982188294,43.495034697443295
Task_49111,2015,541,150,65,215,3.717712177121771,40.34325397629332
Task_49112,1546,206,107,123,230,7.468599033816425,32.22864500023951
Task_49113,1362,999,120,161,281,1.362,32.08355946487824
Task_49114,2336,979,115,108,223,2.3836734693877553,47.16406712931027
Task_49115,2317,214,158,121,279,10.776744186046512,44.649275093153
Task_49116,1859,869,32,44,76,2.136781609195402,37.19840303558133
Task_49117,755,542,80,120,200,1.3904235727440146,20.674371534007367
Task_49118,1434,964,71,129,200,1.4860103626943004,32.77251045742959
Task_49119,2549,283,177,53,230,8.975352112676056,47.99757293329031
Task_49120,1528,229,189,122,311,6.643478260869565,32.39044773393593
Task_49121,2805,230,88,127,215,12.142857142857142,52.097141281173485
Task_49122,2382,343,25,69,94,6.924418604651163,44.59937588909366
Task_49123,2157,775,189,70,259,2.779639175257732,43.519830784077726
Task_49124,2878,589,103,173,276,4.877966101694915,54.857157079615014
Task_49125,1747,531,141,44,185,3.2838345864661656,35.631041546952964
Task_49126,1478,774,54,186,240,1.9070967741935483,33.191830693869896
Task_49127,1785,339,122,26,148,5.25,35.328000803700014
Task_49128,2255,530,35,129,164,4.246704331450094,44.20429684762936
Task_49129,2639,454,85,177,262,5.8,50.58504076632869
Task_49130,1691,339,127,16,143,4.973529411764706,33.73126654021985
Task_49131,2226,341,60,90,150,6.508771929824562,42.93543802451461
Task_49132,2725,333,179,19,198,8.158682634730539,50.442912016821595
Task_49133,1606,305,78,22,100,5.248366013071895,31.86045121000212
Task_49134,1621,933,163,73,236,1.7355460385438972,35.45961889997795
Task_49135,2030,720,193,121,314,2.8155339805825244,41.93592184250163
Task_49136,735,69,138,143,281,10.5,18.828524579919662
Task_49137,1408,162,130,37,167,8.63803680981595,28.73798268611512
Task_49138,819,966,67,159,226,0.8469493278179938,23.1817723560483
Task_49139,1102,427,195,143,338,2.574766355140187,26.458377299467866
Task_49140,589,317,147,168,315,1.8522012578616351,17.92683882989408
Task_49141,2676,663,12,96,108,4.030120481927711,50.66747789126509
Task_49142,951,288,167,142,309,3.290657439446367,23.492171213196638
Task_49143,1267,795,151,187,338,1.5917085427135678,30.27404537252117
Task_49144,1855,933,97,104,201,1.9860813704496787,39.301538263723735
Task_49145,2523,773,192,131,323,3.25968992248062,49.96749610498616
Task_49146,1034,979,58,200,258,1.0551020408163265,26.78734700883747
Task_49147,1140,370,39,143,182,3.07277628032345,26.147006608171125
Task_49148,1027,489,12,189,201,2.095918367346939,24.880909052660826
Task_49149,913,232,174,149,323,3.9184549356223175,22.780637421452088
Task_49150,1180,449,200,101,301,2.6222222222222222,27.534256698213422
Task_49151,1293,91,140,102,242,14.054347826086957,27.40085414574898
Task_49152,2564,905,43,59,102,2.8300220750551874,49.197957672076065
Task_49153,1463,942,51,156,207,1.5514316012725344,33.27248266702905
Task_49154,623,878,162,183,345,0.7087599544937428,20.432426121323875
Task_49155,2039,755,51,181,232,2.697089947089947,42.00474128459181
Task_49156,626,280,63,107,170,2.227758007117438,17.670062311073366
Task_49157,2085,593,185,60,245,3.51010101010101,41.68273332666595
Task_49158,1964,346,38,34,72,5.659942363112392,37.20424367201178
Task_49159,2341,1007,42,49,91,2.322420634920635,45.80407353624674
Task_49160,1637,714,140,99,239,2.2895104895104894,35.31543273018652
Task_49161,2114,1020,17,17,34,2.0705190989226248,41.3155973537497
Task_49162,2361,919,162,128,290,2.5663043478260867,47.70452642642169
Task_49163,2152,929,104,74,178,2.313978494623656,43.63442370726937
Task_49164,1486,307,102,138,240,4.824675324675325,31.696183998702494
Task_49165,1362,701,100,14,114,1.9401709401709402,29.358009310709704
Task_49166,1164,833,108,98,206,1.39568345323741,28.001807662494485
Task_49167,1709,652,194,87,281,2.6171516079632466,36.37801034502208
Task_49168,2502,717,187,62,249,3.4846796657381613,48.70404393137003
Task_49169,2725,676,158,40,198,4.025110782865584,51.65348286233077
Task_49170,2181,994,64,33,97,2.191959798994975,43.06673400753585
Task_49171,2567,748,105,36,141,3.427236315086782,48.970845338378034
Task_49172,1511,611,24,71,95,2.468954248366013,31.732741116435687
Task_49173,1278,333,81,174,255,3.8263473053892216,28.6660876096953
Task_49174,2560,966,57,98,155,2.6473629782833505,50.236211944880644
Task_49175,1413,143,87,80,167,9.8125,29.061035448657105
Task_49176,1620,304,95,71,166,5.311475409836065,33.15657052411215
Task_49177,1505,516,37,54,91,2.9110251450676983,31.155098214556627
Task_49178,1535,503,101,69,170,3.0456349206349205,32.361669463710655
Task_49179,1435,914,177,188,365,1.5683060109289617,33.39919844791254
Task_49180,1521,572,143,62,205,2.654450261780105,32.51148711783538
Task_49181,576,565,69,87,156,1.017667844522968,17.49161117577783
Task_49182,973,764,108,74,182,1.2718954248366012,24.4218879545973
Task_49183,2309,352,151,145,296,6.541076487252124,45.125273150861936
Task_49184,2460,843,140,193,333,2.914691943127962,49.32481000519192
Task_49185,1843,198,168,191,359,9.261306532663317,37.60844796197126
Task_49186,957,743,195,71,266,1.2862903225806452,24.461152288514644
Task_49187,1042,652,41,193,234,1.5957120980091883,25.81788078508495
Task_49188,1689,335,113,77,190,5.026785714285714,34.51331506146805
Task_49189,1431,467,63,169,232,3.0576923076923075,31.420130928622132
Task_49190,2382,174,137,32,169,13.611428571428572,44.153329723121516
Task_49191,2257,485,156,178,334,4.6440329218107,44.95895293786529
Task_49192,2515,436,183,142,325,5.755148741418764,48.790021978085896
Task_49193,2151,415,40,140,180,5.170673076923077,42.28821824408107
Task_49194,2290,657,89,75,164,3.480243161094225,44.93287445931722
Task_49195,2658,1017,66,144,210,2.611001964636542,52.45676442170136
Task_49196,2279,381,115,120,235,5.965968586387435,44.43605384190042
Task_49197,2550,224,81,38,119,11.333333333333334,46.67798958751121
Task_49198,1415,462,66,52,118,3.0561555075593954,29.847627748960416
Task_49199,753,574,59,115,174,1.3095652173913044,20.603577324211624
Task_49200,888,78,186,19,205,11.240506329113924,19.946032898885164
Task_49201,2853,106,80,30,110,26.66355140186916,50.39498021480083
Task_49202,2139,711,87,68,155,3.0042134831460676,42.36401655796041
Task_49203,1605,905,108,56,164,1.771523178807947,34.71059477683313
Task_49204,1209,531,71,57,128,2.2725563909774436,27.1419568298021
Task_49205,647,522,129,40,169,1.2370936902485659,18.09079932965798
Task_49206,1359,587,176,154,330,2.311224489795918,31.011396830143536
Task_49207,2601,968,137,90,227,2.6842105263157894,51.289046401836664
Task_49208,1463,130,119,148,267,11.16793893129771,30.571330953820688
Task_49209,2986,683,182,18,200,4.3654970760233915,55.71915931393614
Task_49210,1486,556,48,151,199,2.66786355475763,32.39004041770416
Task_49211,2621,190,123,114,237,13.722513089005236,49.15106882473824
Task_49212,932,835,40,73,113,1.1148325358851674,23.61326243573753
Task_49213,2820,895,109,107,216,3.1473214285714284,54.53827385041075
Task_49214,1533,152,59,20,79,10.019607843137255,29.549864907498456
Task_49215,544,947,134,55,189,0.5738396624472574,18.31846460821139
Task_49216,1616,660,200,19,219,2.4447806354009076,34.04137553610179
Task_49217,1433,937,105,19,124,1.5277185501066097,31.33137503945891
Task_49218,1516,713,162,49,211,2.123249299719888,32.7810107229323
Task_49219,2946,465,193,174,367,6.3218884120171674,55.94334689627154
Task_49220,2129,388,129,23,152,5.473007712082262,40.87876068771458
Task_49221,2266,789,33,165,198,2.868354430379747,45.43890999230964
Task_49222,2166,714,153,26,179,3.0293706293706295,42.7853478078888
Task_49223,1959,1000,48,135,183,1.957042957042957,41.13645869834917
Task_49224,1511,913,170,57,227,1.6531728665207877,33.52145852095084
Task_49225,2799,901,146,101,247,3.1031042128603104,54.35522808921064
Task_49226,625,231,142,23,165,2.6939655172413794,16.793012673283485
Task_49227,668,857,24,33,57,0.7785547785547785,18.46407263214059
Task_49228,1720,394,24,134,158,4.3544303797468356,35.10812188852682
Task_49229,2412,179,155,162,317,13.4,46.00347380464164
Task_49230,1672,160,124,121,245,10.385093167701863,33.92758255805481
Task_49231,1985,917,116,51,167,2.162309368191721,40.75336787422893
Task_49232,1461,621,93,22,115,2.3488745980707395,30.76415356740773
Task_49233,2886,542,115,68,183,5.314917127071824,53.94792977901256
Task_49234,2617,437,115,76,191,5.974885844748859,49.533334922854294
Task_49235,840,568,122,91,213,1.476274165202109,22.004875677087142
Task_49236,2687,342,158,184,342,7.833819241982507,51.33478819029305
Task_49237,1910,929,70,152,222,2.053763440860215,40.390385011521246
Task_49238,1402,226,47,126,173,6.176211453744493,29.781857829343213
Task_49239,721,163,114,188,302,4.396341463414634,19.29134089062247
Task_49240,2339,178,100,142,242,13.067039106145252,44.47130720782968
Task_49241,1338,368,25,182,207,3.6260162601626016,29.456383051708098
Task_49242,1103,403,168,128,296,2.73019801980198,26.186697188223818
Task_49243,1828,548,132,109,241,3.3296903460837886,37.847965472758624
Task_49244,725,997,26,110,136,0.7264529058116233,21.154357815325657
Task_49245,507,703,84,192,276,0.7201704545454546,17.771132149561527
Task_49246,2805,630,46,25,71,4.445324881141046,51.39624221767719
Task_49247,1888,139,60,79,139,13.485714285714286,36.300442257498084
Task_49248,1581,184,44,94,138,8.545945945945945,32.002727731514895
Task_49249,1378,328,175,195,370,4.188449848024316,30.727080665546918
Task_49250,2584,691,138,126,264,3.7341040462427744,50.40222380643829
Task_49251,1925,523,18,55,73,3.6736641221374047,37.4050411689735
Task_49252,2704,290,56,16,72,9.292096219931272,48.49592656208723
Task_49253,805,761,14,165,179,1.0564304461942258,21.978383828991824
Task_49254,2054,894,189,21,210,2.2949720670391063,41.67534353514045
Task_49255,2999,678,164,138,302,4.41678939617084,57.123404413397964
Task_49256,2233,776,44,160,204,2.873873873873874,44.90542119585516
Task_49257,1693,745,187,181,368,2.2694369973190347,37.0069869796839
Task_49258,722,308,169,79,248,2.336569579288026,19.466637998660005
Task_49259,1217,442,59,200,259,2.7471783295711063,28.12343595742487
Task_49260,1935,770,125,90,215,2.509727626459144,40.064166586070165
Task_49261,883,109,13,112,125,8.027272727272727,20.014528082600165
Task_49262,2102,265,70,172,242,7.902255639097745,41.42132686657739
Task_49263,2049,662,82,13,95,3.090497737556561,39.962947264067594
Task_49264,2578,811,53,152,205,3.1748768472906406,50.529146121099814
Task_49265,2947,629,20,167,187,4.677777777777778,55.6395264820191
Task_49266,1817,760,52,73,125,2.3876478318002627,37.53399025559909
Task_49267,1209,323,172,125,297,3.7314814814814814,27.6064609818841
Task_49268,2771,194,186,115,301,14.21025641025641,51.81527158503372
Task_49269,2822,439,52,116,168,6.413636363636364,52.936901017997634
Task_49270,2182,89,190,110,300,24.244444444444444,41.609406320605785
Task_49271,694,562,97,117,214,1.2326820603907638,19.75685913770563
Task_49272,1321,558,102,127,229,2.363148479427549,29.823813398552815
Task_49273,1409,1006,65,142,207,1.3992055610724925,32.55573687296902
Task_49274,1453,332,143,169,312,4.363363363363363,31.62681315698582
Task_49275,2188,612,59,48,107,3.569331158238173,42.11101988361677
Task_49276,2013,339,66,151,217,5.920588235294118,40.1298352006098
Task_49277,2083,518,152,13,165,4.0134874759152215,40.74669188988434
Task_49278,2251,550,177,196,373,4.08529945553539,45.27463826296728
Task_49279,1443,564,87,77,164,2.5539823008849556,31.210187655173215
Task_49280,848,839,57,16,73,1.0095238095238095,20.98422270219776
Task_49281,2232,405,86,136,222,5.497536945812808,43.6968210401186
Task_49282,2358,168,117,87,204,13.95266272189349,44.44032602773567
Task_49283,861,312,45,70,115,2.7507987220447285,20.796611307788012
Task_49284,2140,779,122,187,309,2.7435897435897436,43.937624066382604
Task_49285,2787,89,170,173,343,30.966666666666665,51.386700603735086
Task_49286,2370,926,185,126,311,2.55663430420712,47.96068826496391
Task_49287,1349,126,148,50,198,10.622047244094489,27.753410623077116
Task_49288,1042,546,97,192,289,1.9049360146252285,25.741810180606905
Task_49289,2345,695,15,42,57,3.3692528735632186,44.403306086524736
Task_49290,935,460,33,110,143,2.0281995661605206,22.809125412125464
Task_49291,727,103,105,32,137,6.990384615384615,17.29901347083097
Task_49292,1347,739,25,98,123,1.8202702702702702,30.048542052093264
Task_49293,1357,421,125,50,175,3.2156398104265405,29.163690520175454
Task_49294,2031,729,142,180,322,2.782191780821918,42.10253301929904
Task_49295,2202,922,198,52,250,2.3856988082340194,44.642958875067414
Task_49296,1180,113,167,198,365,10.350877192982455,26.47304657529231
Task_49297,2978,172,137,40,177,17.213872832369944,53.55892322467971
Task_49298,2513,702,29,58,87,3.5746799431009957,47.62312551054841
Task_49299,2723,136,66,168,234,19.875912408759124,50.4009205262231
Task_49300,2910,907,131,68,199,3.2048458149779737,55.591817325071595
Task_49301,1044,179,122,52,174,5.8,23.36430665126456
Task_49302,1921,830,164,130,294,2.3116726835138386,40.476162165367
Task_49303,2232,333,105,136,241,6.682634730538922,43.582095922123585
Task_49304,2381,538,51,102,153,4.417439703153989,46.040146209371024
Task_49305,1810,405,194,124,318,4.458128078817734,37.4739144478313
Task_49306,2744,253,115,75,190,10.803149606299213,50.892162434555736
Task_49307,1106,314,28,11,39,3.511111111111111,23.20992635579793
Task_49308,1345,466,142,186,328,2.880085653104925,30.446128723758694
Task_49309,2340,270,138,119,257,8.634686346863468,45.117981622956734
Task_49310,630,564,93,172,265,1.1150442477876106,19.08108304005724
Task_49311,1814,431,92,101,193,4.199074074074074,37.0319663404212
Task_49312,622,823,182,181,363,0.7548543689320388,20.237279322662705
Task_49313,2263,710,61,130,191,3.182841068917018,45.12135761935349
Task_49314,2746,296,163,80,243,9.245791245791246,51.40891573586595
Task_49315,2097,681,117,109,226,3.0747800586510263,42.4604913179463
Task_49316,2922,754,19,187,206,3.8701986754966886,55.76857959566516
Task_49317,1751,752,40,186,226,2.3253652058432936,37.324877855293835
Task_49318,1299,316,121,39,160,4.097791798107256,27.63390012848869
Task_49319,670,92,138,43,181,7.204301075268817,16.54359869502704
Task_49320,2839,101,166,38,204,27.833333333333332,50.91903158663276
Task_49321,2410,626,182,199,381,3.843700159489633,48.07481010309556
Task_49322,2894,700,178,187,365,4.128388017118402,55.88578783741656
Task_49323,2781,573,129,124,253,4.844947735191638,53.09428953048251
Task_49324,2956,514,198,16,214,5.739805825242718,54.75477611914076
Task_49325,1477,158,131,14,145,9.28930817610063,29.50161061460663
Task_49326,718,139,184,133,317,5.128571428571429,19.08771456740149
Task_49327,1591,636,124,115,239,2.497645211930926,34.372008020377656
Task_49328,1066,955,93,50,143,1.1150627615062763,26.067696129822462
Task_49329,1009,790,103,14,117,1.2756005056890012,24.01196603359664
Task_49330,2815,800,52,132,184,3.5143570536828963,54.087692479049814
Task_49331,2755,168,78,19,97,16.301775147928993,49.34638188789484
Task_49332,2441,920,51,66,117,2.6503800217155264,47.723511654784154
Task_49333,2440,275,153,167,320,8.840579710144928,47.070702649215804
Task_49334,840,762,179,140,319,1.1009174311926606,23.201982680293444
Task_49335,640,140,116,97,213,4.539007092198582,17.3726515054467
Task_49336,2169,339,58,60,118,6.379411764705883,41.31527374668933
Task_49337,686,495,142,177,319,1.3830645161290323,19.99768725020046
Task_49338,2597,960,48,138,186,2.7023933402705516,51.144514830199974
Task_49339,1040,954,52,10,62,1.0890052356020943,24.36570355646421
Task_49340,1482,114,88,176,264,12.88695652173913,30.709291147231784
Task_49341,713,798,162,115,277,0.8923654568210263,21.112449349114947
Task_49342,2772,994,74,82,156,2.785929648241206,53.67756231743891
Task_49343,1382,796,112,122,234,1.7340025094102887,31.53508092722521
Task_49344,615,916,199,137,336,0.6706652126499455,20.338657810818745
Task_49345,716,122,130,19,149,5.821138211382114,17.3097103106345
Task_49346,2646,504,37,77,114,5.23960396039604,49.78050708325708
Task_49347,729,918,92,78,170,0.7932535364526659,21.093831707228826
Task_49348,2063,402,15,116,131,5.119106699751861,40.4495110624706
Task_49349,2322,665,100,48,148,3.4864864864864864,44.92522859185211
Task_49350,678,89,51,59,110,7.533333333333333,16.28328500848851
Task_49351,601,571,186,112,298,1.0506993006993006,18.692275210084816
Task_49352,1844,856,87,33,120,2.15169194865811,37.57496389085215
Task_49353,1972,298,67,53,120,6.595317725752508,38.14096575107869
Task_49354,2276,559,78,147,225,4.064285714285714,45.027285693776015
Task_49355,1410,227,90,171,261,6.184210526315789,30.360539767978405
Task_49356,2607,951,123,140,263,2.7384453781512605,51.59837197964854
Task_49357,1418,639,184,171,355,2.215625,32.24632504761685
Task_49358,640,616,79,17,96,1.0372771474878444,17.59644282844967
Task_49359,532,525,184,154,338,1.0114068441064639,17.680244871839452
Task_49360,1175,274,117,32,149,4.2727272727272725,25.518681634399282
Task_49361,1458,158,180,38,218,9.169811320754716,29.790184351015608
Task_49362,1969,590,86,93,179,3.3316412859560067,39.83386035271898
Task_49363,1824,783,20,107,127,2.326530612244898,37.82248694390715
Task_49364,1882,911,178,118,296,2.06359649122807,40.101953354541735
Task_49365,1842,877,136,108,244,2.0979498861047836,39.11331039448314
Task_49366,1956,218,193,71,264,8.931506849315069,38.58112499986876
Task_49367,2587,485,20,99,119,5.323045267489712,48.79971633072259
Task_49368,796,751,110,13,123,1.0585106382978724,20.73214926279935
Task_49369,1511,404,171,117,288,3.730864197530864,32.59384725562413
Task_49370,1825,808,125,165,290,2.2558714462299134,38.919833235892675
Task_49371,2796,946,26,54,80,2.9524815205913413,52.747027164863084
Task_49372,2188,791,183,166,349,2.7626262626262625,44.885141414956514
Task_49373,2062,660,26,152,178,3.1195158850226927,41.65018577336833
Task_49374,871,270,174,188,362,3.2140221402214024,22.47530408177622
Task_49375,2595,75,166,95,261,34.14473684210526,47.787574690775045
Task_49376,2314,83,115,64,179,27.547619047619047,42.50674609475906
Task_49377,1114,871,192,143,335,1.2775229357798166,27.959977454870582
Task_49378,1214,197,134,13,147,6.1313131313131315,25.795124845527766
Task_49379,2895,146,111,70,181,19.693877551020407,52.36830500100481
Task_49380,1900,437,169,22,191,4.337899543378995,37.71067016291662
Task_49381,986,253,103,70,173,3.8818897637795278,22.899190965688074
Task_49382,1766,429,110,165,275,4.1069767441860465,36.7215895635764
Task_49383,2537,69,102,59,161,36.24285714285714,45.71615631636539
Task_49384,2381,782,147,65,212,3.0408684546615583,46.88734350119373
Task_49385,1830,329,77,117,194,5.545454545454546,37.038123184507285
Task_49386,2109,243,97,59,156,8.64344262295082,40.398923157520365
Task_49387,1881,803,168,124,292,2.33955223880597,39.74036609505371
Task_49388,2293,817,27,162,189,2.8031784841075793,45.889997209583136
Task_49389,2157,130,61,164,225,16.46564885496183,41.360292559652386
Task_49390,775,483,176,119,295,1.6012396694214877,21.216391142010554
Task_49391,1296,921,114,67,181,1.405639913232104,29.92034466150467
Task_49392,1366,289,136,90,226,4.710344827586207,29.573895651935516
Task_49393,884,459,78,153,231,1.9217391304347826,22.708334549400217
Task_49394,1125,448,51,79,130,2.505567928730512,25.833366438766102
Task_49395,1872,267,50,77,127,6.985074626865671,36.9662781721669
Task_49396,1203,798,31,108,139,1.5056320400500627,28.033963643912568
Task_49397,1334,568,48,188,236,2.3444639718804923,30.24189572476199
Task_49398,1847,897,45,150,195,2.056792873051225,39.12359292853243
Task_49399,1890,922,141,197,338,2.047670639219935,40.56803882885489
Task_49400,2619,284,53,17,70,9.189473684210526,47.14125913746438
Task_49401,1356,149,72,143,215,9.04,28.863893115305615
Task_49402,2731,237,110,80,190,11.474789915966387,50.71057150102593
Task_49403,1290,683,143,90,233,1.8859649122807018,29.65606381211987
Task_49404,998,197,107,112,219,5.040404040404041,23.51975632416999
Task_49405,2436,894,70,60,130,2.7217877094972067,47.63775808452743
Task_49406,2755,570,78,191,269,4.824868651488616,52.91021881939947
Task_49407,2740,196,20,72,92,13.908629441624365,49.78427724090816
Task_49408,2275,482,62,153,215,4.7101449275362315,44.7283506048856
Task_49409,2014,701,137,161,298,2.868945868945869,41.60936617735492
Task_49410,1161,177,153,60,213,6.522471910112359,25.3829723568119
Task_49411,1541,435,168,81,249,3.5344036697247705,32.83548323462637
Task_49412,863,432,45,10,55,1.9930715935334873,19.882057808200784
Task_49413,1874,332,139,183,322,5.627627627627628,38.35072825785141
Task_49414,1031,556,132,30,162,1.8509874326750448,24.211778854641512
Task_49415,2913,205,152,88,240,14.140776699029127,53.73956684414347
Task_49416,2156,369,196,99,295,5.827027027027027,42.6838861166425
Task_49417,1779,714,72,113,185,2.488111888111888,37.374524380586315
Task_49418,1032,675,129,168,297,1.5266272189349113,25.936330331325355
Task_49419,1468,793,30,45,75,1.848866498740554,30.76095415299427
Task_49420,918,720,132,29,161,1.273231622746186,22.893236750647556
Task_49421,1271,964,47,26,73,1.317098445595855,28.196670707549274
Task_49422,2371,659,173,138,311,3.5924242424242423,47.15669303842426
Task_49423,1382,331,50,57,107,4.162650602409639,28.714431528100004
Task_49424,704,903,115,184,299,0.7787610619469026,21.521905549832834
Task_49425,1298,169,123,154,277,7.635294117647059,28.23897619139701
Task_49426,1623,944,29,57,86,1.7174603174603174,34.255814056377154
Task_49427,2052,232,32,88,120,8.806866952789699,39.52113623067995
Task_49428,618,259,14,83,97,2.376923076923077,16.588295989058782
Task_49429,1044,115,105,165,270,9.0,23.87484203404181
Task_49430,1443,241,117,14,131,5.962809917355372,29.412990179976187
Task_49431,2795,921,71,88,159,3.031453362255965,53.81655221351739
Task_49432,2012,389,125,87,212,5.158974358974359,40.02458388036532
Task_49433,1677,652,77,35,112,2.568147013782542,34.24831298699636
Task_49434,2366,367,57,46,103,6.429347826086956,44.047811918311616
Task_49435,1349,1004,112,134,246,1.3422885572139303,31.695704346515807
Task_49436,1507,592,168,104,272,2.5413153456998314,33.03613682604791
Task_49437,2372,706,30,178,208,3.355021216407355,46.9184527897927
Task_49438,2672,122,151,52,203,21.723577235772357,48.78553113237843
Task_49439,2230,256,93,137,230,8.67704280155642,43.272515702942826
Task_49440,2891,771,109,66,175,3.744818652849741,54.72401139699671
Task_49441,2815,572,137,12,149,4.912739965095986,52.34607248505166
Task_49442,2032,550,37,167,204,3.6878402903811254,41.0266184911604
Task_49443,2211,83,88,106,194,26.321428571428573,41.492571111833264
Task_49444,1768,510,93,54,147,3.459882583170254,35.97264296801988
Task_49445,2549,460,55,51,106,5.5292841648590025,47.52041976833815
Task_49446,939,684,25,117,142,1.3708029197080291,23.506268081969086
Task_49447,1479,170,165,47,212,8.649122807017545,30.13296617796237
Task_49448,537,955,59,106,165,0.5617154811715481,18.437872437802387
Task_49449,1381,620,148,161,309,2.2238325281803544,31.378855961057997
Task_49450,1589,433,120,171,291,3.661290322580645,34.01410619414768
Task_49451,2739,690,68,108,176,3.963820549927641,52.47862571073207
Task_49452,2588,216,147,86,233,11.926267281105991,48.61118121131265
Task_49453,1203,733,127,164,291,1.6389645776566757,28.821859247746755
Task_49454,2247,267,102,140,242,8.384328358208956,43.600637143352024
Task_49455,1810,580,121,176,297,3.1153184165232357,38.0148355667092
Task_49456,740,222,172,115,287,3.318385650224215,19.802976355983322
Task_49457,924,639,62,188,250,1.44375,23.991550927454032
Task_49458,774,1009,84,193,277,0.7663366336633664,22.851414034961056
Task_49459,1995,73,55,74,129,26.95945945945946,37.2470739907542
Task_49460,1354,580,86,164,250,2.3304647160068845,30.52461499126221
Task_49461,2412,343,97,135,232,7.011627906976744,46.428633617851865
Task_49462,1809,713,89,72,161,2.533613445378151,37.27732647782458
Task_49463,755,573,169,132,301,1.3153310104529616,21.193087098069885
Task_49464,1660,261,184,17,201,6.33587786259542,33.35690321793618
Task_49465,1595,491,169,27,196,3.241869918699187,33.12748018348507
Task_49466,833,795,147,97,244,1.0464824120603016,22.824419799774393
Task_49467,977,163,184,146,330,5.9573170731707314,23.392263855353132
Task_49468,1651,664,127,192,319,2.482706766917293,35.8835612132202
Task_49469,2671,314,195,63,258,8.47936507936508,50.14626004067575
Task_49470,2074,927,149,35,184,2.2349137931034484,42.04068802269131
Task_49471,2883,216,120,115,235,13.285714285714286,53.3871461278182
Task_49472,684,742,23,74,97,0.9205921938088829,19.10808839127983
Task_49473,2016,454,197,164,361,4.430769230769231,41.14521234078344
Task_49474,975,121,171,188,359,7.991803278688525,23.30792545282795
Task_49475,1330,359,69,46,115,3.6944444444444446,27.903288309486886
Task_49476,2578,103,26,126,152,24.78846153846154,46.854484218456406
Task_49477,2278,823,128,196,324,2.7645631067961167,46.34247458532169
Task_49478,717,833,109,84,193,0.8597122302158273,20.7904621834836
Task_49479,2090,799,73,44,117,2.6125,41.27699225421325
Task_49480,1844,122,51,161,212,14.991869918699187,36.329097768585434
Task_49481,762,162,160,22,182,4.674846625766871,18.5767651477702
Task_49482,1002,384,28,182,210,2.602597402597403,24.209704933299147
Task_49483,1832,914,87,154,241,2.0021857923497266,39.08416093776341
Task_49484,2390,939,21,198,219,2.5425531914893615,47.99074920060962
Task_49485,2553,743,190,109,299,3.431451612903226,50.20799259164098
Task_49486,1059,83,72,185,257,12.607142857142858,23.932366005147305
Task_49487,2895,944,107,67,174,3.0634920634920637,55.33018880796002
Task_49488,1286,198,55,152,207,6.4623115577889445,28.146825415027973
Task_49489,2491,285,143,164,307,8.70979020979021,47.849528031783585
Task_49490,2641,802,15,172,187,3.2889165628891655,51.34524786298729
Task_49491,2613,76,77,105,182,33.935064935064936,47.781560172001946
Task_49492,1447,749,84,132,216,1.9293333333333333,32.37537618955357
Task_49493,1474,812,127,190,317,1.813038130381304,33.52961236975806
Task_49494,2413,222,91,149,240,10.820627802690582,46.06062840636764
Task_49495,718,497,155,103,258,1.4417670682730923,20.12715305959181
Task_49496,831,190,175,69,244,4.350785340314136,20.63735678769901
Task_49497,1180,186,19,134,153,6.310160427807487,25.801089495073626
Task_49498,2048,330,60,88,148,6.187311178247734,40.091898198936214
Task_49499,2144,935,72,183,255,2.2905982905982905,44.298672902057994
Task_49500,1988,640,131,188,319,3.1014040561622465,41.139900366726245
Task_49501,2675,418,111,131,242,6.384248210023866,50.87259143252626
Task_49502,2894,361,198,94,292,7.994475138121547,54.310365085123216
Task_49503,1201,380,32,84,116,3.152230971128609,26.542634411520794
Task_49504,2084,395,70,140,210,5.262626262626263,41.386028228232696
Task_49505,514,136,45,144,189,3.7518248175182483,15.260253278302393
Task_49506,1034,706,71,164,235,1.4625176803394626,25.832246675094538
Task_49507,1982,919,87,26,113,2.1543478260869566,39.93996022591329
Task_49508,2210,765,180,117,297,2.8851174934725847,44.84603607183558
Task_49509,2815,747,26,69,95,3.763368983957219,52.76915208408301
Task_49510,2156,922,65,22,87,2.335861321776815,42.372079408221104
Task_49511,981,574,84,135,219,1.7060869565217391,24.45313105466801
Task_49512,1112,544,173,119,292,2.0403669724770643,26.742737984782593
Task_49513,1379,628,128,30,158,2.192368839427663,29.878764237595075
Task_49514,1959,88,63,199,262,22.01123595505618,38.11813815665459
Task_49515,1740,863,140,19,159,2.013888888888889,36.26231276903591
Task_49516,2169,986,158,18,176,2.197568389057751,43.606237779773686
Task_49517,2349,311,88,28,116,7.528846153846154,43.81400865592679
Task_49518,1588,76,159,113,272,20.623376623376622,32.08484937625971
Task_49519,2524,997,156,139,295,2.529058116232465,50.56928876145673
Task_49520,1203,904,153,50,203,1.329281767955801,28.379088594637597
Task_49521,1504,847,129,160,289,1.7735849056603774,33.93015585613816
Task_49522,1319,1000,187,76,263,1.3176823176823176,31.04176896140957
Task_49523,1853,258,17,52,69,7.154440154440154,35.36321837133886
Task_49524,1508,800,91,37,128,1.8826466916354556,32.452821257304
Task_49525,2153,631,137,72,209,3.4066455696202533,42.83838124651311
Task_49526,1927,596,53,187,240,3.2278056951423784,39.7494836054585
Task_49527,2907,674,84,41,125,4.306666666666667,53.96143530150704
Task_49528,1161,530,10,171,181,2.1864406779661016,26.976749105237833
Task_49529,2228,820,169,43,212,2.7137637028014616,44.30017783283393
Task_49530,2034,494,13,113,126,4.109090909090909,40.26624177036535
Task_49531,1564,868,173,83,256,1.7997698504027617,34.626001219324586
Task_49532,1477,885,67,55,122,1.6670428893905191,32.19446030650814
Task_49533,1049,87,186,188,374,11.920454545454545,24.26921639891943
Task_49534,828,347,122,107,229,2.3793103448275863,21.324977768907278
Task_49535,1657,394,81,106,187,4.19493670886076,34.4401888123718
Task_49536,1703,510,54,58,112,3.3326810176125243,34.42608346420779
Task_49537,2379,203,187,14,201,11.661764705882353,44.490734401883394
Task_49538,1929,600,24,46,70,3.2096505823627286,37.49433714736934
Task_49539,2185,835,39,79,118,2.6136363636363638,43.561008698672005
Task_49540,1296,338,34,135,169,3.8230088495575223,28.43645479290542
Task_49541,1690,848,90,200,290,1.9905771495877502,36.95120307284768
Task_49542,2871,164,130,135,265,17.4,52.950185802107576
Task_49543,2552,606,98,48,146,4.204283360790774,48.410501398047835
Task_49544,2397,413,59,178,237,5.7898550724637685,46.57300886515524
Task_49545,1810,645,142,63,205,2.801857585139319,37.356896875295064
Task_49546,888,79,77,92,169,11.1,20.568714742200623
Task_49547,594,262,68,44,112,2.258555133079848,15.874321279830973
Task_49548,1319,235,172,124,296,5.588983050847458,29.045509283279085
Task_49549,2342,618,101,132,233,3.7835218093699514,46.207224532017385
Task_49550,2018,821,105,41,146,2.4549878345498786,40.58842689987721
Task_49551,1944,671,200,60,260,2.892857142857143,39.763290472254866
Task_49552,1682,303,149,189,338,5.532894736842105,35.29828839185275
Task_49553,2040,410,40,129,169,4.963503649635037,40.42725118527712
Task_49554,1720,490,158,60,218,3.5030549898167007,35.454471929287344
Task_49555,506,431,119,19,138,1.1712962962962963,15.256416753968134
Task_49556,511,90,164,170,334,5.615384615384615,15.640289769990295
Task_49557,2030,766,14,119,133,2.646675358539765,41.095308007099256
Task_49558,1491,261,66,130,196,5.690839694656488,31.487769271713663
Task_49559,1091,89,64,41,105,12.122222222222222,22.238060666388037
Task_49560,2433,884,170,171,341,2.7491525423728813,49.029021034638845
Task_49561,1540,476,197,34,231,3.2285115303983227,32.39591719427535
Task_49562,2203,391,29,157,186,5.619897959183674,43.07282108040231
Task_49563,1480,932,62,125,187,1.5862808145766345,33.330684898936305
Task_49564,758,442,10,144,154,1.7110609480812642,19.954288693113607
Task_49565,1569,873,56,57,113,1.7951945080091534,33.50380403834799
Task_49566,1118,344,88,36,124,3.2405797101449276,24.542109727988656
Task_49567,2475,269,182,96,278,9.166666666666666,47.33724569185037
Task_49568,626,609,59,126,185,1.0262295081967212,18.714212755991085
Task_49569,631,123,34,25,59,5.088709677419355,15.114922578814912
Task_49570,833,333,159,25,184,2.4940119760479043,20.4693650947106
Task_49571,689,847,77,197,274,0.8125,21.02603494466811
Task_49572,2980,949,45,191,236,3.136842105263158,57.48392315948511
Task_49573,2983,536,126,122,248,5.554934823091248,56.14813293428936
Task_49574,2098,577,58,178,236,3.629757785467128,42.363805136856826
Task_49575,2645,1012,130,122,252,2.611056268509378,52.31480054485701
Task_49576,2036,578,104,195,299,3.516407599309154,41.62422247275621
Task_49577,1030,409,169,130,299,2.5121951219512195,25.06705276740497
Task_49578,1246,201,144,128,272,6.1683168316831685,27.671534806696823
Task_49579,2445,188,33,143,176,12.936507936507937,46.112455032503355
Task_49580,2555,439,186,152,338,5.806818181818182,49.506196509815084
Task_49581,2279,294,188,148,336,7.725423728813559,44.63704817924086
Task_49582,1716,187,156,186,342,9.127659574468085,35.466048111787025
Task_49583,1550,272,47,101,148,5.677655677655678,31.97502531570232
Task_49584,2020,107,62,97,159,18.703703703703702,38.240364153236406
Task_49585,2516,988,171,134,305,2.5439838220424673,50.45221385780826
Task_49586,2848,251,148,177,325,11.301587301587302,53.46735018289877
Task_49587,2971,960,155,41,196,3.0915712799167534,56.43578505583101
Task_49588,1583,970,25,188,213,1.6302780638516994,35.248006794120926
Task_49589,626,1006,134,90,224,0.6216484607745779,20.215185165827013
Task_49590,502,886,184,125,309,0.5659526493799324,18.30299559385045
Task_49591,878,797,36,138,174,1.100250626566416,23.207428609668682
Task_49592,863,782,96,159,255,1.1021711366538953,23.36332593972611
Task_49593,1712,172,57,133,190,9.895953757225433,34.35211296886185
Task_49594,2626,691,134,110,244,3.7947976878612715,50.953908938778056
Task_49595,2938,363,136,103,239,8.071428571428571,54.79422143887448
Task_49596,2945,862,62,55,117,3.4125144843568944,55.23457766649195
Task_49597,1401,632,124,87,211,2.213270142180095,31.121632075424046
Task_49598,1834,426,59,26,85,4.295081967213115,35.67573153889354
Task_49599,1402,606,71,126,197,2.3097199341021417,31.17141111222458
Task_49600,2188,641,12,183,195,3.4080996884735204,43.708556068769006
Task_49601,529,607,171,102,273,0.8700657894736842,17.566952351973203
Task_49602,655,86,160,15,175,7.528735632183908,16.09609689774631
Task_49603,2738,174,200,29,229,15.645714285714286,50.11276527213101
Task_49604,1180,657,146,12,158,1.7933130699088147,26.72629657607887
Task_49605,605,742,56,172,228,0.8142664872139973,19.11409504363579
Task_49606,1467,82,45,44,89,17.674698795180724,28.109947151321823
Task_49607,1827,608,115,61,176,3.0,37.30951245667203
Task_49608,1937,741,91,166,257,2.6105121293800537,40.33690380627694
Task_49609,1700,416,24,194,218,4.07673860911271,35.408204465120555
Task_49610,1799,758,120,158,278,2.370223978919631,38.287482964807474
Task_49611,533,357,85,18,103,1.488826815642458,15.04432824461329
Task_49612,2696,570,57,115,172,4.7215411558669,51.39480597303022
Task_49613,681,70,132,64,196,9.591549295774648,17.08014839917966
Task_49614,2019,521,114,15,129,3.867816091954023,39.456302898062
Task_49615,1649,488,149,11,160,3.372188139059305,33.631451376942884
Task_49616,2908,371,31,172,203,7.817204301075269,54.283305475381006
Task_49617,1471,1019,148,120,268,1.442156862745098,33.74718165521056
Task_49618,1092,668,158,157,315,1.6322869955156951,26.959201795911994
Task_49619,538,692,193,31,224,0.7763347763347763,17.223257974597733
Task_49620,2767,174,167,15,182,15.811428571428571,50.228111583342816
Task_49621,2691,936,23,199,222,2.871931696905016,52.77176411255038
Task_49622,2395,228,168,162,330,10.458515283842795,46.224600014495444
Task_49623,2995,460,158,21,179,6.496746203904555,55.05074332410931
Task_49624,2374,149,107,179,286,15.826666666666666,45.21192392500856
Task_49625,1911,620,134,137,271,3.077294685990338,39.566237797743625
Task_49626,2828,90,192,99,291,31.076923076923077,51.71671294707619
Task_49627,1576,938,42,45,87,1.678381256656017,33.311443701229706
Task_49628,1884,691,183,114,297,2.722543352601156,39.44535219029165
Task_49629,1871,479,117,95,212,3.8979166666666667,38.171165048455215
Task_49630,2151,311,53,122,175,6.894230769230769,41.954484138608386
Task_49631,1504,101,175,48,223,14.745098039215685,30.035506990861517
Task_49632,2754,492,31,132,163,5.586206896551724,51.95026301488661
Task_49633,2846,527,143,107,250,5.390151515151516,53.936874324300994
Task_49634,824,377,30,152,182,2.17989417989418,21.18010808399845
Task_49635,866,367,19,166,185,2.3532608695652173,21.833258964305923
Task_49636,1391,176,129,43,172,7.858757062146893,28.527670723678398
Task_49637,1583,97,124,17,141,16.153061224489797,30.425107340312977
Task_49638,787,975,138,162,300,0.8063524590163934,23.017290415067077
Task_49639,1176,713,154,55,209,1.6470588235294117,27.51588773857861
Task_49640,2861,404,154,133,287,7.064197530864197,53.97505530764047
Task_49641,935,674,70,83,153,1.385185185185185,23.468317836617075
Task_49642,2393,637,10,98,108,3.750783699059561,46.08548420959816
Task_49643,585,153,200,58,258,3.7987012987012987,16.42061074342082
Task_49644,948,373,142,20,162,2.53475935828877,22.25203253970353
Task_49645,635,124,84,179,263,5.08,17.533233387002728
Task_49646,2014,573,168,11,179,3.508710801393728,39.86661902280732
Task_49647,749,322,78,170,248,2.318885448916409,20.240813423504477
Task_49648,2207,703,129,134,263,3.1349431818181817,44.47551749462961
Task_49649,859,601,11,42,53,1.4269102990033222,20.53529987641721
Task_49650,988,609,161,79,240,1.619672131147541,24.578340777738827
Task_49651,2176,228,117,143,260,9.502183406113538,42.422363165673545
Task_49652,2819,173,188,69,257,16.201149425287355,51.75490643506485
Task_49653,1474,325,150,175,325,4.521472392638037,32.00330124214062
Task_49654,2925,808,172,162,334,3.61557478368356,56.54138807758503
Task_49655,1561,423,12,108,120,3.681603773584906,32.370812722265924
Task_49656,884,300,129,159,288,2.9368770764119603,22.40211266054473
Task_49657,1153,738,29,41,70,1.5602165087956699,25.614214572259318
Task_49658,2555,639,141,39,180,3.9921875,48.75612613736505
Task_49659,903,796,53,73,126,1.1329987452948558,23.245133183015696
Task_49660,2964,261,184,119,303,11.312977099236642,55.153829196626454
Task_49661,1762,791,96,27,123,2.224747474747475,36.163295808666525
Task_49662,628,570,44,176,220,1.0998248686514887,18.82369386682954
Task_49663,1936,575,165,48,213,3.361111111111111,38.94222582846191
Task_49664,2501,931,44,189,233,2.6834763948497855,49.80955006886209
Task_49665,2158,611,193,56,249,3.526143790849673,42.92590611280004
Task_49666,565,64,39,179,218,8.692307692307692,15.92558915217355
Task_49667,670,728,85,120,205,0.9190672153635117,19.850344809676866
Task_49668,1450,184,42,43,85,7.837837837837838,29.003808511420612
Task_49669,1840,698,193,114,307,2.632331902718169,38.81540924928377
Task_49670,1326,568,196,108,304,2.330404217926186,30.244575067646206
Task_49671,557,780,30,176,206,0.7131882202304738,18.43300877379235
Task_49672,2702,452,59,135,194,5.964679911699779,51.271506278071115
Task_49673,1102,552,43,114,157,1.9927667269439422,25.827096421783263
Task_49674,2252,763,101,152,253,2.9476439790575917,45.35813270360004
Task_49675,1590,933,173,171,344,1.702355460385439,35.823976575882746
Task_49676,2190,307,31,116,147,7.1103896103896105,42.19830949863845
Task_49677,566,464,73,125,198,1.217204301075269,17.42145701900093
Task_49678,1815,342,115,103,218,5.291545189504373,36.86486368101605
Task_49679,1351,783,131,38,169,1.7232142857142858,30.05009022756192
Task_49680,732,837,119,50,169,0.8735083532219571,20.57241537819456
Task_49681,1821,331,38,105,143,5.484939759036145,36.407787400300236
Task_49682,1020,935,198,66,264,1.0897435897435896,26.004357427295133
Task_49683,2808,648,178,156,334,4.326656394453004,54.173383312027475
Task_49684,1981,942,147,132,279,2.1007423117709436,41.71102384967731
Task_49685,2015,951,42,120,162,2.116596638655462,41.62369403512712
Task_49686,942,933,100,170,270,1.0085653104925054,25.155776933291893
Task_49687,2379,173,188,123,311,13.672413793103448,45.39291451097028
Task_49688,1582,86,195,179,374,18.183908045977013,32.60919019477304
Task_49689,1593,762,105,19,124,2.0878112712975097,33.32526547287099
Task_49690,2570,729,199,86,285,3.5205479452054793,50.27006047890336
Task_49691,578,271,150,20,170,2.125,16.124606262413096
Task_49692,1368,978,21,70,91,1.397344228804903,30.505681833629477
Task_49693,587,848,181,133,314,0.6914016489988222,19.571671852212955
Task_49694,1008,156,137,181,318,6.420382165605096,23.86117454410335
Task_49695,1227,257,93,96,189,4.755813953488372,27.21572155589511
Task_49696,1202,762,54,175,229,1.5753604193971167,28.677199185276283
Task_49697,2612,782,127,93,220,3.3358876117496807,50.8694069131634
Task_49698,2186,927,111,110,221,2.355603448275862,44.619088359533684
Task_49699,1593,251,104,13,117,6.321428571428571,31.5777803467024
Task_49700,2324,614,123,97,220,3.778861788617886,45.82795596609659
Task_49701,1978,122,61,23,84,16.08130081300813,36.52565500266327
Task_49702,1594,948,154,85,239,1.679662802950474,35.26165747855675
Task_49703,1898,917,186,54,240,2.0675381263616557,39.7322887194734
Task_49704,2270,686,60,97,157,3.304221251819505,44.8158252922585
Task_49705,585,340,195,71,266,1.715542521994135,17.322362552556708
Task_49706,743,503,117,132,249,1.4742063492063493,20.54361168212365
Task_49707,1571,860,136,169,305,1.8246225319396052,35.13087102738084
Task_49708,2747,719,103,97,200,3.8152777777777778,52.77011447275482
Task_49709,2518,404,131,64,195,6.217283950617284,47.75278552868417
Task_49710,844,897,198,187,385,0.9398663697104677,24.090998387927357
Task_49711,711,419,137,160,297,1.6928571428571428,20.072019470879876
Task_49712,533,87,97,79,176,6.056818181818182,14.810491205381224
Task_49713,2964,411,104,150,254,7.194174757281553,55.5045895288301
Task_49714,1891,429,85,23,108,4.397674418604651,36.875607477893524
Task_49715,1592,591,12,94,106,2.689189189189189,33.22213517170667
Task_49716,2768,743,27,128,155,3.7204301075268815,52.79586537262159
Task_49717,1919,206,161,105,266,9.270531400966183,38.252956663968924
Task_49718,1681,660,107,90,197,2.5431164901664145,35.6150718511574
Task_49719,1210,70,77,117,194,17.04225352112676,25.91743533984399
Task_49720,1717,146,19,62,81,11.680272108843537,32.94625243851185
Task_49721,1797,654,125,91,216,2.7435114503816793,37.49744246815496
Task_49722,2924,420,160,188,348,6.945368171021378,55.38104329902533
Task_49723,2192,191,123,200,323,11.416666666666666,42.89899448421219
Task_49724,2881,342,126,84,210,8.39941690962099,53.58713817067622
Task_49725,1873,928,114,34,148,2.016146393972013,38.61379071334161
Task_49726,2971,236,175,134,309,12.535864978902953,55.21775981275374
Task_49727,565,949,157,162,319,0.5947368421052631,19.610092684037962
Task_49728,1504,497,183,162,345,3.0200803212851404,33.10288237106489
Task_49729,1223,922,38,165,203,1.3250270855904658,29.290248349871792
Task_49730,1854,227,24,123,147,8.131578947368421,36.60203995998638
Task_49731,2709,133,79,63,142,20.21641791044776,49.04725570831493
Task_49732,1390,269,88,32,120,5.148148148148148,28.523088590548173
Task_49733,546,984,24,61,85,0.5543147208121827,17.403182913365097
Task_49734,617,1005,177,23,200,0.6133200795228628,19.564438624689696
Task_49735,2486,567,82,59,141,4.376760563380282,47.42117819082304
Task_49736,1066,606,185,158,343,1.7561779242174629,26.48180600117748
Task_49737,2078,889,101,86,187,2.3348314606741574,42.51340787289939
Task_49738,672,752,57,78,135,0.8924302788844621,19.53681647261568
Task_49739,881,522,33,181,214,1.684512428298279,22.74860993833231
Task_49740,1171,559,112,141,253,2.0910714285714285,27.580448899344447
Task_49741,2942,453,27,114,141,6.4801762114537445,54.528435214666615
Task_49742,1119,362,85,182,267,3.0826446280991737,26.263335380909258
Task_49743,1637,608,195,145,340,2.6880131362889985,35.51177684119239
Task_49744,672,477,90,13,103,1.405857740585774,17.626138404254295
Task_49745,1147,230,12,147,159,4.965367965367966,25.495879391251275
Task_49746,2303,476,158,162,320,4.828092243186583,45.57151032030197
Task_49747,2709,750,168,85,253,3.607190412782956,52.38181710326119
Task_49748,737,380,183,135,318,1.9343832020997376,20.432134067186993
Task_49749,2141,770,123,29,152,2.776913099870298,42.337222414876955
Task_49750,2539,870,169,163,332,2.9150401836969,50.61251621480259
Task_49751,2055,563,94,137,231,3.643617021276596,41.49627733741934
Task_49752,1369,865,112,193,305,1.5808314087759816,31.93826752301493
Task_49753,2528,222,115,61,176,11.336322869955158,47.11094680168992
Task_49754,1239,944,125,182,307,1.3111111111111111,30.112058458788912
Task_49755,2551,507,159,119,278,5.021653543307087,49.345438313838294
Task_49756,2151,210,158,60,218,10.19431279620853,41.32485452122226
Task_49757,1441,873,27,88,115,1.6487414187643021,31.88385391794311
Task_49758,2934,437,57,10,67,6.698630136986301,52.60507904108055
Task_49759,2070,139,123,199,322,14.785714285714286,40.50141988812309
Task_49760,2211,681,26,48,74,3.2419354838709675,42.27273397922766
Task_49761,1143,346,170,165,335,3.2939481268011526,26.867046223024715
Task_49762,2878,893,68,100,168,3.21923937360179,55.249422404971966
Task_49763,997,536,49,101,150,1.856610800744879,24.122714454918952
Task_49764,720,913,94,74,168,0.787746170678337,20.857631540335316
Task_49765,2350,442,153,115,268,5.3047404063205414,45.90172656919634
Task_49766,1233,260,29,104,133,4.724137931034483,26.860118404739826
Task_49767,737,651,25,103,128,1.1303680981595092,20.283025140211013
Task_49768,570,784,71,112,183,0.7261146496815286,18.482106104081996
Task_49769,863,366,52,65,117,2.35149863760218,20.974008856876797
Task_49770,1552,497,92,70,162,3.1164658634538154,32.55152659193697
Task_49771,2978,435,116,74,190,6.830275229357798,55.222990373361085
Task_49772,1532,289,166,47,213,5.2827586206896555,31.61462457805256
Task_49773,971,125,53,120,173,7.7063492063492065,22.26695989710427
Task_49774,531,890,30,125,155,0.5959595959595959,17.984512507619197
Task_49775,760,556,120,164,284,1.3644524236983842,21.1896338150569
Task_49776,514,377,170,146,316,1.3597883597883598,16.854802639946126
Task_49777,2265,941,47,65,112,2.4044585987261144,44.91709217391312
Task_49778,2246,83,35,102,137,26.738095238095237,41.37118639752136
Task_49779,1137,199,122,125,247,5.685,25.836413799849492
Task_49780,2791,522,115,17,132,5.336520076481835,51.6867522557237
Task_49781,2763,802,24,148,172,3.4408468244084682,53.16428595401717
Task_49782,1353,588,174,73,247,2.297113752122241,30.19683830416628
Task_49783,2937,915,33,160,193,3.2063318777292578,56.43514868733547
Task_49784,1735,600,68,112,180,2.886855241264559,36.31646151544387
Task_49785,2529,998,192,174,366,2.5315315315315314,51.0229472956276
Task_49786,993,684,192,153,345,1.4496350364963504,25.52980734201753
Task_49787,1957,192,161,168,329,10.139896373056995,39.17455426103344
Task_49788,982,694,113,166,279,1.4129496402877697,25.10820102427964
Task_49789,682,423,27,195,222,1.6084905660377358,19.328926751429556
Task_49790,2332,325,43,198,241,7.153374233128834,45.24390193904463
Task_49791,2081,462,192,190,382,4.494600431965443,42.332652775219906
Task_49792,1559,121,179,100,279,12.778688524590164,32.00685267124019
Task_49793,2451,322,129,149,278,7.588235294117647,47.193773154058704
Task_49794,1494,398,82,114,196,3.744360902255639,31.928506485792415
Task_49795,2131,437,41,154,195,4.865296803652968,42.16022402623796
Task_49796,2854,534,37,28,65,5.3345794392523365,51.874973686144095
Task_49797,1702,768,77,117,194,2.213263979193758,36.410267477588945
Task_49798,853,399,138,93,231,2.1325,21.857423971869114
Task_49799,1977,488,149,57,206,4.042944785276074,39.4693460049187
Task_49800,2521,556,30,64,94,4.526032315978456,47.49296983718774
Task_49801,584,617,78,180,258,0.9449838187702265,18.543309643469154
Task_49802,2893,864,147,84,231,3.344508670520231,55.55710339320637
Task_49803,2702,305,75,183,258,8.830065359477125,51.127997891255625
Task_49804,1688,172,11,57,68,9.757225433526012,32.39499287269158
Task_49805,1709,950,42,105,147,1.797055730809674,36.63171578569943
Task_49806,1123,378,65,150,215,2.9630606860158313,26.16033042233144
Task_49807,1826,936,49,75,124,1.9487726787620063,38.259461906682965
Task_49808,2998,894,122,197,319,3.3497206703910614,57.95174393381867
Task_49809,2021,290,10,58,68,6.945017182130584,38.10704417808495
Task_49810,1268,885,79,198,277,1.4311512415349887,30.33434145904921
Task_49811,937,301,103,84,187,3.1026490066225167,22.58233475969146
Task_49812,2932,822,199,139,338,3.5625759416767924,56.68063059612759
Task_49813,1281,731,142,67,209,1.75,29.269489963417403
Task_49814,2189,648,92,81,173,3.3728813559322033,43.398725044683204
Task_49815,1686,928,90,96,186,1.814854682454252,36.51971812354576
Task_49816,914,568,155,158,313,1.6063268892794376,23.8209454791765
Task_49817,1799,540,90,174,264,3.325323475046211,37.556699670972236
Task_49818,2299,178,78,57,135,12.843575418994414,42.83421338764308
Task_49819,2487,88,189,65,254,27.9438202247191,45.66433638718821
Task_49820,1614,571,118,156,274,2.8216783216783217,34.74969602469989
Task_49821,2350,992,68,49,117,2.366565961732125,46.144310890443144
Task_49822,889,86,84,116,200,10.218390804597702,20.88083069592655
Task_49823,1938,687,14,149,163,2.816860465116279,39.660606096311874
Task_49824,513,403,21,135,156,1.2698019801980198,15.951979036411638
Task_49825,2925,620,150,26,176,4.7101449275362315,54.496116992580106
Task_49826,2643,624,49,39,88,4.2288,49.20934313223325
Task_49827,1253,520,93,56,149,2.404990403071017,27.855446390873453
Task_49828,1583,479,143,16,159,3.2979166666666666,32.544318573420156
Task_49829,720,936,104,69,173,0.768409818569904,20.877741148851122
Task_49830,2262,561,119,15,134,4.02491103202847,43.421335148806556
Task_49831,1732,951,29,48,77,1.819327731092437,35.55537501409854
Task_49832,2197,995,168,183,351,2.2058232931726907,45.697995809767
Task_49833,1540,78,90,193,283,19.49367088607595,31.504017144983532
Task_49834,2479,187,55,164,219,13.186170212765957,46.9813896709562
Task_49835,2059,214,114,148,262,9.576744186046511,40.53853243736051
Task_49836,1572,672,124,27,151,2.335809806835067,33.018625463144495
Task_49837,2000,984,169,102,271,2.030456852791878,42.06265785215227
Task_49838,2377,776,140,179,319,3.0592020592020592,47.71624910378021
Task_49839,1462,538,144,69,213,2.712430426716141,31.552007618735075
Task_49840,2922,890,109,37,146,3.2794612794612794,55.15272961696784
Task_49841,1720,855,66,135,201,2.0093457943925235,37.03497991120939
Task_49842,1769,669,28,176,204,2.6402985074626866,37.21651843745049
Task_49843,1033,879,68,157,225,1.1738636363636363,26.292676489410614
Task_49844,567,606,134,150,284,0.9341021416803954,18.292698109640437
Task_49845,887,383,107,47,154,2.3098958333333335,21.293578853335106
Task_49846,1117,104,71,110,181,10.638095238095238,24.461411102159754
Task_49847,1716,791,26,138,164,2.1666666666666665,36.47153316502433
Task_49848,2181,412,102,28,130,5.280871670702179,41.73393364855128
Task_49849,2380,502,156,189,345,4.731610337972167,47.02668004860768
Task_49850,2684,612,186,102,288,4.378466557911909,51.80838462814287
Task_49851,1276,83,157,146,303,15.19047619047619,27.419243309894323
Task_49852,2497,952,160,156,316,2.620146904512067,50.120733927241496
Task_49853,1334,710,94,167,261,1.8762306610407877,30.71832289609925
Task_49854,2411,83,39,28,67,28.702380952380953,42.722190418282224
Task_49855,1259,534,69,80,149,2.353271028037383,28.26761974544412
Task_49856,1029,864,72,30,102,1.1895953757225433,24.652222317700534
Task_49857,1331,314,36,108,144,4.2253968253968255,28.619824919167502
Task_49858,748,904,147,69,216,0.8265193370165745,21.418848280321996
Task_49859,1261,309,196,200,396,4.067741935483871,28.93911679017989
Task_49860,2746,903,29,24,53,3.0376106194690267,51.27753200011608
Task_49861,2610,840,87,103,190,3.103448275862069,50.87277059013644
Task_49862,1887,203,34,59,93,9.25,36.13866318723614
Task_49863,1501,586,161,56,217,2.557069846678024,32.29821038289023
Task_49864,1691,999,129,168,297,1.691,37.41304414170366
Task_49865,1461,943,130,31,161,1.5476694915254237,32.18246351317509
Task_49866,2153,882,94,87,181,2.4382785956964894,43.65240513319379
Task_49867,1009,1008,162,19,181,1.0,25.322433103300316
Task_49868,1480,369,101,176,277,4.0,32.02713399800883
Task_49869,1224,745,119,91,210,1.6407506702412868,28.66483225897919
Task_49870,1983,814,101,191,292,2.4331288343558284,41.48894051540443
Task_49871,2471,604,118,52,170,4.084297520661157,47.50902413223758
Task_49872,2728,116,79,152,231,23.316239316239315,50.24775497323376
Task_49873,1534,122,61,23,84,12.471544715447154,29.539418122691163
Task_49874,2273,833,188,168,356,2.725419664268585,46.39771232985115
Task_49875,987,598,37,101,138,1.647746243739566,24.028532417703236
Task_49876,1273,349,190,80,270,3.637142857142857,28.416046607046656
Task_49877,1236,915,16,134,150,1.3493449781659388,28.961034068327844
Task_49878,1994,1017,100,115,215,1.9587426326129667,41.83676057664669
Task_49879,2806,879,75,163,238,3.1886363636363635,54.51238751118834
Task_49880,2277,736,154,118,272,3.08955223880597,45.70522474328749
Task_49881,1630,884,90,81,171,1.8418079096045197,35.23284108470853
Task_49882,2874,597,103,59,162,4.806020066889632,53.740468234157525
Task_49883,1296,88,186,101,287,14.561797752808989,27.62916183230752
Task_49884,1576,891,137,56,193,1.7668161434977578,34.320193927704004
Task_49885,2943,791,161,158,319,3.715909090909091,56.69958629709142
Task_49886,555,572,37,41,78,0.9685863874345549,15.898335816459557
Task_49887,1227,527,193,114,307,2.3238636363636362,28.57048740889765
Task_49888,1852,175,157,196,353,10.522727272727273,37.37708510896517
Task_49889,704,897,80,96,176,0.7839643652561247,20.863505920913315
Task_49890,503,412,11,78,89,1.2179176755447942,15.114031083170616
Task_49891,1087,898,194,78,272,1.2091212458286986,27.143281442643385
Task_49892,2486,755,73,67,140,3.2883597883597884,48.11590520701097
Task_49893,2435,408,41,109,150,5.9535452322738385,46.405505071335995
Task_49894,586,263,137,149,286,2.2196969696969697,17.548834044373265
Task_49895,2037,269,71,27,98,7.544444444444444,38.612979816477086
Task_49896,705,103,83,173,256,6.778846153846154,18.441403526439355
Task_49897,1287,97,178,200,378,13.13265306122449,28.05211990441676
Task_49898,1090,890,39,189,228,1.22334455667789,27.2139667862532
Task_49899,737,891,38,154,192,0.8262331838565022,21.38764724082634
Task_49900,2834,417,194,149,343,6.779904306220096,53.867067271983636
Task_49901,2066,398,101,93,194,5.177944862155388,40.87921423853491
Task_49902,1641,633,190,23,213,2.588328075709779,34.35196763632504
Task_49903,2109,356,165,166,331,5.907563025210084,42.163526017170746
Task_49904,777,697,114,88,202,1.1131805157593124,21.326597483755176
Task_49905,1300,697,86,190,276,1.8624641833810889,30.190516554760034
Task_49906,712,710,82,106,188,1.0014064697609002,20.346673740547264
Task_49907,1793,289,23,149,172,6.182758620689655,36.157995175917456
Task_49908,2588,484,81,163,244,5.336082474226804,49.8212370412783
Task_49909,1750,985,110,141,251,1.7748478701825559,38.05766716488913
Task_49910,2244,1022,167,123,290,2.193548387096774,46.16389109549275
Task_49911,1882,484,177,143,320,3.8804123711340206,38.904955378967124
Task_49912,2180,646,151,97,248,3.3693972179289027,43.77477533051084
Task_49913,516,680,87,171,258,0.7577092511013216,17.5733064018124
Task_49914,2570,751,200,128,328,3.4175531914893615,50.66103901809879
Task_49915,2145,1006,55,160,215,2.1300893743793448,44.33107221806233
Task_49916,2081,254,94,112,206,8.16078431372549,40.73795554673058
Task_49917,1181,527,73,194,267,2.2367424242424243,27.839103957620974
Task_49918,2123,355,172,94,266,5.963483146067416,41.976508380530426
Task_49919,2863,458,173,167,340,6.237472766884531,54.474585758375326
Task_49920,1779,809,23,130,153,2.196296296296296,37.28822873381568
Task_49921,1623,687,92,188,280,2.359011627906977,35.33810673209804
Task_49922,2654,654,57,78,135,4.051908396946565,50.613378662799704
Task_49923,1474,749,93,169,262,1.9653333333333334,33.09325631941899
Task_49924,548,323,102,89,191,1.691358024691358,16.568876676940175
Task_49925,2909,516,50,12,62,5.626692456479691,52.529301755195114
Task_49926,1922,902,143,39,182,2.1284606866002216,39.54802474016362
Task_49927,1635,380,111,129,240,4.291338582677166,34.27944777784174
Task_49928,2321,337,137,165,302,6.866863905325443,45.320725907725965
Task_49929,950,715,34,36,70,1.3268156424581006,22.340250282820616
Task_49930,1594,977,36,104,140,1.6298568507157465,34.83343607163441
Task_49931,1943,613,124,178,302,3.1644951140065145,40.25076645102808
Task_49932,1478,693,191,49,240,2.1296829971181555,32.24732034491599
Task_49933,1300,885,79,125,204,1.4672686230248306,30.405355061758243
Task_49934,2824,268,156,129,285,10.49814126394052,52.900930124895524
Task_49935,2863,957,127,61,188,2.988517745302714,54.87196449777286
Task_49936,2133,330,180,158,338,6.444108761329305,42.47564588541871
Task_49937,1292,709,51,105,156,1.819718309859155,29.381508556332232
Task_49938,2710,813,89,144,233,3.329238329238329,52.64815142102153
Task_49939,1649,78,117,127,244,20.873417721518987,32.94727574897456
Task_49940,2283,483,57,85,142,4.716942148760331,44.2606312969311
Task_49941,2380,660,160,80,240,3.600605143721634,46.797958611909706
Task_49942,1143,998,111,52,163,1.1441441441441442,27.689738517752943
Task_49943,1299,871,34,64,98,1.489678899082569,29.14358866810773
Task_49944,2894,233,64,51,115,12.367521367521368,52.32416830712637
Task_49945,1887,720,74,96,170,2.6171983356449378,39.04374130987441
Task_49946,1238,528,152,98,250,2.340264650283554,28.474959884885298
Task_49947,816,956,61,61,122,0.8526645768025078,21.87987378740661
Task_49948,794,394,39,21,60,2.010126582278481,18.760644644180562
Task_49949,2045,820,55,136,191,2.490864799025579,42.02373295617037
Task_49950,2832,984,121,15,136,2.8751269035532996,53.777248851587096
Task_49951,2816,784,54,73,127,3.5872611464968154,53.48287708486601
Task_49952,2964,172,111,150,261,17.13294797687861,54.436705653469346
Task_49953,2999,494,131,190,321,6.058585858585858,56.693536289451515
Task_49954,2268,118,83,148,231,19.058823529411764,43.010211520601594
Task_49955,766,879,180,58,238,0.8704545454545455,21.707089631140164
Task_49956,1058,98,164,179,343,10.686868686868687,24.275228582975036
Task_49957,2670,596,135,157,292,4.472361809045226,51.634273226339076
Task_49958,2952,205,58,115,173,14.330097087378642,54.18973506979366
Task_49959,1909,399,118,185,303,4.7725,39.042740466495125
Task_49960,1284,550,148,166,314,2.3303085299455537,29.653075116107058
Task_49961,2658,742,89,181,270,3.5773889636608343,51.822024177540605
Task_49962,2364,712,166,53,219,3.3155680224403925,46.42185407429485
Task_49963,612,442,68,80,148,1.381489841986456,17.672500251623912
Task_49964,958,1008,186,132,318,0.9494549058473737,25.860175989569726
Task_49965,577,736,88,59,147,0.7829036635006784,17.803477700183766
Task_49966,2567,70,174,128,302,36.15492957746479,47.56125427794466
Task_49967,734,400,103,180,283,1.8304239401496258,20.355909310658728
Task_49968,1848,870,156,145,301,2.121699196326062,39.4977261174653
Task_49969,2999,329,106,84,190,9.087878787878788,55.3130008648122
Task_49970,2359,203,114,95,209,11.563725490196079,44.92916231797003
Task_49971,1735,944,96,151,247,1.835978835978836,37.71042095044117
Task_49972,1655,601,103,144,247,2.749169435215947,35.35419272991988
Task_49973,1894,251,29,73,102,7.515873015873016,36.72173648449231
Task_49974,597,144,81,23,104,4.117241379310345,15.156088016442332
Task_49975,2127,695,20,95,115,3.0560344827586206,42.195711204356215
Task_49976,1228,835,127,105,232,1.4688995215311005,29.141984306141453
Task_49977,1251,110,12,169,181,11.27027027027027,26.556449699071603
Task_49978,1384,503,151,44,195,2.746031746031746,29.8540073694451
Task_49979,2489,995,17,26,43,2.498995983935743,47.39500670744326
Task_49980,1341,454,17,91,108,2.9472527472527474,28.817147945946516
Task_49981,1783,511,176,180,356,3.482421875,37.64033645394272
Task_49982,603,922,128,137,265,0.6533044420368364,19.848512892388637
Task_49983,1638,878,161,182,343,1.863481228668942,36.4387479747063
Task_49984,1675,80,35,197,232,20.679012345679013,33.401090410891726
Task_49985,2851,483,56,198,254,5.890495867768595,54.094011581687795
Task_49986,2035,822,106,173,279,2.4726609963547994,42.25280768610107
Task_49987,686,497,70,132,202,1.3775100401606426,19.487395374275106
Task_49988,797,976,66,23,89,0.8157625383828045,21.27992018821675
Task_49989,2064,521,38,82,120,3.954022988505747,40.6963924338553
Task_49990,2501,94,39,138,177,26.326315789473686,46.01816230003792
Task_49991,1072,672,113,55,168,1.5928677563150073,25.523235130236333
Task_49992,2286,237,69,189,258,9.605042016806722,44.32418855319455
Task_49993,1674,804,162,11,173,2.079503105590062,35.17135248834516
Task_49994,1776,805,104,90,194,2.203473945409429,37.557832941699
Task_49995,1312,921,30,96,126,1.4229934924078091,30.155739129446903
Task_49996,799,929,54,35,89,0.8591397849462366,21.079516114575
Task_49997,2199,670,34,198,232,3.277198211624441,44.21101718032134
Task_49998,1743,311,88,70,158,5.586538461538462,34.828939845810474
Task_49999,1023,830,177,164,341,1.2310469314079422,26.44563706259031
Task_50000,735,732,69,76,145,1.0027285129604366,20.41323112771392
